Rk,Team,Date,PTS,Unnamed: 4,Opp,Result,MP,FG,FGA,FG%,2P,2PA,2P%,3P,3PA,3P%,FT,FTA,FT%,PTS.1,FG.1,FGA.1,FG%.1,2P.1,2PA.1,2P%.1,3P.1,3PA.1,3P%.1,FT.1,FTA.1,FT%.1,PTS.2
1,HOU,2019-10-30,159,@,WAS,1,240,55,103,0.534,32,49,0.653,23,54,0.426,26,33,0.788,159,57,91,0.626,37,55,0.673,20,36,0.556,24,29,0.828,158
2,HOU,2019-11-30,158,,ATL,1,240,52,89,0.584,27,38,0.711,25,51,0.49,29,34,0.853,158,38,89,0.427,23,43,0.535,15,46,0.326,20,25,0.8,111
3,WAS,2019-10-30,158,,HOU,0,240,57,91,0.626,37,55,0.673,20,36,0.556,24,29,0.828,158,55,103,0.534,32,49,0.653,23,54,0.426,26,33,0.788,159
4,HOU,2020-07-31,153,@,DAL,1,265,52,101,0.515,33,53,0.623,19,48,0.396,30,39,0.769,153,50,105,0.476,29,56,0.518,21,49,0.429,28,38,0.737,149
5,ATL,2020-01-26,152,,WAS,1,240,54,93,0.581,39,58,0.672,15,35,0.429,29,34,0.853,152,42,88,0.477,31,55,0.564,11,33,0.333,38,42,0.905,133
6,MIL,2020-01-28,151,,WAS,1,240,50,90,0.556,31,53,0.585,19,37,0.514,32,35,0.914,151,44,94,0.468,30,62,0.484,14,32,0.438,29,34,0.853,131
7,LAC,2019-12-01,150,,WAS,1,240,52,94,0.553,38,62,0.613,14,32,0.438,32,40,0.8,150,47,102,0.461,36,72,0.5,11,30,0.367,20,27,0.741,125
8,LAC,2019-11-16,150,,ATL,1,240,50,93,0.538,33,60,0.55,17,33,0.515,33,35,0.943,150,34,90,0.378,28,66,0.424,6,24,0.25,27,37,0.73,101
9,BOS,2020-08-05,149,,BRK,1,240,50,88,0.568,30,49,0.612,20,39,0.513,29,35,0.829,149,45,95,0.474,37,63,0.587,8,32,0.25,17,21,0.81,115
10,DAL,2020-07-31,149,,HOU,0,265,50,105,0.476,29,56,0.518,21,49,0.429,28,38,0.737,149,52,101,0.515,33,53,0.623,19,48,0.396,30,39,0.769,153
11,SAS,2019-12-23,145,@,MEM,1,240,60,89,0.674,45,65,0.692,15,24,0.625,10,14,0.714,145,45,96,0.469,30,59,0.508,15,37,0.405,10,16,0.625,115
12,ATL,2020-03-09,143,,CHO,1,290,53,96,0.552,32,53,0.604,21,43,0.488,16,27,0.593,143,49,104,0.471,30,56,0.536,19,48,0.396,21,23,0.913,138
13,NYK,2019-12-17,143,,ATL,1,240,53,95,0.558,40,67,0.597,13,28,0.464,24,31,0.774,143,45,99,0.455,30,56,0.536,15,43,0.349,15,20,0.75,120
14,DAL,2019-11-22,143,,CLE,1,240,58,100,0.58,38,63,0.603,20,37,0.541,7,9,0.778,143,37,86,0.43,25,57,0.439,12,29,0.414,15,17,0.882,101
15,MIN,2020-02-08,142,,LAC,1,240,52,95,0.547,26,51,0.51,26,44,0.591,12,18,0.667,142,41,86,0.477,32,60,0.533,9,26,0.346,24,29,0.828,115
16,LAL,2019-12-08,142,,MIN,1,240,55,94,0.585,41,63,0.651,14,31,0.452,18,20,0.9,142,44,84,0.524,29,47,0.617,15,37,0.405,22,26,0.846,125
17,DAL,2019-11-20,142,,GSW,1,240,51,90,0.567,29,52,0.558,22,38,0.579,18,23,0.783,142,35,90,0.389,27,63,0.429,8,27,0.296,16,25,0.64,94
18,ATL,2020-02-28,141,,BRK,1,240,50,97,0.515,31,58,0.534,19,39,0.487,22,30,0.733,141,42,92,0.457,24,46,0.522,18,46,0.391,16,21,0.762,118
19,BOS,2020-02-13,141,,LAC,1,290,45,103,0.437,27,60,0.45,18,43,0.419,33,40,0.825,141,46,110,0.418,35,75,0.467,11,35,0.314,30,37,0.811,133
20,DAL,2019-12-28,141,@,GSW,1,240,48,92,0.522,24,41,0.585,24,51,0.471,21,21,1.0,141,45,93,0.484,27,54,0.5,18,39,0.462,13,17,0.765,121
21,PHI,2019-12-07,141,,CLE,1,240,57,90,0.633,46,64,0.719,11,26,0.423,16,23,0.696,141,36,96,0.375,27,61,0.443,9,35,0.257,13,17,0.765,94
22,LAC,2019-10-24,141,@,GSW,1,240,50,80,0.625,32,48,0.667,18,32,0.563,23,30,0.767,141,39,99,0.394,24,57,0.421,15,42,0.357,29,30,0.967,122
23,SAC,2020-08-06,140,,NOP,1,240,50,93,0.538,34,60,0.567,16,33,0.485,24,33,0.727,140,47,82,0.573,33,48,0.688,14,34,0.412,17,23,0.739,125
24,POR,2020-07-31,140,,MEM,1,265,49,91,0.538,36,61,0.59,13,30,0.433,29,34,0.853,140,42,93,0.452,29,52,0.558,13,41,0.317,38,50,0.76,135
25,PHO,2020-03-08,140,,MIL,1,240,47,85,0.553,28,42,0.667,19,43,0.442,27,31,0.871,140,51,95,0.537,38,62,0.613,13,33,0.394,16,21,0.762,131
26,HOU,2020-02-26,140,,MEM,1,240,52,93,0.559,29,43,0.674,23,50,0.46,13,15,0.867,140,43,108,0.398,30,69,0.435,13,39,0.333,13,21,0.619,112
27,ATL,2020-02-09,140,,NYK,1,290,49,108,0.454,35,68,0.515,14,40,0.35,28,31,0.903,140,52,110,0.473,39,76,0.513,13,34,0.382,18,25,0.72,135
28,OKC,2020-01-24,140,,ATL,1,240,50,86,0.581,36,61,0.59,14,25,0.56,26,34,0.765,140,42,92,0.457,31,56,0.554,11,36,0.306,16,20,0.8,111
29,TOR,2020-01-17,140,,WAS,1,240,52,91,0.571,30,48,0.625,22,43,0.512,14,16,0.875,140,40,89,0.449,25,54,0.463,15,35,0.429,16,23,0.696,111
30,BOS,2020-01-11,140,,NOP,1,240,55,100,0.55,41,71,0.577,14,29,0.483,16,18,0.889,140,40,100,0.4,26,55,0.473,14,45,0.311,11,18,0.611,105
31,MEM,2020-01-04,140,@,LAC,1,240,49,96,0.51,31,57,0.544,18,39,0.462,24,28,0.857,140,45,101,0.446,38,71,0.535,7,30,0.233,17,22,0.773,114
32,WAS,2019-11-27,140,@,PHO,1,240,51,89,0.573,32,54,0.593,19,35,0.543,19,20,0.95,140,48,93,0.516,33,55,0.6,15,38,0.395,21,24,0.875,132
33,BOS,2019-11-13,140,,WAS,1,240,49,96,0.51,33,60,0.55,16,36,0.444,26,29,0.897,140,50,96,0.521,39,67,0.582,11,29,0.379,22,27,0.815,133
34,BRK,2020-03-06,139,,SAS,1,240,51,96,0.531,36,60,0.6,15,36,0.417,22,31,0.71,139,43,92,0.467,33,58,0.569,10,34,0.294,24,27,0.889,120
35,MIN,2020-03-03,139,@,NOP,1,240,54,97,0.557,40,63,0.635,14,34,0.412,17,20,0.85,139,52,100,0.52,38,61,0.623,14,39,0.359,16,27,0.593,134
36,DAL,2020-02-24,139,,MIN,1,240,51,101,0.505,35,57,0.614,16,44,0.364,21,28,0.75,139,42,95,0.442,27,53,0.509,15,42,0.357,24,34,0.706,123
37,NYK,2020-02-03,139,@,CLE,1,265,57,102,0.559,47,76,0.618,10,26,0.385,15,21,0.714,139,52,92,0.565,34,57,0.596,18,35,0.514,12,18,0.667,134
38,NOP,2020-01-31,139,,MEM,1,240,51,95,0.537,36,61,0.59,15,34,0.441,22,26,0.846,139,45,96,0.469,39,65,0.6,6,31,0.194,15,26,0.577,111
39,POR,2020-01-26,139,,IND,1,240,49,90,0.544,29,55,0.527,20,35,0.571,21,25,0.84,139,48,93,0.516,35,65,0.538,13,28,0.464,20,21,0.952,129
40,BOS,2020-01-20,139,,LAL,1,240,52,93,0.559,36,59,0.61,16,34,0.471,19,29,0.655,139,39,89,0.438,32,63,0.508,7,26,0.269,22,29,0.759,107
41,HOU,2020-01-11,139,,MIN,1,240,49,95,0.516,31,50,0.62,18,45,0.4,23,29,0.793,139,36,95,0.379,23,47,0.489,13,48,0.271,24,36,0.667,109
42,HOU,2019-12-21,139,@,PHO,1,240,51,87,0.586,32,46,0.696,19,41,0.463,18,23,0.783,139,47,91,0.516,39,63,0.619,8,28,0.286,23,30,0.767,125
43,OKC,2019-12-06,139,,MIN,1,265,49,88,0.557,44,70,0.629,5,18,0.278,36,40,0.9,139,50,96,0.521,37,58,0.638,13,38,0.342,14,20,0.7,127
44,PHO,2019-12-05,139,@,NOP,1,265,50,106,0.472,36,70,0.514,14,36,0.389,25,27,0.926,139,44,87,0.506,27,46,0.587,17,41,0.415,27,35,0.771,132
45,CHO,2020-03-09,138,@,ATL,0,290,49,104,0.471,30,56,0.536,19,48,0.396,21,23,0.913,138,53,96,0.552,32,53,0.604,21,43,0.488,16,27,0.593,143
46,NOP,2020-02-11,138,,POR,1,240,49,92,0.533,35,58,0.603,14,34,0.412,26,32,0.813,138,44,93,0.473,37,64,0.578,7,29,0.241,22,28,0.786,117
47,NOP,2020-01-16,138,,UTA,1,265,51,93,0.548,40,67,0.597,11,26,0.423,25,35,0.714,138,46,100,0.46,31,61,0.508,15,39,0.385,25,32,0.781,132
48,WAS,2019-11-20,138,,SAS,1,240,54,92,0.587,36,62,0.581,18,30,0.6,12,15,0.8,138,49,93,0.527,37,61,0.607,12,32,0.375,22,29,0.759,132
49,PHO,2019-11-10,138,,BRK,1,240,52,99,0.525,33,57,0.579,19,42,0.452,15,19,0.789,138,44,91,0.484,36,57,0.632,8,34,0.235,16,17,0.941,112
50,DAL,2019-11-09,138,@,MEM,1,240,52,97,0.536,34,55,0.618,18,42,0.429,16,20,0.8,138,50,95,0.526,38,59,0.644,12,36,0.333,10,14,0.714,122
51,MIL,2020-02-24,137,@,WAS,1,265,49,86,0.57,32,49,0.653,17,37,0.459,22,27,0.815,137,47,98,0.48,32,63,0.508,15,35,0.429,25,33,0.758,134
52,TOR,2020-02-10,137,,MIN,1,240,51,89,0.573,34,56,0.607,17,33,0.515,18,23,0.783,137,39,86,0.453,21,46,0.457,18,40,0.45,30,35,0.857,126
53,MIA,2020-02-03,137,,PHI,1,240,48,85,0.565,32,53,0.604,16,32,0.5,25,30,0.833,137,36,83,0.434,23,45,0.511,13,38,0.342,21,25,0.84,106
54,MIL,2019-11-30,137,,CHO,1,240,54,96,0.563,34,52,0.654,20,44,0.455,9,15,0.6,137,37,101,0.366,22,56,0.393,15,45,0.333,7,8,0.875,96
55,DAL,2019-11-24,137,@,HOU,1,240,49,102,0.48,32,58,0.552,17,44,0.386,22,28,0.786,137,45,98,0.459,35,54,0.648,10,44,0.227,23,31,0.742,123
56,MIL,2019-11-21,137,,POR,1,240,50,106,0.472,34,63,0.54,16,43,0.372,21,26,0.808,137,50,103,0.485,33,64,0.516,17,39,0.436,12,14,0.857,129
57,WAS,2019-11-15,137,@,MIN,1,240,54,100,0.54,44,72,0.611,10,28,0.357,19,25,0.76,137,42,89,0.472,31,52,0.596,11,37,0.297,21,29,0.724,116
58,MEM,2019-11-06,137,,MIN,1,240,50,88,0.568,38,65,0.585,12,23,0.522,25,30,0.833,137,43,96,0.448,27,51,0.529,16,45,0.356,19,26,0.731,121
59,SAC,2020-08-13,136,@,LAL,1,240,54,95,0.568,33,48,0.688,21,47,0.447,7,12,0.583,136,48,98,0.49,33,63,0.524,15,35,0.429,11,15,0.733,122
60,DAL,2020-08-08,136,,MIL,1,265,48,115,0.417,31,62,0.5,17,53,0.321,23,25,0.92,136,47,99,0.475,32,55,0.582,15,44,0.341,23,34,0.676,132
61,NYK,2020-03-11,136,@,ATL,1,265,50,94,0.532,39,66,0.591,11,28,0.393,25,34,0.735,136,48,106,0.453,34,65,0.523,14,41,0.341,21,26,0.808,131
62,LAC,2020-03-01,136,,PHI,1,240,45,76,0.592,32,52,0.615,13,24,0.542,33,41,0.805,136,48,95,0.505,27,52,0.519,21,43,0.488,13,20,0.65,130
63,ORL,2020-02-28,136,,MIN,1,240,53,98,0.541,41,58,0.707,12,40,0.3,18,22,0.818,136,46,95,0.484,29,51,0.569,17,44,0.386,16,24,0.667,125
64,DET,2020-01-18,136,@,ATL,1,240,51,86,0.593,36,54,0.667,15,32,0.469,19,25,0.76,136,40,93,0.43,30,59,0.508,10,34,0.294,13,15,0.867,103
65,SAS,2019-12-28,136,,DET,1,240,53,93,0.57,35,58,0.603,18,35,0.514,12,15,0.8,136,40,90,0.444,28,54,0.519,12,36,0.333,17,30,0.567,109
66,CHI,2019-12-11,136,,ATL,1,240,54,94,0.574,43,70,0.614,11,24,0.458,17,19,0.895,136,35,83,0.422,22,45,0.489,13,38,0.342,19,26,0.731,102
67,LAL,2019-12-06,136,@,POR,1,240,46,85,0.541,29,49,0.592,17,36,0.472,27,33,0.818,136,39,86,0.453,29,52,0.558,10,34,0.294,25,29,0.862,113
68,POR,2019-11-27,136,,OKC,1,240,49,94,0.521,35,64,0.547,14,30,0.467,24,24,1.0,136,39,88,0.443,28,53,0.528,11,35,0.314,30,38,0.789,119
69,MEM,2020-07-31,135,@,POR,0,265,42,93,0.452,29,52,0.558,13,41,0.317,38,50,0.76,135,49,91,0.538,36,61,0.59,13,30,0.433,29,34,0.853,140
70,HOU,2020-02-20,135,@,GSW,1,240,45,85,0.529,20,36,0.556,25,49,0.51,20,22,0.909,135,44,89,0.494,37,56,0.661,7,33,0.212,10,12,0.833,105
71,ORL,2020-02-10,135,,ATL,1,240,50,95,0.526,32,57,0.561,18,38,0.474,17,22,0.773,135,47,88,0.534,31,51,0.608,16,37,0.432,16,17,0.941,126
72,NYK,2020-02-09,135,@,ATL,0,290,52,110,0.473,39,76,0.513,13,34,0.382,18,25,0.72,135,49,108,0.454,35,68,0.515,14,40,0.35,28,31,0.903,140
73,LAC,2020-01-05,135,,NYK,1,240,45,83,0.542,27,51,0.529,18,32,0.563,27,33,0.818,135,48,84,0.571,36,61,0.59,12,23,0.522,24,37,0.649,132
74,MIA,2019-12-10,135,,ATL,1,265,53,103,0.515,39,62,0.629,14,41,0.341,15,22,0.682,135,45,95,0.474,25,41,0.61,20,54,0.37,11,18,0.611,121
75,LAC,2019-12-08,135,@,WAS,1,240,50,96,0.521,35,56,0.625,15,40,0.375,20,27,0.741,135,40,88,0.455,26,55,0.473,14,33,0.424,25,30,0.833,119
76,SAS,2019-12-03,135,,HOU,1,290,50,106,0.472,37,76,0.487,13,30,0.433,22,32,0.688,135,42,111,0.378,27,60,0.45,15,51,0.294,34,36,0.944,133
77,MIL,2019-11-20,135,@,ATL,1,240,46,87,0.529,29,44,0.659,17,43,0.395,26,34,0.765,135,44,96,0.458,30,65,0.462,14,31,0.452,25,31,0.806,127
78,BOS,2019-11-09,135,@,SAS,1,240,48,94,0.511,34,57,0.596,14,37,0.378,25,28,0.893,135,39,99,0.394,25,69,0.362,14,30,0.467,23,30,0.767,115
79,BRK,2019-11-04,135,,NOP,1,240,49,92,0.533,33,51,0.647,16,41,0.39,21,28,0.75,135,48,97,0.495,35,65,0.538,13,32,0.406,16,21,0.762,125
80,PHI,2020-08-14,134,@,HOU,1,240,49,87,0.563,31,49,0.633,18,38,0.474,18,22,0.818,134,35,80,0.438,23,32,0.719,12,48,0.25,14,16,0.875,96
81,POR,2020-08-13,134,@,BRK,1,240,50,104,0.481,37,65,0.569,13,39,0.333,21,24,0.875,134,53,96,0.552,39,63,0.619,14,33,0.424,13,19,0.684,133
82,POR,2020-08-11,134,@,DAL,1,240,46,98,0.469,31,60,0.517,15,38,0.395,27,29,0.931,134,42,81,0.519,22,37,0.595,20,44,0.455,27,33,0.818,131
83,DEN,2020-08-08,134,,UTA,1,290,51,108,0.472,42,71,0.592,9,37,0.243,23,30,0.767,134,47,105,0.448,25,50,0.5,22,55,0.4,16,22,0.727,132
84,NOP,2020-03-03,134,,MIN,0,240,52,100,0.52,38,61,0.623,14,39,0.359,16,27,0.593,134,54,97,0.557,40,63,0.635,14,34,0.412,17,20,0.85,139
85,WAS,2020-02-24,134,,MIL,0,265,47,98,0.48,32,63,0.508,15,35,0.429,25,33,0.758,134,49,86,0.57,32,49,0.653,17,37,0.459,22,27,0.815,137
86,CLE,2020-02-03,134,,NYK,0,265,52,92,0.565,34,57,0.596,18,35,0.514,12,18,0.667,134,57,102,0.559,47,76,0.618,10,26,0.385,15,21,0.714,139
87,MIA,2020-01-22,134,,WAS,1,265,43,85,0.506,26,52,0.5,17,33,0.515,31,36,0.861,134,50,99,0.505,37,57,0.649,13,42,0.31,16,20,0.8,129
88,DEN,2020-01-16,134,@,GSW,1,265,47,100,0.47,30,65,0.462,17,35,0.486,23,26,0.885,134,42,95,0.442,22,50,0.44,20,45,0.444,27,31,0.871,131
89,MEM,2020-01-10,134,,SAS,1,240,52,100,0.52,36,62,0.581,16,38,0.421,14,16,0.875,134,42,87,0.483,25,47,0.532,17,40,0.425,20,23,0.87,121
90,LAC,2019-12-21,134,@,SAS,1,240,54,99,0.545,42,63,0.667,12,36,0.333,14,19,0.737,134,42,82,0.512,32,54,0.593,10,28,0.357,15,19,0.789,109
91,LAC,2019-11-24,134,,NOP,1,240,46,98,0.469,30,55,0.545,16,43,0.372,26,33,0.788,134,43,98,0.439,30,57,0.526,13,41,0.317,10,18,0.556,109
92,MIL,2019-11-04,134,@,MIN,1,240,50,93,0.538,36,54,0.667,14,39,0.359,20,30,0.667,134,37,103,0.359,24,60,0.4,13,43,0.302,19,22,0.864,106
93,GSW,2019-10-28,134,@,NOP,1,240,51,104,0.49,37,69,0.536,14,35,0.4,18,24,0.75,134,48,103,0.466,33,56,0.589,15,47,0.319,12,22,0.545,123
94,MEM,2019-10-27,134,,BRK,1,265,50,103,0.485,36,70,0.514,14,33,0.424,20,25,0.8,134,44,101,0.436,29,56,0.518,15,45,0.333,30,37,0.811,133
95,BRK,2020-08-13,133,,POR,0,240,53,96,0.552,39,63,0.619,14,33,0.424,13,19,0.684,133,50,104,0.481,37,65,0.569,13,39,0.333,21,24,0.875,134
96,ORL,2020-08-13,133,,NOP,1,240,48,84,0.571,33,56,0.589,15,28,0.536,22,30,0.733,133,48,87,0.552,38,53,0.717,10,34,0.294,21,27,0.778,127
97,SAC,2020-03-03,133,,WAS,1,240,50,89,0.562,37,60,0.617,13,29,0.448,20,24,0.833,133,41,80,0.513,25,42,0.595,16,38,0.421,28,34,0.824,126
98,DEN,2020-03-01,133,,TOR,1,240,47,83,0.566,29,47,0.617,18,36,0.5,21,30,0.7,133,41,89,0.461,31,51,0.608,10,38,0.263,26,29,0.897,118
99,MIL,2020-02-28,133,,OKC,1,240,50,100,0.5,29,55,0.527,21,45,0.467,12,14,0.857,133,33,91,0.363,27,56,0.482,6,35,0.171,14,20,0.7,86
100,LAC,2020-02-13,133,@,BOS,0,290,46,110,0.418,35,75,0.467,11,35,0.314,30,37,0.811,133,45,103,0.437,27,60,0.45,18,43,0.419,33,40,0.825,141
101,LAC,2020-02-09,133,@,CLE,1,240,53,93,0.57,41,57,0.719,12,36,0.333,15,20,0.75,133,35,95,0.368,28,62,0.452,7,33,0.212,15,22,0.682,92
102,BRK,2020-01-31,133,,CHI,1,240,50,80,0.625,35,49,0.714,15,31,0.484,18,25,0.72,133,42,86,0.488,30,52,0.577,12,34,0.353,22,26,0.846,118
103,PHO,2020-01-28,133,@,DAL,1,240,51,86,0.593,39,58,0.672,12,28,0.429,19,21,0.905,133,37,83,0.446,30,50,0.6,7,33,0.212,23,27,0.852,104
104,SAC,2020-01-27,133,@,MIN,1,265,44,88,0.5,26,48,0.542,18,40,0.45,27,34,0.794,133,43,89,0.483,20,43,0.465,23,46,0.5,20,33,0.606,129
105,WAS,2020-01-26,133,@,ATL,0,240,42,88,0.477,31,55,0.564,11,33,0.333,38,42,0.905,133,54,93,0.581,39,58,0.672,15,35,0.429,29,34,0.853,152
106,DAL,2020-01-23,133,@,POR,1,240,48,93,0.516,26,46,0.565,22,47,0.468,15,24,0.625,133,46,91,0.505,25,52,0.481,21,39,0.538,12,15,0.8,125
107,LAC,2020-01-18,133,@,NOP,1,240,46,93,0.495,36,62,0.581,10,31,0.323,31,39,0.795,133,46,86,0.535,31,45,0.689,15,41,0.366,23,36,0.639,130
108,TOR,2019-12-16,133,,CLE,1,240,52,89,0.584,36,57,0.632,16,32,0.5,13,17,0.765,133,44,90,0.489,32,55,0.582,12,35,0.343,13,17,0.765,113
109,WAS,2019-12-16,133,@,DET,1,240,49,88,0.557,31,54,0.574,18,34,0.529,17,21,0.81,133,41,86,0.477,28,47,0.596,13,39,0.333,24,34,0.706,119
110,HOU,2019-12-03,133,@,SAS,0,290,42,111,0.378,27,60,0.45,15,51,0.294,34,36,0.944,133,50,106,0.472,37,76,0.487,13,30,0.433,22,32,0.688,135
111,WAS,2019-11-13,133,@,BOS,0,240,50,96,0.521,39,67,0.582,11,29,0.379,22,27,0.815,133,49,96,0.51,33,60,0.55,16,36,0.444,26,29,0.897,140
112,BRK,2019-10-27,133,@,MEM,0,265,44,101,0.436,29,56,0.518,15,45,0.333,30,37,0.811,133,50,103,0.485,36,70,0.514,14,33,0.424,20,25,0.8,134
113,UTA,2020-08-08,132,@,DEN,0,290,47,105,0.448,25,50,0.5,22,55,0.4,16,22,0.727,132,51,108,0.472,42,71,0.592,9,37,0.243,23,30,0.767,134
114,MIL,2020-08-08,132,@,DAL,0,265,47,99,0.475,32,55,0.582,15,44,0.341,23,34,0.676,132,48,115,0.417,31,62,0.5,17,53,0.321,23,25,0.92,136
115,DEN,2020-08-05,132,@,SAS,1,240,50,91,0.549,36,55,0.655,14,36,0.389,18,21,0.857,132,46,93,0.495,35,63,0.556,11,30,0.367,23,27,0.852,126
116,PHI,2020-08-03,132,,SAS,1,240,46,87,0.529,32,56,0.571,14,31,0.452,26,30,0.867,132,46,93,0.495,34,67,0.507,12,26,0.462,26,29,0.897,130
117,ORL,2020-08-02,132,,SAC,1,240,43,82,0.524,25,44,0.568,18,38,0.474,28,35,0.8,132,45,91,0.495,37,63,0.587,8,28,0.286,18,22,0.818,116
118,CLE,2020-03-08,132,,SAS,1,265,43,94,0.457,30,60,0.5,13,34,0.382,33,45,0.733,132,43,98,0.439,33,72,0.458,10,26,0.385,33,36,0.917,129
119,ORL,2020-03-06,132,@,MIN,1,240,51,84,0.607,44,63,0.698,7,21,0.333,23,31,0.742,132,46,98,0.469,36,61,0.59,10,37,0.27,16,20,0.8,118
120,LAC,2020-02-28,132,,DEN,1,240,48,89,0.539,30,50,0.6,18,39,0.462,18,20,0.9,132,41,91,0.451,32,66,0.485,9,25,0.36,12,16,0.75,103
121,UTA,2020-01-16,132,@,NOP,0,265,46,100,0.46,31,61,0.508,15,39,0.385,25,32,0.781,132,51,93,0.548,40,67,0.597,11,26,0.423,25,35,0.714,138
122,NYK,2020-01-05,132,@,LAC,0,240,48,84,0.571,36,61,0.59,12,23,0.522,24,37,0.649,132,45,83,0.542,27,51,0.529,18,32,0.563,27,33,0.818,135
123,DET,2019-12-26,132,,WAS,1,240,46,86,0.535,27,38,0.711,19,48,0.396,21,26,0.808,132,38,92,0.413,31,68,0.456,7,24,0.292,19,27,0.704,102
124,NOP,2019-12-05,132,,PHO,0,265,44,87,0.506,27,46,0.587,17,41,0.415,27,35,0.771,132,50,106,0.472,36,70,0.514,14,36,0.389,25,27,0.926,139
125,MIL,2019-12-02,132,,NYK,1,240,48,86,0.558,32,51,0.627,16,35,0.457,20,32,0.625,132,28,91,0.308,18,52,0.346,10,39,0.256,22,33,0.667,88
126,DET,2019-12-01,132,,SAS,1,240,52,88,0.591,37,57,0.649,15,31,0.484,13,18,0.722,132,36,88,0.409,29,62,0.468,7,26,0.269,19,22,0.864,98
127,PHO,2019-11-27,132,,WAS,0,240,48,93,0.516,33,55,0.6,15,38,0.395,21,24,0.875,132,51,89,0.573,32,54,0.593,19,35,0.543,19,20,0.95,140
128,SAS,2019-11-20,132,@,WAS,0,240,49,93,0.527,37,61,0.607,12,32,0.375,22,29,0.759,132,54,92,0.587,36,62,0.581,18,30,0.6,12,15,0.8,138
129,TOR,2019-11-18,132,,CHO,1,240,50,97,0.515,30,54,0.556,20,43,0.465,12,15,0.8,132,33,78,0.423,18,33,0.545,15,45,0.333,15,24,0.625,96
130,HOU,2019-11-18,132,,POR,1,240,47,100,0.47,30,55,0.545,17,45,0.378,21,26,0.808,132,40,96,0.417,29,60,0.483,11,36,0.306,17,23,0.739,108
131,NOP,2019-11-14,132,,LAC,1,240,47,98,0.48,29,64,0.453,18,34,0.529,20,29,0.69,132,46,84,0.548,35,60,0.583,11,24,0.458,24,31,0.774,127
132,DAL,2020-08-11,131,,POR,0,240,42,81,0.519,22,37,0.595,20,44,0.455,27,33,0.818,131,46,98,0.469,31,60,0.517,15,38,0.395,27,29,0.931,134
133,ATL,2020-03-11,131,,NYK,0,265,48,106,0.453,34,65,0.523,14,41,0.341,21,26,0.808,131,50,94,0.532,39,66,0.591,11,28,0.393,25,34,0.735,136
134,LAC,2020-03-10,131,@,GSW,1,240,46,92,0.5,26,48,0.542,20,44,0.455,19,19,1.0,131,37,79,0.468,26,41,0.634,11,38,0.289,22,27,0.815,107
135,MIL,2020-03-08,131,@,PHO,0,240,51,95,0.537,38,62,0.613,13,33,0.394,16,21,0.762,131,47,85,0.553,28,42,0.667,19,43,0.442,27,31,0.871,140
136,PHO,2020-02-24,131,@,UTA,1,240,49,87,0.563,37,67,0.552,12,20,0.6,21,24,0.875,131,32,68,0.471,22,42,0.524,10,26,0.385,37,43,0.86,111
137,OKC,2020-02-23,131,,SAS,1,240,50,87,0.575,40,65,0.615,10,22,0.455,21,24,0.875,131,38,103,0.369,27,65,0.415,11,38,0.289,16,19,0.842,103
138,GSW,2020-02-01,131,@,CLE,1,240,48,90,0.533,30,55,0.545,18,35,0.514,17,19,0.895,131,41,95,0.432,25,51,0.49,16,44,0.364,14,14,1.0,112
139,WAS,2020-01-28,131,@,MIL,0,240,44,94,0.468,30,62,0.484,14,32,0.438,29,34,0.853,131,50,90,0.556,31,53,0.585,19,37,0.514,32,35,0.914,151
140,HOU,2020-01-24,131,@,MIN,1,240,47,91,0.516,36,59,0.61,11,32,0.344,26,31,0.839,131,48,98,0.49,37,66,0.561,11,32,0.344,17,20,0.85,124
141,GSW,2020-01-16,131,,DEN,0,265,42,95,0.442,22,50,0.44,20,45,0.444,27,31,0.871,131,47,100,0.47,30,65,0.462,17,35,0.486,23,26,0.885,134
142,DEN,2019-11-17,131,@,MEM,1,240,49,89,0.551,31,57,0.544,18,32,0.563,15,23,0.652,131,39,84,0.464,23,48,0.479,16,36,0.444,20,24,0.833,114
143,DAL,2019-11-03,131,@,CLE,1,240,50,94,0.532,30,53,0.566,20,41,0.488,11,13,0.846,131,39,96,0.406,21,48,0.438,18,48,0.375,15,22,0.682,111
144,MIN,2019-11-02,131,@,WAS,1,240,51,94,0.543,34,55,0.618,17,39,0.436,12,17,0.706,131,37,95,0.389,25,60,0.417,12,35,0.343,23,27,0.852,109
145,MIA,2019-10-26,131,@,MIL,1,265,46,101,0.455,30,57,0.526,16,44,0.364,23,36,0.639,131,41,94,0.436,24,40,0.6,17,54,0.315,27,35,0.771,126
146,PHO,2020-08-11,130,@,PHI,1,240,49,89,0.551,37,61,0.607,12,28,0.429,20,21,0.952,130,46,93,0.495,31,60,0.517,15,33,0.455,10,14,0.714,117
147,MIL,2020-08-06,130,,MIA,1,240,41,78,0.526,26,41,0.634,15,37,0.405,33,38,0.868,130,35,83,0.422,14,37,0.378,21,46,0.457,25,27,0.926,116
148,SAS,2020-08-03,130,@,PHI,0,240,46,93,0.495,34,67,0.507,12,26,0.462,26,29,0.897,130,46,87,0.529,32,56,0.571,14,31,0.452,26,30,0.867,132
149,POR,2020-03-02,130,@,ORL,1,240,49,88,0.557,33,55,0.6,16,33,0.485,16,16,1.0,130,37,96,0.385,23,53,0.434,14,43,0.326,19,22,0.864,107
150,PHI,2020-03-01,130,@,LAC,0,240,48,95,0.505,27,52,0.519,21,43,0.488,13,20,0.65,130,45,76,0.592,32,52,0.615,13,24,0.542,33,41,0.805,136
151,ORL,2020-02-26,130,@,ATL,1,240,49,100,0.49,35,68,0.515,14,32,0.438,18,25,0.72,130,42,94,0.447,29,58,0.5,13,36,0.361,23,25,0.92,120
152,DAL,2020-02-12,130,,SAC,1,240,48,85,0.565,31,45,0.689,17,40,0.425,17,21,0.81,130,41,99,0.414,29,60,0.483,12,39,0.308,17,22,0.773,111
153,TOR,2020-01-28,130,,ATL,1,240,48,97,0.495,35,54,0.648,13,43,0.302,21,27,0.778,130,41,92,0.446,29,45,0.644,12,47,0.255,20,25,0.8,114
154,NOP,2020-01-18,130,,LAC,0,240,46,86,0.535,31,45,0.689,15,41,0.366,23,36,0.639,130,46,93,0.495,36,62,0.581,10,31,0.323,31,39,0.795,133
155,TOR,2020-01-15,130,@,OKC,1,240,52,85,0.612,37,58,0.638,15,27,0.556,11,15,0.733,130,43,85,0.506,27,43,0.628,16,42,0.381,19,20,0.95,121
156,HOU,2019-12-31,130,,DEN,1,240,46,87,0.529,30,53,0.566,16,34,0.471,22,31,0.71,130,45,97,0.464,37,72,0.514,8,25,0.32,6,9,0.667,104
157,ORL,2019-12-15,130,@,NOP,1,240,46,89,0.517,29,55,0.527,17,34,0.5,21,26,0.808,130,47,88,0.534,28,45,0.622,19,43,0.442,6,12,0.5,119
158,HOU,2019-12-13,130,@,ORL,1,240,48,86,0.558,26,47,0.553,22,39,0.564,12,13,0.923,130,40,91,0.44,25,54,0.463,15,37,0.405,12,16,0.75,107
159,DAL,2019-12-07,130,,NOP,1,240,46,86,0.535,33,48,0.688,13,38,0.342,25,31,0.806,130,32,89,0.36,29,57,0.509,3,32,0.094,17,21,0.81,84
160,BRK,2019-12-04,130,@,ATL,1,240,50,101,0.495,36,70,0.514,14,31,0.452,16,18,0.889,130,48,90,0.533,39,64,0.609,9,26,0.346,13,21,0.619,118
161,TOR,2019-12-01,130,,UTA,1,240,47,90,0.522,28,54,0.519,19,36,0.528,17,21,0.81,130,38,90,0.422,25,55,0.455,13,35,0.371,21,29,0.724,110
162,LAL,2019-11-22,130,@,OKC,1,240,45,88,0.511,28,57,0.491,17,31,0.548,23,29,0.793,130,49,93,0.527,38,62,0.613,11,31,0.355,18,20,0.9,127
163,PHO,2019-10-26,130,,LAC,1,240,43,86,0.5,26,43,0.605,17,43,0.395,27,34,0.794,130,40,87,0.46,29,55,0.527,11,32,0.344,31,39,0.795,122
164,TOR,2019-10-22,130,,NOP,1,265,42,103,0.408,28,63,0.444,14,40,0.35,32,38,0.842,130,43,102,0.422,24,57,0.421,19,45,0.422,17,20,0.85,122
165,BRK,2020-08-09,129,@,LAC,1,240,47,85,0.553,27,42,0.643,20,43,0.465,15,19,0.789,129,45,93,0.484,32,57,0.561,13,36,0.361,17,20,0.85,120
166,HOU,2020-08-09,129,@,SAC,1,240,43,91,0.473,25,34,0.735,18,57,0.316,25,30,0.833,129,41,87,0.471,31,50,0.62,10,37,0.27,20,23,0.87,112
167,SAS,2020-07-31,129,,SAC,1,240,48,90,0.533,37,65,0.569,11,25,0.44,22,27,0.815,129,46,95,0.484,34,57,0.596,12,38,0.316,16,20,0.8,120
168,SAS,2020-03-08,129,@,CLE,0,265,43,98,0.439,33,72,0.458,10,26,0.385,33,36,0.917,129,43,94,0.457,30,60,0.5,13,34,0.382,33,45,0.733,132
169,BRK,2020-03-03,129,@,BOS,1,265,43,100,0.43,29,51,0.569,14,49,0.286,29,38,0.763,129,44,103,0.427,29,54,0.537,15,49,0.306,17,23,0.739,120
170,ATL,2020-02-29,129,,POR,1,240,46,84,0.548,28,42,0.667,18,42,0.429,19,22,0.864,129,47,94,0.5,39,66,0.591,8,28,0.286,15,21,0.714,117
171,UTA,2020-02-28,129,,WAS,1,240,44,89,0.494,25,52,0.481,19,37,0.514,22,30,0.733,129,45,98,0.459,31,61,0.508,14,37,0.378,15,21,0.714,119
172,MIN,2020-02-26,129,@,MIA,1,240,47,91,0.516,30,45,0.667,17,46,0.37,18,25,0.72,129,41,78,0.526,30,52,0.577,11,26,0.423,33,43,0.767,126
173,PHI,2020-02-24,129,,ATL,1,240,45,88,0.511,33,58,0.569,12,30,0.4,27,30,0.9,129,40,97,0.412,32,59,0.542,8,38,0.211,24,27,0.889,112
174,SAC,2020-02-20,129,,MEM,1,240,42,83,0.506,23,44,0.523,19,39,0.487,26,36,0.722,129,43,85,0.506,31,55,0.564,12,30,0.4,27,32,0.844,125
175,ATL,2020-02-20,129,,MIA,1,240,41,85,0.482,25,50,0.5,16,35,0.457,31,35,0.886,129,40,98,0.408,29,61,0.475,11,37,0.297,33,38,0.868,124
176,BRK,2020-02-05,129,,GSW,1,240,51,100,0.51,37,66,0.561,14,34,0.412,13,15,0.867,129,35,96,0.365,30,57,0.526,5,39,0.128,13,18,0.722,88
177,LAL,2020-02-04,129,,SAS,1,240,50,85,0.588,38,57,0.667,12,28,0.429,17,25,0.68,129,40,91,0.44,27,64,0.422,13,27,0.481,9,15,0.6,102
178,TOR,2020-02-02,129,,CHI,1,240,47,84,0.56,31,50,0.62,16,34,0.471,19,23,0.826,129,35,90,0.389,20,42,0.476,15,48,0.313,17,26,0.654,102
179,MIL,2020-02-02,129,,PHO,1,240,48,97,0.495,33,59,0.559,15,38,0.395,18,27,0.667,129,41,104,0.394,35,81,0.432,6,23,0.261,20,23,0.87,108
180,LAL,2020-02-01,129,@,SAC,1,240,44,86,0.512,25,43,0.581,19,43,0.442,22,27,0.815,129,39,91,0.429,25,47,0.532,14,44,0.318,21,26,0.808,113
181,MIN,2020-01-27,129,,SAC,0,265,43,89,0.483,20,43,0.465,23,46,0.5,20,33,0.606,129,44,88,0.5,26,48,0.542,18,40,0.45,27,34,0.794,133
182,IND,2020-01-26,129,@,POR,0,240,48,93,0.516,35,65,0.538,13,28,0.464,20,21,0.952,129,49,90,0.544,29,55,0.527,20,35,0.571,21,25,0.84,139
183,IND,2020-01-24,129,@,GSW,1,240,50,87,0.575,33,59,0.559,17,28,0.607,12,13,0.923,129,40,82,0.488,21,43,0.488,19,39,0.487,19,23,0.826,118
184,WAS,2020-01-22,129,@,MIA,0,265,50,99,0.505,37,57,0.649,13,42,0.31,16,20,0.8,129,43,85,0.506,26,52,0.5,17,33,0.515,31,36,0.861,134
185,UTA,2020-01-22,129,@,GSW,1,240,50,93,0.538,33,53,0.623,17,40,0.425,12,23,0.522,129,35,88,0.398,29,65,0.446,6,23,0.261,20,24,0.833,96
186,POR,2020-01-20,129,,GSW,1,265,44,100,0.44,30,56,0.536,14,44,0.318,27,30,0.9,129,48,116,0.414,39,80,0.488,9,36,0.25,19,22,0.864,124
187,LAL,2020-01-10,129,@,DAL,1,240,47,89,0.528,37,65,0.569,10,24,0.417,25,32,0.781,129,39,96,0.406,28,58,0.483,11,38,0.289,25,37,0.676,114
188,SAS,2020-01-08,129,@,BOS,1,240,48,87,0.552,39,58,0.672,9,29,0.31,24,26,0.923,129,37,89,0.416,24,51,0.471,13,38,0.342,27,30,0.9,114
189,BOS,2019-12-27,129,,CLE,1,240,49,95,0.516,35,55,0.636,14,40,0.35,17,19,0.895,129,44,85,0.518,35,62,0.565,9,23,0.391,20,29,0.69,117
190,MIA,2019-12-20,129,,NYK,1,240,43,77,0.558,25,39,0.641,18,38,0.474,25,34,0.735,129,41,94,0.436,31,60,0.517,10,34,0.294,22,33,0.667,114
191,DEN,2019-12-05,129,@,NYK,1,240,49,87,0.563,28,48,0.583,21,39,0.538,10,18,0.556,129,34,83,0.41,25,49,0.51,9,34,0.265,15,23,0.652,92
192,POR,2019-11-21,129,@,MIL,0,240,50,103,0.485,33,64,0.516,17,39,0.436,12,14,0.857,129,50,106,0.472,34,63,0.54,16,43,0.372,21,26,0.808,137
193,MIN,2019-11-13,129,,SAS,1,240,45,91,0.495,34,57,0.596,11,34,0.324,28,34,0.824,129,44,90,0.489,41,73,0.562,3,17,0.176,23,29,0.793,114
194,MIL,2019-11-06,129,@,LAC,1,240,42,98,0.429,24,49,0.49,18,49,0.367,27,34,0.794,129,41,98,0.418,28,67,0.418,13,31,0.419,29,36,0.806,124
195,HOU,2019-11-06,129,,GSW,1,240,48,97,0.495,27,52,0.519,21,45,0.467,12,19,0.632,129,38,96,0.396,25,63,0.397,13,33,0.394,23,28,0.821,112
196,MIA,2019-11-03,129,,HOU,1,240,47,89,0.528,29,48,0.604,18,41,0.439,17,22,0.773,129,31,79,0.392,17,31,0.548,14,48,0.292,24,31,0.774,100
197,PHI,2019-11-02,129,@,POR,1,240,54,107,0.505,43,74,0.581,11,33,0.333,10,12,0.833,129,45,78,0.577,26,44,0.591,19,34,0.559,19,25,0.76,128
198,MIL,2019-10-28,129,,CLE,1,240,48,92,0.522,31,54,0.574,17,38,0.447,16,24,0.667,129,45,100,0.45,33,61,0.541,12,39,0.308,10,12,0.833,112
199,PHO,2020-08-13,128,,DAL,1,240,49,89,0.551,35,55,0.636,14,34,0.412,16,21,0.762,128,39,89,0.438,31,63,0.492,8,26,0.308,16,19,0.842,102
200,PHO,2020-08-10,128,,OKC,1,240,42,89,0.472,25,55,0.455,17,34,0.5,27,29,0.931,128,35,90,0.389,22,51,0.431,13,39,0.333,18,21,0.857,101
201,BOS,2020-08-02,128,,POR,1,240,42,77,0.545,24,47,0.511,18,30,0.6,26,34,0.765,128,45,90,0.5,26,48,0.542,19,42,0.452,15,16,0.938,124
202,ORL,2020-07-31,128,@,BRK,1,240,46,87,0.529,35,56,0.625,11,31,0.355,25,28,0.893,128,44,91,0.484,31,49,0.633,13,42,0.31,17,23,0.739,118
203,DEN,2020-02-23,128,,MIN,1,240,53,90,0.589,42,60,0.7,11,30,0.367,11,17,0.647,128,40,90,0.444,26,50,0.52,14,40,0.35,22,29,0.759,116
204,NOP,2020-02-21,128,@,POR,1,240,45,84,0.536,27,50,0.54,18,34,0.529,20,33,0.606,128,43,94,0.457,33,67,0.493,10,27,0.37,19,25,0.76,115
205,LAC,2020-02-05,128,,MIA,1,240,45,89,0.506,21,35,0.6,24,54,0.444,14,19,0.737,128,40,93,0.43,24,51,0.471,16,42,0.381,15,21,0.714,111
206,DET,2020-02-02,128,,DEN,1,265,48,94,0.511,34,63,0.54,14,31,0.452,18,24,0.75,128,48,96,0.5,38,64,0.594,10,32,0.313,17,22,0.773,123
207,HOU,2020-01-31,128,,DAL,1,240,45,98,0.459,24,53,0.453,21,45,0.467,17,20,0.85,128,43,90,0.478,29,54,0.537,14,36,0.389,21,27,0.778,121
208,LAL,2020-01-23,128,@,BRK,1,240,47,94,0.5,28,56,0.5,19,38,0.5,15,20,0.75,128,40,91,0.44,19,45,0.422,21,46,0.457,12,15,0.8,113
209,MIL,2020-01-16,128,,BOS,1,240,43,87,0.494,27,56,0.482,16,31,0.516,26,37,0.703,128,43,98,0.439,28,49,0.571,15,49,0.306,22,27,0.815,123
210,LAC,2020-01-14,128,,CLE,1,240,49,94,0.521,34,56,0.607,15,38,0.395,15,21,0.714,128,38,91,0.418,24,54,0.444,14,37,0.378,13,15,0.867,103
211,MIL,2020-01-14,128,,NYK,1,240,45,92,0.489,30,56,0.536,15,36,0.417,23,28,0.821,128,36,102,0.353,25,65,0.385,11,37,0.297,19,26,0.731,102
212,LAL,2020-01-13,128,,CLE,1,240,48,88,0.545,37,58,0.638,11,30,0.367,21,28,0.75,128,38,85,0.447,31,60,0.517,7,25,0.28,16,24,0.667,99
213,UTA,2020-01-08,128,,NYK,1,240,49,90,0.544,33,47,0.702,16,43,0.372,14,23,0.609,128,42,97,0.433,33,72,0.458,9,25,0.36,11,11,1.0,104
214,UTA,2020-01-06,128,@,NOP,1,240,46,90,0.511,30,57,0.526,16,33,0.485,20,24,0.833,128,45,94,0.479,33,63,0.524,12,31,0.387,24,30,0.8,126
215,WAS,2020-01-04,128,,DEN,1,240,50,91,0.549,44,75,0.587,6,16,0.375,22,27,0.815,128,40,87,0.46,34,58,0.586,6,29,0.207,28,34,0.824,114
216,SAC,2020-01-02,128,,MEM,1,240,44,90,0.489,30,56,0.536,14,34,0.412,26,31,0.839,128,45,93,0.484,32,59,0.542,13,34,0.382,20,21,0.952,123
217,LAL,2019-12-28,128,@,POR,1,240,47,91,0.516,36,59,0.61,11,32,0.344,23,28,0.821,128,41,86,0.477,26,51,0.51,15,35,0.429,23,27,0.852,120
218,DEN,2019-12-22,128,@,LAL,1,240,45,92,0.489,34,60,0.567,11,32,0.344,27,30,0.9,128,39,83,0.47,29,54,0.537,10,29,0.345,16,22,0.727,104
219,MEM,2019-12-14,128,,WAS,1,240,48,84,0.571,37,57,0.649,11,27,0.407,21,24,0.875,128,36,85,0.424,22,47,0.468,14,38,0.368,25,32,0.781,111
220,ORL,2019-12-04,128,,PHO,1,240,49,85,0.576,35,60,0.583,14,25,0.56,16,20,0.8,128,43,88,0.489,28,55,0.509,15,33,0.455,13,20,0.65,114
221,UTA,2019-11-23,128,,NOP,1,240,42,82,0.512,27,46,0.587,15,36,0.417,29,33,0.879,128,42,101,0.416,25,60,0.417,17,41,0.415,19,20,0.95,120
222,DET,2019-11-22,128,,ATL,1,240,49,82,0.598,32,48,0.667,17,34,0.5,13,20,0.65,128,38,88,0.432,28,51,0.549,10,37,0.27,17,17,1.0,103
223,PHO,2019-11-14,128,,ATL,1,240,41,85,0.482,26,46,0.565,15,39,0.385,31,38,0.816,128,40,91,0.44,32,60,0.533,8,31,0.258,24,30,0.8,112
224,POR,2019-11-02,128,,PHI,0,240,45,78,0.577,26,44,0.591,19,34,0.559,19,25,0.76,128,54,107,0.505,43,74,0.581,11,33,0.333,10,12,0.833,129
225,NOP,2020-08-13,127,@,ORL,0,240,48,87,0.552,38,53,0.717,10,34,0.294,21,27,0.778,127,48,84,0.571,33,56,0.589,15,28,0.536,22,30,0.733,133
226,IND,2020-08-01,127,,PHI,1,240,48,95,0.505,34,61,0.557,14,34,0.412,17,23,0.739,127,46,93,0.495,37,68,0.544,9,25,0.36,20,25,0.8,121
227,PHO,2020-03-06,127,,POR,1,240,45,91,0.495,26,49,0.531,19,42,0.452,18,19,0.947,127,43,87,0.494,30,55,0.545,13,32,0.406,18,24,0.75,117
228,DAL,2020-03-04,127,,NOP,1,265,44,95,0.463,22,45,0.489,22,50,0.44,17,24,0.708,127,50,114,0.439,33,68,0.485,17,46,0.37,6,11,0.545,123
229,MEM,2020-03-02,127,@,ATL,1,240,46,92,0.5,32,60,0.533,14,32,0.438,21,31,0.677,127,32,99,0.323,23,64,0.359,9,35,0.257,15,16,0.938,88
230,TOR,2020-02-23,127,,IND,1,240,47,92,0.511,30,48,0.625,17,44,0.386,16,18,0.889,127,31,95,0.326,23,62,0.371,8,33,0.242,11,17,0.647,81
231,BOS,2020-02-21,127,@,MIN,1,240,44,95,0.463,34,66,0.515,10,29,0.345,29,37,0.784,127,36,89,0.404,21,47,0.447,15,42,0.357,30,35,0.857,117
232,CLE,2020-02-12,127,,ATL,1,240,48,94,0.511,38,66,0.576,10,28,0.357,21,25,0.84,127,36,84,0.429,23,50,0.46,13,34,0.382,20,25,0.8,105
233,DEN,2020-02-10,127,,SAS,1,240,45,80,0.563,27,45,0.6,18,35,0.514,19,23,0.826,127,41,85,0.482,25,53,0.472,16,32,0.5,22,25,0.88,120
234,PHO,2020-02-07,127,,HOU,1,240,43,77,0.558,28,46,0.609,15,31,0.484,26,27,0.963,127,29,85,0.341,18,37,0.486,11,48,0.229,22,26,0.846,91
235,ATL,2020-02-05,127,@,MIN,1,240,43,82,0.524,30,50,0.6,13,32,0.406,28,30,0.933,127,45,91,0.495,36,56,0.643,9,35,0.257,21,28,0.75,120
236,DEN,2020-02-04,127,,POR,1,240,46,90,0.511,29,56,0.518,17,34,0.5,18,25,0.72,127,36,91,0.396,27,60,0.45,9,31,0.29,18,22,0.818,99
237,DEN,2020-01-31,127,@,MIL,1,240,48,100,0.48,26,54,0.481,22,46,0.478,9,9,1.0,127,43,95,0.453,31,55,0.564,12,40,0.3,17,26,0.654,115
238,POR,2020-01-31,127,@,LAL,1,240,49,97,0.505,36,61,0.59,13,36,0.361,16,21,0.762,127,45,96,0.469,34,64,0.531,11,32,0.344,18,28,0.643,119
239,ATL,2020-01-30,127,,PHI,1,240,42,87,0.483,31,52,0.596,11,35,0.314,32,37,0.865,127,38,82,0.463,29,51,0.569,9,31,0.29,32,45,0.711,117
240,SAS,2020-01-29,127,,UTA,1,240,46,82,0.561,38,51,0.745,8,31,0.258,27,30,0.9,127,37,84,0.44,23,46,0.5,14,38,0.368,32,46,0.696,120
241,MEM,2020-01-29,127,@,NYK,1,240,43,86,0.5,30,58,0.517,13,28,0.464,28,33,0.848,127,39,91,0.429,30,63,0.476,9,28,0.321,19,29,0.655,106
242,DET,2020-01-22,127,,SAC,1,240,39,73,0.534,27,44,0.614,12,29,0.414,37,44,0.841,127,42,98,0.429,32,63,0.508,10,35,0.286,12,23,0.522,106
243,DAL,2020-01-15,127,@,SAC,1,240,47,92,0.511,34,52,0.654,13,40,0.325,20,24,0.833,127,50,96,0.521,38,63,0.603,12,33,0.364,11,20,0.55,123
244,UTA,2020-01-12,127,@,WAS,1,240,48,90,0.533,38,60,0.633,10,30,0.333,21,25,0.84,127,47,93,0.505,40,71,0.563,7,22,0.318,15,17,0.882,116
245,MIL,2020-01-10,127,@,SAC,1,240,47,95,0.495,37,56,0.661,10,39,0.256,23,30,0.767,127,44,96,0.458,34,61,0.557,10,35,0.286,8,10,0.8,106
246,MIL,2020-01-04,127,,SAS,1,240,43,87,0.494,26,42,0.619,17,45,0.378,24,33,0.727,127,38,92,0.413,27,60,0.45,11,32,0.344,31,34,0.912,118
247,NOP,2019-12-29,127,,HOU,1,240,50,102,0.49,32,58,0.552,18,44,0.409,9,13,0.692,127,42,81,0.519,27,42,0.643,15,39,0.385,13,20,0.65,112
248,MIL,2019-12-13,127,@,MEM,1,240,44,87,0.506,33,57,0.579,11,30,0.367,28,33,0.848,127,38,98,0.388,18,49,0.367,20,49,0.408,18,23,0.783,114
249,UTA,2019-12-11,127,@,MIN,1,240,47,83,0.566,31,48,0.646,16,35,0.457,17,22,0.773,127,40,91,0.44,25,50,0.5,15,41,0.366,21,26,0.808,116
250,MIL,2019-12-11,127,,NOP,1,240,50,93,0.538,31,54,0.574,19,39,0.487,8,9,0.889,127,39,88,0.443,23,43,0.535,16,45,0.356,18,22,0.818,112
251,MIN,2019-12-06,127,@,OKC,0,265,50,96,0.521,37,58,0.638,13,38,0.342,14,20,0.7,127,49,88,0.557,44,70,0.629,5,18,0.278,36,40,0.9,139
252,MIL,2019-12-04,127,@,DET,1,240,44,90,0.489,30,55,0.545,14,35,0.4,25,27,0.926,127,39,93,0.419,28,57,0.491,11,36,0.306,14,22,0.636,103
253,POR,2019-12-04,127,,SAC,1,240,47,84,0.56,31,52,0.596,16,32,0.5,17,21,0.81,127,44,95,0.463,33,61,0.541,11,34,0.324,17,23,0.739,116
254,DET,2019-12-03,127,@,CLE,1,240,51,94,0.543,33,59,0.559,18,35,0.514,7,11,0.636,127,38,90,0.422,30,63,0.476,8,27,0.296,10,14,0.714,94
255,ORL,2019-12-03,127,@,WAS,1,240,46,90,0.511,31,59,0.525,15,31,0.484,20,27,0.741,127,45,89,0.506,33,54,0.611,12,35,0.343,18,23,0.783,120
256,OKC,2019-11-22,127,,LAL,0,240,49,93,0.527,38,62,0.613,11,31,0.355,18,20,0.9,127,45,88,0.511,28,57,0.491,17,31,0.548,23,29,0.793,130
257,ATL,2019-11-20,127,,MIL,0,240,44,96,0.458,30,65,0.462,14,31,0.452,25,31,0.806,127,46,87,0.529,29,44,0.659,17,43,0.395,26,34,0.765,135
258,OKC,2019-11-15,127,,PHI,1,265,41,76,0.539,31,52,0.596,10,24,0.417,35,41,0.854,127,45,90,0.5,31,58,0.534,14,32,0.438,15,22,0.682,119
259,LAC,2019-11-14,127,@,NOP,0,240,46,84,0.548,35,60,0.583,11,24,0.458,24,31,0.774,127,47,98,0.48,29,64,0.453,18,34,0.529,20,29,0.69,132
260,GSW,2019-11-04,127,,POR,1,240,42,86,0.488,32,60,0.533,10,26,0.385,33,36,0.917,127,47,105,0.448,34,65,0.523,13,40,0.325,11,14,0.786,118
261,SAS,2019-11-01,127,@,GSW,1,240,44,93,0.473,31,58,0.534,13,35,0.371,26,30,0.867,127,39,84,0.464,26,56,0.464,13,28,0.464,19,21,0.905,110
262,MIN,2019-10-23,127,@,BRK,1,265,46,108,0.426,33,65,0.508,13,43,0.302,22,28,0.786,127,48,101,0.475,33,67,0.493,15,34,0.441,15,26,0.577,126
263,MIL,2020-08-11,126,@,WAS,1,240,44,87,0.506,26,49,0.531,18,38,0.474,20,28,0.714,126,39,95,0.411,27,60,0.45,12,35,0.343,23,30,0.767,113
264,LAC,2020-08-06,126,@,DAL,1,240,50,92,0.543,36,61,0.59,14,31,0.452,12,15,0.8,126,39,87,0.448,22,39,0.564,17,48,0.354,16,21,0.762,111
265,SAS,2020-08-05,126,,DEN,0,240,46,93,0.495,35,63,0.556,11,30,0.367,23,27,0.852,126,50,91,0.549,36,55,0.655,14,36,0.389,18,21,0.857,132
266,LAC,2020-08-01,126,,NOP,1,240,37,87,0.425,12,40,0.3,25,47,0.532,27,35,0.771,126,38,85,0.447,29,55,0.527,9,30,0.3,18,28,0.643,103
267,ORL,2020-03-08,126,@,HOU,1,240,44,91,0.484,31,62,0.5,13,29,0.448,25,31,0.806,126,39,88,0.443,30,56,0.536,9,32,0.281,19,25,0.76,106
268,OKC,2020-03-06,126,@,NYK,1,240,47,96,0.49,35,65,0.538,12,31,0.387,20,25,0.8,126,41,91,0.451,37,67,0.552,4,24,0.167,17,22,0.773,103
269,WAS,2020-03-03,126,@,SAC,0,240,41,80,0.513,25,42,0.595,16,38,0.421,28,34,0.824,126,50,89,0.562,37,60,0.617,13,29,0.448,20,24,0.833,133
270,UTA,2020-03-02,126,@,CLE,1,240,47,83,0.566,27,42,0.643,20,41,0.488,12,14,0.857,126,42,91,0.462,25,50,0.5,17,41,0.415,12,18,0.667,113
271,MIA,2020-02-28,126,,DAL,1,240,41,79,0.519,24,44,0.545,17,35,0.486,27,36,0.75,126,40,84,0.476,19,34,0.559,21,50,0.42,17,19,0.895,118
272,MIA,2020-02-26,126,,MIN,0,240,41,78,0.526,30,52,0.577,11,26,0.423,33,43,0.767,126,47,91,0.516,30,45,0.667,17,46,0.37,18,25,0.72,129
273,CHI,2020-02-23,126,,WAS,1,240,45,81,0.556,27,44,0.614,18,37,0.486,18,28,0.643,126,37,73,0.507,25,43,0.581,12,30,0.4,31,36,0.861,117
274,MIL,2020-02-20,126,@,DET,1,240,47,93,0.505,37,60,0.617,10,33,0.303,22,27,0.815,126,40,83,0.482,27,46,0.587,13,37,0.351,13,16,0.813,106
275,WAS,2020-02-11,126,,CHI,1,240,48,89,0.539,37,57,0.649,11,32,0.344,19,24,0.792,126,44,92,0.478,28,53,0.528,16,39,0.41,10,14,0.714,114
276,MIN,2020-02-10,126,@,TOR,0,240,39,86,0.453,21,46,0.457,18,40,0.45,30,35,0.857,126,51,89,0.573,34,56,0.607,17,33,0.515,18,23,0.783,137
277,ATL,2020-02-10,126,@,ORL,0,240,47,88,0.534,31,51,0.608,16,37,0.432,16,17,0.941,126,50,95,0.526,32,57,0.561,18,38,0.474,17,22,0.773,135
278,HOU,2020-01-27,126,@,UTA,1,240,38,81,0.469,23,41,0.561,15,40,0.375,35,49,0.714,126,43,85,0.506,31,43,0.721,12,42,0.286,19,26,0.731,117
279,NOP,2020-01-20,126,@,MEM,1,240,42,88,0.477,21,40,0.525,21,48,0.438,21,24,0.875,126,46,103,0.447,37,70,0.529,9,33,0.273,15,21,0.714,116
280,NOP,2020-01-06,126,,UTA,0,240,45,94,0.479,33,63,0.524,12,31,0.387,24,30,0.8,126,46,90,0.511,30,57,0.526,16,33,0.485,20,24,0.833,128
281,SAS,2020-01-06,126,,MIL,1,240,45,88,0.511,26,53,0.491,19,35,0.543,17,19,0.895,126,38,95,0.4,23,50,0.46,15,45,0.333,13,14,0.929,104
282,LAC,2020-01-02,126,,DET,1,240,50,92,0.543,39,64,0.609,11,28,0.393,15,21,0.714,126,40,94,0.426,33,61,0.541,7,33,0.212,25,35,0.714,112
283,OKC,2019-12-20,126,,PHO,1,240,49,87,0.563,39,63,0.619,10,24,0.417,18,21,0.857,126,38,87,0.437,27,55,0.491,11,32,0.344,21,23,0.913,108
284,OKC,2019-12-18,126,,MEM,1,240,46,84,0.548,39,60,0.65,7,24,0.292,27,34,0.794,126,50,99,0.505,40,73,0.548,10,26,0.385,12,15,0.8,122
285,UTA,2019-12-07,126,,MEM,1,240,45,80,0.563,26,46,0.565,19,34,0.559,17,18,0.944,126,43,81,0.531,33,46,0.717,10,35,0.286,16,25,0.64,112
286,TOR,2019-11-27,126,,NYK,1,240,46,94,0.489,25,53,0.472,21,41,0.512,13,17,0.765,126,33,88,0.375,21,47,0.447,12,41,0.293,20,24,0.833,98
287,IND,2019-11-25,126,,MEM,1,240,51,94,0.543,33,61,0.541,18,33,0.545,6,10,0.6,126,46,96,0.479,33,67,0.493,13,29,0.448,9,13,0.692,114
288,HOU,2019-10-26,126,,NOP,1,240,43,94,0.457,30,49,0.612,13,45,0.289,27,30,0.9,126,46,100,0.46,28,50,0.56,18,50,0.36,13,16,0.813,123
289,MIL,2019-10-26,126,,MIA,0,265,41,94,0.436,24,40,0.6,17,54,0.315,27,35,0.771,126,46,101,0.455,30,57,0.526,16,44,0.364,23,36,0.639,131
290,BRK,2019-10-23,126,,MIN,0,265,48,101,0.475,33,67,0.493,15,34,0.441,15,26,0.577,126,46,108,0.426,33,65,0.508,13,43,0.302,22,28,0.786,127
291,CHO,2019-10-23,126,,CHI,1,240,45,88,0.511,22,44,0.5,23,44,0.523,13,16,0.813,126,49,105,0.467,40,75,0.533,9,30,0.3,18,22,0.818,125
292,TOR,2020-08-12,125,@,PHI,1,240,40,90,0.444,22,47,0.468,18,43,0.419,27,40,0.675,125,39,84,0.464,22,44,0.5,17,40,0.425,26,33,0.788,121
293,POR,2020-08-06,125,@,DEN,1,240,43,92,0.467,20,53,0.377,23,39,0.59,16,20,0.8,125,44,84,0.524,30,56,0.536,14,28,0.5,13,17,0.765,115
294,NOP,2020-08-06,125,@,SAC,0,240,47,82,0.573,33,48,0.688,14,34,0.412,17,23,0.739,125,50,93,0.538,34,60,0.567,16,33,0.485,24,33,0.727,140
295,MIA,2020-08-01,125,@,DEN,1,240,40,72,0.556,27,43,0.628,13,29,0.448,32,37,0.865,125,39,89,0.438,31,54,0.574,8,35,0.229,19,24,0.792,105
296,PHO,2020-07-31,125,@,WAS,1,240,42,80,0.525,31,48,0.646,11,32,0.344,30,32,0.938,125,42,91,0.462,34,69,0.493,8,22,0.364,20,23,0.87,112
297,PHI,2020-03-05,125,@,SAC,1,240,47,96,0.49,30,59,0.508,17,37,0.459,14,17,0.824,125,42,79,0.532,31,50,0.62,11,29,0.379,13,18,0.722,108
298,POR,2020-03-04,125,,WAS,1,240,42,81,0.519,29,50,0.58,13,31,0.419,28,32,0.875,125,40,103,0.388,29,68,0.426,11,35,0.314,13,21,0.619,104
299,NYK,2020-03-02,125,,HOU,1,240,47,97,0.485,35,67,0.522,12,30,0.4,19,30,0.633,125,39,94,0.415,19,38,0.5,20,56,0.357,25,27,0.926,123
300,NYK,2020-02-29,125,,CHI,1,240,47,85,0.553,39,65,0.6,8,20,0.4,23,33,0.697,125,41,89,0.461,24,54,0.444,17,35,0.486,16,23,0.696,115
301,MIN,2020-02-28,125,@,ORL,0,240,46,95,0.484,29,51,0.569,17,44,0.386,16,24,0.667,125,53,98,0.541,41,58,0.707,12,40,0.3,18,22,0.818,136
302,CLE,2020-02-24,125,,MIA,1,265,43,97,0.443,29,60,0.483,14,37,0.378,25,34,0.735,125,44,96,0.458,28,54,0.519,16,42,0.381,15,20,0.75,119
303,MEM,2020-02-20,125,@,SAC,0,240,43,85,0.506,31,55,0.564,12,30,0.4,27,32,0.844,125,42,83,0.506,23,44,0.523,19,39,0.487,26,36,0.722,129
304,LAL,2020-02-10,125,,PHO,1,240,47,91,0.516,33,54,0.611,14,37,0.378,17,25,0.68,125,32,76,0.421,21,45,0.467,11,31,0.355,25,31,0.806,100
305,LAL,2020-02-08,125,@,GSW,1,240,43,82,0.524,29,53,0.547,14,29,0.483,25,34,0.735,125,46,89,0.517,33,57,0.579,13,32,0.406,15,23,0.652,120
306,POR,2020-02-06,125,,SAS,1,240,49,92,0.533,31,55,0.564,18,37,0.486,9,12,0.75,125,41,92,0.446,31,64,0.484,10,28,0.357,25,28,0.893,117
307,NOP,2020-02-06,125,@,CHI,1,240,49,87,0.563,33,49,0.673,16,38,0.421,11,19,0.579,125,46,93,0.495,33,64,0.516,13,29,0.448,14,23,0.609,119
308,HOU,2020-02-04,125,,CHO,1,240,43,97,0.443,23,37,0.622,20,60,0.333,19,23,0.826,125,39,83,0.47,26,50,0.52,13,33,0.394,19,24,0.792,110
309,GSW,2020-02-03,125,@,WAS,1,240,43,87,0.494,28,57,0.491,15,30,0.5,24,31,0.774,125,42,83,0.506,33,61,0.541,9,22,0.409,24,29,0.828,117
310,POR,2020-01-29,125,,HOU,1,240,46,89,0.517,33,53,0.623,13,36,0.361,20,27,0.741,125,40,94,0.426,23,47,0.489,17,47,0.362,15,18,0.833,112
311,BRK,2020-01-29,125,,DET,1,240,43,85,0.506,28,46,0.609,15,39,0.385,24,30,0.8,125,42,83,0.506,32,57,0.561,10,26,0.385,21,28,0.75,115
312,NOP,2020-01-28,125,@,CLE,1,240,47,88,0.534,34,54,0.63,13,34,0.382,18,24,0.75,125,42,97,0.433,31,63,0.492,11,34,0.324,16,18,0.889,111
313,MEM,2020-01-24,125,@,DET,1,240,43,79,0.544,32,57,0.561,11,22,0.5,28,31,0.903,125,39,91,0.429,28,59,0.475,11,32,0.344,23,31,0.742,112
314,POR,2020-01-23,125,,DAL,0,240,46,91,0.505,25,52,0.481,21,39,0.538,12,15,0.8,125,48,93,0.516,26,46,0.565,22,47,0.468,15,24,0.625,133
315,LAL,2020-01-11,125,@,OKC,1,240,51,99,0.515,36,67,0.537,15,32,0.469,8,10,0.8,125,43,92,0.467,34,61,0.557,9,31,0.29,15,17,0.882,110
316,PHI,2019-12-23,125,@,DET,1,240,52,95,0.547,40,65,0.615,12,30,0.4,9,11,0.818,125,43,84,0.512,33,54,0.611,10,30,0.333,13,18,0.722,109
317,PHO,2019-12-21,125,,HOU,0,240,47,91,0.516,39,63,0.619,8,28,0.286,23,30,0.767,125,51,87,0.586,32,46,0.696,19,41,0.463,18,23,0.783,139
318,PHI,2019-12-21,125,,WAS,1,240,49,94,0.521,35,61,0.574,14,33,0.424,13,21,0.619,125,36,88,0.409,29,57,0.509,7,31,0.226,29,34,0.853,108
319,MIL,2019-12-14,125,,CLE,1,240,46,85,0.541,32,48,0.667,14,37,0.378,19,26,0.731,125,41,90,0.456,26,55,0.473,15,35,0.429,11,15,0.733,108
320,PHO,2019-12-09,125,,MIN,1,240,47,95,0.495,31,55,0.564,16,40,0.4,15,19,0.789,125,40,85,0.471,34,63,0.54,6,22,0.273,23,29,0.793,109
321,MIN,2019-12-08,125,@,LAL,0,240,44,84,0.524,29,47,0.617,15,37,0.405,22,26,0.846,125,55,94,0.585,41,63,0.651,14,31,0.452,18,20,0.9,142
322,WAS,2019-12-01,125,@,LAC,0,240,47,102,0.461,36,72,0.5,11,30,0.367,20,27,0.741,125,52,94,0.553,38,62,0.613,14,32,0.438,32,40,0.8,150
323,LAL,2019-11-29,125,,WAS,1,240,45,87,0.517,31,55,0.564,14,32,0.438,21,28,0.75,125,38,96,0.396,28,59,0.475,10,37,0.27,17,19,0.895,103
324,MIN,2019-11-25,125,@,ATL,1,240,41,90,0.456,26,55,0.473,15,35,0.429,28,36,0.778,125,41,94,0.436,31,62,0.5,10,32,0.313,21,26,0.808,113
325,WAS,2019-11-22,125,,CHO,1,240,48,91,0.527,34,57,0.596,14,34,0.412,15,20,0.75,125,48,93,0.516,34,59,0.576,14,34,0.412,8,8,1.0,118
326,ORL,2019-11-17,125,,WAS,1,240,43,87,0.494,28,49,0.571,15,38,0.395,24,26,0.923,125,46,97,0.474,27,56,0.482,19,41,0.463,10,12,0.833,121
327,HOU,2019-11-16,125,@,MIN,1,240,43,94,0.457,24,45,0.533,19,49,0.388,20,22,0.909,125,38,84,0.452,26,46,0.565,12,38,0.316,17,23,0.739,105
328,ATL,2019-11-12,125,@,DEN,1,240,44,83,0.53,29,49,0.592,15,34,0.441,22,34,0.647,125,46,104,0.442,35,63,0.556,11,41,0.268,18,22,0.818,121
329,MIN,2019-11-08,125,,GSW,1,265,48,111,0.432,39,75,0.52,9,36,0.25,20,29,0.69,125,43,103,0.417,33,68,0.485,10,35,0.286,23,24,0.958,119
330,NOP,2019-11-04,125,@,BRK,0,240,48,97,0.495,35,65,0.538,13,32,0.406,16,21,0.762,125,49,92,0.533,33,51,0.647,16,41,0.39,21,28,0.75,135
331,TOR,2019-10-30,125,,DET,1,240,51,86,0.593,38,59,0.644,13,27,0.481,10,12,0.833,125,41,88,0.466,27,58,0.466,14,30,0.467,17,23,0.739,113
332,CHI,2019-10-23,125,@,CHO,0,240,49,105,0.467,40,75,0.533,9,30,0.3,18,22,0.818,125,45,88,0.511,22,44,0.5,23,44,0.523,13,16,0.813,126
333,LAC,2020-08-12,124,@,DEN,1,240,46,85,0.541,32,48,0.667,14,37,0.378,18,23,0.783,124,43,87,0.494,30,52,0.577,13,35,0.371,12,19,0.632,111
334,LAL,2020-08-10,124,,DEN,1,240,44,81,0.543,30,52,0.577,14,29,0.483,22,32,0.688,124,45,77,0.584,32,54,0.593,13,23,0.565,18,23,0.783,121
335,POR,2020-08-09,124,,PHI,1,240,43,91,0.473,32,56,0.571,11,35,0.314,27,29,0.931,124,47,97,0.485,33,67,0.493,14,30,0.467,13,17,0.765,121
336,UTA,2020-08-05,124,,MEM,1,240,38,84,0.452,20,39,0.513,18,45,0.4,30,33,0.909,124,43,91,0.473,32,62,0.516,11,29,0.379,18,25,0.72,115
337,POR,2020-08-02,124,@,BOS,0,240,45,90,0.5,26,48,0.542,19,42,0.452,15,16,0.938,124,42,77,0.545,24,47,0.511,18,30,0.6,26,34,0.765,128
338,PHI,2020-03-11,124,,DET,1,240,42,83,0.506,28,50,0.56,14,33,0.424,26,32,0.813,124,39,84,0.464,28,49,0.571,11,35,0.314,17,25,0.68,106
339,WAS,2020-03-01,124,@,GSW,1,240,40,82,0.488,20,52,0.385,20,30,0.667,24,27,0.889,124,42,89,0.472,33,61,0.541,9,28,0.321,17,24,0.708,110
340,OKC,2020-02-25,124,@,CHI,1,240,42,76,0.553,28,46,0.609,14,30,0.467,26,35,0.743,124,52,97,0.536,40,66,0.606,12,31,0.387,6,9,0.667,122
341,LAC,2020-02-24,124,,MEM,1,240,47,94,0.5,31,57,0.544,16,37,0.432,14,17,0.824,124,37,89,0.416,30,62,0.484,7,27,0.259,16,22,0.727,97
342,MIA,2020-02-22,124,,CLE,1,240,45,79,0.57,26,39,0.667,19,40,0.475,15,20,0.75,124,38,79,0.481,25,43,0.581,13,36,0.361,16,22,0.727,105
343,MIA,2020-02-20,124,@,ATL,0,240,40,98,0.408,29,61,0.475,11,37,0.297,33,38,0.868,124,41,85,0.482,25,50,0.5,16,35,0.457,31,35,0.886,129
344,NOP,2020-02-08,124,@,IND,1,240,44,95,0.463,29,57,0.509,15,38,0.395,21,25,0.84,124,44,83,0.53,35,57,0.614,9,26,0.346,20,27,0.741,117
345,POR,2020-02-01,124,,UTA,1,240,47,92,0.511,32,63,0.508,15,29,0.517,15,18,0.833,124,40,94,0.426,22,53,0.415,18,41,0.439,9,9,1.0,107
346,SAC,2020-01-30,124,@,LAC,1,240,44,88,0.5,23,47,0.489,21,41,0.512,15,18,0.833,124,35,92,0.38,22,61,0.361,13,31,0.419,20,25,0.8,103
347,MIN,2020-01-24,124,,HOU,0,240,48,98,0.49,37,66,0.561,11,32,0.344,17,20,0.85,124,47,91,0.516,36,59,0.61,11,32,0.344,26,31,0.839,131
348,WAS,2020-01-23,124,@,CLE,1,240,47,85,0.553,31,49,0.633,16,36,0.444,14,18,0.778,124,44,96,0.458,33,63,0.524,11,33,0.333,13,17,0.765,112
349,GSW,2020-01-20,124,@,POR,0,265,48,116,0.414,39,80,0.488,9,36,0.25,19,22,0.864,124,44,100,0.44,30,56,0.536,14,44,0.318,27,30,0.9,129
350,LAL,2020-01-18,124,@,HOU,1,240,45,93,0.484,34,60,0.567,11,33,0.333,23,32,0.719,124,40,90,0.444,28,53,0.528,12,37,0.324,23,29,0.793,115
351,DAL,2020-01-14,124,@,GSW,1,240,49,96,0.51,36,59,0.61,13,37,0.351,13,21,0.619,124,39,87,0.448,30,55,0.545,9,32,0.281,10,13,0.769,97
352,NYK,2020-01-12,124,,MIA,1,240,46,90,0.511,37,59,0.627,9,31,0.29,23,28,0.821,124,42,78,0.538,28,43,0.651,14,35,0.4,23,28,0.821,121
353,DEN,2020-01-02,124,@,IND,1,240,46,87,0.529,38,60,0.633,8,27,0.296,24,27,0.889,124,43,82,0.524,31,56,0.554,12,26,0.462,18,25,0.72,116
354,LAC,2019-12-13,124,@,MIN,1,240,39,79,0.494,28,54,0.519,11,25,0.44,35,39,0.897,124,38,85,0.447,28,44,0.636,10,41,0.244,31,37,0.838,117
355,NYK,2019-12-11,124,@,GSW,1,265,43,90,0.478,31,61,0.508,12,29,0.414,26,34,0.765,124,45,104,0.433,35,67,0.522,10,37,0.27,22,30,0.733,122
356,NOP,2019-11-21,124,@,PHO,1,240,47,88,0.534,31,53,0.585,16,35,0.457,14,22,0.636,124,40,86,0.465,27,55,0.491,13,31,0.419,28,32,0.875,121
357,MIA,2019-11-20,124,,CLE,1,240,41,78,0.526,22,41,0.537,19,37,0.514,23,31,0.742,124,37,87,0.425,25,49,0.51,12,38,0.316,14,16,0.875,100
358,MIL,2019-11-14,124,,CHI,1,240,42,88,0.477,36,55,0.655,6,33,0.182,34,47,0.723,124,38,93,0.409,20,50,0.4,18,43,0.419,21,25,0.84,115
359,POR,2019-11-10,124,,ATL,1,265,45,104,0.433,33,68,0.485,12,36,0.333,22,28,0.786,124,42,104,0.404,31,63,0.492,11,41,0.268,18,25,0.72,113
360,MIA,2019-11-07,124,@,PHO,1,240,45,82,0.549,30,54,0.556,15,28,0.536,19,24,0.792,124,37,84,0.44,26,52,0.5,11,32,0.344,23,31,0.742,108
361,TOR,2019-11-06,124,,SAC,1,240,43,78,0.551,29,49,0.592,14,29,0.483,24,29,0.828,124,42,95,0.442,22,51,0.431,20,44,0.455,16,21,0.762,120
362,LAC,2019-11-06,124,,MIL,0,240,41,98,0.418,28,67,0.418,13,31,0.419,29,36,0.806,124,42,98,0.429,24,49,0.49,18,49,0.367,27,34,0.794,129
363,SAS,2019-10-26,124,,WAS,1,240,50,108,0.463,40,80,0.5,10,28,0.357,14,17,0.824,124,47,95,0.495,31,61,0.508,16,34,0.471,12,17,0.706,122
364,PHO,2019-10-23,124,,SAC,1,240,49,98,0.5,38,65,0.585,11,33,0.333,15,18,0.833,124,34,87,0.391,24,58,0.414,10,29,0.345,17,26,0.654,95
365,SAS,2020-08-11,123,,HOU,1,240,46,93,0.495,33,61,0.541,13,32,0.406,18,20,0.9,123,36,89,0.404,22,41,0.537,14,48,0.292,19,21,0.905,105
366,SAC,2020-03-07,123,@,POR,1,240,41,85,0.482,20,46,0.435,21,39,0.538,20,23,0.87,123,42,89,0.472,32,50,0.64,10,39,0.256,17,26,0.654,111
367,NOP,2020-03-04,123,@,DAL,0,265,50,114,0.439,33,68,0.485,17,46,0.37,6,11,0.545,123,44,95,0.463,22,45,0.489,22,50,0.44,17,24,0.708,127
368,TOR,2020-03-03,123,@,PHO,1,240,40,86,0.465,26,52,0.5,14,34,0.412,29,35,0.829,123,39,85,0.459,24,46,0.522,15,39,0.385,21,25,0.84,114
369,HOU,2020-03-02,123,@,NYK,0,240,39,94,0.415,19,38,0.5,20,56,0.357,25,27,0.926,123,47,97,0.485,35,67,0.522,12,30,0.4,19,30,0.633,125
370,HOU,2020-02-24,123,,NYK,1,240,43,86,0.5,27,38,0.711,16,48,0.333,21,31,0.677,123,40,91,0.44,29,62,0.468,11,29,0.379,21,30,0.7,112
371,MIN,2020-02-24,123,@,DAL,0,240,42,95,0.442,27,53,0.509,15,42,0.357,24,34,0.706,123,51,101,0.505,35,57,0.614,16,44,0.364,21,28,0.75,139
372,OKC,2020-02-13,123,@,NOP,1,240,46,92,0.5,33,65,0.508,13,27,0.481,18,22,0.818,123,42,86,0.488,28,51,0.549,14,35,0.4,20,27,0.741,118
373,UTA,2020-02-10,123,@,DAL,1,240,46,78,0.59,31,43,0.721,15,35,0.429,16,21,0.762,123,39,83,0.47,24,40,0.6,15,43,0.349,26,31,0.839,119
374,MIL,2020-02-10,123,,SAC,1,240,43,96,0.448,25,54,0.463,18,42,0.429,19,23,0.826,123,42,101,0.416,28,58,0.483,14,43,0.326,13,18,0.722,111
375,BOS,2020-02-03,123,@,ATL,1,240,48,90,0.533,36,61,0.59,12,29,0.414,15,17,0.882,123,42,84,0.5,30,54,0.556,12,30,0.4,19,21,0.905,115
376,DEN,2020-02-02,123,@,DET,0,265,48,96,0.5,38,64,0.594,10,32,0.313,17,22,0.773,123,48,94,0.511,34,63,0.54,14,31,0.452,18,24,0.75,128
377,DAL,2020-02-01,123,,ATL,1,240,44,94,0.468,24,55,0.436,20,39,0.513,15,16,0.938,123,37,91,0.407,27,58,0.466,10,33,0.303,16,21,0.762,100
378,NOP,2020-01-26,123,,BOS,1,240,44,92,0.478,28,56,0.5,16,36,0.444,19,29,0.655,123,41,89,0.461,33,56,0.589,8,33,0.242,18,22,0.818,108
379,PHO,2020-01-18,123,@,BOS,1,240,42,89,0.472,29,58,0.5,13,31,0.419,26,30,0.867,123,42,96,0.438,27,54,0.5,15,42,0.357,20,22,0.909,119
380,UTA,2020-01-18,123,,SAC,1,240,43,85,0.506,29,43,0.674,14,42,0.333,23,24,0.958,123,42,86,0.488,32,60,0.533,10,26,0.385,7,12,0.583,101
381,BOS,2020-01-16,123,@,MIL,0,240,43,98,0.439,28,49,0.571,15,49,0.306,22,27,0.815,123,43,87,0.494,27,56,0.482,16,31,0.516,26,37,0.703,128
382,SAC,2020-01-15,123,,DAL,0,240,50,96,0.521,38,63,0.603,12,33,0.364,11,20,0.55,123,47,92,0.511,34,52,0.654,13,40,0.325,20,24,0.833,127
383,ATL,2020-01-14,123,,PHO,1,240,46,93,0.495,32,62,0.516,14,31,0.452,17,20,0.85,123,40,87,0.46,36,67,0.537,4,20,0.2,26,32,0.813,110
384,NOP,2020-01-10,123,@,NYK,1,240,48,86,0.558,30,48,0.625,18,38,0.474,9,17,0.529,123,46,100,0.46,41,73,0.562,5,27,0.185,14,20,0.7,111
385,ORL,2020-01-08,123,,WAS,1,240,43,87,0.494,33,60,0.55,10,27,0.37,27,34,0.794,123,36,84,0.429,30,61,0.492,6,23,0.261,11,19,0.579,89
386,NOP,2020-01-08,123,,CHI,1,240,41,87,0.471,26,43,0.605,15,44,0.341,26,32,0.813,123,41,92,0.446,27,57,0.474,14,35,0.4,12,21,0.571,108
387,DEN,2020-01-06,123,@,ATL,1,240,47,92,0.511,38,65,0.585,9,27,0.333,20,27,0.741,123,35,77,0.455,17,38,0.447,18,39,0.462,27,32,0.844,115
388,CHO,2020-01-04,123,@,DAL,1,265,42,85,0.494,31,60,0.517,11,25,0.44,28,31,0.903,123,47,100,0.47,32,50,0.64,15,50,0.3,11,13,0.846,120
389,LAL,2020-01-03,123,,NOP,1,240,43,86,0.5,29,57,0.509,14,29,0.483,23,28,0.821,123,48,102,0.471,37,65,0.569,11,37,0.297,6,7,0.857,113
390,DAL,2020-01-02,123,,BRK,1,240,45,89,0.506,27,51,0.529,18,38,0.474,15,17,0.882,123,42,91,0.462,30,54,0.556,12,37,0.324,15,17,0.882,111
391,MEM,2020-01-02,123,@,SAC,0,240,45,93,0.484,32,59,0.542,13,34,0.382,20,21,0.952,123,44,90,0.489,30,56,0.536,14,34,0.412,26,31,0.839,128
392,WAS,2019-12-30,123,,MIA,1,240,43,84,0.512,26,47,0.553,17,37,0.459,20,30,0.667,123,33,73,0.452,23,45,0.511,10,28,0.357,29,39,0.744,105
393,MIL,2019-12-30,123,@,CHI,1,240,46,84,0.548,35,52,0.673,11,32,0.344,20,24,0.833,123,40,107,0.374,23,63,0.365,17,44,0.386,5,8,0.625,102
394,MIL,2019-12-21,123,@,NYK,1,240,41,85,0.482,23,42,0.548,18,43,0.419,23,35,0.657,123,39,97,0.402,30,67,0.448,9,30,0.3,15,21,0.714,102
395,HOU,2019-11-24,123,,DAL,0,240,45,98,0.459,35,54,0.648,10,44,0.227,23,31,0.742,123,49,102,0.48,32,58,0.552,17,44,0.386,22,28,0.786,137
396,NYK,2019-11-18,123,,CLE,1,240,44,98,0.449,36,75,0.48,8,23,0.348,27,35,0.771,123,36,76,0.474,19,40,0.475,17,36,0.472,16,30,0.533,105
397,LAL,2019-11-12,123,@,PHO,1,240,51,95,0.537,41,70,0.586,10,25,0.4,11,21,0.524,123,43,91,0.473,27,53,0.509,16,38,0.421,13,17,0.765,115
398,BRK,2019-11-01,123,,HOU,1,240,42,85,0.494,23,53,0.434,19,32,0.594,20,28,0.714,123,41,99,0.414,29,51,0.569,12,48,0.25,22,27,0.815,116
399,MIL,2019-11-01,123,@,ORL,1,240,47,93,0.505,30,46,0.652,17,47,0.362,12,18,0.667,123,34,91,0.374,22,54,0.407,12,37,0.324,11,17,0.647,91
400,NOP,2019-10-28,123,,GSW,0,240,48,103,0.466,33,56,0.589,15,47,0.319,12,22,0.545,123,51,104,0.49,37,69,0.536,14,35,0.4,18,24,0.75,134
401,NOP,2019-10-26,123,@,HOU,0,240,46,100,0.46,28,50,0.56,18,50,0.36,13,16,0.813,123,43,94,0.457,30,49,0.612,13,45,0.289,27,30,0.9,126
402,DAL,2019-10-25,123,@,NOP,1,240,45,93,0.484,31,53,0.585,14,40,0.35,19,26,0.731,123,45,98,0.459,30,57,0.526,15,41,0.366,11,15,0.733,116
403,LAL,2020-08-13,122,,SAC,0,240,48,98,0.49,33,63,0.524,15,35,0.429,11,15,0.733,122,54,95,0.568,33,48,0.688,21,47,0.447,7,12,0.583,136
404,BOS,2020-08-11,122,@,MEM,1,240,44,86,0.512,28,49,0.571,16,37,0.432,18,23,0.783,122,35,89,0.393,28,60,0.467,7,29,0.241,30,38,0.789,107
405,DAL,2020-08-10,122,@,UTA,1,240,48,85,0.565,36,61,0.59,12,24,0.5,14,16,0.875,122,39,82,0.476,18,36,0.5,21,46,0.457,15,20,0.75,114
406,BOS,2020-08-09,122,,ORL,1,265,45,102,0.441,33,62,0.532,12,40,0.3,20,24,0.833,122,41,102,0.402,26,55,0.473,15,47,0.319,22,26,0.846,119
407,SAS,2020-08-09,122,@,NOP,1,240,40,89,0.449,29,61,0.475,11,28,0.393,31,32,0.969,122,42,96,0.438,30,66,0.455,12,30,0.4,17,22,0.773,113
408,LAC,2020-08-08,122,@,POR,1,240,42,85,0.494,27,51,0.529,15,34,0.441,23,28,0.821,122,44,90,0.489,27,47,0.574,17,43,0.395,12,17,0.706,117
409,BOS,2020-08-07,122,@,TOR,1,240,47,96,0.49,31,50,0.62,16,46,0.348,12,16,0.75,122,38,89,0.427,28,51,0.549,10,38,0.263,14,17,0.824,100
410,WAS,2020-03-10,122,,NYK,1,240,35,74,0.473,21,39,0.538,14,35,0.4,38,45,0.844,122,42,81,0.519,34,60,0.567,8,21,0.381,23,31,0.742,115
411,LAL,2020-03-01,122,@,NOP,1,240,50,97,0.515,37,62,0.597,13,35,0.371,9,10,0.9,122,40,95,0.421,33,63,0.524,7,32,0.219,27,33,0.818,114
412,CHI,2020-02-25,122,,OKC,0,240,52,97,0.536,40,66,0.606,12,31,0.387,6,9,0.667,122,42,76,0.553,28,46,0.609,14,30,0.467,26,35,0.743,124
413,DAL,2020-02-21,122,@,ORL,1,240,43,84,0.512,28,46,0.609,15,38,0.395,21,26,0.808,122,41,104,0.394,32,61,0.525,9,43,0.209,15,19,0.789,106
414,SAC,2020-02-08,122,,SAS,1,240,45,86,0.523,26,51,0.51,19,35,0.543,13,20,0.65,122,41,81,0.506,34,57,0.596,7,24,0.292,13,18,0.722,102
415,LAC,2020-01-24,122,@,MIA,1,240,43,94,0.457,27,59,0.458,16,35,0.457,20,23,0.87,122,40,93,0.43,27,49,0.551,13,44,0.295,24,29,0.828,117
416,TOR,2020-01-20,122,@,ATL,1,240,38,92,0.413,25,50,0.5,13,42,0.31,33,43,0.767,122,41,83,0.494,29,50,0.58,12,33,0.364,23,33,0.697,117
417,TOR,2020-01-18,122,@,MIN,1,240,47,91,0.516,34,56,0.607,13,35,0.371,15,17,0.882,122,38,94,0.404,24,44,0.545,14,50,0.28,22,27,0.815,112
418,LAC,2020-01-16,122,,ORL,1,240,47,95,0.495,33,63,0.524,14,32,0.438,14,20,0.7,122,36,92,0.391,22,50,0.44,14,42,0.333,9,16,0.563,95
419,MEM,2020-01-12,122,,GSW,1,240,45,100,0.45,34,65,0.523,11,35,0.314,21,25,0.84,122,35,92,0.38,18,58,0.31,17,34,0.5,15,21,0.714,102
420,MIL,2020-01-11,122,@,POR,1,240,47,103,0.456,33,65,0.508,14,38,0.368,14,20,0.7,122,37,95,0.389,27,59,0.458,10,36,0.278,17,21,0.81,101
421,MIA,2020-01-08,122,@,IND,1,240,43,81,0.531,27,43,0.628,16,38,0.421,20,25,0.8,122,40,84,0.476,31,57,0.544,9,27,0.333,19,25,0.76,108
422,HOU,2020-01-08,122,@,ATL,1,240,39,92,0.424,26,47,0.553,13,45,0.289,31,41,0.756,122,39,106,0.368,26,62,0.419,13,44,0.295,24,27,0.889,115
423,MIA,2020-01-05,122,,POR,1,240,47,90,0.522,29,46,0.63,18,44,0.409,10,16,0.625,122,40,87,0.46,27,50,0.54,13,37,0.351,18,20,0.9,111
424,POR,2020-01-03,122,@,WAS,1,240,45,88,0.511,39,63,0.619,6,25,0.24,26,33,0.788,122,38,90,0.422,27,57,0.474,11,33,0.333,16,25,0.64,103
425,ORL,2020-01-01,122,@,WAS,1,240,45,95,0.474,33,63,0.524,12,32,0.375,20,27,0.741,122,33,87,0.379,24,56,0.429,9,31,0.29,26,31,0.839,101
426,MIN,2019-12-30,122,,BRK,1,265,42,104,0.404,25,60,0.417,17,44,0.386,21,29,0.724,122,40,99,0.404,25,58,0.431,15,41,0.366,20,27,0.741,115
427,PHO,2019-12-30,122,@,POR,1,240,44,92,0.478,31,69,0.449,13,23,0.565,21,22,0.955,122,44,96,0.458,30,62,0.484,14,34,0.412,14,18,0.778,116
428,BRK,2019-12-21,122,,ATL,1,240,46,100,0.46,35,70,0.5,11,30,0.367,19,28,0.679,122,39,105,0.371,28,57,0.491,11,48,0.229,23,27,0.852,112
429,TOR,2019-12-20,122,,WAS,1,240,38,78,0.487,26,48,0.542,12,30,0.4,34,44,0.773,122,40,87,0.46,26,48,0.542,14,39,0.359,24,32,0.75,118
430,HOU,2019-12-19,122,@,LAC,1,240,43,86,0.5,29,49,0.592,14,37,0.378,22,29,0.759,122,43,86,0.5,27,49,0.551,16,37,0.432,15,19,0.789,117
431,POR,2019-12-18,122,,GSW,1,240,44,97,0.454,35,66,0.53,9,31,0.29,25,28,0.893,122,41,103,0.398,25,65,0.385,16,38,0.421,14,23,0.609,112
432,MEM,2019-12-18,122,@,OKC,0,240,50,99,0.505,40,73,0.548,10,26,0.385,12,15,0.8,122,46,84,0.548,39,60,0.65,7,24,0.292,27,34,0.794,126
433,MIA,2019-12-14,122,@,DAL,1,265,39,91,0.429,23,51,0.451,16,40,0.4,28,34,0.824,122,45,101,0.446,28,57,0.491,17,44,0.386,11,17,0.647,118
434,DAL,2019-12-12,122,@,DET,1,240,45,88,0.511,29,44,0.659,16,44,0.364,16,23,0.696,122,40,89,0.449,25,47,0.532,15,42,0.357,16,23,0.696,111
435,GSW,2019-12-11,122,,NYK,0,265,45,104,0.433,35,67,0.522,10,37,0.27,22,30,0.733,122,43,90,0.478,31,61,0.508,12,29,0.414,26,34,0.765,124
436,IND,2019-12-11,122,,BOS,1,240,41,85,0.482,31,60,0.517,10,25,0.4,30,36,0.833,122,43,87,0.494,29,51,0.569,14,36,0.389,17,22,0.773,117
437,ATL,2019-12-08,122,@,CHO,1,240,44,91,0.484,26,46,0.565,18,45,0.4,16,17,0.941,122,36,90,0.4,25,59,0.424,11,31,0.355,24,29,0.828,107
438,MIA,2019-11-29,122,,GSW,1,240,44,82,0.537,31,57,0.544,13,25,0.52,21,28,0.75,122,30,77,0.39,20,49,0.408,10,28,0.357,35,40,0.875,105
439,MIL,2019-11-25,122,,UTA,1,240,43,97,0.443,30,56,0.536,13,41,0.317,23,29,0.793,122,43,85,0.506,22,40,0.55,21,45,0.467,11,12,0.917,118
440,LAC,2019-11-22,122,,HOU,1,240,45,87,0.517,32,54,0.593,13,33,0.394,19,24,0.792,122,39,84,0.464,24,41,0.585,15,43,0.349,26,38,0.684,119
441,LAL,2019-11-17,122,,ATL,1,240,47,89,0.528,32,54,0.593,15,35,0.429,13,16,0.813,122,37,86,0.43,29,58,0.5,8,28,0.286,19,25,0.76,101
442,UTA,2019-11-11,122,@,GSW,1,240,40,81,0.494,24,46,0.522,16,35,0.457,26,32,0.813,122,45,94,0.479,35,63,0.556,10,31,0.323,8,14,0.571,108
443,HOU,2019-11-11,122,@,NOP,1,240,44,85,0.518,32,44,0.727,12,41,0.293,22,32,0.688,122,41,95,0.432,27,50,0.54,14,45,0.311,20,27,0.741,116
444,MEM,2019-11-09,122,,DAL,0,240,50,95,0.526,38,59,0.644,12,36,0.333,10,14,0.714,122,52,97,0.536,34,55,0.618,18,42,0.429,16,20,0.8,138
445,TOR,2019-11-08,122,@,NOP,1,240,41,93,0.441,22,50,0.44,19,43,0.442,21,24,0.875,122,40,99,0.404,30,58,0.517,10,41,0.244,14,21,0.667,104
446,DET,2019-11-06,122,,NYK,1,240,44,79,0.557,29,49,0.592,15,30,0.5,19,24,0.792,122,39,80,0.488,28,55,0.509,11,25,0.44,13,21,0.619,102
447,CHO,2019-11-05,122,,IND,1,265,42,88,0.477,32,57,0.561,10,31,0.323,28,42,0.667,122,51,94,0.543,39,64,0.609,12,30,0.4,6,7,0.857,120
448,NOP,2019-10-31,122,,DEN,1,240,41,77,0.532,26,44,0.591,15,33,0.455,25,32,0.781,122,43,89,0.483,36,63,0.571,7,26,0.269,14,16,0.875,107
449,WAS,2019-10-26,122,@,SAS,0,240,47,95,0.495,31,61,0.508,16,34,0.471,12,17,0.706,122,50,108,0.463,40,80,0.5,10,28,0.357,14,17,0.824,124
450,LAC,2019-10-26,122,@,PHO,0,240,40,87,0.46,29,55,0.527,11,32,0.344,31,39,0.795,122,43,86,0.5,26,43,0.605,17,43,0.395,27,34,0.794,130
451,POR,2019-10-25,122,@,SAC,1,240,46,85,0.541,35,55,0.636,11,30,0.367,19,22,0.864,122,37,87,0.425,22,50,0.44,15,37,0.405,23,27,0.852,112
452,GSW,2019-10-24,122,,LAC,0,240,39,99,0.394,24,57,0.421,15,42,0.357,29,30,0.967,122,50,80,0.625,32,48,0.667,18,32,0.563,23,30,0.767,141
453,NOP,2019-10-22,122,@,TOR,0,265,43,102,0.422,24,57,0.421,19,45,0.422,17,20,0.85,122,42,103,0.408,28,63,0.444,14,40,0.35,32,38,0.842,130
454,PHI,2020-08-12,121,,TOR,0,240,39,84,0.464,22,44,0.5,17,40,0.425,26,33,0.788,121,40,90,0.444,22,47,0.468,18,43,0.419,27,40,0.675,125
455,DEN,2020-08-10,121,@,LAL,0,240,45,77,0.584,32,54,0.593,13,23,0.565,18,23,0.783,121,44,81,0.543,30,52,0.577,14,29,0.483,22,32,0.688,124
456,PHI,2020-08-09,121,@,POR,0,240,47,97,0.485,33,67,0.493,14,30,0.467,13,17,0.765,121,43,91,0.473,32,56,0.571,11,35,0.314,27,29,0.931,124
457,OKC,2020-08-09,121,,WAS,1,240,43,84,0.512,25,45,0.556,18,39,0.462,17,22,0.773,121,38,92,0.413,29,56,0.518,9,36,0.25,18,22,0.818,103
458,MEM,2020-08-07,121,,OKC,1,240,46,83,0.554,35,52,0.673,11,31,0.355,18,20,0.9,121,34,97,0.351,21,54,0.389,13,43,0.302,11,15,0.733,92
459,DEN,2020-08-03,121,@,OKC,1,265,42,87,0.483,35,62,0.565,7,25,0.28,30,39,0.769,121,37,87,0.425,22,51,0.431,15,36,0.417,24,31,0.774,113
460,PHI,2020-08-01,121,@,IND,0,240,46,93,0.495,37,68,0.544,9,25,0.36,20,25,0.8,121,48,95,0.505,34,61,0.557,14,34,0.412,17,23,0.739,127
461,POR,2020-03-10,121,,PHO,1,240,45,89,0.506,28,54,0.519,17,35,0.486,14,17,0.824,121,35,87,0.402,24,55,0.436,11,32,0.344,24,25,0.96,105
462,DAL,2020-03-06,121,,MEM,1,240,45,95,0.474,27,48,0.563,18,47,0.383,13,17,0.765,121,39,84,0.464,30,54,0.556,9,30,0.3,9,13,0.692,96
463,TOR,2020-03-05,121,@,GSW,1,240,40,84,0.476,27,43,0.628,13,41,0.317,28,31,0.903,121,40,98,0.408,26,46,0.565,14,52,0.269,19,25,0.76,113
464,HOU,2020-02-06,121,@,LAL,1,240,43,85,0.506,24,43,0.558,19,42,0.452,16,18,0.889,121,45,91,0.495,36,60,0.6,9,31,0.29,12,16,0.75,111
465,MEM,2020-02-05,121,@,DAL,1,240,47,89,0.528,35,64,0.547,12,25,0.48,15,20,0.75,121,34,94,0.362,17,51,0.333,17,43,0.395,22,24,0.917,107
466,DAL,2020-01-31,121,@,HOU,0,240,43,90,0.478,29,54,0.537,14,36,0.389,21,27,0.778,121,45,98,0.459,24,53,0.453,21,45,0.467,17,20,0.85,128
467,WAS,2020-01-30,121,,CHO,1,240,41,86,0.477,27,49,0.551,14,37,0.378,25,27,0.926,121,43,99,0.434,34,69,0.493,9,30,0.3,12,19,0.632,107
468,BRK,2020-01-25,121,@,DET,1,265,42,94,0.447,27,52,0.519,15,42,0.357,22,25,0.88,121,43,104,0.413,30,69,0.435,13,35,0.371,12,18,0.667,111
469,HOU,2020-01-22,121,,DEN,1,240,42,89,0.472,29,60,0.483,13,29,0.448,24,28,0.857,121,42,92,0.457,32,64,0.5,10,28,0.357,11,15,0.733,105
470,SAS,2020-01-22,121,@,NOP,1,240,45,89,0.506,34,62,0.548,11,27,0.407,20,25,0.8,121,39,84,0.464,25,48,0.521,14,36,0.389,25,32,0.781,117
471,ATL,2020-01-17,121,@,SAS,1,240,41,82,0.5,22,42,0.524,19,40,0.475,20,27,0.741,121,45,98,0.459,37,69,0.536,8,29,0.276,22,23,0.957,120
472,PHO,2020-01-16,121,@,NYK,1,240,47,92,0.511,35,62,0.565,12,30,0.4,15,18,0.833,121,37,90,0.411,29,64,0.453,8,26,0.308,16,24,0.667,98
473,OKC,2020-01-15,121,,TOR,0,240,43,85,0.506,27,43,0.628,16,42,0.381,19,20,0.95,121,52,85,0.612,37,58,0.638,15,27,0.556,11,15,0.733,130
474,MEM,2020-01-14,121,,HOU,1,240,46,91,0.505,33,54,0.611,13,37,0.351,16,19,0.842,121,37,86,0.43,23,41,0.561,14,45,0.311,22,24,0.917,110
475,MIA,2020-01-12,121,@,NYK,0,240,42,78,0.538,28,43,0.651,14,35,0.4,23,28,0.821,121,46,90,0.511,37,59,0.627,9,31,0.29,23,28,0.821,124
476,SAS,2020-01-10,121,@,MEM,0,240,42,87,0.483,25,47,0.532,17,40,0.425,20,23,0.87,121,52,100,0.52,36,62,0.581,16,38,0.421,14,16,0.875,134
477,MEM,2020-01-05,121,@,PHO,1,240,45,83,0.542,27,41,0.659,18,42,0.429,13,17,0.765,121,43,95,0.453,37,69,0.536,6,26,0.231,22,26,0.846,114
478,OKC,2020-01-04,121,@,CLE,1,240,43,96,0.448,29,59,0.492,14,37,0.378,21,26,0.808,121,39,85,0.459,25,55,0.455,14,30,0.467,14,17,0.824,106
479,TOR,2020-01-04,121,@,BRK,1,240,44,97,0.454,31,65,0.477,13,32,0.406,20,28,0.714,121,32,67,0.478,19,32,0.594,13,35,0.371,25,34,0.735,102
480,GSW,2019-12-28,121,,DAL,0,240,45,93,0.484,27,54,0.5,18,39,0.462,13,17,0.765,121,48,92,0.522,24,41,0.585,24,51,0.471,21,21,1.0,141
481,UTA,2019-12-26,121,,POR,1,240,46,81,0.568,32,45,0.711,14,36,0.389,15,22,0.682,121,43,89,0.483,28,55,0.509,15,34,0.441,14,19,0.737,115
482,PHI,2019-12-25,121,,MIL,1,240,44,101,0.436,23,57,0.404,21,44,0.477,12,15,0.8,121,45,95,0.474,32,62,0.516,13,33,0.394,6,8,0.75,109
483,CLE,2019-12-23,121,,ATL,1,240,50,96,0.521,39,67,0.582,11,29,0.379,10,12,0.833,121,45,95,0.474,30,53,0.566,15,42,0.357,13,17,0.765,118
484,WAS,2019-12-23,121,@,NYK,1,240,47,100,0.47,37,70,0.529,10,30,0.333,17,30,0.567,121,44,93,0.473,29,57,0.509,15,36,0.417,12,15,0.8,115
485,SAS,2019-12-14,121,@,PHO,1,265,44,106,0.415,36,76,0.474,8,30,0.267,25,34,0.735,121,45,103,0.437,35,63,0.556,10,40,0.25,19,26,0.731,119
486,ATL,2019-12-10,121,@,MIA,0,265,45,95,0.474,25,41,0.61,20,54,0.37,11,18,0.611,121,53,103,0.515,39,62,0.629,14,41,0.341,15,22,0.682,135
487,LAL,2019-12-04,121,@,UTA,1,240,46,90,0.511,32,61,0.525,14,29,0.483,15,25,0.6,121,34,83,0.41,20,52,0.385,14,31,0.452,14,19,0.737,96
488,DAL,2019-12-04,121,,MIN,1,240,46,92,0.5,35,55,0.636,11,37,0.297,18,23,0.783,121,37,89,0.416,20,51,0.392,17,38,0.447,23,26,0.885,114
489,MIA,2019-12-03,121,@,TOR,1,265,45,99,0.455,30,61,0.492,15,38,0.395,16,21,0.762,121,35,91,0.385,24,48,0.5,11,43,0.256,29,36,0.806,110
490,IND,2019-11-27,121,,UTA,1,240,50,96,0.521,42,74,0.568,8,22,0.364,13,16,0.813,121,36,83,0.434,26,51,0.51,10,32,0.313,20,25,0.8,102
491,LAC,2019-11-27,121,@,MEM,1,240,44,95,0.463,30,54,0.556,14,41,0.341,19,25,0.76,121,43,92,0.467,32,64,0.5,11,28,0.393,22,26,0.846,119
492,BOS,2019-11-27,121,,BRK,1,240,43,97,0.443,30,63,0.476,13,34,0.382,22,24,0.917,121,40,90,0.444,19,34,0.559,21,56,0.375,9,19,0.474,110
493,PHO,2019-11-21,121,,NOP,0,240,40,86,0.465,27,55,0.491,13,31,0.419,28,32,0.875,121,47,88,0.534,31,53,0.585,16,35,0.457,14,22,0.636,124
494,WAS,2019-11-17,121,@,ORL,0,240,46,97,0.474,27,56,0.482,19,41,0.463,10,12,0.833,121,43,87,0.494,28,49,0.571,15,38,0.395,24,26,0.923,125
495,POR,2019-11-16,121,@,SAS,1,240,42,93,0.452,29,54,0.537,13,39,0.333,24,26,0.923,121,41,88,0.466,36,70,0.514,5,18,0.278,29,34,0.853,116
496,DEN,2019-11-12,121,,ATL,0,240,46,104,0.442,35,63,0.556,11,41,0.268,18,22,0.818,121,44,83,0.53,29,49,0.592,15,34,0.441,22,34,0.647,125
497,MIL,2019-11-10,121,@,OKC,1,240,47,83,0.566,36,55,0.655,11,28,0.393,16,18,0.889,121,45,91,0.495,28,49,0.571,17,42,0.405,12,17,0.706,119
498,SAC,2019-11-08,121,@,ATL,1,240,42,76,0.553,24,45,0.533,18,31,0.581,19,22,0.864,121,46,87,0.529,37,59,0.627,9,28,0.321,8,14,0.571,109
499,SAS,2019-11-07,121,,OKC,1,240,51,94,0.543,42,74,0.568,9,20,0.45,10,11,0.909,121,42,80,0.525,32,59,0.542,10,21,0.476,18,24,0.75,112
500,MIN,2019-11-06,121,@,MEM,0,240,43,96,0.448,27,51,0.529,16,45,0.356,19,26,0.731,121,50,88,0.568,38,65,0.585,12,23,0.522,25,30,0.833,137
501,IND,2019-11-06,121,,WAS,1,240,44,94,0.468,32,64,0.5,12,30,0.4,21,26,0.808,121,37,95,0.389,24,55,0.436,13,40,0.325,19,19,1.0,106
502,PHO,2019-10-30,121,@,GSW,1,240,44,96,0.458,29,60,0.483,15,36,0.417,18,21,0.857,121,36,82,0.439,28,54,0.519,8,28,0.286,30,36,0.833,110
503,POR,2019-10-27,121,@,DAL,1,240,45,87,0.517,36,65,0.554,9,22,0.409,22,26,0.846,121,37,94,0.394,24,44,0.545,13,50,0.26,32,41,0.78,119
504,MIN,2019-10-25,121,@,CHO,1,240,43,91,0.473,31,53,0.585,12,38,0.316,23,31,0.742,121,37,84,0.44,25,55,0.455,12,29,0.414,13,26,0.5,99
505,LAC,2020-08-09,120,,BRK,0,240,45,93,0.484,32,57,0.561,13,36,0.361,17,20,0.85,120,47,85,0.553,27,42,0.643,20,43,0.465,15,19,0.789,129
506,IND,2020-08-04,120,,ORL,1,240,46,84,0.548,33,51,0.647,13,33,0.394,15,19,0.789,120,39,82,0.476,27,48,0.563,12,34,0.353,19,23,0.826,109
507,HOU,2020-08-02,120,,MIL,1,240,36,91,0.396,15,30,0.5,21,61,0.344,27,31,0.871,120,45,92,0.489,36,57,0.632,9,35,0.257,17,23,0.739,116
508,SAC,2020-07-31,120,@,SAS,0,240,46,95,0.484,34,57,0.596,12,38,0.316,16,20,0.8,120,48,90,0.533,37,65,0.569,11,25,0.44,22,27,0.815,129
509,ORL,2020-03-10,120,@,MEM,1,240,43,92,0.467,29,59,0.492,14,33,0.424,20,22,0.909,120,38,76,0.5,27,47,0.574,11,29,0.379,28,38,0.737,115
510,NOP,2020-03-08,120,@,MIN,1,240,44,90,0.489,33,55,0.6,11,35,0.314,21,31,0.677,120,37,94,0.394,29,61,0.475,8,33,0.242,25,31,0.806,107
511,SAS,2020-03-06,120,@,BRK,0,240,43,92,0.467,33,58,0.569,10,34,0.294,24,27,0.889,120,51,96,0.531,36,60,0.6,15,36,0.417,22,31,0.71,139
512,LAC,2020-03-05,120,@,HOU,1,240,39,84,0.464,26,44,0.591,13,40,0.325,29,39,0.744,120,35,97,0.361,28,55,0.509,7,42,0.167,28,36,0.778,105
513,BOS,2020-03-03,120,,BRK,0,265,44,103,0.427,29,54,0.537,15,49,0.306,17,23,0.739,120,43,100,0.43,29,51,0.569,14,49,0.286,29,38,0.763,129
514,LAL,2020-03-03,120,,PHI,1,240,46,86,0.535,33,53,0.623,13,33,0.394,15,18,0.833,120,38,85,0.447,22,45,0.489,16,40,0.4,15,20,0.75,107
515,ATL,2020-02-26,120,,ORL,0,240,42,94,0.447,29,58,0.5,13,36,0.361,23,25,0.92,120,49,100,0.49,35,68,0.515,14,32,0.438,18,25,0.72,130
516,HOU,2020-02-22,120,@,UTA,1,240,45,92,0.489,25,44,0.568,20,48,0.417,10,14,0.714,120,42,90,0.467,35,59,0.593,7,31,0.226,19,24,0.792,110
517,LAL,2020-02-12,120,@,DEN,1,265,47,93,0.505,35,60,0.583,12,33,0.364,14,27,0.519,120,44,88,0.5,33,63,0.524,11,25,0.44,17,22,0.773,116
518,SAS,2020-02-10,120,@,DEN,0,240,41,85,0.482,25,53,0.472,16,32,0.5,22,25,0.88,120,45,80,0.563,27,45,0.6,18,35,0.514,19,23,0.826,127
519,GSW,2020-02-08,120,,LAL,0,240,46,89,0.517,33,57,0.579,13,32,0.406,15,23,0.652,120,43,82,0.524,29,53,0.547,14,29,0.483,25,34,0.735,125
520,MIN,2020-02-05,120,,ATL,0,240,45,91,0.495,36,56,0.643,9,35,0.257,21,28,0.75,120,43,82,0.524,30,50,0.6,13,32,0.406,28,30,0.933,127
521,MIL,2020-02-04,120,@,NOP,1,240,48,102,0.471,37,66,0.561,11,36,0.306,13,17,0.765,120,38,99,0.384,24,50,0.48,14,49,0.286,18,24,0.75,108
522,UTA,2020-01-29,120,@,SAS,0,240,37,84,0.44,23,46,0.5,14,38,0.368,32,46,0.696,120,46,82,0.561,38,51,0.745,8,31,0.258,27,30,0.9,127
523,OKC,2020-01-29,120,@,SAC,1,240,44,88,0.5,29,54,0.537,15,34,0.441,17,20,0.85,120,42,91,0.462,33,52,0.635,9,39,0.231,7,11,0.636,100
524,OKC,2020-01-22,120,@,ORL,1,240,46,76,0.605,37,57,0.649,9,19,0.474,19,23,0.826,120,44,92,0.478,30,57,0.526,14,35,0.4,12,16,0.75,114
525,SAS,2020-01-20,120,@,PHO,1,240,43,87,0.494,26,56,0.464,17,31,0.548,17,22,0.773,120,42,80,0.525,34,58,0.586,8,22,0.364,26,30,0.867,118
526,DAL,2020-01-17,120,,POR,1,240,39,89,0.438,19,42,0.452,20,47,0.426,22,28,0.786,120,44,85,0.518,35,55,0.636,9,30,0.3,15,22,0.682,112
527,SAS,2020-01-17,120,,ATL,0,240,45,98,0.459,37,69,0.536,8,29,0.276,22,23,0.957,120,41,82,0.5,22,42,0.524,19,40,0.475,20,27,0.741,121
528,PHI,2020-01-06,120,,OKC,1,240,46,90,0.511,33,64,0.516,13,26,0.5,15,18,0.833,120,40,89,0.449,28,60,0.467,12,29,0.414,21,31,0.677,113
529,DAL,2020-01-04,120,,CHO,0,265,47,100,0.47,32,50,0.64,15,50,0.3,11,13,0.846,120,42,85,0.494,31,60,0.517,11,25,0.44,28,31,0.903,123
530,PHO,2020-01-03,120,,NYK,1,240,42,90,0.467,32,62,0.516,10,28,0.357,26,33,0.788,120,41,92,0.446,31,55,0.564,10,37,0.27,20,30,0.667,112
531,DEN,2019-12-29,120,,SAC,1,240,42,81,0.519,34,52,0.654,8,29,0.276,28,31,0.903,120,45,85,0.529,32,51,0.627,13,34,0.382,12,17,0.706,115
532,POR,2019-12-28,120,,LAL,0,240,41,86,0.477,26,51,0.51,15,35,0.429,23,27,0.852,120,47,91,0.516,36,59,0.61,11,32,0.344,23,28,0.821,128
533,UTA,2019-12-28,120,@,LAC,1,240,45,86,0.523,28,51,0.549,17,35,0.486,13,17,0.765,120,35,95,0.368,23,55,0.418,12,40,0.3,25,27,0.926,107
534,NOP,2019-12-28,120,,IND,1,240,43,93,0.462,25,51,0.49,18,42,0.429,16,20,0.8,120,33,85,0.388,27,57,0.474,6,28,0.214,26,29,0.897,98
535,IND,2019-12-23,120,,TOR,1,265,45,95,0.474,27,53,0.509,18,42,0.429,12,20,0.6,120,43,94,0.457,32,54,0.593,11,40,0.275,18,24,0.75,115
536,LAC,2019-12-17,120,,PHO,1,240,45,89,0.506,31,57,0.544,14,32,0.438,16,22,0.727,120,41,102,0.402,31,67,0.463,10,35,0.286,7,10,0.7,99
537,ATL,2019-12-17,120,@,NYK,0,240,45,99,0.455,30,56,0.536,15,43,0.349,15,20,0.75,120,53,95,0.558,40,67,0.597,13,28,0.464,24,31,0.774,143
538,DAL,2019-12-16,120,@,MIL,1,240,41,88,0.466,25,47,0.532,16,41,0.39,22,27,0.815,120,44,105,0.419,33,64,0.516,11,41,0.268,17,24,0.708,116
539,WAS,2019-12-03,120,,ORL,0,240,45,89,0.506,33,54,0.611,12,35,0.343,18,23,0.783,120,46,90,0.511,31,59,0.525,15,31,0.484,20,27,0.741,127
540,DAL,2019-11-29,120,@,PHO,1,240,35,85,0.412,18,38,0.474,17,47,0.362,33,38,0.868,120,41,93,0.441,28,55,0.509,13,38,0.342,18,25,0.72,113
541,NOP,2019-11-23,120,@,UTA,0,240,42,101,0.416,25,60,0.417,17,41,0.415,19,20,0.95,120,42,82,0.512,27,46,0.587,15,36,0.417,29,33,0.879,128
542,SAC,2019-11-19,120,,PHO,1,240,42,79,0.532,29,48,0.604,13,31,0.419,23,25,0.92,120,38,89,0.427,26,53,0.491,12,36,0.333,28,34,0.824,116
543,LAL,2019-11-13,120,,GSW,1,240,48,89,0.539,39,69,0.565,9,20,0.45,15,18,0.833,120,36,89,0.404,27,54,0.5,9,35,0.257,13,17,0.765,94
544,CHI,2019-11-12,120,,NYK,1,240,41,81,0.506,27,48,0.563,14,33,0.424,24,31,0.774,120,36,88,0.409,26,56,0.464,10,32,0.313,20,31,0.645,102
545,MIN,2019-11-11,120,@,DET,1,240,45,89,0.506,30,55,0.545,15,34,0.441,15,19,0.789,120,39,87,0.448,23,55,0.418,16,32,0.5,20,25,0.8,114
546,SAC,2019-11-06,120,@,TOR,0,240,42,95,0.442,22,51,0.431,20,44,0.455,16,21,0.762,120,43,78,0.551,29,49,0.592,14,29,0.483,24,29,0.828,124
547,IND,2019-11-05,120,@,CHO,0,265,51,94,0.543,39,64,0.609,12,30,0.4,6,7,0.857,120,42,88,0.477,32,57,0.561,10,31,0.323,28,42,0.667,122
548,LAL,2019-10-29,120,,MEM,1,240,40,86,0.465,33,60,0.55,7,26,0.269,33,39,0.846,120,31,95,0.326,24,61,0.393,7,34,0.206,22,23,0.957,91
549,OKC,2019-10-27,120,,GSW,1,240,44,78,0.564,29,46,0.63,15,32,0.469,17,22,0.773,120,30,92,0.326,25,59,0.424,5,33,0.152,27,31,0.871,92
550,LAL,2019-10-27,120,,CHO,1,240,49,93,0.527,38,62,0.613,11,31,0.355,11,14,0.786,120,35,91,0.385,25,56,0.446,10,35,0.286,21,23,0.913,101
551,SAS,2019-10-23,120,,NYK,1,240,42,83,0.506,35,62,0.565,7,21,0.333,29,36,0.806,120,44,94,0.468,34,64,0.531,10,30,0.333,13,18,0.722,111
552,MIA,2019-10-23,120,,MEM,1,240,40,85,0.471,33,67,0.493,7,18,0.389,33,39,0.846,120,38,89,0.427,33,57,0.579,5,32,0.156,20,30,0.667,101
553,MEM,2020-08-13,119,,MIL,1,240,45,90,0.5,32,57,0.561,13,33,0.394,16,23,0.696,119,39,98,0.398,26,57,0.456,13,41,0.317,15,23,0.652,106
554,ORL,2020-08-09,119,@,BOS,0,265,41,102,0.402,26,55,0.473,15,47,0.319,22,26,0.846,119,45,102,0.441,33,62,0.532,12,40,0.3,20,24,0.833,122
555,PHO,2020-08-08,119,@,MIA,1,240,44,92,0.478,32,60,0.533,12,32,0.375,19,20,0.95,119,41,84,0.488,30,48,0.625,11,36,0.306,19,22,0.864,112
556,BRK,2020-08-07,119,,SAC,1,240,42,86,0.488,25,46,0.543,17,40,0.425,18,28,0.643,119,38,89,0.427,26,49,0.531,12,40,0.3,18,24,0.75,106
557,SAS,2020-08-07,119,,UTA,1,240,45,89,0.506,36,67,0.537,9,22,0.409,20,26,0.769,119,38,91,0.418,22,54,0.407,16,37,0.432,19,24,0.792,111
558,BRK,2020-08-04,119,@,MIL,1,240,43,103,0.417,22,46,0.478,21,57,0.368,12,16,0.75,119,42,88,0.477,25,37,0.676,17,51,0.333,15,23,0.652,116
559,MIL,2020-07-31,119,,BOS,1,240,39,84,0.464,26,43,0.605,13,41,0.317,28,34,0.824,119,37,91,0.407,26,54,0.481,11,37,0.297,27,34,0.794,112
560,SAS,2020-03-10,119,,DAL,1,240,46,89,0.517,31,57,0.544,15,32,0.469,12,15,0.8,119,42,92,0.457,25,48,0.521,17,44,0.386,8,11,0.727,109
561,MIL,2020-03-04,119,,IND,1,240,43,94,0.457,30,48,0.625,13,46,0.283,20,22,0.909,119,42,97,0.433,35,70,0.5,7,27,0.259,9,11,0.818,100
562,WAS,2020-02-28,119,@,UTA,0,240,45,98,0.459,31,61,0.508,14,37,0.378,15,21,0.714,119,44,89,0.494,25,52,0.481,19,37,0.514,22,30,0.733,129
563,IND,2020-02-25,119,,CHO,1,240,49,86,0.57,39,63,0.619,10,23,0.435,11,13,0.846,119,31,93,0.333,21,60,0.35,10,33,0.303,8,18,0.444,80
564,MIA,2020-02-24,119,@,CLE,0,265,44,96,0.458,28,54,0.519,16,42,0.381,15,20,0.75,119,43,97,0.443,29,60,0.483,14,37,0.378,25,34,0.735,125
565,MIL,2020-02-22,119,,PHI,1,240,48,91,0.527,34,50,0.68,14,41,0.341,9,13,0.692,119,35,99,0.354,22,61,0.361,13,38,0.342,15,18,0.833,98
566,DAL,2020-02-10,119,,UTA,0,240,39,83,0.47,24,40,0.6,15,43,0.349,26,31,0.839,119,46,78,0.59,31,43,0.721,15,35,0.429,16,21,0.762,123
567,TOR,2020-02-08,119,,BRK,1,240,45,95,0.474,31,60,0.517,14,35,0.4,15,21,0.714,119,41,92,0.446,25,48,0.521,16,44,0.364,20,24,0.833,118
568,WAS,2020-02-07,119,,DAL,1,240,45,90,0.5,26,52,0.5,19,38,0.5,10,13,0.769,119,42,91,0.462,26,51,0.51,16,40,0.4,18,21,0.857,118
569,PHI,2020-02-07,119,,MEM,1,240,48,90,0.533,34,65,0.523,14,25,0.56,9,15,0.6,119,38,93,0.409,33,72,0.458,5,21,0.238,26,31,0.839,107
570,CHI,2020-02-06,119,,NOP,0,240,46,93,0.495,33,64,0.516,13,29,0.448,14,23,0.609,119,49,87,0.563,33,49,0.673,16,38,0.421,11,19,0.579,125
571,TOR,2020-02-05,119,,IND,1,240,43,86,0.5,31,54,0.574,12,32,0.375,21,24,0.875,119,43,82,0.524,24,43,0.558,19,39,0.487,13,16,0.813,118
572,BRK,2020-02-03,119,,PHO,1,240,43,89,0.483,28,55,0.509,15,34,0.441,18,21,0.857,119,39,90,0.433,33,73,0.452,6,17,0.353,13,18,0.722,97
573,LAL,2020-01-31,119,,POR,0,240,45,96,0.469,34,64,0.531,11,32,0.344,18,28,0.643,119,49,97,0.505,36,61,0.59,13,36,0.361,16,21,0.762,127
574,BOS,2020-01-30,119,,GSW,1,240,42,88,0.477,27,53,0.509,15,35,0.429,20,22,0.909,119,33,77,0.429,21,38,0.553,12,39,0.308,26,30,0.867,104
575,BOS,2020-01-22,119,,MEM,1,240,45,89,0.506,31,57,0.544,14,32,0.438,15,20,0.75,119,36,85,0.424,25,53,0.472,11,32,0.344,12,15,0.8,95
576,OKC,2020-01-18,119,,POR,1,240,43,83,0.518,36,61,0.59,7,22,0.318,26,36,0.722,119,39,91,0.429,27,59,0.458,12,32,0.375,16,21,0.762,106
577,BOS,2020-01-18,119,,PHO,0,240,42,96,0.438,27,54,0.5,15,42,0.357,20,22,0.909,119,42,89,0.472,29,58,0.5,13,31,0.419,26,30,0.867,123
578,ORL,2020-01-15,119,@,LAL,1,240,43,94,0.457,33,68,0.485,10,26,0.385,23,29,0.793,119,48,97,0.495,33,59,0.559,15,38,0.395,7,11,0.636,118
579,MEM,2020-01-07,119,,MIN,1,240,46,89,0.517,38,61,0.623,8,28,0.286,19,21,0.905,119,40,90,0.444,25,43,0.581,15,47,0.319,17,21,0.81,112
580,DEN,2019-12-28,119,,MEM,1,240,45,93,0.484,36,64,0.563,9,29,0.31,20,27,0.741,119,41,84,0.488,32,54,0.593,9,30,0.3,19,25,0.76,110
581,BOS,2019-12-22,119,,CHO,1,240,46,88,0.523,32,56,0.571,14,32,0.438,13,16,0.813,119,33,82,0.402,23,48,0.479,10,34,0.294,17,23,0.739,93
582,CHI,2019-12-21,119,@,DET,1,240,40,77,0.519,22,42,0.524,18,35,0.514,21,25,0.84,119,40,87,0.46,24,52,0.462,16,35,0.457,11,12,0.917,107
583,MEM,2019-12-21,119,,SAC,1,240,40,83,0.482,25,48,0.521,15,35,0.429,24,29,0.828,119,43,100,0.43,32,64,0.5,11,36,0.306,18,24,0.75,115
584,IND,2019-12-20,119,,SAC,1,240,45,86,0.523,31,55,0.564,14,31,0.452,15,18,0.833,119,41,91,0.451,31,59,0.525,10,32,0.313,13,15,0.867,105
585,DET,2019-12-16,119,,WAS,0,240,41,86,0.477,28,47,0.596,13,39,0.333,24,34,0.706,119,49,88,0.557,31,54,0.574,18,34,0.529,17,21,0.81,133
586,NOP,2019-12-15,119,,ORL,0,240,47,88,0.534,28,45,0.622,19,43,0.442,6,12,0.5,119,46,89,0.517,29,55,0.527,17,34,0.5,21,26,0.808,130
587,PHO,2019-12-14,119,,SAS,0,265,45,103,0.437,35,63,0.556,10,40,0.25,19,26,0.731,119,44,106,0.415,36,76,0.474,8,30,0.267,25,34,0.735,121
588,SAC,2019-12-09,119,@,HOU,1,240,40,88,0.455,20,43,0.465,20,45,0.444,19,22,0.864,119,41,84,0.488,24,34,0.706,17,50,0.34,19,23,0.826,118
589,WAS,2019-12-08,119,,LAC,0,240,40,88,0.455,26,55,0.473,14,33,0.424,25,30,0.833,119,50,96,0.521,35,56,0.625,15,40,0.375,20,27,0.741,135
590,MIL,2019-12-06,119,,LAC,1,240,44,94,0.468,30,58,0.517,14,36,0.389,17,21,0.81,119,33,94,0.351,25,62,0.403,8,32,0.25,17,19,0.895,91
591,HOU,2019-12-05,119,@,TOR,1,240,40,98,0.408,18,43,0.419,22,55,0.4,17,19,0.895,119,38,88,0.432,26,49,0.531,12,39,0.308,21,24,0.875,109
592,WAS,2019-12-05,119,,PHI,1,240,41,90,0.456,30,63,0.476,11,27,0.407,26,32,0.813,119,41,77,0.532,28,49,0.571,13,28,0.464,18,24,0.75,113
593,PHI,2019-11-30,119,,IND,1,240,38,77,0.494,27,54,0.5,11,23,0.478,32,36,0.889,119,42,76,0.553,31,54,0.574,11,22,0.5,21,25,0.84,116
594,MIL,2019-11-29,119,@,CLE,1,240,45,88,0.511,33,54,0.611,12,34,0.353,17,23,0.739,119,44,88,0.5,27,54,0.5,17,34,0.5,5,10,0.5,110
595,OKC,2019-11-27,119,@,POR,0,240,39,88,0.443,28,53,0.528,11,35,0.314,30,38,0.789,119,49,94,0.521,35,64,0.547,14,30,0.467,24,24,1.0,136
596,MEM,2019-11-27,119,,LAC,0,240,43,92,0.467,32,64,0.5,11,28,0.393,22,26,0.846,119,44,95,0.463,30,54,0.556,14,41,0.341,19,25,0.76,121
597,TOR,2019-11-23,119,@,ATL,1,240,40,88,0.455,27,51,0.529,13,37,0.351,26,30,0.867,119,47,90,0.522,33,56,0.589,14,34,0.412,8,11,0.727,116
598,HOU,2019-11-22,119,@,LAC,0,240,39,84,0.464,24,41,0.585,15,43,0.349,26,38,0.684,119,45,87,0.517,32,54,0.593,13,33,0.394,19,24,0.792,122
599,PHI,2019-11-15,119,@,OKC,0,265,45,90,0.5,31,58,0.534,14,32,0.438,15,22,0.682,119,41,76,0.539,31,52,0.596,10,24,0.417,35,41,0.854,127
600,MEM,2019-11-13,119,@,CHO,1,240,48,89,0.539,31,54,0.574,17,35,0.486,6,9,0.667,119,43,87,0.494,27,51,0.529,16,36,0.444,15,19,0.789,117
601,UTA,2019-11-12,119,,BRK,1,240,43,92,0.467,37,66,0.561,6,26,0.231,27,35,0.771,119,41,90,0.456,30,53,0.566,11,37,0.297,21,25,0.84,114
602,OKC,2019-11-10,119,,MIL,0,240,45,91,0.495,28,49,0.571,17,42,0.405,12,17,0.706,119,47,83,0.566,36,55,0.655,11,28,0.393,16,18,0.889,121
603,GSW,2019-11-08,119,@,MIN,0,265,43,103,0.417,33,68,0.485,10,35,0.286,23,24,0.958,119,48,111,0.432,39,75,0.52,9,36,0.25,20,29,0.69,125
604,BRK,2019-11-08,119,@,POR,1,240,41,99,0.414,25,62,0.403,16,37,0.432,21,30,0.7,119,40,97,0.412,29,67,0.433,11,30,0.367,24,25,0.96,115
605,BOS,2019-11-05,119,@,CLE,1,240,48,85,0.565,36,55,0.655,12,30,0.4,11,15,0.733,119,40,95,0.421,27,62,0.435,13,33,0.394,20,22,0.909,113
606,LAL,2019-11-01,119,@,DAL,1,265,47,96,0.49,38,64,0.594,9,32,0.281,16,21,0.762,119,40,102,0.392,26,66,0.394,14,36,0.389,16,23,0.696,110
607,DAL,2019-10-27,119,,POR,0,240,37,94,0.394,24,44,0.545,13,50,0.26,32,41,0.78,119,45,87,0.517,36,65,0.554,9,22,0.409,22,26,0.846,121
608,DET,2019-10-23,119,@,IND,1,240,41,78,0.526,30,54,0.556,11,24,0.458,26,33,0.788,119,41,89,0.461,33,68,0.485,8,21,0.381,20,24,0.833,110
609,UTA,2020-08-13,118,,SAS,1,240,47,101,0.465,32,55,0.582,15,46,0.326,9,10,0.9,118,39,79,0.494,29,59,0.492,10,20,0.5,24,36,0.667,112
610,NOP,2020-08-07,118,,WAS,1,240,42,88,0.477,30,53,0.566,12,35,0.343,22,26,0.846,118,38,90,0.422,28,63,0.444,10,27,0.37,21,23,0.913,107
611,BRK,2020-08-02,118,,WAS,1,240,38,90,0.422,27,57,0.474,11,33,0.333,31,37,0.838,118,40,88,0.455,31,57,0.544,9,31,0.29,21,27,0.778,110
612,BRK,2020-07-31,118,,ORL,0,240,44,91,0.484,31,49,0.633,13,42,0.31,17,23,0.739,118,46,87,0.529,35,56,0.625,11,31,0.355,25,28,0.893,128
613,TOR,2020-03-08,118,@,SAC,1,240,39,82,0.476,20,34,0.588,19,48,0.396,21,27,0.778,118,42,90,0.467,34,59,0.576,8,31,0.258,21,23,0.913,113
614,GSW,2020-03-07,118,,PHI,1,240,44,80,0.55,35,55,0.636,9,25,0.36,21,28,0.75,118,41,84,0.488,28,50,0.56,13,34,0.382,19,22,0.864,114
615,MEM,2020-03-07,118,,ATL,1,240,43,87,0.494,31,54,0.574,12,33,0.364,20,33,0.606,118,32,95,0.337,19,46,0.413,13,49,0.265,24,28,0.857,101
616,WAS,2020-03-06,118,,ATL,1,240,36,76,0.474,21,45,0.467,15,31,0.484,31,35,0.886,118,46,86,0.535,34,54,0.63,12,32,0.375,8,12,0.667,112
617,MIN,2020-03-06,118,,ORL,0,240,46,98,0.469,36,61,0.59,10,37,0.27,16,20,0.8,118,51,84,0.607,44,63,0.698,7,21,0.333,23,31,0.742,132
618,MEM,2020-03-04,118,@,BRK,1,240,43,100,0.43,23,56,0.411,20,44,0.455,12,14,0.857,118,30,90,0.333,23,48,0.479,7,42,0.167,12,17,0.706,79
619,TOR,2020-03-01,118,@,DEN,0,240,41,89,0.461,31,51,0.608,10,38,0.263,26,29,0.897,118,47,83,0.566,29,47,0.617,18,36,0.5,21,30,0.7,133
620,DAL,2020-02-28,118,@,MIA,0,240,40,84,0.476,19,34,0.559,21,50,0.42,17,19,0.895,118,41,79,0.519,24,44,0.545,17,35,0.486,27,36,0.75,126
621,BRK,2020-02-28,118,@,ATL,0,240,42,92,0.457,24,46,0.522,18,46,0.391,16,21,0.762,118,50,97,0.515,31,58,0.534,19,39,0.487,22,30,0.733,141
622,LAL,2020-02-25,118,,NOP,1,240,45,102,0.441,32,58,0.552,13,44,0.295,15,21,0.714,118,39,86,0.453,31,59,0.525,8,27,0.296,23,30,0.767,109
623,BOS,2020-02-25,118,@,POR,1,240,43,90,0.478,24,51,0.471,19,39,0.487,13,14,0.929,118,38,85,0.447,25,54,0.463,13,31,0.419,17,23,0.739,106
624,TOR,2020-02-21,118,,PHO,1,240,42,80,0.525,28,43,0.651,14,37,0.378,20,22,0.909,118,38,92,0.413,32,58,0.552,6,34,0.176,19,23,0.826,101
625,NOP,2020-02-13,118,,OKC,0,240,42,86,0.488,28,51,0.549,14,35,0.4,20,27,0.741,118,46,92,0.5,33,65,0.508,13,27,0.481,18,22,0.818,123
626,IND,2020-02-12,118,,MIL,1,240,45,86,0.523,36,59,0.61,9,27,0.333,19,24,0.792,118,37,91,0.407,24,54,0.444,13,37,0.351,24,25,0.96,111
627,PHI,2020-02-09,118,,CHI,1,240,42,84,0.5,31,57,0.544,11,27,0.407,23,32,0.719,118,43,88,0.489,31,56,0.554,12,32,0.375,13,17,0.765,111
628,BRK,2020-02-08,118,@,TOR,0,240,41,92,0.446,25,48,0.521,16,44,0.364,20,24,0.833,118,45,95,0.474,31,60,0.517,14,35,0.4,15,21,0.714,119
629,DAL,2020-02-07,118,@,WAS,0,240,42,91,0.462,26,51,0.51,16,40,0.4,18,21,0.857,118,45,90,0.5,26,52,0.5,19,38,0.5,10,13,0.769,119
630,IND,2020-02-05,118,@,TOR,0,240,43,82,0.524,24,43,0.558,19,39,0.487,13,16,0.813,118,43,86,0.5,31,54,0.574,12,32,0.375,21,24,0.875,119
631,LAC,2020-02-01,118,,MIN,1,240,45,98,0.459,33,64,0.516,12,34,0.353,16,18,0.889,118,34,84,0.405,27,45,0.6,7,39,0.179,31,37,0.838,106
632,CHI,2020-01-31,118,@,BRK,0,240,42,86,0.488,30,52,0.577,12,34,0.353,22,26,0.846,118,50,80,0.625,35,49,0.714,15,31,0.484,18,25,0.72,133
633,CHI,2020-01-25,118,@,CLE,1,240,44,85,0.518,32,52,0.615,12,33,0.364,18,24,0.75,118,42,84,0.5,29,54,0.537,13,30,0.433,9,11,0.818,106
634,GSW,2020-01-24,118,,IND,0,240,40,82,0.488,21,43,0.488,19,39,0.487,19,23,0.826,118,50,87,0.575,33,59,0.559,17,28,0.607,12,13,0.923,129
635,TOR,2020-01-24,118,@,NYK,1,240,41,81,0.506,24,46,0.522,17,35,0.486,19,23,0.826,118,42,85,0.494,29,49,0.592,13,36,0.361,15,21,0.714,112
636,UTA,2020-01-20,118,,IND,1,240,47,87,0.54,35,56,0.625,12,31,0.387,12,12,1.0,118,39,93,0.419,32,67,0.478,7,26,0.269,3,7,0.429,88
637,MIA,2020-01-20,118,,SAC,1,265,42,83,0.506,26,41,0.634,16,42,0.381,18,22,0.818,118,44,106,0.415,31,55,0.564,13,51,0.255,12,15,0.8,113
638,PHO,2020-01-20,118,,SAS,0,240,42,80,0.525,34,58,0.586,8,22,0.364,26,30,0.867,118,43,87,0.494,26,56,0.464,17,31,0.548,17,22,0.773,120
639,CHI,2020-01-18,118,,CLE,1,240,48,87,0.552,39,62,0.629,9,25,0.36,13,17,0.765,118,40,73,0.548,25,44,0.568,15,29,0.517,21,23,0.913,116
640,LAL,2020-01-15,118,,ORL,0,240,48,97,0.495,33,59,0.559,15,38,0.395,7,11,0.636,118,43,94,0.457,33,68,0.485,10,26,0.385,23,29,0.793,119
641,UTA,2020-01-14,118,@,BRK,1,240,46,92,0.5,33,56,0.589,13,36,0.361,13,15,0.867,118,45,90,0.5,37,64,0.578,8,26,0.308,9,15,0.6,107
642,DAL,2020-01-06,118,,CHI,1,240,44,84,0.524,28,43,0.651,16,41,0.39,14,19,0.737,118,46,98,0.469,37,67,0.552,9,31,0.29,9,11,0.818,110
643,MIN,2020-01-05,118,@,CLE,1,240,47,95,0.495,33,57,0.579,14,38,0.368,10,13,0.769,118,40,84,0.476,32,59,0.542,8,25,0.32,15,19,0.789,103
644,SAS,2020-01-04,118,@,MIL,0,240,38,92,0.413,27,60,0.45,11,32,0.344,31,34,0.912,118,43,87,0.494,26,42,0.619,17,45,0.378,24,33,0.727,127
645,HOU,2020-01-03,118,,PHI,1,240,41,86,0.477,29,54,0.537,12,32,0.375,24,32,0.75,118,42,92,0.457,36,65,0.554,6,27,0.222,18,25,0.72,108
646,BOS,2019-12-25,118,@,TOR,1,240,46,92,0.5,32,59,0.542,14,33,0.424,12,14,0.857,118,38,80,0.475,30,57,0.526,8,23,0.348,18,22,0.818,102
647,ATL,2019-12-23,118,@,CLE,0,240,45,95,0.474,30,53,0.566,15,42,0.357,13,17,0.765,118,50,96,0.521,39,67,0.582,11,29,0.379,10,12,0.833,121
648,OKC,2019-12-22,118,,LAC,1,240,46,97,0.474,37,70,0.529,9,27,0.333,17,20,0.85,118,40,86,0.465,29,59,0.492,11,27,0.407,21,24,0.875,112
649,POR,2019-12-20,118,,ORL,1,240,42,84,0.5,25,48,0.521,17,36,0.472,17,19,0.895,118,39,106,0.368,32,78,0.41,7,28,0.25,18,26,0.692,103
650,WAS,2019-12-20,118,@,TOR,0,240,40,87,0.46,26,48,0.542,14,39,0.359,24,32,0.75,118,38,78,0.487,26,48,0.542,12,30,0.4,34,44,0.773,122
651,SAS,2019-12-19,118,,BRK,1,240,43,96,0.448,30,63,0.476,13,33,0.394,19,23,0.826,118,35,83,0.422,28,47,0.596,7,36,0.194,28,30,0.933,105
652,MEM,2019-12-16,118,,MIA,1,240,42,86,0.488,29,50,0.58,13,36,0.361,21,30,0.7,118,37,81,0.457,26,57,0.456,11,24,0.458,26,31,0.839,111
653,DAL,2019-12-14,118,,MIA,0,265,45,101,0.446,28,57,0.491,17,44,0.386,11,17,0.647,118,39,91,0.429,23,51,0.451,16,40,0.4,28,34,0.824,122
654,HOU,2019-12-09,118,,SAC,0,240,41,84,0.488,24,34,0.706,17,50,0.34,19,23,0.826,118,40,88,0.455,20,43,0.465,20,45,0.444,19,22,0.864,119
655,ATL,2019-12-04,118,,BRK,0,240,48,90,0.533,39,64,0.609,9,26,0.346,13,21,0.619,118,50,101,0.495,36,70,0.514,14,31,0.452,16,18,0.889,130
656,DAL,2019-12-03,118,@,NOP,1,240,38,88,0.432,19,43,0.442,19,45,0.422,23,27,0.852,118,38,94,0.404,27,53,0.509,11,41,0.268,10,15,0.667,97
657,UTA,2019-11-25,118,@,MIL,0,240,43,85,0.506,22,40,0.55,21,45,0.467,11,12,0.917,118,43,97,0.443,30,56,0.536,13,41,0.317,23,29,0.793,122
658,CHO,2019-11-22,118,@,WAS,0,240,48,93,0.516,34,59,0.576,14,34,0.412,8,8,1.0,118,48,91,0.527,34,57,0.596,14,34,0.412,15,20,0.75,125
659,ORL,2019-11-08,118,,MEM,1,240,44,93,0.473,37,65,0.569,7,28,0.25,23,27,0.852,118,32,86,0.372,21,57,0.368,11,29,0.379,11,13,0.846,86
660,LAL,2019-11-05,118,@,CHI,1,240,45,92,0.489,34,59,0.576,11,33,0.333,17,24,0.708,118,43,85,0.506,29,53,0.547,14,32,0.438,12,23,0.522,112
661,POR,2019-11-04,118,@,GSW,0,240,47,105,0.448,34,65,0.523,13,40,0.325,11,14,0.786,118,42,86,0.488,32,60,0.533,10,26,0.385,33,36,0.917,127
662,IND,2019-10-30,118,@,BRK,1,240,45,96,0.469,34,70,0.486,11,26,0.423,17,20,0.85,118,41,93,0.441,31,62,0.5,10,31,0.323,16,26,0.615,108
663,CHO,2019-10-30,118,@,SAC,1,240,46,84,0.548,30,52,0.577,16,32,0.5,10,14,0.714,118,44,96,0.458,30,50,0.6,14,46,0.304,9,12,0.75,111
664,BOS,2019-10-26,118,@,NYK,1,240,42,93,0.452,27,52,0.519,15,41,0.366,19,29,0.655,118,31,82,0.378,24,55,0.436,7,27,0.259,26,34,0.765,95
665,TOR,2020-08-14,117,,DEN,1,240,45,90,0.5,27,55,0.491,18,35,0.514,9,14,0.643,117,36,87,0.414,20,49,0.408,16,38,0.421,21,23,0.913,109
666,PHI,2020-08-11,117,,PHO,0,240,46,93,0.495,31,60,0.517,15,33,0.455,10,14,0.714,117,49,89,0.551,37,61,0.607,12,28,0.429,20,21,0.952,130
667,POR,2020-08-08,117,,LAC,0,240,44,90,0.489,27,47,0.574,17,43,0.395,12,17,0.706,117,42,85,0.494,27,51,0.529,15,34,0.441,23,28,0.821,122
668,PHO,2020-08-04,117,@,LAC,1,240,45,96,0.469,28,64,0.438,17,32,0.531,10,14,0.714,117,42,85,0.494,34,56,0.607,8,29,0.276,23,27,0.852,115
669,PHO,2020-08-02,117,,DAL,1,240,42,93,0.452,30,60,0.5,12,33,0.364,21,23,0.913,117,38,93,0.409,32,62,0.516,6,31,0.194,33,37,0.892,115
670,HOU,2020-03-10,117,,MIN,1,240,41,80,0.513,26,42,0.619,15,38,0.395,20,26,0.769,117,40,83,0.482,26,48,0.542,14,35,0.4,17,23,0.739,111
671,POR,2020-03-06,117,@,PHO,0,240,43,87,0.494,30,55,0.545,13,32,0.406,18,24,0.75,117,45,91,0.495,26,49,0.531,19,42,0.452,18,19,0.947,127
672,POR,2020-02-29,117,@,ATL,0,240,47,94,0.5,39,66,0.591,8,28,0.286,15,21,0.714,117,46,84,0.548,28,42,0.667,18,42,0.429,19,22,0.864,129
673,WAS,2020-02-23,117,@,CHI,0,240,37,73,0.507,25,43,0.581,12,30,0.4,31,36,0.861,117,45,81,0.556,27,44,0.614,18,37,0.486,18,28,0.643,126
674,LAL,2020-02-21,117,,MEM,1,240,41,86,0.477,32,57,0.561,9,29,0.31,26,40,0.65,117,42,92,0.457,37,77,0.481,5,15,0.333,16,31,0.516,105
675,MIN,2020-02-21,117,,BOS,0,240,36,89,0.404,21,47,0.447,15,42,0.357,30,35,0.857,117,44,95,0.463,34,66,0.515,10,29,0.345,29,37,0.784,127
676,POR,2020-02-11,117,@,NOP,0,240,44,93,0.473,37,64,0.578,7,29,0.241,22,28,0.786,117,49,92,0.533,35,58,0.603,14,34,0.412,26,32,0.813,138
677,IND,2020-02-08,117,,NOP,0,240,44,83,0.53,35,57,0.614,9,26,0.346,20,27,0.741,117,44,95,0.463,29,57,0.509,15,38,0.395,21,25,0.84,124
678,DEN,2020-02-08,117,@,PHO,1,240,45,82,0.549,34,54,0.63,11,28,0.393,16,21,0.762,117,38,87,0.437,29,55,0.527,9,32,0.281,23,23,1.0,108
679,UTA,2020-02-07,117,,POR,1,240,45,91,0.495,35,61,0.574,10,30,0.333,17,24,0.708,117,44,97,0.454,27,57,0.474,17,40,0.425,9,14,0.643,114
680,SAS,2020-02-06,117,@,POR,0,240,41,92,0.446,31,64,0.484,10,28,0.357,25,28,0.893,117,49,92,0.533,31,55,0.564,18,37,0.486,9,12,0.75,125
681,WAS,2020-02-03,117,,GSW,0,240,42,83,0.506,33,61,0.541,9,22,0.409,24,29,0.828,117,43,87,0.494,28,57,0.491,15,30,0.5,24,31,0.774,125
682,HOU,2020-02-02,117,,NOP,1,240,41,105,0.39,25,54,0.463,16,51,0.314,19,22,0.864,117,42,94,0.447,32,61,0.525,10,33,0.303,15,20,0.75,109
683,PHI,2020-01-30,117,@,ATL,0,240,38,82,0.463,29,51,0.569,9,31,0.29,32,45,0.711,117,42,87,0.483,31,52,0.596,11,35,0.314,32,37,0.865,127
684,UTA,2020-01-27,117,,HOU,0,240,43,85,0.506,31,43,0.721,12,42,0.286,19,26,0.731,117,38,81,0.469,23,41,0.561,15,40,0.375,35,49,0.714,126
685,DEN,2020-01-26,117,,HOU,1,240,44,93,0.473,33,65,0.508,11,28,0.393,18,20,0.9,117,40,88,0.455,29,55,0.527,11,33,0.333,19,27,0.704,110
686,MIA,2020-01-24,117,,LAC,0,240,40,93,0.43,27,49,0.551,13,44,0.295,24,29,0.828,117,43,94,0.457,27,59,0.458,16,35,0.457,20,23,0.87,122
687,CHI,2020-01-22,117,,MIN,1,240,39,84,0.464,30,54,0.556,9,30,0.3,30,37,0.811,117,41,86,0.477,26,42,0.619,15,44,0.341,13,24,0.542,110
688,NOP,2020-01-22,117,,SAS,0,240,39,84,0.464,25,48,0.521,14,36,0.389,25,32,0.781,117,45,89,0.506,34,62,0.548,11,27,0.407,20,25,0.8,121
689,PHI,2020-01-20,117,@,BRK,1,240,42,94,0.447,29,55,0.527,13,39,0.333,20,27,0.741,117,39,81,0.481,28,52,0.538,11,29,0.379,22,34,0.647,111
690,ATL,2020-01-20,117,,TOR,0,240,41,83,0.494,29,50,0.58,12,33,0.364,23,33,0.697,117,38,92,0.413,25,50,0.5,13,42,0.31,33,43,0.767,122
691,MIL,2020-01-18,117,@,BRK,1,240,45,89,0.506,28,52,0.538,17,37,0.459,10,16,0.625,117,33,99,0.333,18,50,0.36,15,49,0.306,16,17,0.941,97
692,PHI,2020-01-15,117,,BRK,1,240,45,88,0.511,34,58,0.586,11,30,0.367,16,25,0.64,117,38,87,0.437,26,62,0.419,12,25,0.48,18,30,0.6,106
693,POR,2020-01-15,117,@,HOU,1,240,41,95,0.432,30,59,0.508,11,36,0.306,24,29,0.828,117,38,96,0.396,22,47,0.468,16,49,0.327,15,23,0.652,107
694,OKC,2020-01-13,117,@,MIN,1,240,41,82,0.5,29,52,0.558,12,30,0.4,23,26,0.885,117,38,91,0.418,26,56,0.464,12,35,0.343,16,21,0.762,104
695,NOP,2020-01-13,117,@,DET,1,265,43,103,0.417,34,77,0.442,9,26,0.346,22,27,0.815,117,40,99,0.404,29,67,0.433,11,32,0.344,19,24,0.792,110
696,BRK,2020-01-10,117,,MIA,1,240,45,93,0.484,30,49,0.612,15,44,0.341,12,19,0.632,117,44,85,0.518,37,56,0.661,7,29,0.241,18,21,0.857,113
697,LAL,2020-01-07,117,,NYK,1,240,41,82,0.5,24,46,0.522,17,36,0.472,18,21,0.857,117,37,95,0.389,33,75,0.44,4,20,0.2,9,16,0.563,87
698,NOP,2020-01-04,117,@,SAC,1,240,38,87,0.437,22,42,0.524,16,45,0.356,25,33,0.758,117,38,85,0.447,26,64,0.406,12,21,0.571,27,36,0.75,115
699,NYK,2020-01-01,117,,POR,1,240,47,98,0.48,33,62,0.532,14,36,0.389,9,14,0.643,117,37,94,0.394,27,62,0.435,10,32,0.313,9,15,0.6,93
700,LAL,2020-01-01,117,,PHO,1,240,43,90,0.478,36,62,0.581,7,28,0.25,24,34,0.706,117,42,86,0.488,36,63,0.571,6,23,0.261,17,23,0.739,107
701,SAS,2019-12-31,117,,GSW,1,265,45,96,0.469,31,65,0.477,14,31,0.452,13,17,0.765,117,44,96,0.458,32,69,0.464,12,27,0.444,13,18,0.722,113
702,TOR,2019-12-31,117,,CLE,1,240,40,84,0.476,23,45,0.511,17,39,0.436,20,25,0.8,117,37,87,0.425,27,49,0.551,10,38,0.263,13,16,0.813,97
703,MEM,2019-12-29,117,,CHO,1,240,45,93,0.484,35,58,0.603,10,35,0.286,17,17,1.0,117,37,86,0.43,28,55,0.509,9,31,0.29,21,32,0.656,104
704,MIA,2019-12-28,117,,PHI,1,265,42,94,0.447,32,66,0.485,10,28,0.357,23,29,0.793,117,42,89,0.472,32,59,0.542,10,30,0.333,22,29,0.759,116
705,CLE,2019-12-27,117,@,BOS,0,240,44,85,0.518,35,62,0.565,9,23,0.391,20,29,0.69,117,49,95,0.516,35,55,0.636,14,40,0.35,17,19,0.895,129
706,MIL,2019-12-22,117,,IND,1,240,44,104,0.423,29,60,0.483,15,44,0.341,14,17,0.824,117,37,100,0.37,25,60,0.417,12,40,0.3,3,5,0.6,89
707,DAL,2019-12-20,117,@,PHI,1,240,43,83,0.518,29,50,0.58,14,33,0.424,17,22,0.773,117,38,90,0.422,28,56,0.5,10,34,0.294,12,18,0.667,98
708,LAC,2019-12-19,117,,HOU,0,240,43,86,0.5,27,49,0.551,16,37,0.432,15,19,0.789,117,43,86,0.5,29,49,0.592,14,37,0.378,22,29,0.759,122
709,MIN,2019-12-13,117,,LAC,0,240,38,85,0.447,28,44,0.636,10,41,0.244,31,37,0.838,117,39,79,0.494,28,54,0.519,11,25,0.44,35,39,0.897,124
710,CLE,2019-12-12,117,@,SAS,1,265,44,96,0.458,29,51,0.569,15,45,0.333,14,20,0.7,117,42,86,0.488,37,70,0.529,5,16,0.313,20,25,0.8,109
711,BOS,2019-12-11,117,@,IND,0,240,43,87,0.494,29,51,0.569,14,36,0.389,17,22,0.773,117,41,85,0.482,31,60,0.517,10,25,0.4,30,36,0.833,122
712,LAC,2019-12-03,117,,POR,1,240,43,94,0.457,26,60,0.433,17,34,0.5,14,25,0.56,117,39,91,0.429,32,64,0.5,7,27,0.259,12,15,0.8,97
713,IND,2019-12-02,117,@,MEM,1,240,44,88,0.5,28,50,0.56,16,38,0.421,13,15,0.867,117,38,89,0.427,28,51,0.549,10,38,0.263,18,19,0.947,104
714,HOU,2019-11-27,117,,MIA,1,240,38,83,0.458,23,39,0.59,15,44,0.341,26,33,0.788,117,37,80,0.463,23,43,0.535,14,37,0.378,20,27,0.741,108
715,DEN,2019-11-26,117,,WAS,1,240,47,90,0.522,41,66,0.621,6,24,0.25,17,23,0.739,117,40,95,0.421,30,55,0.545,10,40,0.25,14,21,0.667,104
716,POR,2019-11-25,117,@,CHI,1,240,46,89,0.517,38,62,0.613,8,27,0.296,17,22,0.773,117,36,86,0.419,27,47,0.574,9,39,0.231,13,20,0.65,94
717,MIA,2019-11-25,117,,CHO,1,240,40,77,0.519,27,46,0.587,13,31,0.419,24,28,0.857,117,36,87,0.414,27,54,0.5,9,33,0.273,19,25,0.76,100
718,DAL,2019-11-18,117,,SAS,1,240,42,84,0.5,25,43,0.581,17,41,0.415,16,23,0.696,117,44,96,0.458,36,72,0.5,8,24,0.333,14,16,0.875,110
719,BRK,2019-11-16,117,@,CHI,1,240,40,88,0.455,30,45,0.667,10,43,0.233,27,31,0.871,117,32,91,0.352,23,52,0.442,9,39,0.231,38,41,0.927,111
720,CHO,2019-11-13,117,,MEM,0,240,43,87,0.494,27,51,0.529,16,36,0.444,15,19,0.789,117,48,89,0.539,31,54,0.574,17,35,0.486,6,9,0.667,119
721,MIA,2019-11-12,117,,DET,1,240,41,77,0.532,27,45,0.6,14,32,0.438,21,27,0.778,117,34,78,0.436,19,37,0.514,15,41,0.366,25,37,0.676,108
722,HOU,2019-11-09,117,@,CHI,1,240,39,83,0.47,20,39,0.513,19,44,0.432,20,28,0.714,117,37,98,0.378,33,66,0.5,4,32,0.125,16,18,0.889,94
723,CLE,2019-10-30,117,,CHI,1,240,41,78,0.526,31,54,0.574,10,24,0.417,25,31,0.806,117,39,90,0.433,25,51,0.49,14,39,0.359,19,23,0.826,111
724,PHI,2019-10-30,117,,MIN,1,240,43,92,0.467,34,67,0.507,9,25,0.36,22,28,0.786,117,32,81,0.395,22,46,0.478,10,35,0.286,21,28,0.75,95
725,PHI,2019-10-26,117,@,DET,1,240,42,87,0.483,29,53,0.547,13,34,0.382,20,30,0.667,117,41,76,0.539,33,57,0.579,8,19,0.421,21,36,0.583,111
726,ATL,2019-10-24,117,@,DET,1,240,44,86,0.512,33,55,0.6,11,31,0.355,18,21,0.857,117,35,85,0.412,25,48,0.521,10,37,0.27,20,22,0.909,100
727,MIL,2019-10-24,117,@,HOU,1,240,46,99,0.465,30,53,0.566,16,46,0.348,9,18,0.5,117,33,90,0.367,17,42,0.405,16,48,0.333,29,39,0.744,111
728,OKC,2020-08-12,116,,MIA,1,240,39,89,0.438,23,47,0.489,16,42,0.381,22,27,0.815,116,42,86,0.488,28,44,0.636,14,42,0.333,17,20,0.85,115
729,IND,2020-08-08,116,,LAL,1,240,44,84,0.524,29,51,0.569,15,33,0.455,13,14,0.929,116,42,100,0.42,29,61,0.475,13,39,0.333,14,19,0.737,111
730,MIA,2020-08-06,116,@,MIL,0,240,35,83,0.422,14,37,0.378,21,46,0.457,25,27,0.926,116,41,78,0.526,26,41,0.634,15,37,0.405,33,38,0.868,130
731,MIL,2020-08-04,116,,BRK,0,240,42,88,0.477,25,37,0.676,17,51,0.333,15,23,0.652,116,43,103,0.417,22,46,0.478,21,57,0.368,12,16,0.75,119
732,LAL,2020-08-03,116,@,UTA,1,240,41,82,0.5,32,56,0.571,9,26,0.346,25,31,0.806,116,37,83,0.446,25,40,0.625,12,43,0.279,22,25,0.88,108
733,SAC,2020-08-02,116,@,ORL,0,240,45,91,0.495,37,63,0.587,8,28,0.286,18,22,0.818,116,43,82,0.524,25,44,0.568,18,38,0.474,28,35,0.8,132
734,MIL,2020-08-02,116,@,HOU,0,240,45,92,0.489,36,57,0.632,9,35,0.257,17,23,0.739,116,36,91,0.396,15,30,0.5,21,61,0.344,27,31,0.871,120
735,MIA,2020-03-04,116,,ORL,1,240,41,79,0.519,19,35,0.543,22,44,0.5,12,15,0.8,116,44,84,0.524,31,54,0.574,13,30,0.433,12,14,0.857,113
736,GSW,2020-03-03,116,@,DEN,1,240,42,82,0.512,24,41,0.585,18,41,0.439,14,22,0.636,116,39,87,0.448,36,67,0.537,3,20,0.15,19,26,0.731,100
737,IND,2020-03-02,116,@,SAS,1,240,39,78,0.5,24,47,0.511,15,31,0.484,23,26,0.885,116,40,77,0.519,24,45,0.533,16,32,0.5,15,19,0.789,111
738,MIA,2020-02-29,116,,BRK,1,240,41,91,0.451,27,53,0.509,14,38,0.368,20,24,0.833,116,40,86,0.465,24,42,0.571,16,44,0.364,17,23,0.739,113
739,NOP,2020-02-28,116,,CLE,1,240,48,88,0.545,39,65,0.6,9,23,0.391,11,15,0.733,116,43,95,0.453,32,64,0.5,11,31,0.355,7,12,0.583,104
740,LAL,2020-02-27,116,@,GSW,1,240,45,88,0.511,37,64,0.578,8,24,0.333,18,27,0.667,116,34,80,0.425,25,48,0.521,9,32,0.281,9,10,0.9,86
741,MIN,2020-02-23,116,@,DEN,0,240,40,90,0.444,26,50,0.52,14,40,0.35,22,29,0.759,116,53,90,0.589,42,60,0.7,11,30,0.367,11,17,0.647,128
742,UTA,2020-02-12,116,,MIA,1,240,41,85,0.482,27,49,0.551,14,36,0.389,20,23,0.87,116,38,88,0.432,25,49,0.51,13,39,0.333,12,16,0.75,101
743,ORL,2020-02-12,116,,DET,1,265,44,96,0.458,32,60,0.533,12,36,0.333,16,18,0.889,116,40,92,0.435,22,47,0.468,18,45,0.4,14,15,0.933,112
744,DEN,2020-02-12,116,,LAL,0,265,44,88,0.5,33,63,0.524,11,25,0.44,17,22,0.773,116,47,93,0.505,35,60,0.583,12,33,0.364,14,27,0.519,120
745,HOU,2020-02-11,116,,BOS,1,240,33,77,0.429,20,32,0.625,13,45,0.289,37,42,0.881,116,37,85,0.435,26,53,0.491,11,32,0.344,20,25,0.8,105
746,DAL,2020-02-08,116,@,CHO,1,240,44,87,0.506,27,52,0.519,17,35,0.486,11,11,1.0,116,38,87,0.437,27,51,0.529,11,36,0.306,13,18,0.722,100
747,BOS,2020-02-05,116,,ORL,1,240,46,86,0.535,33,63,0.524,13,23,0.565,11,16,0.688,116,32,75,0.427,19,44,0.432,13,31,0.419,23,30,0.767,100
748,DET,2020-02-05,116,,PHO,1,240,46,95,0.484,34,67,0.507,12,28,0.429,12,16,0.75,116,42,77,0.545,30,51,0.588,12,26,0.462,12,15,0.8,108
749,BOS,2020-02-01,116,,PHI,1,240,38,80,0.475,30,50,0.6,8,30,0.267,32,41,0.78,116,31,84,0.369,24,51,0.471,7,33,0.212,26,31,0.839,95
750,MIL,2020-01-24,116,@,CHO,1,240,44,87,0.506,34,51,0.667,10,36,0.278,18,24,0.75,116,32,86,0.372,18,47,0.383,14,39,0.359,25,30,0.833,103
751,MEM,2020-01-20,116,,NOP,0,240,46,103,0.447,37,70,0.529,9,33,0.273,15,21,0.714,116,42,88,0.477,21,40,0.525,21,48,0.438,21,24,0.875,126
752,CLE,2020-01-18,116,@,CHI,0,240,40,73,0.548,25,44,0.568,15,29,0.517,21,23,0.913,116,48,87,0.552,39,62,0.629,9,25,0.36,13,17,0.765,118
753,IND,2020-01-17,116,,MIN,1,240,46,82,0.561,38,58,0.655,8,24,0.333,16,20,0.8,116,40,88,0.455,23,49,0.469,17,39,0.436,17,21,0.81,114
754,DET,2020-01-15,116,@,BOS,1,240,47,78,0.603,35,46,0.761,12,32,0.375,10,19,0.526,116,41,83,0.494,32,55,0.582,9,28,0.321,12,20,0.6,103
755,WAS,2020-01-12,116,,UTA,0,240,47,93,0.505,40,71,0.563,7,22,0.318,15,17,0.882,116,48,90,0.533,38,60,0.633,10,30,0.333,21,25,0.84,127
756,IND,2020-01-10,116,@,CHI,1,240,48,84,0.571,37,54,0.685,11,30,0.367,9,14,0.643,116,37,80,0.463,19,39,0.487,18,41,0.439,13,16,0.813,105
757,MIN,2020-01-09,116,,POR,1,240,44,89,0.494,31,57,0.544,13,32,0.406,15,21,0.714,116,35,96,0.365,24,59,0.407,11,37,0.297,21,31,0.677,102
758,ATL,2020-01-04,116,,IND,1,240,42,82,0.512,32,50,0.64,10,32,0.313,22,24,0.917,116,36,87,0.414,26,60,0.433,10,27,0.37,29,35,0.829,111
759,IND,2020-01-02,116,,DEN,0,240,43,82,0.524,31,56,0.554,12,26,0.462,18,25,0.72,116,46,87,0.529,38,60,0.633,8,27,0.296,24,27,0.889,124
760,POR,2019-12-30,116,,PHO,0,240,44,96,0.458,30,62,0.484,14,34,0.412,14,18,0.778,116,44,92,0.478,31,69,0.449,13,23,0.565,21,22,0.955,122
761,PHI,2019-12-28,116,@,MIA,0,265,42,89,0.472,32,59,0.542,10,30,0.333,22,29,0.759,116,42,94,0.447,32,66,0.485,10,28,0.357,23,29,0.793,117
762,CHI,2019-12-28,116,,ATL,1,240,43,87,0.494,28,56,0.5,15,31,0.484,15,19,0.789,116,32,86,0.372,23,52,0.442,9,34,0.265,8,11,0.727,81
763,GSW,2019-12-25,116,,HOU,1,240,41,87,0.471,32,59,0.542,9,28,0.321,25,28,0.893,116,37,100,0.37,21,49,0.429,16,51,0.314,14,16,0.875,104
764,MIL,2019-12-16,116,,DAL,0,240,44,105,0.419,33,64,0.516,11,41,0.268,17,24,0.708,116,41,88,0.466,25,47,0.532,16,41,0.39,22,27,0.815,120
765,PHI,2019-12-13,116,,NOP,1,240,43,87,0.494,36,67,0.537,7,20,0.35,23,34,0.676,116,38,88,0.432,29,64,0.453,9,24,0.375,24,35,0.686,109
766,MIN,2019-12-11,116,,UTA,0,240,40,91,0.44,25,50,0.5,15,41,0.366,21,26,0.808,116,47,83,0.566,31,48,0.646,16,35,0.457,17,22,0.773,127
767,HOU,2019-12-11,116,@,CLE,1,240,43,87,0.494,26,45,0.578,17,42,0.405,13,13,1.0,116,46,89,0.517,33,57,0.579,13,32,0.406,5,8,0.625,110
768,SAC,2019-12-04,116,@,POR,0,240,44,95,0.463,33,61,0.541,11,34,0.324,17,23,0.739,116,47,84,0.56,31,52,0.596,16,32,0.5,17,21,0.81,127
769,IND,2019-11-30,116,@,PHI,0,240,42,76,0.553,31,54,0.574,11,22,0.5,21,25,0.84,116,38,77,0.494,27,54,0.5,11,23,0.478,32,36,0.889,119
770,ORL,2019-11-27,116,@,CLE,1,240,45,93,0.484,33,60,0.55,12,33,0.364,14,17,0.824,116,37,81,0.457,26,47,0.553,11,34,0.324,19,22,0.864,104
771,DEN,2019-11-24,116,,PHO,1,240,43,91,0.473,29,60,0.483,14,31,0.452,16,23,0.696,116,41,82,0.5,29,47,0.617,12,35,0.343,10,12,0.833,104
772,ATL,2019-11-23,116,,TOR,0,240,47,90,0.522,33,56,0.589,14,34,0.412,8,11,0.727,116,40,88,0.455,27,51,0.529,13,37,0.351,26,30,0.867,119
773,CHI,2019-11-23,116,@,CHO,1,240,43,95,0.453,21,48,0.438,22,47,0.468,8,12,0.667,116,44,80,0.55,32,52,0.615,12,28,0.429,15,22,0.682,115
774,MIA,2019-11-22,116,@,CHI,1,240,39,79,0.494,25,41,0.61,14,38,0.368,24,28,0.857,116,41,90,0.456,31,60,0.517,10,30,0.333,16,20,0.8,108
775,BRK,2019-11-22,116,,SAC,1,240,41,81,0.506,29,47,0.617,12,34,0.353,22,31,0.71,116,39,86,0.453,35,60,0.583,4,26,0.154,15,19,0.789,97
776,PHO,2019-11-19,116,@,SAC,0,240,38,89,0.427,26,53,0.491,12,36,0.333,28,34,0.824,116,42,79,0.532,29,48,0.604,13,31,0.419,23,25,0.92,120
777,SAS,2019-11-16,116,,POR,0,240,41,88,0.466,36,70,0.514,5,18,0.278,29,34,0.853,116,42,93,0.452,29,54,0.537,13,39,0.333,24,26,0.923,121
778,MIN,2019-11-15,116,,WAS,0,240,42,89,0.472,31,52,0.596,11,37,0.297,21,29,0.724,116,54,100,0.54,44,72,0.611,10,28,0.357,19,25,0.76,137
779,NOP,2019-11-11,116,,HOU,0,240,41,95,0.432,27,50,0.54,14,45,0.311,20,27,0.741,116,44,85,0.518,32,44,0.727,12,41,0.293,22,32,0.688,122
780,BOS,2019-11-11,116,,DAL,1,240,41,86,0.477,26,51,0.51,15,35,0.429,19,25,0.76,116,37,89,0.416,26,47,0.553,11,42,0.262,21,28,0.75,106
781,HOU,2019-11-01,116,@,BRK,0,240,41,99,0.414,29,51,0.569,12,48,0.25,22,27,0.815,116,42,85,0.494,23,53,0.434,19,32,0.594,20,28,0.714,123
782,BOS,2019-10-30,116,,MIL,1,240,41,92,0.446,24,51,0.471,17,41,0.415,17,21,0.81,116,38,82,0.463,24,37,0.649,14,45,0.311,15,24,0.625,105
783,HOU,2019-10-28,116,,OKC,1,240,39,90,0.433,29,46,0.63,10,44,0.227,28,33,0.848,116,41,94,0.436,28,59,0.475,13,35,0.371,17,24,0.708,112
784,MIN,2019-10-27,116,,MIA,1,240,39,91,0.429,26,46,0.565,13,45,0.289,25,33,0.758,116,42,85,0.494,27,49,0.551,15,36,0.417,10,15,0.667,109
785,NOP,2019-10-25,116,,DAL,0,240,45,98,0.459,30,57,0.526,15,41,0.366,11,15,0.733,116,45,93,0.484,31,53,0.585,14,40,0.35,19,26,0.731,123
786,MIA,2020-08-12,115,@,OKC,0,240,42,86,0.488,28,44,0.636,14,42,0.333,17,20,0.85,115,39,89,0.438,23,47,0.489,16,42,0.381,22,27,0.815,116
787,DEN,2020-08-06,115,,POR,0,240,44,84,0.524,30,56,0.536,14,28,0.5,13,17,0.765,115,43,92,0.467,20,53,0.377,23,39,0.59,16,20,0.8,125
788,MEM,2020-08-05,115,@,UTA,0,240,43,91,0.473,32,62,0.516,11,29,0.379,18,25,0.72,115,38,84,0.452,20,39,0.513,18,45,0.4,30,33,0.909,124
789,BRK,2020-08-05,115,@,BOS,0,240,45,95,0.474,37,63,0.587,8,32,0.25,17,21,0.81,115,50,88,0.568,30,49,0.612,20,39,0.513,29,35,0.829,149
790,LAC,2020-08-04,115,,PHO,0,240,42,85,0.494,34,56,0.607,8,29,0.276,23,27,0.852,115,45,96,0.469,28,64,0.438,17,32,0.531,10,14,0.714,117
791,DAL,2020-08-02,115,@,PHO,0,240,38,93,0.409,32,62,0.516,6,31,0.194,33,37,0.892,115,42,93,0.452,30,60,0.5,12,33,0.364,21,23,0.913,117
792,NYK,2020-03-10,115,@,WAS,0,240,42,81,0.519,34,60,0.567,8,21,0.381,23,31,0.742,115,35,74,0.473,21,39,0.538,14,35,0.4,38,45,0.844,122
793,MEM,2020-03-10,115,,ORL,0,240,38,76,0.5,27,47,0.574,11,29,0.379,28,38,0.737,115,43,92,0.467,29,59,0.492,14,33,0.424,20,22,0.909,120
794,MIN,2020-03-04,115,,CHI,1,240,40,81,0.494,21,38,0.553,19,43,0.442,16,25,0.64,115,45,94,0.479,34,64,0.531,11,30,0.367,7,11,0.636,108
795,GSW,2020-02-29,115,@,PHO,1,240,41,87,0.471,32,57,0.561,9,30,0.3,24,32,0.75,115,34,83,0.41,22,54,0.407,12,29,0.414,19,23,0.826,99
796,CHI,2020-02-29,115,@,NYK,0,240,41,89,0.461,24,54,0.444,17,35,0.486,16,23,0.696,115,47,85,0.553,39,65,0.6,8,20,0.4,23,33,0.697,125
797,PHI,2020-02-27,115,,NYK,1,240,45,91,0.495,30,60,0.5,15,31,0.484,10,13,0.769,115,42,83,0.506,34,60,0.567,8,23,0.348,14,24,0.583,106
798,DEN,2020-02-25,115,,DET,1,240,44,76,0.579,35,57,0.614,9,19,0.474,18,22,0.818,115,33,81,0.407,18,40,0.45,15,41,0.366,17,21,0.81,98
799,ORL,2020-02-24,115,@,BRK,1,240,44,89,0.494,31,55,0.564,13,34,0.382,14,17,0.824,115,46,96,0.479,30,59,0.508,16,37,0.432,5,8,0.625,113
800,NOP,2020-02-23,115,@,GSW,1,240,46,98,0.469,29,56,0.518,17,42,0.405,6,13,0.462,115,40,92,0.435,29,57,0.509,11,35,0.314,10,15,0.667,101
801,BRK,2020-02-22,115,@,CHO,1,240,42,87,0.483,25,40,0.625,17,47,0.362,14,19,0.737,115,31,88,0.352,19,53,0.358,12,35,0.343,12,21,0.571,86
802,POR,2020-02-21,115,,NOP,0,240,43,94,0.457,33,67,0.493,10,27,0.37,19,25,0.76,115,45,84,0.536,27,50,0.54,18,34,0.529,20,33,0.606,128
803,CHO,2020-02-12,115,@,MIN,1,240,43,92,0.467,29,58,0.5,14,34,0.412,15,23,0.652,115,39,101,0.386,25,52,0.481,14,49,0.286,16,20,0.8,108
804,POR,2020-02-09,115,,MIA,1,240,40,85,0.471,21,43,0.488,19,42,0.452,16,22,0.727,115,39,98,0.398,19,49,0.388,20,49,0.408,11,14,0.786,109
805,LAC,2020-02-08,115,@,MIN,0,240,41,86,0.477,32,60,0.533,9,26,0.346,24,29,0.828,115,52,95,0.547,26,51,0.51,26,44,0.591,12,18,0.667,142
806,TOR,2020-02-07,115,@,IND,1,240,42,88,0.477,25,50,0.5,17,38,0.447,14,17,0.824,115,39,86,0.453,29,52,0.558,10,34,0.294,18,22,0.818,106
807,ATL,2020-02-03,115,,BOS,0,240,42,84,0.5,30,54,0.556,12,30,0.4,19,21,0.905,115,48,90,0.533,36,61,0.59,12,29,0.414,15,17,0.882,123
808,MIL,2020-01-31,115,,DEN,0,240,43,95,0.453,31,55,0.564,12,40,0.3,17,26,0.654,115,48,100,0.48,26,54,0.481,22,46,0.478,9,9,1.0,127
809,TOR,2020-01-30,115,@,CLE,1,240,41,84,0.488,29,52,0.558,12,32,0.375,21,28,0.75,115,42,90,0.467,29,54,0.537,13,36,0.361,12,14,0.857,109
810,DET,2020-01-29,115,@,BRK,0,240,42,83,0.506,32,57,0.561,10,26,0.385,21,28,0.75,115,43,85,0.506,28,46,0.609,15,39,0.385,24,30,0.8,125
811,IND,2020-01-29,115,,CHI,1,265,46,89,0.517,39,62,0.629,7,27,0.259,16,22,0.727,115,45,85,0.529,39,52,0.75,6,33,0.182,10,15,0.667,106
812,PHI,2020-01-28,115,,GSW,1,240,42,82,0.512,31,50,0.62,11,32,0.344,20,26,0.769,115,37,87,0.425,22,47,0.468,15,40,0.375,15,21,0.714,104
813,CLE,2020-01-27,115,@,DET,1,240,48,96,0.5,39,72,0.542,9,24,0.375,10,13,0.769,115,38,84,0.452,26,49,0.531,12,35,0.343,12,17,0.706,100
814,IND,2020-01-19,115,@,DEN,1,240,43,86,0.5,30,57,0.526,13,29,0.448,16,19,0.842,115,41,88,0.466,38,65,0.585,3,23,0.13,22,32,0.688,107
815,HOU,2020-01-18,115,,LAL,0,240,40,90,0.444,28,53,0.528,12,37,0.324,23,29,0.793,115,45,93,0.484,34,60,0.567,11,33,0.333,23,32,0.719,124
816,MIA,2020-01-17,115,@,OKC,1,240,41,84,0.488,27,48,0.563,14,36,0.389,19,24,0.792,115,37,84,0.44,19,38,0.5,18,46,0.391,16,18,0.889,108
817,CHI,2020-01-15,115,,WAS,1,240,43,85,0.506,29,47,0.617,14,38,0.368,15,22,0.682,115,37,79,0.468,26,52,0.5,11,27,0.407,21,26,0.808,106
818,POR,2020-01-13,115,,CHO,1,240,42,83,0.506,26,46,0.565,16,37,0.432,15,19,0.789,115,40,90,0.444,22,52,0.423,18,38,0.474,14,18,0.778,112
819,CLE,2020-01-09,115,@,DET,1,265,48,91,0.527,43,71,0.606,5,20,0.25,14,20,0.7,115,48,98,0.49,42,78,0.538,6,20,0.3,10,16,0.625,112
820,ATL,2020-01-08,115,,HOU,0,240,39,106,0.368,26,62,0.419,13,44,0.295,24,27,0.889,115,39,92,0.424,26,47,0.553,13,45,0.289,31,41,0.756,122
821,DET,2020-01-07,115,@,CLE,1,240,42,91,0.462,29,58,0.5,13,33,0.394,18,21,0.857,115,42,85,0.494,28,54,0.519,14,31,0.452,15,16,0.938,113
822,ATL,2020-01-06,115,,DEN,0,240,35,77,0.455,17,38,0.447,18,39,0.462,27,32,0.844,115,47,92,0.511,38,65,0.585,9,27,0.333,20,27,0.741,123
823,IND,2020-01-06,115,@,CHO,1,240,47,89,0.528,37,63,0.587,10,26,0.385,11,14,0.786,115,37,81,0.457,27,51,0.529,10,30,0.333,20,22,0.909,104
824,SAC,2020-01-04,115,,NOP,0,240,38,85,0.447,26,64,0.406,12,21,0.571,27,36,0.75,115,38,87,0.437,22,42,0.524,16,45,0.356,25,33,0.758,117
825,IND,2019-12-31,115,,PHI,1,240,42,86,0.488,31,61,0.508,11,25,0.44,20,26,0.769,115,37,91,0.407,31,62,0.5,6,29,0.207,17,20,0.85,97
826,BRK,2019-12-30,115,@,MIN,0,265,40,99,0.404,25,58,0.431,15,41,0.366,20,27,0.741,115,42,104,0.404,25,60,0.417,17,44,0.386,21,29,0.724,122
827,SAC,2019-12-29,115,@,DEN,0,240,45,85,0.529,32,51,0.627,13,34,0.382,12,17,0.706,115,42,81,0.519,34,52,0.654,8,29,0.276,28,31,0.903,120
828,POR,2019-12-26,115,@,UTA,0,240,43,89,0.483,28,55,0.509,15,34,0.441,14,19,0.737,115,46,81,0.568,32,45,0.711,14,36,0.389,15,22,0.682,121
829,MEM,2019-12-23,115,,SAS,0,240,45,96,0.469,30,59,0.508,15,37,0.405,10,16,0.625,115,60,89,0.674,45,65,0.692,15,24,0.625,10,14,0.714,145
830,NYK,2019-12-23,115,,WAS,0,240,44,93,0.473,29,57,0.509,15,36,0.417,12,15,0.8,115,47,100,0.47,37,70,0.529,10,30,0.333,17,30,0.567,121
831,TOR,2019-12-23,115,@,IND,0,265,43,94,0.457,32,54,0.593,11,40,0.275,18,24,0.75,115,45,95,0.474,27,53,0.509,18,42,0.429,12,20,0.6,120
832,SAC,2019-12-21,115,@,MEM,0,240,43,100,0.43,32,64,0.5,11,36,0.306,18,24,0.75,115,40,83,0.482,25,48,0.521,15,35,0.429,24,29,0.828,119
833,DET,2019-12-14,115,@,HOU,1,240,41,92,0.446,29,55,0.527,12,37,0.324,21,25,0.84,115,41,102,0.402,28,57,0.491,13,45,0.289,12,18,0.667,107
834,PHI,2019-12-12,115,@,BOS,1,240,41,82,0.5,27,54,0.5,14,28,0.5,19,23,0.826,115,42,91,0.462,31,60,0.517,11,31,0.355,14,17,0.824,109
835,MEM,2019-12-11,115,@,PHO,1,240,42,87,0.483,32,63,0.508,10,24,0.417,21,26,0.808,115,37,93,0.398,28,59,0.475,9,34,0.265,25,30,0.833,108
836,POR,2019-12-10,115,,NYK,1,240,39,90,0.433,22,49,0.449,17,41,0.415,20,24,0.833,115,32,91,0.352,25,53,0.472,7,38,0.184,16,26,0.615,87
837,HOU,2019-12-07,115,,PHO,1,240,41,91,0.451,30,51,0.588,11,40,0.275,22,30,0.733,115,40,96,0.417,29,61,0.475,11,35,0.314,18,28,0.643,109
838,MEM,2019-12-01,115,@,MIN,1,240,41,100,0.41,25,60,0.417,16,40,0.4,17,21,0.81,115,33,85,0.388,22,49,0.449,11,36,0.306,30,35,0.857,107
839,CHO,2019-11-23,115,,CHI,0,240,44,80,0.55,32,52,0.615,12,28,0.429,15,22,0.682,115,43,95,0.453,21,48,0.438,22,47,0.468,8,12,0.667,116
840,PHI,2019-11-22,115,,SAS,1,240,46,89,0.517,36,63,0.571,10,26,0.385,13,19,0.684,115,43,85,0.506,37,67,0.552,6,18,0.333,12,16,0.75,104
841,NOP,2019-11-19,115,,POR,1,240,41,93,0.441,28,57,0.491,13,36,0.361,20,24,0.833,115,40,92,0.435,24,63,0.381,16,29,0.552,8,13,0.615,104
842,MIL,2019-11-18,115,@,CHI,1,240,38,82,0.463,23,41,0.561,15,41,0.366,24,35,0.686,115,39,97,0.402,27,63,0.429,12,34,0.353,11,14,0.786,101
843,IND,2019-11-18,115,@,BRK,1,240,44,101,0.436,30,68,0.441,14,33,0.424,13,17,0.765,115,30,84,0.357,19,50,0.38,11,34,0.324,15,24,0.625,86
844,CHI,2019-11-14,115,@,MIL,0,240,38,93,0.409,20,50,0.4,18,43,0.419,21,25,0.84,115,42,88,0.477,36,55,0.655,6,33,0.182,34,47,0.723,124
845,PHO,2019-11-12,115,,LAL,0,240,43,91,0.473,27,53,0.509,16,38,0.421,13,17,0.765,115,51,95,0.537,41,70,0.586,10,25,0.4,11,21,0.524,123
846,NOP,2019-11-09,115,@,CHO,1,240,40,75,0.533,26,42,0.619,14,33,0.424,21,30,0.7,115,36,88,0.409,24,53,0.453,12,35,0.343,26,34,0.765,110
847,SAS,2019-11-09,115,,BOS,0,240,39,99,0.394,25,69,0.362,14,30,0.467,23,30,0.767,115,48,94,0.511,34,57,0.596,14,37,0.378,25,28,0.893,135
848,POR,2019-11-08,115,,BRK,0,240,40,97,0.412,29,67,0.433,11,30,0.367,24,25,0.96,115,41,99,0.414,25,62,0.403,16,37,0.432,21,30,0.7,119
849,WAS,2019-11-04,115,,DET,1,240,43,93,0.462,35,64,0.547,8,29,0.276,21,25,0.84,115,34,82,0.415,21,55,0.382,13,27,0.481,18,23,0.783,99
850,OKC,2019-11-02,115,,NOP,1,240,41,90,0.456,26,53,0.491,15,37,0.405,18,23,0.783,115,40,94,0.426,29,62,0.468,11,32,0.344,13,22,0.591,104
851,MIL,2019-11-02,115,,TOR,1,240,41,89,0.461,28,51,0.549,13,38,0.342,20,25,0.8,115,34,84,0.405,19,48,0.396,15,36,0.417,22,25,0.88,105
852,UTA,2020-08-10,114,,DAL,0,240,39,82,0.476,18,36,0.5,21,46,0.457,15,20,0.75,114,48,85,0.565,36,61,0.59,12,24,0.5,14,16,0.875,122
853,TOR,2020-08-10,114,@,MIL,1,240,42,97,0.433,30,57,0.526,12,40,0.3,18,26,0.692,114,33,84,0.393,19,41,0.463,14,43,0.326,26,35,0.743,106
854,MIA,2020-08-10,114,,IND,1,240,44,98,0.449,31,58,0.534,13,40,0.325,13,19,0.684,114,33,84,0.393,23,49,0.469,10,35,0.286,16,25,0.64,92
855,PHO,2020-08-06,114,,IND,1,240,43,92,0.467,34,58,0.586,9,34,0.265,19,20,0.95,114,37,85,0.435,27,56,0.482,10,29,0.345,15,19,0.789,99
856,DAL,2020-08-04,114,@,SAC,1,265,33,90,0.367,24,49,0.49,9,41,0.22,39,50,0.78,114,43,104,0.413,27,61,0.443,16,43,0.372,8,12,0.667,110
857,BOS,2020-03-10,114,@,IND,1,240,41,93,0.441,28,56,0.5,13,37,0.351,19,22,0.864,114,46,93,0.495,37,69,0.536,9,24,0.375,10,11,0.909,111
858,PHI,2020-03-07,114,@,GSW,0,240,41,84,0.488,28,50,0.56,13,34,0.382,19,22,0.864,114,44,80,0.55,35,55,0.636,9,25,0.36,21,28,0.75,118
859,DEN,2020-03-05,114,@,CHO,1,240,44,83,0.53,36,57,0.632,8,26,0.308,18,20,0.9,114,38,77,0.494,25,44,0.568,13,33,0.394,23,28,0.821,112
860,OKC,2020-03-04,114,@,DET,1,240,46,75,0.613,36,51,0.706,10,24,0.417,12,17,0.706,114,40,86,0.465,22,43,0.512,18,43,0.419,9,15,0.6,107
861,PHO,2020-03-03,114,,TOR,0,240,39,85,0.459,24,46,0.522,15,39,0.385,21,25,0.84,114,40,86,0.465,26,52,0.5,14,34,0.412,29,35,0.829,123
862,NOP,2020-03-01,114,,LAL,0,240,40,95,0.421,33,63,0.524,7,32,0.219,27,33,0.818,114,50,97,0.515,37,62,0.597,13,35,0.371,9,10,0.9,122
863,SAS,2020-02-29,114,,ORL,1,240,44,84,0.524,30,53,0.566,14,31,0.452,12,16,0.75,114,41,84,0.488,26,47,0.553,15,37,0.405,16,23,0.696,113
864,BOS,2020-02-26,114,@,UTA,1,240,45,84,0.536,34,58,0.586,11,26,0.423,13,16,0.813,114,40,89,0.449,28,49,0.571,12,40,0.3,11,15,0.733,103
865,LAL,2020-02-23,114,,BOS,1,240,39,86,0.453,28,52,0.538,11,34,0.324,25,37,0.676,114,38,83,0.458,25,49,0.51,13,34,0.382,23,30,0.767,112
866,WAS,2020-02-12,114,@,NYK,1,240,40,84,0.476,30,56,0.536,10,28,0.357,24,33,0.727,114,36,88,0.409,33,65,0.508,3,23,0.13,21,29,0.724,96
867,SAS,2020-02-11,114,@,OKC,1,240,41,84,0.488,34,59,0.576,7,25,0.28,25,27,0.926,114,39,85,0.459,28,54,0.519,11,31,0.355,17,21,0.81,106
868,CHI,2020-02-11,114,@,WAS,0,240,44,92,0.478,28,53,0.528,16,39,0.41,10,14,0.714,114,48,89,0.539,37,57,0.649,11,32,0.344,19,24,0.792,126
869,UTA,2020-02-09,114,@,HOU,1,240,42,86,0.488,27,48,0.563,15,38,0.395,15,18,0.833,114,44,95,0.463,29,53,0.547,15,42,0.357,10,14,0.714,113
870,POR,2020-02-07,114,@,UTA,0,240,44,97,0.454,27,57,0.474,17,40,0.425,9,14,0.643,114,45,91,0.495,35,61,0.574,10,30,0.333,17,24,0.708,117
871,SAS,2020-02-01,114,,CHO,1,240,45,87,0.517,35,59,0.593,10,28,0.357,14,21,0.667,114,35,83,0.422,25,47,0.532,10,36,0.278,10,12,0.833,90
872,ATL,2020-01-28,114,@,TOR,0,240,41,92,0.446,29,45,0.644,12,47,0.255,20,25,0.8,114,48,97,0.495,35,54,0.648,13,43,0.302,21,27,0.778,130
873,MEM,2020-01-26,114,,PHO,1,240,44,84,0.524,36,65,0.554,8,19,0.421,18,26,0.692,114,35,92,0.38,24,63,0.381,11,29,0.379,28,35,0.8,109
874,ORL,2020-01-22,114,,OKC,0,240,44,92,0.478,30,57,0.526,14,35,0.4,12,16,0.75,114,46,76,0.605,37,57,0.649,9,19,0.474,19,23,0.826,120
875,MIN,2020-01-17,114,@,IND,0,240,40,88,0.455,23,49,0.469,17,39,0.436,17,21,0.81,114,46,82,0.561,38,58,0.655,8,24,0.333,16,20,0.8,116
876,ORL,2020-01-13,114,@,SAC,1,240,40,92,0.435,31,63,0.492,9,29,0.31,25,30,0.833,114,45,87,0.517,33,56,0.589,12,31,0.387,10,11,0.909,112
877,DEN,2020-01-12,114,,LAC,1,240,37,77,0.481,26,52,0.5,11,25,0.44,29,37,0.784,114,38,84,0.452,30,51,0.588,8,33,0.242,20,26,0.769,104
878,DAL,2020-01-10,114,,LAL,0,240,39,96,0.406,28,58,0.483,11,38,0.289,25,37,0.676,114,47,89,0.528,37,65,0.569,10,24,0.417,25,32,0.781,129
879,BOS,2020-01-08,114,,SAS,0,240,37,89,0.416,24,51,0.471,13,38,0.342,27,30,0.9,114,48,87,0.552,39,58,0.672,9,29,0.31,24,26,0.923,129
880,SAC,2020-01-07,114,@,PHO,1,240,37,84,0.44,22,48,0.458,15,36,0.417,25,28,0.893,114,37,77,0.481,26,42,0.619,11,35,0.314,18,22,0.818,103
881,PHO,2020-01-05,114,,MEM,0,240,43,95,0.453,37,69,0.536,6,26,0.231,22,26,0.846,114,45,83,0.542,27,41,0.659,18,42,0.429,13,17,0.765,121
882,DEN,2020-01-04,114,@,WAS,0,240,40,87,0.46,34,58,0.586,6,29,0.207,28,34,0.824,114,50,91,0.549,44,75,0.587,6,16,0.375,22,27,0.815,128
883,LAC,2020-01-04,114,,MEM,0,240,45,101,0.446,38,71,0.535,7,30,0.233,17,22,0.773,114,49,96,0.51,31,57,0.544,18,39,0.462,24,28,0.857,140
884,UTA,2019-12-21,114,@,CHO,1,240,39,75,0.52,22,41,0.537,17,34,0.5,19,20,0.95,114,39,85,0.459,27,56,0.482,12,29,0.414,17,22,0.773,107
885,BOS,2019-12-20,114,,DET,1,240,45,86,0.523,36,59,0.61,9,27,0.333,15,21,0.714,114,34,85,0.4,23,54,0.426,11,31,0.355,14,19,0.737,93
886,CLE,2019-12-20,114,,MEM,1,240,40,92,0.435,23,55,0.418,17,37,0.459,17,23,0.739,114,44,102,0.431,30,61,0.492,14,41,0.341,5,7,0.714,107
887,NYK,2019-12-20,114,@,MIA,0,240,41,94,0.436,31,60,0.517,10,34,0.294,22,33,0.667,114,43,77,0.558,25,39,0.641,18,38,0.474,25,34,0.735,129
888,MEM,2019-12-13,114,,MIL,0,240,38,98,0.388,18,49,0.367,20,49,0.408,18,23,0.783,114,44,87,0.506,33,57,0.579,11,30,0.367,28,33,0.848,127
889,UTA,2019-12-13,114,,GSW,1,240,37,79,0.468,21,41,0.512,16,38,0.421,24,31,0.774,114,41,91,0.451,32,62,0.516,9,29,0.31,15,22,0.682,106
890,DEN,2019-12-12,114,,POR,1,240,42,88,0.477,24,52,0.462,18,36,0.5,12,19,0.632,114,41,86,0.477,32,56,0.571,9,30,0.3,8,11,0.727,99
891,CHO,2019-12-10,114,,WAS,1,240,38,85,0.447,22,44,0.5,16,41,0.39,22,28,0.786,114,38,90,0.422,27,55,0.491,11,35,0.314,20,25,0.8,107
892,PHO,2019-12-04,114,@,ORL,0,240,43,88,0.489,28,55,0.509,15,33,0.455,13,20,0.65,114,49,85,0.576,35,60,0.583,14,25,0.56,16,20,0.8,128
893,MIN,2019-12-04,114,@,DAL,0,240,37,89,0.416,20,51,0.392,17,38,0.447,23,26,0.885,114,46,92,0.5,35,55,0.636,11,37,0.297,18,23,0.783,121
894,DAL,2019-12-01,114,@,LAL,1,240,42,97,0.433,25,48,0.521,17,49,0.347,13,18,0.722,114,40,87,0.46,33,60,0.55,7,27,0.259,13,16,0.813,100
895,LAL,2019-11-27,114,@,NOP,1,240,44,85,0.518,36,61,0.59,8,24,0.333,18,25,0.72,114,34,84,0.405,17,44,0.386,17,40,0.425,25,30,0.833,110
896,LAC,2019-11-26,114,@,DAL,1,240,41,97,0.423,30,64,0.469,11,33,0.333,21,30,0.7,114,30,79,0.38,19,41,0.463,11,38,0.289,28,35,0.8,99
897,LAL,2019-11-25,114,@,SAS,1,240,44,89,0.494,30,56,0.536,14,33,0.424,12,18,0.667,114,41,88,0.466,31,63,0.492,10,25,0.4,12,15,0.8,104
898,MEM,2019-11-25,114,@,IND,0,240,46,96,0.479,33,67,0.493,13,29,0.448,9,13,0.692,114,51,94,0.543,33,61,0.541,18,33,0.545,6,10,0.6,126
899,GSW,2019-11-19,114,@,MEM,1,240,43,90,0.478,34,61,0.557,9,29,0.31,19,22,0.864,114,36,88,0.409,27,63,0.429,9,25,0.36,14,19,0.737,95
900,MEM,2019-11-17,114,,DEN,0,240,39,84,0.464,23,48,0.479,16,36,0.444,20,24,0.833,114,49,89,0.551,31,57,0.544,18,32,0.563,15,23,0.652,131
901,PHI,2019-11-17,114,@,CLE,1,240,46,84,0.548,37,61,0.607,9,23,0.391,13,17,0.765,114,34,90,0.378,28,65,0.431,6,25,0.24,21,24,0.875,95
902,SAS,2019-11-13,114,@,MIN,0,240,44,90,0.489,41,73,0.562,3,17,0.176,23,29,0.793,114,45,91,0.495,34,57,0.596,11,34,0.324,28,34,0.824,129
903,TOR,2019-11-13,114,@,POR,1,240,42,92,0.457,28,60,0.467,14,32,0.438,16,17,0.941,114,38,96,0.396,21,48,0.438,17,48,0.354,13,16,0.813,106
904,BRK,2019-11-12,114,@,UTA,0,240,41,90,0.456,30,53,0.566,11,37,0.297,21,25,0.84,114,43,92,0.467,37,66,0.561,6,26,0.231,27,35,0.771,119
905,DET,2019-11-11,114,,MIN,0,240,39,87,0.448,23,55,0.418,16,32,0.5,20,25,0.8,114,45,89,0.506,30,55,0.545,15,34,0.441,15,19,0.789,120
906,PHI,2019-11-10,114,,CHO,1,240,46,84,0.548,36,56,0.643,10,28,0.357,12,16,0.75,114,38,84,0.452,24,51,0.471,14,33,0.424,16,22,0.727,106
907,OKC,2019-11-09,114,,GSW,1,240,43,79,0.544,29,49,0.592,14,30,0.467,14,17,0.824,114,42,85,0.494,35,63,0.556,7,22,0.318,17,17,1.0,108
908,PHO,2019-11-04,114,,PHI,1,240,41,77,0.532,30,49,0.612,11,28,0.393,21,27,0.778,114,42,89,0.472,29,60,0.483,13,29,0.448,12,20,0.6,109
909,PHO,2019-11-02,114,@,MEM,1,240,44,88,0.5,30,54,0.556,14,34,0.412,12,16,0.75,114,42,86,0.488,33,58,0.569,9,28,0.321,12,19,0.632,105
910,WAS,2020-08-11,113,,MIL,0,240,39,95,0.411,27,60,0.45,12,35,0.343,23,30,0.767,113,44,87,0.506,26,49,0.531,18,38,0.474,20,28,0.714,126
911,NOP,2020-08-09,113,,SAS,0,240,42,96,0.438,30,66,0.455,12,30,0.4,17,22,0.773,113,40,89,0.449,29,61,0.475,11,28,0.393,31,32,0.969,122
912,HOU,2020-08-06,113,,LAL,1,240,36,84,0.429,15,27,0.556,21,57,0.368,20,23,0.87,113,35,77,0.455,33,58,0.569,2,19,0.105,25,36,0.694,97
913,OKC,2020-08-03,113,,DEN,0,265,37,87,0.425,22,51,0.431,15,36,0.417,24,31,0.774,113,42,87,0.483,35,62,0.565,7,25,0.28,30,39,0.769,121
914,DAL,2020-03-11,113,,DEN,1,240,42,92,0.457,30,57,0.526,12,35,0.343,17,23,0.739,113,39,83,0.47,25,44,0.568,14,39,0.359,5,8,0.625,97
915,SAC,2020-03-08,113,,TOR,0,240,42,90,0.467,34,59,0.576,8,31,0.258,21,23,0.913,113,39,82,0.476,20,34,0.588,19,48,0.396,21,27,0.778,118
916,LAL,2020-03-06,113,,MIL,1,240,38,91,0.418,32,59,0.542,6,32,0.188,31,38,0.816,113,37,89,0.416,25,46,0.543,12,43,0.279,17,23,0.739,103
917,GSW,2020-03-05,113,,TOR,0,240,40,98,0.408,26,46,0.565,14,52,0.269,19,25,0.76,113,40,84,0.476,27,43,0.628,13,41,0.317,28,31,0.903,121
918,ORL,2020-03-04,113,@,MIA,0,240,44,84,0.524,31,54,0.574,13,30,0.433,12,14,0.857,113,41,79,0.519,19,35,0.543,22,44,0.5,12,15,0.8,116
919,CLE,2020-03-02,113,,UTA,0,240,42,91,0.462,25,50,0.5,17,41,0.415,12,18,0.667,113,47,83,0.566,27,42,0.643,20,41,0.488,12,14,0.857,126
920,ORL,2020-02-29,113,@,SAS,0,240,41,84,0.488,26,47,0.553,15,37,0.405,16,23,0.696,113,44,84,0.524,30,53,0.566,14,31,0.452,12,16,0.75,114
921,IND,2020-02-29,113,@,CLE,1,240,47,87,0.54,39,64,0.609,8,23,0.348,11,14,0.786,113,41,85,0.482,36,63,0.571,5,22,0.227,17,20,0.85,104
922,BRK,2020-02-29,113,@,MIA,0,240,40,86,0.465,24,42,0.571,16,44,0.364,17,23,0.739,113,41,91,0.451,27,53,0.509,14,38,0.368,20,24,0.833,116
923,DET,2020-02-28,113,@,PHO,1,240,44,90,0.489,31,58,0.534,13,32,0.406,12,16,0.75,113,45,75,0.6,36,52,0.692,9,23,0.391,12,17,0.706,111
924,BRK,2020-02-24,113,,ORL,0,240,46,96,0.479,30,59,0.508,16,37,0.432,5,8,0.625,113,44,89,0.494,31,55,0.564,13,34,0.382,14,17,0.824,115
925,SAS,2020-02-21,113,@,UTA,1,240,40,91,0.44,30,71,0.423,10,20,0.5,23,26,0.885,113,35,82,0.427,23,49,0.469,12,33,0.364,22,26,0.846,104
926,OKC,2020-02-21,113,,DEN,1,240,40,87,0.46,31,61,0.508,9,26,0.346,24,27,0.889,113,37,77,0.481,31,50,0.62,6,27,0.222,21,23,0.913,101
927,CLE,2020-02-21,113,@,WAS,1,240,43,81,0.531,32,54,0.593,11,27,0.407,16,25,0.64,113,41,106,0.387,32,69,0.464,9,37,0.243,17,23,0.739,108
928,MIA,2020-02-10,113,@,GSW,1,240,43,87,0.494,31,54,0.574,12,33,0.364,15,21,0.714,113,30,77,0.39,19,43,0.442,11,34,0.324,30,34,0.882,101
929,HOU,2020-02-09,113,,UTA,0,240,44,95,0.463,29,53,0.547,15,42,0.357,10,14,0.714,113,42,86,0.488,27,48,0.563,15,38,0.395,15,18,0.833,114
930,SAC,2020-02-03,113,,MIN,1,240,38,75,0.507,24,48,0.5,14,27,0.519,23,31,0.742,113,37,85,0.435,24,47,0.511,13,38,0.342,22,28,0.786,109
931,WAS,2020-02-01,113,,BRK,1,240,44,100,0.44,35,68,0.515,9,32,0.281,16,26,0.615,113,39,94,0.415,23,47,0.489,16,47,0.34,13,21,0.619,107
932,SAC,2020-02-01,113,,LAL,0,240,39,91,0.429,25,47,0.532,14,44,0.318,21,26,0.808,113,44,86,0.512,25,43,0.581,19,43,0.442,22,27,0.815,129
933,MIA,2020-01-27,113,,ORL,1,240,42,79,0.532,28,51,0.549,14,28,0.5,15,16,0.938,113,33,89,0.371,22,52,0.423,11,37,0.297,15,19,0.789,92
934,OKC,2020-01-25,113,@,MIN,1,240,39,80,0.488,28,56,0.5,11,24,0.458,24,25,0.96,113,40,90,0.444,28,47,0.596,12,43,0.279,12,18,0.667,104
935,DEN,2020-01-24,113,@,NOP,1,240,40,106,0.377,27,65,0.415,13,41,0.317,20,20,1.0,113,38,82,0.463,26,55,0.473,12,27,0.444,18,30,0.6,106
936,BRK,2020-01-23,113,,LAL,0,240,40,91,0.44,19,45,0.422,21,46,0.457,12,15,0.8,113,47,94,0.5,28,56,0.5,19,38,0.5,15,20,0.75,128
937,SAC,2020-01-20,113,@,MIA,0,265,44,106,0.415,31,55,0.564,13,51,0.255,12,15,0.8,113,42,83,0.506,26,41,0.634,16,42,0.381,18,22,0.818,118
938,MEM,2020-01-17,113,,CLE,1,240,45,89,0.506,36,61,0.59,9,28,0.321,14,20,0.7,113,41,92,0.446,32,56,0.571,9,36,0.25,18,26,0.692,109
939,BOS,2020-01-13,113,,CHI,1,240,39,83,0.47,30,60,0.5,9,23,0.391,26,29,0.897,113,37,81,0.457,31,56,0.554,6,25,0.24,21,26,0.808,101
940,MIA,2020-01-10,113,@,BRK,0,240,44,85,0.518,37,56,0.661,7,29,0.241,18,21,0.857,113,45,93,0.484,30,49,0.612,15,44,0.341,12,19,0.632,117
941,OKC,2020-01-09,113,,HOU,1,240,43,87,0.494,32,55,0.582,11,32,0.344,16,20,0.8,113,34,89,0.382,23,49,0.469,11,40,0.275,13,14,0.929,92
942,CLE,2020-01-07,113,,DET,0,240,42,85,0.494,28,54,0.519,14,31,0.452,15,16,0.938,113,42,91,0.462,29,58,0.5,13,33,0.394,18,21,0.857,115
943,OKC,2020-01-06,113,@,PHI,0,240,40,89,0.449,28,60,0.467,12,29,0.414,21,31,0.677,113,46,90,0.511,33,64,0.516,13,26,0.5,15,18,0.833,120
944,NOP,2020-01-03,113,@,LAL,0,240,48,102,0.471,37,65,0.569,11,37,0.297,6,7,0.857,113,43,86,0.5,29,57,0.509,14,29,0.483,23,28,0.821,123
945,GSW,2019-12-31,113,@,SAS,0,265,44,96,0.458,32,69,0.464,12,27,0.444,13,18,0.722,113,45,96,0.469,31,65,0.477,14,31,0.452,13,17,0.765,117
946,TOR,2019-12-28,113,@,BOS,1,240,44,84,0.524,30,50,0.6,14,34,0.412,11,17,0.647,113,31,78,0.397,24,46,0.522,7,32,0.219,28,36,0.778,97
947,MIA,2019-12-27,113,,IND,1,240,40,89,0.449,24,51,0.471,16,38,0.421,17,19,0.895,113,44,90,0.489,30,59,0.508,14,31,0.452,10,12,0.833,112
948,GSW,2019-12-23,113,,MIN,1,240,38,87,0.437,26,57,0.456,12,30,0.4,25,30,0.833,113,35,87,0.402,24,53,0.453,11,34,0.324,23,29,0.793,104
949,DEN,2019-12-23,113,@,PHO,1,240,43,78,0.551,28,50,0.56,15,28,0.536,12,15,0.8,113,42,87,0.483,29,50,0.58,13,37,0.351,14,18,0.778,111
950,HOU,2019-12-23,113,@,SAC,1,240,39,87,0.448,24,48,0.5,15,39,0.385,20,23,0.87,113,41,87,0.471,34,57,0.596,7,30,0.233,15,23,0.652,104
951,POR,2019-12-21,113,,MIN,1,240,40,94,0.426,27,59,0.458,13,35,0.371,20,25,0.8,113,38,87,0.437,23,50,0.46,15,37,0.405,15,16,0.938,106
952,DEN,2019-12-18,113,,ORL,1,240,40,84,0.476,29,57,0.509,11,27,0.407,22,25,0.88,113,37,87,0.425,26,58,0.448,11,29,0.379,19,21,0.905,104
953,CLE,2019-12-16,113,@,TOR,0,240,44,90,0.489,32,55,0.582,12,35,0.343,13,17,0.765,113,52,89,0.584,36,57,0.632,16,32,0.5,13,17,0.765,133
954,LAL,2019-12-13,113,@,MIA,1,240,43,87,0.494,31,50,0.62,12,37,0.324,15,23,0.652,113,39,85,0.459,29,52,0.558,10,33,0.303,22,28,0.786,110
955,CHO,2019-12-11,113,@,BRK,1,240,36,88,0.409,21,53,0.396,15,35,0.429,26,32,0.813,113,38,88,0.432,28,50,0.56,10,38,0.263,22,33,0.667,108
956,POR,2019-12-06,113,,LAL,0,240,39,86,0.453,29,52,0.558,10,34,0.294,25,29,0.862,113,46,85,0.541,29,49,0.592,17,36,0.472,27,33,0.818,136
957,PHI,2019-12-05,113,@,WAS,0,240,41,77,0.532,28,49,0.571,13,28,0.464,18,24,0.75,113,41,90,0.456,30,63,0.476,11,27,0.407,26,32,0.813,119
958,CHI,2019-12-02,113,@,SAC,1,240,36,75,0.48,20,38,0.526,16,37,0.432,25,29,0.862,113,40,83,0.482,31,50,0.62,9,33,0.273,17,20,0.85,106
959,BOS,2019-12-01,113,@,NYK,1,240,41,93,0.441,26,52,0.5,15,41,0.366,16,22,0.727,113,35,76,0.461,27,50,0.54,8,26,0.308,26,37,0.703,104
960,PHO,2019-11-29,113,,DAL,0,240,41,93,0.441,28,55,0.509,13,38,0.342,18,25,0.72,113,35,85,0.412,18,38,0.474,17,47,0.362,33,38,0.868,120
961,MIN,2019-11-27,113,@,SAS,1,240,37,85,0.435,19,45,0.422,18,40,0.45,21,27,0.778,113,41,97,0.423,36,68,0.529,5,29,0.172,14,17,0.824,101
962,ATL,2019-11-25,113,,MIN,0,240,41,94,0.436,31,62,0.5,10,32,0.313,21,26,0.808,113,41,90,0.456,26,55,0.473,15,35,0.429,28,36,0.778,125
963,SAC,2019-11-24,113,@,WAS,1,240,39,81,0.481,28,50,0.56,11,31,0.355,24,28,0.857,113,42,92,0.457,29,58,0.5,13,34,0.382,9,12,0.75,106
964,PHI,2019-11-23,113,,MIA,1,240,42,83,0.506,28,54,0.519,14,29,0.483,15,17,0.882,113,30,75,0.4,24,51,0.471,6,24,0.25,20,27,0.741,86
965,UTA,2019-11-22,113,,GSW,1,240,43,85,0.506,29,53,0.547,14,32,0.438,13,16,0.813,113,43,94,0.457,31,66,0.47,12,28,0.429,11,12,0.917,109
966,TOR,2019-11-20,113,,ORL,1,240,45,87,0.517,36,60,0.6,9,27,0.333,14,19,0.737,113,35,91,0.385,26,59,0.441,9,32,0.281,18,28,0.643,97
967,MEM,2019-11-11,113,@,SAS,1,240,44,87,0.506,33,59,0.559,11,28,0.393,14,20,0.7,113,42,90,0.467,30,60,0.5,12,30,0.4,13,17,0.765,109
968,ATL,2019-11-10,113,@,POR,0,265,42,104,0.404,31,63,0.492,11,41,0.268,18,25,0.72,113,45,104,0.433,33,68,0.485,12,36,0.333,22,28,0.786,124
969,TOR,2019-11-10,113,@,LAL,1,240,43,89,0.483,31,53,0.585,12,36,0.333,15,22,0.682,113,41,94,0.436,31,64,0.484,10,30,0.333,12,19,0.632,104
970,CLE,2019-11-08,113,@,WAS,1,240,41,90,0.456,35,63,0.556,6,27,0.222,25,29,0.862,113,45,96,0.469,38,65,0.585,7,31,0.226,3,6,0.5,100
971,CHI,2019-11-06,113,@,ATL,1,240,41,82,0.5,28,49,0.571,13,33,0.394,18,27,0.667,113,30,74,0.405,24,44,0.545,6,30,0.2,27,35,0.771,93
972,CLE,2019-11-05,113,,BOS,0,240,40,95,0.421,27,62,0.435,13,33,0.394,20,22,0.909,113,48,85,0.565,36,55,0.655,12,30,0.4,11,15,0.733,119
973,SAC,2019-11-03,113,@,NYK,1,240,41,85,0.482,26,46,0.565,15,39,0.385,16,25,0.64,113,32,80,0.4,24,49,0.49,8,31,0.258,20,31,0.645,92
974,DET,2019-11-02,113,,BRK,1,240,41,91,0.451,33,64,0.516,8,27,0.296,23,29,0.793,113,43,93,0.462,33,61,0.541,10,32,0.313,13,17,0.765,109
975,DET,2019-10-30,113,@,TOR,0,240,41,88,0.466,27,58,0.466,14,30,0.467,17,23,0.739,113,51,86,0.593,38,59,0.644,13,27,0.481,10,12,0.833,125
976,SAS,2019-10-28,113,,POR,1,240,41,85,0.482,34,63,0.54,7,22,0.318,24,32,0.75,113,39,100,0.39,29,67,0.433,10,33,0.303,22,27,0.815,110
977,UTA,2019-10-26,113,,SAC,1,240,44,78,0.564,26,41,0.634,18,37,0.486,7,12,0.583,113,30,81,0.37,23,55,0.418,7,26,0.269,14,17,0.824,81
978,BRK,2019-10-25,113,,NYK,1,240,37,78,0.474,21,41,0.512,16,37,0.432,23,34,0.676,113,38,81,0.469,21,56,0.375,17,25,0.68,16,28,0.571,109
979,SAS,2020-08-13,112,@,UTA,0,240,39,79,0.494,29,59,0.492,10,20,0.5,24,36,0.667,112,47,101,0.465,32,55,0.582,15,46,0.326,9,10,0.9,118
980,SAC,2020-08-11,112,,NOP,1,240,43,88,0.489,32,62,0.516,11,26,0.423,15,16,0.938,112,42,82,0.512,35,58,0.603,7,24,0.292,15,19,0.789,106
981,SAC,2020-08-09,112,,HOU,0,240,41,87,0.471,31,50,0.62,10,37,0.27,20,23,0.87,112,43,91,0.473,25,34,0.735,18,57,0.316,25,30,0.833,129
982,MIA,2020-08-08,112,,PHO,0,240,41,84,0.488,30,48,0.625,11,36,0.306,19,22,0.864,112,44,92,0.478,32,60,0.533,12,32,0.375,19,20,0.95,119
983,MIA,2020-08-04,112,,BOS,1,240,34,77,0.442,19,34,0.559,15,43,0.349,29,39,0.744,112,37,85,0.435,27,52,0.519,10,33,0.303,22,27,0.815,106
984,BOS,2020-07-31,112,@,MIL,0,240,37,91,0.407,26,54,0.481,11,37,0.297,27,34,0.794,112,39,84,0.464,26,43,0.605,13,41,0.317,28,34,0.824,119
985,WAS,2020-07-31,112,,PHO,0,240,42,91,0.462,34,69,0.493,8,22,0.364,20,23,0.87,112,42,80,0.525,31,48,0.646,11,32,0.344,30,32,0.938,125
986,IND,2020-03-08,112,@,DAL,1,240,46,88,0.523,38,65,0.585,8,23,0.348,12,18,0.667,112,39,91,0.429,25,48,0.521,14,43,0.326,17,25,0.68,109
987,LAL,2020-03-08,112,@,LAC,1,240,39,87,0.448,29,52,0.558,10,35,0.286,24,28,0.857,112,34,86,0.395,27,55,0.491,7,31,0.226,28,37,0.757,103
988,ATL,2020-03-06,112,@,WAS,0,240,46,86,0.535,34,54,0.63,12,32,0.375,8,12,0.667,112,36,76,0.474,21,45,0.467,15,31,0.484,31,35,0.886,118
989,CHO,2020-03-05,112,,DEN,0,240,38,77,0.494,25,44,0.568,13,33,0.394,23,28,0.821,112,44,83,0.53,36,57,0.632,8,26,0.308,18,20,0.9,114
990,UTA,2020-03-04,112,@,NYK,1,240,41,81,0.506,31,45,0.689,10,36,0.278,20,25,0.8,112,41,85,0.482,34,65,0.523,7,20,0.35,15,18,0.833,104
991,BOS,2020-03-04,112,@,CLE,1,240,40,86,0.465,29,56,0.518,11,30,0.367,21,26,0.808,112,39,89,0.438,26,51,0.51,13,38,0.342,15,20,0.75,106
992,OKC,2020-02-27,112,,SAC,1,240,41,84,0.488,32,58,0.552,9,26,0.346,21,29,0.724,112,41,91,0.451,29,56,0.518,12,35,0.343,14,14,1.0,108
993,MEM,2020-02-26,112,@,HOU,0,240,43,108,0.398,30,69,0.435,13,39,0.333,13,21,0.619,112,52,93,0.559,29,43,0.674,23,50,0.46,13,15,0.867,140
994,SAC,2020-02-25,112,@,GSW,1,240,40,76,0.526,27,46,0.587,13,30,0.433,19,34,0.559,112,35,79,0.443,31,51,0.608,4,28,0.143,20,24,0.833,94
995,NYK,2020-02-24,112,@,HOU,0,240,40,91,0.44,29,62,0.468,11,29,0.379,21,30,0.7,112,43,86,0.5,27,38,0.711,16,48,0.333,21,31,0.677,123
996,ATL,2020-02-24,112,@,PHI,0,240,40,97,0.412,32,59,0.542,8,38,0.211,24,27,0.889,112,45,88,0.511,33,58,0.569,12,30,0.4,27,30,0.9,129
997,BOS,2020-02-23,112,@,LAL,0,240,38,83,0.458,25,49,0.51,13,34,0.382,23,30,0.767,112,39,86,0.453,28,52,0.538,11,34,0.324,25,37,0.676,114
998,SAC,2020-02-22,112,@,LAC,1,240,40,89,0.449,28,58,0.483,12,31,0.387,20,26,0.769,112,34,87,0.391,24,57,0.421,10,30,0.333,25,29,0.862,103
999,PHO,2020-02-22,112,@,CHI,1,240,38,86,0.442,28,56,0.5,10,30,0.333,26,31,0.839,112,36,83,0.434,22,45,0.489,14,38,0.368,18,21,0.857,104
1000,PHI,2020-02-20,112,,BRK,1,265,38,86,0.442,34,64,0.531,4,22,0.182,32,35,0.914,112,36,102,0.353,26,68,0.382,10,34,0.294,22,28,0.786,104
1001,DET,2020-02-12,112,@,ORL,0,265,40,92,0.435,22,47,0.468,18,45,0.4,14,15,0.933,112,44,96,0.458,32,60,0.533,12,36,0.333,16,18,0.889,116
1002,PHO,2020-02-12,112,,GSW,1,240,42,91,0.462,28,54,0.519,14,37,0.378,14,15,0.933,112,39,77,0.506,28,46,0.609,11,31,0.355,17,19,0.895,106
1003,BOS,2020-02-09,112,@,OKC,1,240,38,84,0.452,22,48,0.458,16,36,0.444,20,27,0.741,112,39,86,0.453,28,59,0.475,11,27,0.407,22,29,0.759,111
1004,BOS,2020-02-07,112,,ATL,1,240,37,86,0.43,21,49,0.429,16,37,0.432,22,27,0.815,112,35,86,0.407,22,47,0.468,13,39,0.333,24,26,0.923,107
1005,MIL,2020-02-06,112,,PHI,1,240,44,94,0.468,32,57,0.561,12,37,0.324,12,18,0.667,112,37,99,0.374,18,54,0.333,19,45,0.422,8,14,0.571,101
1006,ORL,2020-02-03,112,@,CHO,1,240,43,80,0.538,27,46,0.587,16,34,0.471,10,17,0.588,112,41,89,0.461,32,58,0.552,9,31,0.29,9,14,0.643,100
1007,DAL,2020-02-03,112,@,IND,1,240,36,86,0.419,18,41,0.439,18,45,0.4,22,23,0.957,112,44,96,0.458,37,62,0.597,7,34,0.206,8,11,0.727,103
1008,CLE,2020-02-01,112,,GSW,0,240,41,95,0.432,25,51,0.49,16,44,0.364,14,14,1.0,112,48,90,0.533,30,55,0.545,18,35,0.514,17,19,0.895,131
1009,HOU,2020-01-29,112,@,POR,0,240,40,94,0.426,23,47,0.489,17,47,0.362,15,18,0.833,112,46,89,0.517,33,53,0.623,13,36,0.361,20,27,0.741,125
1010,LAC,2020-01-26,112,@,ORL,1,240,37,79,0.468,24,49,0.49,13,30,0.433,25,29,0.862,112,34,95,0.358,27,63,0.429,7,32,0.219,22,32,0.688,97
1011,UTA,2020-01-25,112,,DAL,1,240,40,91,0.44,25,48,0.521,15,43,0.349,17,22,0.773,112,42,97,0.433,26,56,0.464,16,41,0.39,7,13,0.538,107
1012,NYK,2020-01-24,112,,TOR,0,240,42,85,0.494,29,49,0.592,13,36,0.361,15,21,0.714,112,41,81,0.506,24,46,0.522,17,35,0.486,19,23,0.826,118
1013,DET,2020-01-24,112,,MEM,0,240,39,91,0.429,28,59,0.475,11,32,0.344,23,31,0.742,112,43,79,0.544,32,57,0.561,11,22,0.5,28,31,0.903,125
1014,CLE,2020-01-23,112,,WAS,0,240,44,96,0.458,33,63,0.524,11,33,0.333,13,17,0.765,112,47,85,0.553,31,49,0.633,16,36,0.444,14,18,0.778,124
1015,IND,2020-01-22,112,@,PHO,1,240,45,84,0.536,36,64,0.563,9,20,0.45,13,20,0.65,112,30,84,0.357,26,64,0.406,4,20,0.2,23,26,0.885,87
1016,OKC,2020-01-20,112,@,HOU,1,240,40,92,0.435,28,60,0.467,12,32,0.375,20,26,0.769,112,43,97,0.443,34,52,0.654,9,45,0.2,12,17,0.706,107
1017,MIN,2020-01-18,112,,TOR,0,240,38,94,0.404,24,44,0.545,14,50,0.28,22,27,0.815,112,47,91,0.516,34,56,0.607,13,35,0.371,15,17,0.882,122
1018,POR,2020-01-17,112,@,DAL,0,240,44,85,0.518,35,55,0.636,9,30,0.3,15,22,0.682,112,39,89,0.438,19,42,0.452,20,47,0.426,22,28,0.786,120
1019,CHO,2020-01-13,112,@,POR,0,240,40,90,0.444,22,52,0.423,18,38,0.474,14,18,0.778,112,42,83,0.506,26,46,0.565,16,37,0.432,15,19,0.789,115
1020,SAC,2020-01-13,112,,ORL,0,240,45,87,0.517,33,56,0.589,12,31,0.387,10,11,0.909,112,40,92,0.435,31,63,0.492,9,29,0.31,25,30,0.833,114
1021,DET,2020-01-09,112,,CLE,0,265,48,98,0.49,42,78,0.538,6,20,0.3,10,16,0.625,112,48,91,0.527,43,71,0.606,5,20,0.25,14,20,0.7,115
1022,TOR,2020-01-08,112,@,CHO,1,265,42,94,0.447,28,58,0.483,14,36,0.389,14,20,0.7,112,38,86,0.442,23,49,0.469,15,37,0.405,19,26,0.731,110
1023,MIN,2020-01-07,112,@,MEM,0,240,40,90,0.444,25,43,0.581,15,47,0.319,17,21,0.81,112,46,89,0.517,38,61,0.623,8,28,0.286,19,21,0.905,119
1024,NYK,2020-01-03,112,@,PHO,0,240,41,92,0.446,31,55,0.564,10,37,0.27,20,30,0.667,112,42,90,0.467,32,62,0.516,10,28,0.357,26,33,0.788,120
1025,DET,2020-01-02,112,@,LAC,0,240,40,94,0.426,33,61,0.541,7,33,0.212,25,35,0.714,112,50,92,0.543,39,64,0.609,11,28,0.393,15,21,0.714,126
1026,HOU,2019-12-29,112,@,NOP,0,240,42,81,0.519,27,42,0.643,15,39,0.385,13,20,0.65,112,50,102,0.49,32,58,0.552,18,44,0.409,9,13,0.692,127
1027,PHO,2019-12-28,112,@,SAC,1,240,45,86,0.523,36,60,0.6,9,26,0.346,13,15,0.867,112,41,84,0.488,29,53,0.547,12,31,0.387,16,24,0.667,110
1028,IND,2019-12-27,112,@,MIA,0,240,44,90,0.489,30,59,0.508,14,31,0.452,10,12,0.833,112,40,89,0.449,24,51,0.471,16,38,0.421,17,19,0.895,113
1029,MIL,2019-12-27,112,@,ATL,1,240,46,91,0.505,35,63,0.556,11,28,0.393,9,13,0.692,112,33,91,0.363,21,50,0.42,12,41,0.293,8,14,0.571,86
1030,NOP,2019-12-25,112,@,DEN,1,240,41,90,0.456,23,47,0.489,18,43,0.419,12,12,1.0,112,37,92,0.402,25,55,0.455,12,37,0.324,14,18,0.778,100
1031,LAC,2019-12-22,112,@,OKC,0,240,40,86,0.465,29,59,0.492,11,27,0.407,21,24,0.875,112,46,97,0.474,37,70,0.529,9,27,0.333,17,20,0.85,118
1032,ATL,2019-12-21,112,@,BRK,0,240,39,105,0.371,28,57,0.491,11,48,0.229,23,27,0.852,112,46,100,0.46,35,70,0.5,11,30,0.367,19,28,0.679,122
1033,GSW,2019-12-18,112,@,POR,0,240,41,103,0.398,25,65,0.385,16,38,0.421,14,23,0.609,112,44,97,0.454,35,66,0.53,9,31,0.29,25,28,0.893,122
1034,TOR,2019-12-18,112,@,DET,1,240,39,91,0.429,26,56,0.464,13,35,0.371,21,24,0.875,112,39,87,0.448,33,52,0.635,6,35,0.171,15,22,0.682,99
1035,NOP,2019-12-11,112,@,MIL,0,240,39,88,0.443,23,43,0.535,16,45,0.356,18,22,0.818,112,50,93,0.538,31,54,0.574,19,39,0.487,8,9,0.889,127
1036,LAC,2019-12-11,112,@,TOR,1,240,38,86,0.442,26,46,0.565,12,40,0.3,24,27,0.889,112,31,88,0.352,23,52,0.442,8,36,0.222,22,25,0.88,92
1037,MEM,2019-12-07,112,@,UTA,0,240,43,81,0.531,33,46,0.717,10,35,0.286,16,25,0.64,112,45,80,0.563,26,46,0.565,19,34,0.559,17,18,0.944,126
1038,MIA,2019-12-06,112,,WAS,1,240,42,86,0.488,32,58,0.552,10,28,0.357,18,24,0.75,112,39,91,0.429,27,52,0.519,12,39,0.308,13,14,0.929,103
1039,BOS,2019-12-04,112,,MIA,1,240,35,79,0.443,19,38,0.5,16,41,0.39,26,32,0.813,112,34,77,0.442,20,39,0.513,14,38,0.368,11,17,0.647,93
1040,BRK,2019-11-29,112,,BOS,1,240,43,93,0.462,26,52,0.5,17,41,0.415,9,13,0.692,112,41,93,0.441,32,65,0.492,9,28,0.321,16,21,0.762,107
1041,LAL,2019-11-19,112,,OKC,1,240,43,89,0.483,29,58,0.5,14,31,0.452,12,19,0.632,112,38,80,0.475,29,52,0.558,9,28,0.321,22,25,0.88,107
1042,MIN,2019-11-18,112,@,UTA,1,240,41,89,0.461,27,51,0.529,14,38,0.368,16,19,0.842,112,35,96,0.365,23,65,0.354,12,31,0.387,20,26,0.769,102
1043,ATL,2019-11-14,112,@,PHO,0,240,40,91,0.44,32,60,0.533,8,31,0.258,24,30,0.8,112,41,85,0.482,26,46,0.565,15,39,0.385,31,38,0.816,128
1044,ORL,2019-11-13,112,,PHI,1,240,38,86,0.442,28,54,0.519,10,32,0.313,26,34,0.765,112,40,91,0.44,32,61,0.525,8,30,0.267,9,13,0.692,97
1045,BRK,2019-11-10,112,@,PHO,0,240,44,91,0.484,36,57,0.632,8,34,0.235,16,17,0.941,112,52,99,0.525,33,57,0.579,19,42,0.452,15,19,0.789,138
1046,IND,2019-11-08,112,,DET,1,240,43,83,0.518,39,68,0.574,4,15,0.267,22,25,0.88,112,39,86,0.453,26,53,0.491,13,33,0.394,15,18,0.833,106
1047,OKC,2019-11-07,112,@,SAS,0,240,42,80,0.525,32,59,0.542,10,21,0.476,18,24,0.75,112,51,94,0.543,42,74,0.568,9,20,0.45,10,11,0.909,121
1048,GSW,2019-11-06,112,@,HOU,0,240,38,96,0.396,25,63,0.397,13,33,0.394,23,28,0.821,112,48,97,0.495,27,52,0.519,21,45,0.467,12,19,0.632,129
1049,CHI,2019-11-05,112,,LAL,0,240,43,85,0.506,29,53,0.547,14,32,0.438,12,23,0.522,112,45,92,0.489,34,59,0.576,11,33,0.333,17,24,0.708,118
1050,CHI,2019-11-01,112,,DET,1,240,39,89,0.438,23,49,0.469,16,40,0.4,18,23,0.783,112,41,85,0.482,35,56,0.625,6,29,0.207,18,24,0.75,106
1051,MIA,2019-10-29,112,,ATL,1,240,33,73,0.452,20,42,0.476,13,31,0.419,33,45,0.733,112,35,83,0.422,24,44,0.545,11,39,0.282,16,24,0.667,97
1052,CLE,2019-10-28,112,@,MIL,0,240,45,100,0.45,33,61,0.541,12,39,0.308,10,12,0.833,112,48,92,0.522,31,54,0.574,17,38,0.447,16,24,0.667,129
1053,OKC,2019-10-28,112,@,HOU,0,240,41,94,0.436,28,59,0.475,13,35,0.371,17,24,0.708,112,39,90,0.433,29,46,0.63,10,44,0.227,28,33,0.848,116
1054,SAC,2019-10-25,112,,POR,0,240,37,87,0.425,22,50,0.44,15,37,0.405,23,27,0.852,112,46,85,0.541,35,55,0.636,11,30,0.367,19,22,0.864,122
1055,BOS,2019-10-25,112,,TOR,1,240,42,109,0.385,29,71,0.408,13,38,0.342,15,16,0.938,112,37,78,0.474,19,42,0.452,18,36,0.5,14,17,0.824,106
1056,LAC,2019-10-22,112,,LAL,1,240,42,81,0.519,31,50,0.62,11,31,0.355,17,24,0.708,112,37,85,0.435,24,52,0.462,13,33,0.394,15,21,0.714,102
1057,DEN,2020-08-12,111,,LAC,0,240,43,87,0.494,30,52,0.577,13,35,0.371,12,19,0.632,111,46,85,0.541,32,48,0.667,14,37,0.378,18,23,0.783,124
1058,LAL,2020-08-08,111,@,IND,0,240,42,100,0.42,29,61,0.475,13,39,0.333,14,19,0.737,111,44,84,0.524,29,51,0.569,15,33,0.455,13,14,0.929,116
1059,UTA,2020-08-07,111,@,SAS,0,240,38,91,0.418,22,54,0.407,16,37,0.432,19,24,0.792,111,45,89,0.506,36,67,0.537,9,22,0.409,20,26,0.769,119
1060,DAL,2020-08-06,111,,LAC,0,240,39,87,0.448,22,39,0.564,17,48,0.354,16,21,0.762,111,50,92,0.543,36,61,0.59,14,31,0.452,12,15,0.8,126
1061,IND,2020-08-03,111,@,WAS,1,240,44,92,0.478,37,66,0.561,7,26,0.269,16,16,1.0,111,41,94,0.436,30,64,0.469,11,30,0.367,7,13,0.538,100
1062,IND,2020-03-10,111,,BOS,0,240,46,93,0.495,37,69,0.536,9,24,0.375,10,11,0.909,111,41,93,0.441,28,56,0.5,13,37,0.351,19,22,0.864,114
1063,MIN,2020-03-10,111,@,HOU,0,240,40,83,0.482,26,48,0.542,14,35,0.4,17,23,0.739,111,41,80,0.513,26,42,0.619,15,38,0.395,20,26,0.769,117
1064,POR,2020-03-07,111,,SAC,0,240,42,89,0.472,32,50,0.64,10,39,0.256,17,26,0.654,111,41,85,0.482,20,46,0.435,21,39,0.538,20,23,0.87,123
1065,UTA,2020-03-07,111,@,DET,1,240,40,77,0.519,30,44,0.682,10,33,0.303,21,28,0.75,111,40,86,0.465,31,56,0.554,9,30,0.3,16,22,0.727,105
1066,SAS,2020-03-02,111,,IND,0,240,40,77,0.519,24,45,0.533,16,32,0.5,15,19,0.789,111,39,78,0.5,24,47,0.511,15,31,0.484,23,26,0.885,116
1067,DAL,2020-03-01,111,@,MIN,1,240,44,94,0.468,33,54,0.611,11,40,0.275,12,19,0.632,111,36,99,0.364,23,57,0.404,13,42,0.31,6,15,0.4,91
1068,HOU,2020-02-29,111,@,BOS,1,265,41,98,0.418,26,43,0.605,15,55,0.273,14,18,0.778,111,39,100,0.39,26,58,0.448,13,42,0.31,19,25,0.76,110
1069,PHO,2020-02-28,111,,DET,0,240,45,75,0.6,36,52,0.692,9,23,0.391,12,17,0.706,111,44,90,0.489,31,58,0.534,13,32,0.406,12,16,0.75,113
1070,UTA,2020-02-24,111,,PHO,0,240,32,68,0.471,22,42,0.524,10,26,0.385,37,43,0.86,111,49,87,0.563,37,67,0.552,12,20,0.6,21,24,0.875,131
1071,ATL,2020-02-22,111,,DAL,1,240,43,98,0.439,35,61,0.574,8,37,0.216,17,26,0.654,111,40,89,0.449,26,45,0.578,14,44,0.318,13,19,0.684,107
1072,MEM,2020-02-12,111,,POR,1,240,45,95,0.474,39,72,0.542,6,23,0.261,15,22,0.682,111,36,97,0.371,23,60,0.383,13,37,0.351,19,24,0.792,104
1073,SAC,2020-02-12,111,@,DAL,0,240,41,99,0.414,29,60,0.483,12,39,0.308,17,22,0.773,111,48,85,0.565,31,45,0.689,17,40,0.425,17,21,0.81,130
1074,MIL,2020-02-12,111,@,IND,0,240,37,91,0.407,24,54,0.444,13,37,0.351,24,25,0.96,111,45,86,0.523,36,59,0.61,9,27,0.333,19,24,0.792,118
1075,SAC,2020-02-10,111,@,MIL,0,240,42,101,0.416,28,58,0.483,14,43,0.326,13,18,0.722,111,43,96,0.448,25,54,0.463,18,42,0.429,19,23,0.826,123
1076,CHI,2020-02-09,111,@,PHI,0,240,43,88,0.489,31,56,0.554,12,32,0.375,13,17,0.765,111,42,84,0.5,31,57,0.544,11,27,0.407,23,32,0.719,118
1077,OKC,2020-02-09,111,,BOS,0,240,39,86,0.453,28,59,0.475,11,27,0.407,22,29,0.759,111,38,84,0.452,22,48,0.458,16,36,0.444,20,27,0.741,112
1078,MIL,2020-02-08,111,@,ORL,1,240,42,93,0.452,27,54,0.5,15,39,0.385,12,16,0.75,111,37,98,0.378,27,58,0.466,10,40,0.25,11,14,0.786,95
1079,LAL,2020-02-06,111,,HOU,0,240,45,91,0.495,36,60,0.6,9,31,0.29,12,16,0.75,111,43,85,0.506,24,43,0.558,19,42,0.452,16,18,0.889,121
1080,MIA,2020-02-05,111,@,LAC,0,240,40,93,0.43,24,51,0.471,16,42,0.381,15,21,0.714,111,45,89,0.506,21,35,0.6,24,54,0.444,14,19,0.737,128
1081,OKC,2020-01-31,111,@,PHO,1,240,42,97,0.433,35,66,0.53,7,31,0.226,20,22,0.909,111,36,76,0.474,27,52,0.519,9,24,0.375,26,29,0.897,107
1082,MEM,2020-01-31,111,@,NOP,0,240,45,96,0.469,39,65,0.6,6,31,0.194,15,26,0.577,111,51,95,0.537,36,61,0.59,15,34,0.441,22,26,0.846,139
1083,CLE,2020-01-28,111,,NOP,0,240,42,97,0.433,31,63,0.492,11,34,0.324,16,18,0.889,111,47,88,0.534,34,54,0.63,13,34,0.382,18,24,0.75,125
1084,DET,2020-01-25,111,,BRK,0,265,43,104,0.413,30,69,0.435,13,35,0.371,12,18,0.667,111,42,94,0.447,27,52,0.519,15,42,0.357,22,25,0.88,121
1085,ATL,2020-01-24,111,@,OKC,0,240,42,92,0.457,31,56,0.554,11,36,0.306,16,20,0.8,111,50,86,0.581,36,61,0.59,14,25,0.56,26,34,0.765,140
1086,MIL,2020-01-20,111,,CHI,1,240,45,77,0.584,34,51,0.667,11,26,0.423,10,23,0.435,111,34,92,0.37,20,44,0.455,14,48,0.292,16,18,0.889,98
1087,BRK,2020-01-20,111,,PHI,0,240,39,81,0.481,28,52,0.538,11,29,0.379,22,34,0.647,111,42,94,0.447,29,55,0.527,13,39,0.333,20,27,0.741,117
1088,WAS,2020-01-17,111,@,TOR,0,240,40,89,0.449,25,54,0.463,15,35,0.429,16,23,0.696,111,52,91,0.571,30,48,0.625,22,43,0.512,14,16,0.875,140
1089,CLE,2020-01-11,111,@,DEN,1,240,44,89,0.494,32,52,0.615,12,37,0.324,11,13,0.846,111,41,95,0.432,33,56,0.589,8,39,0.205,13,18,0.722,103
1090,WAS,2020-01-10,111,,ATL,1,240,42,112,0.375,32,83,0.386,10,29,0.345,17,28,0.607,111,41,89,0.461,34,60,0.567,7,29,0.241,12,24,0.5,101
1091,NYK,2020-01-10,111,,NOP,0,240,46,100,0.46,41,73,0.562,5,27,0.185,14,20,0.7,111,48,86,0.558,30,48,0.625,18,38,0.474,9,17,0.529,123
1092,OKC,2020-01-07,111,@,BRK,1,265,38,92,0.413,27,55,0.491,11,37,0.297,24,29,0.828,111,40,98,0.408,29,61,0.475,11,37,0.297,12,16,0.75,103
1093,SAC,2020-01-06,111,,GSW,1,240,39,81,0.481,24,51,0.471,15,30,0.5,18,23,0.783,111,34,86,0.395,29,60,0.483,5,26,0.192,25,32,0.781,98
1094,POR,2020-01-05,111,@,MIA,0,240,40,87,0.46,27,50,0.54,13,37,0.351,18,20,0.9,111,47,90,0.522,29,46,0.63,18,44,0.409,10,16,0.625,122
1095,BOS,2020-01-04,111,@,CHI,1,240,43,82,0.524,35,63,0.556,8,19,0.421,17,21,0.81,111,34,80,0.425,21,46,0.457,13,34,0.382,23,31,0.742,104
1096,IND,2020-01-04,111,@,ATL,0,240,36,87,0.414,26,60,0.433,10,27,0.37,29,35,0.829,111,42,82,0.512,32,50,0.64,10,32,0.313,22,24,0.917,116
1097,DET,2020-01-04,111,@,GSW,1,240,43,83,0.518,32,56,0.571,11,27,0.407,14,16,0.875,111,33,82,0.402,22,61,0.361,11,21,0.524,27,32,0.844,104
1098,BRK,2020-01-02,111,@,DAL,0,240,42,91,0.462,30,54,0.556,12,37,0.324,15,17,0.882,111,45,89,0.506,27,51,0.529,18,38,0.474,15,17,0.882,123
1099,MIL,2019-12-28,111,,ORL,1,240,43,84,0.512,30,47,0.638,13,37,0.351,12,18,0.667,111,35,87,0.402,21,52,0.404,14,35,0.4,16,19,0.842,100
1100,LAC,2019-12-25,111,@,LAL,1,240,39,85,0.459,30,60,0.5,9,25,0.36,24,32,0.75,111,39,96,0.406,27,51,0.529,12,45,0.267,16,21,0.762,106
1101,PHO,2019-12-23,111,,DEN,0,240,42,87,0.483,29,50,0.58,13,37,0.351,14,18,0.778,111,43,78,0.551,28,50,0.56,15,28,0.536,12,15,0.8,113
1102,UTA,2019-12-19,111,@,ATL,1,240,39,83,0.47,33,59,0.559,6,24,0.25,27,38,0.711,111,39,90,0.433,28,61,0.459,11,29,0.379,17,19,0.895,106
1103,MIL,2019-12-19,111,,LAL,1,240,36,77,0.468,20,38,0.526,16,39,0.41,23,32,0.719,111,37,80,0.463,25,45,0.556,12,35,0.343,18,23,0.783,104
1104,POR,2019-12-16,111,@,PHO,1,240,40,84,0.476,26,50,0.52,14,34,0.412,17,20,0.85,111,41,90,0.456,29,56,0.518,12,34,0.353,16,19,0.842,110
1105,MIA,2019-12-16,111,@,MEM,0,240,37,81,0.457,26,57,0.456,11,24,0.458,26,31,0.839,111,42,86,0.488,29,50,0.58,13,36,0.361,21,30,0.7,118
1106,DEN,2019-12-15,111,,NYK,1,240,44,94,0.468,34,66,0.515,10,28,0.357,13,19,0.684,111,44,94,0.468,36,62,0.581,8,32,0.25,9,10,0.9,105
1107,WAS,2019-12-14,111,@,MEM,0,240,36,85,0.424,22,47,0.468,14,38,0.368,25,32,0.781,111,48,84,0.571,37,57,0.649,11,27,0.407,21,24,0.875,128
1108,DET,2019-12-12,111,,DAL,0,240,40,89,0.449,25,47,0.532,15,42,0.357,16,23,0.696,111,45,88,0.511,29,44,0.659,16,44,0.364,16,23,0.696,122
1109,BRK,2019-12-06,111,@,CHO,1,240,42,88,0.477,27,50,0.54,15,38,0.395,12,15,0.8,111,36,83,0.434,19,43,0.442,17,40,0.425,15,17,0.882,104
1110,ATL,2019-11-30,111,@,HOU,0,240,38,89,0.427,23,43,0.535,15,46,0.326,20,25,0.8,111,52,89,0.584,27,38,0.711,25,51,0.49,29,34,0.853,158
1111,MIL,2019-11-27,111,,ATL,1,240,42,88,0.477,32,54,0.593,10,34,0.294,17,27,0.63,111,38,94,0.404,27,60,0.45,11,34,0.324,15,22,0.682,102
1112,IND,2019-11-23,111,,ORL,1,240,43,79,0.544,33,55,0.6,10,24,0.417,15,16,0.938,111,43,92,0.467,30,61,0.492,13,31,0.419,7,9,0.778,106
1113,SAS,2019-11-23,111,@,NYK,1,240,40,75,0.533,28,52,0.538,12,23,0.522,19,28,0.679,111,40,93,0.43,25,53,0.472,15,40,0.375,9,15,0.6,104
1114,CHI,2019-11-16,111,,BRK,0,240,32,91,0.352,23,52,0.442,9,39,0.231,38,41,0.927,111,40,88,0.455,30,45,0.667,10,43,0.233,27,31,0.871,117
1115,ORL,2019-11-15,111,,SAS,1,240,36,87,0.414,24,58,0.414,12,29,0.414,27,34,0.794,111,45,89,0.506,32,63,0.508,13,26,0.5,6,10,0.6,109
1116,HOU,2019-11-15,111,,IND,1,240,36,89,0.404,22,43,0.512,14,46,0.304,25,29,0.862,111,37,82,0.451,29,49,0.592,8,33,0.242,20,26,0.769,102
1117,IND,2019-11-12,111,,OKC,1,240,46,94,0.489,39,71,0.549,7,23,0.304,12,13,0.923,111,29,82,0.354,23,57,0.404,6,25,0.24,21,24,0.875,85
1118,CLE,2019-11-03,111,,DAL,0,240,39,96,0.406,21,48,0.438,18,48,0.375,15,22,0.682,111,50,94,0.532,30,53,0.566,20,41,0.488,11,13,0.846,131
1119,SAC,2019-10-30,111,,CHO,0,240,44,96,0.458,30,50,0.6,14,46,0.304,9,12,0.75,111,46,84,0.548,30,52,0.577,16,32,0.5,10,14,0.714,118
1120,CHI,2019-10-30,111,@,CLE,0,240,39,90,0.433,25,51,0.49,14,39,0.359,19,23,0.826,111,41,78,0.526,31,54,0.574,10,24,0.417,25,31,0.806,117
1121,LAC,2019-10-28,111,,CHO,1,240,40,83,0.482,28,50,0.56,12,33,0.364,19,21,0.905,111,36,83,0.434,22,44,0.5,14,39,0.359,10,14,0.714,96
1122,DET,2019-10-26,111,,PHI,0,240,41,76,0.539,33,57,0.579,8,19,0.421,21,36,0.583,111,42,87,0.483,29,53,0.547,13,34,0.382,20,30,0.667,117
1123,HOU,2019-10-24,111,,MIL,0,240,33,90,0.367,17,42,0.405,16,48,0.333,29,39,0.744,111,46,99,0.465,30,53,0.566,16,46,0.348,9,18,0.5,117
1124,NYK,2019-10-23,111,@,SAS,0,240,44,94,0.468,34,64,0.531,10,30,0.333,13,18,0.722,111,42,83,0.506,35,62,0.565,7,21,0.333,29,36,0.806,120
1125,SAC,2020-08-04,110,,DAL,0,265,43,104,0.413,27,61,0.443,16,43,0.372,8,12,0.667,110,33,90,0.367,24,49,0.49,9,41,0.22,39,50,0.78,114
1126,POR,2020-08-04,110,,HOU,1,240,39,95,0.411,27,64,0.422,12,31,0.387,20,29,0.69,110,34,87,0.391,15,34,0.441,19,53,0.358,15,24,0.625,102
1127,WAS,2020-08-02,110,@,BRK,0,240,40,88,0.455,31,57,0.544,9,31,0.29,21,27,0.778,110,38,90,0.422,27,57,0.474,11,33,0.333,31,37,0.838,118
1128,OKC,2020-08-01,110,,UTA,1,240,41,77,0.532,31,51,0.608,10,26,0.385,18,24,0.75,110,34,87,0.391,26,56,0.464,8,31,0.258,18,22,0.818,94
1129,BRK,2020-03-08,110,,CHI,1,240,32,64,0.5,21,34,0.618,11,30,0.367,35,41,0.854,110,39,92,0.424,27,58,0.466,12,34,0.353,17,25,0.68,107
1130,NOP,2020-03-06,110,,MIA,1,240,38,91,0.418,24,53,0.453,14,38,0.368,20,28,0.714,110,37,86,0.43,28,53,0.528,9,33,0.273,21,31,0.677,104
1131,GSW,2020-03-01,110,,WAS,0,240,42,89,0.472,33,61,0.541,9,28,0.321,17,24,0.708,110,40,82,0.488,20,52,0.385,20,30,0.667,24,27,0.889,124
1132,BOS,2020-02-29,110,,HOU,0,265,39,100,0.39,26,58,0.448,13,42,0.31,19,25,0.76,110,41,98,0.418,26,43,0.605,15,55,0.273,14,18,0.778,111
1133,WAS,2020-02-26,110,,BRK,1,240,41,96,0.427,26,57,0.456,15,39,0.385,13,16,0.813,110,36,87,0.414,26,51,0.51,10,36,0.278,24,35,0.686,106
1134,UTA,2020-02-22,110,,HOU,0,240,42,90,0.467,35,59,0.593,7,31,0.226,19,24,0.792,110,45,92,0.489,25,44,0.568,20,48,0.417,10,14,0.714,120
1135,PHI,2020-02-11,110,,LAC,1,240,44,95,0.463,36,68,0.529,8,27,0.296,14,21,0.667,110,40,90,0.444,26,59,0.441,14,31,0.452,9,13,0.692,103
1136,CHO,2020-02-04,110,@,HOU,0,240,39,83,0.47,26,50,0.52,13,33,0.394,19,24,0.792,110,43,97,0.443,23,37,0.622,20,60,0.333,19,23,0.826,125
1137,CHI,2020-01-27,110,,SAS,1,240,42,93,0.452,28,56,0.5,14,37,0.378,12,15,0.8,110,38,82,0.463,28,57,0.491,10,25,0.4,23,34,0.676,109
1138,NYK,2020-01-26,110,,BRK,1,240,49,92,0.533,43,73,0.589,6,19,0.316,6,13,0.462,110,34,81,0.42,21,42,0.5,13,39,0.333,16,23,0.696,97
1139,TOR,2020-01-26,110,@,SAS,1,240,41,99,0.414,25,49,0.51,16,50,0.32,12,15,0.8,110,34,82,0.415,18,45,0.4,16,37,0.432,22,24,0.917,106
1140,HOU,2020-01-26,110,@,DEN,0,240,40,88,0.455,29,55,0.527,11,33,0.333,19,27,0.704,110,44,93,0.473,33,65,0.508,11,28,0.393,18,20,0.9,117
1141,MIN,2020-01-22,110,@,CHI,0,240,41,86,0.477,26,42,0.619,15,44,0.341,13,24,0.542,110,39,84,0.464,30,54,0.556,9,30,0.3,30,37,0.811,117
1142,LAC,2020-01-21,110,@,DAL,1,240,36,97,0.371,24,59,0.407,12,38,0.316,26,33,0.788,110,39,91,0.429,27,48,0.563,12,43,0.279,17,24,0.708,107
1143,PHO,2020-01-14,110,@,ATL,0,240,40,87,0.46,36,67,0.537,4,20,0.2,26,32,0.813,110,46,93,0.495,32,62,0.516,14,31,0.452,17,20,0.85,123
1144,HOU,2020-01-14,110,@,MEM,0,240,37,86,0.43,23,41,0.561,14,45,0.311,22,24,0.917,110,46,91,0.505,33,54,0.611,13,37,0.351,16,19,0.842,121
1145,DET,2020-01-13,110,,NOP,0,265,40,99,0.404,29,67,0.433,11,32,0.344,19,24,0.792,110,43,103,0.417,34,77,0.442,9,26,0.346,22,27,0.815,117
1146,OKC,2020-01-11,110,,LAL,0,240,43,92,0.467,34,61,0.557,9,31,0.29,15,17,0.882,110,51,99,0.515,36,67,0.537,15,32,0.469,8,10,0.8,125
1147,CHO,2020-01-08,110,,TOR,0,265,38,86,0.442,23,49,0.469,15,37,0.405,19,26,0.731,110,42,94,0.447,28,58,0.483,14,36,0.389,14,20,0.7,112
1148,CHI,2020-01-06,110,@,DAL,0,240,46,98,0.469,37,67,0.552,9,31,0.29,9,11,0.818,110,44,84,0.524,28,43,0.651,16,41,0.39,14,19,0.737,118
1149,SAC,2019-12-28,110,,PHO,0,240,41,84,0.488,29,53,0.547,12,31,0.387,16,24,0.667,110,45,86,0.523,36,60,0.6,9,26,0.346,13,15,0.867,112
1150,MEM,2019-12-28,110,@,DEN,0,240,41,84,0.488,32,54,0.593,9,30,0.3,19,25,0.76,110,45,93,0.484,36,64,0.563,9,29,0.31,20,27,0.741,119
1151,MEM,2019-12-26,110,@,OKC,1,240,46,84,0.548,36,59,0.61,10,25,0.4,8,11,0.727,110,38,92,0.413,28,57,0.491,10,35,0.286,11,13,0.846,97
1152,TOR,2019-12-22,110,,DAL,1,240,37,94,0.394,27,60,0.45,10,34,0.294,26,31,0.839,110,35,90,0.389,20,44,0.455,15,46,0.326,22,27,0.815,107
1153,CHI,2019-12-18,110,@,WAS,1,265,39,97,0.402,28,60,0.467,11,37,0.297,21,24,0.875,110,34,95,0.358,20,50,0.4,14,45,0.311,27,32,0.844,109
1154,CHO,2019-12-17,110,,SAC,1,240,39,81,0.481,26,51,0.51,13,30,0.433,19,27,0.704,110,38,91,0.418,24,52,0.462,14,39,0.359,12,13,0.923,102
1155,PHO,2019-12-16,110,,POR,0,240,41,90,0.456,29,56,0.518,12,34,0.353,16,19,0.842,110,40,84,0.476,26,50,0.52,14,34,0.412,17,20,0.85,111
1156,DEN,2019-12-14,110,,OKC,1,240,43,85,0.506,36,58,0.621,7,27,0.259,17,23,0.739,110,38,81,0.469,32,58,0.552,6,23,0.261,20,23,0.87,102
1157,TOR,2019-12-14,110,,BRK,1,240,38,98,0.388,24,58,0.414,14,40,0.35,20,25,0.8,110,39,101,0.386,27,55,0.491,12,46,0.261,12,17,0.706,102
1158,MIA,2019-12-13,110,,LAL,0,240,39,85,0.459,29,52,0.558,10,33,0.303,22,28,0.786,110,43,87,0.494,31,50,0.62,12,37,0.324,15,23,0.652,113
1159,IND,2019-12-13,110,@,ATL,1,240,46,92,0.5,39,70,0.557,7,22,0.318,11,15,0.733,110,39,94,0.415,33,66,0.5,6,28,0.214,16,23,0.696,100
1160,CLE,2019-12-11,110,,HOU,0,240,46,89,0.517,33,57,0.579,13,32,0.406,5,8,0.625,110,43,87,0.494,26,45,0.578,17,42,0.405,13,13,1.0,116
1161,MIL,2019-12-09,110,,ORL,1,240,43,92,0.467,27,51,0.529,16,41,0.39,8,15,0.533,110,35,92,0.38,25,61,0.41,10,31,0.323,21,26,0.808,101
1162,MEM,2019-12-09,110,@,GSW,1,240,41,82,0.5,26,42,0.619,15,40,0.375,13,17,0.765,110,35,93,0.376,24,66,0.364,11,27,0.407,21,25,0.84,102
1163,LAC,2019-12-09,110,@,IND,1,240,40,97,0.412,30,65,0.462,10,32,0.313,20,27,0.741,110,34,97,0.351,24,62,0.387,10,35,0.286,21,28,0.75,99
1164,BOS,2019-12-09,110,,CLE,1,240,45,78,0.577,30,51,0.588,15,27,0.556,5,8,0.625,110,36,91,0.396,29,60,0.483,7,31,0.226,9,19,0.474,88
1165,SAC,2019-12-08,110,@,DAL,1,240,44,85,0.518,31,51,0.608,13,34,0.382,9,11,0.818,110,41,86,0.477,24,42,0.571,17,44,0.386,7,8,0.875,106
1166,PHI,2019-12-08,110,,TOR,1,240,40,79,0.506,26,47,0.553,14,32,0.438,16,21,0.762,110,38,88,0.432,27,55,0.491,11,33,0.333,17,20,0.85,104
1167,MIA,2019-12-08,110,,CHI,1,265,32,77,0.416,21,42,0.5,11,35,0.314,35,44,0.795,110,35,80,0.438,22,44,0.5,13,36,0.361,22,27,0.815,105
1168,TOR,2019-12-03,110,,MIA,0,265,35,91,0.385,24,48,0.5,11,43,0.256,29,36,0.806,110,45,99,0.455,30,61,0.492,15,38,0.395,16,21,0.762,121
1169,UTA,2019-12-01,110,@,TOR,0,240,38,90,0.422,25,55,0.455,13,35,0.371,21,29,0.724,110,47,90,0.522,28,54,0.519,19,36,0.528,17,21,0.81,130
1170,CLE,2019-11-29,110,,MIL,0,240,44,88,0.5,27,54,0.5,17,34,0.5,5,10,0.5,110,45,88,0.511,33,54,0.611,12,34,0.353,17,23,0.739,119
1171,CHO,2019-11-29,110,@,DET,1,240,40,83,0.482,21,45,0.467,19,38,0.5,11,15,0.733,110,41,83,0.494,26,48,0.542,15,35,0.429,10,20,0.5,107
1172,BRK,2019-11-27,110,@,BOS,0,240,40,90,0.444,19,34,0.559,21,56,0.375,9,19,0.474,110,43,97,0.443,30,63,0.476,13,34,0.382,22,24,0.917,121
1173,NOP,2019-11-27,110,,LAL,0,240,34,84,0.405,17,44,0.386,17,40,0.425,25,30,0.833,110,44,85,0.518,36,61,0.59,8,24,0.333,18,25,0.72,114
1174,CLE,2019-11-23,110,,POR,1,240,37,87,0.425,27,56,0.482,10,31,0.323,26,32,0.813,110,39,87,0.448,25,47,0.532,14,40,0.35,12,16,0.75,104
1175,SAS,2019-11-18,110,@,DAL,0,240,44,96,0.458,36,72,0.5,8,24,0.333,14,16,0.875,110,42,84,0.5,25,43,0.581,17,41,0.415,16,23,0.696,117
1176,DAL,2019-11-16,110,,TOR,1,240,37,88,0.42,28,49,0.571,9,39,0.231,27,33,0.818,110,37,89,0.416,20,48,0.417,17,41,0.415,11,15,0.733,102
1177,CHO,2019-11-09,110,,NOP,0,240,36,88,0.409,24,53,0.453,12,35,0.343,26,34,0.765,110,40,75,0.533,26,42,0.619,14,33,0.424,21,30,0.7,115
1178,GSW,2019-11-01,110,,SAS,0,240,39,84,0.464,26,56,0.464,13,28,0.464,19,21,0.905,110,44,93,0.473,31,58,0.534,13,35,0.371,26,30,0.867,127
1179,DAL,2019-11-01,110,,LAL,0,265,40,102,0.392,26,66,0.394,14,36,0.389,16,23,0.696,110,47,96,0.49,38,64,0.594,9,32,0.281,16,21,0.762,119
1180,UTA,2019-10-30,110,,LAC,1,240,44,80,0.55,33,56,0.589,11,24,0.458,11,16,0.688,110,39,82,0.476,31,59,0.525,8,23,0.348,10,12,0.833,96
1181,GSW,2019-10-30,110,,PHO,0,240,36,82,0.439,28,54,0.519,8,28,0.286,30,36,0.833,110,44,96,0.458,29,60,0.483,15,36,0.417,18,21,0.857,121
1182,POR,2019-10-28,110,@,SAS,0,240,39,100,0.39,29,67,0.433,10,33,0.303,22,27,0.815,110,41,85,0.482,34,63,0.54,7,22,0.318,24,32,0.75,113
1183,CLE,2019-10-26,110,,IND,1,240,40,80,0.5,29,49,0.592,11,31,0.355,19,29,0.655,110,39,87,0.448,29,59,0.492,10,28,0.357,11,13,0.846,99
1184,CHI,2019-10-25,110,@,MEM,1,240,40,93,0.43,28,51,0.549,12,42,0.286,18,24,0.75,110,39,94,0.415,29,65,0.446,10,29,0.345,14,20,0.7,102
1185,IND,2019-10-23,110,,DET,0,240,41,89,0.461,33,68,0.485,8,21,0.381,20,24,0.833,110,41,78,0.526,30,54,0.556,11,24,0.458,26,33,0.788,119
1186,DEN,2020-08-14,109,@,TOR,0,240,36,87,0.414,20,49,0.408,16,38,0.421,21,23,0.913,109,45,90,0.5,27,55,0.491,18,35,0.514,9,14,0.643,117
1187,IND,2020-08-14,109,,MIA,1,240,43,89,0.483,28,51,0.549,15,38,0.395,8,11,0.727,109,31,87,0.356,21,49,0.429,10,38,0.263,20,27,0.741,92
1188,TOR,2020-08-05,109,@,ORL,1,240,38,78,0.487,26,45,0.578,12,33,0.364,21,30,0.7,109,35,87,0.402,24,46,0.522,11,41,0.268,18,26,0.692,99
1189,ORL,2020-08-04,109,@,IND,0,240,39,82,0.476,27,48,0.563,12,34,0.353,19,23,0.826,109,46,84,0.548,33,51,0.647,13,33,0.394,15,19,0.789,120
1190,NOP,2020-08-03,109,,MEM,1,240,37,82,0.451,26,53,0.491,11,29,0.379,24,39,0.615,109,37,93,0.398,25,50,0.5,12,43,0.279,13,15,0.867,99
1191,CHO,2020-03-11,109,@,MIA,1,240,37,82,0.451,20,48,0.417,17,34,0.5,18,22,0.818,109,39,84,0.464,24,40,0.6,15,44,0.341,5,6,0.833,98
1192,DAL,2020-03-10,109,@,SAS,0,240,42,92,0.457,25,48,0.521,17,44,0.386,8,11,0.727,109,46,89,0.517,31,57,0.544,15,32,0.469,12,15,0.8,119
1193,DEN,2020-03-09,109,,MIL,1,240,41,94,0.436,25,53,0.472,16,41,0.39,11,12,0.917,109,34,90,0.378,19,40,0.475,15,50,0.3,12,18,0.667,95
1194,DAL,2020-03-08,109,,IND,0,240,39,91,0.429,25,48,0.521,14,43,0.326,17,25,0.68,109,46,88,0.523,38,65,0.585,8,23,0.348,12,18,0.667,112
1195,LAC,2020-03-03,109,@,OKC,1,240,38,84,0.452,27,48,0.563,11,36,0.306,22,26,0.846,109,34,81,0.42,25,53,0.472,9,28,0.321,17,26,0.654,94
1196,CHI,2020-03-02,109,,DAL,1,240,44,94,0.468,34,58,0.586,10,36,0.278,11,17,0.647,109,40,84,0.476,28,42,0.667,12,42,0.286,15,20,0.75,107
1197,DAL,2020-02-26,109,@,SAS,1,240,36,86,0.419,19,41,0.463,17,45,0.378,20,30,0.667,109,39,92,0.424,28,59,0.475,11,33,0.333,14,19,0.737,103
1198,NOP,2020-02-25,109,@,LAL,0,240,39,86,0.453,31,59,0.525,8,27,0.296,23,30,0.767,109,45,102,0.441,32,58,0.552,13,44,0.295,15,21,0.714,118
1199,MIA,2020-02-09,109,@,POR,0,240,39,98,0.398,19,49,0.388,20,49,0.408,11,14,0.786,109,40,85,0.471,21,43,0.488,19,42,0.452,16,22,0.727,115
1200,OKC,2020-02-05,109,,CLE,1,240,38,81,0.469,29,55,0.527,9,26,0.346,24,30,0.8,109,41,89,0.461,26,51,0.51,15,38,0.395,6,11,0.545,103
1201,MIN,2020-02-03,109,@,SAC,0,240,37,85,0.435,24,47,0.511,13,38,0.342,22,28,0.786,109,38,75,0.507,24,48,0.5,14,27,0.519,23,31,0.742,113
1202,NOP,2020-02-02,109,@,HOU,0,240,42,94,0.447,32,61,0.525,10,33,0.303,15,20,0.75,109,41,105,0.39,25,54,0.463,16,51,0.314,19,22,0.864,117
1203,CLE,2020-01-30,109,,TOR,0,240,42,90,0.467,29,54,0.537,13,36,0.361,12,14,0.857,109,41,84,0.488,29,52,0.558,12,32,0.375,21,28,0.75,115
1204,BOS,2020-01-28,109,@,MIA,1,240,39,83,0.47,26,47,0.553,13,36,0.361,18,24,0.75,109,33,89,0.371,24,52,0.462,9,37,0.243,26,31,0.839,101
1205,SAS,2020-01-27,109,@,CHI,0,240,38,82,0.463,28,57,0.491,10,25,0.4,23,34,0.676,109,42,93,0.452,28,56,0.5,14,37,0.378,12,15,0.8,110
1206,PHO,2020-01-26,109,@,MEM,0,240,35,92,0.38,24,63,0.381,11,29,0.379,28,35,0.8,109,44,84,0.524,36,65,0.554,8,19,0.421,18,26,0.692,114
1207,BOS,2020-01-24,109,@,ORL,1,240,40,86,0.465,26,51,0.51,14,35,0.4,15,18,0.833,109,36,90,0.4,24,53,0.453,12,37,0.324,14,19,0.737,98
1208,GSW,2020-01-18,109,,ORL,1,240,43,94,0.457,31,54,0.574,12,40,0.3,11,11,1.0,109,39,86,0.453,30,55,0.545,9,31,0.29,8,13,0.615,95
1209,CLE,2020-01-17,109,@,MEM,0,240,41,92,0.446,32,56,0.571,9,36,0.25,18,26,0.692,109,45,89,0.506,36,61,0.59,9,28,0.321,14,20,0.7,113
1210,MIN,2020-01-11,109,@,HOU,0,240,36,95,0.379,23,47,0.489,13,48,0.271,24,36,0.667,109,49,95,0.516,31,50,0.62,18,45,0.4,23,29,0.793,139
1211,DAL,2020-01-11,109,,PHI,1,240,40,79,0.506,29,52,0.558,11,27,0.407,18,27,0.667,109,37,98,0.378,28,61,0.459,9,37,0.243,8,12,0.667,91
1212,LAC,2020-01-10,109,,GSW,1,240,41,84,0.488,30,45,0.667,11,39,0.282,16,22,0.727,109,37,96,0.385,29,57,0.509,8,39,0.205,18,25,0.72,100
1213,UTA,2020-01-10,109,,CHO,1,240,40,79,0.506,22,37,0.595,18,42,0.429,11,14,0.786,109,35,75,0.467,27,49,0.551,8,26,0.308,14,19,0.737,92
1214,PHI,2020-01-09,109,,BOS,1,240,43,88,0.489,32,61,0.525,11,27,0.407,12,17,0.706,109,38,88,0.432,24,52,0.462,14,36,0.389,8,8,1.0,98
1215,UTA,2020-01-04,109,@,ORL,1,240,42,93,0.452,26,53,0.491,16,40,0.4,9,14,0.643,109,38,85,0.447,27,48,0.563,11,37,0.297,9,12,0.75,96
1216,BOS,2020-01-03,109,,ATL,1,240,41,93,0.441,35,68,0.515,6,25,0.24,21,29,0.724,109,39,93,0.419,23,48,0.479,16,45,0.356,12,15,0.8,106
1217,CHO,2020-01-02,109,@,CLE,1,240,37,83,0.446,22,45,0.489,15,38,0.395,20,24,0.833,109,41,81,0.506,28,46,0.609,13,35,0.371,11,14,0.786,106
1218,OKC,2020-01-02,109,@,SAS,1,240,43,89,0.483,34,64,0.531,9,25,0.36,14,20,0.7,109,40,92,0.435,27,61,0.443,13,31,0.419,10,12,0.833,103
1219,BOS,2019-12-31,109,@,CHO,1,240,44,97,0.454,30,59,0.508,14,38,0.368,7,10,0.7,109,34,86,0.395,22,52,0.423,12,34,0.353,12,16,0.75,92
1220,DET,2019-12-28,109,@,SAS,0,240,40,90,0.444,28,54,0.519,12,36,0.333,17,30,0.567,109,53,93,0.57,35,58,0.603,18,35,0.514,12,15,0.8,136
1221,MIL,2019-12-25,109,@,PHI,0,240,45,95,0.474,32,62,0.516,13,33,0.394,6,8,0.75,109,44,101,0.436,23,57,0.404,21,44,0.477,12,15,0.8,121
1222,DET,2019-12-23,109,,PHI,0,240,43,84,0.512,33,54,0.611,10,30,0.333,13,18,0.722,109,52,95,0.547,40,65,0.615,12,30,0.4,9,11,0.818,125
1223,SAS,2019-12-21,109,,LAC,0,240,42,82,0.512,32,54,0.593,10,28,0.357,15,19,0.789,109,54,99,0.545,42,63,0.667,12,36,0.333,14,19,0.737,134
1224,DEN,2019-12-20,109,,MIN,1,240,44,89,0.494,34,61,0.557,10,28,0.357,11,12,0.917,109,36,87,0.414,26,45,0.578,10,42,0.238,18,27,0.667,100
1225,BOS,2019-12-18,109,@,DAL,1,240,35,86,0.407,23,48,0.479,12,38,0.316,27,30,0.9,109,34,87,0.391,19,44,0.432,15,43,0.349,20,25,0.8,103
1226,WAS,2019-12-18,109,,CHI,0,265,34,95,0.358,20,50,0.4,14,45,0.311,27,32,0.844,109,39,97,0.402,28,60,0.467,11,37,0.297,21,24,0.875,110
1227,UTA,2019-12-17,109,,ORL,1,240,42,90,0.467,27,54,0.5,15,36,0.417,10,16,0.625,109,42,93,0.452,35,58,0.603,7,35,0.2,11,15,0.733,102
1228,HOU,2019-12-16,109,,SAS,1,240,40,98,0.408,29,55,0.527,11,43,0.256,18,27,0.667,109,39,91,0.429,27,58,0.466,12,33,0.364,17,20,0.85,107
1229,OKC,2019-12-16,109,,CHI,1,240,35,69,0.507,19,35,0.543,16,34,0.471,23,28,0.821,109,43,87,0.494,34,56,0.607,9,31,0.29,11,13,0.846,106
1230,BRK,2019-12-15,109,,PHI,1,240,43,94,0.457,34,70,0.486,9,24,0.375,14,18,0.778,109,37,86,0.43,32,60,0.533,5,26,0.192,10,17,0.588,89
1231,CHI,2019-12-14,109,,LAC,1,240,40,85,0.471,26,54,0.481,14,31,0.452,15,18,0.833,109,35,80,0.438,25,58,0.431,10,22,0.455,26,36,0.722,106
1232,NOP,2019-12-13,109,@,PHI,0,240,38,88,0.432,29,64,0.453,9,24,0.375,24,35,0.686,109,43,87,0.494,36,67,0.537,7,20,0.35,23,34,0.676,116
1233,BOS,2019-12-12,109,,PHI,0,240,42,91,0.462,31,60,0.517,11,31,0.355,14,17,0.824,109,41,82,0.5,27,54,0.5,14,28,0.5,19,23,0.826,115
1234,SAS,2019-12-12,109,,CLE,0,265,42,86,0.488,37,70,0.529,5,16,0.313,20,25,0.8,109,44,96,0.458,29,51,0.569,15,45,0.333,14,20,0.7,117
1235,MIN,2019-12-09,109,@,PHO,0,240,40,85,0.471,34,63,0.54,6,22,0.273,23,29,0.793,109,47,95,0.495,31,55,0.564,16,40,0.4,15,19,0.789,125
1236,PHO,2019-12-07,109,@,HOU,0,240,40,96,0.417,29,61,0.475,11,35,0.314,18,28,0.643,109,41,91,0.451,30,51,0.588,11,40,0.275,22,30,0.733,115
1237,TOR,2019-12-05,109,,HOU,0,240,38,88,0.432,26,49,0.531,12,39,0.308,21,24,0.875,109,40,98,0.408,18,43,0.419,22,55,0.4,17,19,0.895,119
1238,PHO,2019-12-02,109,@,CHO,1,240,39,88,0.443,30,46,0.652,9,42,0.214,22,30,0.733,109,38,84,0.452,31,59,0.525,7,25,0.28,21,26,0.808,104
1239,MIA,2019-12-01,109,@,BRK,1,240,37,95,0.389,25,58,0.431,12,37,0.324,23,28,0.821,109,40,91,0.44,26,49,0.531,14,42,0.333,12,16,0.75,106
1240,OKC,2019-11-29,109,,NOP,1,240,43,90,0.478,30,56,0.536,13,34,0.382,10,16,0.625,109,39,87,0.448,28,49,0.571,11,38,0.289,15,21,0.714,104
1241,NOP,2019-11-24,109,@,LAC,0,240,43,98,0.439,30,57,0.526,13,41,0.317,10,18,0.556,109,46,98,0.469,30,55,0.545,16,43,0.372,26,33,0.788,134
1242,LAL,2019-11-23,109,@,MEM,1,240,38,84,0.452,25,45,0.556,13,39,0.333,20,29,0.69,109,43,89,0.483,29,59,0.492,14,30,0.467,8,13,0.615,108
1243,GSW,2019-11-22,109,@,UTA,0,240,43,94,0.457,31,66,0.47,12,28,0.429,11,12,0.917,109,43,85,0.506,29,53,0.547,14,32,0.438,13,16,0.813,113
1244,CHI,2019-11-20,109,,DET,1,240,39,91,0.429,25,64,0.391,14,27,0.519,17,26,0.654,109,28,83,0.337,20,50,0.4,8,33,0.242,25,32,0.781,89
1245,PHI,2019-11-20,109,,NYK,1,240,39,89,0.438,26,57,0.456,13,32,0.406,18,26,0.692,109,40,84,0.476,27,59,0.458,13,25,0.52,11,15,0.733,104
1246,MIA,2019-11-16,109,,NOP,1,240,44,81,0.543,35,57,0.614,9,24,0.375,12,13,0.923,109,37,82,0.451,21,47,0.447,16,35,0.457,4,6,0.667,94
1247,SAS,2019-11-15,109,@,ORL,0,240,45,89,0.506,32,63,0.508,13,26,0.5,6,10,0.6,109,36,87,0.414,24,58,0.414,12,29,0.414,27,34,0.794,111
1248,CHO,2019-11-15,109,,DET,1,240,43,96,0.448,30,61,0.492,13,35,0.371,10,16,0.625,109,40,81,0.494,25,46,0.543,15,35,0.429,11,11,1.0,106
1249,SAS,2019-11-11,109,,MEM,0,240,42,90,0.467,30,60,0.5,12,30,0.4,13,17,0.765,109,44,87,0.506,33,59,0.559,11,28,0.393,14,20,0.7,113
1250,IND,2019-11-10,109,@,ORL,1,240,48,91,0.527,39,71,0.549,9,20,0.45,4,5,0.8,109,41,89,0.461,26,53,0.491,15,36,0.417,5,6,0.833,102
1251,ATL,2019-11-08,109,,SAC,0,240,46,87,0.529,37,59,0.627,9,28,0.321,8,14,0.571,109,42,76,0.553,24,45,0.533,18,31,0.581,19,22,0.864,121
1252,DEN,2019-11-05,109,,MIA,1,240,45,86,0.523,36,63,0.571,9,23,0.391,10,16,0.625,109,32,88,0.364,23,59,0.39,9,29,0.31,16,25,0.64,89
1253,PHI,2019-11-04,109,@,PHO,0,240,42,89,0.472,29,60,0.483,13,29,0.448,12,20,0.6,109,41,77,0.532,30,49,0.612,11,28,0.393,21,27,0.778,114
1254,BRK,2019-11-02,109,@,DET,0,240,43,93,0.462,33,61,0.541,10,32,0.313,13,17,0.765,109,41,91,0.451,33,64,0.516,8,27,0.296,23,29,0.793,113
1255,WAS,2019-11-02,109,,MIN,0,240,37,95,0.389,25,60,0.417,12,35,0.343,23,27,0.852,109,51,94,0.543,34,55,0.618,17,39,0.436,12,17,0.706,131
1256,DAL,2019-10-29,109,@,DEN,1,240,41,84,0.488,28,47,0.596,13,37,0.351,14,24,0.583,109,43,91,0.473,32,59,0.542,11,32,0.344,9,13,0.692,106
1257,MIA,2019-10-27,109,@,MIN,0,240,42,85,0.494,27,49,0.551,15,36,0.417,10,15,0.667,109,39,91,0.429,26,46,0.565,13,45,0.289,25,33,0.758,116
1258,NYK,2019-10-25,109,@,BRK,0,240,38,81,0.469,21,56,0.375,17,25,0.68,16,28,0.571,109,37,78,0.474,21,41,0.512,16,37,0.432,23,34,0.676,113
1259,IND,2020-08-12,108,@,HOU,1,240,40,100,0.4,29,69,0.42,11,31,0.355,17,22,0.773,108,32,86,0.372,16,29,0.552,16,57,0.281,24,28,0.857,104
1260,BRK,2020-08-11,108,@,ORL,1,240,38,89,0.427,25,46,0.543,13,43,0.302,19,24,0.792,108,32,83,0.386,25,60,0.417,7,23,0.304,25,29,0.862,96
1261,TOR,2020-08-09,108,,MEM,1,240,34,71,0.479,19,32,0.594,15,39,0.385,25,33,0.758,108,37,91,0.407,23,49,0.469,14,42,0.333,11,16,0.688,99
1262,PHI,2020-08-07,108,,ORL,1,240,38,93,0.409,30,64,0.469,8,29,0.276,24,33,0.727,108,37,88,0.42,29,56,0.518,8,32,0.25,19,25,0.76,101
1263,UTA,2020-08-03,108,,LAL,0,240,37,83,0.446,25,40,0.625,12,43,0.279,22,25,0.88,108,41,82,0.5,32,56,0.571,9,26,0.346,25,31,0.806,116
1264,SAS,2020-08-02,108,@,MEM,1,240,36,86,0.419,24,57,0.421,12,29,0.414,24,33,0.727,108,42,91,0.462,35,61,0.574,7,30,0.233,15,18,0.833,106
1265,CHI,2020-03-10,108,,CLE,1,240,42,84,0.5,30,50,0.6,12,34,0.353,12,15,0.8,108,40,80,0.5,34,56,0.607,6,24,0.25,17,23,0.739,103
1266,CHO,2020-03-07,108,,HOU,1,240,37,70,0.529,22,38,0.579,15,32,0.469,19,25,0.76,108,35,76,0.461,20,31,0.645,15,45,0.333,14,20,0.7,99
1267,IND,2020-03-06,108,@,CHI,1,240,38,75,0.507,30,53,0.566,8,22,0.364,24,33,0.727,108,40,97,0.412,31,59,0.525,9,38,0.237,13,15,0.867,102
1268,SAC,2020-03-05,108,,PHI,0,240,42,79,0.532,31,50,0.62,11,29,0.379,13,18,0.722,108,47,96,0.49,30,59,0.508,17,37,0.459,14,17,0.824,125
1269,CHI,2020-03-04,108,@,MIN,0,240,45,94,0.479,34,64,0.531,11,30,0.367,7,11,0.636,108,40,81,0.494,21,38,0.553,19,43,0.442,16,25,0.64,115
1270,SAC,2020-02-27,108,@,OKC,0,240,41,91,0.451,29,56,0.518,12,35,0.343,14,14,1.0,108,41,84,0.488,32,58,0.552,9,26,0.346,21,29,0.724,112
1271,CLE,2020-02-26,108,,PHI,1,240,41,78,0.526,30,54,0.556,11,24,0.458,15,17,0.882,108,36,89,0.404,23,51,0.451,13,38,0.342,9,14,0.643,94
1272,MIL,2020-02-25,108,@,TOR,1,240,32,84,0.381,18,42,0.429,14,42,0.333,30,36,0.833,108,32,91,0.352,14,39,0.359,18,52,0.346,15,21,0.714,97
1273,WAS,2020-02-21,108,,CLE,0,240,41,106,0.387,32,69,0.464,9,37,0.243,17,23,0.739,108,43,81,0.531,32,54,0.593,11,27,0.407,16,25,0.64,113
1274,MIN,2020-02-12,108,,CHO,0,240,39,101,0.386,25,52,0.481,14,49,0.286,16,20,0.8,108,43,92,0.467,29,58,0.5,14,34,0.412,15,23,0.652,115
1275,PHO,2020-02-08,108,,DEN,0,240,38,87,0.437,29,55,0.527,9,32,0.281,23,23,1.0,108,45,82,0.549,34,54,0.63,11,28,0.393,16,21,0.762,117
1276,OKC,2020-02-07,108,,DET,1,240,39,76,0.513,34,53,0.642,5,23,0.217,25,30,0.833,108,38,89,0.427,27,51,0.529,11,38,0.289,14,19,0.737,101
1277,PHO,2020-02-05,108,@,DET,0,240,42,77,0.545,30,51,0.588,12,26,0.462,12,15,0.8,108,46,95,0.484,34,67,0.507,12,28,0.429,12,16,0.75,116
1278,NOP,2020-02-04,108,,MIL,0,240,38,99,0.384,24,50,0.48,14,49,0.286,18,24,0.75,108,48,102,0.471,37,66,0.561,11,36,0.306,13,17,0.765,120
1279,LAC,2020-02-03,108,,SAS,1,240,39,84,0.464,28,57,0.491,11,27,0.407,19,24,0.792,108,40,95,0.421,28,58,0.483,12,37,0.324,13,16,0.813,105
1280,PHO,2020-02-02,108,@,MIL,0,240,41,104,0.394,35,81,0.432,6,23,0.261,20,23,0.87,108,48,97,0.495,33,59,0.559,15,38,0.395,18,27,0.667,129
1281,BOS,2020-01-26,108,@,NOP,0,240,41,89,0.461,33,56,0.589,8,33,0.242,18,22,0.818,108,44,92,0.478,28,56,0.5,16,36,0.444,19,29,0.655,123
1282,PHI,2020-01-25,108,,LAL,1,240,41,78,0.526,28,41,0.683,13,37,0.351,13,19,0.684,108,35,76,0.461,29,45,0.644,6,31,0.194,15,23,0.652,91
1283,OKC,2020-01-17,108,,MIA,0,240,37,84,0.44,19,38,0.5,18,46,0.391,16,18,0.889,108,41,84,0.488,27,48,0.563,14,36,0.389,19,24,0.792,115
1284,BRK,2020-01-12,108,,ATL,1,240,41,77,0.532,31,51,0.608,10,26,0.385,16,29,0.552,108,32,97,0.33,20,49,0.408,12,48,0.25,10,11,0.909,86
1285,CHI,2020-01-11,108,@,DET,1,240,42,83,0.506,31,48,0.646,11,35,0.314,13,14,0.929,108,36,78,0.462,27,50,0.54,9,28,0.321,18,27,0.667,99
1286,IND,2020-01-08,108,,MIA,0,240,40,84,0.476,31,57,0.544,9,27,0.333,19,25,0.76,108,43,81,0.531,27,43,0.628,16,38,0.421,20,25,0.8,122
1287,CHI,2020-01-08,108,@,NOP,0,240,41,92,0.446,27,57,0.474,14,35,0.4,12,21,0.571,108,41,87,0.471,26,43,0.605,15,44,0.341,26,32,0.813,123
1288,PHI,2020-01-03,108,@,HOU,0,240,42,92,0.457,36,65,0.554,6,27,0.222,18,25,0.72,108,41,86,0.477,29,54,0.537,12,32,0.375,24,32,0.75,118
1289,LAL,2019-12-29,108,,DAL,1,240,38,78,0.487,29,55,0.527,9,23,0.391,23,28,0.821,108,32,89,0.36,19,46,0.413,13,43,0.302,18,20,0.9,95
1290,HOU,2019-12-28,108,,BRK,1,240,44,101,0.436,31,59,0.525,13,42,0.31,7,16,0.438,108,37,92,0.402,26,53,0.491,11,39,0.282,13,21,0.619,98
1291,WAS,2019-12-21,108,@,PHI,0,240,36,88,0.409,29,57,0.509,7,31,0.226,29,34,0.853,108,49,94,0.521,35,61,0.574,14,33,0.424,13,21,0.619,125
1292,PHO,2019-12-20,108,@,OKC,0,240,38,87,0.437,27,55,0.491,11,32,0.344,21,23,0.913,108,49,87,0.563,39,63,0.619,10,24,0.417,18,21,0.857,126
1293,MIA,2019-12-18,108,@,PHI,1,240,40,85,0.471,28,54,0.519,12,31,0.387,16,20,0.8,108,38,90,0.422,26,51,0.51,12,39,0.308,16,18,0.889,104
1294,BRK,2019-12-17,108,@,NOP,1,265,40,96,0.417,29,57,0.509,11,39,0.282,17,23,0.739,108,37,107,0.346,26,67,0.388,11,40,0.275,16,24,0.667,101
1295,CLE,2019-12-14,108,@,MIL,0,240,41,90,0.456,26,55,0.473,15,35,0.429,11,15,0.733,108,46,85,0.541,32,48,0.667,14,37,0.378,19,26,0.731,125
1296,BRK,2019-12-11,108,,CHO,0,240,38,88,0.432,28,50,0.56,10,38,0.263,22,33,0.667,108,36,88,0.409,21,53,0.396,15,35,0.429,26,32,0.813,113
1297,PHO,2019-12-11,108,,MEM,0,240,37,93,0.398,28,59,0.475,9,34,0.265,25,30,0.833,108,42,87,0.483,32,63,0.508,10,24,0.417,21,26,0.808,115
1298,OKC,2019-12-08,108,@,POR,1,240,35,85,0.412,24,53,0.453,11,32,0.344,27,34,0.794,108,36,100,0.36,27,67,0.403,9,33,0.273,15,18,0.833,96
1299,BOS,2019-12-06,108,,DEN,1,240,44,82,0.537,31,47,0.66,13,35,0.371,7,8,0.875,108,39,94,0.415,34,64,0.531,5,30,0.167,12,15,0.8,95
1300,DET,2019-12-06,108,,IND,1,240,39,87,0.448,28,62,0.452,11,25,0.44,19,26,0.731,108,38,83,0.458,29,59,0.492,9,24,0.375,16,20,0.8,101
1301,MIA,2019-11-27,108,@,HOU,0,240,37,80,0.463,23,43,0.535,14,37,0.378,20,27,0.741,108,38,83,0.458,23,39,0.59,15,44,0.341,26,33,0.788,117
1302,BRK,2019-11-25,108,@,CLE,1,240,44,94,0.468,33,60,0.55,11,34,0.324,9,11,0.818,108,40,94,0.426,27,62,0.435,13,32,0.406,13,20,0.65,106
1303,MEM,2019-11-23,108,,LAL,0,240,43,89,0.483,29,59,0.492,14,30,0.467,8,13,0.615,108,38,84,0.452,25,45,0.556,13,39,0.333,20,29,0.69,109
1304,CHI,2019-11-22,108,,MIA,0,240,41,90,0.456,31,60,0.517,10,30,0.333,16,20,0.8,108,39,79,0.494,25,41,0.61,14,38,0.368,24,28,0.857,116
1305,POR,2019-11-18,108,@,HOU,0,240,40,96,0.417,29,60,0.483,11,36,0.306,17,23,0.739,108,47,100,0.47,30,55,0.545,17,45,0.378,21,26,0.808,132
1306,NOP,2019-11-17,108,,GSW,1,240,37,89,0.416,19,43,0.442,18,46,0.391,16,20,0.8,108,37,91,0.407,30,66,0.455,7,25,0.28,19,23,0.826,100
1307,MIA,2019-11-14,108,@,CLE,1,240,43,79,0.544,31,49,0.633,12,30,0.4,10,11,0.909,108,36,85,0.424,28,53,0.528,8,32,0.25,17,21,0.81,97
1308,DET,2019-11-12,108,@,MIA,0,240,34,78,0.436,19,37,0.514,15,41,0.366,25,37,0.676,108,41,77,0.532,27,45,0.6,14,32,0.438,21,27,0.778,117
1309,GSW,2019-11-11,108,,UTA,0,240,45,94,0.479,35,63,0.556,10,31,0.323,8,14,0.571,108,40,81,0.494,24,46,0.522,16,35,0.457,26,32,0.813,122
1310,CLE,2019-11-10,108,@,NYK,1,240,36,82,0.439,28,54,0.519,8,28,0.286,28,31,0.903,108,31,86,0.36,22,55,0.4,9,31,0.29,16,25,0.64,87
1311,GSW,2019-11-09,108,@,OKC,0,240,42,85,0.494,35,63,0.556,7,22,0.318,17,17,1.0,108,43,79,0.544,29,49,0.592,14,30,0.467,14,17,0.824,114
1312,BOS,2019-11-07,108,@,CHO,1,240,40,93,0.43,30,60,0.5,10,33,0.303,18,23,0.783,108,33,86,0.384,27,55,0.491,6,31,0.194,15,21,0.714,87
1313,PHO,2019-11-07,108,,MIA,0,240,37,84,0.44,26,52,0.5,11,32,0.344,23,31,0.742,108,45,82,0.549,30,54,0.556,15,28,0.536,19,24,0.792,124
1314,ATL,2019-11-05,108,,SAS,1,240,43,90,0.478,32,60,0.533,11,30,0.367,11,16,0.688,108,38,91,0.418,30,58,0.517,8,33,0.242,16,23,0.696,100
1315,IND,2019-11-03,108,,CHI,1,240,40,85,0.471,32,59,0.542,8,26,0.308,20,27,0.741,108,36,84,0.429,27,55,0.491,9,29,0.31,14,25,0.56,95
1316,BRK,2019-10-30,108,,IND,0,240,41,93,0.441,31,62,0.5,10,31,0.323,16,26,0.615,108,45,96,0.469,34,70,0.486,11,26,0.423,17,20,0.85,118
1317,TOR,2019-10-26,108,@,CHI,1,240,38,82,0.463,23,40,0.575,15,42,0.357,17,18,0.944,108,29,97,0.299,20,62,0.323,9,35,0.257,17,25,0.68,84
1318,DEN,2019-10-25,108,,PHO,1,265,36,92,0.391,29,65,0.446,7,27,0.259,29,36,0.806,108,34,86,0.395,26,58,0.448,8,28,0.286,31,32,0.969,107
1319,DEN,2019-10-23,108,@,POR,1,240,34,81,0.42,16,49,0.327,18,32,0.563,22,27,0.815,108,36,87,0.414,29,59,0.492,7,28,0.25,21,23,0.913,100
1320,DAL,2019-10-23,108,,WAS,1,240,35,76,0.461,24,40,0.6,11,36,0.306,27,33,0.818,108,37,93,0.398,26,52,0.5,11,41,0.268,15,18,0.833,100
1321,LAC,2020-08-14,107,,OKC,1,265,34,85,0.4,22,48,0.458,12,37,0.324,27,39,0.692,107,38,106,0.358,24,62,0.387,14,44,0.318,13,22,0.591,103
1322,MEM,2020-08-11,107,,BOS,0,240,35,89,0.393,28,60,0.467,7,29,0.241,30,38,0.789,107,44,86,0.512,28,49,0.571,16,37,0.432,18,23,0.783,122
1323,WAS,2020-08-07,107,@,NOP,0,240,38,90,0.422,28,63,0.444,10,27,0.37,21,23,0.913,107,42,88,0.477,30,53,0.566,12,35,0.343,22,26,0.846,118
1324,PHI,2020-08-05,107,@,WAS,1,240,38,82,0.463,27,53,0.509,11,29,0.379,20,29,0.69,107,36,85,0.424,29,64,0.453,7,21,0.333,19,24,0.792,98
1325,TOR,2020-08-03,107,@,MIA,1,240,29,67,0.433,13,35,0.371,16,32,0.5,33,36,0.917,107,37,87,0.425,23,42,0.548,14,45,0.311,15,16,0.938,103
1326,TOR,2020-08-01,107,,LAL,1,240,35,84,0.417,21,50,0.42,14,34,0.412,23,26,0.885,107,29,82,0.354,19,42,0.452,10,40,0.25,24,33,0.727,92
1327,GSW,2020-03-10,107,,LAC,0,240,37,79,0.468,26,41,0.634,11,38,0.289,22,27,0.815,107,46,92,0.5,26,48,0.542,20,44,0.455,19,19,1.0,131
1328,MIN,2020-03-08,107,,NOP,0,240,37,94,0.394,29,61,0.475,8,33,0.242,25,31,0.806,107,44,90,0.489,33,55,0.6,11,35,0.314,21,31,0.677,120
1329,CHI,2020-03-08,107,@,BRK,0,240,39,92,0.424,27,58,0.466,12,34,0.353,17,25,0.68,107,32,64,0.5,21,34,0.618,11,30,0.367,35,41,0.854,110
1330,DET,2020-03-04,107,,OKC,0,240,40,86,0.465,22,43,0.512,18,43,0.419,9,15,0.6,107,46,75,0.613,36,51,0.706,10,24,0.417,12,17,0.706,114
1331,PHI,2020-03-03,107,@,LAL,0,240,38,85,0.447,22,45,0.489,16,40,0.4,15,20,0.75,107,46,86,0.535,33,53,0.623,13,33,0.394,15,18,0.833,120
1332,ORL,2020-03-02,107,,POR,0,240,37,96,0.385,23,53,0.434,14,43,0.326,19,22,0.864,107,49,88,0.557,33,55,0.6,16,33,0.485,16,16,1.0,130
1333,DAL,2020-03-02,107,@,CHI,0,240,40,84,0.476,28,42,0.667,12,42,0.286,15,20,0.75,107,44,94,0.468,34,58,0.586,10,36,0.278,11,17,0.647,109
1334,CHO,2020-02-26,107,,NYK,1,240,39,83,0.47,29,53,0.547,10,30,0.333,19,25,0.76,107,43,85,0.506,39,70,0.557,4,15,0.267,11,17,0.647,101
1335,POR,2020-02-23,107,,DET,1,240,41,84,0.488,28,54,0.519,13,30,0.433,12,19,0.632,107,37,86,0.43,26,51,0.51,11,35,0.314,19,20,0.95,104
1336,DAL,2020-02-22,107,@,ATL,0,240,40,89,0.449,26,45,0.578,14,44,0.318,13,19,0.684,107,43,98,0.439,35,61,0.574,8,37,0.216,17,26,0.654,111
1337,ATL,2020-02-07,107,@,BOS,0,240,35,86,0.407,22,47,0.468,13,39,0.333,24,26,0.923,107,37,86,0.43,21,49,0.429,16,37,0.432,22,27,0.815,112
1338,MEM,2020-02-07,107,@,PHI,0,240,38,93,0.409,33,72,0.458,5,21,0.238,26,31,0.839,107,48,90,0.533,34,65,0.523,14,25,0.56,9,15,0.6,119
1339,DAL,2020-02-05,107,,MEM,0,240,34,94,0.362,17,51,0.333,17,43,0.395,22,24,0.917,107,47,89,0.528,35,64,0.547,12,25,0.48,15,20,0.75,121
1340,BRK,2020-02-01,107,@,WAS,0,240,39,94,0.415,23,47,0.489,16,47,0.34,13,21,0.619,107,44,100,0.44,35,68,0.515,9,32,0.281,16,26,0.615,113
1341,UTA,2020-02-01,107,@,POR,0,240,40,94,0.426,22,53,0.415,18,41,0.439,9,9,1.0,107,47,92,0.511,32,63,0.508,15,29,0.517,15,18,0.833,124
1342,PHO,2020-01-31,107,,OKC,0,240,36,76,0.474,27,52,0.519,9,24,0.375,26,29,0.897,107,42,97,0.433,35,66,0.53,7,31,0.226,20,22,0.909,111
1343,CHO,2020-01-30,107,@,WAS,0,240,43,99,0.434,34,69,0.493,9,30,0.3,12,19,0.632,107,41,86,0.477,27,49,0.551,14,37,0.378,25,27,0.926,121
1344,DAL,2020-01-27,107,@,OKC,1,240,41,99,0.414,22,48,0.458,19,51,0.373,6,9,0.667,107,34,86,0.395,22,56,0.393,12,30,0.4,17,19,0.895,97
1345,DAL,2020-01-25,107,@,UTA,0,240,42,97,0.433,26,56,0.464,16,41,0.39,7,13,0.538,107,40,91,0.44,25,48,0.521,15,43,0.349,17,22,0.773,112
1346,TOR,2020-01-22,107,,PHI,1,240,40,86,0.465,27,53,0.509,13,33,0.394,14,21,0.667,107,32,84,0.381,14,38,0.368,18,46,0.391,13,18,0.722,95
1347,DAL,2020-01-21,107,,LAC,0,240,39,91,0.429,27,48,0.563,12,43,0.279,17,24,0.708,107,36,97,0.371,24,59,0.407,12,38,0.316,26,33,0.788,110
1348,DEN,2020-01-20,107,@,MIN,1,240,43,90,0.478,32,59,0.542,11,31,0.355,10,12,0.833,107,38,91,0.418,25,49,0.51,13,42,0.31,11,14,0.786,100
1349,HOU,2020-01-20,107,,OKC,0,240,43,97,0.443,34,52,0.654,9,45,0.2,12,17,0.706,107,40,92,0.435,28,60,0.467,12,32,0.375,20,26,0.769,112
1350,LAL,2020-01-20,107,@,BOS,0,240,39,89,0.438,32,63,0.508,7,26,0.269,22,29,0.759,107,52,93,0.559,36,59,0.61,16,34,0.471,19,29,0.655,139
1351,SAS,2020-01-19,107,,MIA,1,240,36,85,0.424,24,52,0.462,12,33,0.364,23,24,0.958,107,37,86,0.43,27,52,0.519,10,34,0.294,18,20,0.9,102
1352,DEN,2020-01-19,107,,IND,0,240,41,88,0.466,38,65,0.585,3,23,0.13,22,32,0.688,107,43,86,0.5,30,57,0.526,13,29,0.448,16,19,0.842,115
1353,HOU,2020-01-15,107,,POR,0,240,38,96,0.396,22,47,0.468,16,49,0.327,15,23,0.652,107,41,95,0.432,30,59,0.508,11,36,0.306,24,29,0.828,117
1354,BRK,2020-01-14,107,,UTA,0,240,45,90,0.5,37,64,0.578,8,26,0.308,9,15,0.6,107,46,92,0.5,33,56,0.589,13,36,0.361,13,15,0.867,118
1355,DEN,2020-01-08,107,@,DAL,1,240,41,85,0.482,32,61,0.525,9,24,0.375,16,20,0.8,107,39,77,0.506,27,42,0.643,12,35,0.343,16,24,0.667,106
1356,MIL,2020-01-08,107,@,GSW,1,240,35,87,0.402,26,46,0.565,9,41,0.22,28,32,0.875,107,33,87,0.379,18,49,0.367,15,38,0.395,17,20,0.85,98
1357,PHO,2020-01-01,107,@,LAL,0,240,42,86,0.488,36,63,0.571,6,23,0.261,17,23,0.739,107,43,90,0.478,36,62,0.581,7,28,0.25,24,34,0.706,117
1358,LAC,2019-12-28,107,,UTA,0,240,35,95,0.368,23,55,0.418,12,40,0.3,25,27,0.926,107,45,86,0.523,28,51,0.549,17,35,0.486,13,17,0.765,120
1359,NYK,2019-12-28,107,@,WAS,1,240,38,85,0.447,27,54,0.5,11,31,0.355,20,26,0.769,107,33,96,0.344,23,71,0.324,10,25,0.4,24,31,0.774,100
1360,MIA,2019-12-23,107,,UTA,1,240,37,90,0.411,28,65,0.431,9,25,0.36,24,27,0.889,107,39,90,0.433,27,54,0.5,12,36,0.333,14,18,0.778,104
1361,DAL,2019-12-22,107,@,TOR,0,240,35,90,0.389,20,44,0.455,15,46,0.326,22,27,0.815,107,37,94,0.394,27,60,0.45,10,34,0.294,26,31,0.839,110
1362,DET,2019-12-21,107,,CHI,0,240,40,87,0.46,24,52,0.462,16,35,0.457,11,12,0.917,107,40,77,0.519,22,42,0.524,18,35,0.514,21,25,0.84,119
1363,CHO,2019-12-21,107,,UTA,0,240,39,85,0.459,27,56,0.482,12,29,0.414,17,22,0.773,107,39,75,0.52,22,41,0.537,17,34,0.5,19,20,0.95,114
1364,MEM,2019-12-20,107,@,CLE,0,240,44,102,0.431,30,61,0.492,14,41,0.341,5,7,0.714,107,40,92,0.435,23,55,0.418,17,37,0.459,17,23,0.739,114
1365,NOP,2019-12-18,107,@,MIN,1,240,38,86,0.442,24,53,0.453,14,33,0.424,17,21,0.81,107,36,95,0.379,26,56,0.464,10,39,0.256,17,27,0.63,99
1366,SAS,2019-12-16,107,@,HOU,0,240,39,91,0.429,27,58,0.466,12,33,0.364,17,20,0.85,107,40,98,0.408,29,55,0.527,11,43,0.256,18,27,0.667,109
1367,IND,2019-12-15,107,,CHO,1,240,40,88,0.455,30,53,0.566,10,35,0.286,17,20,0.85,107,28,91,0.308,23,59,0.39,5,32,0.156,24,35,0.686,85
1368,HOU,2019-12-14,107,,DET,0,240,41,102,0.402,28,57,0.491,13,45,0.289,12,18,0.667,107,41,92,0.446,29,55,0.527,12,37,0.324,21,25,0.84,115
1369,ORL,2019-12-13,107,,HOU,0,240,40,91,0.44,25,54,0.463,15,37,0.405,12,16,0.75,107,48,86,0.558,26,47,0.553,22,39,0.564,12,13,0.923,130
1370,WAS,2019-12-10,107,@,CHO,0,240,38,90,0.422,27,55,0.491,11,35,0.314,20,25,0.8,107,38,85,0.447,22,44,0.5,16,41,0.39,22,28,0.786,114
1371,CHO,2019-12-08,107,,ATL,0,240,36,90,0.4,25,59,0.424,11,31,0.355,24,29,0.828,107,44,91,0.484,26,46,0.565,18,45,0.4,16,17,0.941,122
1372,IND,2019-12-04,107,@,OKC,1,240,42,87,0.483,33,63,0.524,9,24,0.375,14,17,0.824,107,41,84,0.488,32,58,0.552,9,26,0.346,9,10,0.9,100
1373,MIN,2019-12-01,107,,MEM,0,240,33,85,0.388,22,49,0.449,11,36,0.306,30,35,0.857,107,41,100,0.41,25,60,0.417,16,40,0.4,17,21,0.81,115
1374,OKC,2019-12-01,107,@,NOP,1,240,38,81,0.469,27,48,0.563,11,33,0.333,20,26,0.769,107,39,87,0.448,22,49,0.449,17,38,0.447,9,10,0.9,104
1375,BOS,2019-11-29,107,@,BRK,0,240,41,93,0.441,32,65,0.492,9,28,0.321,16,21,0.762,107,43,93,0.462,26,52,0.5,17,41,0.415,9,13,0.692,112
1376,DET,2019-11-29,107,,CHO,0,240,41,83,0.494,26,48,0.542,15,35,0.429,10,20,0.5,107,40,83,0.482,21,45,0.467,19,38,0.5,11,15,0.733,110
1377,SAS,2019-11-29,107,,LAC,1,240,40,93,0.43,26,57,0.456,14,36,0.389,13,14,0.929,107,36,92,0.391,24,59,0.407,12,33,0.364,13,13,1.0,97
1378,POR,2019-11-29,107,,CHI,1,240,38,84,0.452,28,54,0.519,10,30,0.333,21,28,0.75,107,36,94,0.383,22,56,0.393,14,38,0.368,17,25,0.68,103
1379,LAC,2019-11-20,107,,BOS,1,265,39,93,0.419,22,48,0.458,17,45,0.378,12,16,0.75,107,41,104,0.394,29,59,0.492,12,45,0.267,10,14,0.714,104
1380,OKC,2019-11-19,107,@,LAL,0,240,38,80,0.475,29,52,0.558,9,28,0.321,22,25,0.88,107,43,89,0.483,29,58,0.5,14,31,0.452,12,19,0.632,112
1381,MEM,2019-11-15,107,,UTA,1,240,43,96,0.448,33,61,0.541,10,35,0.286,11,13,0.846,107,35,87,0.402,26,53,0.491,9,34,0.265,27,32,0.844,106
1382,SAC,2019-11-12,107,,POR,1,240,38,86,0.442,27,54,0.5,11,32,0.344,20,26,0.769,107,34,77,0.442,26,47,0.553,8,30,0.267,23,30,0.767,99
1383,LAC,2019-11-07,107,,POR,1,240,39,89,0.438,35,66,0.53,4,23,0.174,25,30,0.833,107,39,104,0.375,28,65,0.431,11,39,0.282,12,16,0.75,101
1384,DAL,2019-11-06,107,,ORL,1,240,36,84,0.429,25,53,0.472,11,31,0.355,24,30,0.8,107,39,80,0.488,33,56,0.589,6,24,0.25,22,28,0.786,106
1385,HOU,2019-11-04,107,@,MEM,1,240,35,93,0.376,18,43,0.419,17,50,0.34,20,29,0.69,107,40,94,0.426,37,69,0.536,3,25,0.12,17,21,0.81,100
1386,DEN,2019-10-31,107,@,NOP,0,240,43,89,0.483,36,63,0.571,7,26,0.269,14,16,0.875,107,41,77,0.532,26,44,0.591,15,33,0.455,25,32,0.781,122
1387,PHO,2019-10-25,107,@,DEN,0,265,34,86,0.395,26,58,0.448,8,28,0.286,31,32,0.969,107,36,92,0.391,29,65,0.446,7,27,0.259,29,36,0.806,108
1388,PHI,2019-10-23,107,,BOS,1,240,37,85,0.435,30,56,0.536,7,29,0.241,26,36,0.722,107,33,90,0.367,26,64,0.406,7,26,0.269,20,34,0.588,93
1389,MIL,2020-08-13,106,@,MEM,0,240,39,98,0.398,26,57,0.456,13,41,0.317,15,23,0.652,106,45,90,0.5,32,57,0.561,13,33,0.394,16,23,0.696,119
1390,NOP,2020-08-11,106,@,SAC,0,240,42,82,0.512,35,58,0.603,7,24,0.292,15,19,0.789,106,43,88,0.489,32,62,0.516,11,26,0.423,15,16,0.938,112
1391,MIL,2020-08-10,106,,TOR,0,240,33,84,0.393,19,41,0.463,14,43,0.326,26,35,0.743,106,42,97,0.433,30,57,0.526,12,40,0.3,18,26,0.692,114
1392,SAC,2020-08-07,106,@,BRK,0,240,38,89,0.427,26,49,0.531,12,40,0.3,18,24,0.75,106,42,86,0.488,25,46,0.543,17,40,0.425,18,28,0.643,119
1393,BOS,2020-08-04,106,@,MIA,0,240,37,85,0.435,27,52,0.519,10,33,0.303,22,27,0.815,106,34,77,0.442,19,34,0.559,15,43,0.349,29,39,0.744,112
1394,MEM,2020-08-02,106,,SAS,0,240,42,91,0.462,35,61,0.574,7,30,0.233,15,18,0.833,106,36,86,0.419,24,57,0.421,12,29,0.414,24,33,0.727,108
1395,UTA,2020-07-30,106,@,NOP,1,240,37,84,0.44,29,50,0.58,8,34,0.235,24,28,0.857,106,40,94,0.426,29,63,0.46,11,31,0.355,13,18,0.722,104
1396,DET,2020-03-11,106,@,PHI,0,240,39,84,0.464,28,49,0.571,11,35,0.314,17,25,0.68,106,42,83,0.506,28,50,0.56,14,33,0.424,26,32,0.813,124
1397,HOU,2020-03-08,106,,ORL,0,240,39,88,0.443,30,56,0.536,9,32,0.281,19,25,0.76,106,44,91,0.484,31,62,0.5,13,29,0.448,25,31,0.806,126
1398,CLE,2020-03-04,106,,BOS,0,240,39,89,0.438,26,51,0.51,13,38,0.342,15,20,0.75,106,40,86,0.465,29,56,0.518,11,30,0.367,21,26,0.808,112
1399,SAC,2020-03-01,106,,DET,1,240,37,91,0.407,28,56,0.5,9,35,0.257,23,26,0.885,106,33,80,0.413,15,38,0.395,18,42,0.429,16,24,0.667,100
1400,IND,2020-02-27,106,,POR,1,240,40,90,0.444,32,65,0.492,8,25,0.32,18,23,0.783,106,41,89,0.461,32,59,0.542,9,30,0.3,9,14,0.643,100
1401,NYK,2020-02-27,106,@,PHI,0,240,42,83,0.506,34,60,0.567,8,23,0.348,14,24,0.583,106,45,91,0.495,30,60,0.5,15,31,0.484,10,13,0.769,115
1402,BRK,2020-02-26,106,@,WAS,0,240,36,87,0.414,26,51,0.51,10,36,0.278,24,35,0.686,106,41,96,0.427,26,57,0.456,15,39,0.385,13,16,0.813,110
1403,POR,2020-02-25,106,,BOS,0,240,38,85,0.447,25,54,0.463,13,31,0.419,17,23,0.739,106,43,90,0.478,24,51,0.471,19,39,0.487,13,14,0.929,118
1404,ORL,2020-02-21,106,,DAL,0,240,41,104,0.394,32,61,0.525,9,43,0.209,15,19,0.789,106,43,84,0.512,28,46,0.609,15,38,0.395,21,26,0.808,122
1405,IND,2020-02-21,106,@,NYK,1,240,36,88,0.409,28,60,0.467,8,28,0.286,26,33,0.788,106,35,81,0.432,24,56,0.429,11,25,0.44,17,25,0.68,98
1406,DET,2020-02-20,106,,MIL,0,240,40,83,0.482,27,46,0.587,13,37,0.351,13,16,0.813,106,47,93,0.505,37,60,0.617,10,33,0.303,22,27,0.815,126
1407,GSW,2020-02-12,106,@,PHO,0,240,39,77,0.506,28,46,0.609,11,31,0.355,17,19,0.895,106,42,91,0.462,28,54,0.519,14,37,0.378,14,15,0.933,112
1408,OKC,2020-02-11,106,,SAS,0,240,39,85,0.459,28,54,0.519,11,31,0.355,17,21,0.81,106,41,84,0.488,34,59,0.576,7,25,0.28,25,27,0.926,114
1409,BRK,2020-02-10,106,@,IND,1,240,35,87,0.402,23,50,0.46,12,37,0.324,24,32,0.75,106,45,92,0.489,38,62,0.613,7,30,0.233,8,11,0.727,105
1410,MEM,2020-02-09,106,@,WAS,1,240,43,102,0.422,38,70,0.543,5,32,0.156,15,25,0.6,106,35,100,0.35,28,67,0.418,7,33,0.212,22,29,0.759,99
1411,IND,2020-02-07,106,,TOR,0,240,39,86,0.453,29,52,0.558,10,34,0.294,18,22,0.818,106,42,88,0.477,25,50,0.5,17,38,0.447,14,17,0.824,115
1412,PHI,2020-02-03,106,@,MIA,0,240,36,83,0.434,23,45,0.511,13,38,0.342,21,25,0.84,106,48,85,0.565,32,53,0.604,16,32,0.5,25,30,0.833,137
1413,MIN,2020-02-01,106,@,LAC,0,240,34,84,0.405,27,45,0.6,7,39,0.179,31,37,0.838,106,45,98,0.459,33,64,0.516,12,34,0.353,16,18,0.889,118
1414,DEN,2020-01-30,106,,UTA,1,240,40,85,0.471,31,58,0.534,9,27,0.333,17,21,0.81,106,36,78,0.462,19,41,0.463,17,37,0.459,11,17,0.647,100
1415,CHI,2020-01-29,106,@,IND,0,265,45,85,0.529,39,52,0.75,6,33,0.182,10,15,0.667,106,46,89,0.517,39,62,0.629,7,27,0.259,16,22,0.727,115
1416,NYK,2020-01-29,106,,MEM,0,240,39,91,0.429,30,63,0.476,9,28,0.321,19,29,0.655,106,43,86,0.5,30,58,0.517,13,28,0.464,28,33,0.848,127
1417,SAS,2020-01-26,106,,TOR,0,240,34,82,0.415,18,45,0.4,16,37,0.432,22,24,0.917,106,41,99,0.414,25,49,0.51,16,50,0.32,12,15,0.8,110
1418,CLE,2020-01-25,106,,CHI,0,240,42,84,0.5,29,54,0.537,13,30,0.433,9,11,0.818,106,44,85,0.518,32,52,0.615,12,33,0.364,18,24,0.75,118
1419,NOP,2020-01-24,106,,DEN,0,240,38,82,0.463,26,55,0.473,12,27,0.444,18,30,0.6,106,40,106,0.377,27,65,0.415,13,41,0.317,20,20,1.0,113
1420,SAC,2020-01-22,106,@,DET,0,240,42,98,0.429,32,63,0.508,10,35,0.286,12,23,0.522,106,39,73,0.534,27,44,0.614,12,29,0.414,37,44,0.841,127
1421,WAS,2020-01-20,106,,DET,1,240,42,82,0.512,33,58,0.569,9,24,0.375,13,16,0.813,106,38,89,0.427,28,57,0.491,10,32,0.313,14,20,0.7,100
1422,ORL,2020-01-20,106,@,CHO,1,240,44,92,0.478,30,64,0.469,14,28,0.5,4,9,0.444,106,29,76,0.382,19,43,0.442,10,33,0.303,15,20,0.75,83
1423,NYK,2020-01-20,106,@,CLE,1,240,41,85,0.482,32,62,0.516,9,23,0.391,15,17,0.882,106,32,94,0.34,21,61,0.344,11,33,0.333,11,17,0.647,86
1424,POR,2020-01-18,106,@,OKC,0,240,39,91,0.429,27,59,0.458,12,32,0.375,16,21,0.762,106,43,83,0.518,36,61,0.59,7,22,0.318,26,36,0.722,119
1425,WAS,2020-01-15,106,@,CHI,0,240,37,79,0.468,26,52,0.5,11,27,0.407,21,26,0.808,106,43,85,0.506,29,47,0.617,14,38,0.368,15,22,0.682,115
1426,MIA,2020-01-15,106,,SAS,1,240,41,88,0.466,24,48,0.5,17,40,0.425,7,13,0.538,106,39,89,0.438,29,56,0.518,10,33,0.303,12,15,0.8,100
1427,BRK,2020-01-15,106,@,PHI,0,240,38,87,0.437,26,62,0.419,12,25,0.48,18,30,0.6,106,45,88,0.511,34,58,0.586,11,30,0.367,16,25,0.64,117
1428,SAC,2020-01-10,106,,MIL,0,240,44,96,0.458,34,61,0.557,10,35,0.286,8,10,0.8,106,47,95,0.495,37,56,0.661,10,39,0.256,23,30,0.767,127
1429,DAL,2020-01-08,106,,DEN,0,240,39,77,0.506,27,42,0.643,12,35,0.343,16,24,0.667,106,41,85,0.482,32,61,0.525,9,24,0.375,16,20,0.8,107
1430,LAL,2020-01-05,106,,DET,1,240,42,92,0.457,36,72,0.5,6,20,0.3,16,23,0.696,106,29,78,0.372,18,52,0.346,11,26,0.423,30,35,0.857,99
1431,CLE,2020-01-04,106,,OKC,0,240,39,85,0.459,25,55,0.455,14,30,0.467,14,17,0.824,106,43,96,0.448,29,59,0.492,14,37,0.378,21,26,0.808,121
1432,ATL,2020-01-03,106,@,BOS,0,240,39,93,0.419,23,48,0.479,16,45,0.356,12,15,0.8,106,41,93,0.441,35,68,0.515,6,25,0.24,21,29,0.724,109
1433,CLE,2020-01-02,106,,CHO,0,240,41,81,0.506,28,46,0.609,13,35,0.371,11,14,0.786,106,37,83,0.446,22,45,0.489,15,38,0.395,20,24,0.833,109
1434,MIL,2020-01-01,106,,MIN,1,240,40,94,0.426,31,58,0.534,9,36,0.25,17,26,0.654,106,34,91,0.374,19,45,0.422,15,46,0.326,21,28,0.75,104
1435,OKC,2019-12-31,106,,DAL,1,240,39,91,0.429,33,64,0.516,6,27,0.222,22,28,0.786,106,33,93,0.355,18,42,0.429,15,51,0.294,20,27,0.741,101
1436,LAL,2019-12-25,106,,LAC,0,240,39,96,0.406,27,51,0.529,12,45,0.267,16,21,0.762,106,39,85,0.459,30,60,0.5,9,25,0.36,24,32,0.75,111
1437,MIN,2019-12-21,106,@,POR,0,240,38,87,0.437,23,50,0.46,15,37,0.405,15,16,0.938,106,40,94,0.426,27,59,0.458,13,35,0.371,20,25,0.8,113
1438,GSW,2019-12-20,106,,NOP,1,240,36,83,0.434,26,50,0.52,10,33,0.303,24,25,0.96,106,39,93,0.419,30,59,0.508,9,34,0.265,15,23,0.652,102
1439,ATL,2019-12-19,106,,UTA,0,240,39,90,0.433,28,61,0.459,11,29,0.379,17,19,0.895,106,39,83,0.47,33,59,0.559,6,24,0.25,27,38,0.711,111
1440,CHI,2019-12-16,106,@,OKC,0,240,43,87,0.494,34,56,0.607,9,31,0.29,11,13,0.846,106,35,69,0.507,19,35,0.543,16,34,0.471,23,28,0.821,109
1441,LAC,2019-12-14,106,@,CHI,0,240,35,80,0.438,25,58,0.431,10,22,0.455,26,36,0.722,106,40,85,0.471,26,54,0.481,14,31,0.452,15,18,0.833,109
1442,GSW,2019-12-13,106,@,UTA,0,240,41,91,0.451,32,62,0.516,9,29,0.31,15,22,0.682,106,37,79,0.468,21,41,0.512,16,38,0.421,24,31,0.774,114
1443,DAL,2019-12-08,106,,SAC,0,240,41,86,0.477,24,42,0.571,17,44,0.386,7,8,0.875,106,44,85,0.518,31,51,0.608,13,34,0.382,9,11,0.818,110
1444,CHI,2019-12-04,106,,MEM,1,240,33,77,0.429,20,44,0.455,13,33,0.394,27,37,0.73,106,37,96,0.385,30,66,0.455,7,30,0.233,18,21,0.857,99
1445,CHO,2019-12-04,106,,GSW,1,240,40,87,0.46,19,39,0.487,21,48,0.438,5,8,0.625,106,36,78,0.462,27,55,0.491,9,23,0.391,10,15,0.667,91
1446,SAC,2019-12-02,106,,CHI,0,240,40,83,0.482,31,50,0.62,9,33,0.273,17,20,0.85,106,36,75,0.48,20,38,0.526,16,37,0.432,25,29,0.862,113
1447,BRK,2019-12-01,106,,MIA,0,240,40,91,0.44,26,49,0.531,14,42,0.333,12,16,0.75,106,37,95,0.389,25,58,0.431,12,37,0.324,23,28,0.821,109
1448,CLE,2019-11-25,106,,BRK,0,240,40,94,0.426,27,62,0.435,13,32,0.406,13,20,0.65,106,44,94,0.468,33,60,0.55,11,34,0.324,9,11,0.818,108
1449,WAS,2019-11-24,106,,SAC,0,240,42,92,0.457,29,58,0.5,13,34,0.382,9,12,0.75,106,39,81,0.481,28,50,0.56,11,31,0.355,24,28,0.857,113
1450,ORL,2019-11-23,106,@,IND,0,240,43,92,0.467,30,61,0.492,13,31,0.419,7,9,0.778,106,43,79,0.544,33,55,0.6,10,24,0.417,15,16,0.938,111
1451,UTA,2019-11-15,106,@,MEM,0,240,35,87,0.402,26,53,0.491,9,34,0.265,27,32,0.844,106,43,96,0.448,33,61,0.541,10,35,0.286,11,13,0.846,107
1452,DET,2019-11-15,106,@,CHO,0,240,40,81,0.494,25,46,0.543,15,35,0.429,11,11,1.0,106,43,96,0.448,30,61,0.492,13,35,0.371,10,16,0.625,109
1453,NYK,2019-11-14,106,,DAL,1,240,42,94,0.447,29,64,0.453,13,30,0.433,9,11,0.818,106,36,84,0.429,28,48,0.583,8,36,0.222,23,31,0.742,103
1454,POR,2019-11-13,106,,TOR,0,240,38,96,0.396,21,48,0.438,17,48,0.354,13,16,0.813,106,42,92,0.457,28,60,0.467,14,32,0.438,16,17,0.941,114
1455,DAL,2019-11-11,106,@,BOS,0,240,37,89,0.416,26,47,0.553,11,42,0.262,21,28,0.75,106,41,86,0.477,26,51,0.51,15,35,0.429,19,25,0.76,116
1456,CHO,2019-11-10,106,@,PHI,0,240,38,84,0.452,24,51,0.471,14,33,0.424,16,22,0.727,106,46,84,0.548,36,56,0.643,10,28,0.357,12,16,0.75,114
1457,DET,2019-11-08,106,@,IND,0,240,39,86,0.453,26,53,0.491,13,33,0.394,15,18,0.833,106,43,83,0.518,39,68,0.574,4,15,0.267,22,25,0.88,112
1458,NYK,2019-11-08,106,@,DAL,1,240,37,89,0.416,23,61,0.377,14,28,0.5,18,31,0.581,106,37,90,0.411,23,46,0.5,14,44,0.318,14,17,0.824,102
1459,WAS,2019-11-06,106,@,IND,0,240,37,95,0.389,24,55,0.436,13,40,0.325,19,19,1.0,106,44,94,0.468,32,64,0.5,12,30,0.4,21,26,0.808,121
1460,UTA,2019-11-06,106,,PHI,1,240,41,89,0.461,33,67,0.493,8,22,0.364,16,24,0.667,106,33,80,0.413,25,55,0.455,8,25,0.32,30,34,0.882,104
1461,ORL,2019-11-06,106,@,DAL,0,240,39,80,0.488,33,56,0.589,6,24,0.25,22,28,0.786,106,36,84,0.429,25,53,0.472,11,31,0.355,24,30,0.8,107
1462,MIN,2019-11-04,106,,MIL,0,240,37,103,0.359,24,60,0.4,13,43,0.302,19,22,0.864,106,50,93,0.538,36,54,0.667,14,39,0.359,20,30,0.667,134
1463,DET,2019-11-01,106,@,CHI,0,240,41,85,0.482,35,56,0.625,6,29,0.207,18,24,0.75,106,39,89,0.438,23,49,0.469,16,40,0.4,18,23,0.783,112
1464,MIA,2019-10-31,106,@,ATL,1,240,40,84,0.476,26,47,0.553,14,37,0.378,12,19,0.632,106,36,88,0.409,29,54,0.537,7,34,0.206,18,26,0.692,97
1465,DEN,2019-10-29,106,,DAL,0,240,43,91,0.473,32,59,0.542,11,32,0.344,9,13,0.692,106,41,84,0.488,28,47,0.596,13,37,0.351,14,24,0.583,109
1466,TOR,2019-10-25,106,@,BOS,0,240,37,78,0.474,19,42,0.452,18,36,0.5,14,17,0.824,106,42,109,0.385,29,71,0.408,13,38,0.342,15,16,0.938,112
1467,HOU,2020-08-11,105,@,SAS,0,240,36,89,0.404,22,41,0.537,14,48,0.292,19,21,0.905,105,46,93,0.495,33,61,0.541,13,32,0.406,18,20,0.9,123
1468,OKC,2020-08-05,105,@,LAL,1,240,34,79,0.43,29,55,0.527,5,24,0.208,32,36,0.889,105,31,88,0.352,26,51,0.51,5,37,0.135,19,29,0.655,86
1469,DEN,2020-08-01,105,,MIA,0,240,39,89,0.438,31,54,0.574,8,35,0.229,19,24,0.792,105,40,72,0.556,27,43,0.628,13,29,0.448,32,37,0.865,125
1470,PHO,2020-03-10,105,@,POR,0,240,35,87,0.402,24,55,0.436,11,32,0.344,24,25,0.96,105,45,89,0.506,28,54,0.519,17,35,0.486,14,17,0.824,121
1471,OKC,2020-03-08,105,@,BOS,1,240,35,79,0.443,25,54,0.463,10,25,0.4,25,34,0.735,105,38,92,0.413,25,55,0.455,13,37,0.351,15,19,0.789,104
1472,DET,2020-03-07,105,,UTA,0,240,40,86,0.465,31,56,0.554,9,30,0.3,16,22,0.727,105,40,77,0.519,30,44,0.682,10,33,0.303,21,28,0.75,111
1473,HOU,2020-03-05,105,,LAC,0,240,35,97,0.361,28,55,0.509,7,42,0.167,28,36,0.778,105,39,84,0.464,26,44,0.591,13,40,0.325,29,39,0.744,120
1474,MIA,2020-03-02,105,,MIL,1,240,37,86,0.43,19,49,0.388,18,37,0.486,13,18,0.722,105,35,86,0.407,28,52,0.538,7,34,0.206,12,19,0.632,89
1475,MEM,2020-02-29,105,,LAL,1,240,43,95,0.453,33,64,0.516,10,31,0.323,9,11,0.818,105,36,87,0.414,27,52,0.519,9,35,0.257,7,12,0.583,88
1476,CLE,2020-02-22,105,@,MIA,0,240,38,79,0.481,25,43,0.581,13,36,0.361,16,22,0.727,105,45,79,0.57,26,39,0.667,19,40,0.475,15,20,0.75,124
1477,MEM,2020-02-21,105,@,LAL,0,240,42,92,0.457,37,77,0.481,5,15,0.333,16,31,0.516,105,41,86,0.477,32,57,0.561,9,29,0.31,26,40,0.65,117
1478,GSW,2020-02-20,105,,HOU,0,240,44,89,0.494,37,56,0.661,7,33,0.212,10,12,0.833,105,45,85,0.529,20,36,0.556,25,49,0.51,20,22,0.909,135
1479,ATL,2020-02-12,105,@,CLE,0,240,36,84,0.429,23,50,0.46,13,34,0.382,20,25,0.8,105,48,94,0.511,38,66,0.576,10,28,0.357,21,25,0.84,127
1480,BOS,2020-02-11,105,@,HOU,0,240,37,85,0.435,26,53,0.491,11,32,0.344,20,25,0.8,105,33,77,0.429,20,32,0.625,13,45,0.289,37,42,0.881,116
1481,IND,2020-02-10,105,,BRK,0,240,45,92,0.489,38,62,0.613,7,30,0.233,8,11,0.727,105,35,87,0.402,23,50,0.46,12,37,0.324,24,32,0.75,106
1482,SAC,2020-02-07,105,,MIA,1,240,40,82,0.488,21,38,0.553,19,44,0.432,6,12,0.5,105,34,77,0.442,22,37,0.595,12,40,0.3,17,25,0.68,97
1483,NYK,2020-02-06,105,,ORL,1,240,43,92,0.467,37,72,0.514,6,20,0.3,13,19,0.684,105,34,75,0.453,25,44,0.568,9,31,0.29,26,30,0.867,103
1484,SAS,2020-02-03,105,@,LAC,0,240,40,95,0.421,28,58,0.483,12,37,0.324,13,16,0.813,105,39,84,0.464,28,57,0.491,11,27,0.407,19,24,0.792,108
1485,TOR,2020-01-31,105,@,DET,1,240,44,85,0.518,35,58,0.603,9,27,0.333,8,11,0.727,105,28,79,0.354,17,43,0.395,11,36,0.306,25,34,0.735,92
1486,DEN,2020-01-22,105,@,HOU,0,240,42,92,0.457,32,64,0.5,10,28,0.357,11,15,0.733,105,42,89,0.472,29,60,0.483,13,29,0.448,24,28,0.857,121
1487,SAS,2020-01-12,105,@,TOR,1,240,38,87,0.437,31,55,0.564,7,32,0.219,22,30,0.733,105,39,96,0.406,22,48,0.458,17,48,0.354,9,11,0.818,104
1488,NOP,2020-01-11,105,@,BOS,0,240,40,100,0.4,26,55,0.473,14,45,0.311,11,18,0.611,105,55,100,0.55,41,71,0.577,14,29,0.483,16,18,0.889,140
1489,CHI,2020-01-10,105,,IND,0,240,37,80,0.463,19,39,0.487,18,41,0.439,13,16,0.813,105,48,84,0.571,37,54,0.685,11,30,0.367,9,14,0.643,116
1490,ORL,2020-01-03,105,,MIA,1,240,33,81,0.407,20,46,0.435,13,35,0.371,26,29,0.897,105,30,80,0.375,23,43,0.535,7,37,0.189,18,23,0.783,85
1491,LAC,2019-12-31,105,@,SAC,1,240,36,88,0.409,24,52,0.462,12,36,0.333,21,22,0.955,105,33,80,0.413,25,52,0.481,8,28,0.286,13,19,0.684,87
1492,MIA,2019-12-30,105,@,WAS,0,240,33,73,0.452,23,45,0.511,10,28,0.357,29,39,0.744,105,43,84,0.512,26,47,0.553,17,37,0.459,20,30,0.667,123
1493,GSW,2019-12-27,105,,PHO,1,240,38,92,0.413,29,65,0.446,9,27,0.333,20,25,0.8,105,35,75,0.467,28,42,0.667,7,33,0.212,19,24,0.792,96
1494,MIN,2019-12-26,105,@,SAC,1,290,36,104,0.346,26,58,0.448,10,46,0.217,23,29,0.793,105,37,107,0.346,28,68,0.412,9,39,0.231,21,25,0.84,104
1495,SAC,2019-12-20,105,@,IND,0,240,41,91,0.451,31,59,0.525,10,32,0.313,13,15,0.867,105,45,86,0.523,31,55,0.564,14,31,0.452,15,18,0.833,119
1496,BRK,2019-12-19,105,@,SAS,0,240,35,83,0.422,28,47,0.596,7,36,0.194,28,30,0.933,105,43,96,0.448,30,63,0.476,13,33,0.394,19,23,0.826,118
1497,IND,2019-12-17,105,,LAL,1,240,41,85,0.482,31,60,0.517,10,25,0.4,13,20,0.65,105,43,91,0.473,35,60,0.583,8,31,0.258,8,17,0.471,102
1498,NYK,2019-12-15,105,@,DEN,0,240,44,94,0.468,36,62,0.581,8,32,0.25,9,10,0.9,105,44,94,0.468,34,66,0.515,10,28,0.357,13,19,0.684,111
1499,DET,2019-12-09,105,@,NOP,1,240,36,85,0.424,25,50,0.5,11,35,0.314,22,27,0.815,105,40,91,0.44,32,53,0.604,8,38,0.211,15,22,0.682,103
1500,CHI,2019-12-08,105,@,MIA,0,265,35,80,0.438,22,44,0.5,13,36,0.361,22,27,0.815,105,32,77,0.416,21,42,0.5,11,35,0.314,35,44,0.795,110
1501,BRK,2019-12-08,105,,DEN,1,240,40,87,0.46,33,59,0.559,7,28,0.25,18,23,0.783,105,36,89,0.404,18,47,0.383,18,42,0.429,12,14,0.857,102
1502,SAS,2019-12-06,105,,SAC,1,265,41,96,0.427,30,64,0.469,11,32,0.344,12,17,0.706,105,40,102,0.392,31,68,0.456,9,34,0.265,15,18,0.833,104
1503,LAL,2019-12-03,105,@,DEN,1,240,39,84,0.464,32,60,0.533,7,24,0.292,20,30,0.667,105,37,91,0.407,31,62,0.5,6,29,0.207,16,17,0.941,96
1504,GSW,2019-11-29,105,@,MIA,0,240,30,77,0.39,20,49,0.408,10,28,0.357,35,40,0.875,105,44,82,0.537,31,57,0.544,13,25,0.52,21,28,0.75,122
1505,IND,2019-11-29,105,,ATL,1,265,39,92,0.424,33,66,0.5,6,26,0.231,21,28,0.75,105,39,90,0.433,30,58,0.517,9,32,0.281,17,18,0.944,104
1506,DEN,2019-11-20,105,,HOU,1,240,44,94,0.468,35,67,0.522,9,27,0.333,8,15,0.533,105,32,76,0.421,20,38,0.526,12,38,0.316,19,25,0.76,95
1507,CLE,2019-11-18,105,@,NYK,0,240,36,76,0.474,19,40,0.475,17,36,0.472,16,30,0.533,105,44,98,0.449,36,75,0.48,8,23,0.348,27,35,0.771,123
1508,MIN,2019-11-16,105,,HOU,0,240,38,84,0.452,26,46,0.565,12,38,0.316,17,23,0.739,105,43,94,0.457,24,45,0.533,19,49,0.388,20,22,0.909,125
1509,BOS,2019-11-15,105,@,GSW,1,240,37,91,0.407,24,58,0.414,13,33,0.394,18,23,0.783,105,34,82,0.415,29,54,0.537,5,28,0.179,27,34,0.794,100
1510,LAC,2019-11-03,105,,UTA,1,240,36,92,0.391,29,60,0.483,7,32,0.219,26,34,0.765,105,31,78,0.397,21,47,0.447,10,31,0.323,22,31,0.71,94
1511,TOR,2019-11-02,105,@,MIL,0,240,34,84,0.405,19,48,0.396,15,36,0.417,22,25,0.88,105,41,89,0.461,28,51,0.549,13,38,0.342,20,25,0.8,115
1512,MEM,2019-11-02,105,,PHO,0,240,42,86,0.488,33,58,0.569,9,28,0.321,12,19,0.632,105,44,88,0.5,30,54,0.556,14,34,0.412,12,16,0.75,114
1513,MIL,2019-10-30,105,@,BOS,0,240,38,82,0.463,24,37,0.649,14,45,0.311,15,24,0.625,105,41,92,0.446,24,51,0.471,17,41,0.415,17,21,0.81,116
1514,NYK,2019-10-28,105,,CHI,1,240,38,91,0.418,29,62,0.468,9,29,0.31,20,32,0.625,105,36,85,0.424,27,50,0.54,9,35,0.257,17,21,0.81,98
1515,PHI,2019-10-28,105,@,ATL,1,240,37,88,0.42,26,47,0.553,11,41,0.268,20,25,0.8,105,36,84,0.429,27,57,0.474,9,27,0.333,22,32,0.688,103
1516,HOU,2020-08-12,104,,IND,0,240,32,86,0.372,16,29,0.552,16,57,0.281,24,28,0.857,104,40,100,0.4,29,69,0.42,11,31,0.355,17,22,0.773,108
1517,NOP,2020-07-30,104,,UTA,0,240,40,94,0.426,29,63,0.46,11,31,0.355,13,18,0.722,104,37,84,0.44,29,50,0.58,8,34,0.235,24,28,0.857,106
1518,BRK,2020-03-10,104,@,LAL,1,240,37,90,0.411,24,50,0.48,13,40,0.325,17,23,0.739,104,40,87,0.46,25,47,0.532,15,40,0.375,7,12,0.583,102
1519,BOS,2020-03-08,104,,OKC,0,240,38,92,0.413,25,55,0.455,13,37,0.351,15,19,0.789,104,35,79,0.443,25,54,0.463,10,25,0.4,25,34,0.735,105
1520,CLE,2020-03-07,104,,DEN,1,240,42,76,0.553,30,48,0.625,12,28,0.429,8,12,0.667,104,43,85,0.506,30,53,0.566,13,32,0.406,3,8,0.375,102
1521,MIA,2020-03-06,104,@,NOP,0,240,37,86,0.43,28,53,0.528,9,33,0.273,21,31,0.677,104,38,91,0.418,24,53,0.453,14,38,0.368,20,28,0.714,110
1522,WAS,2020-03-04,104,@,POR,0,240,40,103,0.388,29,68,0.426,11,35,0.314,13,21,0.619,104,42,81,0.519,29,50,0.58,13,31,0.419,28,32,0.875,125
1523,NYK,2020-03-04,104,,UTA,0,240,41,85,0.482,34,65,0.523,7,20,0.35,15,18,0.833,104,41,81,0.506,31,45,0.689,10,36,0.278,20,25,0.8,112
1524,SAS,2020-03-03,104,@,CHO,1,240,38,80,0.475,27,48,0.563,11,32,0.344,17,20,0.85,104,39,82,0.476,27,53,0.509,12,29,0.414,13,18,0.722,103
1525,CLE,2020-02-29,104,,IND,0,240,41,85,0.482,36,63,0.571,5,22,0.227,17,20,0.85,104,47,87,0.54,39,64,0.609,8,23,0.348,11,14,0.786,113
1526,SAC,2020-02-28,104,@,MEM,1,240,38,91,0.418,27,53,0.509,11,38,0.289,17,21,0.81,104,39,91,0.429,31,61,0.508,8,30,0.267,15,20,0.75,101
1527,CLE,2020-02-28,104,@,NOP,0,240,43,95,0.453,32,64,0.5,11,31,0.355,7,12,0.583,104,48,88,0.545,39,65,0.6,9,23,0.391,11,15,0.733,116
1528,DET,2020-02-23,104,@,POR,0,240,37,86,0.43,26,51,0.51,11,35,0.314,19,20,0.95,104,41,84,0.488,28,54,0.519,13,30,0.433,12,19,0.632,107
1529,CHI,2020-02-22,104,,PHO,0,240,36,83,0.434,22,45,0.489,14,38,0.368,18,21,0.857,104,38,86,0.442,28,56,0.5,10,30,0.333,26,31,0.839,112
1530,UTA,2020-02-21,104,,SAS,0,240,35,82,0.427,23,49,0.469,12,33,0.364,22,26,0.846,104,40,91,0.44,30,71,0.423,10,20,0.5,23,26,0.885,113
1531,BRK,2020-02-20,104,@,PHI,0,265,36,102,0.353,26,68,0.382,10,34,0.294,22,28,0.786,104,38,86,0.442,34,64,0.531,4,22,0.182,32,35,0.914,112
1532,POR,2020-02-12,104,@,MEM,0,240,36,97,0.371,23,60,0.383,13,37,0.351,19,24,0.792,104,45,95,0.474,39,72,0.542,6,23,0.261,15,22,0.682,111
1533,GSW,2020-01-30,104,@,BOS,0,240,33,77,0.429,21,38,0.553,12,39,0.308,26,30,0.867,104,42,88,0.477,27,53,0.509,15,35,0.429,20,22,0.909,119
1534,GSW,2020-01-28,104,@,PHI,0,240,37,87,0.425,22,47,0.468,15,40,0.375,15,21,0.714,104,42,82,0.512,31,50,0.62,11,32,0.344,20,26,0.769,115
1535,DAL,2020-01-28,104,,PHO,0,240,37,83,0.446,30,50,0.6,7,33,0.212,23,27,0.852,104,51,86,0.593,39,58,0.672,12,28,0.429,19,21,0.905,133
1536,MEM,2020-01-28,104,,DEN,1,240,46,82,0.561,40,64,0.625,6,18,0.333,6,14,0.429,104,32,86,0.372,15,41,0.366,17,45,0.378,15,18,0.833,96
1537,MIN,2020-01-25,104,,OKC,0,240,40,90,0.444,28,47,0.596,12,43,0.279,12,18,0.667,104,39,80,0.488,28,56,0.5,11,24,0.458,24,25,0.96,113
1538,IND,2020-01-15,104,@,MIN,1,240,44,85,0.518,37,62,0.597,7,23,0.304,9,12,0.75,104,38,88,0.432,27,60,0.45,11,28,0.393,12,16,0.75,99
1539,MIN,2020-01-13,104,,OKC,0,240,38,91,0.418,26,56,0.464,12,35,0.343,16,21,0.762,104,41,82,0.5,29,52,0.558,12,30,0.4,23,26,0.885,117
1540,TOR,2020-01-12,104,,SAS,0,240,39,96,0.406,22,48,0.458,17,48,0.354,9,11,0.818,104,38,87,0.437,31,55,0.564,7,32,0.219,22,30,0.733,105
1541,LAC,2020-01-12,104,@,DEN,0,240,38,84,0.452,30,51,0.588,8,33,0.242,20,26,0.769,104,37,77,0.481,26,52,0.5,11,25,0.44,29,37,0.784,114
1542,NYK,2020-01-08,104,@,UTA,0,240,42,97,0.433,33,72,0.458,9,25,0.36,11,11,1.0,104,49,90,0.544,33,47,0.702,16,43,0.372,14,23,0.609,128
1543,CHO,2020-01-06,104,,IND,0,240,37,81,0.457,27,51,0.529,10,30,0.333,20,22,0.909,104,47,89,0.528,37,63,0.587,10,26,0.385,11,14,0.786,115
1544,MIL,2020-01-06,104,@,SAS,0,240,38,95,0.4,23,50,0.46,15,45,0.333,13,14,0.929,104,45,88,0.511,26,53,0.491,19,35,0.543,17,19,0.895,126
1545,GSW,2020-01-04,104,,DET,0,240,33,82,0.402,22,61,0.361,11,21,0.524,27,32,0.844,104,43,83,0.518,32,56,0.571,11,27,0.407,14,16,0.875,111
1546,CHI,2020-01-04,104,,BOS,0,240,34,80,0.425,21,46,0.457,13,34,0.382,23,31,0.742,104,43,82,0.524,35,63,0.556,8,19,0.421,17,21,0.81,111
1547,MIN,2020-01-01,104,@,MIL,0,240,34,91,0.374,19,45,0.422,15,46,0.326,21,28,0.75,104,40,94,0.426,31,58,0.534,9,36,0.25,17,26,0.654,106
1548,DEN,2019-12-31,104,@,HOU,0,240,45,97,0.464,37,72,0.514,8,25,0.32,6,9,0.667,104,46,87,0.529,30,53,0.566,16,34,0.471,22,31,0.71,130
1549,UTA,2019-12-30,104,,DET,1,240,39,83,0.47,29,57,0.509,10,26,0.385,16,20,0.8,104,30,79,0.38,26,65,0.4,4,14,0.286,17,23,0.739,81
1550,CHO,2019-12-29,104,@,MEM,0,240,37,86,0.43,28,55,0.509,9,31,0.29,21,32,0.656,104,45,93,0.484,35,58,0.603,10,35,0.286,17,17,1.0,117
1551,OKC,2019-12-27,104,@,CHO,1,265,40,89,0.449,35,58,0.603,5,31,0.161,19,31,0.613,104,42,101,0.416,35,62,0.565,7,39,0.179,11,18,0.611,102
1552,SAC,2019-12-26,104,,MIN,0,290,37,107,0.346,28,68,0.412,9,39,0.231,21,25,0.84,104,36,104,0.346,26,58,0.448,10,46,0.217,23,29,0.793,105
1553,HOU,2019-12-25,104,@,GSW,0,240,37,100,0.37,21,49,0.429,16,51,0.314,14,16,0.875,104,41,87,0.471,32,59,0.542,9,28,0.321,25,28,0.893,116
1554,UTA,2019-12-23,104,@,MIA,0,240,39,90,0.433,27,54,0.5,12,36,0.333,14,18,0.778,104,37,90,0.411,28,65,0.431,9,25,0.36,24,27,0.889,107
1555,MIN,2019-12-23,104,@,GSW,0,240,35,87,0.402,24,53,0.453,11,34,0.324,23,29,0.793,104,38,87,0.437,26,57,0.456,12,30,0.4,25,30,0.833,113
1556,SAC,2019-12-23,104,,HOU,0,240,41,87,0.471,34,57,0.596,7,30,0.233,15,23,0.652,104,39,87,0.448,24,48,0.5,15,39,0.385,20,23,0.87,113
1557,LAL,2019-12-22,104,,DEN,0,240,39,83,0.47,29,54,0.537,10,29,0.345,16,22,0.727,104,45,92,0.489,34,60,0.567,11,32,0.344,27,30,0.9,128
1558,LAL,2019-12-19,104,@,MIL,0,240,37,80,0.463,25,45,0.556,12,35,0.343,18,23,0.783,104,36,77,0.468,20,38,0.526,16,39,0.41,23,32,0.719,111
1559,PHI,2019-12-18,104,,MIA,0,240,38,90,0.422,26,51,0.51,12,39,0.308,16,18,0.889,104,40,85,0.471,28,54,0.519,12,31,0.387,16,20,0.8,108
1560,ORL,2019-12-18,104,@,DEN,0,240,37,87,0.425,26,58,0.448,11,29,0.379,19,21,0.905,104,40,84,0.476,29,57,0.509,11,27,0.407,22,25,0.88,113
1561,OKC,2019-12-09,104,@,UTA,1,240,40,85,0.471,32,57,0.561,8,28,0.286,16,19,0.842,104,36,89,0.404,28,58,0.483,8,31,0.258,10,12,0.833,90
1562,TOR,2019-12-08,104,@,PHI,0,240,38,88,0.432,27,55,0.491,11,33,0.333,17,20,0.85,104,40,79,0.506,26,47,0.553,14,32,0.438,16,21,0.762,110
1563,IND,2019-12-07,104,@,NYK,1,240,41,85,0.482,29,57,0.509,12,28,0.429,10,13,0.769,104,39,96,0.406,29,65,0.446,10,31,0.323,15,21,0.714,103
1564,CHO,2019-12-06,104,,BRK,0,240,36,83,0.434,19,43,0.442,17,40,0.425,15,17,0.882,104,42,88,0.477,27,50,0.54,15,38,0.395,12,15,0.8,111
1565,SAC,2019-12-06,104,@,SAS,0,265,40,102,0.392,31,68,0.456,9,34,0.265,15,18,0.833,104,41,96,0.427,30,64,0.469,11,32,0.344,12,17,0.706,105
1566,ATL,2019-12-02,104,,GSW,1,240,41,89,0.461,33,60,0.55,8,29,0.276,14,15,0.933,104,33,83,0.398,30,66,0.455,3,17,0.176,10,12,0.833,79
1567,CHO,2019-12-02,104,,PHO,0,240,38,84,0.452,31,59,0.525,7,25,0.28,21,26,0.808,104,39,88,0.443,30,46,0.652,9,42,0.214,22,30,0.733,109
1568,MEM,2019-12-02,104,,IND,0,240,38,89,0.427,28,51,0.549,10,38,0.263,18,19,0.947,104,44,88,0.5,28,50,0.56,16,38,0.421,13,15,0.867,117
1569,NYK,2019-12-01,104,,BOS,0,240,35,76,0.461,27,50,0.54,8,26,0.308,26,37,0.703,104,41,93,0.441,26,52,0.5,15,41,0.366,16,22,0.727,113
1570,NOP,2019-12-01,104,,OKC,0,240,39,87,0.448,22,49,0.449,17,38,0.447,9,10,0.9,104,38,81,0.469,27,48,0.563,11,33,0.333,20,26,0.769,107
1571,NOP,2019-11-29,104,@,OKC,0,240,39,87,0.448,28,49,0.571,11,38,0.289,15,21,0.714,104,43,90,0.478,30,56,0.536,13,34,0.382,10,16,0.625,109
1572,ATL,2019-11-29,104,@,IND,0,265,39,90,0.433,30,58,0.517,9,32,0.281,17,18,0.944,104,39,92,0.424,33,66,0.5,6,26,0.231,21,28,0.75,105
1573,CLE,2019-11-27,104,,ORL,0,240,37,81,0.457,26,47,0.553,11,34,0.324,19,22,0.864,104,45,93,0.484,33,60,0.55,12,33,0.364,14,17,0.824,116
1574,GSW,2019-11-27,104,,CHI,1,240,37,81,0.457,26,52,0.5,11,29,0.379,19,26,0.731,104,34,89,0.382,24,60,0.4,10,29,0.345,12,18,0.667,90
1575,WAS,2019-11-26,104,@,DEN,0,240,40,95,0.421,30,55,0.545,10,40,0.25,14,21,0.667,104,47,90,0.522,41,66,0.621,6,24,0.25,17,23,0.739,117
1576,SAS,2019-11-25,104,,LAL,0,240,41,88,0.466,31,63,0.492,10,25,0.4,12,15,0.8,104,44,89,0.494,30,56,0.536,14,33,0.424,12,18,0.667,114
1577,PHO,2019-11-24,104,@,DEN,0,240,41,82,0.5,29,47,0.617,12,35,0.343,10,12,0.833,104,43,91,0.473,29,60,0.483,14,31,0.452,16,23,0.696,116
1578,NYK,2019-11-23,104,,SAS,0,240,40,93,0.43,25,53,0.472,15,40,0.375,9,15,0.6,104,40,75,0.533,28,52,0.538,12,23,0.522,19,28,0.679,111
1579,MIL,2019-11-23,104,,DET,1,240,41,84,0.488,28,47,0.596,13,37,0.351,9,18,0.5,104,37,91,0.407,27,56,0.482,10,35,0.286,6,10,0.6,90
1580,POR,2019-11-23,104,@,CLE,0,240,39,87,0.448,25,47,0.532,14,40,0.35,12,16,0.75,104,37,87,0.425,27,56,0.482,10,31,0.323,26,32,0.813,110
1581,SAS,2019-11-22,104,@,PHI,0,240,43,85,0.506,37,67,0.552,6,18,0.333,12,16,0.75,104,46,89,0.517,36,63,0.571,10,26,0.385,13,19,0.684,115
1582,NYK,2019-11-20,104,@,PHI,0,240,40,84,0.476,27,59,0.458,13,25,0.52,11,15,0.733,104,39,89,0.438,26,57,0.456,13,32,0.406,18,26,0.692,109
1583,BOS,2019-11-20,104,@,LAC,0,265,41,104,0.394,29,59,0.492,12,45,0.267,10,14,0.714,104,39,93,0.419,22,48,0.458,17,45,0.378,12,16,0.75,107
1584,POR,2019-11-19,104,@,NOP,0,240,40,92,0.435,24,63,0.381,16,29,0.552,8,13,0.615,104,41,93,0.441,28,57,0.491,13,36,0.361,20,24,0.833,115
1585,LAL,2019-11-10,104,,TOR,0,240,41,94,0.436,31,64,0.484,10,30,0.333,12,19,0.632,104,43,89,0.483,31,53,0.585,12,36,0.333,15,22,0.682,113
1586,NOP,2019-11-08,104,,TOR,0,240,40,99,0.404,30,58,0.517,10,41,0.244,14,21,0.667,104,41,93,0.441,22,50,0.44,19,43,0.442,21,24,0.875,122
1587,PHI,2019-11-06,104,@,UTA,0,240,33,80,0.413,25,55,0.455,8,25,0.32,30,34,0.882,104,41,89,0.461,33,67,0.493,8,22,0.364,16,24,0.667,106
1588,NOP,2019-11-02,104,@,OKC,0,240,40,94,0.426,29,62,0.468,11,32,0.344,13,22,0.591,104,41,90,0.456,26,53,0.491,15,37,0.405,18,23,0.783,115
1589,BOS,2019-11-01,104,,NYK,1,240,33,74,0.446,22,40,0.55,11,34,0.324,27,29,0.931,104,37,93,0.398,23,55,0.418,14,38,0.368,14,21,0.667,102
1590,TOR,2019-10-28,104,,ORL,1,240,33,85,0.388,23,46,0.5,10,39,0.256,28,30,0.933,104,34,89,0.382,22,50,0.44,12,39,0.308,15,18,0.833,95
1591,OKC,2020-08-14,103,@,LAC,0,265,38,106,0.358,24,62,0.387,14,44,0.318,13,22,0.591,103,34,85,0.4,22,48,0.458,12,37,0.324,27,39,0.692,107
1592,WAS,2020-08-09,103,@,OKC,0,240,38,92,0.413,29,56,0.518,9,36,0.25,18,22,0.818,103,43,84,0.512,25,45,0.556,18,39,0.462,17,22,0.773,121
1593,MIA,2020-08-03,103,,TOR,0,240,37,87,0.425,23,42,0.548,14,45,0.311,15,16,0.938,103,29,67,0.433,13,35,0.371,16,32,0.5,33,36,0.917,107
1594,NOP,2020-08-01,103,@,LAC,0,240,38,85,0.447,29,55,0.527,9,30,0.3,18,28,0.643,103,37,87,0.425,12,40,0.3,25,47,0.532,27,35,0.771,126
1595,LAL,2020-07-30,103,,LAC,1,240,32,82,0.39,21,46,0.457,11,36,0.306,28,37,0.757,103,32,74,0.432,16,38,0.421,16,36,0.444,21,28,0.75,101
1596,CLE,2020-03-10,103,@,CHI,0,240,40,80,0.5,34,56,0.607,6,24,0.25,17,23,0.739,103,42,84,0.5,30,50,0.6,12,34,0.353,12,15,0.8,108
1597,LAC,2020-03-08,103,,LAL,0,240,34,86,0.395,27,55,0.491,7,31,0.226,28,37,0.757,103,39,87,0.448,29,52,0.558,10,35,0.286,24,28,0.857,112
1598,MIL,2020-03-06,103,@,LAL,0,240,37,89,0.416,25,46,0.543,12,43,0.279,17,23,0.739,103,38,91,0.418,32,59,0.542,6,32,0.188,31,38,0.816,113
1599,NYK,2020-03-06,103,,OKC,0,240,41,91,0.451,37,67,0.552,4,24,0.167,17,22,0.773,103,47,96,0.49,35,65,0.538,12,31,0.387,20,25,0.8,126
1600,CHO,2020-03-03,103,,SAS,0,240,39,82,0.476,27,53,0.509,12,29,0.414,13,18,0.722,103,38,80,0.475,27,48,0.563,11,32,0.344,17,20,0.85,104
1601,DEN,2020-02-28,103,@,LAC,0,240,41,91,0.451,32,66,0.485,9,25,0.36,12,16,0.75,103,48,89,0.539,30,50,0.6,18,39,0.462,18,20,0.9,132
1602,UTA,2020-02-26,103,,BOS,0,240,40,89,0.449,28,49,0.571,12,40,0.3,11,15,0.733,103,45,84,0.536,34,58,0.586,11,26,0.423,13,16,0.813,114
1603,SAS,2020-02-26,103,,DAL,0,240,39,92,0.424,28,59,0.475,11,33,0.333,14,19,0.737,103,36,86,0.419,19,41,0.463,17,45,0.378,20,30,0.667,109
1604,SAS,2020-02-23,103,@,OKC,0,240,38,103,0.369,27,65,0.415,11,38,0.289,16,19,0.842,103,50,87,0.575,40,65,0.615,10,22,0.455,21,24,0.875,131
1605,LAC,2020-02-22,103,,SAC,0,240,34,87,0.391,24,57,0.421,10,30,0.333,25,29,0.862,103,40,89,0.449,28,58,0.483,12,31,0.387,20,26,0.769,112
1606,CHO,2020-02-20,103,@,CHI,1,240,35,74,0.473,27,46,0.587,8,28,0.286,25,29,0.862,103,37,87,0.425,30,56,0.536,7,31,0.226,12,19,0.632,93
1607,LAC,2020-02-11,103,@,PHI,0,240,40,90,0.444,26,59,0.441,14,31,0.452,9,13,0.692,103,44,95,0.463,36,68,0.529,8,27,0.296,14,21,0.667,110
1608,ORL,2020-02-06,103,@,NYK,0,240,34,75,0.453,25,44,0.568,9,31,0.29,26,30,0.867,103,43,92,0.467,37,72,0.514,6,20,0.3,13,19,0.684,105
1609,CLE,2020-02-05,103,@,OKC,0,240,41,89,0.461,26,51,0.51,15,38,0.395,6,11,0.545,103,38,81,0.469,29,55,0.527,9,26,0.346,24,30,0.8,109
1610,IND,2020-02-03,103,,DAL,0,240,44,96,0.458,37,62,0.597,7,34,0.206,8,11,0.727,103,36,86,0.419,18,41,0.439,18,45,0.4,22,23,0.957,112
1611,LAC,2020-01-30,103,,SAC,0,240,35,92,0.38,22,61,0.361,13,31,0.419,20,25,0.8,103,44,88,0.5,23,47,0.489,21,41,0.512,15,18,0.833,124
1612,CHO,2020-01-24,103,,MIL,0,240,32,86,0.372,18,47,0.383,14,39,0.359,25,30,0.833,103,44,87,0.506,34,51,0.667,10,36,0.278,18,24,0.75,116
1613,PHO,2020-01-24,103,@,SAS,1,240,39,84,0.464,31,55,0.564,8,29,0.276,17,21,0.81,103,33,78,0.423,28,53,0.528,5,25,0.2,28,33,0.848,99
1614,ATL,2020-01-18,103,,DET,0,240,40,93,0.43,30,59,0.508,10,34,0.294,13,15,0.867,103,51,86,0.593,36,54,0.667,15,32,0.469,19,25,0.76,136
1615,BOS,2020-01-15,103,,DET,0,240,41,83,0.494,32,55,0.582,9,28,0.321,12,20,0.6,103,47,78,0.603,35,46,0.761,12,32,0.375,10,19,0.526,116
1616,CLE,2020-01-14,103,@,LAC,0,240,38,91,0.418,24,54,0.444,14,37,0.378,13,15,0.867,103,49,94,0.521,34,56,0.607,15,38,0.395,15,21,0.714,128
1617,DEN,2020-01-11,103,,CLE,0,240,41,95,0.432,33,56,0.589,8,39,0.205,13,18,0.722,103,44,89,0.494,32,52,0.615,12,37,0.324,11,13,0.846,111
1618,PHO,2020-01-07,103,,SAC,0,240,37,77,0.481,26,42,0.619,11,35,0.314,18,22,0.818,103,37,84,0.44,22,48,0.458,15,36,0.417,25,28,0.893,114
1619,BRK,2020-01-07,103,,OKC,0,265,40,98,0.408,29,61,0.475,11,37,0.297,12,16,0.75,103,38,92,0.413,27,55,0.491,11,37,0.297,24,29,0.828,111
1620,CLE,2020-01-05,103,,MIN,0,240,40,84,0.476,32,59,0.542,8,25,0.32,15,19,0.789,103,47,95,0.495,33,57,0.579,14,38,0.368,10,13,0.769,118
1621,WAS,2020-01-03,103,,POR,0,240,38,90,0.422,27,57,0.474,11,33,0.333,16,25,0.64,103,45,88,0.511,39,63,0.619,6,25,0.24,26,33,0.788,122
1622,SAS,2020-01-02,103,,OKC,0,240,40,92,0.435,27,61,0.443,13,31,0.419,10,12,0.833,103,43,89,0.483,34,64,0.531,9,25,0.36,14,20,0.7,109
1623,ORL,2019-12-23,103,,CHI,1,240,39,81,0.481,29,55,0.527,10,26,0.385,15,23,0.652,103,35,88,0.398,22,51,0.431,13,37,0.351,12,15,0.8,95
1624,ORL,2019-12-20,103,@,POR,0,240,39,106,0.368,32,78,0.41,7,28,0.25,18,26,0.692,103,42,84,0.5,25,48,0.521,17,36,0.472,17,19,0.895,118
1625,DAL,2019-12-18,103,,BOS,0,240,34,87,0.391,19,44,0.432,15,43,0.349,20,25,0.8,103,35,86,0.407,23,48,0.479,12,38,0.316,27,30,0.9,109
1626,NYK,2019-12-13,103,@,SAC,1,240,44,95,0.463,35,65,0.538,9,30,0.3,6,10,0.6,103,39,83,0.47,22,44,0.5,17,39,0.436,6,8,0.75,101
1627,NOP,2019-12-09,103,,DET,0,240,40,91,0.44,32,53,0.604,8,38,0.211,15,22,0.682,103,36,85,0.424,25,50,0.5,11,35,0.314,22,27,0.815,105
1628,NYK,2019-12-07,103,,IND,0,240,39,96,0.406,29,65,0.446,10,31,0.323,15,21,0.714,103,41,85,0.482,29,57,0.509,12,28,0.429,10,13,0.769,104
1629,WAS,2019-12-06,103,@,MIA,0,240,39,91,0.429,27,52,0.519,12,39,0.308,13,14,0.929,103,42,86,0.488,32,58,0.552,10,28,0.357,18,24,0.75,112
1630,DET,2019-12-04,103,,MIL,0,240,39,93,0.419,28,57,0.491,11,36,0.306,14,22,0.636,103,44,90,0.489,30,55,0.545,14,35,0.4,25,27,0.926,127
1631,PHI,2019-12-02,103,,UTA,1,240,37,91,0.407,24,65,0.369,13,26,0.5,16,23,0.696,103,38,81,0.469,33,59,0.559,5,22,0.227,13,20,0.65,94
1632,WAS,2019-11-29,103,@,LAL,0,240,38,96,0.396,28,59,0.475,10,37,0.27,17,19,0.895,103,45,87,0.517,31,55,0.564,14,32,0.438,21,28,0.75,125
1633,CHI,2019-11-29,103,@,POR,0,240,36,94,0.383,22,56,0.393,14,38,0.368,17,25,0.68,103,38,84,0.452,28,54,0.519,10,30,0.333,21,28,0.75,107
1634,UTA,2019-11-29,103,@,MEM,1,240,38,95,0.4,26,60,0.433,12,35,0.343,15,19,0.789,103,37,94,0.394,27,60,0.45,10,34,0.294,10,17,0.588,94
1635,BOS,2019-11-25,103,,SAC,1,240,38,85,0.447,31,55,0.564,7,30,0.233,20,23,0.87,103,37,79,0.468,19,32,0.594,18,47,0.383,10,15,0.667,102
1636,DET,2019-11-25,103,,ORL,1,240,34,79,0.43,20,41,0.488,14,38,0.368,21,25,0.84,103,32,84,0.381,24,59,0.407,8,25,0.32,16,22,0.727,88
1637,BRK,2019-11-24,103,@,NYK,1,240,31,77,0.403,17,39,0.436,14,38,0.368,27,34,0.794,103,37,80,0.463,19,45,0.422,18,35,0.514,9,16,0.563,101
1638,ATL,2019-11-22,103,@,DET,0,240,38,88,0.432,28,51,0.549,10,37,0.27,17,17,1.0,103,49,82,0.598,32,48,0.667,17,34,0.5,13,20,0.65,128
1639,UTA,2019-11-20,103,@,MIN,1,240,35,86,0.407,21,53,0.396,14,33,0.424,19,27,0.704,103,35,89,0.393,21,44,0.477,14,45,0.311,11,21,0.524,95
1640,CHO,2019-11-16,103,@,NYK,1,240,36,87,0.414,19,39,0.487,17,48,0.354,14,19,0.737,103,39,86,0.453,33,66,0.5,6,20,0.3,18,23,0.783,102
1641,DAL,2019-11-14,103,@,NYK,0,240,36,84,0.429,28,48,0.583,8,36,0.222,23,31,0.742,103,42,94,0.447,29,64,0.453,13,30,0.433,9,11,0.818,106
1642,UTA,2019-11-08,103,,MIL,1,240,34,84,0.405,19,48,0.396,15,36,0.417,20,29,0.69,103,34,95,0.358,24,59,0.407,10,36,0.278,22,30,0.733,100
1643,LAL,2019-11-03,103,@,SAS,1,240,42,87,0.483,36,63,0.571,6,24,0.25,13,19,0.684,103,33,83,0.398,27,58,0.466,6,25,0.24,24,29,0.828,96
1644,LAC,2019-10-31,103,,SAS,1,240,39,91,0.429,34,65,0.523,5,26,0.192,20,27,0.741,103,36,80,0.45,29,59,0.492,7,21,0.333,18,27,0.667,97
1645,ATL,2019-10-28,103,,PHI,0,240,36,84,0.429,27,57,0.474,9,27,0.333,22,32,0.688,103,37,88,0.42,26,47,0.553,11,41,0.268,20,25,0.8,105
1646,ATL,2019-10-26,103,,ORL,1,240,43,84,0.512,34,54,0.63,9,30,0.3,8,15,0.533,103,35,99,0.354,30,68,0.441,5,31,0.161,24,26,0.923,99
1647,DAL,2020-08-13,102,@,PHO,0,240,39,89,0.438,31,63,0.492,8,26,0.308,16,19,0.842,102,49,89,0.551,35,55,0.636,14,34,0.412,16,21,0.762,128
1648,HOU,2020-08-04,102,@,POR,0,240,34,87,0.391,15,34,0.441,19,53,0.358,15,24,0.625,102,39,95,0.411,27,64,0.422,12,31,0.387,20,29,0.69,110
1649,LAL,2020-03-10,102,,BRK,0,240,40,87,0.46,25,47,0.532,15,40,0.375,7,12,0.583,102,37,90,0.411,24,50,0.48,13,40,0.325,17,23,0.739,104
1650,DEN,2020-03-07,102,@,CLE,0,240,43,85,0.506,30,53,0.566,13,32,0.406,3,8,0.375,102,42,76,0.553,30,48,0.625,12,28,0.429,8,12,0.667,104
1651,CHI,2020-03-06,102,,IND,0,240,40,97,0.412,31,59,0.525,9,38,0.237,13,15,0.867,102,38,75,0.507,30,53,0.566,8,22,0.364,24,33,0.727,108
1652,LAC,2020-02-26,102,@,PHO,1,240,37,84,0.44,23,46,0.5,14,38,0.368,14,15,0.933,102,34,87,0.391,25,53,0.472,9,34,0.265,15,18,0.833,92
1653,SAS,2020-02-08,102,@,SAC,0,240,41,81,0.506,34,57,0.596,7,24,0.292,13,18,0.722,102,45,86,0.523,26,51,0.51,19,35,0.543,13,20,0.65,122
1654,SAS,2020-02-04,102,@,LAL,0,240,40,91,0.44,27,64,0.422,13,27,0.481,9,15,0.6,102,50,85,0.588,38,57,0.667,12,28,0.429,17,25,0.68,129
1655,CHI,2020-02-02,102,@,TOR,0,240,35,90,0.389,20,42,0.476,15,48,0.313,17,26,0.654,102,47,84,0.56,31,50,0.62,16,34,0.471,19,23,0.826,129
1656,MIA,2020-02-01,102,@,ORL,1,240,33,77,0.429,18,44,0.409,15,33,0.455,21,26,0.808,102,33,83,0.398,24,50,0.48,9,33,0.273,14,17,0.824,89
1657,ATL,2020-01-22,102,,LAC,1,240,36,102,0.353,25,67,0.373,11,35,0.314,19,23,0.826,102,33,78,0.423,29,57,0.509,4,21,0.19,25,39,0.641,95
1658,MIA,2020-01-19,102,@,SAS,0,240,37,86,0.43,27,52,0.519,10,34,0.294,18,20,0.9,102,36,85,0.424,24,52,0.462,12,33,0.364,23,24,0.958,107
1659,NYK,2020-01-14,102,@,MIL,0,240,36,102,0.353,25,65,0.385,11,37,0.297,19,26,0.731,102,45,92,0.489,30,56,0.536,15,36,0.417,23,28,0.821,128
1660,GSW,2020-01-12,102,@,MEM,0,240,35,92,0.38,18,58,0.31,17,34,0.5,15,21,0.714,102,45,100,0.45,34,65,0.523,11,35,0.314,21,25,0.84,122
1661,POR,2020-01-09,102,@,MIN,0,240,35,96,0.365,24,59,0.407,11,37,0.297,21,31,0.677,102,44,89,0.494,31,57,0.544,13,32,0.406,15,21,0.714,116
1662,BRK,2020-01-04,102,,TOR,0,240,32,67,0.478,19,32,0.594,13,35,0.371,25,34,0.735,102,44,97,0.454,31,65,0.477,13,32,0.406,20,28,0.714,121
1663,UTA,2020-01-02,102,@,CHI,1,240,37,76,0.487,26,46,0.565,11,30,0.367,17,22,0.773,102,37,94,0.394,26,58,0.448,11,36,0.306,13,17,0.765,98
1664,CHI,2019-12-30,102,,MIL,0,240,40,107,0.374,23,63,0.365,17,44,0.386,5,8,0.625,102,46,84,0.548,35,52,0.673,11,32,0.344,20,24,0.833,123
1665,CHO,2019-12-27,102,,OKC,0,265,42,101,0.416,35,62,0.565,7,39,0.179,11,18,0.611,102,40,89,0.449,35,58,0.603,5,31,0.161,19,31,0.613,104
1666,WAS,2019-12-26,102,@,DET,0,240,38,92,0.413,31,68,0.456,7,24,0.292,19,27,0.704,102,46,86,0.535,27,38,0.711,19,48,0.396,21,26,0.808,132
1667,DAL,2019-12-26,102,,SAS,1,240,38,90,0.422,22,50,0.44,16,40,0.4,10,15,0.667,102,40,83,0.482,32,54,0.593,8,29,0.276,10,15,0.667,98
1668,TOR,2019-12-25,102,,BOS,0,240,38,80,0.475,30,57,0.526,8,23,0.348,18,22,0.818,102,46,92,0.5,32,59,0.542,14,33,0.424,12,14,0.857,118
1669,NOP,2019-12-23,102,@,POR,1,240,38,93,0.409,23,58,0.397,15,35,0.429,11,16,0.688,102,37,91,0.407,33,62,0.532,4,29,0.138,16,18,0.889,94
1670,NYK,2019-12-21,102,,MIL,0,240,39,97,0.402,30,67,0.448,9,30,0.3,15,21,0.714,102,41,85,0.482,23,42,0.548,18,43,0.419,23,35,0.657,123
1671,NOP,2019-12-20,102,@,GSW,0,240,39,93,0.419,30,59,0.508,9,34,0.265,15,23,0.652,102,36,83,0.434,26,50,0.52,10,33,0.303,24,25,0.96,106
1672,SAC,2019-12-17,102,@,CHO,0,240,38,91,0.418,24,52,0.462,14,39,0.359,12,13,0.923,102,39,81,0.481,26,51,0.51,13,30,0.433,19,27,0.704,110
1673,LAL,2019-12-17,102,@,IND,0,240,43,91,0.473,35,60,0.583,8,31,0.258,8,17,0.471,102,41,85,0.482,31,60,0.517,10,25,0.4,13,20,0.65,105
1674,ORL,2019-12-17,102,@,UTA,0,240,42,93,0.452,35,58,0.603,7,35,0.2,11,15,0.733,102,42,90,0.467,27,54,0.5,15,36,0.417,10,16,0.625,109
1675,OKC,2019-12-14,102,@,DEN,0,240,38,81,0.469,32,58,0.552,6,23,0.261,20,23,0.87,102,43,85,0.506,36,58,0.621,7,27,0.259,17,23,0.739,110
1676,BRK,2019-12-14,102,@,TOR,0,240,39,101,0.386,27,55,0.491,12,46,0.261,12,17,0.706,102,38,98,0.388,24,58,0.414,14,40,0.35,20,25,0.8,110
1677,ATL,2019-12-11,102,@,CHI,0,240,35,83,0.422,22,45,0.489,13,38,0.342,19,26,0.731,102,54,94,0.574,43,70,0.614,11,24,0.458,17,19,0.895,136
1678,GSW,2019-12-09,102,,MEM,0,240,35,93,0.376,24,66,0.364,11,27,0.407,21,25,0.84,102,41,82,0.5,26,42,0.619,15,40,0.375,13,17,0.765,110
1679,DEN,2019-12-08,102,@,BRK,0,240,36,89,0.404,18,47,0.383,18,42,0.429,12,14,0.857,102,40,87,0.46,33,59,0.559,7,28,0.25,18,23,0.783,105
1680,CHO,2019-11-27,102,,DET,1,240,39,88,0.443,32,58,0.552,7,30,0.233,17,20,0.85,102,41,88,0.466,31,56,0.554,10,32,0.313,9,15,0.6,101
1681,UTA,2019-11-27,102,@,IND,0,240,36,83,0.434,26,51,0.51,10,32,0.313,20,25,0.8,102,50,96,0.521,42,74,0.568,8,22,0.364,13,16,0.813,121
1682,ATL,2019-11-27,102,@,MIL,0,240,38,94,0.404,27,60,0.45,11,34,0.324,15,22,0.682,102,42,88,0.477,32,54,0.593,10,34,0.294,17,27,0.63,111
1683,SAC,2019-11-25,102,@,BOS,0,240,37,79,0.468,19,32,0.594,18,47,0.383,10,15,0.667,102,38,85,0.447,31,55,0.564,7,30,0.233,20,23,0.87,103
1684,UTA,2019-11-18,102,,MIN,0,240,35,96,0.365,23,65,0.354,12,31,0.387,20,26,0.769,102,41,89,0.461,27,51,0.529,14,38,0.368,16,19,0.842,112
1685,TOR,2019-11-16,102,@,DAL,0,240,37,89,0.416,20,48,0.417,17,41,0.415,11,15,0.733,102,37,88,0.42,28,49,0.571,9,39,0.231,27,33,0.818,110
1686,NYK,2019-11-16,102,,CHO,0,240,39,86,0.453,33,66,0.5,6,20,0.3,18,23,0.783,102,36,87,0.414,19,39,0.487,17,48,0.354,14,19,0.737,103
1687,MIL,2019-11-16,102,@,IND,1,240,43,96,0.448,32,57,0.561,11,39,0.282,5,7,0.714,102,32,100,0.32,20,66,0.303,12,34,0.353,7,9,0.778,83
1688,IND,2019-11-15,102,@,HOU,0,240,37,82,0.451,29,49,0.592,8,33,0.242,20,26,0.769,102,36,89,0.404,22,43,0.512,14,46,0.304,25,29,0.862,111
1689,HOU,2019-11-13,102,,LAC,1,240,33,86,0.384,19,44,0.432,14,42,0.333,22,27,0.815,102,38,98,0.388,28,65,0.431,10,33,0.303,7,14,0.5,93
1690,NYK,2019-11-12,102,@,CHI,0,240,36,88,0.409,26,56,0.464,10,32,0.313,20,31,0.645,102,41,81,0.506,27,48,0.563,14,33,0.424,24,31,0.774,120
1691,ORL,2019-11-10,102,,IND,0,240,41,89,0.461,26,53,0.491,15,36,0.417,5,6,0.833,102,48,91,0.527,39,71,0.549,9,20,0.45,4,5,0.8,109
1692,DAL,2019-11-08,102,,NYK,0,240,37,90,0.411,23,46,0.5,14,44,0.318,14,17,0.824,102,37,89,0.416,23,61,0.377,14,28,0.5,18,31,0.581,106
1693,NYK,2019-11-06,102,@,DET,0,240,39,80,0.488,28,55,0.509,11,25,0.44,13,21,0.619,102,44,79,0.557,29,49,0.592,15,30,0.5,19,24,0.792,122
1694,OKC,2019-11-05,102,,ORL,1,240,37,86,0.43,25,53,0.472,12,33,0.364,16,20,0.8,102,32,82,0.39,29,60,0.483,3,22,0.136,27,31,0.871,94
1695,SAC,2019-11-01,102,,UTA,1,240,41,84,0.488,33,55,0.6,8,29,0.276,12,17,0.706,102,35,73,0.479,24,45,0.533,11,28,0.393,20,27,0.741,101
1696,IND,2019-11-01,102,,CLE,1,240,39,96,0.406,34,69,0.493,5,27,0.185,19,21,0.905,102,32,87,0.368,21,55,0.382,11,32,0.344,20,25,0.8,95
1697,NYK,2019-11-01,102,@,BOS,0,240,37,93,0.398,23,55,0.418,14,38,0.368,14,21,0.667,102,33,74,0.446,22,40,0.55,11,34,0.324,27,29,0.931,104
1698,POR,2019-10-30,102,@,OKC,1,240,34,86,0.395,17,51,0.333,17,35,0.486,17,24,0.708,102,33,84,0.393,29,57,0.509,4,27,0.148,29,37,0.784,99
1699,MEM,2019-10-25,102,,CHI,0,240,39,94,0.415,29,65,0.446,10,29,0.345,14,20,0.7,102,40,93,0.43,28,51,0.549,12,42,0.286,18,24,0.75,110
1700,LAL,2019-10-22,102,@,LAC,0,240,37,85,0.435,24,52,0.462,13,33,0.394,15,21,0.714,102,42,81,0.519,31,50,0.62,11,31,0.355,17,24,0.708,112
1701,OKC,2020-08-10,101,@,PHO,0,240,35,90,0.389,22,51,0.431,13,39,0.333,18,21,0.857,101,42,89,0.472,25,55,0.455,17,34,0.5,27,29,0.931,128
1702,ORL,2020-08-07,101,@,PHI,0,240,37,88,0.42,29,56,0.518,8,32,0.25,19,25,0.76,101,38,93,0.409,30,64,0.469,8,29,0.276,24,33,0.727,108
1703,LAC,2020-07-30,101,@,LAL,0,240,32,74,0.432,16,38,0.421,16,36,0.444,21,28,0.75,101,32,82,0.39,21,46,0.457,11,36,0.306,28,37,0.757,103
1704,TOR,2020-03-09,101,@,UTA,1,240,36,83,0.434,23,47,0.489,13,36,0.361,16,18,0.889,101,33,83,0.398,17,40,0.425,16,43,0.372,10,14,0.714,92
1705,ATL,2020-03-07,101,@,MEM,0,240,32,95,0.337,19,46,0.413,13,49,0.265,24,28,0.857,101,43,87,0.494,31,54,0.574,12,33,0.364,20,33,0.606,118
1706,MEM,2020-02-28,101,,SAC,0,240,39,91,0.429,31,61,0.508,8,30,0.267,15,20,0.75,101,38,91,0.418,27,53,0.509,11,38,0.289,17,21,0.81,104
1707,NYK,2020-02-26,101,@,CHO,0,240,43,85,0.506,39,70,0.557,4,15,0.267,11,17,0.647,101,39,83,0.47,29,53,0.547,10,30,0.333,19,25,0.76,107
1708,GSW,2020-02-23,101,,NOP,0,240,40,92,0.435,29,57,0.509,11,35,0.314,10,15,0.667,101,46,98,0.469,29,56,0.518,17,42,0.405,6,13,0.462,115
1709,PHO,2020-02-21,101,@,TOR,0,240,38,92,0.413,32,58,0.552,6,34,0.176,19,23,0.826,101,42,80,0.525,28,43,0.651,14,37,0.378,20,22,0.909,118
1710,DEN,2020-02-21,101,@,OKC,0,240,37,77,0.481,31,50,0.62,6,27,0.222,21,23,0.913,101,40,87,0.46,31,61,0.508,9,26,0.346,24,27,0.889,113
1711,MIA,2020-02-12,101,@,UTA,0,240,38,88,0.432,25,49,0.51,13,39,0.333,12,16,0.75,101,41,85,0.482,27,49,0.551,14,36,0.389,20,23,0.87,116
1712,BRK,2020-02-12,101,,TOR,1,240,36,88,0.409,27,53,0.509,9,35,0.257,20,25,0.8,101,34,90,0.378,21,47,0.447,13,43,0.302,10,13,0.769,91
1713,GSW,2020-02-10,101,,MIA,0,240,30,77,0.39,19,43,0.442,11,34,0.324,30,34,0.882,101,43,87,0.494,31,54,0.574,12,33,0.364,15,21,0.714,113
1714,DET,2020-02-07,101,@,OKC,0,240,38,89,0.427,27,51,0.529,11,38,0.289,14,19,0.737,101,39,76,0.513,34,53,0.642,5,23,0.217,25,30,0.833,108
1715,PHI,2020-02-06,101,@,MIL,0,240,37,99,0.374,18,54,0.333,19,45,0.422,8,14,0.571,101,44,94,0.468,32,57,0.561,12,37,0.324,12,18,0.667,112
1716,MIA,2020-01-28,101,,BOS,0,240,33,89,0.371,24,52,0.462,9,37,0.243,26,31,0.839,101,39,83,0.47,26,47,0.553,13,36,0.361,18,24,0.75,109
1717,SAC,2020-01-18,101,@,UTA,0,240,42,86,0.488,32,60,0.533,10,26,0.385,7,12,0.583,101,43,85,0.506,29,43,0.674,14,42,0.333,23,24,0.958,123
1718,CHI,2020-01-13,101,@,BOS,0,240,37,81,0.457,31,56,0.554,6,25,0.24,21,26,0.808,101,39,83,0.47,30,60,0.5,9,23,0.391,26,29,0.897,113
1719,IND,2020-01-13,101,,PHI,1,240,33,86,0.384,23,60,0.383,10,26,0.385,25,31,0.806,101,37,89,0.416,31,56,0.554,6,33,0.182,15,19,0.789,95
1720,POR,2020-01-11,101,,MIL,0,240,37,95,0.389,27,59,0.458,10,36,0.278,17,21,0.81,101,47,103,0.456,33,65,0.508,14,38,0.368,14,20,0.7,122
1721,ATL,2020-01-10,101,@,WAS,0,240,41,89,0.461,34,60,0.567,7,29,0.241,12,24,0.5,101,42,112,0.375,32,83,0.386,10,29,0.345,17,28,0.607,111
1722,POR,2020-01-07,101,@,TOR,1,240,38,88,0.432,25,53,0.472,13,35,0.371,12,14,0.857,101,35,96,0.365,20,54,0.37,15,42,0.357,14,19,0.737,99
1723,ORL,2020-01-06,101,,BRK,1,240,35,81,0.432,27,55,0.491,8,26,0.308,23,31,0.742,101,32,96,0.333,22,49,0.449,10,47,0.213,15,19,0.789,89
1724,WAS,2020-01-01,101,,ORL,0,240,33,87,0.379,24,56,0.429,9,31,0.29,26,31,0.839,101,45,95,0.474,33,63,0.524,12,32,0.375,20,27,0.741,122
1725,DAL,2019-12-31,101,@,OKC,0,240,33,93,0.355,18,42,0.429,15,51,0.294,20,27,0.741,101,39,91,0.429,33,64,0.516,6,27,0.222,22,28,0.786,106
1726,ATL,2019-12-30,101,@,ORL,1,240,39,81,0.481,30,52,0.577,9,29,0.31,14,17,0.824,101,37,89,0.416,32,64,0.5,5,25,0.2,14,24,0.583,93
1727,NOP,2019-12-17,101,,BRK,0,265,37,107,0.346,26,67,0.388,11,40,0.275,16,24,0.667,101,40,96,0.417,29,57,0.509,11,39,0.282,17,23,0.739,108
1728,LAL,2019-12-15,101,@,ATL,1,240,36,84,0.429,31,53,0.585,5,31,0.161,24,33,0.727,101,31,86,0.36,19,44,0.432,12,42,0.286,22,25,0.88,96
1729,SAC,2019-12-13,101,,NYK,0,240,39,83,0.47,22,44,0.5,17,39,0.436,6,8,0.75,101,44,95,0.463,35,65,0.538,9,30,0.3,6,10,0.6,103
1730,ORL,2019-12-09,101,@,MIL,0,240,35,92,0.38,25,61,0.41,10,31,0.323,21,26,0.808,101,43,92,0.467,27,51,0.529,16,41,0.39,8,15,0.533,110
1731,IND,2019-12-06,101,@,DET,0,240,38,83,0.458,29,59,0.492,9,24,0.375,16,20,0.8,101,39,87,0.448,28,62,0.452,11,25,0.44,19,26,0.731,108
1732,PHI,2019-11-29,101,@,NYK,1,240,31,72,0.431,24,46,0.522,7,26,0.269,32,40,0.8,101,34,78,0.436,26,58,0.448,8,20,0.4,19,33,0.576,95
1733,SAS,2019-11-27,101,,MIN,0,240,41,97,0.423,36,68,0.529,5,29,0.172,14,17,0.824,101,37,85,0.435,19,45,0.422,18,40,0.45,21,27,0.778,113
1734,DET,2019-11-27,101,@,CHO,0,240,41,88,0.466,31,56,0.554,10,32,0.313,9,15,0.6,101,39,88,0.443,32,58,0.552,7,30,0.233,17,20,0.85,102
1735,TOR,2019-11-25,101,,PHI,1,240,38,84,0.452,27,50,0.54,11,34,0.324,14,22,0.636,101,36,88,0.409,21,48,0.438,15,40,0.375,9,16,0.563,96
1736,NYK,2019-11-24,101,,BRK,0,240,37,80,0.463,19,45,0.422,18,35,0.514,9,16,0.563,101,31,77,0.403,17,39,0.436,14,38,0.368,27,34,0.794,103
1737,CLE,2019-11-22,101,@,DAL,0,240,37,86,0.43,25,57,0.439,12,29,0.414,15,17,0.882,101,58,100,0.58,38,63,0.603,20,37,0.541,7,9,0.778,143
1738,BRK,2019-11-20,101,,CHO,1,240,36,90,0.4,26,51,0.51,10,39,0.256,19,23,0.826,101,30,81,0.37,19,48,0.396,11,33,0.333,20,26,0.769,91
1739,CHI,2019-11-18,101,,MIL,0,240,39,97,0.402,27,63,0.429,12,34,0.353,11,14,0.786,101,38,82,0.463,23,41,0.561,15,41,0.366,24,35,0.686,115
1740,ATL,2019-11-17,101,@,LAL,0,240,37,86,0.43,29,58,0.5,8,28,0.286,19,25,0.76,101,47,89,0.528,32,54,0.593,15,35,0.429,13,16,0.813,122
1741,ATL,2019-11-16,101,@,LAC,0,240,34,90,0.378,28,66,0.424,6,24,0.25,27,37,0.73,101,50,93,0.538,33,60,0.55,17,33,0.515,33,35,0.943,150
1742,DEN,2019-11-14,101,,BRK,1,240,43,101,0.426,33,68,0.485,10,33,0.303,5,10,0.5,101,36,95,0.379,28,57,0.491,8,38,0.211,13,16,0.813,93
1743,POR,2019-11-07,101,@,LAC,0,240,39,104,0.375,28,65,0.431,11,39,0.282,12,16,0.75,101,39,89,0.438,35,66,0.53,4,23,0.174,25,30,0.833,107
1744,UTA,2019-11-01,101,@,SAC,0,240,35,73,0.479,24,45,0.533,11,28,0.393,20,27,0.741,101,41,84,0.488,33,55,0.6,8,29,0.276,12,17,0.706,102
1745,DEN,2019-10-28,101,@,SAC,1,240,36,98,0.367,26,62,0.419,10,36,0.278,19,21,0.905,101,36,91,0.396,24,54,0.444,12,37,0.324,10,16,0.625,94
1746,CHO,2019-10-27,101,@,LAL,0,240,35,91,0.385,25,56,0.446,10,35,0.286,21,23,0.913,101,49,93,0.527,38,62,0.613,11,31,0.355,11,14,0.786,120
1747,MEM,2019-10-23,101,@,MIA,0,240,38,89,0.427,33,57,0.579,5,32,0.156,20,30,0.667,101,40,85,0.471,33,67,0.493,7,18,0.389,33,39,0.846,120
1748,TOR,2020-08-07,100,,BOS,0,240,38,89,0.427,28,51,0.549,10,38,0.263,14,17,0.824,100,47,96,0.49,31,50,0.62,16,46,0.348,12,16,0.75,122
1749,WAS,2020-08-03,100,,IND,0,240,41,94,0.436,30,64,0.469,11,30,0.367,7,13,0.538,100,44,92,0.478,37,66,0.561,7,26,0.269,16,16,1.0,111
1750,MIA,2020-03-08,100,@,WAS,1,240,32,66,0.485,19,38,0.5,13,28,0.464,23,28,0.821,100,26,78,0.333,7,31,0.226,19,47,0.404,18,21,0.857,89
1751,IND,2020-03-04,100,@,MIL,0,240,42,97,0.433,35,70,0.5,7,27,0.259,9,11,0.818,100,43,94,0.457,30,48,0.625,13,46,0.283,20,22,0.909,119
1752,DEN,2020-03-03,100,,GSW,0,240,39,87,0.448,36,67,0.537,3,20,0.15,19,26,0.731,100,42,82,0.512,24,41,0.585,18,41,0.439,14,22,0.636,116
1753,DET,2020-03-01,100,@,SAC,0,240,33,80,0.413,15,38,0.395,18,42,0.429,16,24,0.667,100,37,91,0.407,28,56,0.5,9,35,0.257,23,26,0.885,106
1754,POR,2020-02-27,100,@,IND,0,240,41,89,0.461,32,59,0.542,9,30,0.3,9,14,0.643,100,40,90,0.444,32,65,0.492,8,25,0.32,18,23,0.783,106
1755,PHO,2020-02-10,100,@,LAL,0,240,32,76,0.421,21,45,0.467,11,31,0.355,25,31,0.806,100,47,91,0.516,33,54,0.611,14,37,0.378,17,25,0.68,125
1756,CHO,2020-02-08,100,,DAL,0,240,38,87,0.437,27,51,0.529,11,36,0.306,13,18,0.722,100,44,87,0.506,27,52,0.519,17,35,0.486,11,11,1.0,116
1757,ORL,2020-02-05,100,@,BOS,0,240,32,75,0.427,19,44,0.432,13,31,0.419,23,30,0.767,100,46,86,0.535,33,63,0.524,13,23,0.565,11,16,0.688,116
1758,CHO,2020-02-03,100,,ORL,0,240,41,89,0.461,32,58,0.552,9,31,0.29,9,14,0.643,100,43,80,0.538,27,46,0.587,16,34,0.471,10,17,0.588,112
1759,ATL,2020-02-01,100,@,DAL,0,240,37,91,0.407,27,58,0.466,10,33,0.303,16,21,0.762,100,44,94,0.468,24,55,0.436,20,39,0.513,15,16,0.938,123
1760,UTA,2020-01-30,100,@,DEN,0,240,36,78,0.462,19,41,0.463,17,37,0.459,11,17,0.647,100,40,85,0.471,31,58,0.534,9,27,0.333,17,21,0.81,106
1761,SAC,2020-01-29,100,,OKC,0,240,42,91,0.462,33,52,0.635,9,39,0.231,7,11,0.636,100,44,88,0.5,29,54,0.537,15,34,0.441,17,20,0.85,120
1762,DET,2020-01-27,100,,CLE,0,240,38,84,0.452,26,49,0.531,12,35,0.343,12,17,0.706,100,48,96,0.5,39,72,0.542,9,24,0.375,10,13,0.769,115
1763,LAL,2020-01-22,100,@,NYK,1,240,36,82,0.439,27,55,0.491,9,27,0.333,19,28,0.679,100,36,88,0.409,25,54,0.463,11,34,0.324,9,13,0.692,92
1764,DET,2020-01-20,100,@,WAS,0,240,38,89,0.427,28,57,0.491,10,32,0.313,14,20,0.7,100,42,82,0.512,33,58,0.569,9,24,0.375,13,16,0.813,106
1765,MIN,2020-01-20,100,,DEN,0,240,38,91,0.418,25,49,0.51,13,42,0.31,11,14,0.786,100,43,90,0.478,32,59,0.542,11,31,0.355,10,12,0.833,107
1766,PHI,2020-01-17,100,,CHI,1,240,40,82,0.488,31,53,0.585,9,29,0.31,11,11,1.0,100,35,81,0.432,27,46,0.587,8,35,0.229,11,15,0.733,89
1767,DEN,2020-01-15,100,,CHO,1,240,38,79,0.481,29,51,0.569,9,28,0.321,15,25,0.6,100,33,81,0.407,21,46,0.457,12,35,0.343,8,14,0.571,86
1768,SAS,2020-01-15,100,@,MIA,0,240,39,89,0.438,29,56,0.518,10,33,0.303,12,15,0.8,100,41,88,0.466,24,48,0.5,17,40,0.425,7,13,0.538,106
1769,PHO,2020-01-12,100,,CHO,1,240,41,82,0.5,34,61,0.557,7,21,0.333,11,18,0.611,100,36,86,0.419,28,51,0.549,8,35,0.229,12,18,0.667,92
1770,GSW,2020-01-10,100,@,LAC,0,240,37,96,0.385,29,57,0.509,8,39,0.205,18,25,0.72,100,41,84,0.488,30,45,0.667,11,39,0.282,16,22,0.727,109
1771,ORL,2019-12-28,100,@,MIL,0,240,35,87,0.402,21,52,0.404,14,35,0.4,16,19,0.842,100,43,84,0.512,30,47,0.638,13,37,0.351,12,18,0.667,111
1772,WAS,2019-12-28,100,,NYK,0,240,33,96,0.344,23,71,0.324,10,25,0.4,24,31,0.774,100,38,85,0.447,27,54,0.5,11,31,0.355,20,26,0.769,107
1773,DEN,2019-12-25,100,,NOP,0,240,37,92,0.402,25,55,0.455,12,37,0.324,14,18,0.778,100,41,90,0.456,23,47,0.489,18,43,0.419,12,12,1.0,112
1774,MIN,2019-12-20,100,@,DEN,0,240,36,87,0.414,26,45,0.578,10,42,0.238,18,27,0.667,100,44,89,0.494,34,61,0.557,10,28,0.357,11,12,0.917,109
1775,CLE,2019-12-18,100,,CHO,1,240,40,74,0.541,33,48,0.688,7,26,0.269,13,17,0.765,100,37,91,0.407,24,54,0.444,13,37,0.351,11,18,0.611,98
1776,SAC,2019-12-15,100,@,GSW,1,240,38,63,0.603,28,41,0.683,10,22,0.455,14,16,0.875,100,30,76,0.395,24,51,0.471,6,25,0.24,13,18,0.722,79
1777,ATL,2019-12-13,100,,IND,0,240,39,94,0.415,33,66,0.5,6,28,0.214,16,23,0.696,100,46,92,0.5,39,70,0.557,7,22,0.318,11,15,0.733,110
1778,GSW,2019-12-06,100,@,CHI,1,240,38,71,0.535,29,47,0.617,9,24,0.375,15,22,0.682,100,39,88,0.443,22,47,0.468,17,41,0.415,3,5,0.6,98
1779,OKC,2019-12-04,100,,IND,0,240,41,84,0.488,32,58,0.552,9,26,0.346,9,10,0.9,100,42,87,0.483,33,63,0.524,9,24,0.375,14,17,0.824,107
1780,ORL,2019-12-01,100,,GSW,1,240,37,87,0.425,26,54,0.481,11,33,0.333,15,22,0.682,100,36,91,0.396,30,68,0.441,6,23,0.261,18,23,0.783,96
1781,LAL,2019-12-01,100,,DAL,0,240,40,87,0.46,33,60,0.55,7,27,0.259,13,16,0.813,100,42,97,0.433,25,48,0.521,17,49,0.347,13,18,0.722,114
1782,SAC,2019-11-30,100,,DEN,1,265,37,96,0.385,29,63,0.46,8,33,0.242,18,21,0.857,100,36,87,0.414,25,55,0.455,11,32,0.344,14,21,0.667,97
1783,OKC,2019-11-25,100,@,GSW,1,240,40,85,0.471,29,53,0.547,11,32,0.344,9,11,0.818,100,37,89,0.416,28,69,0.406,9,20,0.45,14,16,0.875,97
1784,CHO,2019-11-25,100,@,MIA,0,240,36,87,0.414,27,54,0.5,9,33,0.273,19,25,0.76,100,40,77,0.519,27,46,0.587,13,31,0.419,24,28,0.857,117
1785,PHO,2019-11-23,100,@,MIN,1,240,33,96,0.344,23,61,0.377,10,35,0.286,24,26,0.923,100,38,91,0.418,26,49,0.531,12,42,0.286,10,17,0.588,98
1786,CLE,2019-11-20,100,@,MIA,0,240,37,87,0.425,25,49,0.51,12,38,0.316,14,16,0.875,100,41,78,0.526,22,41,0.537,19,37,0.514,23,31,0.742,124
1787,GSW,2019-11-17,100,@,NOP,0,240,37,91,0.407,30,66,0.455,7,25,0.28,19,23,0.826,100,37,89,0.416,19,43,0.442,18,46,0.391,16,20,0.8,108
1788,SAC,2019-11-17,100,,BOS,1,240,38,89,0.427,24,54,0.444,14,35,0.4,10,12,0.833,100,34,82,0.415,24,52,0.462,10,30,0.333,21,24,0.875,99
1789,GSW,2019-11-15,100,,BOS,0,240,34,82,0.415,29,54,0.537,5,28,0.179,27,34,0.794,100,37,91,0.407,24,58,0.414,13,33,0.394,18,23,0.783,105
1790,DEN,2019-11-10,100,@,MIN,1,265,39,101,0.386,28,73,0.384,11,28,0.393,11,17,0.647,100,34,97,0.351,28,52,0.538,6,45,0.133,24,33,0.727,98
1791,MIL,2019-11-08,100,@,UTA,0,240,34,95,0.358,24,59,0.407,10,36,0.278,22,30,0.733,100,34,84,0.405,19,48,0.396,15,36,0.417,20,29,0.69,103
1792,DEN,2019-11-08,100,,PHI,1,240,39,87,0.448,30,65,0.462,9,22,0.409,13,17,0.765,100,38,86,0.442,25,60,0.417,13,26,0.5,8,17,0.471,97
1793,WAS,2019-11-08,100,,CLE,0,240,45,96,0.469,38,65,0.585,7,31,0.226,3,6,0.5,100,41,90,0.456,35,63,0.556,6,27,0.222,25,29,0.862,113
1794,SAS,2019-11-05,100,@,ATL,0,240,38,91,0.418,30,58,0.517,8,33,0.242,16,23,0.696,100,43,90,0.478,32,60,0.533,11,30,0.367,11,16,0.688,108
1795,MEM,2019-11-04,100,,HOU,0,240,40,94,0.426,37,69,0.536,3,25,0.12,17,21,0.81,100,35,93,0.376,18,43,0.419,17,50,0.34,20,29,0.69,107
1796,HOU,2019-11-03,100,@,MIA,0,240,31,79,0.392,17,31,0.548,14,48,0.292,24,31,0.774,100,47,89,0.528,29,48,0.604,18,41,0.439,17,22,0.773,129
1797,DET,2019-10-24,100,,ATL,0,240,35,85,0.412,25,48,0.521,10,37,0.27,20,22,0.909,100,44,86,0.512,33,55,0.6,11,31,0.355,18,21,0.857,117
1798,UTA,2019-10-23,100,,OKC,1,240,40,90,0.444,34,66,0.515,6,24,0.25,14,20,0.7,100,32,83,0.386,22,56,0.393,10,27,0.37,21,31,0.677,95
1799,POR,2019-10-23,100,,DEN,0,240,36,87,0.414,29,59,0.492,7,28,0.25,21,23,0.913,100,34,81,0.42,16,49,0.327,18,32,0.563,22,27,0.815,108
1800,WAS,2019-10-23,100,@,DAL,0,240,37,93,0.398,26,52,0.5,11,41,0.268,15,18,0.833,100,35,76,0.461,24,40,0.6,11,36,0.306,27,33,0.818,108
1801,MEM,2020-08-09,99,@,TOR,0,240,37,91,0.407,23,49,0.469,14,42,0.333,11,16,0.688,99,34,71,0.479,19,32,0.594,15,39,0.385,25,33,0.758,108
1802,IND,2020-08-06,99,@,PHO,0,240,37,85,0.435,27,56,0.482,10,29,0.345,15,19,0.789,99,43,92,0.467,34,58,0.586,9,34,0.265,19,20,0.95,114
1803,ORL,2020-08-05,99,,TOR,0,240,35,87,0.402,24,46,0.522,11,41,0.268,18,26,0.692,99,38,78,0.487,26,45,0.578,12,33,0.364,21,30,0.7,109
1804,MEM,2020-08-03,99,@,NOP,0,240,37,93,0.398,25,50,0.5,12,43,0.279,13,15,0.867,99,37,82,0.451,26,53,0.491,11,29,0.379,24,39,0.615,109
1805,HOU,2020-03-07,99,@,CHO,0,240,35,76,0.461,20,31,0.645,15,45,0.333,14,20,0.7,99,37,70,0.529,22,38,0.579,15,32,0.469,19,25,0.76,108
1806,UTA,2020-03-06,99,@,BOS,1,240,36,80,0.45,19,35,0.543,17,45,0.378,10,12,0.833,99,35,94,0.372,25,58,0.431,10,36,0.278,14,18,0.778,94
1807,PHO,2020-02-29,99,,GSW,0,240,34,83,0.41,22,54,0.407,12,29,0.414,19,23,0.826,99,41,87,0.471,32,57,0.561,9,30,0.3,24,32,0.75,115
1808,CHO,2020-02-28,99,@,TOR,1,240,34,78,0.436,21,48,0.438,13,30,0.433,18,25,0.72,99,33,95,0.347,23,52,0.442,10,43,0.233,20,29,0.69,96
1809,WAS,2020-02-09,99,,MEM,0,240,35,100,0.35,28,67,0.418,7,33,0.212,22,29,0.759,99,43,102,0.422,38,70,0.543,5,32,0.156,15,25,0.6,106
1810,POR,2020-02-04,99,@,DEN,0,240,36,91,0.396,27,60,0.45,9,31,0.29,18,22,0.818,99,46,90,0.511,29,56,0.518,17,34,0.5,18,25,0.72,127
1811,SAS,2020-01-24,99,,PHO,0,240,33,78,0.423,28,53,0.528,5,25,0.2,28,33,0.848,99,39,84,0.464,31,55,0.564,8,29,0.276,17,21,0.81,103
1812,MIN,2020-01-15,99,,IND,0,240,38,88,0.432,27,60,0.45,11,28,0.393,12,16,0.75,99,44,85,0.518,37,62,0.597,7,23,0.304,9,12,0.75,104
1813,CLE,2020-01-13,99,@,LAL,0,240,38,85,0.447,31,60,0.517,7,25,0.28,16,24,0.667,99,48,88,0.545,37,58,0.638,11,30,0.367,21,28,0.75,128
1814,DET,2020-01-11,99,,CHI,0,240,36,78,0.462,27,50,0.54,9,28,0.321,18,27,0.667,99,42,83,0.506,31,48,0.646,11,35,0.314,13,14,0.929,108
1815,TOR,2020-01-07,99,,POR,0,240,35,96,0.365,20,54,0.37,15,42,0.357,14,19,0.737,99,38,88,0.432,25,53,0.472,13,35,0.371,12,14,0.857,101
1816,WAS,2020-01-06,99,,BOS,1,240,39,84,0.464,32,63,0.508,7,21,0.333,14,23,0.609,99,33,95,0.347,25,58,0.431,8,37,0.216,20,26,0.769,94
1817,DET,2020-01-05,99,@,LAL,0,240,29,78,0.372,18,52,0.346,11,26,0.423,30,35,0.857,99,42,92,0.457,36,72,0.5,6,20,0.3,16,23,0.696,106
1818,MIN,2020-01-02,99,,GSW,1,240,38,95,0.4,25,52,0.481,13,43,0.302,10,17,0.588,99,33,77,0.429,30,57,0.526,3,20,0.15,15,21,0.714,84
1819,MIN,2019-12-18,99,,NOP,0,240,36,95,0.379,26,56,0.464,10,39,0.256,17,27,0.63,99,38,86,0.442,24,53,0.453,14,33,0.424,17,21,0.81,107
1820,DET,2019-12-18,99,,TOR,0,240,39,87,0.448,33,52,0.635,6,35,0.171,15,22,0.682,99,39,91,0.429,26,56,0.464,13,35,0.371,21,24,0.875,112
1821,PHO,2019-12-17,99,@,LAC,0,240,41,102,0.402,31,67,0.463,10,35,0.286,7,10,0.7,99,45,89,0.506,31,57,0.544,14,32,0.438,16,22,0.727,120
1822,POR,2019-12-12,99,@,DEN,0,240,41,86,0.477,32,56,0.571,9,30,0.3,8,11,0.727,99,42,88,0.477,24,52,0.462,18,36,0.5,12,19,0.632,114
1823,IND,2019-12-09,99,,LAC,0,240,34,97,0.351,24,62,0.387,10,35,0.286,21,28,0.75,99,40,97,0.412,30,65,0.462,10,32,0.313,20,27,0.741,110
1824,MEM,2019-12-04,99,@,CHI,0,240,37,96,0.385,30,66,0.455,7,30,0.233,18,21,0.857,99,33,77,0.429,20,44,0.455,13,33,0.394,27,37,0.73,106
1825,DAL,2019-11-26,99,,LAC,0,240,30,79,0.38,19,41,0.463,11,38,0.289,28,35,0.8,99,41,97,0.423,30,64,0.469,11,33,0.333,21,30,0.7,114
1826,BOS,2019-11-18,99,@,PHO,1,240,37,89,0.416,25,48,0.521,12,41,0.293,13,17,0.765,99,33,82,0.402,23,46,0.5,10,36,0.278,9,12,0.75,85
1827,BOS,2019-11-17,99,@,SAC,0,240,34,82,0.415,24,52,0.462,10,30,0.333,21,24,0.875,99,38,89,0.427,24,54,0.444,14,35,0.4,10,12,0.833,100
1828,LAL,2019-11-15,99,,SAC,1,240,34,81,0.42,23,44,0.523,11,37,0.297,20,22,0.909,99,36,82,0.439,20,43,0.465,16,39,0.41,9,9,1.0,97
1829,POR,2019-11-12,99,@,SAC,0,240,34,77,0.442,26,47,0.553,8,30,0.267,23,30,0.767,99,38,86,0.442,27,54,0.5,11,32,0.344,20,26,0.769,107
1830,DET,2019-11-04,99,@,WAS,0,240,34,82,0.415,21,55,0.382,13,27,0.481,18,23,0.783,99,43,93,0.462,35,64,0.547,8,29,0.276,21,25,0.84,115
1831,OKC,2019-10-30,99,,POR,0,240,33,84,0.393,29,57,0.509,4,27,0.148,29,37,0.784,99,34,86,0.395,17,51,0.333,17,35,0.486,17,24,0.708,102
1832,IND,2019-10-26,99,@,CLE,0,240,39,87,0.448,29,59,0.492,10,28,0.357,11,13,0.846,99,40,80,0.5,29,49,0.592,11,31,0.355,19,29,0.655,110
1833,ORL,2019-10-26,99,@,ATL,0,240,35,99,0.354,30,68,0.441,5,31,0.161,24,26,0.923,99,43,84,0.512,34,54,0.63,9,30,0.3,8,15,0.533,103
1834,CHO,2019-10-25,99,,MIN,0,240,37,84,0.44,25,55,0.455,12,29,0.414,13,26,0.5,99,43,91,0.473,31,53,0.585,12,38,0.316,23,31,0.742,121
1835,WAS,2020-08-05,98,,PHI,0,240,36,85,0.424,29,64,0.453,7,21,0.333,19,24,0.792,98,38,82,0.463,27,53,0.509,11,29,0.379,20,29,0.69,107
1836,MIA,2020-03-11,98,,CHO,0,240,39,84,0.464,24,40,0.6,15,44,0.341,5,6,0.833,98,37,82,0.451,20,48,0.417,17,34,0.5,18,22,0.818,109
1837,DET,2020-02-25,98,@,DEN,0,240,33,81,0.407,18,40,0.45,15,41,0.366,17,21,0.81,98,44,76,0.579,35,57,0.614,9,19,0.474,18,22,0.818,115
1838,PHI,2020-02-22,98,@,MIL,0,240,35,99,0.354,22,61,0.361,13,38,0.342,15,18,0.833,98,48,91,0.527,34,50,0.68,14,41,0.341,9,13,0.692,119
1839,NYK,2020-02-21,98,,IND,0,240,35,81,0.432,24,56,0.429,11,25,0.44,17,25,0.68,98,36,88,0.409,28,60,0.467,8,28,0.286,26,33,0.788,106
1840,DEN,2020-02-05,98,@,UTA,1,240,39,90,0.433,32,60,0.533,7,30,0.233,13,18,0.722,98,36,86,0.419,22,47,0.468,14,39,0.359,9,14,0.643,95
1841,ORL,2020-01-24,98,,BOS,0,240,36,90,0.4,24,53,0.453,12,37,0.324,14,19,0.737,98,40,86,0.465,26,51,0.51,14,35,0.4,15,18,0.833,109
1842,SAC,2020-01-24,98,@,CHI,1,240,35,81,0.432,25,49,0.51,10,32,0.313,18,21,0.857,98,31,79,0.392,23,42,0.548,8,37,0.216,11,14,0.786,81
1843,CHI,2020-01-20,98,@,MIL,0,240,34,92,0.37,20,44,0.455,14,48,0.292,16,18,0.889,98,45,77,0.584,34,51,0.667,11,26,0.423,10,23,0.435,111
1844,NYK,2020-01-16,98,,PHO,0,240,37,90,0.411,29,64,0.453,8,26,0.308,16,24,0.667,98,47,92,0.511,35,62,0.565,12,30,0.4,15,18,0.833,121
1845,PHO,2020-01-10,98,,ORL,1,240,33,79,0.418,24,51,0.471,9,28,0.321,23,26,0.885,98,33,89,0.371,24,56,0.429,9,33,0.273,19,24,0.792,94
1846,BOS,2020-01-09,98,@,PHI,0,240,38,88,0.432,24,52,0.462,14,36,0.389,8,8,1.0,98,43,88,0.489,32,61,0.525,11,27,0.407,12,17,0.706,109
1847,GSW,2020-01-08,98,,MIL,0,240,33,87,0.379,18,49,0.367,15,38,0.395,17,20,0.85,98,35,87,0.402,26,46,0.565,9,41,0.22,28,32,0.875,107
1848,GSW,2020-01-06,98,@,SAC,0,240,34,86,0.395,29,60,0.483,5,26,0.192,25,32,0.781,98,39,81,0.481,24,51,0.471,15,30,0.5,18,23,0.783,111
1849,CHI,2020-01-02,98,,UTA,0,240,37,94,0.394,26,58,0.448,11,36,0.306,13,17,0.765,98,37,76,0.487,26,46,0.565,11,30,0.367,17,22,0.773,102
1850,OKC,2019-12-29,98,@,TOR,1,240,34,78,0.436,24,45,0.533,10,33,0.303,20,23,0.87,98,35,83,0.422,20,43,0.465,15,40,0.375,12,12,1.0,97
1851,BRK,2019-12-28,98,@,HOU,0,240,37,92,0.402,26,53,0.491,11,39,0.282,13,21,0.619,98,44,101,0.436,31,59,0.525,13,42,0.31,7,16,0.438,108
1852,IND,2019-12-28,98,@,NOP,0,240,33,85,0.388,27,57,0.474,6,28,0.214,26,29,0.897,98,43,93,0.462,25,51,0.49,18,42,0.429,16,20,0.8,120
1853,ORL,2019-12-27,98,,PHI,1,240,37,88,0.42,27,58,0.466,10,30,0.333,14,23,0.609,98,35,87,0.402,25,58,0.431,10,29,0.345,17,21,0.81,97
1854,SAS,2019-12-26,98,@,DAL,0,240,40,83,0.482,32,54,0.593,8,29,0.276,10,15,0.667,98,38,90,0.422,22,50,0.44,16,40,0.4,10,15,0.667,102
1855,PHI,2019-12-20,98,,DAL,0,240,38,90,0.422,28,56,0.5,10,34,0.294,12,18,0.667,98,43,83,0.518,29,50,0.58,14,33,0.424,17,22,0.773,117
1856,CHO,2019-12-18,98,@,CLE,0,240,37,91,0.407,24,54,0.444,13,37,0.351,11,18,0.611,98,40,74,0.541,33,48,0.688,7,26,0.269,13,17,0.765,100
1857,CHI,2019-12-06,98,,GSW,0,240,39,88,0.443,22,47,0.468,17,41,0.415,3,5,0.6,98,38,71,0.535,29,47,0.617,9,24,0.375,15,22,0.682,100
1858,SAS,2019-12-01,98,@,DET,0,240,36,88,0.409,29,62,0.468,7,26,0.269,19,22,0.864,98,52,88,0.591,37,57,0.649,15,31,0.484,13,18,0.722,132
1859,NYK,2019-11-27,98,@,TOR,0,240,33,88,0.375,21,47,0.447,12,41,0.293,20,24,0.833,98,46,94,0.489,25,53,0.472,21,41,0.512,13,17,0.765,126
1860,MIN,2019-11-23,98,,PHO,0,240,38,91,0.418,26,49,0.531,12,42,0.286,10,17,0.588,98,33,96,0.344,23,61,0.377,10,35,0.286,24,26,0.923,100
1861,PHI,2019-11-12,98,,CLE,1,240,40,89,0.449,32,51,0.627,8,38,0.211,10,13,0.769,98,38,86,0.442,33,65,0.508,5,21,0.238,16,20,0.8,97
1862,LAC,2019-11-11,98,,TOR,1,240,34,92,0.37,26,56,0.464,8,36,0.222,22,30,0.733,98,34,85,0.4,23,55,0.418,11,30,0.367,9,15,0.6,88
1863,MIN,2019-11-10,98,,DEN,0,265,34,97,0.351,28,52,0.538,6,45,0.133,24,33,0.727,98,39,101,0.386,28,73,0.384,11,28,0.393,11,17,0.647,100
1864,CHI,2019-10-28,98,@,NYK,0,240,36,85,0.424,27,50,0.54,9,35,0.257,17,21,0.81,98,38,91,0.418,29,62,0.468,9,29,0.31,20,32,0.625,105
1865,LAL,2020-08-06,97,@,HOU,0,240,35,77,0.455,33,58,0.569,2,19,0.105,25,36,0.694,97,36,84,0.429,15,27,0.556,21,57,0.368,20,23,0.87,113
1866,DEN,2020-03-11,97,@,DAL,0,240,39,83,0.47,25,44,0.568,14,39,0.359,5,8,0.625,97,42,92,0.457,30,57,0.526,12,35,0.343,17,23,0.739,113
1867,TOR,2020-02-25,97,,MIL,0,240,32,91,0.352,14,39,0.359,18,52,0.346,15,21,0.714,97,32,84,0.381,18,42,0.429,14,42,0.333,30,36,0.833,108
1868,MEM,2020-02-24,97,@,LAC,0,240,37,89,0.416,30,62,0.484,7,27,0.259,16,22,0.727,97,47,94,0.5,31,57,0.544,16,37,0.432,14,17,0.824,124
1869,MIA,2020-02-07,97,@,SAC,0,240,34,77,0.442,22,37,0.595,12,40,0.3,17,25,0.68,97,40,82,0.488,21,38,0.553,19,44,0.432,6,12,0.5,105
1870,PHO,2020-02-03,97,@,BRK,0,240,39,90,0.433,33,73,0.452,6,17,0.353,13,18,0.722,97,43,89,0.483,28,55,0.509,15,34,0.441,18,21,0.857,119
1871,CHO,2020-01-28,97,,NYK,1,240,34,88,0.386,26,56,0.464,8,32,0.25,21,27,0.778,97,38,86,0.442,29,54,0.537,9,32,0.281,7,11,0.636,92
1872,OKC,2020-01-27,97,,DAL,0,240,34,86,0.395,22,56,0.393,12,30,0.4,17,19,0.895,97,41,99,0.414,22,48,0.458,19,51,0.373,6,9,0.667,107
1873,BRK,2020-01-26,97,@,NYK,0,240,34,81,0.42,21,42,0.5,13,39,0.333,16,23,0.696,97,49,92,0.533,43,73,0.589,6,19,0.316,6,13,0.462,110
1874,ORL,2020-01-26,97,,LAC,0,240,34,95,0.358,27,63,0.429,7,32,0.219,22,32,0.688,97,37,79,0.468,24,49,0.49,13,30,0.433,25,29,0.862,112
1875,BRK,2020-01-18,97,,MIL,0,240,33,99,0.333,18,50,0.36,15,49,0.306,16,17,0.941,97,45,89,0.506,28,52,0.538,17,37,0.459,10,16,0.625,117
1876,GSW,2020-01-14,97,,DAL,0,240,39,87,0.448,30,55,0.545,9,32,0.281,10,13,0.769,97,49,96,0.51,36,59,0.61,13,37,0.351,13,21,0.619,124
1877,PHI,2019-12-31,97,@,IND,0,240,37,91,0.407,31,62,0.5,6,29,0.207,17,20,0.85,97,42,86,0.488,31,61,0.508,11,25,0.44,20,26,0.769,115
1878,CLE,2019-12-31,97,@,TOR,0,240,37,87,0.425,27,49,0.551,10,38,0.263,13,16,0.813,97,40,84,0.476,23,45,0.511,17,39,0.436,20,25,0.8,117
1879,TOR,2019-12-29,97,,OKC,0,240,35,83,0.422,20,43,0.465,15,40,0.375,12,12,1.0,97,34,78,0.436,24,45,0.533,10,33,0.303,20,23,0.87,98
1880,BOS,2019-12-28,97,,TOR,0,240,31,78,0.397,24,46,0.522,7,32,0.219,28,36,0.778,97,44,84,0.524,30,50,0.6,14,34,0.412,11,17,0.647,113
1881,PHI,2019-12-27,97,@,ORL,0,240,35,87,0.402,25,58,0.431,10,29,0.345,17,21,0.81,97,37,88,0.42,27,58,0.466,10,30,0.333,14,23,0.609,98
1882,OKC,2019-12-26,97,,MEM,0,240,38,92,0.413,28,57,0.491,10,35,0.286,11,13,0.846,97,46,84,0.548,36,59,0.61,10,25,0.4,8,11,0.727,110
1883,PHI,2019-12-10,97,,DEN,1,240,37,89,0.416,25,53,0.472,12,36,0.333,11,16,0.688,97,37,85,0.435,30,58,0.517,7,27,0.259,11,12,0.917,92
1884,NOP,2019-12-03,97,,DAL,0,240,38,94,0.404,27,53,0.509,11,41,0.268,10,15,0.667,97,38,88,0.432,19,43,0.442,19,45,0.422,23,27,0.852,118
1885,POR,2019-12-03,97,@,LAC,0,240,39,91,0.429,32,64,0.5,7,27,0.259,12,15,0.8,97,43,94,0.457,26,60,0.433,17,34,0.5,14,25,0.56,117
1886,DEN,2019-11-30,97,@,SAC,0,265,36,87,0.414,25,55,0.455,11,32,0.344,14,21,0.667,97,37,96,0.385,29,63,0.46,8,33,0.242,18,21,0.857,100
1887,LAC,2019-11-29,97,@,SAS,0,240,36,92,0.391,24,59,0.407,12,33,0.364,13,13,1.0,97,40,93,0.43,26,57,0.456,14,36,0.389,13,14,0.929,107
1888,PHI,2019-11-27,97,,SAC,1,240,36,77,0.468,31,51,0.608,5,26,0.192,20,24,0.833,97,39,95,0.411,30,61,0.492,9,34,0.265,4,9,0.444,91
1889,GSW,2019-11-25,97,,OKC,0,240,37,89,0.416,28,69,0.406,9,20,0.45,14,16,0.875,97,40,85,0.471,29,53,0.547,11,32,0.344,9,11,0.818,100
1890,SAC,2019-11-22,97,@,BRK,0,240,39,86,0.453,35,60,0.583,4,26,0.154,15,19,0.789,97,41,81,0.506,29,47,0.617,12,34,0.353,22,31,0.71,116
1891,ORL,2019-11-20,97,@,TOR,0,240,35,91,0.385,26,59,0.441,9,32,0.281,18,28,0.643,97,45,87,0.517,36,60,0.6,9,27,0.333,14,19,0.737,113
1892,SAC,2019-11-15,97,@,LAL,0,240,36,82,0.439,20,43,0.465,16,39,0.41,9,9,1.0,97,34,81,0.42,23,44,0.523,11,37,0.297,20,22,0.909,99
1893,CLE,2019-11-14,97,,MIA,0,240,36,85,0.424,28,53,0.528,8,32,0.25,17,21,0.81,97,43,79,0.544,31,49,0.633,12,30,0.4,10,11,0.909,108
1894,PHI,2019-11-13,97,@,ORL,0,240,40,91,0.44,32,61,0.525,8,30,0.267,9,13,0.692,97,38,86,0.442,28,54,0.519,10,32,0.313,26,34,0.765,112
1895,CLE,2019-11-12,97,@,PHI,0,240,38,86,0.442,33,65,0.508,5,21,0.238,16,20,0.8,97,40,89,0.449,32,51,0.627,8,38,0.211,10,13,0.769,98
1896,PHI,2019-11-08,97,@,DEN,0,240,38,86,0.442,25,60,0.417,13,26,0.5,8,17,0.471,97,39,87,0.448,30,65,0.462,9,22,0.409,13,17,0.765,100
1897,ATL,2019-10-31,97,,MIA,0,240,36,88,0.409,29,54,0.537,7,34,0.206,18,26,0.692,97,40,84,0.476,26,47,0.553,14,37,0.378,12,19,0.632,106
1898,SAS,2019-10-31,97,@,LAC,0,240,36,80,0.45,29,59,0.492,7,21,0.333,18,27,0.667,97,39,91,0.429,34,65,0.523,5,26,0.192,20,27,0.741,103
1899,ATL,2019-10-29,97,@,MIA,0,240,35,83,0.422,24,44,0.545,11,39,0.282,16,24,0.667,97,33,73,0.452,20,42,0.476,13,31,0.419,33,45,0.733,112
1900,WAS,2019-10-25,97,@,OKC,1,240,39,97,0.402,28,56,0.5,11,41,0.268,8,10,0.8,97,33,83,0.398,28,60,0.467,5,23,0.217,14,22,0.636,85
1901,HOU,2020-08-14,96,,PHI,0,240,35,80,0.438,23,32,0.719,12,48,0.25,14,16,0.875,96,49,87,0.563,31,49,0.633,18,38,0.474,18,22,0.818,134
1902,WAS,2020-08-13,96,@,BOS,1,240,34,88,0.386,24,62,0.387,10,26,0.385,18,24,0.75,96,35,88,0.398,27,53,0.509,8,35,0.229,12,14,0.857,90
1903,ORL,2020-08-11,96,,BRK,0,240,32,83,0.386,25,60,0.417,7,23,0.304,25,29,0.862,96,38,89,0.427,25,46,0.543,13,43,0.302,19,24,0.792,108
1904,NYK,2020-03-08,96,,DET,1,240,36,82,0.439,30,63,0.476,6,19,0.316,18,25,0.72,96,29,80,0.363,18,42,0.429,11,38,0.289,15,22,0.682,84
1905,MEM,2020-03-06,96,@,DAL,0,240,39,84,0.464,30,54,0.556,9,30,0.3,9,13,0.692,96,45,95,0.474,27,48,0.563,18,47,0.383,13,17,0.765,121
1906,TOR,2020-02-28,96,,CHO,0,240,33,95,0.347,23,52,0.442,10,43,0.233,20,29,0.69,96,34,78,0.436,21,48,0.438,13,30,0.433,18,25,0.72,99
1907,NYK,2020-02-12,96,,WAS,0,240,36,88,0.409,33,65,0.508,3,23,0.13,21,29,0.724,96,40,84,0.476,30,56,0.536,10,28,0.357,24,33,0.727,114
1908,MEM,2020-02-03,96,,DET,1,240,42,90,0.467,40,73,0.548,2,17,0.118,10,12,0.833,96,34,98,0.347,26,72,0.361,8,26,0.308,6,9,0.667,82
1909,DEN,2020-01-28,96,@,MEM,0,240,32,86,0.372,15,41,0.366,17,45,0.378,15,18,0.833,96,46,82,0.561,40,64,0.625,6,18,0.333,6,14,0.429,104
1910,GSW,2020-01-22,96,,UTA,0,240,35,88,0.398,29,65,0.446,6,23,0.261,20,24,0.833,96,50,93,0.538,33,53,0.623,17,40,0.425,12,23,0.522,129
1911,ORL,2020-01-04,96,,UTA,0,240,38,85,0.447,27,48,0.563,11,37,0.297,9,12,0.75,96,42,93,0.452,26,53,0.491,16,40,0.4,9,14,0.643,109
1912,PHO,2019-12-27,96,@,GSW,0,240,35,75,0.467,28,42,0.667,7,33,0.212,19,24,0.792,96,38,92,0.413,29,65,0.446,9,27,0.333,20,25,0.8,105
1913,ATL,2019-12-15,96,,LAL,0,240,31,86,0.36,19,44,0.432,12,42,0.286,22,25,0.88,96,36,84,0.429,31,53,0.585,5,31,0.161,24,33,0.727,101
1914,LAL,2019-12-11,96,@,ORL,1,240,37,87,0.425,25,56,0.446,12,31,0.387,10,19,0.526,96,34,81,0.42,26,55,0.473,8,26,0.308,11,17,0.647,87
1915,POR,2019-12-08,96,,OKC,0,240,36,100,0.36,27,67,0.403,9,33,0.273,15,18,0.833,96,35,85,0.412,24,53,0.453,11,32,0.344,27,34,0.794,108
1916,UTA,2019-12-04,96,,LAL,0,240,34,83,0.41,20,52,0.385,14,31,0.452,14,19,0.737,96,46,90,0.511,32,61,0.525,14,29,0.483,15,25,0.6,121
1917,DEN,2019-12-03,96,,LAL,0,240,37,91,0.407,31,62,0.5,6,29,0.207,16,17,0.941,96,39,84,0.464,32,60,0.533,7,24,0.292,20,30,0.667,105
1918,GSW,2019-12-01,96,@,ORL,0,240,36,91,0.396,30,68,0.441,6,23,0.261,18,23,0.783,96,37,87,0.425,26,54,0.481,11,33,0.333,15,22,0.682,100
1919,CHO,2019-11-30,96,@,MIL,0,240,37,101,0.366,22,56,0.393,15,45,0.333,7,8,0.875,96,54,96,0.563,34,52,0.654,20,44,0.455,9,15,0.6,137
1920,PHI,2019-11-25,96,@,TOR,0,240,36,88,0.409,21,48,0.438,15,40,0.375,9,16,0.563,96,38,84,0.452,27,50,0.54,11,34,0.324,14,22,0.636,101
1921,DEN,2019-11-22,96,,BOS,1,240,39,88,0.443,32,60,0.533,7,28,0.25,11,13,0.846,96,33,81,0.407,26,54,0.481,7,27,0.259,19,23,0.826,92
1922,CHO,2019-11-18,96,@,TOR,0,240,33,78,0.423,18,33,0.545,15,45,0.333,15,24,0.625,96,50,97,0.515,30,54,0.556,20,43,0.465,12,15,0.8,132
1923,SAS,2019-11-03,96,,LAL,0,240,33,83,0.398,27,58,0.466,6,25,0.24,24,29,0.828,96,42,87,0.483,36,63,0.571,6,24,0.25,13,19,0.684,103
1924,LAC,2019-10-30,96,@,UTA,0,240,39,82,0.476,31,59,0.525,8,23,0.348,10,12,0.833,96,44,80,0.55,33,56,0.589,11,24,0.458,11,16,0.688,110
1925,DET,2019-10-28,96,,IND,1,240,37,81,0.457,24,57,0.421,13,24,0.542,9,10,0.9,96,39,94,0.415,33,73,0.452,6,21,0.286,10,13,0.769,94
1926,UTA,2019-10-28,96,@,PHO,1,240,27,71,0.38,17,40,0.425,10,31,0.323,32,39,0.821,96,33,80,0.413,20,46,0.435,13,34,0.382,16,23,0.696,95
1927,CHO,2019-10-28,96,@,LAC,0,240,36,83,0.434,22,44,0.5,14,39,0.359,10,14,0.714,96,40,83,0.482,28,50,0.56,12,33,0.364,19,21,0.905,111
1928,MIL,2020-03-09,95,@,DEN,0,240,34,90,0.378,19,40,0.475,15,50,0.3,12,18,0.667,95,41,94,0.436,25,53,0.472,16,41,0.39,11,12,0.917,109
1929,NYK,2020-02-08,95,@,DET,1,240,38,85,0.447,30,63,0.476,8,22,0.364,11,17,0.647,95,34,69,0.493,21,40,0.525,13,29,0.448,11,16,0.688,92
1930,ORL,2020-02-08,95,,MIL,0,240,37,98,0.378,27,58,0.466,10,40,0.25,11,14,0.786,95,42,93,0.452,27,54,0.5,15,39,0.385,12,16,0.75,111
1931,UTA,2020-02-05,95,,DEN,0,240,36,86,0.419,22,47,0.468,14,39,0.359,9,14,0.643,95,39,90,0.433,32,60,0.533,7,30,0.233,13,18,0.722,98
1932,PHI,2020-02-01,95,@,BOS,0,240,31,84,0.369,24,51,0.471,7,33,0.212,26,31,0.839,95,38,80,0.475,30,50,0.6,8,30,0.267,32,41,0.78,116
1933,PHI,2020-01-22,95,@,TOR,0,240,32,84,0.381,14,38,0.368,18,46,0.391,13,18,0.722,95,40,86,0.465,27,53,0.509,13,33,0.394,14,21,0.667,107
1934,MEM,2020-01-22,95,@,BOS,0,240,36,85,0.424,25,53,0.472,11,32,0.344,12,15,0.8,95,45,89,0.506,31,57,0.544,14,32,0.438,15,20,0.75,119
1935,LAC,2020-01-22,95,@,ATL,0,240,33,78,0.423,29,57,0.509,4,21,0.19,25,39,0.641,95,36,102,0.353,25,67,0.373,11,35,0.314,19,23,0.826,102
1936,ORL,2020-01-18,95,@,GSW,0,240,39,86,0.453,30,55,0.545,9,31,0.29,8,13,0.615,95,43,94,0.457,31,54,0.574,12,40,0.3,11,11,1.0,109
1937,ORL,2020-01-16,95,@,LAC,0,240,36,92,0.391,22,50,0.44,14,42,0.333,9,16,0.563,95,47,95,0.495,33,63,0.524,14,32,0.438,14,20,0.7,122
1938,PHI,2020-01-13,95,@,IND,0,240,37,89,0.416,31,56,0.554,6,33,0.182,15,19,0.789,95,33,86,0.384,23,60,0.383,10,26,0.385,25,31,0.806,101
1939,DAL,2019-12-29,95,@,LAL,0,240,32,89,0.36,19,46,0.413,13,43,0.302,18,20,0.9,95,38,78,0.487,29,55,0.527,9,23,0.391,23,28,0.821,108
1940,CHI,2019-12-23,95,@,ORL,0,240,35,88,0.398,22,51,0.431,13,37,0.351,12,15,0.8,95,39,81,0.481,29,55,0.527,10,26,0.385,15,23,0.652,103
1941,DEN,2019-12-06,95,@,BOS,0,240,39,94,0.415,34,64,0.531,5,30,0.167,12,15,0.8,95,44,82,0.537,31,47,0.66,13,35,0.371,7,8,0.875,108
1942,NYK,2019-11-29,95,,PHI,0,240,34,78,0.436,26,58,0.448,8,20,0.4,19,33,0.576,95,31,72,0.431,24,46,0.522,7,26,0.269,32,40,0.8,101
1943,HOU,2019-11-20,95,@,DEN,0,240,32,76,0.421,20,38,0.526,12,38,0.316,19,25,0.76,95,44,94,0.468,35,67,0.522,9,27,0.333,8,15,0.533,105
1944,MIN,2019-11-20,95,,UTA,0,240,35,89,0.393,21,44,0.477,14,45,0.311,11,21,0.524,95,35,86,0.407,21,53,0.396,14,33,0.424,19,27,0.704,103
1945,MEM,2019-11-19,95,,GSW,0,240,36,88,0.409,27,63,0.429,9,25,0.36,14,19,0.737,95,43,90,0.478,34,61,0.557,9,29,0.31,19,22,0.864,114
1946,CLE,2019-11-17,95,,PHI,0,240,34,90,0.378,28,65,0.431,6,25,0.24,21,24,0.875,95,46,84,0.548,37,61,0.607,9,23,0.391,13,17,0.765,114
1947,LAL,2019-11-08,95,,MIA,1,240,40,89,0.449,32,57,0.561,8,32,0.25,7,8,0.875,95,28,80,0.35,22,45,0.489,6,35,0.171,18,24,0.75,80
1948,CHI,2019-11-03,95,@,IND,0,240,36,84,0.429,27,55,0.491,9,29,0.31,14,25,0.56,95,40,85,0.471,32,59,0.542,8,26,0.308,20,27,0.741,108
1949,CLE,2019-11-01,95,@,IND,0,240,32,87,0.368,21,55,0.382,11,32,0.344,20,25,0.8,95,39,96,0.406,34,69,0.493,5,27,0.185,19,21,0.905,102
1950,MIN,2019-10-30,95,@,PHI,0,240,32,81,0.395,22,46,0.478,10,35,0.286,21,28,0.75,95,43,92,0.467,34,67,0.507,9,25,0.36,22,28,0.786,117
1951,ORL,2019-10-30,95,,NYK,1,240,37,88,0.42,25,56,0.446,12,32,0.375,9,12,0.75,95,31,82,0.378,24,51,0.471,7,31,0.226,14,20,0.7,83
1952,ORL,2019-10-28,95,@,TOR,0,240,34,89,0.382,22,50,0.44,12,39,0.308,15,18,0.833,95,33,85,0.388,23,46,0.5,10,39,0.256,28,30,0.933,104
1953,PHO,2019-10-28,95,,UTA,0,240,33,80,0.413,20,46,0.435,13,34,0.382,16,23,0.696,95,27,71,0.38,17,40,0.425,10,31,0.323,32,39,0.821,96
1954,NYK,2019-10-26,95,,BOS,0,240,31,82,0.378,24,55,0.436,7,27,0.259,26,34,0.765,95,42,93,0.452,27,52,0.519,15,41,0.366,19,29,0.655,118
1955,LAL,2019-10-25,95,,UTA,1,240,34,86,0.395,26,60,0.433,8,26,0.308,19,24,0.792,95,29,70,0.414,21,45,0.467,8,25,0.32,20,21,0.952,86
1956,SAC,2019-10-23,95,@,PHO,0,240,34,87,0.391,24,58,0.414,10,29,0.345,17,26,0.654,95,49,98,0.5,38,65,0.585,11,33,0.333,15,18,0.833,124
1957,OKC,2019-10-23,95,@,UTA,0,240,32,83,0.386,22,56,0.393,10,27,0.37,21,31,0.677,95,40,90,0.444,34,66,0.515,6,24,0.25,14,20,0.7,100
1958,UTA,2020-08-01,94,@,OKC,0,240,34,87,0.391,26,56,0.464,8,31,0.258,18,22,0.818,94,41,77,0.532,31,51,0.608,10,26,0.385,18,24,0.75,110
1959,BOS,2020-03-06,94,,UTA,0,240,35,94,0.372,25,58,0.431,10,36,0.278,14,18,0.778,94,36,80,0.45,19,35,0.543,17,45,0.378,10,12,0.833,99
1960,OKC,2020-03-03,94,,LAC,0,240,34,81,0.42,25,53,0.472,9,28,0.321,17,26,0.654,94,38,84,0.452,27,48,0.563,11,36,0.306,22,26,0.846,109
1961,PHI,2020-02-26,94,@,CLE,0,240,36,89,0.404,23,51,0.451,13,38,0.342,9,14,0.643,94,41,78,0.526,30,54,0.556,11,24,0.458,15,17,0.882,108
1962,GSW,2020-02-25,94,,SAC,0,240,35,79,0.443,31,51,0.608,4,28,0.143,20,24,0.833,94,40,76,0.526,27,46,0.587,13,30,0.433,19,34,0.559,112
1963,ORL,2020-01-10,94,@,PHO,0,240,33,89,0.371,24,56,0.429,9,33,0.273,19,24,0.792,94,33,79,0.418,24,51,0.471,9,28,0.321,23,26,0.885,98
1964,BOS,2020-01-06,94,@,WAS,0,240,33,95,0.347,25,58,0.431,8,37,0.216,20,26,0.769,94,39,84,0.464,32,63,0.508,7,21,0.333,14,23,0.609,99
1965,CLE,2019-12-28,94,@,MIN,1,240,32,77,0.416,28,57,0.491,4,20,0.2,26,36,0.722,94,33,93,0.355,25,56,0.446,8,37,0.216,14,19,0.737,88
1966,NYK,2019-12-26,94,@,BRK,1,240,37,92,0.402,28,63,0.444,9,29,0.31,11,15,0.733,94,21,78,0.269,8,28,0.286,13,50,0.26,27,36,0.75,82
1967,POR,2019-12-23,94,,NOP,0,240,37,91,0.407,33,62,0.532,4,29,0.138,16,18,0.889,94,38,93,0.409,23,58,0.397,15,35,0.429,11,16,0.688,102
1968,SAC,2019-12-11,94,,OKC,1,240,39,88,0.443,29,57,0.509,10,31,0.323,6,10,0.6,94,34,79,0.43,21,46,0.457,13,33,0.394,12,18,0.667,93
1969,CLE,2019-12-07,94,@,PHI,0,240,36,96,0.375,27,61,0.443,9,35,0.257,13,17,0.765,94,57,90,0.633,46,64,0.719,11,26,0.423,16,23,0.696,141
1970,CLE,2019-12-03,94,,DET,0,240,38,90,0.422,30,63,0.476,8,27,0.296,10,14,0.714,94,51,94,0.543,33,59,0.559,18,35,0.514,7,11,0.636,127
1971,UTA,2019-12-02,94,@,PHI,0,240,38,81,0.469,33,59,0.559,5,22,0.227,13,20,0.65,94,37,91,0.407,24,65,0.369,13,26,0.5,16,23,0.696,103
1972,MEM,2019-11-29,94,,UTA,0,240,37,94,0.394,27,60,0.45,10,34,0.294,10,17,0.588,94,38,95,0.4,26,60,0.433,12,35,0.343,15,19,0.789,103
1973,CHI,2019-11-25,94,,POR,0,240,36,86,0.419,27,47,0.574,9,39,0.231,13,20,0.65,94,46,89,0.517,38,62,0.613,8,27,0.296,17,22,0.773,117
1974,GSW,2019-11-20,94,@,DAL,0,240,35,90,0.389,27,63,0.429,8,27,0.296,16,25,0.64,94,51,90,0.567,29,52,0.558,22,38,0.579,18,23,0.783,142
1975,NOP,2019-11-16,94,@,MIA,0,240,37,82,0.451,21,47,0.447,16,35,0.457,4,6,0.667,94,44,81,0.543,35,57,0.614,9,24,0.375,12,13,0.923,109
1976,GSW,2019-11-13,94,@,LAL,0,240,36,89,0.404,27,54,0.5,9,35,0.257,13,17,0.765,94,48,89,0.539,39,69,0.565,9,20,0.45,15,18,0.833,120
1977,CHI,2019-11-09,94,,HOU,0,240,37,98,0.378,33,66,0.5,4,32,0.125,16,18,0.889,94,39,83,0.47,20,39,0.513,19,44,0.432,20,28,0.714,117
1978,ORL,2019-11-05,94,@,OKC,0,240,32,82,0.39,29,60,0.483,3,22,0.136,27,31,0.871,94,37,86,0.43,25,53,0.472,12,33,0.364,16,20,0.8,102
1979,UTA,2019-11-03,94,@,LAC,0,240,31,78,0.397,21,47,0.447,10,31,0.323,22,31,0.71,94,36,92,0.391,29,60,0.483,7,32,0.219,26,34,0.765,105
1980,IND,2019-10-28,94,@,DET,0,240,39,94,0.415,33,73,0.452,6,21,0.286,10,13,0.769,94,37,81,0.457,24,57,0.421,13,24,0.542,9,10,0.9,96
1981,SAC,2019-10-28,94,,DEN,0,240,36,91,0.396,24,54,0.444,12,37,0.324,10,16,0.625,94,36,98,0.367,26,62,0.419,10,36,0.278,19,21,0.905,101
1982,ORL,2019-10-23,94,,CLE,1,240,37,86,0.43,28,56,0.5,9,30,0.3,11,19,0.579,94,33,88,0.375,24,54,0.444,9,34,0.265,10,15,0.667,85
1983,MIL,2020-03-01,93,@,CHO,1,240,35,87,0.402,28,56,0.5,7,31,0.226,16,21,0.762,93,34,96,0.354,26,61,0.426,8,35,0.229,9,10,0.9,85
1984,CHI,2020-02-20,93,,CHO,0,240,37,87,0.425,30,56,0.536,7,31,0.226,12,19,0.632,93,35,74,0.473,27,46,0.587,8,28,0.286,25,29,0.862,103
1985,POR,2020-01-01,93,@,NYK,0,240,37,94,0.394,27,62,0.435,10,32,0.313,9,15,0.6,93,47,98,0.48,33,62,0.532,14,36,0.389,9,14,0.643,117
1986,ORL,2019-12-30,93,,ATL,0,240,37,89,0.416,32,64,0.5,5,25,0.2,14,24,0.583,93,39,81,0.481,30,52,0.577,9,29,0.31,14,17,0.824,101
1987,CHO,2019-12-22,93,@,BOS,0,240,33,82,0.402,23,48,0.479,10,34,0.294,17,23,0.739,93,46,88,0.523,32,56,0.571,14,32,0.438,13,16,0.813,119
1988,DET,2019-12-20,93,@,BOS,0,240,34,85,0.4,23,54,0.426,11,31,0.355,14,19,0.737,93,45,86,0.523,36,59,0.61,9,27,0.333,15,21,0.714,114
1989,OKC,2019-12-11,93,@,SAC,0,240,34,79,0.43,21,46,0.457,13,33,0.394,12,18,0.667,93,39,88,0.443,29,57,0.509,10,31,0.323,6,10,0.6,94
1990,TOR,2019-12-09,93,@,CHI,1,240,34,90,0.378,27,61,0.443,7,29,0.241,18,26,0.692,93,35,89,0.393,23,43,0.535,12,46,0.261,10,14,0.714,92
1991,ORL,2019-12-06,93,@,CLE,1,240,32,82,0.39,23,56,0.411,9,26,0.346,20,23,0.87,93,35,83,0.422,25,49,0.51,10,34,0.294,7,10,0.7,87
1992,MIA,2019-12-04,93,@,BOS,0,240,34,77,0.442,20,39,0.513,14,38,0.368,11,17,0.647,93,35,79,0.443,19,38,0.5,16,41,0.39,26,32,0.813,112
1993,BRK,2019-11-14,93,@,DEN,0,240,36,95,0.379,28,57,0.491,8,38,0.211,13,16,0.813,93,43,101,0.426,33,68,0.485,10,33,0.303,5,10,0.5,101
1994,LAC,2019-11-13,93,@,HOU,0,240,38,98,0.388,28,65,0.431,10,33,0.303,7,14,0.5,93,33,86,0.384,19,44,0.432,14,42,0.333,22,27,0.815,102
1995,ATL,2019-11-06,93,,CHI,0,240,30,74,0.405,24,44,0.545,6,30,0.2,27,35,0.771,93,41,82,0.5,28,49,0.571,13,33,0.394,18,27,0.667,113
1996,CHO,2019-11-02,93,@,GSW,1,240,36,85,0.424,31,56,0.554,5,29,0.172,16,23,0.696,93,34,77,0.442,25,49,0.51,9,28,0.321,10,13,0.769,87
1997,BOS,2019-10-23,93,@,PHI,0,240,33,90,0.367,26,64,0.406,7,26,0.269,20,34,0.588,93,37,85,0.435,30,56,0.536,7,29,0.241,26,36,0.722,107
1998,MIA,2020-08-14,92,@,IND,0,240,31,87,0.356,21,49,0.429,10,38,0.263,20,27,0.741,92,43,89,0.483,28,51,0.549,15,38,0.395,8,11,0.727,109
1999,IND,2020-08-10,92,@,MIA,0,240,33,84,0.393,23,49,0.469,10,35,0.286,16,25,0.64,92,44,98,0.449,31,58,0.534,13,40,0.325,13,19,0.684,114
2000,OKC,2020-08-07,92,@,MEM,0,240,34,97,0.351,21,54,0.389,13,43,0.302,11,15,0.733,92,46,83,0.554,35,52,0.673,11,31,0.355,18,20,0.9,121
2001,LAL,2020-08-01,92,@,TOR,0,240,29,82,0.354,19,42,0.452,10,40,0.25,24,33,0.727,92,35,84,0.417,21,50,0.42,14,34,0.412,23,26,0.885,107
2002,UTA,2020-03-09,92,,TOR,0,240,33,83,0.398,17,40,0.425,16,43,0.372,10,14,0.714,92,36,83,0.434,23,47,0.489,13,36,0.361,16,18,0.889,101
2003,PHO,2020-02-26,92,,LAC,0,240,34,87,0.391,25,53,0.472,9,34,0.265,15,18,0.833,92,37,84,0.44,23,46,0.5,14,38,0.368,14,15,0.933,102
2004,CLE,2020-02-09,92,,LAC,0,240,35,95,0.368,28,62,0.452,7,33,0.212,15,22,0.682,92,53,93,0.57,41,57,0.719,12,36,0.333,15,20,0.75,133
2005,DET,2020-02-08,92,,NYK,0,240,34,69,0.493,21,40,0.525,13,29,0.448,11,16,0.688,92,38,85,0.447,30,63,0.476,8,22,0.364,11,17,0.647,95
2006,NYK,2020-02-01,92,@,IND,1,240,34,82,0.415,27,56,0.482,7,26,0.269,17,23,0.739,92,32,76,0.421,24,52,0.462,8,24,0.333,13,21,0.619,85
2007,DET,2020-01-31,92,,TOR,0,240,28,79,0.354,17,43,0.395,11,36,0.306,25,34,0.735,92,44,85,0.518,35,58,0.603,9,27,0.333,8,11,0.727,105
2008,NYK,2020-01-28,92,@,CHO,0,240,38,86,0.442,29,54,0.537,9,32,0.281,7,11,0.636,92,34,88,0.386,26,56,0.464,8,32,0.25,21,27,0.778,97
2009,ORL,2020-01-27,92,@,MIA,0,240,33,89,0.371,22,52,0.423,11,37,0.297,15,19,0.789,92,42,79,0.532,28,51,0.549,14,28,0.5,15,16,0.938,113
2010,NYK,2020-01-22,92,,LAL,0,240,36,88,0.409,25,54,0.463,11,34,0.324,9,13,0.692,92,36,82,0.439,27,55,0.491,9,27,0.333,19,28,0.679,100
2011,CHO,2020-01-12,92,@,PHO,0,240,36,86,0.419,28,51,0.549,8,35,0.229,12,18,0.667,92,41,82,0.5,34,61,0.557,7,21,0.333,11,18,0.611,100
2012,CHO,2020-01-10,92,@,UTA,0,240,35,75,0.467,27,49,0.551,8,26,0.308,14,19,0.737,92,40,79,0.506,22,37,0.595,18,42,0.429,11,14,0.786,109
2013,HOU,2020-01-09,92,@,OKC,0,240,34,89,0.382,23,49,0.469,11,40,0.275,13,14,0.929,92,43,87,0.494,32,55,0.582,11,32,0.344,16,20,0.8,113
2014,CHO,2019-12-31,92,,BOS,0,240,34,86,0.395,22,52,0.423,12,34,0.353,12,16,0.75,92,44,97,0.454,30,59,0.508,14,38,0.368,7,10,0.7,109
2015,TOR,2019-12-11,92,,LAC,0,240,31,88,0.352,23,52,0.442,8,36,0.222,22,25,0.88,92,38,86,0.442,26,46,0.565,12,40,0.3,24,27,0.889,112
2016,DEN,2019-12-10,92,@,PHI,0,240,37,85,0.435,30,58,0.517,7,27,0.259,11,12,0.917,92,37,89,0.416,25,53,0.472,12,36,0.333,11,16,0.688,97
2017,CHI,2019-12-09,92,,TOR,0,240,35,89,0.393,23,43,0.535,12,46,0.261,10,14,0.714,92,34,90,0.378,27,61,0.443,7,29,0.241,18,26,0.692,93
2018,NYK,2019-12-05,92,,DEN,0,240,34,83,0.41,25,49,0.51,9,34,0.265,15,23,0.652,92,49,87,0.563,28,48,0.583,21,39,0.538,10,18,0.556,129
2019,BOS,2019-11-22,92,@,DEN,0,240,33,81,0.407,26,54,0.481,7,27,0.259,19,23,0.826,92,39,88,0.443,32,60,0.533,7,28,0.25,11,13,0.846,96
2020,NYK,2019-11-03,92,,SAC,0,240,32,80,0.4,24,49,0.49,8,31,0.258,20,31,0.645,92,41,85,0.482,26,46,0.565,15,39,0.385,16,25,0.64,113
2021,GSW,2019-10-27,92,@,OKC,0,240,30,92,0.326,25,59,0.424,5,33,0.152,27,31,0.871,92,44,78,0.564,29,46,0.63,15,32,0.469,17,22,0.773,120
2022,MIN,2020-03-01,91,,DAL,0,240,36,99,0.364,23,57,0.404,13,42,0.31,6,15,0.4,91,44,94,0.468,33,54,0.611,11,40,0.275,12,19,0.632,111
2023,TOR,2020-02-12,91,@,BRK,0,240,34,90,0.378,21,47,0.447,13,43,0.302,10,13,0.769,91,36,88,0.409,27,53,0.509,9,35,0.257,20,25,0.8,101
2024,HOU,2020-02-07,91,@,PHO,0,240,29,85,0.341,18,37,0.486,11,48,0.229,22,26,0.846,91,43,77,0.558,28,46,0.609,15,31,0.484,26,27,0.963,127
2025,LAL,2020-01-25,91,@,PHI,0,240,35,76,0.461,29,45,0.644,6,31,0.194,15,23,0.652,91,41,78,0.526,28,41,0.683,13,37,0.351,13,19,0.684,108
2026,PHI,2020-01-11,91,@,DAL,0,240,37,98,0.378,28,61,0.459,9,37,0.243,8,12,0.667,91,40,79,0.506,29,52,0.558,11,27,0.407,18,27,0.667,109
2027,LAC,2019-12-06,91,@,MIL,0,240,33,94,0.351,25,62,0.403,8,32,0.25,17,19,0.895,91,44,94,0.468,30,58,0.517,14,36,0.389,17,21,0.81,119
2028,GSW,2019-12-04,91,@,CHO,0,240,36,78,0.462,27,55,0.491,9,23,0.391,10,15,0.667,91,40,87,0.46,19,39,0.487,21,48,0.438,5,8,0.625,106
2029,SAC,2019-11-27,91,@,PHI,0,240,39,95,0.411,30,61,0.492,9,34,0.265,4,9,0.444,91,36,77,0.468,31,51,0.608,5,26,0.192,20,24,0.833,97
2030,CHO,2019-11-20,91,@,BRK,0,240,30,81,0.37,19,48,0.396,11,33,0.333,20,26,0.769,91,36,90,0.4,26,51,0.51,10,39,0.256,19,23,0.826,101
2031,DEN,2019-11-02,91,@,ORL,1,240,27,73,0.37,18,45,0.4,9,28,0.321,28,39,0.718,91,37,86,0.43,31,57,0.544,6,29,0.207,7,11,0.636,87
2032,ORL,2019-11-01,91,,MIL,0,240,34,91,0.374,22,54,0.407,12,37,0.324,11,17,0.647,91,47,93,0.505,30,46,0.652,17,47,0.362,12,18,0.667,123
2033,MEM,2019-10-29,91,@,LAL,0,240,31,95,0.326,24,61,0.393,7,34,0.206,22,23,0.957,91,40,86,0.465,33,60,0.55,7,26,0.269,33,39,0.846,120
2034,BOS,2020-08-13,90,,WAS,0,240,35,88,0.398,27,53,0.509,8,35,0.229,12,14,0.857,90,34,88,0.386,24,62,0.387,10,26,0.385,18,24,0.75,96
2035,CHO,2020-02-01,90,@,SAS,0,240,35,83,0.422,25,47,0.532,10,36,0.278,10,12,0.833,90,45,87,0.517,35,59,0.593,10,28,0.357,14,21,0.667,114
2036,PHI,2020-01-18,90,@,NYK,1,240,34,78,0.436,24,46,0.522,10,32,0.313,12,19,0.632,90,35,88,0.398,29,63,0.46,6,25,0.24,11,18,0.611,87
2037,UTA,2019-12-09,90,,OKC,0,240,36,89,0.404,28,58,0.483,8,31,0.258,10,12,0.833,90,40,85,0.471,32,57,0.561,8,28,0.286,16,19,0.842,104
2038,TOR,2019-11-29,90,@,ORL,1,240,31,84,0.369,20,46,0.435,11,38,0.289,17,28,0.607,90,27,78,0.346,20,49,0.408,7,29,0.241,22,27,0.815,83
2039,CHI,2019-11-27,90,@,GSW,0,240,34,89,0.382,24,60,0.4,10,29,0.345,12,18,0.667,90,37,81,0.457,26,52,0.5,11,29,0.379,19,26,0.731,104
2040,DET,2019-11-23,90,@,MIL,0,240,37,91,0.407,27,56,0.482,10,35,0.286,6,10,0.6,90,41,84,0.488,28,47,0.596,13,37,0.351,9,18,0.5,104
2041,LAC,2019-11-18,90,,OKC,1,240,35,87,0.402,25,51,0.49,10,36,0.278,10,14,0.714,90,28,75,0.373,21,48,0.438,7,27,0.259,25,28,0.893,88
2042,WAS,2020-03-08,89,,MIA,0,240,26,78,0.333,7,31,0.226,19,47,0.404,18,21,0.857,89,32,66,0.485,19,38,0.5,13,28,0.464,23,28,0.821,100
2043,MIL,2020-03-02,89,@,MIA,0,240,35,86,0.407,28,52,0.538,7,34,0.206,12,19,0.632,89,37,86,0.43,19,49,0.388,18,37,0.486,13,18,0.722,105
2044,ORL,2020-02-01,89,,MIA,0,240,33,83,0.398,24,50,0.48,9,33,0.273,14,17,0.824,89,33,77,0.429,18,44,0.409,15,33,0.455,21,26,0.808,102
2045,CHI,2020-01-17,89,@,PHI,0,240,35,81,0.432,27,46,0.587,8,35,0.229,11,15,0.733,89,40,82,0.488,31,53,0.585,9,29,0.31,11,11,1.0,100
2046,WAS,2020-01-08,89,@,ORL,0,240,36,84,0.429,30,61,0.492,6,23,0.261,11,19,0.579,89,43,87,0.494,33,60,0.55,10,27,0.37,27,34,0.794,123
2047,BRK,2020-01-06,89,@,ORL,0,240,32,96,0.333,22,49,0.449,10,47,0.213,15,19,0.789,89,35,81,0.432,27,55,0.491,8,26,0.308,23,31,0.742,101
2048,IND,2019-12-22,89,@,MIL,0,240,37,100,0.37,25,60,0.417,12,40,0.3,3,5,0.6,89,44,104,0.423,29,60,0.483,15,44,0.341,14,17,0.824,117
2049,PHI,2019-12-15,89,@,BRK,0,240,37,86,0.43,32,60,0.533,5,26,0.192,10,17,0.588,89,43,94,0.457,34,70,0.486,9,24,0.375,14,18,0.778,109
2050,DET,2019-11-20,89,@,CHI,0,240,28,83,0.337,20,50,0.4,8,33,0.242,25,32,0.781,89,39,91,0.429,25,64,0.391,14,27,0.519,17,26,0.654,109
2051,MIA,2019-11-05,89,@,DEN,0,240,32,88,0.364,23,59,0.39,9,29,0.31,16,25,0.64,89,45,86,0.523,36,63,0.571,9,23,0.391,10,16,0.625,109
2052,ATL,2020-03-02,88,,MEM,0,240,32,99,0.323,23,64,0.359,9,35,0.257,15,16,0.938,88,46,92,0.5,32,60,0.533,14,32,0.438,21,31,0.677,127
2053,LAL,2020-02-29,88,@,MEM,0,240,36,87,0.414,27,52,0.519,9,35,0.257,7,12,0.583,88,43,95,0.453,33,64,0.516,10,31,0.323,9,11,0.818,105
2054,GSW,2020-02-05,88,@,BRK,0,240,35,96,0.365,30,57,0.526,5,39,0.128,13,18,0.722,88,51,100,0.51,37,66,0.561,14,34,0.412,13,15,0.867,129
2055,IND,2020-01-20,88,@,UTA,0,240,39,93,0.419,32,67,0.478,7,26,0.269,3,7,0.429,88,47,87,0.54,35,56,0.625,12,31,0.387,12,12,1.0,118
2056,MIN,2019-12-28,88,,CLE,0,240,33,93,0.355,25,56,0.446,8,37,0.216,14,19,0.737,88,32,77,0.416,28,57,0.491,4,20,0.2,26,36,0.722,94
2057,CLE,2019-12-09,88,@,BOS,0,240,36,91,0.396,29,60,0.483,7,31,0.226,9,19,0.474,88,45,78,0.577,30,51,0.588,15,27,0.556,5,8,0.625,110
2058,NYK,2019-12-02,88,@,MIL,0,240,28,91,0.308,18,52,0.346,10,39,0.256,22,33,0.667,88,48,86,0.558,32,51,0.627,16,35,0.457,20,32,0.625,132
2059,ORL,2019-11-25,88,@,DET,0,240,32,84,0.381,24,59,0.407,8,25,0.32,16,22,0.727,88,34,79,0.43,20,41,0.488,14,38,0.368,21,25,0.84,103
2060,OKC,2019-11-18,88,@,LAC,0,240,28,75,0.373,21,48,0.438,7,27,0.259,25,28,0.893,88,35,87,0.402,25,51,0.49,10,36,0.278,10,14,0.714,90
2061,TOR,2019-11-11,88,@,LAC,0,240,34,85,0.4,23,55,0.418,11,30,0.367,9,15,0.6,88,34,92,0.37,26,56,0.464,8,36,0.222,22,30,0.733,98
2062,CHO,2020-02-10,87,@,DET,1,240,33,88,0.375,24,52,0.462,9,36,0.25,12,14,0.857,87,29,82,0.354,22,47,0.468,7,35,0.2,11,13,0.846,76
2063,PHO,2020-01-22,87,,IND,0,240,30,84,0.357,26,64,0.406,4,20,0.2,23,26,0.885,87,45,84,0.536,36,64,0.563,9,20,0.45,13,20,0.65,112
2064,NYK,2020-01-18,87,,PHI,0,240,35,88,0.398,29,63,0.46,6,25,0.24,11,18,0.611,87,34,78,0.436,24,46,0.522,10,32,0.313,12,19,0.632,90
2065,NYK,2020-01-07,87,@,LAL,0,240,37,95,0.389,33,75,0.44,4,20,0.2,9,16,0.563,87,41,82,0.5,24,46,0.522,17,36,0.472,18,21,0.857,117
2066,SAC,2019-12-31,87,,LAC,0,240,33,80,0.413,25,52,0.481,8,28,0.286,13,19,0.684,87,36,88,0.409,24,52,0.462,12,36,0.333,21,22,0.955,105
2067,ORL,2019-12-11,87,,LAL,0,240,34,81,0.42,26,55,0.473,8,26,0.308,11,17,0.647,87,37,87,0.425,25,56,0.446,12,31,0.387,10,19,0.526,96
2068,NYK,2019-12-10,87,@,POR,0,240,32,91,0.352,25,53,0.472,7,38,0.184,16,26,0.615,87,39,90,0.433,22,49,0.449,17,41,0.415,20,24,0.833,115
2069,CLE,2019-12-06,87,,ORL,0,240,35,83,0.422,25,49,0.51,10,34,0.294,7,10,0.7,87,32,82,0.39,23,56,0.411,9,26,0.346,20,23,0.87,93
2070,NYK,2019-11-10,87,,CLE,0,240,31,86,0.36,22,55,0.4,9,31,0.29,16,25,0.64,87,36,82,0.439,28,54,0.519,8,28,0.286,28,31,0.903,108
2071,CHO,2019-11-07,87,,BOS,0,240,33,86,0.384,27,55,0.491,6,31,0.194,15,21,0.714,87,40,93,0.43,30,60,0.5,10,33,0.303,18,23,0.783,108
2072,ORL,2019-11-02,87,,DEN,0,240,37,86,0.43,31,57,0.544,6,29,0.207,7,11,0.636,87,27,73,0.37,18,45,0.4,9,28,0.321,28,39,0.718,91
2073,GSW,2019-11-02,87,,CHO,0,240,34,77,0.442,25,49,0.51,9,28,0.321,10,13,0.769,87,36,85,0.424,31,56,0.554,5,29,0.172,16,23,0.696,93
2074,LAL,2020-08-05,86,,OKC,0,240,31,88,0.352,26,51,0.51,5,37,0.135,19,29,0.655,86,34,79,0.43,29,55,0.527,5,24,0.208,32,36,0.889,105
2075,OKC,2020-02-28,86,@,MIL,0,240,33,91,0.363,27,56,0.482,6,35,0.171,14,20,0.7,86,50,100,0.5,29,55,0.527,21,45,0.467,12,14,0.857,133
2076,GSW,2020-02-27,86,,LAL,0,240,34,80,0.425,25,48,0.521,9,32,0.281,9,10,0.9,86,45,88,0.511,37,64,0.578,8,24,0.333,18,27,0.667,116
2077,CHO,2020-02-22,86,,BRK,0,240,31,88,0.352,19,53,0.358,12,35,0.343,12,21,0.571,86,42,87,0.483,25,40,0.625,17,47,0.362,14,19,0.737,115
2078,CLE,2020-01-20,86,,NYK,0,240,32,94,0.34,21,61,0.344,11,33,0.333,11,17,0.647,86,41,85,0.482,32,62,0.516,9,23,0.391,15,17,0.882,106
2079,CHO,2020-01-15,86,@,DEN,0,240,33,81,0.407,21,46,0.457,12,35,0.343,8,14,0.571,86,38,79,0.481,29,51,0.569,9,28,0.321,15,25,0.6,100
2080,ATL,2020-01-12,86,@,BRK,0,240,32,97,0.33,20,49,0.408,12,48,0.25,10,11,0.909,86,41,77,0.532,31,51,0.608,10,26,0.385,16,29,0.552,108
2081,ATL,2019-12-27,86,,MIL,0,240,33,91,0.363,21,50,0.42,12,41,0.293,8,14,0.571,86,46,91,0.505,35,63,0.556,11,28,0.393,9,13,0.692,112
2082,MIA,2019-11-23,86,@,PHI,0,240,30,75,0.4,24,51,0.471,6,24,0.25,20,27,0.741,86,42,83,0.506,28,54,0.519,14,29,0.483,15,17,0.882,113
2083,BRK,2019-11-18,86,,IND,0,240,30,84,0.357,19,50,0.38,11,34,0.324,15,24,0.625,86,44,101,0.436,30,68,0.441,14,33,0.424,13,17,0.765,115
2084,MEM,2019-11-08,86,@,ORL,0,240,32,86,0.372,21,57,0.368,11,29,0.379,11,13,0.846,86,44,93,0.473,37,65,0.569,7,28,0.25,23,27,0.852,118
2085,UTA,2019-10-25,86,@,LAL,0,240,29,70,0.414,21,45,0.467,8,25,0.32,20,21,0.952,86,34,86,0.395,26,60,0.433,8,26,0.308,19,24,0.792,95
2086,CHO,2020-03-01,85,,MIL,0,240,34,96,0.354,26,61,0.426,8,35,0.229,9,10,0.9,85,35,87,0.402,28,56,0.5,7,31,0.226,16,21,0.762,93
2087,IND,2020-02-01,85,,NYK,0,240,32,76,0.421,24,52,0.462,8,24,0.333,13,21,0.619,85,34,82,0.415,27,56,0.482,7,26,0.269,17,23,0.739,92
2088,MIA,2020-01-03,85,@,ORL,0,240,30,80,0.375,23,43,0.535,7,37,0.189,18,23,0.783,85,33,81,0.407,20,46,0.435,13,35,0.371,26,29,0.897,105
2089,CHO,2019-12-15,85,@,IND,0,240,28,91,0.308,23,59,0.39,5,32,0.156,24,35,0.686,85,40,88,0.455,30,53,0.566,10,35,0.286,17,20,0.85,107
2090,PHO,2019-11-18,85,,BOS,0,240,33,82,0.402,23,46,0.5,10,36,0.278,9,12,0.75,85,37,89,0.416,25,48,0.521,12,41,0.293,13,17,0.765,99
2091,OKC,2019-11-12,85,@,IND,0,240,29,82,0.354,23,57,0.404,6,25,0.24,21,24,0.875,85,46,94,0.489,39,71,0.549,7,23,0.304,12,13,0.923,111
2092,OKC,2019-10-25,85,,WAS,0,240,33,83,0.398,28,60,0.467,5,23,0.217,14,22,0.636,85,39,97,0.402,28,56,0.5,11,41,0.268,8,10,0.8,97
2093,CLE,2019-10-23,85,@,ORL,0,240,33,88,0.375,24,54,0.444,9,34,0.265,10,15,0.667,85,37,86,0.43,28,56,0.5,9,30,0.3,11,19,0.579,94
2094,DET,2020-03-08,84,@,NYK,0,240,29,80,0.363,18,42,0.429,11,38,0.289,15,22,0.682,84,36,82,0.439,30,63,0.476,6,19,0.316,18,25,0.72,96
2095,MIA,2020-01-02,84,,TOR,1,240,33,81,0.407,21,44,0.477,12,37,0.324,6,11,0.545,84,28,89,0.315,22,47,0.468,6,42,0.143,14,17,0.824,76
2096,GSW,2020-01-02,84,@,MIN,0,240,33,77,0.429,30,57,0.526,3,20,0.15,15,21,0.714,84,38,95,0.4,25,52,0.481,13,43,0.302,10,17,0.588,99
2097,NOP,2019-12-07,84,@,DAL,0,240,32,89,0.36,29,57,0.509,3,32,0.094,17,21,0.81,84,46,86,0.535,33,48,0.688,13,38,0.342,25,31,0.806,130
2098,CHI,2019-10-26,84,,TOR,0,240,29,97,0.299,20,62,0.323,9,35,0.257,17,25,0.68,84,38,82,0.463,23,40,0.575,15,42,0.357,17,18,0.944,108
2099,CHO,2020-01-20,83,,ORL,0,240,29,76,0.382,19,43,0.442,10,33,0.303,15,20,0.75,83,44,92,0.478,30,64,0.469,14,28,0.5,4,9,0.444,106
2100,CHO,2019-12-13,83,@,CHI,1,240,30,79,0.38,24,48,0.5,6,31,0.194,17,21,0.81,83,27,90,0.3,20,56,0.357,7,34,0.206,12,14,0.857,73
2101,ORL,2019-11-29,83,,TOR,0,240,27,78,0.346,20,49,0.408,7,29,0.241,22,27,0.815,83,31,84,0.369,20,46,0.435,11,38,0.289,17,28,0.607,90
2102,IND,2019-11-16,83,,MIL,0,240,32,100,0.32,20,66,0.303,12,34,0.353,7,9,0.778,83,43,96,0.448,32,57,0.561,11,39,0.282,5,7,0.714,102
2103,NYK,2019-10-30,83,@,ORL,0,240,31,82,0.378,24,51,0.471,7,31,0.226,14,20,0.7,83,37,88,0.42,25,56,0.446,12,32,0.375,9,12,0.75,95
2104,DET,2020-02-03,82,@,MEM,0,240,34,98,0.347,26,72,0.361,8,26,0.308,6,9,0.667,82,42,90,0.467,40,73,0.548,2,17,0.118,10,12,0.833,96
2105,BRK,2019-12-26,82,,NYK,0,240,21,78,0.269,8,28,0.286,13,50,0.26,27,36,0.75,82,37,92,0.402,28,63,0.444,9,29,0.31,11,15,0.733,94
2106,IND,2020-02-23,81,@,TOR,0,240,31,95,0.326,23,62,0.371,8,33,0.242,11,17,0.647,81,47,92,0.511,30,48,0.625,17,44,0.386,16,18,0.889,127
2107,CHI,2020-01-24,81,,SAC,0,240,31,79,0.392,23,42,0.548,8,37,0.216,11,14,0.786,81,35,81,0.432,25,49,0.51,10,32,0.313,18,21,0.857,98
2108,DET,2019-12-30,81,@,UTA,0,240,30,79,0.38,26,65,0.4,4,14,0.286,17,23,0.739,81,39,83,0.47,29,57,0.509,10,26,0.385,16,20,0.8,104
2109,ATL,2019-12-28,81,@,CHI,0,240,32,86,0.372,23,52,0.442,9,34,0.265,8,11,0.727,81,43,87,0.494,28,56,0.5,15,31,0.484,15,19,0.789,116
2110,SAC,2019-10-26,81,@,UTA,0,240,30,81,0.37,23,55,0.418,7,26,0.269,14,17,0.824,81,44,78,0.564,26,41,0.634,18,37,0.486,7,12,0.583,113
2111,CHO,2020-02-25,80,@,IND,0,240,31,93,0.333,21,60,0.35,10,33,0.303,8,18,0.444,80,49,86,0.57,39,63,0.619,10,23,0.435,11,13,0.846,119
2112,MIA,2019-11-08,80,@,LAL,0,240,28,80,0.35,22,45,0.489,6,35,0.171,18,24,0.75,80,40,89,0.449,32,57,0.561,8,32,0.25,7,8,0.875,95
2113,BRK,2020-03-04,79,,MEM,0,240,30,90,0.333,23,48,0.479,7,42,0.167,12,17,0.706,79,43,100,0.43,23,56,0.411,20,44,0.455,12,14,0.857,118
2114,GSW,2019-12-15,79,,SAC,0,240,30,76,0.395,24,51,0.471,6,25,0.24,13,18,0.722,79,38,63,0.603,28,41,0.683,10,22,0.455,14,16,0.875,100
2115,GSW,2019-12-02,79,@,ATL,0,240,33,83,0.398,30,66,0.455,3,17,0.176,10,12,0.833,79,41,89,0.461,33,60,0.55,8,29,0.276,14,15,0.933,104
2116,DET,2020-02-10,76,,CHO,0,240,29,82,0.354,22,47,0.468,7,35,0.2,11,13,0.846,76,33,88,0.375,24,52,0.462,9,36,0.25,12,14,0.857,87
2117,TOR,2020-01-02,76,@,MIA,0,240,28,89,0.315,22,47,0.468,6,42,0.143,14,17,0.824,76,33,81,0.407,21,44,0.477,12,37,0.324,6,11,0.545,84
2118,CHI,2019-12-13,73,,CHO,0,240,27,90,0.3,20,56,0.357,7,34,0.206,12,14,0.857,73,30,79,0.38,24,48,0.5,6,31,0.194,17,21,0.81,83
