Rk,Team,Date,PTS,Unnamed: 4,Opp,Result,MP,FG,FGA,FG%,2P,2PA,2P%,3P,3PA,3P%,FT,FTA,FT%,PTS.1,FG.1,FGA.1,FG%.1,2P.1,2PA.1,2P%.1,3P.1,3PA.1,3P%.1,FT.1,FTA.1,FT%.1,PTS.2
1,MIA,2018-03-19,149,,DEN,1,290,56,102,0.549,36,66,0.545,20,36,0.556,17,27,0.63,149,46,100,0.46,28,62,0.452,18,38,0.474,31,37,0.838,141
2,OKC,2018-01-20,148,@,CLE,1,240,58,100,0.58,44,70,0.629,14,30,0.467,18,28,0.643,148,46,89,0.517,36,52,0.692,10,37,0.27,22,27,0.815,124
3,HOU,2017-12-31,148,,LAL,1,290,49,106,0.462,31,54,0.574,18,52,0.346,32,39,0.821,148,53,105,0.505,43,80,0.538,10,25,0.4,26,37,0.703,142
4,DEN,2017-11-17,146,,NOP,1,240,56,89,0.629,38,54,0.704,18,35,0.514,16,21,0.762,146,48,91,0.527,36,58,0.621,12,33,0.364,6,10,0.6,114
5,GSW,2017-11-24,143,,CHI,1,240,53,91,0.582,37,55,0.673,16,36,0.444,21,21,1.0,143,35,99,0.354,22,63,0.349,13,36,0.361,11,15,0.733,94
6,LAL,2017-12-31,142,@,HOU,0,290,53,105,0.505,43,80,0.538,10,25,0.4,26,37,0.703,142,49,106,0.462,31,54,0.574,18,52,0.346,32,39,0.821,148
7,HOU,2017-11-16,142,@,PHO,1,240,43,90,0.478,22,46,0.478,21,44,0.477,35,38,0.921,142,47,104,0.452,37,74,0.5,10,30,0.333,12,21,0.571,116
8,DEN,2018-03-19,141,@,MIA,0,290,46,100,0.46,28,62,0.452,18,38,0.474,31,37,0.838,141,56,102,0.549,36,66,0.545,20,36,0.556,17,27,0.63,149
9,GSW,2017-12-30,141,,MEM,1,240,50,85,0.588,32,52,0.615,18,33,0.545,23,25,0.92,141,49,94,0.521,34,73,0.466,15,21,0.714,15,22,0.682,128
10,GSW,2017-10-30,141,@,LAC,1,240,52,89,0.584,38,60,0.633,14,29,0.483,23,30,0.767,141,39,86,0.453,29,61,0.475,10,25,0.4,25,30,0.833,113
11,CHO,2018-03-22,140,,MEM,1,240,49,92,0.533,30,52,0.577,19,40,0.475,23,27,0.852,140,30,78,0.385,26,60,0.433,4,18,0.222,15,21,0.714,79
12,CLE,2018-02-07,140,,MIN,1,265,52,88,0.591,31,47,0.66,21,41,0.512,15,23,0.652,140,54,93,0.581,35,60,0.583,19,33,0.576,11,12,0.917,138
13,IND,2017-10-18,140,,BRK,1,240,53,102,0.52,44,68,0.647,9,34,0.265,25,32,0.781,140,45,94,0.479,33,64,0.516,12,30,0.4,29,32,0.906,131
14,NOP,2018-02-14,139,,LAL,1,240,53,99,0.535,39,67,0.582,14,32,0.438,19,21,0.905,139,46,90,0.511,36,68,0.529,10,22,0.455,15,18,0.833,117
15,NOP,2018-02-10,138,@,BRK,1,290,52,106,0.491,43,82,0.524,9,24,0.375,25,39,0.641,138,43,114,0.377,22,55,0.4,21,59,0.356,21,22,0.955,128
16,MIN,2018-02-07,138,@,CLE,0,265,54,93,0.581,35,60,0.583,19,33,0.576,11,12,0.917,138,52,88,0.591,31,47,0.66,21,41,0.512,15,23,0.652,140
17,OKC,2018-04-11,137,,MEM,1,240,47,85,0.553,27,42,0.643,20,43,0.465,23,32,0.719,137,44,91,0.484,31,60,0.517,13,31,0.419,22,24,0.917,123
18,CHO,2018-04-06,137,@,ORL,1,240,48,86,0.558,31,55,0.564,17,31,0.548,24,26,0.923,137,42,94,0.447,33,71,0.465,9,23,0.391,7,13,0.538,100
19,CHO,2018-03-26,137,,NYK,1,265,51,93,0.548,40,65,0.615,11,28,0.393,24,28,0.857,137,54,105,0.514,45,75,0.6,9,30,0.3,11,11,1.0,128
20,HOU,2017-11-05,137,,UTA,1,240,48,81,0.593,25,42,0.595,23,39,0.59,18,21,0.857,137,38,88,0.432,25,54,0.463,13,34,0.382,21,24,0.875,110
21,DEN,2018-03-21,135,@,CHI,1,240,51,83,0.614,31,48,0.646,20,35,0.571,13,16,0.813,135,39,89,0.438,26,51,0.51,13,38,0.342,11,14,0.786,102
22,GSW,2017-11-11,135,,PHI,1,240,48,82,0.585,34,55,0.618,14,27,0.519,25,26,0.962,135,44,94,0.468,32,66,0.485,12,28,0.429,14,20,0.7,114
23,DEN,2018-04-07,134,@,LAC,1,240,53,85,0.624,41,56,0.732,12,29,0.414,16,23,0.696,134,43,87,0.494,37,70,0.529,6,17,0.353,23,34,0.676,115
24,BOS,2018-02-28,134,,CHO,1,240,54,87,0.621,42,67,0.627,12,20,0.6,14,15,0.933,134,42,91,0.462,33,64,0.516,9,27,0.333,13,22,0.591,106
25,GSW,2018-02-22,134,,LAC,1,240,47,77,0.61,33,52,0.635,14,25,0.56,26,34,0.765,134,44,88,0.5,33,56,0.589,11,32,0.344,28,34,0.824,127
26,DEN,2018-02-15,134,@,MIL,1,240,47,85,0.553,23,45,0.511,24,40,0.6,16,20,0.8,134,49,92,0.533,40,66,0.606,9,26,0.346,16,22,0.727,123
27,DEN,2018-01-03,134,,PHO,1,240,51,82,0.622,39,55,0.709,12,27,0.444,20,22,0.909,134,39,92,0.424,26,57,0.456,13,35,0.371,20,28,0.714,111
28,UTA,2018-02-05,133,@,NOP,1,240,52,89,0.584,38,68,0.559,14,21,0.667,15,17,0.882,133,47,93,0.505,39,71,0.549,8,22,0.364,7,13,0.538,109
29,CHO,2018-02-02,133,,IND,1,240,44,83,0.53,29,50,0.58,15,33,0.455,30,34,0.882,133,44,87,0.506,32,58,0.552,12,29,0.414,26,28,0.929,126
30,CHO,2018-01-17,133,,WAS,1,240,48,98,0.49,33,67,0.493,15,31,0.484,22,26,0.846,133,40,82,0.488,27,59,0.458,13,23,0.565,16,23,0.696,109
31,TOR,2018-01-11,133,,CLE,1,240,53,106,0.5,35,64,0.547,18,42,0.429,9,13,0.692,133,34,89,0.382,28,63,0.444,6,26,0.231,25,30,0.833,99
32,OKC,2018-01-03,133,@,LAL,1,240,56,93,0.602,42,63,0.667,14,30,0.467,7,9,0.778,133,38,92,0.413,27,59,0.458,11,33,0.333,9,15,0.6,96
33,GSW,2017-12-01,133,@,ORL,1,240,55,88,0.625,43,64,0.672,12,24,0.5,11,11,1.0,133,44,96,0.458,33,68,0.485,11,28,0.393,13,18,0.722,112
34,SAS,2017-11-11,133,,CHI,1,240,51,85,0.6,33,58,0.569,18,27,0.667,13,16,0.813,133,40,86,0.465,34,63,0.54,6,23,0.261,8,13,0.615,94
35,GSW,2017-10-23,133,@,DAL,1,240,48,86,0.558,33,47,0.702,15,39,0.385,22,26,0.846,133,38,96,0.396,29,67,0.433,9,29,0.31,18,30,0.6,103
36,PHI,2018-04-06,132,,CLE,1,240,50,101,0.495,36,62,0.581,14,39,0.359,18,21,0.857,132,45,87,0.517,29,53,0.547,16,34,0.471,24,33,0.727,130
37,CLE,2018-03-21,132,,TOR,1,240,47,78,0.603,32,54,0.593,15,24,0.625,23,28,0.821,132,47,88,0.534,32,54,0.593,15,34,0.441,20,23,0.87,129
38,OKC,2018-03-18,132,@,TOR,1,240,49,88,0.557,39,67,0.582,10,21,0.476,24,34,0.706,132,46,81,0.568,31,51,0.608,15,30,0.5,18,23,0.783,125
39,TOR,2018-03-11,132,@,NYK,1,240,47,93,0.505,31,58,0.534,16,35,0.457,22,25,0.88,132,40,88,0.455,33,67,0.493,7,21,0.333,19,24,0.792,106
40,NOP,2018-01-22,132,,CHI,1,290,47,113,0.416,31,69,0.449,16,44,0.364,22,26,0.846,132,45,92,0.489,37,61,0.607,8,31,0.258,30,34,0.882,128
41,LAL,2018-01-07,132,,ATL,1,240,48,86,0.558,32,50,0.64,16,36,0.444,20,25,0.8,132,41,94,0.436,29,60,0.483,12,34,0.353,19,23,0.826,113
42,LAL,2017-10-20,132,@,PHO,1,240,48,93,0.516,36,67,0.537,12,26,0.462,24,33,0.727,132,45,92,0.489,31,63,0.492,14,29,0.483,26,38,0.684,130
43,LAL,2018-03-01,131,@,MIA,1,240,47,79,0.595,31,50,0.62,16,29,0.552,21,26,0.808,131,46,95,0.484,37,64,0.578,9,31,0.29,12,16,0.75,113
44,CLE,2018-01-06,131,@,ORL,1,240,47,94,0.5,32,60,0.533,15,34,0.441,22,31,0.71,131,49,98,0.5,35,61,0.574,14,37,0.378,15,22,0.682,127
45,CHO,2018-01-02,131,@,SAC,1,240,51,89,0.573,36,57,0.632,15,32,0.469,14,18,0.778,131,45,87,0.517,38,70,0.543,7,17,0.412,14,18,0.778,111
46,TOR,2018-01-01,131,,MIL,1,265,45,91,0.495,31,58,0.534,14,33,0.424,27,33,0.818,131,44,93,0.473,31,66,0.47,13,27,0.481,26,28,0.929,127
47,NOP,2017-12-10,131,,PHI,1,240,46,80,0.575,31,56,0.554,15,24,0.625,24,32,0.75,131,44,96,0.458,35,67,0.522,9,29,0.31,27,30,0.9,124
48,DET,2017-11-29,131,,PHO,1,240,51,89,0.573,38,61,0.623,13,28,0.464,16,21,0.762,131,39,84,0.464,32,62,0.516,7,22,0.318,22,28,0.786,107
49,BRK,2017-10-18,131,@,IND,0,240,45,94,0.479,33,64,0.516,12,30,0.4,29,32,0.906,131,53,102,0.52,44,68,0.647,9,34,0.265,25,32,0.781,140
50,PHI,2018-04-11,130,,MIL,1,240,52,105,0.495,37,69,0.536,15,36,0.417,11,15,0.733,130,37,90,0.411,30,65,0.462,7,25,0.28,14,16,0.875,95
51,MEM,2018-04-08,130,,DET,1,240,48,83,0.578,32,50,0.64,16,33,0.485,18,24,0.75,130,38,93,0.409,15,46,0.326,23,47,0.489,18,23,0.783,117
52,CLE,2018-04-06,130,@,PHI,0,240,45,87,0.517,29,53,0.547,16,34,0.471,24,33,0.727,130,50,101,0.495,36,62,0.581,14,39,0.359,18,21,0.857,132
53,DEN,2018-03-11,130,,SAC,1,240,50,89,0.562,35,52,0.673,15,37,0.405,15,21,0.714,130,39,91,0.429,33,60,0.55,6,31,0.194,20,26,0.769,104
54,DAL,2018-02-10,130,,LAL,1,240,48,89,0.539,36,62,0.581,12,27,0.444,22,27,0.815,130,46,84,0.548,30,50,0.6,16,34,0.471,15,22,0.682,123
55,HOU,2018-02-09,130,,DEN,1,240,43,86,0.5,24,45,0.533,19,41,0.463,25,34,0.735,130,42,88,0.477,39,60,0.65,3,28,0.107,17,21,0.81,104
56,TOR,2018-02-02,130,,POR,1,240,46,99,0.465,27,59,0.458,19,40,0.475,19,21,0.905,130,37,73,0.507,30,52,0.577,7,21,0.333,24,33,0.727,105
57,DEN,2018-01-25,130,,NYK,1,240,48,80,0.6,34,52,0.654,14,28,0.5,20,24,0.833,130,45,82,0.549,37,61,0.607,8,21,0.381,20,24,0.833,118
58,WAS,2017-12-23,130,,ORL,1,240,47,86,0.547,31,56,0.554,16,30,0.533,20,23,0.87,130,42,87,0.483,34,61,0.557,8,26,0.308,11,17,0.647,103
59,HOU,2017-12-11,130,,NOP,1,240,48,88,0.545,31,43,0.721,17,45,0.378,17,25,0.68,130,49,85,0.576,31,52,0.596,18,33,0.545,7,13,0.538,123
60,PHI,2017-11-25,130,,ORL,1,240,48,95,0.505,32,61,0.525,16,34,0.471,18,20,0.9,130,39,86,0.453,27,55,0.491,12,31,0.387,21,31,0.677,111
61,CLE,2017-11-03,130,@,WAS,1,240,46,82,0.561,34,55,0.618,12,27,0.444,26,28,0.929,130,45,84,0.536,34,56,0.607,11,28,0.393,21,31,0.677,122
62,IND,2017-10-24,130,@,MIN,1,240,56,84,0.667,46,62,0.742,10,22,0.455,8,11,0.727,130,42,86,0.488,33,62,0.532,9,24,0.375,14,22,0.636,107
63,LAC,2017-10-21,130,,PHO,1,240,48,88,0.545,36,62,0.581,12,26,0.462,22,30,0.733,130,27,71,0.38,21,47,0.447,6,24,0.25,28,38,0.737,88
64,PHO,2017-10-20,130,,LAL,0,240,45,92,0.489,31,63,0.492,14,29,0.483,26,38,0.684,130,48,93,0.516,36,67,0.537,12,26,0.462,24,33,0.727,132
65,TOR,2018-03-21,129,@,CLE,0,240,47,88,0.534,32,54,0.593,15,34,0.441,20,23,0.87,129,47,78,0.603,32,54,0.593,15,24,0.625,23,28,0.821,132
66,HOU,2018-03-18,129,@,MIN,1,240,43,78,0.551,27,43,0.628,16,35,0.457,27,36,0.75,129,45,86,0.523,35,66,0.53,10,20,0.5,20,26,0.769,120
67,CHO,2018-03-15,129,@,ATL,1,240,46,87,0.529,29,54,0.537,17,33,0.515,20,30,0.667,129,42,90,0.467,26,54,0.481,16,36,0.444,17,26,0.654,117
68,CLE,2018-03-13,129,@,PHO,1,240,43,87,0.494,26,52,0.5,17,35,0.486,26,30,0.867,129,38,98,0.388,32,66,0.485,6,32,0.188,25,30,0.833,107
69,CHI,2018-03-11,129,@,ATL,1,240,48,98,0.49,31,61,0.508,17,37,0.459,16,19,0.842,129,42,82,0.512,23,42,0.548,19,40,0.475,19,22,0.864,122
70,MIA,2018-03-10,129,,WAS,1,240,52,88,0.591,42,60,0.7,10,28,0.357,15,21,0.714,129,34,77,0.442,27,57,0.474,7,20,0.35,27,34,0.794,102
71,CLE,2018-02-27,129,,BRK,1,240,50,97,0.515,38,73,0.521,12,24,0.5,17,27,0.63,129,44,82,0.537,32,50,0.64,12,32,0.375,23,30,0.767,123
72,LAC,2018-02-14,129,@,BOS,1,240,44,88,0.5,33,59,0.559,11,29,0.379,30,33,0.909,129,42,97,0.433,27,66,0.409,15,31,0.484,20,21,0.952,119
73,GSW,2018-02-12,129,,PHO,1,240,52,89,0.584,41,63,0.651,11,26,0.423,14,21,0.667,129,33,95,0.347,30,72,0.417,3,23,0.13,14,22,0.636,83
74,SAS,2018-02-07,129,@,PHO,1,240,46,93,0.495,30,61,0.492,16,32,0.5,21,27,0.778,129,33,97,0.34,30,65,0.462,3,32,0.094,12,18,0.667,81
75,UTA,2018-02-02,129,@,PHO,1,240,51,90,0.567,36,61,0.59,15,29,0.517,12,17,0.706,129,36,87,0.414,27,54,0.5,9,33,0.273,16,19,0.842,97
76,UTA,2018-01-30,129,,GSW,1,240,53,91,0.582,39,63,0.619,14,28,0.5,9,14,0.643,129,39,85,0.459,34,60,0.567,5,25,0.2,16,21,0.762,99
77,WAS,2018-01-27,129,@,ATL,1,240,49,85,0.576,31,53,0.585,18,32,0.563,13,14,0.929,129,38,88,0.432,26,45,0.578,12,43,0.279,16,21,0.762,104
78,TOR,2018-01-05,129,@,MIL,1,240,48,86,0.558,38,53,0.717,10,33,0.303,23,28,0.821,129,41,77,0.532,34,60,0.567,7,17,0.412,21,29,0.724,110
79,TOR,2017-12-20,129,@,CHO,1,240,49,91,0.538,33,58,0.569,16,33,0.485,15,18,0.833,129,39,85,0.459,32,62,0.516,7,23,0.304,26,35,0.743,111
80,CHO,2017-11-22,129,,WAS,1,265,43,91,0.473,33,63,0.524,10,28,0.357,33,40,0.825,129,48,99,0.485,37,66,0.561,11,33,0.333,17,22,0.773,124
81,TOR,2017-11-14,129,@,HOU,1,240,41,78,0.526,27,48,0.563,14,30,0.467,33,42,0.786,129,33,79,0.418,21,40,0.525,12,39,0.308,35,41,0.854,113
82,DEN,2017-11-01,129,,TOR,1,240,47,88,0.534,31,56,0.554,16,32,0.5,19,29,0.655,129,42,85,0.494,31,54,0.574,11,31,0.355,16,25,0.64,111
83,DEN,2018-04-01,128,,MIL,1,265,40,90,0.444,29,54,0.537,11,36,0.306,37,46,0.804,128,45,100,0.45,33,67,0.493,12,33,0.364,23,27,0.852,125
84,NYK,2018-03-26,128,@,CHO,0,265,54,105,0.514,45,75,0.6,9,30,0.3,11,11,1.0,128,51,93,0.548,40,65,0.615,11,28,0.393,24,28,0.857,137
85,NOP,2018-03-22,128,,LAL,1,240,52,95,0.547,46,71,0.648,6,24,0.25,18,22,0.818,128,43,87,0.494,26,48,0.542,17,39,0.436,22,28,0.786,125
86,PHI,2018-03-06,128,@,CHO,1,240,50,87,0.575,34,54,0.63,16,33,0.485,12,15,0.8,128,40,80,0.5,29,51,0.569,11,29,0.379,23,31,0.742,114
87,LAC,2018-03-02,128,,NYK,1,240,50,89,0.562,41,64,0.641,9,25,0.36,19,24,0.792,128,41,89,0.461,30,64,0.469,11,25,0.44,12,16,0.75,105
88,LAC,2018-02-23,128,@,PHO,1,240,45,87,0.517,31,55,0.564,14,32,0.438,24,32,0.75,128,45,103,0.437,36,72,0.5,9,31,0.29,18,31,0.581,117
89,BRK,2018-02-10,128,,NOP,0,290,43,114,0.377,22,55,0.4,21,59,0.356,21,22,0.955,128,52,106,0.491,43,82,0.524,9,24,0.375,25,39,0.641,138
90,CHI,2018-01-22,128,@,NOP,0,290,45,92,0.489,37,61,0.607,8,31,0.258,30,34,0.882,128,47,113,0.416,31,69,0.449,16,44,0.364,22,26,0.846,132
91,MEM,2017-12-30,128,@,GSW,0,240,49,94,0.521,34,73,0.466,15,21,0.714,15,22,0.682,128,50,85,0.588,32,52,0.615,18,33,0.545,23,25,0.92,141
92,DAL,2017-12-29,128,@,NOP,1,240,46,83,0.554,24,44,0.545,22,39,0.564,14,18,0.778,128,42,85,0.494,34,54,0.63,8,31,0.258,28,32,0.875,120
93,MIN,2017-12-27,128,,DEN,1,265,47,90,0.522,35,61,0.574,12,29,0.414,22,30,0.733,128,42,91,0.462,27,52,0.519,15,39,0.385,26,31,0.839,125
94,NOP,2017-12-27,128,,BRK,1,240,48,90,0.533,31,57,0.544,17,33,0.515,15,19,0.789,128,41,90,0.456,22,52,0.423,19,38,0.5,12,14,0.857,113
95,LAC,2017-12-22,128,@,HOU,1,240,43,91,0.473,25,49,0.51,18,42,0.429,24,31,0.774,128,36,78,0.462,19,38,0.5,17,40,0.425,29,35,0.829,118
96,ORL,2017-11-10,128,@,PHO,1,240,43,82,0.524,30,54,0.556,13,28,0.464,29,43,0.674,128,44,94,0.468,39,70,0.557,5,24,0.208,19,25,0.76,112
97,TOR,2017-10-21,128,,PHI,1,240,42,89,0.472,29,45,0.644,13,44,0.295,31,37,0.838,128,32,82,0.39,24,58,0.414,8,24,0.333,22,36,0.611,94
98,GSW,2017-10-20,128,@,NOP,1,240,47,92,0.511,29,51,0.569,18,41,0.439,16,20,0.8,128,45,98,0.459,29,62,0.468,16,36,0.444,14,22,0.636,120
99,LAC,2018-03-21,127,@,MIL,1,240,45,86,0.523,30,56,0.536,15,30,0.5,22,29,0.759,127,50,91,0.549,42,65,0.646,8,26,0.308,12,17,0.706,120
100,LAL,2018-03-11,127,,CLE,1,240,48,96,0.5,35,62,0.565,13,34,0.382,18,20,0.9,127,41,88,0.466,29,57,0.509,12,31,0.387,19,23,0.826,113
101,LAC,2018-02-22,127,@,GSW,0,240,44,88,0.5,33,56,0.589,11,32,0.344,28,34,0.824,127,47,77,0.61,33,52,0.635,14,25,0.56,26,34,0.765,134
102,DEN,2018-02-01,127,,OKC,1,240,50,97,0.515,35,59,0.593,15,38,0.395,12,17,0.706,127,51,98,0.52,42,70,0.6,9,28,0.321,13,17,0.765,124
103,ORL,2018-01-31,127,,LAL,1,240,44,81,0.543,26,49,0.531,18,32,0.563,21,29,0.724,127,39,83,0.47,35,63,0.556,4,20,0.2,23,30,0.767,105
104,LAL,2018-01-21,127,,NYK,1,240,51,91,0.56,41,65,0.631,10,26,0.385,15,21,0.714,127,44,81,0.543,32,56,0.571,12,25,0.48,7,10,0.7,107
105,GSW,2018-01-13,127,@,TOR,1,240,47,81,0.58,38,57,0.667,9,24,0.375,24,28,0.857,127,45,93,0.484,37,68,0.544,8,25,0.32,27,32,0.844,125
106,MIN,2018-01-08,127,,CLE,1,240,52,100,0.52,42,69,0.609,10,31,0.323,13,17,0.765,127,37,84,0.44,24,46,0.522,13,38,0.342,12,16,0.75,99
107,ORL,2018-01-06,127,,CLE,0,240,49,98,0.5,35,61,0.574,14,37,0.378,15,22,0.682,127,47,94,0.5,32,60,0.533,15,34,0.441,22,31,0.71,131
108,CHI,2018-01-05,127,@,DAL,1,240,44,78,0.564,30,50,0.6,14,28,0.5,25,31,0.806,127,49,92,0.533,35,60,0.583,14,32,0.438,12,17,0.706,124
109,OKC,2018-01-04,127,@,LAC,1,240,51,95,0.537,36,61,0.59,15,34,0.441,10,14,0.714,127,45,100,0.45,36,70,0.514,9,30,0.3,18,23,0.783,117
110,CLE,2018-01-02,127,,POR,1,240,43,83,0.518,30,51,0.588,13,32,0.406,28,37,0.757,127,42,90,0.467,29,58,0.5,13,32,0.406,13,19,0.684,110
111,MIL,2018-01-01,127,@,TOR,0,265,44,93,0.473,31,66,0.47,13,27,0.481,26,28,0.929,127,45,91,0.495,31,58,0.534,14,33,0.424,27,33,0.818,131
112,GSW,2017-11-29,127,@,LAL,1,265,47,94,0.5,35,64,0.547,12,30,0.4,21,28,0.75,127,47,95,0.495,38,71,0.535,9,24,0.375,20,25,0.8,123
113,POR,2017-11-24,127,@,BRK,1,240,48,96,0.5,42,81,0.519,6,15,0.4,25,35,0.714,127,50,100,0.5,40,75,0.533,10,25,0.4,15,21,0.714,125
114,LAL,2017-11-19,127,,DEN,1,240,53,100,0.53,41,68,0.603,12,32,0.375,9,16,0.563,127,36,84,0.429,23,53,0.434,13,31,0.419,24,35,0.686,109
115,GSW,2017-11-04,127,@,DEN,1,240,50,91,0.549,32,51,0.627,18,40,0.45,9,17,0.529,127,40,87,0.46,34,63,0.54,6,24,0.25,22,27,0.815,108
116,NOP,2018-04-07,126,@,GSW,1,240,49,87,0.563,38,60,0.633,11,27,0.407,17,22,0.773,126,49,90,0.544,34,57,0.596,15,33,0.455,7,11,0.636,120
117,IND,2018-04-05,126,,GSW,1,240,50,93,0.538,35,64,0.547,15,29,0.517,11,15,0.733,126,37,83,0.446,28,54,0.519,9,29,0.31,23,24,0.958,106
118,DEN,2018-03-30,126,@,OKC,1,265,49,94,0.521,39,64,0.609,10,30,0.333,18,21,0.857,126,45,108,0.417,25,64,0.391,20,44,0.455,15,27,0.556,125
119,MIN,2018-03-28,126,,ATL,1,240,48,90,0.533,35,60,0.583,13,30,0.433,17,21,0.81,126,41,77,0.532,28,50,0.56,13,27,0.481,19,23,0.826,114
120,ORL,2018-03-14,126,,MIL,1,240,44,87,0.506,26,53,0.491,18,34,0.529,20,23,0.87,126,49,98,0.5,39,74,0.527,10,24,0.417,9,12,0.75,117
121,NOP,2018-03-04,126,@,DAL,1,240,49,91,0.538,37,65,0.569,12,26,0.462,16,21,0.762,126,40,90,0.444,30,67,0.448,10,23,0.435,19,25,0.76,109
122,DEN,2018-03-03,126,@,CLE,1,240,47,86,0.547,28,51,0.549,19,35,0.543,13,15,0.867,126,46,88,0.523,37,64,0.578,9,24,0.375,16,21,0.762,117
123,HOU,2018-02-13,126,@,MIN,1,240,41,83,0.494,19,36,0.528,22,47,0.468,22,29,0.759,126,40,84,0.476,34,61,0.557,6,23,0.261,22,23,0.957,108
124,IND,2018-02-02,126,@,CHO,0,240,44,87,0.506,32,58,0.552,12,29,0.414,26,28,0.929,126,44,83,0.53,29,50,0.58,15,33,0.455,30,34,0.882,133
125,GSW,2018-01-25,126,,MIN,1,240,48,89,0.539,27,52,0.519,21,37,0.568,9,15,0.6,126,46,101,0.455,40,81,0.494,6,20,0.3,15,18,0.833,113
126,MIN,2018-01-22,126,@,LAC,1,240,43,91,0.473,36,69,0.522,7,22,0.318,33,39,0.846,126,47,84,0.56,38,57,0.667,9,27,0.333,15,22,0.682,118
127,LAC,2018-01-13,126,,SAC,1,240,46,82,0.561,34,51,0.667,12,31,0.387,22,26,0.846,126,43,85,0.506,37,68,0.544,6,17,0.353,13,22,0.591,105
128,GSW,2017-12-27,126,,UTA,1,240,51,86,0.593,40,63,0.635,11,23,0.478,13,17,0.765,126,37,92,0.402,31,69,0.449,6,23,0.261,21,27,0.778,101
129,IND,2017-12-10,126,,DEN,1,265,49,93,0.527,39,68,0.574,10,25,0.4,18,22,0.818,126,43,95,0.453,26,53,0.491,17,42,0.405,13,16,0.813,116
130,TOR,2017-12-05,126,,PHO,1,240,44,92,0.478,29,56,0.518,15,36,0.417,23,26,0.885,126,37,75,0.493,28,51,0.549,9,24,0.375,30,38,0.789,113
131,UTA,2017-11-30,126,@,LAC,1,240,49,85,0.576,32,50,0.64,17,35,0.486,11,14,0.786,126,38,70,0.543,28,41,0.683,10,29,0.345,21,30,0.7,107
132,TOR,2017-11-29,126,,CHO,1,240,52,98,0.531,38,66,0.576,14,32,0.438,8,11,0.727,126,37,79,0.468,28,60,0.467,9,19,0.474,30,35,0.857,113
133,ATL,2017-11-15,126,,SAC,1,240,50,79,0.633,34,47,0.723,16,32,0.5,10,16,0.625,126,31,88,0.352,25,60,0.417,6,28,0.214,12,20,0.6,80
134,MIA,2017-11-08,126,@,PHO,1,240,43,81,0.531,31,51,0.608,12,30,0.4,28,35,0.8,126,40,88,0.455,28,59,0.475,12,29,0.414,23,30,0.767,115
135,CHO,2017-11-01,126,,MIL,1,240,45,84,0.536,31,59,0.525,14,25,0.56,22,29,0.759,126,45,91,0.495,26,55,0.473,19,36,0.528,12,15,0.8,121
136,BRK,2017-10-20,126,,ORL,1,240,46,92,0.5,37,65,0.569,9,27,0.333,25,35,0.714,126,45,89,0.506,27,56,0.482,18,33,0.545,13,15,0.867,121
137,MIL,2018-04-01,125,@,DEN,0,265,45,100,0.45,33,67,0.493,12,33,0.364,23,27,0.852,125,40,90,0.444,29,54,0.537,11,36,0.306,37,46,0.804,128
138,OKC,2018-03-30,125,,DEN,0,265,45,108,0.417,25,64,0.391,20,44,0.455,15,27,0.556,125,49,94,0.521,39,64,0.609,10,30,0.333,18,21,0.857,126
139,LAL,2018-03-22,125,@,NOP,0,240,43,87,0.494,26,48,0.542,17,39,0.436,22,28,0.786,125,52,95,0.547,46,71,0.648,6,24,0.25,18,22,0.818,128
140,TOR,2018-03-18,125,,OKC,0,240,46,81,0.568,31,51,0.608,15,30,0.5,18,23,0.783,125,49,88,0.557,39,67,0.582,10,21,0.476,24,34,0.706,132
141,WAS,2018-03-14,125,@,BOS,1,290,46,97,0.474,34,65,0.523,12,32,0.375,21,28,0.75,125,48,99,0.485,36,73,0.493,12,26,0.462,16,23,0.696,124
142,DEN,2018-03-09,125,,LAL,1,240,42,83,0.506,27,52,0.519,15,31,0.484,26,30,0.867,125,45,92,0.489,31,57,0.544,14,35,0.4,12,16,0.75,116
143,POR,2018-03-09,125,,GSW,1,240,44,89,0.494,28,50,0.56,16,39,0.41,21,27,0.778,125,38,78,0.487,26,50,0.52,12,28,0.429,20,24,0.833,108
144,BRK,2018-03-08,125,@,CHO,1,240,47,92,0.511,36,60,0.6,11,32,0.344,20,22,0.909,125,41,85,0.482,37,66,0.561,4,19,0.211,25,30,0.833,111
145,MIA,2018-03-05,125,,PHO,1,240,47,92,0.511,35,56,0.625,12,36,0.333,19,23,0.826,125,42,87,0.483,32,63,0.508,10,24,0.417,9,18,0.5,103
146,GSW,2018-02-26,125,@,NYK,1,240,44,85,0.518,29,54,0.537,15,31,0.484,22,26,0.846,125,47,96,0.49,37,71,0.521,10,25,0.4,7,9,0.778,111
147,NOP,2018-02-26,125,,PHO,1,240,43,91,0.473,35,63,0.556,8,28,0.286,31,40,0.775,125,42,97,0.433,35,73,0.479,7,24,0.292,25,32,0.781,116
148,OKC,2018-02-06,125,@,GSW,1,240,44,93,0.473,32,62,0.516,12,31,0.387,25,33,0.758,125,37,76,0.487,29,48,0.604,8,28,0.286,23,31,0.742,105
149,DET,2018-01-30,125,,CLE,1,240,49,93,0.527,40,70,0.571,9,23,0.391,18,28,0.643,125,38,84,0.452,25,49,0.51,13,35,0.371,25,32,0.781,114
150,UTA,2018-01-20,125,,LAC,1,240,45,82,0.549,34,54,0.63,11,28,0.393,24,32,0.75,125,36,82,0.439,25,46,0.543,11,36,0.306,30,38,0.789,113
151,TOR,2018-01-13,125,,GSW,0,240,45,93,0.484,37,68,0.544,8,25,0.32,27,32,0.844,125,47,81,0.58,38,57,0.667,9,24,0.375,24,28,0.857,127
152,WAS,2018-01-12,125,,ORL,1,240,54,95,0.568,50,79,0.633,4,16,0.25,13,19,0.684,125,41,80,0.513,29,51,0.569,12,29,0.414,25,31,0.806,119
153,LAC,2018-01-10,125,@,GSW,1,240,46,94,0.489,35,70,0.5,11,24,0.458,22,28,0.786,125,38,79,0.481,30,56,0.536,8,23,0.348,22,26,0.846,106
154,IND,2018-01-06,125,,CHI,1,240,48,86,0.558,33,55,0.6,15,31,0.484,14,18,0.778,125,30,80,0.375,20,48,0.417,10,32,0.313,16,20,0.8,86
155,GSW,2018-01-03,125,@,DAL,1,240,48,91,0.527,35,59,0.593,13,32,0.406,16,19,0.842,125,43,90,0.478,24,47,0.511,19,43,0.442,17,22,0.773,122
156,DEN,2017-12-27,125,@,MIN,0,265,42,91,0.462,27,52,0.519,15,39,0.385,26,31,0.839,125,47,90,0.522,35,61,0.574,12,29,0.414,22,30,0.733,128
157,GSW,2017-12-04,125,@,NOP,1,240,45,87,0.517,29,54,0.537,16,33,0.485,19,27,0.704,125,45,91,0.495,29,52,0.558,16,39,0.41,9,15,0.6,115
158,BRK,2017-11-24,125,,POR,0,240,50,100,0.5,40,75,0.533,10,25,0.4,15,21,0.714,125,48,96,0.5,42,81,0.519,6,15,0.4,25,35,0.714,127
159,HOU,2017-11-22,125,,DEN,1,240,45,82,0.549,27,41,0.659,18,41,0.439,17,23,0.739,125,35,87,0.402,25,54,0.463,10,33,0.303,15,23,0.652,95
160,UTA,2017-11-18,125,@,ORL,1,240,47,98,0.48,33,64,0.516,14,34,0.412,17,18,0.944,125,31,81,0.383,23,52,0.442,8,29,0.276,15,23,0.652,85
161,TOR,2017-11-15,125,@,NOP,1,240,45,76,0.592,29,42,0.69,16,34,0.471,19,20,0.95,125,46,91,0.505,36,64,0.563,10,27,0.37,14,14,1.0,116
162,DEN,2017-11-11,125,,ORL,1,240,46,87,0.529,34,58,0.586,12,29,0.414,21,27,0.778,125,41,87,0.471,30,56,0.536,11,31,0.355,14,20,0.7,107
163,GSW,2017-11-08,125,,MIN,1,240,48,85,0.565,33,49,0.673,15,36,0.417,14,18,0.778,125,38,92,0.413,33,68,0.485,5,24,0.208,20,27,0.741,101
164,MIN,2017-10-30,125,@,MIA,1,265,41,91,0.451,30,68,0.441,11,23,0.478,32,35,0.914,125,49,93,0.527,42,66,0.636,7,27,0.259,17,25,0.68,122
165,ORL,2017-10-24,125,,BRK,1,240,41,83,0.494,33,60,0.55,8,23,0.348,35,40,0.875,125,40,96,0.417,29,61,0.475,11,35,0.314,30,34,0.882,121
166,PHO,2018-04-10,124,@,DAL,1,240,48,76,0.632,35,50,0.7,13,26,0.5,15,21,0.714,124,37,97,0.381,29,64,0.453,8,33,0.242,15,22,0.682,97
167,BRK,2018-04-07,124,@,CHI,1,240,46,92,0.5,22,37,0.595,24,55,0.436,8,11,0.727,124,36,88,0.409,30,59,0.508,6,29,0.207,18,21,0.857,96
168,MIL,2018-03-30,124,@,LAL,1,265,45,94,0.479,34,65,0.523,11,29,0.379,23,28,0.821,124,48,94,0.511,40,67,0.597,8,27,0.296,18,25,0.72,122
169,SAS,2018-03-23,124,,UTA,1,265,47,92,0.511,40,75,0.533,7,17,0.412,23,27,0.852,124,43,88,0.489,32,60,0.533,11,28,0.393,23,29,0.793,120
170,CLE,2018-03-19,124,,MIL,1,240,43,87,0.494,28,49,0.571,15,38,0.395,23,27,0.852,124,45,88,0.511,37,57,0.649,8,31,0.258,19,20,0.95,117
171,NYK,2018-03-17,124,,CHO,1,240,49,100,0.49,37,74,0.5,12,26,0.462,14,18,0.778,124,33,90,0.367,24,57,0.421,9,33,0.273,26,32,0.813,101
172,GSW,2018-03-17,124,@,PHO,1,240,50,95,0.526,37,64,0.578,13,31,0.419,11,14,0.786,124,39,82,0.476,28,58,0.483,11,24,0.458,20,29,0.69,109
173,BOS,2018-03-14,124,,WAS,0,290,48,99,0.485,36,73,0.493,12,26,0.462,16,23,0.696,124,46,97,0.474,34,65,0.523,12,32,0.375,21,28,0.75,125
174,OKC,2018-03-02,124,@,PHO,1,240,46,96,0.479,35,62,0.565,11,34,0.324,21,29,0.724,124,46,96,0.479,35,71,0.493,11,25,0.44,13,18,0.722,116
175,LAL,2018-02-23,124,,DAL,1,240,48,93,0.516,35,60,0.583,13,33,0.394,15,20,0.75,124,37,91,0.407,18,49,0.367,19,42,0.452,9,11,0.818,102
176,NOP,2018-02-23,124,,MIA,1,265,48,108,0.444,40,77,0.519,8,31,0.258,20,24,0.833,124,50,108,0.463,44,90,0.489,6,18,0.333,17,26,0.654,123
177,OKC,2018-02-01,124,@,DEN,0,240,51,98,0.52,42,70,0.6,9,28,0.321,13,17,0.765,124,50,97,0.515,35,59,0.593,15,38,0.395,12,17,0.706,127
178,POR,2018-01-31,124,,CHI,1,240,46,82,0.561,31,50,0.62,15,32,0.469,17,20,0.85,124,41,99,0.414,28,65,0.431,13,34,0.382,13,22,0.591,108
179,CLE,2018-01-20,124,,OKC,0,240,46,89,0.517,36,52,0.692,10,37,0.27,22,27,0.815,124,58,100,0.58,44,70,0.629,14,30,0.467,18,28,0.643,148
180,GSW,2018-01-08,124,,DEN,1,240,48,85,0.565,35,55,0.636,13,30,0.433,15,21,0.714,124,47,95,0.495,39,76,0.513,8,19,0.421,12,16,0.75,114
181,DAL,2018-01-05,124,,CHI,0,240,49,92,0.533,35,60,0.583,14,32,0.438,12,17,0.706,124,44,78,0.564,30,50,0.6,14,28,0.5,25,31,0.806,127
182,GSW,2018-01-04,124,@,HOU,1,240,48,87,0.552,35,57,0.614,13,30,0.433,15,20,0.75,124,42,89,0.472,25,39,0.641,17,50,0.34,13,22,0.591,114
183,TOR,2018-01-03,124,@,CHI,1,240,45,92,0.489,30,54,0.556,15,38,0.395,19,19,1.0,124,43,93,0.462,30,60,0.5,13,33,0.394,16,19,0.842,115
184,POR,2018-01-01,124,@,CHI,1,265,47,108,0.435,33,75,0.44,14,33,0.424,16,18,0.889,124,45,104,0.433,34,77,0.442,11,27,0.407,19,23,0.826,120
185,OKC,2017-12-27,124,,TOR,1,240,46,87,0.529,37,62,0.597,9,25,0.36,23,33,0.697,124,36,85,0.424,25,47,0.532,11,38,0.289,24,26,0.923,107
186,HOU,2017-12-15,124,,SAS,1,240,43,91,0.473,25,41,0.61,18,50,0.36,20,25,0.8,124,46,94,0.489,36,68,0.529,10,26,0.385,7,13,0.538,109
187,BOS,2017-12-13,124,,DEN,1,240,47,79,0.595,36,54,0.667,11,25,0.44,19,24,0.792,124,45,91,0.495,36,63,0.571,9,28,0.321,19,26,0.731,118
188,PHI,2017-12-10,124,@,NOP,0,240,44,96,0.458,35,67,0.522,9,29,0.31,27,30,0.9,124,46,80,0.575,31,56,0.554,15,24,0.625,24,32,0.75,131
189,HOU,2017-12-09,124,@,POR,1,240,40,75,0.533,30,50,0.6,10,25,0.4,34,42,0.81,124,45,88,0.511,27,47,0.574,18,41,0.439,9,12,0.75,117
190,WAS,2017-11-22,124,@,CHO,0,265,48,99,0.485,37,66,0.561,11,33,0.333,17,22,0.773,124,43,91,0.473,33,63,0.524,10,28,0.357,33,40,0.825,129
191,MIN,2017-11-22,124,,ORL,1,240,40,87,0.46,32,64,0.5,8,23,0.348,36,45,0.8,124,46,91,0.505,34,54,0.63,12,37,0.324,14,22,0.636,118
192,GSW,2017-11-18,124,@,PHI,1,240,50,91,0.549,43,68,0.632,7,23,0.304,17,20,0.85,124,47,97,0.485,37,68,0.544,10,29,0.345,12,16,0.75,116
193,CLE,2017-11-07,124,,MIL,1,240,41,82,0.5,32,64,0.5,9,18,0.5,33,38,0.868,124,47,83,0.566,34,53,0.642,13,30,0.433,12,16,0.75,119
194,LAL,2017-11-03,124,,BRK,1,240,48,94,0.511,39,73,0.534,9,21,0.429,19,27,0.704,124,37,91,0.407,28,53,0.528,9,38,0.237,29,38,0.763,112
195,IND,2017-11-01,124,@,CLE,1,240,49,90,0.544,33,64,0.516,16,26,0.615,10,13,0.769,124,43,86,0.5,36,55,0.655,7,31,0.226,14,20,0.7,107
196,DEN,2017-10-29,124,@,BRK,1,240,47,94,0.5,36,74,0.486,11,20,0.55,19,22,0.864,124,39,96,0.406,27,65,0.415,12,31,0.387,21,31,0.677,111
197,POR,2017-10-18,124,@,PHO,1,240,44,90,0.489,30,66,0.455,14,24,0.583,22,28,0.786,124,28,89,0.315,21,62,0.339,7,27,0.259,13,18,0.722,76
198,MEM,2018-04-11,123,@,OKC,0,240,44,91,0.484,31,60,0.517,13,31,0.419,22,24,0.917,123,47,85,0.553,27,42,0.643,20,43,0.465,23,32,0.719,137
199,CLE,2018-04-09,123,@,NYK,1,240,40,85,0.471,21,40,0.525,19,45,0.422,24,28,0.857,123,46,87,0.529,35,57,0.614,11,30,0.367,6,12,0.5,109
200,IND,2018-04-08,123,@,CHO,1,240,50,93,0.538,41,68,0.603,9,25,0.36,14,18,0.778,123,40,80,0.5,29,50,0.58,11,30,0.367,26,30,0.867,117
201,NOP,2018-04-04,123,,MEM,1,240,45,86,0.523,29,50,0.58,16,36,0.444,17,19,0.895,123,37,93,0.398,27,61,0.443,10,32,0.313,11,15,0.733,95
202,PHI,2018-03-26,123,,DEN,1,240,46,91,0.505,33,62,0.532,13,29,0.448,18,25,0.72,123,36,84,0.429,25,52,0.481,11,32,0.344,21,34,0.618,104
203,MIN,2018-03-20,123,,LAC,1,240,45,86,0.523,35,61,0.574,10,25,0.4,23,24,0.958,123,40,93,0.43,32,69,0.464,8,24,0.333,21,26,0.808,109
204,SAC,2018-03-14,123,,MIA,1,265,48,94,0.511,40,70,0.571,8,24,0.333,19,25,0.76,123,41,99,0.414,23,56,0.411,18,43,0.419,19,21,0.905,119
205,LAC,2018-03-04,123,,BRK,1,240,44,84,0.524,34,57,0.596,10,27,0.37,25,30,0.833,123,40,92,0.435,21,47,0.447,19,45,0.422,21,23,0.913,120
206,HOU,2018-03-03,123,,BOS,1,240,39,87,0.448,20,38,0.526,19,49,0.388,26,30,0.867,123,44,91,0.484,31,67,0.463,13,24,0.542,19,21,0.905,120
207,BRK,2018-02-27,123,@,CLE,0,240,44,82,0.537,32,50,0.64,12,32,0.375,23,30,0.767,123,50,97,0.515,38,73,0.521,12,24,0.5,17,27,0.63,129
208,TOR,2018-02-26,123,,DET,1,240,42,80,0.525,25,42,0.595,17,38,0.447,22,23,0.957,123,36,94,0.383,29,72,0.403,7,22,0.318,15,20,0.75,94
209,LAL,2018-02-26,123,@,ATL,1,240,47,90,0.522,32,57,0.561,15,33,0.455,14,19,0.737,123,36,96,0.375,28,60,0.467,8,36,0.222,24,34,0.706,104
210,NOP,2018-02-25,123,@,MIL,1,265,51,107,0.477,41,77,0.532,10,30,0.333,11,14,0.786,123,44,96,0.458,37,71,0.521,7,25,0.28,26,29,0.897,121
211,MIA,2018-02-23,123,@,NOP,0,265,50,108,0.463,44,90,0.489,6,18,0.333,17,26,0.654,123,48,108,0.444,40,77,0.519,8,31,0.258,20,24,0.833,124
212,MIL,2018-02-15,123,,DEN,0,240,49,92,0.533,40,66,0.606,9,26,0.346,16,22,0.727,123,47,85,0.553,23,45,0.511,24,40,0.6,16,20,0.8,134
213,POR,2018-02-14,123,,GSW,1,240,45,93,0.484,33,60,0.55,12,33,0.364,21,24,0.875,123,43,90,0.478,30,53,0.566,13,37,0.351,18,19,0.947,117
214,TOR,2018-02-11,123,@,CHO,1,240,49,87,0.563,31,50,0.62,18,37,0.486,7,10,0.7,123,38,89,0.427,28,66,0.424,10,23,0.435,17,23,0.739,103
215,LAL,2018-02-10,123,@,DAL,0,240,46,84,0.548,30,50,0.6,16,34,0.471,15,22,0.682,123,48,89,0.539,36,62,0.581,12,27,0.444,22,27,0.815,130
216,DEN,2018-02-10,123,@,PHO,1,240,45,88,0.511,32,59,0.542,13,29,0.448,20,22,0.909,123,46,84,0.548,39,65,0.6,7,19,0.368,14,25,0.56,113
217,CLE,2018-02-09,123,@,ATL,1,240,46,86,0.535,31,51,0.608,15,35,0.429,16,24,0.667,123,37,83,0.446,21,39,0.538,16,44,0.364,17,19,0.895,107
218,HOU,2018-02-06,123,@,BRK,1,240,45,81,0.556,29,48,0.604,16,33,0.485,17,21,0.81,123,41,85,0.482,25,50,0.5,16,35,0.457,15,17,0.882,113
219,CHO,2018-01-31,123,@,ATL,1,240,46,90,0.511,29,58,0.5,17,32,0.531,14,18,0.778,123,39,77,0.506,27,45,0.6,12,32,0.375,20,22,0.909,110
220,TOR,2018-01-28,123,,LAL,1,240,46,92,0.5,34,61,0.557,12,31,0.387,19,25,0.76,123,40,91,0.44,32,66,0.485,8,25,0.32,23,33,0.697,111
221,POR,2018-01-24,123,,MIN,1,240,45,82,0.549,28,51,0.549,17,31,0.548,16,21,0.762,123,45,84,0.536,39,68,0.574,6,16,0.375,18,22,0.818,114
222,GSW,2018-01-23,123,,NYK,1,240,46,83,0.554,33,53,0.623,13,30,0.433,18,20,0.9,123,43,83,0.518,34,61,0.557,9,22,0.409,17,19,0.895,112
223,MEM,2018-01-15,123,,LAL,1,240,42,82,0.512,32,60,0.533,10,22,0.455,29,34,0.853,123,38,96,0.396,26,61,0.426,12,35,0.343,26,31,0.839,114
224,NOP,2018-01-14,123,@,NYK,1,265,45,95,0.474,36,63,0.571,9,32,0.281,24,34,0.706,123,46,97,0.474,34,63,0.54,12,34,0.353,14,18,0.778,118
225,PHI,2017-12-31,123,@,PHO,1,240,43,77,0.558,33,53,0.623,10,24,0.417,27,34,0.794,123,37,88,0.42,27,61,0.443,10,27,0.37,26,34,0.765,110
226,IND,2017-12-23,123,,BRK,1,265,47,90,0.522,37,67,0.552,10,23,0.435,19,24,0.792,123,42,98,0.429,26,62,0.419,16,36,0.444,19,25,0.76,119
227,CLE,2017-12-12,123,,ATL,1,240,48,86,0.558,28,48,0.583,20,38,0.526,7,10,0.7,123,43,92,0.467,27,56,0.482,16,36,0.444,12,13,0.923,114
228,NOP,2017-12-11,123,@,HOU,0,240,49,85,0.576,31,52,0.596,18,33,0.545,7,13,0.538,123,48,88,0.545,31,43,0.721,17,45,0.378,17,25,0.68,130
229,NOP,2017-12-06,123,,DEN,1,240,46,86,0.535,34,55,0.618,12,31,0.387,19,29,0.655,123,41,94,0.436,25,59,0.424,16,35,0.457,16,22,0.727,114
230,GSW,2017-12-03,123,@,MIA,1,240,47,84,0.56,36,54,0.667,11,30,0.367,18,24,0.75,123,33,81,0.407,19,44,0.432,14,37,0.378,15,17,0.882,95
231,NOP,2017-12-02,123,@,POR,1,240,45,86,0.523,30,55,0.545,15,31,0.484,18,25,0.72,123,47,105,0.448,36,70,0.514,11,35,0.314,11,11,1.0,116
232,LAL,2017-11-29,123,,GSW,0,265,47,95,0.495,38,71,0.535,9,24,0.375,20,25,0.8,123,47,94,0.5,35,64,0.547,12,30,0.4,21,28,0.75,127
233,CHI,2017-11-17,123,,CHO,1,240,47,91,0.516,30,57,0.526,17,34,0.5,12,13,0.923,123,42,81,0.519,32,60,0.533,10,21,0.476,26,34,0.765,120
234,NOP,2017-10-28,123,,CLE,1,240,49,95,0.516,36,62,0.581,13,33,0.394,12,16,0.75,123,36,78,0.462,24,46,0.522,12,32,0.375,17,23,0.739,101
235,NOP,2018-04-11,122,,SAS,1,240,52,88,0.591,47,69,0.681,5,19,0.263,13,19,0.684,122,37,92,0.402,29,68,0.426,8,24,0.333,16,19,0.842,98
236,NOP,2018-04-06,122,@,PHO,1,240,45,99,0.455,29,61,0.475,16,38,0.421,16,20,0.8,122,37,94,0.394,28,61,0.459,9,33,0.273,20,26,0.769,103
237,NYK,2018-04-06,122,,MIA,1,240,45,89,0.506,27,52,0.519,18,37,0.486,14,21,0.667,122,35,88,0.398,28,61,0.459,7,27,0.259,21,22,0.955,98
238,LAL,2018-04-04,122,,SAS,1,265,47,86,0.547,34,62,0.548,13,24,0.542,15,18,0.833,122,42,97,0.433,33,74,0.446,9,23,0.391,19,27,0.704,112
239,LAL,2018-03-30,122,,MIL,0,265,48,94,0.511,40,67,0.597,8,27,0.296,18,25,0.72,122,45,94,0.479,34,65,0.523,11,29,0.379,23,28,0.821,124
240,POR,2018-03-18,122,@,LAC,1,240,46,92,0.5,32,63,0.508,14,29,0.483,16,20,0.8,122,40,89,0.449,31,66,0.47,9,23,0.391,20,27,0.741,109
241,MIL,2018-03-17,122,,ATL,1,240,41,86,0.477,30,61,0.492,11,25,0.44,29,32,0.906,122,39,85,0.459,27,49,0.551,12,36,0.333,27,28,0.964,117
242,TOR,2018-03-16,122,,DAL,1,265,43,91,0.473,33,61,0.541,10,30,0.333,26,31,0.839,122,48,91,0.527,42,69,0.609,6,22,0.273,13,18,0.722,115
243,ATL,2018-03-11,122,,CHI,0,240,42,82,0.512,23,42,0.548,19,40,0.475,19,22,0.864,122,48,98,0.49,31,61,0.508,17,37,0.459,16,19,0.842,129
244,CHO,2018-03-10,122,,PHO,1,240,44,87,0.506,31,55,0.564,13,32,0.406,21,27,0.778,122,42,83,0.506,24,51,0.471,18,32,0.563,13,19,0.684,115
245,HOU,2018-03-06,122,@,OKC,1,240,38,72,0.528,21,39,0.538,17,33,0.515,29,34,0.853,122,46,93,0.495,34,59,0.576,12,34,0.353,8,11,0.727,112
246,LAC,2018-02-27,122,@,DEN,1,240,46,89,0.517,39,63,0.619,7,26,0.269,23,31,0.742,122,43,87,0.494,33,56,0.589,10,31,0.323,24,30,0.8,120
247,MIN,2018-02-24,122,,CHI,1,240,46,94,0.489,35,59,0.593,11,35,0.314,19,26,0.731,122,42,90,0.467,36,67,0.537,6,23,0.261,14,20,0.7,104
248,MIL,2018-02-23,122,@,TOR,1,265,43,90,0.478,30,64,0.469,13,26,0.5,23,27,0.852,122,43,90,0.478,34,56,0.607,9,34,0.265,24,26,0.923,119
249,DEN,2018-02-23,122,,SAS,1,240,48,97,0.495,36,65,0.554,12,32,0.375,14,19,0.737,122,43,85,0.506,38,69,0.551,5,16,0.313,28,39,0.718,119
250,CHO,2018-02-23,122,@,WAS,1,240,44,90,0.489,27,51,0.529,17,39,0.436,17,20,0.85,122,40,81,0.494,31,56,0.554,9,25,0.36,16,17,0.941,105
251,TOR,2018-02-14,122,@,CHI,1,240,48,92,0.522,34,54,0.63,14,38,0.368,12,15,0.8,122,39,91,0.429,35,67,0.522,4,24,0.167,16,20,0.8,98
252,GSW,2018-02-10,122,,SAS,1,240,48,85,0.565,36,58,0.621,12,27,0.444,14,15,0.933,122,43,94,0.457,38,67,0.567,5,27,0.185,14,19,0.737,105
253,WAS,2018-02-01,122,,TOR,1,240,44,85,0.518,34,55,0.618,10,30,0.333,24,26,0.923,122,44,83,0.53,32,54,0.593,12,29,0.414,19,24,0.792,119
254,OKC,2018-01-28,122,,PHI,1,240,45,92,0.489,35,59,0.593,10,33,0.303,22,30,0.733,122,38,76,0.5,27,47,0.574,11,29,0.379,25,31,0.806,112
255,WAS,2018-01-19,122,@,DET,1,240,41,82,0.5,25,47,0.532,16,35,0.457,24,27,0.889,122,40,80,0.5,30,50,0.6,10,30,0.333,22,26,0.846,112
256,CHI,2018-01-10,122,@,NYK,1,290,45,98,0.459,30,65,0.462,15,33,0.455,17,20,0.85,122,48,96,0.5,38,74,0.514,10,22,0.455,13,21,0.619,119
257,DAL,2018-01-03,122,,GSW,0,240,43,90,0.478,24,47,0.511,19,43,0.442,17,22,0.773,122,48,91,0.527,35,59,0.593,13,32,0.406,16,19,0.842,125
258,MIL,2018-01-03,122,,IND,1,240,44,75,0.587,35,58,0.603,9,17,0.529,25,28,0.893,122,41,84,0.488,38,69,0.551,3,15,0.2,16,19,0.842,101
259,LAC,2017-12-26,122,,SAC,1,240,44,81,0.543,31,50,0.62,13,31,0.419,21,27,0.778,122,40,96,0.417,33,74,0.446,7,22,0.318,8,12,0.667,95
260,LAL,2017-12-20,122,@,HOU,1,240,40,85,0.471,25,50,0.5,15,35,0.429,27,43,0.628,122,37,90,0.411,20,48,0.417,17,42,0.405,25,32,0.781,116
261,DAL,2017-12-04,122,,DEN,1,240,49,86,0.57,37,60,0.617,12,26,0.462,12,17,0.706,122,38,91,0.418,24,55,0.436,14,36,0.389,15,23,0.652,105
262,PHO,2017-11-17,122,@,LAL,1,240,48,103,0.466,35,71,0.493,13,32,0.406,13,19,0.684,122,45,91,0.495,38,66,0.576,7,25,0.28,16,24,0.667,113
263,TOR,2017-11-09,122,,NOP,1,240,45,98,0.459,29,56,0.518,16,42,0.381,16,23,0.696,122,44,82,0.537,31,51,0.608,13,31,0.419,17,25,0.68,118
264,WAS,2017-11-03,122,,CLE,0,240,45,84,0.536,34,56,0.607,11,28,0.393,21,31,0.677,122,46,82,0.561,34,55,0.618,12,27,0.444,26,28,0.929,130
265,PHO,2017-11-01,122,@,WAS,1,240,41,83,0.494,32,59,0.542,9,24,0.375,31,38,0.816,122,41,92,0.446,31,62,0.5,10,30,0.333,24,30,0.8,116
266,PHO,2017-10-31,122,@,BRK,1,240,45,96,0.469,35,74,0.473,10,22,0.455,22,24,0.917,122,42,102,0.412,33,71,0.465,9,31,0.29,21,30,0.7,114
267,MIA,2017-10-30,122,,MIN,0,265,49,93,0.527,42,66,0.636,7,27,0.259,17,25,0.68,122,41,91,0.451,30,68,0.441,11,23,0.478,32,35,0.914,125
268,DET,2017-10-25,122,,MIN,1,240,48,92,0.522,33,58,0.569,15,34,0.441,11,17,0.647,122,37,85,0.435,28,60,0.467,9,25,0.36,18,21,0.857,101
269,HOU,2017-10-17,122,@,GSW,1,240,47,97,0.485,32,56,0.571,15,41,0.366,13,19,0.684,122,43,80,0.538,27,50,0.54,16,30,0.533,19,21,0.905,121
270,PHI,2018-04-10,121,@,ATL,1,240,43,87,0.494,26,50,0.52,17,37,0.459,18,30,0.6,121,41,98,0.418,28,61,0.459,13,37,0.351,18,26,0.692,113
271,PHI,2018-04-03,121,,BRK,1,240,50,91,0.549,41,70,0.586,9,21,0.429,12,18,0.667,121,34,81,0.42,17,39,0.436,17,42,0.405,10,23,0.435,95
272,UTA,2018-04-01,121,@,MIN,1,240,46,76,0.605,35,48,0.729,11,28,0.393,18,25,0.72,121,38,90,0.422,30,66,0.455,8,24,0.333,13,14,0.929,97
273,CLE,2018-03-25,121,@,BRK,1,240,44,87,0.506,32,59,0.542,12,28,0.429,21,26,0.808,121,38,83,0.458,21,46,0.457,17,37,0.459,21,26,0.808,114
274,OKC,2018-03-16,121,,LAC,1,240,46,94,0.489,35,62,0.565,11,32,0.344,18,22,0.818,121,42,86,0.488,31,60,0.517,11,26,0.423,18,23,0.783,113
275,MIL,2018-03-12,121,@,MEM,1,240,47,81,0.58,35,56,0.625,12,25,0.48,15,22,0.682,121,42,89,0.472,33,62,0.532,9,27,0.333,10,19,0.526,103
276,TOR,2018-03-07,121,@,DET,1,265,45,101,0.446,33,61,0.541,12,40,0.3,19,21,0.905,121,44,90,0.489,31,64,0.484,13,26,0.5,18,23,0.783,119
277,NOP,2018-03-06,121,@,LAC,1,240,46,103,0.447,33,73,0.452,13,30,0.433,16,18,0.889,121,46,99,0.465,39,72,0.542,7,27,0.259,17,26,0.654,116
278,NOP,2018-02-28,121,@,SAS,1,240,50,99,0.505,41,73,0.562,9,26,0.346,12,15,0.8,121,48,99,0.485,39,73,0.534,9,26,0.346,11,14,0.786,116
279,MIL,2018-02-25,121,,NOP,0,265,44,96,0.458,37,71,0.521,7,25,0.28,26,29,0.897,121,51,107,0.477,41,77,0.532,10,30,0.333,11,14,0.786,123
280,BOS,2018-02-24,121,@,NYK,1,240,42,93,0.452,29,60,0.483,13,33,0.394,24,28,0.857,121,45,96,0.469,39,69,0.565,6,27,0.222,16,20,0.8,112
281,OKC,2018-02-14,121,@,MEM,1,240,40,81,0.494,23,44,0.523,17,37,0.459,24,35,0.686,121,44,86,0.512,30,59,0.508,14,27,0.519,12,15,0.8,114
282,IND,2018-02-11,121,,NYK,1,240,47,94,0.5,35,66,0.53,12,28,0.429,15,22,0.682,121,41,93,0.441,32,58,0.552,9,35,0.257,22,25,0.88,113
283,CLE,2018-02-11,121,@,BOS,1,240,45,84,0.536,29,54,0.537,16,30,0.533,15,20,0.75,121,36,89,0.404,26,51,0.51,10,38,0.263,17,22,0.773,99
284,GSW,2018-02-08,121,,DAL,1,240,45,88,0.511,31,59,0.525,14,29,0.483,17,20,0.85,121,40,92,0.435,31,55,0.564,9,37,0.243,14,17,0.824,103
285,DEN,2018-02-05,121,,CHO,1,240,46,81,0.568,28,47,0.596,18,34,0.529,11,13,0.846,121,39,77,0.506,28,51,0.549,11,26,0.423,15,24,0.625,104
286,CLE,2018-01-28,121,,DET,1,240,42,83,0.506,27,48,0.563,15,35,0.429,22,26,0.846,121,40,95,0.421,26,59,0.441,14,36,0.389,10,13,0.769,104
287,OKC,2018-01-27,121,@,DET,1,240,45,93,0.484,31,60,0.517,14,33,0.424,17,23,0.739,121,39,84,0.464,27,51,0.529,12,33,0.364,18,24,0.75,108
288,CHO,2018-01-26,121,,ATL,1,240,40,88,0.455,27,54,0.5,13,34,0.382,28,32,0.875,121,37,79,0.468,22,49,0.449,15,30,0.5,21,25,0.84,110
289,OKC,2018-01-25,121,,WAS,1,240,45,87,0.517,36,60,0.6,9,27,0.333,22,29,0.759,121,42,86,0.488,26,51,0.51,16,35,0.457,12,16,0.75,112
290,LAC,2018-01-11,121,@,SAC,1,240,43,84,0.512,30,53,0.566,13,31,0.419,22,30,0.733,121,42,85,0.494,34,59,0.576,8,26,0.308,23,28,0.821,115
291,HOU,2018-01-10,121,,POR,1,240,45,100,0.45,33,62,0.532,12,38,0.316,19,25,0.76,121,40,83,0.482,31,57,0.544,9,26,0.346,23,32,0.719,112
292,GSW,2018-01-06,121,@,LAC,1,240,39,94,0.415,26,55,0.473,13,39,0.333,30,37,0.811,121,39,91,0.429,36,80,0.45,3,11,0.273,24,30,0.8,105
293,WAS,2018-01-03,121,,NYK,1,240,48,81,0.593,39,58,0.672,9,23,0.391,16,26,0.615,121,41,86,0.477,34,67,0.507,7,19,0.368,14,18,0.778,103
294,LAC,2017-12-29,121,@,LAL,1,240,42,86,0.488,33,54,0.611,9,32,0.281,28,34,0.824,121,46,94,0.489,43,75,0.573,3,19,0.158,11,16,0.688,106
295,WAS,2017-12-29,121,,HOU,1,240,47,88,0.534,29,52,0.558,18,36,0.5,9,12,0.75,121,38,89,0.427,24,41,0.585,14,48,0.292,13,16,0.813,103
296,MIN,2017-12-25,121,@,LAL,1,240,49,84,0.583,38,52,0.731,11,32,0.344,12,14,0.857,121,40,92,0.435,30,62,0.484,10,30,0.333,14,20,0.7,104
297,CLE,2017-12-14,121,,LAL,1,240,43,86,0.5,28,50,0.56,15,36,0.417,20,25,0.8,121,47,95,0.495,38,64,0.594,9,31,0.29,9,14,0.643,112
298,CLE,2017-11-30,121,@,ATL,1,240,41,79,0.519,23,40,0.575,18,39,0.462,21,27,0.778,121,41,79,0.519,29,48,0.604,12,31,0.387,20,24,0.833,114
299,ORL,2017-11-29,121,,OKC,1,240,45,76,0.592,32,46,0.696,13,30,0.433,18,26,0.692,121,38,96,0.396,26,64,0.406,12,32,0.375,20,30,0.667,108
300,IND,2017-11-27,121,,ORL,1,240,42,79,0.532,27,53,0.509,15,26,0.577,22,26,0.846,121,40,92,0.435,24,51,0.471,16,41,0.39,13,16,0.813,109
301,UTA,2017-11-25,121,,MIL,1,240,46,81,0.568,28,49,0.571,18,32,0.563,11,19,0.579,121,41,77,0.532,33,56,0.589,8,21,0.381,18,23,0.783,108
302,PHI,2017-11-03,121,,IND,1,240,46,92,0.5,28,56,0.5,18,36,0.5,11,14,0.786,121,45,97,0.464,37,69,0.536,8,28,0.286,12,19,0.632,110
303,MIL,2017-11-01,121,@,CHO,0,240,45,91,0.495,26,55,0.473,19,36,0.528,12,15,0.8,121,45,84,0.536,31,59,0.525,14,25,0.56,22,29,0.759,126
304,BRK,2017-10-24,121,@,ORL,0,240,40,96,0.417,29,61,0.475,11,35,0.314,30,34,0.882,121,41,83,0.494,33,60,0.55,8,23,0.348,35,40,0.875,125
305,ORL,2017-10-20,121,@,BRK,0,240,45,89,0.506,27,56,0.482,18,33,0.545,13,15,0.867,121,46,92,0.5,37,65,0.569,9,27,0.333,25,35,0.714,126
306,GSW,2017-10-17,121,,HOU,0,240,43,80,0.538,27,50,0.54,16,30,0.533,19,21,0.905,121,47,97,0.485,32,56,0.571,15,41,0.366,13,19,0.684,122
307,GSW,2018-04-07,120,,NOP,0,240,49,90,0.544,34,57,0.596,15,33,0.455,7,11,0.636,120,49,87,0.563,38,60,0.633,11,27,0.407,17,22,0.773,126
308,HOU,2018-04-03,120,,WAS,1,240,43,84,0.512,27,38,0.711,16,46,0.348,18,27,0.667,120,38,72,0.528,26,47,0.553,12,25,0.48,16,23,0.696,104
309,CHI,2018-04-03,120,,CHO,1,240,46,99,0.465,31,65,0.477,15,34,0.441,13,18,0.722,120,40,81,0.494,27,47,0.574,13,34,0.382,21,28,0.75,114
310,PHI,2018-03-24,120,,MIN,1,240,42,88,0.477,29,51,0.569,13,37,0.351,23,36,0.639,120,37,96,0.385,31,73,0.425,6,23,0.261,28,38,0.737,108
311,CLE,2018-03-23,120,,PHO,1,240,47,95,0.495,39,66,0.591,8,29,0.276,18,24,0.75,120,38,87,0.437,31,59,0.525,7,28,0.25,12,20,0.6,95
312,UTA,2018-03-23,120,@,SAS,0,265,43,88,0.489,32,60,0.533,11,28,0.393,23,29,0.793,120,47,92,0.511,40,75,0.533,7,17,0.412,23,27,0.852,124
313,MIL,2018-03-21,120,,LAC,0,240,50,91,0.549,42,65,0.646,8,26,0.308,12,17,0.706,120,45,86,0.523,30,56,0.536,15,30,0.5,22,29,0.759,127
314,MIN,2018-03-18,120,,HOU,0,240,45,86,0.523,35,66,0.53,10,20,0.5,20,26,0.769,120,43,78,0.551,27,43,0.628,16,35,0.457,27,36,0.75,129
315,PHI,2018-03-16,120,,BRK,1,240,43,95,0.453,31,68,0.456,12,27,0.444,22,26,0.846,120,40,89,0.449,25,59,0.424,15,30,0.5,21,27,0.778,116
316,DEN,2018-03-15,120,,DET,1,240,43,85,0.506,31,57,0.544,12,28,0.429,22,28,0.786,120,44,92,0.478,30,65,0.462,14,27,0.519,11,17,0.647,113
317,PHI,2018-03-11,120,@,BRK,1,240,50,95,0.526,41,69,0.594,9,26,0.346,11,18,0.611,120,33,85,0.388,23,57,0.404,10,28,0.357,21,24,0.875,97
318,MIL,2018-03-09,120,,NYK,1,240,41,73,0.562,33,55,0.6,8,18,0.444,30,39,0.769,120,47,98,0.48,40,70,0.571,7,28,0.25,11,14,0.786,112
319,BRK,2018-03-04,120,@,LAC,0,240,40,92,0.435,21,47,0.447,19,45,0.422,21,23,0.913,120,44,84,0.524,34,57,0.596,10,27,0.37,25,30,0.833,123
320,BOS,2018-03-03,120,@,HOU,0,240,44,91,0.484,31,67,0.463,13,24,0.542,19,21,0.905,120,39,87,0.448,20,38,0.526,19,49,0.388,26,30,0.867,123
321,DEN,2018-02-27,120,,LAC,0,240,43,87,0.494,33,56,0.589,10,31,0.323,24,30,0.8,120,46,89,0.517,39,63,0.619,7,26,0.269,23,31,0.742,122
322,HOU,2018-02-23,120,,MIN,1,240,40,83,0.482,26,45,0.578,14,38,0.368,26,30,0.867,120,40,94,0.426,30,68,0.441,10,26,0.385,12,16,0.75,102
323,NYK,2018-02-22,120,@,ORL,1,240,48,99,0.485,41,74,0.554,7,25,0.28,17,21,0.81,120,43,83,0.518,32,59,0.542,11,24,0.458,16,23,0.696,113
324,CLE,2018-02-13,120,@,OKC,1,240,45,88,0.511,29,52,0.558,16,36,0.444,14,22,0.636,120,40,90,0.444,29,55,0.527,11,35,0.314,21,30,0.7,112
325,HOU,2018-02-03,120,@,CLE,1,240,44,93,0.473,25,42,0.595,19,51,0.373,13,16,0.813,120,34,87,0.391,26,57,0.456,8,30,0.267,12,16,0.75,88
326,UTA,2018-02-03,120,@,SAS,1,240,39,69,0.565,27,46,0.587,12,23,0.522,30,36,0.833,120,44,91,0.484,34,65,0.523,10,26,0.385,13,18,0.722,111
327,MEM,2018-01-29,120,,PHO,1,240,47,83,0.566,36,61,0.59,11,22,0.5,15,18,0.833,120,38,82,0.463,31,59,0.525,7,23,0.304,26,36,0.722,109
328,UTA,2018-01-17,120,@,SAC,1,240,46,81,0.568,34,52,0.654,12,29,0.414,16,20,0.8,120,38,72,0.528,25,51,0.49,13,21,0.619,16,20,0.8,105
329,IND,2018-01-14,120,@,PHO,1,240,48,88,0.545,37,65,0.569,11,23,0.478,13,14,0.929,120,35,85,0.412,26,48,0.542,9,37,0.243,18,24,0.75,97
330,MIN,2018-01-14,120,,POR,1,240,43,80,0.538,36,61,0.59,7,19,0.368,27,33,0.818,120,39,79,0.494,28,54,0.519,11,25,0.44,14,17,0.824,103
331,CHI,2018-01-01,120,,POR,0,265,45,104,0.433,34,77,0.442,11,27,0.407,19,23,0.826,120,47,108,0.435,33,75,0.44,14,33,0.424,16,18,0.889,124
332,NOP,2017-12-29,120,,DAL,0,240,42,85,0.494,34,54,0.63,8,31,0.258,28,32,0.875,120,46,83,0.554,24,44,0.545,22,39,0.564,14,18,0.778,128
333,OKC,2017-12-22,120,,ATL,1,240,44,82,0.537,31,57,0.544,13,25,0.52,19,31,0.613,120,44,85,0.518,29,53,0.547,15,32,0.469,14,17,0.824,117
334,HOU,2017-12-18,120,,UTA,1,240,40,77,0.519,23,34,0.676,17,43,0.395,23,27,0.852,120,42,91,0.462,34,64,0.531,8,27,0.296,7,8,0.875,99
335,TOR,2017-12-15,120,,BRK,1,240,54,97,0.557,47,69,0.681,7,28,0.25,5,9,0.556,120,32,76,0.421,25,53,0.472,7,23,0.304,16,19,0.842,87
336,TOR,2017-12-01,120,,IND,1,240,48,97,0.495,38,65,0.585,10,32,0.313,14,21,0.667,120,45,102,0.441,37,76,0.487,8,26,0.308,17,22,0.773,115
337,MIN,2017-11-29,120,@,NOP,1,240,47,81,0.58,38,58,0.655,9,23,0.391,17,19,0.895,120,39,84,0.464,25,49,0.51,14,35,0.4,10,11,0.909,102
338,LAC,2017-11-27,120,,LAL,1,240,41,85,0.482,31,57,0.544,10,28,0.357,28,30,0.933,120,44,91,0.484,33,61,0.541,11,30,0.367,16,24,0.667,115
339,IND,2017-11-19,120,@,MIA,1,240,51,85,0.6,40,62,0.645,11,23,0.478,7,8,0.875,120,35,83,0.422,22,46,0.478,13,37,0.351,12,14,0.857,95
340,CHO,2017-11-17,120,@,CHI,0,240,42,81,0.519,32,60,0.533,10,21,0.476,26,34,0.765,120,47,91,0.516,30,57,0.526,17,34,0.5,12,13,0.923,123
341,OKC,2017-11-10,120,,LAC,1,240,40,78,0.513,29,52,0.558,11,26,0.423,29,40,0.725,120,39,84,0.464,27,54,0.5,12,30,0.4,21,30,0.7,111
342,SAS,2017-11-07,120,,LAC,1,240,45,84,0.536,30,56,0.536,15,28,0.536,15,19,0.789,120,42,82,0.512,31,52,0.596,11,30,0.367,12,17,0.706,107
343,NYK,2017-11-03,120,,PHO,1,240,45,87,0.517,37,61,0.607,8,26,0.308,22,25,0.88,120,34,97,0.351,25,65,0.385,9,32,0.281,30,37,0.811,107
344,CHO,2017-10-29,120,,ORL,1,240,53,97,0.546,47,79,0.595,6,18,0.333,8,17,0.471,120,41,97,0.423,30,64,0.469,11,33,0.333,20,26,0.769,113
345,GSW,2017-10-27,120,,WAS,1,240,46,95,0.484,36,57,0.632,10,38,0.263,18,20,0.9,120,43,97,0.443,28,64,0.438,15,33,0.455,16,22,0.727,117
346,NOP,2017-10-20,120,,GSW,0,240,45,98,0.459,29,62,0.468,16,36,0.444,14,22,0.636,120,47,92,0.511,29,51,0.569,18,41,0.439,16,20,0.8,128
347,WAS,2017-10-18,120,,PHI,1,240,42,97,0.433,36,75,0.48,6,22,0.273,30,38,0.789,120,43,93,0.462,28,58,0.483,15,35,0.429,14,19,0.737,115
348,DET,2018-04-11,119,@,CHI,1,240,47,89,0.528,32,54,0.593,15,35,0.429,10,10,1.0,119,32,86,0.372,21,52,0.404,11,34,0.324,12,18,0.667,87
349,UTA,2018-04-10,119,,GSW,1,240,48,90,0.533,35,55,0.636,13,35,0.371,10,13,0.769,119,30,86,0.349,25,67,0.373,5,19,0.263,14,16,0.875,79
350,CHO,2018-04-10,119,@,IND,1,240,46,99,0.465,28,57,0.491,18,42,0.429,9,12,0.75,119,40,99,0.404,32,68,0.471,8,31,0.258,5,8,0.625,93
351,BRK,2018-04-05,119,@,MIL,1,240,41,75,0.547,22,36,0.611,19,39,0.487,18,21,0.857,119,41,93,0.441,36,73,0.493,5,20,0.25,24,30,0.8,111
352,CLE,2018-04-05,119,,WAS,1,240,42,77,0.545,29,50,0.58,13,27,0.481,22,28,0.786,119,47,94,0.5,38,73,0.521,9,21,0.429,12,14,0.857,115
353,PHI,2018-04-01,119,@,CHO,1,240,48,94,0.511,34,62,0.548,14,32,0.438,9,10,0.9,119,33,82,0.402,24,52,0.462,9,30,0.3,27,34,0.794,102
354,UTA,2018-03-22,119,@,DAL,1,240,46,87,0.529,34,58,0.586,12,29,0.414,15,16,0.938,119,42,85,0.494,25,53,0.472,17,32,0.531,11,14,0.786,112
355,MIA,2018-03-21,119,,NYK,1,240,45,81,0.556,30,47,0.638,15,34,0.441,14,19,0.737,119,39,89,0.438,29,58,0.5,10,31,0.323,10,12,0.833,98
356,PHI,2018-03-21,119,,MEM,1,240,46,84,0.548,35,53,0.66,11,31,0.355,16,20,0.8,119,40,99,0.404,31,72,0.431,9,27,0.333,16,20,0.8,105
357,MIA,2018-03-14,119,@,SAC,0,265,41,99,0.414,23,56,0.411,18,43,0.419,19,21,0.905,119,48,94,0.511,40,70,0.571,8,24,0.333,19,25,0.76,123
358,NOP,2018-03-13,119,,CHO,1,240,52,104,0.5,43,82,0.524,9,22,0.409,6,8,0.75,119,45,93,0.484,38,67,0.567,7,26,0.269,18,22,0.818,115
359,OKC,2018-03-13,119,@,ATL,1,240,42,89,0.472,26,54,0.481,16,35,0.457,19,25,0.76,119,37,87,0.425,24,56,0.429,13,31,0.419,20,24,0.833,107
360,DET,2018-03-07,119,,TOR,0,265,44,90,0.489,31,64,0.484,13,26,0.5,18,23,0.783,119,45,101,0.446,33,61,0.541,12,40,0.3,19,21,0.905,121
361,CHI,2018-03-07,119,,MEM,1,240,42,79,0.532,31,50,0.62,11,29,0.379,24,32,0.75,119,40,82,0.488,30,53,0.566,10,29,0.345,20,25,0.8,110
362,HOU,2018-02-25,119,@,DEN,1,240,39,77,0.506,24,42,0.571,15,35,0.429,26,32,0.813,119,44,91,0.484,34,62,0.548,10,29,0.345,16,24,0.667,114
363,SAS,2018-02-23,119,@,DEN,0,240,43,85,0.506,38,69,0.551,5,16,0.313,28,39,0.718,119,48,97,0.495,36,65,0.554,12,32,0.375,14,19,0.737,122
364,TOR,2018-02-23,119,,MIL,0,265,43,90,0.478,34,56,0.607,9,34,0.265,24,26,0.923,119,43,90,0.478,30,64,0.469,13,26,0.5,23,27,0.852,122
365,MIN,2018-02-15,119,,LAL,1,240,42,90,0.467,36,66,0.545,6,24,0.25,29,31,0.935,119,43,94,0.457,36,63,0.571,7,31,0.226,18,26,0.692,111
366,BOS,2018-02-14,119,,LAC,0,240,42,97,0.433,27,66,0.409,15,31,0.484,20,21,0.952,119,44,88,0.5,33,59,0.559,11,29,0.379,30,33,0.909,129
367,GSW,2018-02-02,119,@,SAC,1,240,44,80,0.55,27,47,0.574,17,33,0.515,14,16,0.875,119,42,95,0.442,32,70,0.457,10,25,0.4,10,15,0.667,104
368,BOS,2018-02-02,119,,ATL,1,240,45,89,0.506,34,65,0.523,11,24,0.458,18,20,0.9,119,34,80,0.425,23,49,0.469,11,31,0.355,31,34,0.912,110
369,TOR,2018-02-01,119,@,WAS,0,240,44,83,0.53,32,54,0.593,12,29,0.414,19,24,0.792,119,44,85,0.518,34,55,0.618,10,30,0.333,24,26,0.923,122
370,GSW,2018-01-17,119,@,CHI,1,240,42,84,0.5,29,51,0.569,13,33,0.394,22,25,0.88,119,45,106,0.425,35,67,0.522,10,39,0.256,12,13,0.923,112
371,NYK,2018-01-15,119,@,BRK,1,240,42,82,0.512,33,66,0.5,9,16,0.563,26,37,0.703,119,32,87,0.368,21,55,0.382,11,32,0.344,29,36,0.806,104
372,CHI,2018-01-15,119,,MIA,1,240,42,88,0.477,26,49,0.531,16,39,0.41,19,22,0.864,119,40,84,0.476,28,48,0.583,12,36,0.333,19,24,0.792,111
373,WAS,2018-01-13,119,,BRK,1,265,46,93,0.495,36,70,0.514,10,23,0.435,17,23,0.739,119,42,99,0.424,30,56,0.536,12,43,0.279,17,20,0.85,113
374,NOP,2018-01-12,119,,POR,1,240,45,82,0.549,38,63,0.603,7,19,0.368,22,23,0.957,119,45,101,0.446,33,59,0.559,12,42,0.286,11,14,0.786,113
375,ORL,2018-01-12,119,@,WAS,0,240,41,80,0.513,29,51,0.569,12,29,0.414,25,31,0.806,119,54,95,0.568,50,79,0.633,4,16,0.25,13,19,0.684,125
376,NYK,2018-01-10,119,,CHI,0,290,48,96,0.5,38,74,0.514,10,22,0.455,13,21,0.619,119,45,98,0.459,30,65,0.462,15,33,0.455,17,20,0.85,122
377,CHI,2017-12-29,119,,IND,1,240,43,85,0.506,25,46,0.543,18,39,0.462,15,15,1.0,119,43,93,0.462,36,71,0.507,7,22,0.318,14,20,0.7,107
378,SAS,2017-12-28,119,,NYK,1,240,41,80,0.513,32,60,0.533,9,20,0.45,28,39,0.718,119,41,90,0.456,36,76,0.474,5,14,0.357,20,22,0.909,107
379,BRK,2017-12-23,119,@,IND,0,265,42,98,0.429,26,62,0.419,16,36,0.444,19,25,0.76,119,47,90,0.522,37,67,0.552,10,23,0.435,19,24,0.792,123
380,BRK,2017-12-22,119,,WAS,1,240,44,88,0.5,30,47,0.638,14,41,0.341,17,21,0.81,119,34,93,0.366,29,73,0.397,5,20,0.25,11,15,0.733,84
381,MIL,2017-12-19,119,,CLE,1,240,43,82,0.524,32,53,0.604,11,29,0.379,22,27,0.815,119,40,80,0.5,24,39,0.615,16,41,0.39,20,24,0.833,116
382,OKC,2017-12-15,119,@,PHI,1,315,47,113,0.416,32,78,0.41,15,35,0.429,10,19,0.526,119,44,100,0.44,31,54,0.574,13,46,0.283,16,20,0.8,117
383,MIN,2017-12-14,119,,SAC,1,240,46,82,0.561,36,61,0.59,10,21,0.476,17,20,0.85,119,36,87,0.414,22,54,0.407,14,33,0.424,10,12,0.833,96
384,CHI,2017-12-08,119,@,CHO,1,265,48,99,0.485,42,81,0.519,6,18,0.333,17,22,0.773,119,40,100,0.4,30,71,0.423,10,29,0.345,21,29,0.724,111
385,MIN,2017-11-26,119,,PHO,1,240,49,93,0.527,40,72,0.556,9,21,0.429,12,17,0.706,119,43,85,0.506,30,59,0.508,13,26,0.5,9,12,0.75,108
386,CLE,2017-11-22,119,,BRK,1,240,43,82,0.524,29,48,0.604,14,34,0.412,19,27,0.704,119,42,81,0.519,28,44,0.636,14,37,0.378,11,16,0.688,109
387,TOR,2017-11-07,119,,CHI,1,240,44,81,0.543,31,56,0.554,13,25,0.52,18,24,0.75,119,40,80,0.5,29,51,0.569,11,29,0.379,23,28,0.821,114
388,MIL,2017-11-07,119,@,CLE,0,240,47,83,0.566,34,53,0.642,13,30,0.433,12,16,0.75,119,41,82,0.5,32,64,0.5,9,18,0.5,33,38,0.868,124
389,HOU,2017-11-03,119,@,ATL,1,240,42,89,0.472,26,42,0.619,16,47,0.34,19,23,0.826,119,39,81,0.481,28,48,0.583,11,33,0.333,15,18,0.833,104
390,PHI,2017-11-01,119,,ATL,1,240,46,99,0.465,33,64,0.516,13,35,0.371,14,25,0.56,119,41,94,0.436,33,71,0.465,8,23,0.348,19,27,0.704,109
391,HOU,2017-11-01,119,@,NYK,1,240,42,88,0.477,23,36,0.639,19,52,0.365,16,21,0.762,119,39,90,0.433,31,64,0.484,8,26,0.308,11,13,0.846,97
392,LAC,2017-11-01,119,,DAL,1,240,41,78,0.526,28,50,0.56,13,28,0.464,24,29,0.828,119,35,89,0.393,23,53,0.434,12,36,0.333,16,20,0.8,98
393,MIN,2017-10-27,119,,OKC,1,240,42,86,0.488,34,64,0.531,8,22,0.364,27,35,0.771,119,43,86,0.5,35,58,0.603,8,28,0.286,22,25,0.88,116
394,CLE,2017-10-24,119,,CHI,1,240,43,83,0.518,27,45,0.6,16,38,0.421,17,22,0.773,119,42,88,0.477,25,55,0.455,17,33,0.515,11,13,0.846,112
395,NOP,2017-10-22,119,@,LAL,1,240,47,83,0.566,37,51,0.725,10,32,0.313,15,21,0.714,119,44,90,0.489,35,63,0.556,9,27,0.333,15,20,0.75,112
396,PHI,2018-03-28,118,,NYK,1,240,45,98,0.459,36,67,0.537,9,31,0.29,19,27,0.704,118,36,94,0.383,27,63,0.429,9,31,0.29,20,26,0.769,101
397,CLE,2018-03-28,118,@,CHO,1,240,45,93,0.484,34,65,0.523,11,28,0.393,17,20,0.85,118,39,76,0.513,34,55,0.618,5,21,0.238,22,24,0.917,105
398,HOU,2018-03-27,118,,CHI,1,240,41,93,0.441,23,36,0.639,18,57,0.316,18,21,0.857,118,34,89,0.382,26,52,0.5,8,37,0.216,10,17,0.588,86
399,HOU,2018-03-25,118,,ATL,1,240,44,90,0.489,24,38,0.632,20,52,0.385,10,11,0.909,118,39,88,0.443,28,48,0.583,11,40,0.275,10,11,0.909,99
400,MIL,2018-03-23,118,@,CHI,1,240,43,87,0.494,28,57,0.491,15,30,0.5,17,19,0.895,118,36,87,0.414,24,61,0.393,12,26,0.462,21,23,0.913,105
401,PHI,2018-03-22,118,@,ORL,1,240,42,89,0.472,27,52,0.519,15,37,0.405,19,24,0.792,118,37,91,0.407,27,58,0.466,10,33,0.303,14,22,0.636,98
402,BRK,2018-03-19,118,,MEM,1,240,36,72,0.5,20,32,0.625,16,40,0.4,30,40,0.75,118,46,88,0.523,36,65,0.554,10,23,0.435,13,20,0.65,115
403,PHI,2018-03-15,118,@,NYK,1,240,41,91,0.451,26,54,0.481,15,37,0.405,21,34,0.618,118,45,87,0.517,40,67,0.597,5,20,0.25,15,24,0.625,110
404,DAL,2018-03-06,118,,DEN,1,240,43,90,0.478,28,63,0.444,15,27,0.556,17,23,0.739,118,38,92,0.413,27,56,0.482,11,36,0.306,20,26,0.769,107
405,MIL,2018-03-04,118,,PHI,1,240,47,95,0.495,37,72,0.514,10,23,0.435,14,22,0.636,118,39,70,0.557,25,42,0.595,14,28,0.5,18,22,0.818,110
406,CHO,2018-02-27,118,,CHI,1,240,44,82,0.537,29,47,0.617,15,35,0.429,15,21,0.714,118,39,81,0.481,30,57,0.526,9,24,0.375,16,21,0.762,103
407,MIN,2018-02-26,118,@,SAC,1,240,39,76,0.513,32,60,0.533,7,16,0.438,33,36,0.917,118,40,84,0.476,32,62,0.516,8,22,0.364,12,13,0.923,100
408,WAS,2018-02-14,118,@,NYK,1,240,48,88,0.545,41,66,0.621,7,22,0.318,15,19,0.789,118,45,97,0.464,36,78,0.462,9,19,0.474,14,18,0.778,113
409,NOP,2018-02-12,118,@,DET,1,240,44,100,0.44,30,66,0.455,14,34,0.412,16,16,1.0,118,35,95,0.368,26,60,0.433,9,35,0.257,24,32,0.75,103
410,ATL,2018-02-11,118,,DET,1,240,38,78,0.487,28,49,0.571,10,29,0.345,32,37,0.865,118,38,83,0.458,25,50,0.5,13,33,0.394,26,33,0.788,115
411,POR,2018-02-09,118,@,SAC,1,240,43,88,0.489,28,53,0.528,15,35,0.429,17,18,0.944,118,38,90,0.422,29,67,0.433,9,23,0.391,15,21,0.714,100
412,MIN,2018-02-03,118,,NOP,1,240,48,95,0.505,38,74,0.514,10,21,0.476,12,16,0.75,118,42,101,0.416,34,68,0.5,8,33,0.242,15,17,0.882,107
413,NYK,2018-01-25,118,@,DEN,0,240,45,82,0.549,37,61,0.607,8,21,0.381,20,24,0.833,118,48,80,0.6,34,52,0.654,14,28,0.5,20,24,0.833,130
414,LAC,2018-01-22,118,,MIN,0,240,47,84,0.56,38,57,0.667,9,27,0.333,15,22,0.682,118,43,91,0.473,36,69,0.522,7,22,0.318,33,39,0.846,126
415,POR,2018-01-16,118,,PHO,1,240,46,91,0.505,29,56,0.518,17,35,0.486,9,10,0.9,118,37,89,0.416,21,48,0.438,16,41,0.39,21,22,0.955,111
416,CHO,2018-01-15,118,@,DET,1,240,43,84,0.512,33,63,0.524,10,21,0.476,22,33,0.667,118,42,86,0.488,27,57,0.474,15,29,0.517,8,11,0.727,107
417,GSW,2018-01-15,118,@,CLE,1,240,41,85,0.482,29,53,0.547,12,32,0.375,24,30,0.8,118,43,94,0.457,36,66,0.545,7,28,0.25,15,22,0.682,108
418,NYK,2018-01-14,118,,NOP,0,265,46,97,0.474,34,63,0.54,12,34,0.353,14,18,0.778,118,45,95,0.474,36,63,0.571,9,32,0.281,24,34,0.706,123
419,MIN,2018-01-12,118,,NYK,1,240,49,95,0.516,39,68,0.574,10,27,0.37,10,16,0.625,118,45,83,0.542,33,59,0.559,12,24,0.5,6,9,0.667,108
420,HOU,2017-12-22,118,,LAC,0,240,36,78,0.462,19,38,0.5,17,40,0.425,29,35,0.829,118,43,91,0.473,25,49,0.51,18,42,0.429,24,31,0.774,128
421,DEN,2017-12-13,118,@,BOS,0,240,45,91,0.495,36,63,0.571,9,28,0.321,19,26,0.731,118,47,79,0.595,36,54,0.667,11,25,0.44,19,24,0.792,124
422,PHI,2017-12-12,118,@,MIN,1,265,40,80,0.5,29,54,0.537,11,26,0.423,27,32,0.844,118,44,108,0.407,39,79,0.494,5,29,0.172,19,27,0.704,112
423,HOU,2017-12-03,118,@,LAL,1,240,45,90,0.5,31,53,0.585,14,37,0.378,14,17,0.824,118,32,84,0.381,23,56,0.411,9,28,0.321,22,30,0.733,95
424,PHI,2017-11-29,118,,WAS,1,240,37,81,0.457,34,63,0.54,3,18,0.167,41,64,0.641,118,36,89,0.404,27,67,0.403,9,22,0.409,32,37,0.865,113
425,HOU,2017-11-29,118,,IND,1,240,42,86,0.488,24,46,0.522,18,40,0.45,16,21,0.762,118,42,88,0.477,35,60,0.583,7,28,0.25,6,6,1.0,97
426,DET,2017-11-27,118,@,BOS,1,240,44,85,0.518,33,60,0.55,11,25,0.44,19,23,0.826,118,40,77,0.519,24,44,0.545,16,33,0.485,12,21,0.571,108
427,BOS,2017-11-24,118,,ORL,1,240,42,91,0.462,25,49,0.51,17,42,0.405,17,25,0.68,118,41,95,0.432,32,71,0.451,9,24,0.375,12,19,0.632,103
428,ORL,2017-11-22,118,@,MIN,0,240,46,91,0.505,34,54,0.63,12,37,0.324,14,22,0.636,118,40,87,0.46,32,64,0.5,8,23,0.348,36,45,0.8,124
429,CHO,2017-11-20,118,,MIN,1,240,42,85,0.494,31,59,0.525,11,26,0.423,23,29,0.793,118,37,90,0.411,31,63,0.492,6,27,0.222,22,26,0.846,102
430,GSW,2017-11-19,118,@,BRK,1,240,46,90,0.511,36,66,0.545,10,24,0.417,16,23,0.696,118,34,95,0.358,18,47,0.383,16,48,0.333,27,39,0.692,111
431,CLE,2017-11-17,118,,LAC,1,265,42,90,0.467,31,57,0.544,11,33,0.333,23,29,0.793,118,46,103,0.447,36,68,0.529,10,35,0.286,11,14,0.786,113
432,BRK,2017-11-17,118,,UTA,1,240,43,84,0.512,26,47,0.553,17,37,0.459,15,20,0.75,118,39,79,0.494,27,53,0.509,12,26,0.462,17,24,0.708,107
433,HOU,2017-11-12,118,@,IND,1,240,43,90,0.478,26,43,0.605,17,47,0.362,15,18,0.833,118,37,83,0.446,29,61,0.475,8,22,0.364,13,21,0.619,95
434,PHO,2017-11-11,118,,MIN,1,240,46,86,0.535,36,60,0.6,10,26,0.385,16,24,0.667,118,39,96,0.406,35,76,0.461,4,20,0.2,28,35,0.8,110
435,NYK,2017-11-11,118,,SAC,1,240,47,90,0.522,35,63,0.556,12,27,0.444,12,15,0.8,118,30,80,0.375,23,58,0.397,7,22,0.318,24,30,0.8,91
436,NOP,2017-11-09,118,@,TOR,0,240,44,82,0.537,31,51,0.608,13,31,0.419,17,25,0.68,118,45,98,0.459,29,56,0.518,16,42,0.381,16,23,0.696,122
437,NYK,2017-11-07,118,,CHO,1,240,45,75,0.6,33,50,0.66,12,25,0.48,16,21,0.762,118,42,91,0.462,27,54,0.5,15,37,0.405,14,17,0.824,113
438,CHO,2018-04-08,117,,IND,0,240,40,80,0.5,29,50,0.58,11,30,0.367,26,30,0.867,117,50,93,0.538,41,68,0.603,9,25,0.36,14,18,0.778,123
439,DET,2018-04-08,117,@,MEM,0,240,38,93,0.409,15,46,0.326,23,47,0.489,18,23,0.783,117,48,83,0.578,32,50,0.64,16,33,0.485,18,24,0.75,130
440,GSW,2018-04-08,117,@,PHO,1,240,47,90,0.522,34,58,0.586,13,32,0.406,10,15,0.667,117,39,92,0.424,29,57,0.509,10,35,0.286,12,16,0.75,100
441,UTA,2018-04-05,117,,LAC,1,240,44,83,0.53,34,56,0.607,10,27,0.37,19,28,0.679,117,35,79,0.443,32,62,0.516,3,17,0.176,22,28,0.786,95
442,UTA,2018-04-03,117,,LAL,1,240,43,89,0.483,29,56,0.518,14,33,0.424,17,27,0.63,117,36,74,0.486,22,46,0.478,14,28,0.5,24,36,0.667,110
443,GSW,2018-04-01,117,,PHO,1,240,48,89,0.539,35,61,0.574,13,28,0.464,8,9,0.889,117,41,90,0.456,30,59,0.508,11,31,0.355,14,16,0.875,107
444,LAC,2018-03-25,117,@,TOR,1,240,44,95,0.463,36,77,0.468,8,18,0.444,21,27,0.778,117,41,92,0.446,25,56,0.446,16,36,0.444,8,14,0.571,106
445,DET,2018-03-24,117,,CHI,1,240,43,87,0.494,27,45,0.6,16,42,0.381,15,18,0.833,117,39,97,0.402,28,62,0.452,11,35,0.314,6,9,0.667,95
446,MIL,2018-03-19,117,@,CLE,0,240,45,88,0.511,37,57,0.649,8,31,0.258,19,20,0.95,117,43,87,0.494,28,49,0.571,15,38,0.395,23,27,0.852,124
447,SAS,2018-03-17,117,,MIN,1,240,49,96,0.51,43,70,0.614,6,26,0.231,13,14,0.929,117,39,81,0.481,32,69,0.464,7,12,0.583,16,20,0.8,101
448,ATL,2018-03-17,117,@,MIL,0,240,39,85,0.459,27,49,0.551,12,36,0.333,27,28,0.964,117,41,86,0.477,30,61,0.492,11,25,0.44,29,32,0.906,122
449,ATL,2018-03-15,117,,CHO,0,240,42,90,0.467,26,54,0.481,16,36,0.444,17,26,0.654,117,46,87,0.529,29,54,0.537,17,33,0.515,20,30,0.667,129
450,MIL,2018-03-14,117,@,ORL,0,240,49,98,0.5,39,74,0.527,10,24,0.417,9,12,0.75,117,44,87,0.506,26,53,0.491,18,34,0.529,20,23,0.87,126
451,GSW,2018-03-14,117,,LAL,1,240,44,81,0.543,38,61,0.623,6,20,0.3,23,28,0.821,117,38,84,0.452,26,46,0.565,12,38,0.316,18,28,0.643,106
452,BOS,2018-03-08,117,@,MIN,1,240,43,87,0.494,32,55,0.582,11,32,0.344,20,27,0.741,117,44,94,0.468,32,63,0.508,12,31,0.387,9,13,0.692,109
453,WAS,2018-03-06,117,,MIA,1,265,40,80,0.5,26,56,0.464,14,24,0.583,23,27,0.852,117,42,94,0.447,33,61,0.541,9,33,0.273,20,27,0.741,113
454,CLE,2018-03-03,117,,DEN,0,240,46,88,0.523,37,64,0.578,9,24,0.375,16,21,0.762,117,47,86,0.547,28,51,0.549,19,35,0.543,13,15,0.867,126
455,TOR,2018-02-28,117,@,ORL,1,240,45,83,0.542,33,53,0.623,12,30,0.4,15,24,0.625,117,39,82,0.476,26,52,0.5,13,30,0.433,13,23,0.565,104
456,PHO,2018-02-23,117,,LAC,0,240,45,103,0.437,36,72,0.5,9,31,0.29,18,31,0.581,117,45,87,0.517,31,55,0.564,14,32,0.438,24,32,0.75,128
457,LAL,2018-02-14,117,@,NOP,0,240,46,90,0.511,36,68,0.529,10,22,0.455,15,18,0.833,117,53,99,0.535,39,67,0.582,14,32,0.438,19,21,0.905,139
458,GSW,2018-02-14,117,@,POR,0,240,43,90,0.478,30,53,0.566,13,37,0.351,18,19,0.947,117,45,93,0.484,33,60,0.55,12,33,0.364,21,24,0.875,123
459,DEN,2018-02-13,117,,SAS,1,240,46,93,0.495,36,61,0.59,10,32,0.313,15,18,0.833,117,44,82,0.537,38,60,0.633,6,22,0.273,15,22,0.682,109
460,POR,2018-01-20,117,,DAL,1,240,45,86,0.523,27,50,0.54,18,36,0.5,9,10,0.9,117,38,83,0.458,28,58,0.483,10,25,0.4,22,28,0.786,108
461,NYK,2018-01-19,117,@,UTA,1,240,44,89,0.494,33,69,0.478,11,20,0.55,18,23,0.783,117,42,91,0.462,31,60,0.517,11,31,0.355,20,30,0.667,115
462,PHI,2018-01-15,117,,TOR,1,240,40,81,0.494,34,56,0.607,6,25,0.24,31,38,0.816,117,38,95,0.4,29,63,0.46,9,32,0.281,26,30,0.867,111
463,POR,2018-01-09,117,@,OKC,1,240,43,81,0.531,33,58,0.569,10,23,0.435,21,26,0.808,117,37,84,0.44,24,53,0.453,13,31,0.419,19,26,0.731,106
464,LAC,2018-01-04,117,,OKC,0,240,45,100,0.45,36,70,0.514,9,30,0.3,18,23,0.783,117,51,95,0.537,36,61,0.59,15,34,0.441,10,14,0.714,127
465,MIA,2017-12-30,117,@,ORL,1,240,45,88,0.511,33,64,0.516,12,24,0.5,15,18,0.833,117,44,81,0.543,32,54,0.593,12,27,0.444,11,15,0.733,111
466,BOS,2017-12-23,117,,CHI,1,240,44,92,0.478,32,60,0.533,12,32,0.375,17,21,0.81,117,34,86,0.395,27,67,0.403,7,19,0.368,17,25,0.68,92
467,ATL,2017-12-22,117,@,OKC,0,240,44,85,0.518,29,53,0.547,15,32,0.469,14,17,0.824,117,44,82,0.537,31,57,0.544,13,25,0.52,19,31,0.613,120
468,CHI,2017-12-18,117,,PHI,1,240,44,92,0.478,31,64,0.484,13,28,0.464,16,19,0.842,117,44,91,0.484,30,58,0.517,14,33,0.424,13,18,0.722,115
469,PHI,2017-12-15,117,,OKC,0,315,44,100,0.44,31,54,0.574,13,46,0.283,16,20,0.8,117,47,113,0.416,32,78,0.41,15,35,0.429,10,19,0.526,119
470,DEN,2017-12-15,117,,NOP,1,265,46,100,0.46,30,64,0.469,16,36,0.444,9,14,0.643,117,43,91,0.473,28,57,0.491,15,34,0.441,10,14,0.714,111
471,POR,2017-12-09,117,,HOU,0,240,45,88,0.511,27,47,0.574,18,41,0.439,9,12,0.75,117,40,75,0.533,30,50,0.6,10,25,0.4,34,42,0.81,124
472,MIL,2017-12-09,117,,UTA,1,240,44,81,0.543,37,64,0.578,7,17,0.412,22,26,0.846,117,33,76,0.434,25,53,0.472,8,23,0.348,26,37,0.703,100
473,ATL,2017-12-09,117,,ORL,1,240,41,80,0.513,24,47,0.511,17,33,0.515,18,25,0.72,117,45,92,0.489,32,58,0.552,13,34,0.382,7,8,0.875,110
474,SAS,2017-12-06,117,,MIA,1,240,46,87,0.529,33,62,0.532,13,25,0.52,12,14,0.857,117,39,72,0.542,21,38,0.553,18,34,0.529,9,12,0.75,105
475,HOU,2017-11-27,117,,BRK,1,240,42,86,0.488,22,36,0.611,20,50,0.4,13,20,0.65,117,40,86,0.465,30,47,0.638,10,39,0.256,13,17,0.765,103
476,HOU,2017-11-25,117,,NYK,1,240,41,94,0.436,23,47,0.489,18,47,0.383,17,22,0.773,117,42,85,0.494,38,68,0.559,4,17,0.235,14,19,0.737,102
477,HOU,2017-11-09,117,,CLE,1,240,36,77,0.468,20,31,0.645,16,46,0.348,29,36,0.806,117,45,81,0.556,33,54,0.611,12,27,0.444,11,14,0.786,113
478,NOP,2017-11-07,117,@,IND,1,240,44,87,0.506,30,52,0.577,14,35,0.4,15,22,0.682,117,44,93,0.473,35,69,0.507,9,24,0.375,15,18,0.833,112
479,ATL,2017-11-05,117,@,CLE,1,240,41,86,0.477,30,61,0.492,11,25,0.44,24,34,0.706,117,42,96,0.438,32,60,0.533,10,36,0.278,21,23,0.913,115
480,MIL,2017-10-29,117,@,ATL,1,240,44,81,0.543,31,55,0.564,13,26,0.5,16,21,0.762,117,36,77,0.468,23,48,0.479,13,29,0.448,21,26,0.808,106
481,WAS,2017-10-27,117,@,GSW,0,240,43,97,0.443,28,64,0.438,15,33,0.455,16,22,0.727,117,46,95,0.484,36,57,0.632,10,38,0.263,18,20,0.9,120
482,GSW,2017-10-25,117,,TOR,1,240,43,77,0.558,31,51,0.608,12,26,0.462,19,22,0.864,117,43,94,0.457,35,60,0.583,8,34,0.235,18,19,0.947,112
483,SAS,2017-10-25,117,@,MIA,1,240,42,76,0.553,32,59,0.542,10,17,0.588,23,30,0.767,117,37,80,0.463,28,54,0.519,9,26,0.346,17,18,0.944,100
484,PHO,2017-10-23,117,,SAC,1,240,42,77,0.545,32,47,0.681,10,30,0.333,23,27,0.852,117,43,99,0.434,34,77,0.442,9,22,0.409,20,29,0.69,115
485,TOR,2017-10-19,117,,CHI,1,240,39,83,0.47,26,54,0.481,13,29,0.448,26,28,0.929,117,37,89,0.416,27,57,0.474,10,32,0.313,16,18,0.889,100
486,ATL,2017-10-18,117,@,DAL,1,240,48,94,0.511,39,76,0.513,9,18,0.5,12,15,0.8,117,38,86,0.442,21,41,0.512,17,45,0.378,18,21,0.857,111
487,MIA,2018-04-11,116,,TOR,1,265,46,106,0.434,35,80,0.438,11,26,0.423,13,20,0.65,116,42,92,0.457,33,62,0.532,9,30,0.3,16,21,0.762,109
488,SAS,2018-04-07,116,,POR,1,240,47,84,0.56,40,63,0.635,7,21,0.333,15,21,0.714,116,42,88,0.477,31,60,0.517,11,28,0.393,10,11,0.909,105
489,MIL,2018-03-29,116,@,GSW,1,240,48,87,0.552,37,67,0.552,11,20,0.55,9,10,0.9,116,41,75,0.547,31,55,0.564,10,20,0.5,15,15,1.0,107
490,WAS,2018-03-27,116,,SAS,1,240,46,85,0.541,36,61,0.59,10,24,0.417,14,18,0.778,116,39,87,0.448,29,62,0.468,10,25,0.4,18,33,0.545,106
491,TOR,2018-03-23,116,,BRK,1,240,41,86,0.477,27,58,0.466,14,28,0.5,20,29,0.69,116,41,84,0.488,30,57,0.526,11,27,0.407,19,31,0.613,112
492,BRK,2018-03-16,116,@,PHI,0,240,40,89,0.449,25,59,0.424,15,30,0.5,21,27,0.778,116,43,95,0.453,31,68,0.456,12,27,0.444,22,26,0.846,120
493,UTA,2018-03-15,116,,PHO,1,240,42,97,0.433,30,61,0.492,12,36,0.333,20,32,0.625,116,32,83,0.386,25,67,0.373,7,16,0.438,17,24,0.708,88
494,TOR,2018-03-13,116,@,BRK,1,240,44,91,0.484,33,60,0.55,11,31,0.355,17,21,0.81,116,35,86,0.407,20,50,0.4,15,36,0.417,17,19,0.895,102
495,MIN,2018-03-13,116,@,WAS,1,240,46,87,0.529,39,66,0.591,7,21,0.333,17,19,0.895,116,42,82,0.512,34,62,0.548,8,20,0.4,19,25,0.76,111
496,UTA,2018-03-11,116,@,NOP,1,240,40,96,0.417,28,64,0.438,12,32,0.375,24,25,0.96,116,41,93,0.441,35,72,0.486,6,21,0.286,11,13,0.846,99
497,LAC,2018-03-09,116,,CLE,1,240,43,89,0.483,32,61,0.525,11,28,0.393,19,30,0.633,116,39,87,0.448,27,51,0.529,12,36,0.333,12,18,0.667,102
498,WAS,2018-03-09,116,@,NOP,1,240,46,96,0.479,37,70,0.529,9,26,0.346,15,20,0.75,116,38,82,0.463,32,62,0.516,6,20,0.3,15,18,0.833,97
499,LAL,2018-03-09,116,@,DEN,0,240,45,92,0.489,31,57,0.544,14,35,0.4,12,16,0.75,116,42,83,0.506,27,52,0.519,15,31,0.484,26,30,0.867,125
500,LAC,2018-03-06,116,,NOP,0,240,46,99,0.465,39,72,0.542,7,27,0.259,17,26,0.654,116,46,103,0.447,33,73,0.452,13,30,0.433,16,18,0.889,121
501,LAL,2018-03-03,116,@,SAS,1,240,40,92,0.435,25,58,0.431,15,34,0.441,21,27,0.778,116,44,98,0.449,37,68,0.544,7,30,0.233,17,20,0.85,112
502,UTA,2018-03-02,116,,MIN,1,240,40,78,0.513,31,49,0.633,9,29,0.31,27,35,0.771,116,38,74,0.514,29,57,0.509,9,17,0.529,23,31,0.742,108
503,PHO,2018-03-02,116,,OKC,0,240,46,96,0.479,35,71,0.493,11,25,0.44,13,18,0.722,116,46,96,0.479,35,62,0.565,11,34,0.324,21,29,0.724,124
504,SAC,2018-03-01,116,,BRK,1,265,50,97,0.515,44,83,0.53,6,14,0.429,10,12,0.833,116,40,96,0.417,23,50,0.46,17,46,0.37,14,17,0.824,111
505,SAS,2018-02-28,116,,NOP,0,240,48,99,0.485,39,73,0.534,9,26,0.346,11,14,0.786,116,50,99,0.505,41,73,0.562,9,26,0.346,12,15,0.8,121
506,POR,2018-02-27,116,,SAC,1,240,44,84,0.524,29,50,0.58,15,34,0.441,13,17,0.765,116,39,88,0.443,32,66,0.485,7,22,0.318,14,15,0.933,99
507,PHO,2018-02-26,116,@,NOP,0,240,42,97,0.433,35,73,0.479,7,24,0.292,25,32,0.781,116,43,91,0.473,35,63,0.556,8,28,0.286,31,40,0.775,125
508,PHI,2018-02-24,116,,ORL,1,240,42,81,0.519,33,54,0.611,9,27,0.333,23,27,0.852,116,38,85,0.447,25,54,0.463,13,31,0.419,16,19,0.842,105
509,IND,2018-02-23,116,,ATL,1,240,48,101,0.475,39,73,0.534,9,28,0.321,11,13,0.846,116,37,82,0.451,30,51,0.588,7,31,0.226,12,19,0.632,93
510,PHI,2018-02-22,116,@,CHI,1,240,42,82,0.512,31,53,0.585,11,29,0.379,21,35,0.6,116,44,97,0.454,26,63,0.413,18,34,0.529,9,15,0.6,115
511,ORL,2018-02-06,116,,CLE,1,240,46,88,0.523,40,66,0.606,6,22,0.273,18,27,0.667,116,36,84,0.429,24,47,0.511,12,37,0.324,14,20,0.7,98
512,BRK,2018-01-31,116,,PHI,1,240,39,77,0.506,26,45,0.578,13,32,0.406,25,28,0.893,116,36,76,0.474,29,58,0.5,7,18,0.389,29,34,0.853,108
513,MIL,2018-01-26,116,,BRK,1,240,43,83,0.518,31,60,0.517,12,23,0.522,18,20,0.9,116,33,89,0.371,25,55,0.455,8,34,0.235,17,20,0.85,91
514,IND,2018-01-24,116,,PHO,1,240,45,80,0.563,36,56,0.643,9,24,0.375,17,25,0.68,116,35,84,0.417,26,49,0.531,9,35,0.257,22,29,0.759,101
515,HOU,2018-01-20,116,,GSW,1,240,41,87,0.471,27,50,0.54,14,37,0.378,20,29,0.69,116,40,82,0.488,23,46,0.5,17,36,0.472,11,15,0.733,108
516,PHI,2018-01-20,116,,MIL,1,240,45,85,0.529,35,60,0.583,10,25,0.4,16,19,0.842,116,33,82,0.402,23,50,0.46,10,32,0.313,18,22,0.818,94
517,HOU,2018-01-18,116,,MIN,1,240,42,88,0.477,25,49,0.51,17,39,0.436,15,17,0.882,116,38,81,0.469,30,57,0.526,8,24,0.333,14,21,0.667,98
518,NOP,2018-01-16,116,@,BOS,1,265,45,100,0.45,38,73,0.521,7,27,0.259,19,25,0.76,116,40,101,0.396,21,51,0.412,19,50,0.38,14,16,0.875,113
519,HOU,2018-01-08,116,@,CHI,1,240,39,86,0.453,19,32,0.594,20,54,0.37,18,24,0.75,116,40,86,0.465,28,58,0.483,12,28,0.429,15,18,0.833,107
520,MIN,2018-01-06,116,,NOP,1,240,44,90,0.489,35,72,0.486,9,18,0.5,19,21,0.905,116,33,78,0.423,27,49,0.551,6,29,0.207,26,28,0.929,98
521,HOU,2018-01-03,116,@,ORL,1,240,42,89,0.472,27,55,0.491,15,34,0.441,17,21,0.81,116,35,91,0.385,29,60,0.483,6,31,0.194,22,25,0.88,98
522,DAL,2017-12-31,116,@,OKC,1,240,46,89,0.517,31,55,0.564,15,34,0.441,9,14,0.643,116,43,89,0.483,33,57,0.579,10,32,0.313,17,23,0.739,113
523,HOU,2017-12-20,116,,LAL,0,240,37,90,0.411,20,48,0.417,17,42,0.405,25,32,0.781,116,40,85,0.471,25,50,0.5,15,35,0.429,27,43,0.628,122
524,CLE,2017-12-19,116,@,MIL,0,240,40,80,0.5,24,39,0.615,16,41,0.39,20,24,0.833,116,43,82,0.524,32,53,0.604,11,29,0.379,22,27,0.815,119
525,WAS,2017-12-19,116,,NOP,1,240,46,92,0.5,32,57,0.561,14,35,0.4,10,14,0.714,116,34,80,0.425,29,60,0.483,5,20,0.25,33,40,0.825,106
526,GSW,2017-12-18,116,@,LAL,1,265,43,107,0.402,32,73,0.438,11,34,0.324,19,21,0.905,116,41,92,0.446,31,67,0.463,10,25,0.4,22,35,0.629,114
527,CHO,2017-12-11,116,@,OKC,1,240,43,81,0.531,30,56,0.536,13,25,0.52,17,24,0.708,116,35,85,0.412,26,59,0.441,9,26,0.346,24,25,0.96,103
528,DEN,2017-12-10,116,@,IND,0,265,43,95,0.453,26,53,0.491,17,42,0.405,13,16,0.813,116,49,93,0.527,39,68,0.574,10,25,0.4,18,22,0.818,126
529,TOR,2017-12-08,116,@,MEM,1,240,37,78,0.474,24,47,0.511,13,31,0.419,29,33,0.879,116,41,82,0.5,32,55,0.582,9,27,0.333,16,22,0.727,107
530,SAC,2017-12-08,116,@,NOP,1,265,47,97,0.485,34,67,0.507,13,30,0.433,9,14,0.643,116,41,89,0.461,31,61,0.508,10,28,0.357,17,19,0.895,109
531,UTA,2017-12-04,116,,WAS,1,240,43,76,0.566,27,42,0.643,16,34,0.471,14,18,0.778,116,23,80,0.288,19,60,0.317,4,20,0.2,19,23,0.826,69
532,POR,2017-12-02,116,,NOP,0,240,47,105,0.448,36,70,0.514,11,35,0.314,11,11,1.0,116,45,86,0.523,30,55,0.545,15,31,0.484,18,25,0.72,123
533,BOS,2017-12-02,116,,PHO,1,240,42,80,0.525,28,49,0.571,14,31,0.452,18,23,0.783,116,48,101,0.475,41,77,0.532,7,24,0.292,8,11,0.727,111
534,CLE,2017-12-02,116,,MEM,1,240,42,75,0.56,31,51,0.608,11,24,0.458,21,23,0.913,116,43,84,0.512,30,61,0.492,13,23,0.565,12,14,0.857,111
535,ATL,2017-11-24,116,,NYK,1,240,47,99,0.475,34,68,0.5,13,31,0.419,9,12,0.75,116,40,78,0.513,28,48,0.583,12,30,0.4,12,14,0.857,104
536,LAC,2017-11-22,116,@,ATL,1,240,44,76,0.579,29,46,0.63,15,30,0.5,13,19,0.684,116,40,83,0.482,30,54,0.556,10,29,0.345,13,15,0.867,103
537,CLE,2017-11-20,116,@,DET,1,240,42,80,0.525,26,47,0.553,16,33,0.485,16,17,0.941,116,34,77,0.442,21,47,0.447,13,30,0.433,7,13,0.538,88
538,PHI,2017-11-18,116,,GSW,0,240,47,97,0.485,37,68,0.544,10,29,0.345,12,16,0.75,116,50,91,0.549,43,68,0.632,7,23,0.304,17,20,0.85,124
539,PHO,2017-11-16,116,,HOU,0,240,47,104,0.452,37,74,0.5,10,30,0.333,12,21,0.571,116,43,90,0.478,22,46,0.478,21,44,0.477,35,38,0.921,142
540,NOP,2017-11-15,116,,TOR,0,240,46,91,0.505,36,64,0.563,10,27,0.37,14,14,1.0,116,45,76,0.592,29,42,0.69,16,34,0.471,19,20,0.95,125
541,IND,2017-11-15,116,@,MEM,1,240,43,85,0.506,31,61,0.508,12,24,0.5,18,20,0.9,116,44,86,0.512,36,54,0.667,8,32,0.25,17,22,0.773,113
542,WAS,2017-11-01,116,,PHO,0,240,41,92,0.446,31,62,0.5,10,30,0.333,24,30,0.8,116,41,83,0.494,32,59,0.542,9,24,0.375,31,38,0.816,122
543,NYK,2017-10-30,116,,DEN,1,240,41,82,0.5,28,50,0.56,13,32,0.406,21,23,0.913,116,35,85,0.412,17,44,0.386,18,41,0.439,22,31,0.71,110
544,OKC,2017-10-27,116,@,MIN,0,240,43,86,0.5,35,58,0.603,8,28,0.286,22,25,0.88,116,42,86,0.488,34,64,0.531,8,22,0.364,27,35,0.771,119
545,BRK,2017-10-22,116,,ATL,1,240,41,87,0.471,30,60,0.5,11,27,0.407,23,34,0.676,116,32,94,0.34,25,67,0.373,7,27,0.259,33,36,0.917,104
546,CLE,2017-10-20,116,@,MIL,1,240,44,81,0.543,33,55,0.6,11,26,0.423,17,17,1.0,116,38,82,0.463,27,47,0.574,11,35,0.314,10,12,0.833,97
547,ORL,2017-10-18,116,,MIA,1,240,43,90,0.478,35,69,0.507,8,21,0.381,22,29,0.759,116,44,101,0.436,36,71,0.507,8,30,0.267,13,17,0.765,109
548,LAL,2018-04-11,115,@,LAC,1,240,42,88,0.477,25,49,0.51,17,39,0.436,14,16,0.875,115,41,83,0.494,35,65,0.538,6,18,0.333,12,28,0.429,100
549,OKC,2018-04-09,115,@,MIA,1,240,35,81,0.432,21,46,0.457,14,35,0.4,31,38,0.816,115,40,87,0.46,35,65,0.538,5,22,0.227,8,14,0.571,93
550,MIL,2018-04-07,115,@,NYK,1,240,45,93,0.484,35,68,0.515,10,25,0.4,15,17,0.882,115,41,95,0.432,32,74,0.432,9,21,0.429,11,11,1.0,102
551,LAC,2018-04-07,115,,DEN,0,240,43,87,0.494,37,70,0.529,6,17,0.353,23,34,0.676,115,53,85,0.624,41,56,0.732,12,29,0.414,16,23,0.696,134
552,WAS,2018-04-05,115,@,CLE,0,240,47,94,0.5,38,73,0.521,9,21,0.429,12,14,0.857,115,42,77,0.545,29,50,0.58,13,27,0.481,22,28,0.786,119
553,MIA,2018-04-04,115,@,ATL,1,240,42,94,0.447,25,56,0.446,17,38,0.447,14,17,0.824,115,33,90,0.367,24,60,0.4,9,30,0.3,11,17,0.647,86
554,PHI,2018-04-04,115,@,DET,1,240,44,89,0.494,31,59,0.525,13,30,0.433,14,19,0.737,115,39,88,0.443,23,52,0.442,16,36,0.444,14,23,0.609,108
555,DAL,2018-04-03,115,,POR,1,240,42,92,0.457,25,48,0.521,17,44,0.386,14,20,0.7,115,39,87,0.448,29,47,0.617,10,40,0.25,21,24,0.875,109
556,DET,2018-03-31,115,@,NYK,1,240,44,85,0.518,34,61,0.557,10,24,0.417,17,22,0.773,115,43,91,0.473,30,62,0.484,13,29,0.448,10,12,0.833,109
557,NOP,2018-03-20,115,,DAL,1,240,48,91,0.527,38,66,0.576,10,25,0.4,9,15,0.6,115,43,90,0.478,33,55,0.6,10,35,0.286,9,11,0.818,105
558,HOU,2018-03-20,115,@,POR,1,240,38,79,0.481,19,43,0.442,19,36,0.528,20,29,0.69,115,40,81,0.494,29,53,0.547,11,28,0.393,20,27,0.741,111
559,DET,2018-03-20,115,@,PHO,1,240,43,97,0.443,28,61,0.459,15,36,0.417,14,16,0.875,115,34,90,0.378,27,56,0.482,7,34,0.206,13,20,0.65,88
560,MEM,2018-03-19,115,@,BRK,0,240,46,88,0.523,36,65,0.554,10,23,0.435,13,20,0.65,115,36,72,0.5,20,32,0.625,16,40,0.4,30,40,0.75,118
561,DAL,2018-03-16,115,@,TOR,0,265,48,91,0.527,42,69,0.609,6,22,0.273,13,18,0.722,115,43,91,0.473,33,61,0.541,10,30,0.333,26,31,0.839,122
562,CHO,2018-03-13,115,@,NOP,0,240,45,93,0.484,38,67,0.567,7,26,0.269,18,22,0.818,115,52,104,0.5,43,82,0.524,9,22,0.409,6,8,0.75,119
563,POR,2018-03-12,115,,MIA,1,240,38,83,0.458,24,47,0.511,14,36,0.389,25,30,0.833,115,39,91,0.429,29,60,0.483,10,31,0.323,11,16,0.688,99
564,PHO,2018-03-10,115,@,CHO,0,240,42,83,0.506,24,51,0.471,18,32,0.563,13,19,0.684,115,44,87,0.506,31,55,0.564,13,32,0.406,21,27,0.778,122
565,OKC,2018-03-08,115,,PHO,1,240,42,80,0.525,29,47,0.617,13,33,0.394,18,27,0.667,115,31,92,0.337,22,55,0.4,9,37,0.243,16,18,0.889,87
566,ORL,2018-03-02,115,,DET,1,265,44,86,0.512,31,50,0.62,13,36,0.361,14,19,0.737,115,40,92,0.435,28,63,0.444,12,29,0.414,14,24,0.583,106
567,MIA,2018-02-24,115,,MEM,1,240,41,89,0.461,29,56,0.518,12,33,0.364,21,27,0.778,115,35,80,0.438,30,69,0.435,5,11,0.455,14,17,0.824,89
568,CHI,2018-02-22,115,,PHI,0,240,44,97,0.454,26,63,0.413,18,34,0.529,9,15,0.6,115,42,82,0.512,31,53,0.585,11,29,0.379,21,35,0.6,116
569,TOR,2018-02-13,115,,MIA,1,240,42,90,0.467,29,55,0.527,13,35,0.371,18,23,0.783,115,42,86,0.488,30,57,0.526,12,29,0.414,16,19,0.842,112
570,UTA,2018-02-11,115,@,POR,1,240,41,88,0.466,28,62,0.452,13,26,0.5,20,22,0.909,115,33,81,0.407,24,56,0.429,9,25,0.36,21,25,0.84,96
571,DET,2018-02-11,115,@,ATL,0,240,38,83,0.458,25,50,0.5,13,33,0.394,26,33,0.788,115,38,78,0.487,28,49,0.571,10,29,0.345,32,37,0.865,118
572,DET,2018-02-07,115,,BRK,1,240,44,92,0.478,35,68,0.515,9,24,0.375,18,25,0.72,115,39,90,0.433,22,39,0.564,17,51,0.333,11,12,0.917,106
573,PHI,2018-02-06,115,,WAS,1,240,45,82,0.549,31,54,0.574,14,28,0.5,11,14,0.786,115,41,93,0.441,34,66,0.515,7,27,0.259,13,18,0.722,102
574,CHO,2018-02-04,115,@,PHO,1,240,40,96,0.417,30,58,0.517,10,38,0.263,25,29,0.862,115,41,77,0.532,26,48,0.542,15,29,0.517,13,13,1.0,110
575,DEN,2018-02-03,115,,GSW,1,240,39,91,0.429,27,62,0.435,12,29,0.414,25,29,0.862,115,43,86,0.5,35,55,0.636,8,31,0.258,14,23,0.609,108
576,WAS,2018-02-03,115,@,ORL,1,240,46,85,0.541,39,59,0.661,7,26,0.269,16,18,0.889,115,34,77,0.442,24,45,0.533,10,32,0.313,20,22,0.909,98
577,CLE,2018-01-26,115,,IND,1,240,46,82,0.561,33,45,0.733,13,37,0.351,10,13,0.769,115,43,91,0.473,30,60,0.5,13,31,0.419,9,11,0.818,108
578,NOP,2018-01-26,115,,HOU,1,240,44,82,0.537,33,55,0.6,11,27,0.407,16,21,0.762,115,36,78,0.462,24,42,0.571,12,36,0.333,29,35,0.829,113
579,PHI,2018-01-24,115,,CHI,1,240,42,81,0.519,26,49,0.531,16,32,0.5,15,20,0.75,115,36,94,0.383,25,57,0.439,11,37,0.297,18,22,0.818,101
580,MIN,2018-01-20,115,,TOR,1,240,38,81,0.469,31,65,0.477,7,16,0.438,32,42,0.762,115,39,83,0.47,27,50,0.54,12,33,0.364,19,21,0.905,109
581,UTA,2018-01-19,115,,NYK,0,240,42,91,0.462,31,60,0.517,11,31,0.355,20,30,0.667,115,44,89,0.494,33,69,0.478,11,20,0.55,18,23,0.783,117
582,SAC,2018-01-11,115,,LAC,0,240,42,85,0.494,34,59,0.576,8,26,0.308,23,28,0.821,115,43,84,0.512,30,53,0.566,13,31,0.419,22,30,0.733,121
583,DAL,2018-01-10,115,@,CHO,1,240,39,83,0.47,24,47,0.511,15,36,0.417,22,28,0.786,115,43,84,0.512,33,58,0.569,10,26,0.385,15,30,0.5,111
584,CHI,2018-01-03,115,,TOR,0,240,43,93,0.462,30,60,0.5,13,33,0.394,16,19,0.842,115,45,92,0.489,30,54,0.556,15,38,0.395,19,19,1.0,124
585,CHI,2017-12-26,115,@,MIL,1,240,45,103,0.437,35,75,0.467,10,28,0.357,15,25,0.6,115,39,83,0.47,29,52,0.558,10,31,0.323,18,24,0.75,106
586,MEM,2017-12-23,115,,LAC,1,240,40,90,0.444,27,59,0.458,13,31,0.419,22,25,0.88,115,39,79,0.494,26,45,0.578,13,34,0.382,21,28,0.75,112
587,MIN,2017-12-23,115,@,PHO,1,240,42,84,0.5,36,68,0.529,6,16,0.375,25,29,0.862,115,40,86,0.465,29,54,0.537,11,32,0.344,15,24,0.625,106
588,CLE,2017-12-21,115,,CHI,1,240,42,82,0.512,30,53,0.566,12,29,0.414,19,22,0.864,115,47,85,0.553,35,54,0.648,12,31,0.387,6,8,0.75,112
589,PHI,2017-12-18,115,@,CHI,0,240,44,91,0.484,30,58,0.517,14,33,0.424,13,18,0.722,115,44,92,0.478,31,64,0.484,13,28,0.464,16,19,0.842,117
590,HOU,2017-12-16,115,,MIL,1,240,35,76,0.461,24,41,0.585,11,35,0.314,34,42,0.81,115,38,82,0.463,30,55,0.545,8,27,0.296,27,33,0.818,111
591,CHI,2017-12-15,115,@,MIL,1,240,42,86,0.488,34,64,0.531,8,22,0.364,23,35,0.657,115,40,83,0.482,31,50,0.62,9,33,0.273,20,29,0.69,109
592,NOP,2017-12-13,115,,MIL,1,240,45,80,0.563,32,55,0.582,13,25,0.52,12,15,0.8,115,44,95,0.463,36,68,0.529,8,27,0.296,12,19,0.632,108
593,TOR,2017-12-13,115,@,PHO,1,240,40,92,0.435,31,66,0.47,9,26,0.346,26,31,0.839,115,37,83,0.446,29,59,0.492,8,24,0.333,27,34,0.794,109
594,NOP,2017-12-04,115,,GSW,0,240,45,91,0.495,29,52,0.558,16,39,0.41,9,15,0.6,115,45,87,0.517,29,54,0.537,16,33,0.485,19,27,0.704,125
595,PHO,2017-12-04,115,@,PHI,1,240,44,91,0.484,34,69,0.493,10,22,0.455,17,22,0.773,115,39,91,0.429,32,61,0.525,7,30,0.233,16,16,1.0,101
596,IND,2017-12-04,115,,NYK,1,240,46,86,0.535,35,60,0.583,11,26,0.423,12,15,0.8,115,40,91,0.44,34,68,0.5,6,23,0.261,11,16,0.688,97
597,DEN,2017-12-02,115,,LAL,1,240,40,87,0.46,28,56,0.5,12,31,0.387,23,28,0.821,115,38,86,0.442,29,56,0.518,9,30,0.3,15,21,0.714,100
598,IND,2017-12-01,115,@,TOR,0,240,45,102,0.441,37,76,0.487,8,26,0.308,17,22,0.773,115,48,97,0.495,38,65,0.585,10,32,0.313,14,21,0.667,120
599,NYK,2017-11-29,115,,MIA,1,240,44,73,0.603,39,60,0.65,5,13,0.385,22,26,0.846,115,32,84,0.381,22,46,0.478,10,38,0.263,12,20,0.6,86
600,SAS,2017-11-27,115,,DAL,1,240,43,82,0.524,33,58,0.569,10,24,0.417,19,21,0.905,115,41,85,0.482,27,53,0.509,14,32,0.438,12,17,0.706,108
601,LAL,2017-11-27,115,@,LAC,0,240,44,91,0.484,33,61,0.541,11,30,0.367,16,24,0.667,115,41,85,0.482,31,57,0.544,10,28,0.357,28,30,0.933,120
602,NOP,2017-11-24,115,@,PHO,1,240,45,91,0.495,36,64,0.563,9,27,0.333,16,22,0.727,115,37,94,0.394,35,74,0.473,2,20,0.1,15,18,0.833,91
603,PHI,2017-11-15,115,@,LAL,1,240,42,86,0.488,35,54,0.648,7,32,0.219,24,30,0.8,115,42,109,0.385,39,82,0.476,3,27,0.111,22,27,0.815,109
604,CLE,2017-11-15,115,@,CHO,1,240,42,95,0.442,29,57,0.509,13,38,0.342,18,20,0.9,115,41,86,0.477,35,60,0.583,6,26,0.231,19,28,0.679,107
605,PHO,2017-11-08,115,,MIA,0,240,40,88,0.455,28,59,0.475,12,29,0.414,23,30,0.767,115,43,81,0.531,31,51,0.608,12,30,0.4,28,35,0.8,126
606,CLE,2017-11-05,115,,ATL,0,240,42,96,0.438,32,60,0.533,10,36,0.278,21,23,0.913,115,41,86,0.477,30,61,0.492,11,25,0.44,24,34,0.706,117
607,ORL,2017-10-30,115,@,NOP,1,240,43,85,0.506,27,51,0.529,16,34,0.471,13,18,0.722,115,39,85,0.459,32,57,0.561,7,28,0.25,14,18,0.778,99
608,PHI,2017-10-30,115,@,HOU,1,240,44,80,0.55,34,56,0.607,10,24,0.417,17,24,0.708,115,33,83,0.398,20,36,0.556,13,47,0.277,28,38,0.737,107
609,DET,2017-10-29,115,@,GSW,1,240,43,93,0.462,31,66,0.47,12,27,0.444,17,17,1.0,115,44,77,0.571,34,50,0.68,10,27,0.37,9,12,0.75,107
610,SAC,2017-10-23,115,@,PHO,0,240,43,99,0.434,34,77,0.442,9,22,0.409,20,29,0.69,115,42,77,0.545,32,47,0.681,10,30,0.333,23,27,0.852,117
611,MIN,2017-10-22,115,@,OKC,1,240,43,86,0.5,33,61,0.541,10,25,0.4,19,23,0.826,115,46,96,0.479,35,65,0.538,11,31,0.355,10,16,0.625,113
612,WAS,2017-10-20,115,,DET,1,240,40,75,0.533,34,58,0.586,6,17,0.353,29,35,0.829,115,43,87,0.494,33,64,0.516,10,23,0.435,15,20,0.75,111
613,PHI,2017-10-18,115,@,WAS,0,240,43,93,0.462,28,58,0.483,15,35,0.429,14,19,0.737,115,42,97,0.433,36,75,0.48,6,22,0.273,30,38,0.789,120
614,BRK,2018-04-09,114,,CHI,1,240,41,82,0.5,23,40,0.575,18,42,0.429,14,15,0.933,114,43,89,0.483,31,61,0.508,12,28,0.429,7,12,0.583,105
615,CHO,2018-04-03,114,@,CHI,0,240,40,81,0.494,27,47,0.574,13,34,0.382,21,28,0.75,114,46,99,0.465,31,65,0.477,15,34,0.441,13,18,0.722,120
616,ATL,2018-03-28,114,@,MIN,0,240,41,77,0.532,28,50,0.56,13,27,0.481,19,23,0.826,114,48,90,0.533,35,60,0.583,13,30,0.433,17,21,0.81,126
617,TOR,2018-03-27,114,,DEN,1,240,47,92,0.511,34,58,0.586,13,34,0.382,7,9,0.778,114,42,89,0.472,29,59,0.492,13,30,0.433,13,14,0.929,110
618,BRK,2018-03-25,114,,CLE,0,240,38,83,0.458,21,46,0.457,17,37,0.459,21,26,0.808,114,44,87,0.506,32,59,0.542,12,28,0.429,21,26,0.808,121
619,HOU,2018-03-24,114,,NOP,1,240,45,93,0.484,27,46,0.587,18,47,0.383,6,8,0.75,114,38,96,0.396,32,75,0.427,6,21,0.286,9,12,0.75,91
620,CLE,2018-03-17,114,@,CHI,1,240,44,87,0.506,31,50,0.62,13,37,0.351,13,20,0.65,114,41,91,0.451,25,57,0.439,16,34,0.471,11,15,0.733,109
621,BRK,2018-03-17,114,,DAL,1,240,43,84,0.512,29,48,0.604,14,36,0.389,14,19,0.737,114,41,92,0.446,29,70,0.414,12,22,0.545,12,14,0.857,106
622,DAL,2018-03-10,114,,MEM,1,240,37,77,0.481,27,48,0.563,10,29,0.345,30,35,0.857,114,30,84,0.357,23,66,0.348,7,18,0.389,13,17,0.765,80
623,NOP,2018-03-07,114,@,SAC,1,240,47,83,0.566,36,57,0.632,11,26,0.423,9,9,1.0,114,39,93,0.419,30,65,0.462,9,28,0.321,14,17,0.824,101
624,CHO,2018-03-06,114,,PHI,0,240,40,80,0.5,29,51,0.569,11,29,0.379,23,31,0.742,114,50,87,0.575,34,54,0.63,16,33,0.485,12,15,0.8,128
625,GSW,2018-03-06,114,,BRK,1,240,47,83,0.566,36,60,0.6,11,23,0.478,9,11,0.818,114,36,85,0.424,27,51,0.529,9,34,0.265,20,25,0.8,101
626,GSW,2018-03-02,114,@,ATL,1,240,42,79,0.532,31,48,0.646,11,31,0.355,19,22,0.864,114,38,86,0.442,23,51,0.451,15,35,0.429,18,20,0.9,109
627,CHO,2018-02-25,114,,DET,1,240,42,88,0.477,26,53,0.491,16,35,0.457,14,23,0.609,114,42,85,0.494,38,67,0.567,4,18,0.222,10,14,0.714,98
628,DEN,2018-02-25,114,,HOU,0,240,44,91,0.484,34,62,0.548,10,29,0.345,16,24,0.667,114,39,77,0.506,24,42,0.571,15,35,0.429,26,32,0.813,119
629,MEM,2018-02-14,114,,OKC,0,240,44,86,0.512,30,59,0.508,14,27,0.519,12,15,0.8,114,40,81,0.494,23,44,0.523,17,37,0.459,24,35,0.686,121
630,SAC,2018-02-13,114,@,DAL,1,240,47,87,0.54,35,58,0.603,12,29,0.414,8,12,0.667,114,38,83,0.458,23,43,0.535,15,40,0.375,18,23,0.783,109
631,LAC,2018-02-12,114,@,BRK,1,240,48,85,0.565,42,69,0.609,6,16,0.375,12,14,0.857,114,41,89,0.461,29,49,0.592,12,40,0.3,7,10,0.7,101
632,CHI,2018-02-09,114,,MIN,1,240,41,83,0.494,32,57,0.561,9,26,0.346,23,30,0.767,114,41,87,0.471,33,65,0.508,8,22,0.364,23,28,0.821,113
633,NOP,2018-02-02,114,@,OKC,1,240,46,90,0.511,33,66,0.5,13,24,0.542,9,13,0.692,114,37,97,0.381,28,61,0.459,9,36,0.25,17,20,0.85,100
634,SAC,2018-01-30,114,@,NOP,1,240,46,97,0.474,36,71,0.507,10,26,0.385,12,14,0.857,114,39,77,0.506,30,52,0.577,9,25,0.36,16,22,0.727,103
635,HOU,2018-01-30,114,,ORL,1,240,39,77,0.506,26,42,0.619,13,35,0.371,23,28,0.821,114,42,83,0.506,27,52,0.519,15,31,0.484,8,10,0.8,107
636,CLE,2018-01-30,114,@,DET,0,240,38,84,0.452,25,49,0.51,13,35,0.371,25,32,0.781,114,49,93,0.527,40,70,0.571,9,23,0.391,18,28,0.643,125
637,IND,2018-01-27,114,,ORL,1,240,47,87,0.54,42,69,0.609,5,18,0.278,15,19,0.789,114,42,77,0.545,34,52,0.654,8,25,0.32,20,32,0.625,112
638,MIN,2018-01-24,114,@,POR,0,240,45,84,0.536,39,68,0.574,6,16,0.375,18,22,0.818,114,45,82,0.549,28,51,0.549,17,31,0.548,16,21,0.762,123
639,SAS,2018-01-23,114,,CLE,1,240,47,94,0.5,39,66,0.591,8,28,0.286,12,16,0.75,114,35,72,0.486,29,51,0.569,6,21,0.286,26,31,0.839,102
640,OKC,2018-01-17,114,,LAL,1,240,46,95,0.484,34,60,0.567,12,35,0.343,10,12,0.833,114,38,81,0.469,28,55,0.509,10,26,0.385,4,4,1.0,90
641,LAL,2018-01-15,114,@,MEM,0,240,38,96,0.396,26,61,0.426,12,35,0.343,26,31,0.839,114,42,82,0.512,32,60,0.533,10,22,0.455,29,34,0.853,123
642,BOS,2018-01-11,114,@,PHI,1,240,43,89,0.483,30,54,0.556,13,35,0.371,15,19,0.789,114,38,82,0.463,27,54,0.5,11,28,0.393,16,18,0.889,103
643,DET,2018-01-10,114,@,BRK,1,240,48,93,0.516,38,72,0.528,10,21,0.476,8,12,0.667,114,27,74,0.365,15,37,0.405,12,37,0.324,14,15,0.933,80
644,MIA,2018-01-10,114,@,IND,1,240,43,81,0.531,30,51,0.588,13,30,0.433,15,21,0.714,114,43,87,0.494,42,69,0.609,1,18,0.056,19,29,0.655,106
645,DAL,2018-01-09,114,,ORL,1,240,43,83,0.518,34,57,0.596,9,26,0.346,19,22,0.864,114,36,79,0.456,25,50,0.5,11,29,0.379,16,22,0.727,99
646,DEN,2018-01-08,114,@,GSW,0,240,47,95,0.495,39,76,0.513,8,19,0.421,12,16,0.75,114,48,85,0.565,35,55,0.636,13,30,0.433,15,21,0.714,124
647,TOR,2018-01-08,114,@,BRK,1,265,43,101,0.426,33,67,0.493,10,34,0.294,18,23,0.783,114,39,100,0.39,27,67,0.403,12,33,0.364,23,28,0.821,113
648,PHO,2018-01-07,114,,OKC,1,240,39,88,0.443,22,49,0.449,17,39,0.436,19,23,0.826,114,40,86,0.465,32,59,0.542,8,27,0.296,12,21,0.571,100
649,PHI,2018-01-05,114,,DET,1,240,44,90,0.489,30,60,0.5,14,30,0.467,12,13,0.923,114,30,78,0.385,23,56,0.411,7,22,0.318,11,19,0.579,78
650,HOU,2018-01-04,114,,GSW,0,240,42,89,0.472,25,39,0.641,17,50,0.34,13,22,0.591,114,48,87,0.552,35,57,0.614,13,30,0.433,15,20,0.75,124
651,MIN,2018-01-01,114,,LAL,1,240,40,81,0.494,33,61,0.541,7,20,0.35,27,30,0.9,114,34,76,0.447,26,50,0.52,8,26,0.308,20,29,0.69,96
652,WAS,2017-12-31,114,,CHI,1,240,43,93,0.462,27,57,0.474,16,36,0.444,12,17,0.706,114,42,92,0.457,34,57,0.596,8,35,0.229,18,22,0.818,110
653,MEM,2017-12-31,114,@,SAC,1,240,41,76,0.539,27,46,0.587,14,30,0.467,18,24,0.75,114,37,86,0.43,28,62,0.452,9,24,0.375,13,25,0.52,96
654,POR,2017-12-28,114,,PHI,1,240,35,75,0.467,27,51,0.529,8,24,0.333,36,47,0.766,114,42,87,0.483,26,55,0.473,16,32,0.5,10,14,0.714,110
655,TOR,2017-12-21,114,@,PHI,1,240,35,85,0.412,23,50,0.46,12,35,0.343,32,35,0.914,114,45,86,0.523,36,57,0.632,9,29,0.31,10,14,0.714,109
656,LAL,2017-12-18,114,,GSW,0,265,41,92,0.446,31,67,0.463,10,25,0.4,22,35,0.629,114,43,107,0.402,32,73,0.438,11,34,0.324,19,21,0.905,116
657,DET,2017-12-17,114,,ORL,1,240,42,89,0.472,25,55,0.455,17,34,0.5,13,16,0.813,114,41,85,0.482,24,52,0.462,17,33,0.515,11,17,0.647,110
658,ATL,2017-12-12,114,@,CLE,0,240,43,92,0.467,27,56,0.482,16,36,0.444,12,13,0.923,114,48,86,0.558,28,48,0.583,20,38,0.526,7,10,0.7,123
659,DEN,2017-12-06,114,@,NOP,0,240,41,94,0.436,25,59,0.424,16,35,0.457,16,22,0.727,114,46,86,0.535,34,55,0.618,12,31,0.387,19,29,0.655,123
660,ATL,2017-12-02,114,@,BRK,1,240,47,99,0.475,37,72,0.514,10,27,0.37,10,14,0.714,114,34,82,0.415,17,40,0.425,17,42,0.405,17,21,0.81,102
661,UTA,2017-12-01,114,,NOP,1,240,42,85,0.494,30,55,0.545,12,30,0.4,18,25,0.72,114,42,87,0.483,27,57,0.474,15,30,0.5,9,15,0.6,108
662,ATL,2017-11-30,114,,CLE,0,240,41,79,0.519,29,48,0.604,12,31,0.387,20,24,0.833,114,41,79,0.519,23,40,0.575,18,39,0.462,21,27,0.778,121
663,NOP,2017-11-20,114,,OKC,1,240,41,80,0.513,34,55,0.618,7,25,0.28,25,32,0.781,114,38,89,0.427,27,54,0.5,11,35,0.314,20,26,0.769,107
664,DEN,2017-11-20,114,@,SAC,1,240,42,86,0.488,27,54,0.5,15,32,0.469,15,20,0.75,114,41,86,0.477,33,66,0.5,8,20,0.4,8,9,0.889,98
665,NOP,2017-11-17,114,@,DEN,0,240,48,91,0.527,36,58,0.621,12,33,0.364,6,10,0.6,114,56,89,0.629,38,54,0.704,18,35,0.514,16,21,0.762,146
666,PHI,2017-11-11,114,@,GSW,0,240,44,94,0.468,32,66,0.485,12,28,0.429,14,20,0.7,114,48,82,0.585,34,55,0.618,14,27,0.519,25,26,0.962,135
667,UTA,2017-11-11,114,,BRK,1,240,41,85,0.482,30,56,0.536,11,29,0.379,21,25,0.84,114,35,76,0.461,28,53,0.528,7,23,0.304,29,39,0.744,106
668,DET,2017-11-08,114,,IND,1,240,43,83,0.518,31,56,0.554,12,27,0.444,16,25,0.64,114,38,88,0.432,31,64,0.484,7,24,0.292,14,18,0.778,97
669,CHI,2017-11-07,114,@,TOR,0,240,40,80,0.5,29,51,0.569,11,29,0.379,23,28,0.821,114,44,81,0.543,31,56,0.554,13,25,0.52,18,24,0.75,119
670,BRK,2017-10-31,114,,PHO,0,240,42,102,0.412,33,71,0.465,9,31,0.29,21,30,0.7,114,45,96,0.469,35,74,0.473,10,22,0.455,22,24,0.917,122
671,NYK,2017-10-29,114,@,CLE,1,240,42,89,0.472,29,61,0.475,13,28,0.464,17,21,0.81,114,31,81,0.383,21,48,0.438,10,33,0.303,23,27,0.852,95
672,POR,2017-10-28,114,,PHO,1,240,40,91,0.44,29,65,0.446,11,26,0.423,23,28,0.821,114,37,87,0.425,28,61,0.459,9,26,0.346,24,30,0.8,107
673,ORL,2017-10-27,114,,SAS,1,240,48,84,0.571,37,61,0.607,11,23,0.478,7,14,0.5,114,30,89,0.337,26,65,0.4,4,24,0.167,23,27,0.852,87
674,NOP,2017-10-26,114,@,SAC,1,240,42,86,0.488,29,54,0.537,13,32,0.406,17,23,0.739,114,38,81,0.469,31,61,0.508,7,20,0.35,23,25,0.92,106
675,OKC,2017-10-25,114,,IND,1,240,43,89,0.483,33,62,0.532,10,27,0.37,18,26,0.692,114,28,83,0.337,18,54,0.333,10,29,0.345,30,35,0.857,96
676,ORL,2017-10-21,114,@,CLE,1,240,40,90,0.444,23,55,0.418,17,35,0.486,17,20,0.85,114,33,86,0.384,26,61,0.426,7,25,0.28,20,27,0.741,93
677,POR,2017-10-20,114,@,IND,1,240,46,95,0.484,37,76,0.487,9,19,0.474,13,17,0.765,114,35,78,0.449,31,60,0.517,4,18,0.222,22,33,0.667,96
678,WAS,2018-04-10,113,,BOS,1,240,41,83,0.494,26,53,0.491,15,30,0.5,16,20,0.8,113,33,87,0.379,20,54,0.37,13,33,0.394,22,27,0.815,101
679,ATL,2018-04-10,113,,PHI,0,240,41,98,0.418,28,61,0.459,13,37,0.351,18,26,0.692,113,43,87,0.494,26,50,0.52,17,37,0.459,18,30,0.6,121
680,MIN,2018-04-09,113,,MEM,1,240,42,87,0.483,35,65,0.538,7,22,0.318,22,26,0.846,113,35,85,0.412,30,67,0.448,5,18,0.278,19,21,0.905,94
681,NOP,2018-04-09,113,@,LAC,1,240,44,95,0.463,33,65,0.508,11,30,0.367,14,20,0.7,113,45,98,0.459,43,81,0.531,2,17,0.118,8,19,0.421,100
682,MIN,2018-04-06,113,@,LAL,1,240,43,100,0.43,35,74,0.473,8,26,0.308,19,26,0.731,113,31,79,0.392,23,55,0.418,8,24,0.333,26,32,0.813,96
683,DET,2018-04-06,113,,DAL,1,265,46,92,0.5,34,62,0.548,12,30,0.4,9,17,0.529,113,40,92,0.435,27,53,0.509,13,39,0.333,13,18,0.722,106
684,LAC,2018-04-03,113,,SAS,1,240,37,82,0.451,32,66,0.485,5,16,0.313,34,43,0.791,113,39,88,0.443,31,64,0.484,8,24,0.333,24,28,0.857,110
685,CHI,2018-04-01,113,,WAS,1,240,43,82,0.524,25,48,0.521,18,34,0.529,9,13,0.692,113,37,81,0.457,29,51,0.569,8,30,0.267,12,12,1.0,94
686,POR,2018-04-01,113,,MEM,1,240,39,84,0.464,27,46,0.587,12,38,0.316,23,25,0.92,113,40,88,0.455,31,67,0.463,9,21,0.429,9,12,0.75,98
687,IND,2018-03-25,113,,MIA,1,265,44,90,0.489,36,67,0.537,8,23,0.348,17,21,0.81,113,41,86,0.477,27,51,0.529,14,35,0.4,11,14,0.786,107
688,LAC,2018-03-16,113,@,OKC,0,240,42,86,0.488,31,60,0.517,11,26,0.423,18,23,0.783,113,46,94,0.489,35,62,0.565,11,32,0.344,18,22,0.818,121
689,DET,2018-03-15,113,@,DEN,0,240,44,92,0.478,30,65,0.462,14,27,0.519,11,17,0.647,113,43,85,0.506,31,57,0.544,12,28,0.429,22,28,0.786,120
690,POR,2018-03-15,113,,CLE,1,240,43,96,0.448,31,61,0.508,12,35,0.343,15,19,0.789,113,41,80,0.513,30,47,0.638,11,33,0.333,12,21,0.571,105
691,CLE,2018-03-11,113,@,LAL,0,240,41,88,0.466,29,57,0.509,12,31,0.387,19,23,0.826,113,48,96,0.5,35,62,0.565,13,34,0.382,18,20,0.9,127
692,LAC,2018-03-10,113,,ORL,1,240,41,78,0.526,34,60,0.567,7,18,0.389,24,28,0.857,113,38,84,0.452,30,60,0.5,8,24,0.333,21,27,0.778,105
693,CLE,2018-03-07,113,@,DEN,1,240,44,87,0.506,31,58,0.534,13,29,0.448,12,18,0.667,113,42,86,0.488,32,59,0.542,10,27,0.37,14,18,0.778,108
694,MIA,2018-03-06,113,@,WAS,0,265,42,94,0.447,33,61,0.541,9,33,0.273,20,27,0.741,113,40,80,0.5,26,56,0.464,14,24,0.583,23,27,0.852,117
695,ATL,2018-03-04,113,,PHO,1,240,43,94,0.457,26,61,0.426,17,33,0.515,10,12,0.833,113,46,92,0.5,35,66,0.53,11,26,0.423,9,15,0.6,112
696,MIA,2018-03-01,113,,LAL,0,240,46,95,0.484,37,64,0.578,9,31,0.29,12,16,0.75,113,47,79,0.595,31,50,0.62,16,29,0.552,21,26,0.808,131
697,LAL,2018-02-24,113,@,SAC,1,240,41,91,0.451,24,53,0.453,17,38,0.447,14,20,0.7,113,42,94,0.447,29,69,0.42,13,25,0.52,11,17,0.647,108
698,ORL,2018-02-22,113,,NYK,0,240,43,83,0.518,32,59,0.542,11,24,0.458,16,23,0.696,113,48,99,0.485,41,74,0.554,7,25,0.28,17,21,0.81,120
699,NYK,2018-02-14,113,,WAS,0,240,45,97,0.464,36,78,0.462,9,19,0.474,14,18,0.778,113,48,88,0.545,41,66,0.621,7,22,0.318,15,19,0.789,118
700,NYK,2018-02-11,113,@,IND,0,240,41,93,0.441,32,58,0.552,9,35,0.257,22,25,0.88,113,47,94,0.5,35,66,0.53,12,28,0.429,15,22,0.682,121
701,PHO,2018-02-10,113,,DEN,0,240,46,84,0.548,39,65,0.6,7,19,0.368,14,25,0.56,113,45,88,0.511,32,59,0.542,13,29,0.448,20,22,0.909,123
702,MIN,2018-02-09,113,@,CHI,0,240,41,87,0.471,33,65,0.508,8,22,0.364,23,28,0.821,113,41,83,0.494,32,57,0.561,9,26,0.346,23,30,0.767,114
703,TOR,2018-02-08,113,,NYK,1,240,43,95,0.453,27,52,0.519,16,43,0.372,11,14,0.786,113,33,83,0.398,26,56,0.464,7,27,0.259,15,18,0.833,88
704,BRK,2018-02-06,113,,HOU,0,240,41,85,0.482,25,50,0.5,16,35,0.457,15,17,0.882,113,45,81,0.556,29,48,0.604,16,33,0.485,17,21,0.81,123
705,LAC,2018-02-03,113,,CHI,1,240,40,88,0.455,31,63,0.492,9,25,0.36,24,28,0.857,113,35,97,0.361,23,60,0.383,12,37,0.324,21,21,1.0,103
706,HOU,2018-01-28,113,,PHO,1,240,32,72,0.444,21,35,0.6,11,37,0.297,38,49,0.776,113,36,85,0.424,28,52,0.538,8,33,0.242,22,26,0.846,102
707,SAS,2018-01-28,113,,SAC,1,240,45,90,0.5,34,65,0.523,11,25,0.44,12,17,0.706,113,35,82,0.427,17,48,0.354,18,34,0.529,10,11,0.909,98
708,HOU,2018-01-26,113,@,NOP,0,240,36,78,0.462,24,42,0.571,12,36,0.333,29,35,0.829,113,44,82,0.537,33,55,0.6,11,27,0.407,16,21,0.762,115
709,MIN,2018-01-25,113,@,GSW,0,240,46,101,0.455,40,81,0.494,6,20,0.3,15,18,0.833,113,48,89,0.539,27,52,0.519,21,37,0.568,9,15,0.6,126
710,BOS,2018-01-24,113,@,LAC,1,240,39,93,0.419,25,53,0.472,14,40,0.35,21,22,0.955,113,35,79,0.443,30,58,0.517,5,21,0.238,27,39,0.692,102
711,LAC,2018-01-20,113,@,UTA,0,240,36,82,0.439,25,46,0.543,11,36,0.306,30,38,0.789,113,45,82,0.549,34,54,0.63,11,28,0.393,24,32,0.75,125
712,CHI,2018-01-20,113,@,ATL,1,240,40,80,0.5,26,48,0.542,14,32,0.438,19,21,0.905,113,35,92,0.38,24,44,0.545,11,48,0.229,16,23,0.696,97
713,BOS,2018-01-16,113,,NOP,0,265,40,101,0.396,21,51,0.412,19,50,0.38,14,16,0.875,113,45,100,0.45,38,73,0.521,7,27,0.259,19,25,0.76,116
714,LAC,2018-01-15,113,,HOU,1,240,44,79,0.557,34,54,0.63,10,25,0.4,15,20,0.75,113,38,94,0.404,25,50,0.5,13,44,0.295,13,16,0.813,102
715,BRK,2018-01-13,113,@,WAS,0,265,42,99,0.424,30,56,0.536,12,43,0.279,17,20,0.85,113,46,93,0.495,36,70,0.514,10,23,0.435,17,23,0.739,119
716,POR,2018-01-12,113,@,NOP,0,240,45,101,0.446,33,59,0.559,12,42,0.286,11,14,0.786,113,45,82,0.549,38,63,0.603,7,19,0.368,22,23,0.957,119
717,BRK,2018-01-08,113,,TOR,0,265,39,100,0.39,27,67,0.403,12,33,0.364,23,28,0.821,113,43,101,0.426,33,67,0.493,10,34,0.294,18,23,0.783,114
718,ATL,2018-01-07,113,@,LAL,0,240,41,94,0.436,29,60,0.483,12,34,0.353,19,23,0.826,113,48,86,0.558,32,50,0.64,16,36,0.444,20,25,0.8,132
719,LAC,2018-01-02,113,,MEM,1,240,39,71,0.549,30,48,0.625,9,23,0.391,26,31,0.839,113,38,79,0.481,30,53,0.566,8,26,0.308,21,33,0.636,105
720,OKC,2017-12-31,113,,DAL,0,240,43,89,0.483,33,57,0.579,10,32,0.313,17,23,0.739,113,46,89,0.517,31,55,0.564,15,34,0.441,9,14,0.643,116
721,ATL,2017-12-27,113,,WAS,1,240,41,94,0.436,30,57,0.526,11,37,0.297,20,29,0.69,113,35,81,0.432,26,57,0.456,9,24,0.375,20,26,0.769,99
722,BRK,2017-12-27,113,@,NOP,0,240,41,90,0.456,22,52,0.423,19,38,0.5,12,14,0.857,113,48,90,0.533,31,57,0.544,17,33,0.515,15,19,0.789,128
723,GSW,2017-12-22,113,,LAL,1,240,42,85,0.494,35,61,0.574,7,24,0.292,22,27,0.815,113,40,94,0.426,29,65,0.446,11,29,0.379,15,22,0.682,106
724,MIA,2017-12-22,113,,DAL,1,240,46,72,0.639,30,47,0.638,16,25,0.64,5,6,0.833,113,38,75,0.507,21,40,0.525,17,35,0.486,8,11,0.727,101
725,NYK,2017-12-12,113,,LAL,1,265,48,101,0.475,39,79,0.494,9,22,0.409,8,11,0.727,113,42,102,0.412,29,67,0.433,13,35,0.371,12,15,0.8,109
726,LAC,2017-12-09,113,,WAS,1,240,39,80,0.488,25,48,0.521,14,32,0.438,21,24,0.875,113,42,82,0.512,29,50,0.58,13,32,0.406,15,23,0.652,112
727,MIN,2017-12-06,113,@,LAC,1,240,45,82,0.549,38,63,0.603,7,19,0.368,16,21,0.762,113,44,99,0.444,34,67,0.507,10,32,0.313,9,15,0.6,107
728,PHO,2017-12-05,113,@,TOR,0,240,37,75,0.493,28,51,0.549,9,24,0.375,30,38,0.789,113,44,92,0.478,29,56,0.518,15,36,0.417,23,26,0.885,126
729,CLE,2017-12-04,113,@,CHI,1,240,42,81,0.519,29,45,0.644,13,36,0.361,16,17,0.941,113,34,82,0.415,25,48,0.521,9,34,0.265,14,18,0.778,91
730,CHO,2017-11-29,113,@,TOR,0,240,37,79,0.468,28,60,0.467,9,19,0.474,30,35,0.857,113,52,98,0.531,38,66,0.576,14,32,0.438,8,11,0.727,126
731,WAS,2017-11-29,113,@,PHI,0,240,36,89,0.404,27,67,0.403,9,22,0.409,32,37,0.865,113,37,81,0.457,34,63,0.54,3,18,0.167,41,64,0.641,118
732,CLE,2017-11-27,113,@,PHI,1,240,41,86,0.477,26,49,0.531,15,37,0.405,16,20,0.8,113,36,96,0.375,33,68,0.485,3,28,0.107,16,20,0.8,91
733,SAC,2017-11-22,113,,LAL,1,240,47,85,0.553,37,64,0.578,10,21,0.476,9,14,0.643,113,39,78,0.5,24,49,0.49,15,29,0.517,9,15,0.6,102
734,MIL,2017-11-22,113,@,PHO,1,265,42,97,0.433,34,68,0.5,8,29,0.276,21,31,0.677,113,37,93,0.398,30,71,0.423,7,22,0.318,26,33,0.788,107
735,PHO,2017-11-19,113,,CHI,1,240,45,89,0.506,38,62,0.613,7,27,0.259,16,22,0.727,113,42,101,0.416,30,65,0.462,12,36,0.333,9,14,0.643,105
736,LAL,2017-11-17,113,,PHO,0,240,45,91,0.495,38,66,0.576,7,25,0.28,16,24,0.667,113,48,103,0.466,35,71,0.493,13,32,0.406,13,19,0.684,122
737,LAC,2017-11-17,113,@,CLE,0,265,46,103,0.447,36,68,0.529,10,35,0.286,11,14,0.786,113,42,90,0.467,31,57,0.544,11,33,0.333,23,29,0.793,118
738,MEM,2017-11-15,113,,IND,0,240,44,86,0.512,36,54,0.667,8,32,0.25,17,22,0.773,113,43,85,0.506,31,61,0.508,12,24,0.5,18,20,0.9,116
739,HOU,2017-11-14,113,,TOR,0,240,33,79,0.418,21,40,0.525,12,39,0.308,35,41,0.854,113,41,78,0.526,27,48,0.563,14,30,0.467,33,42,0.786,129
740,WAS,2017-11-11,113,,ATL,1,240,42,78,0.538,35,54,0.648,7,24,0.292,22,28,0.786,113,34,83,0.41,20,50,0.4,14,33,0.424,12,17,0.706,94
741,CLE,2017-11-09,113,@,HOU,0,240,45,81,0.556,33,54,0.611,12,27,0.444,11,14,0.786,113,36,77,0.468,20,31,0.645,16,46,0.348,29,36,0.806,117
742,CHO,2017-11-07,113,@,NYK,0,240,42,91,0.462,27,54,0.5,15,37,0.405,14,17,0.824,113,45,75,0.6,33,50,0.66,12,25,0.48,16,21,0.762,118
743,DAL,2017-11-07,113,@,WAS,1,240,43,91,0.473,32,61,0.525,11,30,0.367,16,20,0.8,113,32,75,0.427,22,50,0.44,10,25,0.4,25,32,0.781,99
744,MEM,2017-11-04,113,@,LAC,1,240,40,84,0.476,27,53,0.509,13,31,0.419,20,24,0.833,113,38,83,0.458,34,57,0.596,4,26,0.154,24,31,0.774,104
745,POR,2017-11-02,113,,LAL,1,240,40,86,0.465,31,64,0.484,9,22,0.409,24,27,0.889,113,43,79,0.544,39,61,0.639,4,18,0.222,20,27,0.741,110
746,BOS,2017-11-01,113,,SAC,1,240,40,82,0.488,23,41,0.561,17,41,0.415,16,19,0.842,113,35,81,0.432,29,61,0.475,6,20,0.3,10,12,0.833,86
747,LAL,2017-10-31,113,,DET,1,240,45,91,0.495,33,65,0.508,12,26,0.462,11,14,0.786,113,41,94,0.436,31,61,0.508,10,33,0.303,1,3,0.333,93
748,LAC,2017-10-30,113,,GSW,0,240,39,86,0.453,29,61,0.475,10,25,0.4,25,30,0.833,113,52,89,0.584,38,60,0.633,14,29,0.483,23,30,0.767,141
749,ORL,2017-10-29,113,@,CHO,0,240,41,97,0.423,30,64,0.469,11,33,0.333,20,26,0.769,113,53,97,0.546,47,79,0.595,6,18,0.333,8,17,0.471,120
750,OKC,2017-10-22,113,,MIN,0,240,46,96,0.479,35,65,0.538,11,31,0.355,10,16,0.625,113,43,86,0.5,33,61,0.541,10,25,0.4,19,23,0.826,115
751,MIL,2017-10-21,113,,POR,1,240,42,80,0.525,35,62,0.565,7,18,0.389,22,30,0.733,113,34,81,0.42,23,53,0.434,11,28,0.393,31,35,0.886,110
752,MIN,2018-04-11,112,,DEN,1,265,42,89,0.472,33,66,0.5,9,23,0.391,19,25,0.76,112,41,90,0.456,28,58,0.483,13,32,0.406,11,18,0.611,106
753,ATL,2018-04-08,112,@,BOS,1,240,43,86,0.5,28,51,0.549,15,35,0.429,11,14,0.786,112,42,82,0.512,33,59,0.559,9,23,0.391,13,20,0.65,106
754,UTA,2018-04-08,112,@,LAL,1,240,42,83,0.506,29,47,0.617,13,36,0.361,15,22,0.682,112,37,93,0.398,32,68,0.471,5,25,0.2,18,22,0.818,97
755,TOR,2018-04-08,112,,ORL,1,240,39,78,0.5,22,38,0.579,17,40,0.425,17,24,0.708,112,42,89,0.472,35,66,0.53,7,23,0.304,10,17,0.588,101
756,SAS,2018-04-04,112,@,LAL,0,265,42,97,0.433,33,74,0.446,9,23,0.391,19,27,0.704,112,47,86,0.547,34,62,0.548,13,24,0.542,15,18,0.833,122
757,CLE,2018-04-03,112,,TOR,1,240,38,77,0.494,25,47,0.532,13,30,0.433,23,26,0.885,112,42,94,0.447,31,60,0.517,11,34,0.324,11,14,0.786,106
758,GSW,2018-03-31,112,@,SAC,1,240,41,83,0.494,32,57,0.561,9,26,0.346,21,28,0.75,112,36,87,0.414,28,59,0.475,8,28,0.286,16,19,0.842,96
759,DET,2018-03-26,112,,LAL,1,240,44,100,0.44,31,67,0.463,13,33,0.394,11,15,0.733,112,40,85,0.471,34,62,0.548,6,23,0.261,20,25,0.8,106
760,BRK,2018-03-23,112,@,TOR,0,240,41,84,0.488,30,57,0.526,11,27,0.407,19,31,0.613,112,41,86,0.477,27,58,0.466,14,28,0.5,20,29,0.69,116
761,DAL,2018-03-22,112,,UTA,0,240,42,85,0.494,25,53,0.472,17,32,0.531,11,14,0.786,112,46,87,0.529,34,58,0.586,12,29,0.414,15,16,0.938,119
762,LAC,2018-03-13,112,@,CHI,1,240,37,76,0.487,29,47,0.617,8,29,0.276,30,41,0.732,112,43,101,0.426,36,72,0.5,7,29,0.241,13,15,0.867,106
763,LAL,2018-03-13,112,,DEN,1,240,40,90,0.444,25,50,0.5,15,40,0.375,17,25,0.68,112,38,86,0.442,25,46,0.543,13,40,0.325,14,19,0.737,103
764,IND,2018-03-09,112,,ATL,1,240,45,91,0.495,31,63,0.492,14,28,0.5,8,10,0.8,112,34,82,0.415,24,49,0.49,10,33,0.303,9,10,0.9,87
765,NYK,2018-03-09,112,@,MIL,0,240,47,98,0.48,40,70,0.571,7,28,0.25,11,14,0.786,112,41,73,0.562,33,55,0.6,8,18,0.444,30,39,0.769,120
766,OKC,2018-03-06,112,,HOU,0,240,46,93,0.495,34,59,0.576,12,34,0.353,8,11,0.727,112,38,72,0.528,21,39,0.538,17,33,0.515,29,34,0.853,122
767,CLE,2018-03-05,112,,DET,1,240,43,88,0.489,31,55,0.564,12,33,0.364,14,17,0.824,112,34,87,0.391,22,53,0.415,12,34,0.353,10,15,0.667,90
768,PHO,2018-03-04,112,@,ATL,0,240,46,92,0.5,35,66,0.53,11,26,0.423,9,15,0.6,112,43,94,0.457,26,61,0.426,17,33,0.515,10,12,0.833,113
769,SAS,2018-03-03,112,,LAL,0,240,44,98,0.449,37,68,0.544,7,30,0.233,17,20,0.85,112,40,92,0.435,25,58,0.431,15,34,0.441,21,27,0.778,116
770,OKC,2018-02-26,112,,ORL,1,240,42,88,0.477,31,63,0.492,11,25,0.44,17,20,0.85,112,39,84,0.464,27,55,0.491,12,29,0.414,15,21,0.714,105
771,GSW,2018-02-24,112,,OKC,1,240,42,89,0.472,25,51,0.49,17,38,0.447,11,13,0.846,112,29,88,0.33,20,54,0.37,9,34,0.265,13,21,0.619,80
772,NYK,2018-02-24,112,,BOS,0,240,45,96,0.469,39,69,0.565,6,27,0.222,16,20,0.8,112,42,93,0.452,29,60,0.483,13,33,0.394,24,28,0.857,121
773,CLE,2018-02-23,112,@,MEM,1,240,40,87,0.46,29,58,0.5,11,29,0.379,21,22,0.955,112,33,84,0.393,24,60,0.4,9,24,0.375,14,18,0.778,89
774,OKC,2018-02-13,112,,CLE,0,240,40,90,0.444,29,55,0.527,11,35,0.314,21,30,0.7,112,45,88,0.511,29,52,0.558,16,36,0.444,14,22,0.636,120
775,MIA,2018-02-13,112,@,TOR,0,240,42,86,0.488,30,57,0.526,12,29,0.414,16,19,0.842,112,42,90,0.467,29,55,0.527,13,35,0.371,18,23,0.783,115
776,PHI,2018-02-10,112,,LAC,1,240,43,90,0.478,30,57,0.526,13,33,0.394,13,17,0.765,112,38,88,0.432,30,56,0.536,8,32,0.25,14,23,0.609,98
777,LAL,2018-02-06,112,,PHO,1,240,39,83,0.47,28,57,0.491,11,26,0.423,23,26,0.885,112,36,94,0.383,28,65,0.431,8,29,0.276,13,23,0.565,93
778,PHI,2018-01-28,112,@,OKC,0,240,38,76,0.5,27,47,0.574,11,29,0.379,25,31,0.806,112,45,92,0.489,35,59,0.593,10,33,0.303,22,30,0.733,122
779,LAC,2018-01-28,112,@,NOP,1,240,45,96,0.469,36,68,0.529,9,28,0.321,13,18,0.722,112,38,85,0.447,29,50,0.58,9,35,0.257,18,25,0.72,103
780,ORL,2018-01-27,112,@,IND,0,240,42,77,0.545,34,52,0.654,8,25,0.32,20,32,0.625,112,47,87,0.54,42,69,0.609,5,18,0.278,15,19,0.789,114
781,WAS,2018-01-25,112,@,OKC,0,240,42,86,0.488,26,51,0.51,16,35,0.457,12,16,0.75,112,45,87,0.517,36,60,0.6,9,27,0.333,22,29,0.759,121
782,NYK,2018-01-23,112,@,GSW,0,240,43,83,0.518,34,61,0.557,9,22,0.409,17,19,0.895,112,46,83,0.554,33,53,0.623,13,30,0.433,18,20,0.9,123
783,CHO,2018-01-22,112,,SAC,1,240,38,86,0.442,22,46,0.478,16,40,0.4,20,25,0.8,112,43,97,0.443,33,75,0.44,10,22,0.455,11,15,0.733,107
784,DET,2018-01-19,112,,WAS,0,240,40,80,0.5,30,50,0.6,10,30,0.333,22,26,0.846,112,41,82,0.5,25,47,0.532,16,35,0.457,24,27,0.889,122
785,CHI,2018-01-17,112,,GSW,0,240,45,106,0.425,35,67,0.522,10,39,0.256,12,13,0.923,112,42,84,0.5,29,51,0.569,13,33,0.394,22,25,0.88,119
786,SAS,2018-01-13,112,,DEN,1,240,41,79,0.519,27,52,0.519,14,27,0.519,16,18,0.889,112,29,83,0.349,22,55,0.4,7,28,0.25,15,17,0.882,80
787,HOU,2018-01-12,112,@,PHO,1,240,39,94,0.415,24,47,0.511,15,47,0.319,19,22,0.864,112,37,80,0.463,23,47,0.489,14,33,0.424,7,9,0.778,95
788,POR,2018-01-10,112,@,HOU,0,240,40,83,0.482,31,57,0.544,9,26,0.346,23,32,0.719,112,45,100,0.45,33,62,0.532,12,38,0.316,19,25,0.76,121
789,NOP,2018-01-08,112,,DET,1,240,46,82,0.561,40,60,0.667,6,22,0.273,14,21,0.667,112,41,93,0.441,33,66,0.5,8,27,0.296,19,22,0.864,109
790,PHI,2018-01-03,112,,SAS,1,240,36,80,0.45,29,58,0.5,7,22,0.318,33,43,0.767,112,39,87,0.448,31,62,0.5,8,25,0.32,20,23,0.87,106
791,OKC,2017-12-25,112,,HOU,1,240,43,79,0.544,35,61,0.574,8,18,0.444,18,23,0.783,112,35,81,0.432,23,44,0.523,12,37,0.324,25,31,0.806,107
792,ATL,2017-12-23,112,,DAL,1,240,42,75,0.56,32,51,0.627,10,24,0.417,18,22,0.818,112,43,85,0.506,34,52,0.654,9,33,0.273,12,15,0.8,107
793,LAC,2017-12-23,112,@,MEM,0,240,39,79,0.494,26,45,0.578,13,34,0.382,21,28,0.75,112,40,90,0.444,27,59,0.458,13,31,0.419,22,25,0.88,115
794,CHI,2017-12-21,112,@,CLE,0,240,47,85,0.553,35,54,0.648,12,31,0.387,6,8,0.75,112,42,82,0.512,30,53,0.566,12,29,0.414,19,22,0.864,115
795,CHI,2017-12-20,112,,ORL,1,240,44,87,0.506,33,55,0.6,11,32,0.344,13,14,0.929,112,35,89,0.393,30,62,0.484,5,27,0.185,19,23,0.826,94
796,MIN,2017-12-20,112,@,DEN,1,240,43,87,0.494,35,63,0.556,8,24,0.333,18,19,0.947,112,36,72,0.5,23,44,0.523,13,28,0.464,19,24,0.792,104
797,BOS,2017-12-18,112,@,IND,1,240,44,79,0.557,28,53,0.528,16,26,0.615,8,14,0.571,112,37,79,0.468,30,58,0.517,7,21,0.333,30,38,0.789,111
798,LAL,2017-12-14,112,@,CLE,0,240,47,95,0.495,38,64,0.594,9,31,0.29,9,14,0.643,112,43,86,0.5,28,50,0.56,15,36,0.417,20,25,0.8,121
799,GSW,2017-12-14,112,,DAL,1,240,47,78,0.603,36,56,0.643,11,22,0.5,7,9,0.778,112,37,82,0.451,27,53,0.509,10,29,0.345,13,17,0.765,97
800,MIN,2017-12-12,112,,PHI,0,265,44,108,0.407,39,79,0.494,5,29,0.172,19,27,0.704,112,40,80,0.5,29,54,0.537,11,26,0.423,27,32,0.844,118
801,WAS,2017-12-09,112,@,LAC,0,240,42,82,0.512,29,50,0.58,13,32,0.406,15,23,0.652,112,39,80,0.488,25,48,0.521,14,32,0.438,21,24,0.875,113
802,HOU,2017-12-07,112,@,UTA,1,240,38,81,0.469,20,39,0.513,18,42,0.429,18,24,0.75,112,34,77,0.442,23,47,0.489,11,30,0.367,22,27,0.815,101
803,MIN,2017-12-03,112,,LAC,1,240,38,88,0.432,30,62,0.484,8,26,0.308,28,31,0.903,112,37,73,0.507,22,39,0.564,15,34,0.441,17,22,0.773,106
804,ORL,2017-12-01,112,,GSW,0,240,44,96,0.458,33,68,0.485,11,28,0.393,13,18,0.722,112,55,88,0.625,43,64,0.672,12,24,0.5,11,11,1.0,133
805,MIL,2017-11-28,112,@,SAC,1,240,42,71,0.592,33,49,0.673,9,22,0.409,19,31,0.613,112,31,77,0.403,26,60,0.433,5,17,0.294,20,29,0.69,87
806,TOR,2017-11-25,112,@,ATL,1,240,46,84,0.548,33,52,0.635,13,32,0.406,7,9,0.778,112,26,75,0.347,20,48,0.417,6,27,0.222,20,23,0.87,78
807,DET,2017-11-12,112,,MIA,1,240,42,87,0.483,28,59,0.475,14,28,0.5,14,20,0.7,112,39,90,0.433,26,53,0.491,13,37,0.351,12,16,0.75,103
808,OKC,2017-11-12,112,,DAL,1,240,36,72,0.5,21,40,0.525,15,32,0.469,25,33,0.758,112,37,87,0.425,26,50,0.52,11,37,0.297,14,18,0.778,99
809,PHO,2017-11-10,112,,ORL,0,240,44,94,0.468,39,70,0.557,5,24,0.208,19,25,0.76,112,43,82,0.524,30,54,0.556,13,28,0.464,29,43,0.674,128
810,ORL,2017-11-08,112,,NYK,1,240,43,80,0.538,30,52,0.577,13,28,0.464,13,22,0.591,112,42,80,0.525,37,68,0.544,5,12,0.417,10,13,0.769,99
811,IND,2017-11-07,112,,NOP,0,240,44,93,0.473,35,69,0.507,9,24,0.375,15,18,0.833,112,44,87,0.506,30,52,0.577,14,35,0.4,15,22,0.682,117
812,DEN,2017-11-07,112,,BRK,1,240,44,93,0.473,35,59,0.593,9,34,0.265,15,20,0.75,112,38,89,0.427,27,54,0.5,11,35,0.314,17,22,0.773,104
813,MIN,2017-11-05,112,,CHO,1,240,38,83,0.458,28,59,0.475,10,24,0.417,26,30,0.867,112,37,89,0.416,28,61,0.459,9,28,0.321,11,21,0.524,94
814,SAS,2017-11-05,112,,PHO,1,240,44,88,0.5,33,66,0.5,11,22,0.5,13,18,0.722,112,37,81,0.457,29,58,0.5,8,23,0.348,13,22,0.591,95
815,MIN,2017-11-04,112,,DAL,1,240,43,79,0.544,33,55,0.6,10,24,0.417,16,20,0.8,112,40,87,0.46,30,60,0.5,10,27,0.37,9,12,0.75,99
816,BRK,2017-11-03,112,@,LAL,0,240,37,91,0.407,28,53,0.528,9,38,0.237,29,38,0.763,112,48,94,0.511,39,73,0.534,9,21,0.429,19,27,0.704,124
817,GSW,2017-11-02,112,@,SAS,1,240,43,83,0.518,29,55,0.527,14,28,0.5,12,16,0.75,112,34,87,0.391,27,63,0.429,7,24,0.292,17,23,0.739,92
818,UTA,2017-11-01,112,,POR,1,265,34,90,0.378,21,61,0.344,13,29,0.448,31,36,0.861,112,37,93,0.398,28,59,0.475,9,34,0.265,20,27,0.741,103
819,PHI,2017-10-28,112,@,DAL,1,240,43,87,0.494,27,52,0.519,16,35,0.457,10,14,0.714,112,38,74,0.514,19,34,0.559,19,40,0.475,15,19,0.789,110
820,BRK,2017-10-25,112,,CLE,1,240,40,93,0.43,23,47,0.489,17,46,0.37,15,21,0.714,112,39,81,0.481,27,46,0.587,12,35,0.343,17,26,0.654,107
821,TOR,2017-10-25,112,@,GSW,0,240,43,94,0.457,35,60,0.583,8,34,0.235,18,19,0.947,112,43,77,0.558,31,51,0.608,12,26,0.462,19,22,0.864,117
822,CHI,2017-10-24,112,@,CLE,0,240,42,88,0.477,25,55,0.455,17,33,0.515,11,13,0.846,112,43,83,0.518,27,45,0.6,16,38,0.421,17,22,0.773,119
823,LAL,2017-10-22,112,,NOP,0,240,44,90,0.489,35,63,0.556,9,27,0.333,15,20,0.75,112,47,83,0.566,37,51,0.725,10,32,0.313,15,21,0.714,119
824,MIA,2017-10-21,112,,IND,1,240,45,87,0.517,31,53,0.585,14,34,0.412,8,14,0.571,112,43,96,0.448,36,77,0.468,7,19,0.368,15,21,0.714,108
825,BOS,2018-04-06,111,,CHI,1,240,45,81,0.556,31,47,0.66,14,34,0.412,7,17,0.412,111,40,86,0.465,26,56,0.464,14,30,0.467,10,17,0.588,104
826,MIL,2018-04-05,111,,BRK,0,240,41,93,0.441,36,73,0.493,5,20,0.25,24,30,0.8,111,41,75,0.547,22,36,0.611,19,39,0.487,18,21,0.857,119
827,GSW,2018-04-03,111,@,OKC,1,240,41,83,0.494,33,54,0.611,8,29,0.276,21,24,0.875,111,35,93,0.376,26,55,0.473,9,38,0.237,28,37,0.757,107
828,IND,2018-04-01,111,@,LAC,1,240,42,86,0.488,31,58,0.534,11,28,0.393,16,21,0.762,111,42,82,0.512,33,57,0.579,9,25,0.36,11,14,0.786,104
829,LAC,2018-03-28,111,@,PHO,1,240,43,80,0.538,35,63,0.556,8,17,0.471,17,25,0.68,111,38,88,0.432,28,54,0.519,10,34,0.294,13,18,0.722,99
830,BRK,2018-03-28,111,@,ORL,1,240,40,87,0.46,28,53,0.528,12,34,0.353,19,22,0.864,111,40,92,0.435,29,61,0.475,11,31,0.355,13,16,0.813,104
831,CHO,2018-03-21,111,@,BRK,1,240,36,94,0.383,33,78,0.423,3,16,0.188,36,47,0.766,111,39,93,0.419,26,56,0.464,13,37,0.351,14,21,0.667,105
832,POR,2018-03-20,111,,HOU,0,240,40,81,0.494,29,53,0.547,11,28,0.393,20,27,0.741,111,38,79,0.481,19,43,0.442,19,36,0.528,20,29,0.69,115
833,CHI,2018-03-15,111,@,MEM,1,240,35,80,0.438,20,39,0.513,15,41,0.366,26,33,0.788,111,38,87,0.437,25,52,0.481,13,35,0.371,21,25,0.84,110
834,WAS,2018-03-13,111,,MIN,0,240,42,82,0.512,34,62,0.548,8,20,0.4,19,25,0.76,111,46,87,0.529,39,66,0.591,7,21,0.333,17,19,0.895,116
835,CHO,2018-03-08,111,,BRK,0,240,41,85,0.482,37,66,0.561,4,19,0.211,25,30,0.833,111,47,92,0.511,36,60,0.6,11,32,0.344,20,22,0.909,125
836,POR,2018-03-06,111,,NYK,1,240,35,81,0.432,15,48,0.313,20,33,0.606,21,24,0.875,111,35,83,0.422,28,64,0.438,7,19,0.368,10,15,0.667,87
837,BRK,2018-03-01,111,@,SAC,0,265,40,96,0.417,23,50,0.46,17,46,0.37,14,17,0.824,111,50,97,0.515,44,83,0.53,6,14,0.429,10,12,0.833,116
838,OKC,2018-02-28,111,@,DAL,1,265,42,93,0.452,32,57,0.561,10,36,0.278,17,19,0.895,111,44,91,0.484,31,55,0.564,13,36,0.361,9,15,0.6,110
839,NYK,2018-02-26,111,,GSW,0,240,47,96,0.49,37,71,0.521,10,25,0.4,7,9,0.778,111,44,85,0.518,29,54,0.537,15,31,0.484,22,26,0.846,125
840,CHO,2018-02-22,111,,BRK,1,240,42,87,0.483,31,66,0.47,11,21,0.524,16,20,0.8,111,36,93,0.387,22,50,0.44,14,43,0.326,10,14,0.714,96
841,LAL,2018-02-15,111,@,MIN,0,240,43,94,0.457,36,63,0.571,7,31,0.226,18,26,0.692,111,42,90,0.467,36,66,0.545,6,24,0.25,29,31,0.935,119
842,MIN,2018-02-11,111,,SAC,1,240,37,74,0.5,28,50,0.56,9,24,0.375,28,32,0.875,111,42,88,0.477,32,63,0.508,10,25,0.4,12,17,0.706,106
843,MIL,2018-02-10,111,@,ORL,1,240,43,82,0.524,34,57,0.596,9,25,0.36,16,20,0.8,111,37,83,0.446,29,53,0.547,8,30,0.267,22,26,0.846,104
844,TOR,2018-02-06,111,,BOS,1,240,40,80,0.5,23,44,0.523,17,36,0.472,14,17,0.824,111,33,83,0.398,23,60,0.383,10,23,0.435,15,20,0.75,91
845,WAS,2018-02-05,111,@,IND,1,240,45,82,0.549,38,57,0.667,7,25,0.28,14,17,0.824,111,37,80,0.463,25,51,0.49,12,29,0.414,16,25,0.64,102
846,DET,2018-02-05,111,,POR,1,240,44,88,0.5,29,58,0.5,15,30,0.5,8,12,0.667,111,37,94,0.394,27,61,0.443,10,33,0.303,7,8,0.875,91
847,ORL,2018-02-05,111,@,MIA,1,240,41,84,0.488,28,54,0.519,13,30,0.433,16,19,0.842,111,40,93,0.43,37,70,0.529,3,23,0.13,26,35,0.743,109
848,DET,2018-02-03,111,,MIA,1,240,44,84,0.524,35,58,0.603,9,26,0.346,14,17,0.824,111,44,91,0.484,30,55,0.545,14,36,0.389,5,7,0.714,107
849,SAS,2018-02-03,111,,UTA,0,240,44,91,0.484,34,65,0.523,10,26,0.385,13,18,0.722,111,39,69,0.565,27,46,0.587,12,23,0.522,30,36,0.833,120
850,NYK,2018-01-30,111,,BRK,1,240,39,89,0.438,26,63,0.413,13,26,0.5,20,25,0.8,111,36,87,0.414,27,50,0.54,9,37,0.243,14,16,0.875,95
851,BOS,2018-01-29,111,@,DEN,1,240,43,91,0.473,26,55,0.473,17,36,0.472,8,10,0.8,111,42,93,0.452,32,60,0.533,10,33,0.303,16,21,0.762,110
852,LAL,2018-01-28,111,@,TOR,0,240,40,91,0.44,32,66,0.485,8,25,0.32,23,33,0.697,111,46,92,0.5,34,61,0.557,12,31,0.387,19,25,0.76,123
853,MIN,2018-01-27,111,,BRK,1,240,42,96,0.438,38,75,0.507,4,21,0.19,23,26,0.885,111,38,82,0.463,29,52,0.558,9,30,0.3,12,15,0.8,97
854,NOP,2018-01-20,111,,MEM,1,240,39,78,0.5,32,51,0.627,7,27,0.259,26,32,0.813,111,37,82,0.451,22,47,0.468,15,35,0.429,15,16,0.938,104
855,PHO,2018-01-16,111,@,POR,0,240,37,89,0.416,21,48,0.438,16,41,0.39,21,22,0.955,111,46,91,0.505,29,56,0.518,17,35,0.486,9,10,0.9,118
856,TOR,2018-01-15,111,@,PHI,0,240,38,95,0.4,29,63,0.46,9,32,0.281,26,30,0.867,111,40,81,0.494,34,56,0.607,6,25,0.24,31,38,0.816,117
857,MIA,2018-01-15,111,@,CHI,0,240,40,84,0.476,28,48,0.583,12,36,0.333,19,24,0.792,111,42,88,0.477,26,49,0.531,16,39,0.41,19,22,0.864,119
858,CHO,2018-01-10,111,,DAL,0,240,43,84,0.512,33,58,0.569,10,26,0.385,15,30,0.5,111,39,83,0.47,24,47,0.511,15,36,0.417,22,28,0.786,115
859,POR,2018-01-07,111,,SAS,1,240,48,92,0.522,40,69,0.58,8,23,0.348,7,10,0.7,111,40,81,0.494,29,58,0.5,11,23,0.478,19,26,0.731,110
860,PHO,2018-01-03,111,@,DEN,0,240,39,92,0.424,26,57,0.456,13,35,0.371,20,28,0.714,111,51,82,0.622,39,55,0.709,12,27,0.444,20,22,0.909,134
861,MIA,2018-01-03,111,,DET,1,240,43,84,0.512,26,50,0.52,17,34,0.5,8,11,0.727,111,41,86,0.477,32,62,0.516,9,24,0.375,13,16,0.813,104
862,SAC,2018-01-02,111,,CHO,0,240,45,87,0.517,38,70,0.543,7,17,0.412,14,18,0.778,111,51,89,0.573,36,57,0.632,15,32,0.469,14,18,0.778,131
863,ORL,2017-12-30,111,,MIA,0,240,44,81,0.543,32,54,0.593,12,27,0.444,11,15,0.733,111,45,88,0.511,33,64,0.516,12,24,0.5,15,18,0.833,117
864,BRK,2017-12-29,111,@,MIA,1,240,39,79,0.494,28,53,0.528,11,26,0.423,22,25,0.88,111,30,89,0.337,27,63,0.429,3,26,0.115,24,31,0.774,87
865,TOR,2017-12-29,111,,ATL,1,240,46,105,0.438,33,68,0.485,13,37,0.351,6,8,0.75,111,38,88,0.432,29,64,0.453,9,24,0.375,13,20,0.65,98
866,CHO,2017-12-29,111,@,GSW,1,240,41,89,0.461,35,69,0.507,6,20,0.3,23,34,0.676,111,40,87,0.46,32,65,0.492,8,22,0.364,12,13,0.923,100
867,PHO,2017-12-29,111,@,SAC,1,240,41,85,0.482,28,55,0.509,13,30,0.433,16,24,0.667,111,37,80,0.463,29,57,0.509,8,23,0.348,19,23,0.826,101
868,WAS,2017-12-25,111,@,BOS,1,240,43,93,0.462,37,67,0.552,6,26,0.231,19,28,0.679,111,39,81,0.481,25,52,0.481,14,29,0.483,11,17,0.647,103
869,CHO,2017-12-23,111,,MIL,1,240,36,74,0.486,27,53,0.509,9,21,0.429,30,40,0.75,111,42,87,0.483,34,61,0.557,8,26,0.308,14,17,0.824,106
870,NOP,2017-12-22,111,@,ORL,1,240,43,86,0.5,33,56,0.589,10,30,0.333,15,24,0.625,111,36,85,0.424,32,65,0.492,4,20,0.2,21,29,0.724,97
871,CHO,2017-12-20,111,,TOR,0,240,39,85,0.459,32,62,0.516,7,23,0.304,26,35,0.743,111,49,91,0.538,33,58,0.569,16,33,0.485,15,18,0.833,129
872,IND,2017-12-18,111,,BOS,0,240,37,79,0.468,30,58,0.517,7,21,0.333,30,38,0.789,111,44,79,0.557,28,53,0.528,16,26,0.615,8,14,0.571,112
873,NYK,2017-12-16,111,,OKC,1,240,38,69,0.551,24,46,0.522,14,23,0.609,21,26,0.808,111,36,85,0.424,24,58,0.414,12,27,0.444,12,20,0.6,96
874,MIL,2017-12-16,111,@,HOU,0,240,38,82,0.463,30,55,0.545,8,27,0.296,27,33,0.818,111,35,76,0.461,24,41,0.585,11,35,0.314,34,42,0.81,115
875,NOP,2017-12-15,111,@,DEN,0,265,43,91,0.473,28,57,0.491,15,34,0.441,10,14,0.714,111,46,100,0.46,30,64,0.469,16,36,0.444,9,14,0.643,117
876,NYK,2017-12-14,111,@,BRK,1,240,41,89,0.461,31,69,0.449,10,20,0.5,19,22,0.864,111,37,83,0.446,25,41,0.61,12,42,0.286,18,23,0.783,104
877,GSW,2017-12-11,111,,POR,1,240,44,80,0.55,34,60,0.567,10,20,0.5,13,17,0.765,111,37,88,0.42,30,60,0.5,7,28,0.25,23,25,0.92,104
878,NYK,2017-12-10,111,,ATL,1,240,39,80,0.488,34,63,0.54,5,17,0.294,28,34,0.824,111,37,77,0.481,28,46,0.609,9,31,0.29,24,30,0.8,107
879,CHO,2017-12-08,111,,CHI,0,265,40,100,0.4,30,71,0.423,10,29,0.345,21,29,0.724,111,48,99,0.485,42,81,0.519,6,18,0.333,17,22,0.773,119
880,BOS,2017-12-04,111,,MIL,1,240,43,78,0.551,33,56,0.589,10,22,0.455,15,19,0.789,111,35,78,0.449,26,57,0.456,9,21,0.429,21,24,0.875,100
881,MEM,2017-12-02,111,@,CLE,0,240,43,84,0.512,30,61,0.492,13,23,0.565,12,14,0.857,111,42,75,0.56,31,51,0.608,11,24,0.458,21,23,0.913,116
882,PHO,2017-12-02,111,@,BOS,0,240,48,101,0.475,41,77,0.532,7,24,0.292,8,11,0.727,111,42,80,0.525,28,49,0.571,14,31,0.452,18,23,0.783,116
883,OKC,2017-12-01,111,,MIN,1,240,41,79,0.519,33,53,0.623,8,26,0.308,21,22,0.955,111,39,76,0.513,27,52,0.519,12,24,0.5,17,21,0.81,107
884,DEN,2017-11-30,111,,CHI,1,240,38,83,0.458,26,52,0.5,12,31,0.387,23,31,0.742,111,44,82,0.537,35,58,0.603,9,24,0.375,13,21,0.619,110
885,ORL,2017-11-25,111,@,PHI,0,240,39,86,0.453,27,55,0.491,12,31,0.387,21,31,0.677,111,48,95,0.505,32,61,0.525,16,34,0.471,18,20,0.9,130
886,BRK,2017-11-19,111,,GSW,0,240,34,95,0.358,18,47,0.383,16,48,0.333,27,39,0.692,111,46,90,0.511,36,66,0.545,10,24,0.417,16,23,0.696,118
887,DAL,2017-11-18,111,,MIL,1,240,38,79,0.481,19,41,0.463,19,38,0.5,16,19,0.842,111,28,74,0.378,22,49,0.449,6,25,0.24,17,31,0.548,79
888,MIN,2017-11-17,111,@,DAL,1,240,39,84,0.464,26,54,0.481,13,30,0.433,20,23,0.87,111,32,86,0.372,24,48,0.5,8,38,0.211,15,17,0.882,87
889,CLE,2017-11-11,111,@,DAL,1,240,35,81,0.432,23,50,0.46,12,31,0.387,29,35,0.829,111,39,92,0.424,29,58,0.5,10,34,0.294,16,21,0.762,104
890,NOP,2017-11-11,111,,LAC,1,240,43,80,0.538,37,64,0.578,6,16,0.375,19,24,0.792,111,35,86,0.407,25,60,0.417,10,26,0.385,23,27,0.852,103
891,HOU,2017-11-11,111,,MEM,1,240,37,83,0.446,21,38,0.553,16,45,0.356,21,28,0.75,111,38,79,0.481,32,59,0.542,6,20,0.3,14,18,0.778,96
892,DET,2017-11-10,111,,ATL,1,240,39,89,0.438,27,59,0.458,12,30,0.4,21,27,0.778,111,44,89,0.494,36,65,0.554,8,24,0.333,8,11,0.727,104
893,LAC,2017-11-10,111,@,OKC,0,240,39,84,0.464,27,54,0.5,12,30,0.4,21,30,0.7,111,40,78,0.513,29,52,0.558,11,26,0.423,29,40,0.725,120
894,WAS,2017-11-09,111,,LAL,1,240,43,83,0.518,36,62,0.581,7,21,0.333,18,20,0.9,111,31,86,0.36,28,63,0.444,3,23,0.13,30,41,0.732,95
895,TOR,2017-11-01,111,@,DEN,0,240,42,85,0.494,31,54,0.574,11,31,0.355,16,25,0.64,111,47,88,0.534,31,56,0.554,16,32,0.5,19,29,0.655,129
896,BRK,2017-10-29,111,,DEN,0,240,39,96,0.406,27,65,0.415,12,31,0.387,21,31,0.677,111,47,94,0.5,36,74,0.486,11,20,0.55,19,22,0.864,124
897,MEM,2017-10-21,111,,GSW,1,240,36,77,0.468,26,50,0.52,10,27,0.37,29,37,0.784,111,33,84,0.393,21,46,0.457,12,38,0.316,23,27,0.852,101
898,DET,2017-10-21,111,@,NYK,1,240,44,91,0.484,35,61,0.574,9,30,0.3,14,15,0.933,111,37,81,0.457,29,51,0.569,8,30,0.267,25,31,0.806,107
899,DET,2017-10-20,111,@,WAS,0,240,43,87,0.494,33,64,0.516,10,23,0.435,15,20,0.75,111,40,75,0.533,34,58,0.586,6,17,0.353,29,35,0.829,115
900,DAL,2017-10-18,111,,ATL,0,240,38,86,0.442,21,41,0.512,17,45,0.378,18,21,0.857,111,48,94,0.511,39,76,0.513,9,18,0.5,12,15,0.8,117
901,BOS,2018-04-11,110,,BRK,1,240,46,102,0.451,40,78,0.513,6,24,0.25,12,15,0.8,110,37,91,0.407,26,51,0.51,11,40,0.275,12,16,0.75,97
902,NYK,2018-04-11,110,@,CLE,1,240,43,85,0.506,31,58,0.534,12,27,0.444,12,13,0.923,110,37,94,0.394,31,70,0.443,6,24,0.25,18,28,0.643,98
903,LAL,2018-04-03,110,@,UTA,0,240,36,74,0.486,22,46,0.478,14,28,0.5,24,36,0.667,110,43,89,0.483,29,56,0.518,14,33,0.424,17,27,0.63,117
904,SAS,2018-04-03,110,@,LAC,0,240,39,88,0.443,31,64,0.484,8,24,0.333,24,28,0.857,110,37,82,0.451,32,66,0.485,5,16,0.313,34,43,0.791,113
905,BRK,2018-03-31,110,@,MIA,1,265,39,91,0.429,29,56,0.518,10,35,0.286,22,28,0.786,110,43,95,0.453,36,78,0.462,7,17,0.412,16,21,0.762,109
906,BOS,2018-03-31,110,,TOR,1,240,40,88,0.455,33,71,0.465,7,17,0.412,23,27,0.852,110,37,80,0.463,29,45,0.644,8,35,0.229,17,22,0.773,99
907,DEN,2018-03-27,110,@,TOR,0,240,42,89,0.472,29,59,0.492,13,30,0.433,13,14,0.929,110,47,92,0.511,34,58,0.586,13,34,0.382,7,9,0.778,114
908,UTA,2018-03-25,110,@,GSW,1,240,42,87,0.483,30,59,0.508,12,28,0.429,14,18,0.778,110,38,91,0.418,32,76,0.421,6,15,0.4,9,10,0.9,91
909,IND,2018-03-19,110,,LAL,1,240,43,87,0.494,37,66,0.561,6,21,0.286,18,19,0.947,110,38,86,0.442,30,53,0.566,8,33,0.242,16,23,0.696,100
910,NYK,2018-03-19,110,,CHI,1,240,43,96,0.448,32,61,0.525,11,35,0.314,13,17,0.765,110,33,92,0.359,30,62,0.484,3,30,0.1,23,31,0.742,92
911,MEM,2018-03-15,110,,CHI,0,240,38,87,0.437,25,52,0.481,13,35,0.371,21,25,0.84,110,35,80,0.438,20,39,0.513,15,41,0.366,26,33,0.788,111
912,NYK,2018-03-15,110,,PHI,0,240,45,87,0.517,40,67,0.597,5,20,0.25,15,24,0.625,110,41,91,0.451,26,54,0.481,15,37,0.405,21,34,0.618,118
913,DAL,2018-03-13,110,@,NYK,1,240,40,89,0.449,26,54,0.481,14,35,0.4,16,18,0.889,110,40,82,0.488,32,57,0.561,8,25,0.32,9,12,0.75,97
914,UTA,2018-03-13,110,,DET,1,240,42,76,0.553,29,42,0.69,13,34,0.382,13,23,0.565,110,30,80,0.375,25,55,0.455,5,25,0.2,14,19,0.737,79
915,GSW,2018-03-08,110,,SAS,1,240,41,95,0.432,33,65,0.508,8,30,0.267,20,23,0.87,110,43,95,0.453,37,73,0.507,6,22,0.273,15,18,0.833,107
916,HOU,2018-03-07,110,@,MIL,1,240,39,82,0.476,25,42,0.595,14,40,0.35,18,27,0.667,110,38,83,0.458,29,55,0.527,9,28,0.321,14,19,0.737,99
917,MEM,2018-03-07,110,@,CHI,0,240,40,82,0.488,30,53,0.566,10,29,0.345,20,25,0.8,110,42,79,0.532,31,50,0.62,11,29,0.379,24,32,0.75,119
918,PHI,2018-03-04,110,@,MIL,0,240,39,70,0.557,25,42,0.595,14,28,0.5,18,22,0.818,110,47,95,0.495,37,72,0.514,10,23,0.435,14,22,0.636,118
919,PHI,2018-03-02,110,,CHO,1,240,41,81,0.506,32,57,0.561,9,24,0.375,19,25,0.76,110,34,81,0.42,23,57,0.404,11,24,0.458,20,32,0.625,99
920,PHO,2018-02-28,110,@,MEM,1,240,38,83,0.458,32,62,0.516,6,21,0.286,28,38,0.737,110,33,87,0.379,20,56,0.357,13,31,0.419,23,28,0.821,102
921,DAL,2018-02-28,110,,OKC,0,265,44,91,0.484,31,55,0.564,13,36,0.361,9,15,0.6,110,42,93,0.452,32,57,0.561,10,36,0.278,17,19,0.895,111
922,DET,2018-02-28,110,,MIL,1,240,42,95,0.442,33,66,0.5,9,29,0.31,17,22,0.773,110,28,73,0.384,20,49,0.408,8,24,0.333,23,28,0.821,87
923,SAS,2018-02-25,110,@,CLE,1,240,38,86,0.442,29,67,0.433,9,19,0.474,25,32,0.781,110,38,91,0.418,30,57,0.526,8,34,0.235,10,14,0.714,94
924,BOS,2018-02-23,110,@,DET,1,240,41,85,0.482,24,46,0.522,17,39,0.436,11,18,0.611,110,37,85,0.435,27,52,0.519,10,33,0.303,14,21,0.667,98
925,WAS,2018-02-22,110,@,CLE,1,240,44,92,0.478,32,62,0.516,12,30,0.4,10,10,1.0,110,42,84,0.5,34,49,0.694,8,35,0.229,11,19,0.579,103
926,OKC,2018-02-22,110,@,SAC,1,240,38,86,0.442,24,51,0.471,14,35,0.4,20,24,0.833,110,42,91,0.462,30,64,0.469,12,27,0.444,11,15,0.733,107
927,OKC,2018-02-11,110,,MEM,1,240,34,77,0.442,18,40,0.45,16,37,0.432,26,40,0.65,110,32,82,0.39,26,54,0.481,6,28,0.214,22,24,0.917,92
928,BOS,2018-02-08,110,@,WAS,1,265,39,84,0.464,30,58,0.517,9,26,0.346,23,34,0.676,110,38,95,0.4,26,69,0.377,12,26,0.462,16,20,0.8,104
929,PHO,2018-02-04,110,,CHO,0,240,41,77,0.532,26,48,0.542,15,29,0.517,13,13,1.0,110,40,96,0.417,30,58,0.517,10,38,0.263,25,29,0.862,115
930,ATL,2018-02-02,110,@,BOS,0,240,34,80,0.425,23,49,0.469,11,31,0.355,31,34,0.912,110,45,89,0.506,34,65,0.523,11,24,0.458,18,20,0.9,119
931,ATL,2018-01-31,110,,CHO,0,240,39,77,0.506,27,45,0.6,12,32,0.375,20,22,0.909,110,46,90,0.511,29,58,0.5,17,32,0.531,14,18,0.778,123
932,DEN,2018-01-29,110,,BOS,0,240,42,93,0.452,32,60,0.533,10,33,0.303,16,21,0.762,110,43,91,0.473,26,55,0.473,17,36,0.472,8,10,0.8,111
933,MIL,2018-01-28,110,@,CHI,1,240,41,77,0.532,28,49,0.571,13,28,0.464,15,25,0.6,110,36,87,0.414,24,53,0.453,12,34,0.353,12,15,0.8,96
934,ATL,2018-01-26,110,@,CHO,0,240,37,79,0.468,22,49,0.449,15,30,0.5,21,25,0.84,110,40,88,0.455,27,54,0.5,13,34,0.382,28,32,0.875,121
935,BRK,2018-01-12,110,@,ATL,1,240,40,87,0.46,27,53,0.509,13,34,0.382,17,26,0.654,110,37,80,0.463,26,52,0.5,11,28,0.393,20,26,0.769,105
936,MIL,2018-01-10,110,,ORL,1,240,45,82,0.549,41,63,0.651,4,19,0.211,16,25,0.64,110,39,90,0.433,31,61,0.508,8,29,0.276,17,18,0.944,103
937,ATL,2018-01-10,110,@,DEN,1,240,40,80,0.5,28,53,0.528,12,27,0.444,18,18,1.0,110,38,95,0.4,29,58,0.5,9,37,0.243,12,20,0.6,97
938,SAS,2018-01-07,110,@,POR,0,240,40,81,0.494,29,58,0.5,11,23,0.478,19,26,0.731,110,48,92,0.522,40,69,0.58,8,23,0.348,7,10,0.7,111
939,MIL,2018-01-06,110,@,WAS,1,240,39,80,0.488,32,58,0.552,7,22,0.318,25,30,0.833,110,37,78,0.474,29,57,0.509,8,21,0.381,21,29,0.724,103
940,POR,2018-01-05,110,,ATL,1,240,43,80,0.538,30,50,0.6,13,30,0.433,11,14,0.786,110,30,83,0.361,22,57,0.386,8,26,0.308,21,25,0.84,89
941,MIL,2018-01-05,110,,TOR,0,240,41,77,0.532,34,60,0.567,7,17,0.412,21,29,0.724,110,48,86,0.558,38,53,0.717,10,33,0.303,23,28,0.821,129
942,POR,2018-01-02,110,@,CLE,0,240,42,90,0.467,29,58,0.5,13,32,0.406,13,19,0.684,110,43,83,0.518,30,51,0.588,13,32,0.406,28,37,0.757,127
943,PHO,2017-12-31,110,,PHI,0,240,37,88,0.42,27,61,0.443,10,27,0.37,26,34,0.765,110,43,77,0.558,33,53,0.623,10,24,0.417,27,34,0.794,123
944,CHI,2017-12-31,110,@,WAS,0,240,42,92,0.457,34,57,0.596,8,35,0.229,18,22,0.818,110,43,93,0.462,27,57,0.474,16,36,0.444,12,17,0.706,114
945,PHI,2017-12-28,110,@,POR,0,240,42,87,0.483,26,55,0.473,16,32,0.5,10,14,0.714,110,35,75,0.467,27,51,0.529,8,24,0.333,36,47,0.766,114
946,DAL,2017-12-20,110,,DET,1,240,40,75,0.533,26,45,0.578,14,30,0.467,16,20,0.8,110,33,77,0.429,26,53,0.491,7,24,0.292,20,22,0.909,93
947,ATL,2017-12-18,110,,MIA,1,240,38,83,0.458,30,61,0.492,8,22,0.364,26,31,0.839,110,36,79,0.456,29,54,0.537,7,25,0.28,25,30,0.833,104
948,ORL,2017-12-17,110,@,DET,0,240,41,85,0.482,24,52,0.462,17,33,0.515,11,17,0.647,110,42,89,0.472,25,55,0.455,17,34,0.5,13,16,0.813,114
949,ORL,2017-12-09,110,@,ATL,0,240,45,92,0.489,32,58,0.552,13,34,0.382,7,8,0.875,110,41,80,0.513,24,47,0.511,17,33,0.515,18,25,0.72,117
950,LAL,2017-12-09,110,@,CHO,1,240,43,85,0.506,34,58,0.586,9,27,0.333,15,21,0.714,110,41,93,0.441,33,68,0.485,8,25,0.32,9,14,0.643,99
951,ORL,2017-12-06,110,,ATL,1,265,46,98,0.469,40,70,0.571,6,28,0.214,12,18,0.667,110,40,93,0.43,29,66,0.439,11,27,0.407,15,20,0.75,106
952,BRK,2017-12-04,110,@,ATL,1,240,41,85,0.482,26,49,0.531,15,36,0.417,13,15,0.867,110,30,82,0.366,21,52,0.404,9,30,0.3,21,27,0.778,90
953,CHI,2017-11-30,110,@,DEN,0,240,44,82,0.537,35,58,0.603,9,24,0.375,13,21,0.619,110,38,83,0.458,26,52,0.5,12,31,0.387,23,31,0.742,111
954,SAC,2017-11-27,110,@,GSW,1,240,42,79,0.532,33,62,0.532,9,17,0.529,17,21,0.81,110,40,80,0.5,24,43,0.558,16,37,0.432,10,14,0.714,106
955,GSW,2017-11-25,110,,NOP,1,240,39,94,0.415,29,61,0.475,10,33,0.303,22,27,0.815,110,34,84,0.405,23,53,0.434,11,31,0.355,16,23,0.696,95
956,UTA,2017-11-22,110,,CHI,1,240,40,86,0.465,26,51,0.51,14,35,0.4,16,19,0.842,110,29,78,0.372,24,57,0.421,5,21,0.238,17,20,0.85,80
957,BOS,2017-11-20,110,@,DAL,1,265,38,84,0.452,25,48,0.521,13,36,0.361,21,26,0.808,110,39,96,0.406,32,63,0.508,7,33,0.212,17,20,0.85,102
958,BOS,2017-11-18,110,@,ATL,1,240,39,82,0.476,23,48,0.479,16,34,0.471,16,20,0.8,110,37,78,0.474,28,54,0.519,9,24,0.375,16,20,0.8,99
959,MIL,2017-11-13,110,,MEM,1,240,40,82,0.488,28,60,0.467,12,22,0.545,18,25,0.72,110,37,76,0.487,26,50,0.52,11,26,0.423,18,21,0.857,103
960,WAS,2017-11-13,110,,SAC,1,240,44,86,0.512,33,52,0.635,11,34,0.324,11,12,0.917,110,34,84,0.405,22,61,0.361,12,23,0.522,12,18,0.667,92
961,GSW,2017-11-13,110,,ORL,1,240,44,88,0.5,36,65,0.554,8,23,0.348,14,16,0.875,110,37,88,0.42,27,56,0.482,10,32,0.313,16,18,0.889,100
962,MIN,2017-11-11,110,@,PHO,0,240,39,96,0.406,35,76,0.461,4,20,0.2,28,35,0.8,110,46,86,0.535,36,60,0.6,10,26,0.385,16,24,0.667,118
963,BOS,2017-11-06,110,@,ATL,1,240,39,81,0.481,25,45,0.556,14,36,0.389,18,22,0.818,110,39,81,0.481,26,55,0.473,13,26,0.5,16,20,0.8,107
964,UTA,2017-11-05,110,@,HOU,0,240,38,88,0.432,25,54,0.463,13,34,0.382,21,24,0.875,110,48,81,0.593,25,42,0.595,23,39,0.59,18,21,0.857,137
965,IND,2017-11-03,110,@,PHI,0,240,45,97,0.464,37,69,0.536,8,28,0.286,12,19,0.632,110,46,92,0.5,28,56,0.5,18,36,0.5,11,14,0.786,121
966,LAL,2017-11-02,110,@,POR,0,240,43,79,0.544,39,61,0.639,4,18,0.222,20,27,0.741,110,40,86,0.465,31,64,0.484,9,22,0.409,24,27,0.889,113
967,OKC,2017-10-31,110,@,MIL,1,240,40,81,0.494,28,53,0.528,12,28,0.429,18,21,0.857,110,32,77,0.416,23,46,0.5,9,31,0.29,18,22,0.818,91
968,DEN,2017-10-30,110,@,NYK,0,240,35,85,0.412,17,44,0.386,18,41,0.439,22,31,0.71,110,41,82,0.5,28,50,0.56,13,32,0.406,21,23,0.913,116
969,WAS,2017-10-29,110,@,SAC,1,240,40,85,0.471,23,51,0.451,17,34,0.5,13,20,0.65,110,32,82,0.39,26,60,0.433,6,22,0.273,13,16,0.813,83
970,DAL,2017-10-28,110,,PHI,0,240,38,74,0.514,19,34,0.559,19,40,0.475,15,19,0.789,110,43,87,0.494,27,52,0.519,16,35,0.457,10,14,0.714,112
971,CHO,2017-10-25,110,,DEN,1,240,38,81,0.469,25,50,0.5,13,31,0.419,21,26,0.808,110,38,100,0.38,30,69,0.435,8,31,0.258,9,15,0.6,93
972,BOS,2017-10-24,110,,NYK,1,240,37,75,0.493,23,46,0.5,14,29,0.483,22,27,0.815,110,36,85,0.424,35,73,0.479,1,12,0.083,16,25,0.64,89
973,POR,2017-10-21,110,@,MIL,0,240,34,81,0.42,23,53,0.434,11,28,0.393,31,35,0.886,110,42,80,0.525,35,62,0.565,7,18,0.389,22,30,0.733,113
974,TOR,2018-04-11,109,@,MIA,0,265,42,92,0.457,33,62,0.532,9,30,0.3,16,21,0.762,109,46,106,0.434,35,80,0.438,11,26,0.423,13,20,0.65,116
975,NYK,2018-04-09,109,,CLE,0,240,46,87,0.529,35,57,0.614,11,30,0.367,6,12,0.5,109,40,85,0.471,21,40,0.525,19,45,0.422,24,28,0.857,123
976,PHI,2018-04-08,109,,DAL,1,240,46,91,0.505,38,64,0.594,8,27,0.296,9,14,0.643,109,40,94,0.426,29,54,0.537,11,40,0.275,6,13,0.462,97
977,POR,2018-04-03,109,@,DAL,0,240,39,87,0.448,29,47,0.617,10,40,0.25,21,24,0.875,109,42,92,0.457,25,48,0.521,17,44,0.386,14,20,0.7,115
978,OKC,2018-04-01,109,@,NOP,1,240,41,95,0.432,32,64,0.5,9,31,0.29,18,25,0.72,109,38,83,0.458,27,51,0.529,11,32,0.344,17,23,0.739,104
979,MIA,2018-03-31,109,,BRK,0,265,43,95,0.453,36,78,0.462,7,17,0.412,16,21,0.762,109,39,91,0.429,29,56,0.518,10,35,0.286,22,28,0.786,110
980,NYK,2018-03-31,109,,DET,0,240,43,91,0.473,30,62,0.484,13,29,0.448,10,12,0.833,109,44,85,0.518,34,61,0.557,10,24,0.417,17,22,0.773,115
981,IND,2018-03-23,109,,LAC,1,240,43,93,0.462,32,62,0.516,11,31,0.355,12,14,0.857,109,42,76,0.553,32,50,0.64,10,26,0.385,10,14,0.714,104
982,LAC,2018-03-20,109,@,MIN,0,240,40,93,0.43,32,69,0.464,8,24,0.333,21,26,0.808,109,45,86,0.523,35,61,0.574,10,25,0.4,23,24,0.958,123
983,LAC,2018-03-18,109,,POR,0,240,40,89,0.449,31,66,0.47,9,23,0.391,20,27,0.741,109,46,92,0.5,32,63,0.508,14,29,0.483,16,20,0.8,122
984,PHO,2018-03-17,109,,GSW,0,240,39,82,0.476,28,58,0.483,11,24,0.458,20,29,0.69,109,50,95,0.526,37,64,0.578,13,31,0.419,11,14,0.786,124
985,WAS,2018-03-17,109,,IND,1,240,40,74,0.541,30,54,0.556,10,20,0.5,19,23,0.826,109,39,86,0.453,27,62,0.435,12,24,0.5,12,15,0.8,102
986,CHI,2018-03-17,109,,CLE,0,240,41,91,0.451,25,57,0.439,16,34,0.471,11,15,0.733,109,44,87,0.506,31,50,0.62,13,37,0.351,13,20,0.65,114
987,HOU,2018-03-12,109,,SAS,1,240,39,80,0.488,26,36,0.722,13,44,0.295,18,23,0.783,109,33,81,0.407,22,53,0.415,11,28,0.393,16,23,0.696,93
988,MIN,2018-03-11,109,,GSW,1,240,44,95,0.463,38,75,0.507,6,20,0.3,15,21,0.714,109,37,91,0.407,27,55,0.491,10,36,0.278,19,21,0.905,103
989,MIN,2018-03-08,109,,BOS,0,240,44,94,0.468,32,63,0.508,12,31,0.387,9,13,0.692,109,43,87,0.494,32,55,0.582,11,32,0.344,20,27,0.741,117
990,DAL,2018-03-04,109,,NOP,0,240,40,90,0.444,30,67,0.448,10,23,0.435,19,25,0.76,109,49,91,0.538,37,65,0.569,12,26,0.462,16,21,0.762,126
991,ATL,2018-03-02,109,,GSW,0,240,38,86,0.442,23,51,0.451,15,35,0.429,18,20,0.9,109,42,79,0.532,31,48,0.646,11,31,0.355,19,22,0.864,114
992,GSW,2018-02-28,109,@,WAS,1,240,37,72,0.514,27,48,0.563,10,24,0.417,25,30,0.833,109,36,90,0.4,25,58,0.431,11,32,0.344,18,21,0.857,101
993,BOS,2018-02-26,109,,MEM,1,240,39,86,0.453,27,49,0.551,12,37,0.324,19,27,0.704,109,34,78,0.436,29,55,0.527,5,23,0.217,25,32,0.781,98
994,DAL,2018-02-26,109,,IND,1,240,40,88,0.455,26,51,0.51,14,37,0.378,15,18,0.833,109,41,87,0.471,36,67,0.537,5,20,0.25,16,23,0.696,103
995,WAS,2018-02-25,109,,PHI,1,240,43,79,0.544,31,54,0.574,12,25,0.48,11,12,0.917,109,31,86,0.36,22,53,0.415,9,33,0.273,23,31,0.742,94
996,DAL,2018-02-13,109,,SAC,0,240,38,83,0.458,23,43,0.535,15,40,0.375,18,23,0.783,109,47,87,0.54,35,58,0.603,12,29,0.414,8,12,0.667,114
997,SAS,2018-02-13,109,@,DEN,0,240,44,82,0.537,38,60,0.633,6,22,0.273,15,22,0.682,109,46,93,0.495,36,61,0.59,10,32,0.313,15,18,0.833,117
998,POR,2018-02-08,109,,CHO,1,265,41,90,0.456,32,59,0.542,9,31,0.29,18,22,0.818,109,38,98,0.388,25,65,0.385,13,33,0.394,14,17,0.824,103
999,HOU,2018-02-07,109,@,MIA,1,240,38,74,0.514,26,43,0.605,12,31,0.387,21,26,0.808,109,39,88,0.443,26,56,0.464,13,32,0.406,10,12,0.833,101
1000,NOP,2018-02-05,109,,UTA,0,240,47,93,0.505,39,71,0.549,8,22,0.364,7,13,0.538,109,52,89,0.584,38,68,0.559,14,21,0.667,15,17,0.882,133
1001,MIA,2018-02-05,109,,ORL,0,240,40,93,0.43,37,70,0.529,3,23,0.13,26,35,0.743,109,41,84,0.488,28,54,0.519,13,30,0.433,16,19,0.842,111
1002,MIL,2018-02-04,109,@,BRK,1,240,42,81,0.519,34,62,0.548,8,19,0.421,17,21,0.81,109,37,90,0.411,28,61,0.459,9,29,0.31,11,14,0.786,94
1003,TOR,2018-01-30,109,,MIN,1,240,39,81,0.481,30,52,0.577,9,29,0.31,22,26,0.846,109,42,85,0.494,37,73,0.507,5,12,0.417,15,24,0.625,104
1004,PHO,2018-01-29,109,@,MEM,0,240,38,82,0.463,31,59,0.525,7,23,0.304,26,36,0.722,109,47,83,0.566,36,61,0.59,11,22,0.5,15,18,0.833,120
1005,GSW,2018-01-27,109,,BOS,1,240,38,84,0.452,28,57,0.491,10,27,0.37,23,26,0.885,109,37,85,0.435,23,57,0.404,14,28,0.5,17,24,0.708,105
1006,LAC,2018-01-26,109,@,MEM,1,240,39,80,0.488,29,53,0.547,10,27,0.37,21,29,0.724,109,39,81,0.481,31,54,0.574,8,27,0.296,14,18,0.778,100
1007,OKC,2018-01-23,109,,BRK,1,240,40,94,0.426,33,69,0.478,7,25,0.28,22,32,0.688,109,37,79,0.468,21,41,0.512,16,38,0.421,18,25,0.72,108
1008,MIL,2018-01-22,109,,PHO,1,240,38,71,0.535,33,54,0.611,5,17,0.294,28,37,0.757,109,39,79,0.494,30,53,0.566,9,26,0.346,18,20,0.9,105
1009,TOR,2018-01-20,109,@,MIN,0,240,39,83,0.47,27,50,0.54,12,33,0.364,19,21,0.905,109,38,81,0.469,31,65,0.477,7,16,0.438,32,42,0.762,115
1010,LAC,2018-01-17,109,,DEN,1,240,40,87,0.46,30,57,0.526,10,30,0.333,19,31,0.613,109,42,97,0.433,37,72,0.514,5,25,0.2,15,18,0.833,104
1011,WAS,2018-01-17,109,@,CHO,0,240,40,82,0.488,27,59,0.458,13,23,0.565,16,23,0.696,109,48,98,0.49,33,67,0.493,15,31,0.484,22,26,0.846,133
1012,IND,2018-01-15,109,@,UTA,1,240,41,77,0.532,27,51,0.529,14,26,0.538,13,15,0.867,109,36,81,0.444,27,48,0.563,9,33,0.273,13,17,0.765,94
1013,IND,2018-01-08,109,,MIL,1,240,44,79,0.557,37,57,0.649,7,22,0.318,14,20,0.7,109,34,74,0.459,27,47,0.574,7,27,0.259,21,27,0.778,96
1014,DET,2018-01-08,109,@,NOP,0,240,41,93,0.441,33,66,0.5,8,27,0.296,19,22,0.864,109,46,82,0.561,40,60,0.667,6,22,0.273,14,21,0.667,112
1015,SAC,2017-12-27,109,,CLE,1,240,41,79,0.519,29,49,0.592,12,30,0.4,15,18,0.833,109,32,74,0.432,20,43,0.465,12,31,0.387,19,25,0.76,95
1016,MEM,2017-12-27,109,@,LAL,1,240,35,71,0.493,30,50,0.6,5,21,0.238,34,39,0.872,109,35,93,0.376,27,65,0.415,8,28,0.286,21,33,0.636,99
1017,SAS,2017-12-26,109,,BRK,1,240,41,80,0.513,34,64,0.531,7,16,0.438,20,24,0.833,109,39,93,0.419,27,61,0.443,12,32,0.375,7,9,0.778,97
1018,NOP,2017-12-23,109,@,MIA,1,240,39,73,0.534,24,48,0.5,15,25,0.6,16,19,0.842,109,36,85,0.424,26,53,0.491,10,32,0.313,12,15,0.8,94
1019,MIL,2017-12-22,109,,CHO,1,240,41,87,0.471,33,58,0.569,8,29,0.276,19,23,0.826,109,39,88,0.443,27,62,0.435,12,26,0.462,14,17,0.824,104
1020,PHI,2017-12-21,109,,TOR,0,240,45,86,0.523,36,57,0.632,9,29,0.31,10,14,0.714,109,35,85,0.412,23,50,0.46,12,35,0.343,32,35,0.914,114
1021,SAS,2017-12-18,109,,LAC,1,240,40,82,0.488,31,58,0.534,9,24,0.375,20,25,0.8,109,37,84,0.44,28,55,0.509,9,29,0.31,8,16,0.5,91
1022,CHO,2017-12-18,109,,NYK,1,240,43,88,0.489,34,68,0.5,9,20,0.45,14,16,0.875,109,36,86,0.419,33,68,0.485,3,18,0.167,16,20,0.8,91
1023,IND,2017-12-17,109,@,BRK,1,240,43,76,0.566,35,58,0.603,8,18,0.444,15,19,0.789,109,34,81,0.42,22,48,0.458,12,33,0.364,17,21,0.81,97
1024,CLE,2017-12-16,109,,UTA,1,240,42,79,0.532,32,57,0.561,10,22,0.455,15,17,0.882,109,37,81,0.457,20,47,0.426,17,34,0.5,9,14,0.643,100
1025,MIL,2017-12-15,109,,CHI,0,240,40,83,0.482,31,50,0.62,9,33,0.273,20,29,0.69,109,42,86,0.488,34,64,0.531,8,22,0.364,23,35,0.657,115
1026,SAS,2017-12-15,109,@,HOU,0,240,46,94,0.489,36,68,0.529,10,26,0.385,7,13,0.538,109,43,91,0.473,25,41,0.61,18,50,0.36,20,25,0.8,124
1027,PHO,2017-12-13,109,,TOR,0,240,37,83,0.446,29,59,0.492,8,24,0.333,27,34,0.794,109,40,92,0.435,31,66,0.47,9,26,0.346,26,31,0.839,115
1028,LAL,2017-12-12,109,@,NYK,0,265,42,102,0.412,29,67,0.433,13,35,0.371,12,15,0.8,109,48,101,0.475,39,79,0.494,9,22,0.409,8,11,0.727,113
1029,NOP,2017-12-08,109,,SAC,0,265,41,89,0.461,31,61,0.508,10,28,0.357,17,19,0.895,109,47,97,0.485,34,67,0.507,13,30,0.433,9,14,0.643,116
1030,MIL,2017-12-08,109,,DAL,1,240,36,79,0.456,28,55,0.509,8,24,0.333,29,34,0.853,109,35,75,0.467,25,51,0.49,10,24,0.417,22,26,0.846,102
1031,WAS,2017-12-07,109,@,PHO,1,240,41,81,0.506,33,60,0.55,8,21,0.381,19,25,0.76,109,36,78,0.462,29,55,0.527,7,23,0.304,20,28,0.714,99
1032,MIL,2017-12-02,109,,SAC,1,240,34,69,0.493,28,50,0.56,6,19,0.316,35,42,0.833,109,37,77,0.481,26,53,0.491,11,24,0.458,19,21,0.905,104
1033,WAS,2017-12-01,109,,DET,1,240,43,89,0.483,36,68,0.529,7,21,0.333,16,19,0.842,109,35,79,0.443,26,49,0.531,9,30,0.3,12,19,0.632,91
1034,BRK,2017-11-29,109,@,DAL,1,240,42,90,0.467,31,61,0.508,11,29,0.379,14,25,0.56,109,39,84,0.464,30,57,0.526,9,27,0.333,17,21,0.81,104
1035,ORL,2017-11-27,109,@,IND,0,240,40,92,0.435,24,51,0.471,16,41,0.39,13,16,0.813,109,42,79,0.532,27,53,0.509,15,26,0.577,22,26,0.846,121
1036,MIA,2017-11-24,109,@,MIN,1,240,38,80,0.475,19,41,0.463,19,39,0.487,14,16,0.875,109,37,84,0.44,30,67,0.448,7,17,0.412,16,26,0.615,97
1037,BRK,2017-11-22,109,@,CLE,0,240,42,81,0.519,28,44,0.636,14,37,0.378,11,16,0.688,109,43,82,0.524,29,48,0.604,14,34,0.412,19,27,0.704,119
1038,DEN,2017-11-19,109,@,LAL,0,240,36,84,0.429,23,53,0.434,13,31,0.419,24,35,0.686,109,53,100,0.53,41,68,0.603,12,32,0.375,9,16,0.563,127
1039,LAL,2017-11-15,109,,PHI,0,240,42,109,0.385,39,82,0.476,3,27,0.111,22,27,0.815,109,42,86,0.488,35,54,0.648,7,32,0.219,24,30,0.8,115
1040,BOS,2017-11-14,109,@,BRK,1,240,39,86,0.453,30,59,0.508,9,27,0.333,22,27,0.815,109,39,88,0.443,25,53,0.472,14,35,0.4,10,16,0.625,102
1041,PHI,2017-11-13,109,@,LAC,1,240,38,77,0.494,31,45,0.689,7,32,0.219,26,35,0.743,109,36,82,0.439,24,50,0.48,12,32,0.375,21,32,0.656,105
1042,MIN,2017-11-13,109,@,UTA,1,240,37,71,0.521,27,51,0.529,10,20,0.5,25,29,0.862,109,37,84,0.44,23,44,0.523,14,40,0.35,10,11,0.909,98
1043,SAC,2017-11-09,109,,PHI,1,240,40,93,0.43,28,66,0.424,12,27,0.444,17,28,0.607,109,37,87,0.425,22,50,0.44,15,37,0.405,19,27,0.704,108
1044,TOR,2017-11-03,109,@,UTA,1,240,38,71,0.535,27,41,0.659,11,30,0.367,22,28,0.786,109,35,80,0.438,27,57,0.474,8,23,0.348,22,24,0.917,100
1045,ATL,2017-11-01,109,@,PHI,0,240,41,94,0.436,33,71,0.465,8,23,0.348,19,27,0.704,109,46,99,0.465,33,64,0.516,13,35,0.371,14,25,0.56,119
1046,HOU,2017-10-27,109,@,CHO,1,240,38,85,0.447,16,28,0.571,22,57,0.386,11,13,0.846,109,33,88,0.375,22,59,0.373,11,29,0.379,16,28,0.571,93
1047,WAS,2017-10-23,109,@,DEN,1,240,37,84,0.44,28,54,0.519,9,30,0.3,26,28,0.929,109,39,80,0.488,31,57,0.544,8,23,0.348,18,23,0.783,104
1048,CHO,2017-10-20,109,,ATL,1,240,37,86,0.43,26,50,0.52,11,36,0.306,24,30,0.8,109,36,95,0.379,29,65,0.446,7,30,0.233,12,14,0.857,91
1049,MIA,2017-10-18,109,@,ORL,0,240,44,101,0.436,36,71,0.507,8,30,0.267,13,17,0.765,109,43,90,0.478,35,69,0.507,8,21,0.381,22,29,0.759,116
1050,TOR,2018-04-09,108,@,DET,1,240,46,87,0.529,34,48,0.708,12,39,0.308,4,4,1.0,108,35,78,0.449,26,48,0.542,9,30,0.3,19,25,0.76,98
1051,OKC,2018-04-07,108,@,HOU,1,240,36,91,0.396,26,58,0.448,10,33,0.303,26,33,0.788,108,36,76,0.474,22,39,0.564,14,37,0.378,16,23,0.696,102
1052,DET,2018-04-04,108,,PHI,0,240,39,88,0.443,23,52,0.442,16,36,0.444,14,23,0.609,108,44,89,0.494,31,59,0.525,13,30,0.433,14,19,0.737,115
1053,DET,2018-04-01,108,@,BRK,1,240,38,84,0.452,31,65,0.477,7,19,0.368,25,32,0.781,108,37,87,0.425,25,44,0.568,12,43,0.279,10,15,0.667,96
1054,MEM,2018-03-28,108,,POR,1,240,41,84,0.488,28,59,0.475,13,25,0.52,13,23,0.565,108,38,79,0.481,30,49,0.612,8,30,0.267,19,30,0.633,103
1055,POR,2018-03-25,108,@,OKC,1,240,42,90,0.467,33,56,0.589,9,34,0.265,15,19,0.789,108,37,84,0.44,29,57,0.509,8,27,0.296,23,28,0.821,105
1056,MIN,2018-03-24,108,@,PHI,0,240,37,96,0.385,31,73,0.425,6,23,0.261,28,38,0.737,108,42,88,0.477,29,51,0.569,13,37,0.351,23,36,0.639,120
1057,MIN,2018-03-23,108,@,NYK,1,240,35,75,0.467,25,49,0.51,10,26,0.385,28,32,0.875,108,40,92,0.435,28,64,0.438,12,28,0.429,12,17,0.706,104
1058,DEN,2018-03-23,108,@,WAS,1,240,37,85,0.435,20,51,0.392,17,34,0.5,17,18,0.944,108,38,80,0.475,24,52,0.462,14,28,0.5,10,14,0.714,100
1059,PHI,2018-03-19,108,,CHO,1,240,42,93,0.452,24,49,0.49,18,44,0.409,6,8,0.75,108,32,84,0.381,26,62,0.419,6,22,0.273,24,30,0.8,94
1060,NOP,2018-03-18,108,,BOS,1,240,41,82,0.5,35,64,0.547,6,18,0.333,20,25,0.8,108,35,87,0.402,26,61,0.426,9,26,0.346,10,20,0.5,89
1061,SAS,2018-03-13,108,,ORL,1,240,40,84,0.476,31,65,0.477,9,19,0.474,19,23,0.826,108,28,82,0.341,21,59,0.356,7,23,0.304,9,9,1.0,72
1062,TOR,2018-03-09,108,,HOU,1,240,41,85,0.482,26,47,0.553,15,38,0.395,11,14,0.786,108,40,81,0.494,31,54,0.574,9,27,0.333,16,23,0.696,105
1063,GSW,2018-03-09,108,@,POR,0,240,38,78,0.487,26,50,0.52,12,28,0.429,20,24,0.833,108,44,89,0.494,28,50,0.56,16,39,0.41,21,27,0.778,125
1064,MIA,2018-03-08,108,,PHI,1,240,42,89,0.472,28,63,0.444,14,26,0.538,10,18,0.556,108,34,86,0.395,19,49,0.388,15,37,0.405,16,21,0.762,99
1065,LAL,2018-03-07,108,,ORL,1,240,43,88,0.489,32,55,0.582,11,33,0.333,11,12,0.917,108,42,84,0.5,30,56,0.536,12,28,0.429,11,19,0.579,107
1066,DEN,2018-03-07,108,,CLE,0,240,42,86,0.488,32,59,0.542,10,27,0.37,14,18,0.778,108,44,87,0.506,31,58,0.534,13,29,0.448,12,18,0.667,113
1067,POR,2018-03-05,108,@,LAL,1,240,35,83,0.422,25,60,0.417,10,23,0.435,28,38,0.737,108,34,87,0.391,23,50,0.46,11,37,0.297,24,31,0.774,103
1068,POR,2018-03-03,108,,OKC,1,240,39,88,0.443,28,55,0.509,11,33,0.333,19,23,0.826,108,40,91,0.44,34,64,0.531,6,27,0.222,14,21,0.667,100
1069,CHI,2018-03-02,108,,DAL,1,240,42,89,0.472,32,62,0.516,10,27,0.37,14,20,0.7,108,35,84,0.417,22,55,0.4,13,29,0.448,17,21,0.81,100
1070,MIN,2018-03-02,108,@,UTA,0,240,38,74,0.514,29,57,0.509,9,17,0.529,23,31,0.742,108,40,78,0.513,31,49,0.633,9,29,0.31,27,35,0.771,116
1071,DEN,2018-03-02,108,@,MEM,1,240,40,73,0.548,34,51,0.667,6,22,0.273,22,26,0.846,108,40,91,0.44,30,64,0.469,10,27,0.37,12,15,0.8,102
1072,PHI,2018-03-01,108,@,CLE,1,240,40,90,0.444,30,60,0.5,10,30,0.333,18,27,0.667,108,36,87,0.414,27,55,0.491,9,32,0.281,16,23,0.696,97
1073,POR,2018-03-01,108,,MIN,1,240,36,92,0.391,27,62,0.435,9,30,0.3,27,35,0.771,108,38,85,0.447,34,65,0.523,4,20,0.2,19,21,0.905,99
1074,SAC,2018-02-24,108,,LAL,0,240,42,94,0.447,29,69,0.42,13,25,0.52,11,17,0.647,108,41,91,0.451,24,53,0.453,17,38,0.447,14,20,0.7,113
1075,IND,2018-02-14,108,@,BRK,1,240,39,90,0.433,33,75,0.44,6,15,0.4,24,28,0.857,108,35,83,0.422,22,48,0.458,13,35,0.371,20,27,0.741,103
1076,MIN,2018-02-13,108,,HOU,0,240,40,84,0.476,34,61,0.557,6,23,0.261,22,23,0.957,108,41,83,0.494,19,36,0.528,22,47,0.468,22,29,0.759,126
1077,PHI,2018-02-12,108,,NYK,1,240,41,75,0.547,31,56,0.554,10,19,0.526,16,24,0.667,108,31,79,0.392,25,55,0.455,6,24,0.25,24,28,0.857,92
1078,LAC,2018-02-09,108,@,DET,1,240,42,91,0.462,32,61,0.525,10,30,0.333,14,15,0.933,108,36,88,0.409,26,57,0.456,10,31,0.323,13,17,0.765,95
1079,ATL,2018-02-06,108,,MEM,1,240,42,83,0.506,34,58,0.586,8,25,0.32,16,21,0.762,108,34,79,0.43,30,57,0.526,4,22,0.182,10,13,0.769,82
1080,LAL,2018-02-04,108,@,OKC,1,240,42,86,0.488,29,56,0.518,13,30,0.433,11,18,0.611,108,40,89,0.449,33,64,0.516,7,25,0.28,17,25,0.68,104
1081,GSW,2018-02-03,108,@,DEN,0,240,43,86,0.5,35,55,0.636,8,31,0.258,14,23,0.609,108,39,91,0.429,27,62,0.435,12,29,0.414,25,29,0.862,115
1082,MIN,2018-02-01,108,,MIL,1,240,42,78,0.538,35,59,0.593,7,19,0.368,17,20,0.85,108,32,85,0.376,26,56,0.464,6,29,0.207,19,25,0.76,89
1083,PHI,2018-01-31,108,@,BRK,0,240,36,76,0.474,29,58,0.5,7,18,0.389,29,34,0.853,108,39,77,0.506,26,45,0.578,13,32,0.406,25,28,0.893,116
1084,CHI,2018-01-31,108,@,POR,0,240,41,99,0.414,28,65,0.431,13,34,0.382,13,22,0.591,108,46,82,0.561,31,50,0.62,15,32,0.469,17,20,0.85,124
1085,DET,2018-01-27,108,,OKC,0,240,39,84,0.464,27,51,0.529,12,33,0.364,18,24,0.75,108,45,93,0.484,31,60,0.517,14,33,0.424,17,23,0.739,121
1086,IND,2018-01-26,108,@,CLE,0,240,43,91,0.473,30,60,0.5,13,31,0.419,9,11,0.818,108,46,82,0.561,33,45,0.733,13,37,0.351,10,13,0.769,115
1087,LAL,2018-01-26,108,@,CHI,1,240,41,91,0.451,36,67,0.537,5,24,0.208,21,28,0.75,108,35,93,0.376,18,57,0.316,17,36,0.472,16,24,0.667,103
1088,TOR,2018-01-24,108,@,ATL,1,240,39,89,0.438,25,53,0.472,14,36,0.389,16,25,0.64,108,37,94,0.394,30,73,0.411,7,21,0.333,12,17,0.706,93
1089,SAS,2018-01-24,108,@,MEM,1,240,38,82,0.463,28,58,0.483,10,24,0.417,22,25,0.88,108,36,83,0.434,34,65,0.523,2,18,0.111,11,14,0.786,85
1090,LAL,2018-01-23,108,,BOS,1,240,40,91,0.44,33,65,0.508,7,26,0.269,21,36,0.583,108,42,90,0.467,27,46,0.587,15,44,0.341,8,10,0.8,107
1091,BRK,2018-01-23,108,@,OKC,0,240,37,79,0.468,21,41,0.512,16,38,0.421,18,25,0.72,108,40,94,0.426,33,69,0.478,7,25,0.28,22,32,0.688,109
1092,GSW,2018-01-20,108,@,HOU,0,240,40,82,0.488,23,46,0.5,17,36,0.472,11,15,0.733,108,41,87,0.471,27,50,0.54,14,37,0.378,20,29,0.69,116
1093,DAL,2018-01-20,108,@,POR,0,240,38,83,0.458,28,58,0.483,10,25,0.4,22,28,0.786,108,45,86,0.523,27,50,0.54,18,36,0.5,9,10,0.9,117
1094,PHO,2018-01-19,108,@,DEN,1,240,40,81,0.494,26,48,0.542,14,33,0.424,14,20,0.7,108,35,78,0.449,21,42,0.5,14,36,0.389,16,21,0.762,100
1095,ORL,2018-01-16,108,,MIN,1,240,40,90,0.444,29,59,0.492,11,31,0.355,17,19,0.895,108,43,98,0.439,36,82,0.439,7,16,0.438,9,10,0.9,102
1096,CLE,2018-01-15,108,,GSW,0,240,43,94,0.457,36,66,0.545,7,28,0.25,15,22,0.682,108,41,85,0.482,29,53,0.547,12,32,0.375,24,30,0.8,118
1097,NYK,2018-01-12,108,@,MIN,0,240,45,83,0.542,33,59,0.559,12,24,0.5,6,9,0.667,108,49,95,0.516,39,68,0.574,10,27,0.37,10,16,0.625,118
1098,GSW,2018-01-12,108,@,MIL,1,240,44,79,0.557,39,64,0.609,5,15,0.333,15,18,0.833,108,36,85,0.424,25,57,0.439,11,28,0.393,11,12,0.917,94
1099,LAC,2018-01-08,108,,ATL,1,240,38,85,0.447,29,67,0.433,9,18,0.5,23,34,0.676,108,38,96,0.396,28,59,0.475,10,37,0.27,21,29,0.724,107
1100,DET,2018-01-06,108,,HOU,1,240,38,75,0.507,26,50,0.52,12,25,0.48,20,27,0.741,108,38,90,0.422,23,43,0.535,15,47,0.319,10,11,0.909,101
1101,CHO,2018-01-05,108,@,LAL,1,240,42,99,0.424,30,66,0.455,12,33,0.364,12,16,0.75,108,38,94,0.404,29,58,0.5,9,36,0.25,9,12,0.75,94
1102,NOP,2018-01-03,108,@,UTA,1,240,41,82,0.5,27,52,0.519,14,30,0.467,12,12,1.0,108,38,84,0.452,31,52,0.596,7,32,0.219,15,17,0.882,98
1103,BOS,2017-12-31,108,,BRK,1,240,39,79,0.494,25,46,0.543,14,33,0.424,16,25,0.64,108,39,95,0.411,28,59,0.475,11,36,0.306,16,19,0.842,105
1104,SAS,2017-12-23,108,@,SAC,1,240,44,88,0.5,33,65,0.508,11,23,0.478,9,11,0.818,108,40,86,0.465,28,64,0.438,12,22,0.545,7,11,0.636,99
1105,LAC,2017-12-20,108,,PHO,1,240,41,87,0.471,31,57,0.544,10,30,0.333,16,24,0.667,108,35,97,0.361,27,62,0.435,8,35,0.229,17,19,0.895,95
1106,MIN,2017-12-18,108,,POR,1,240,42,91,0.462,35,72,0.486,7,19,0.368,17,21,0.81,108,46,84,0.548,36,60,0.6,10,24,0.417,5,5,1.0,107
1107,TOR,2017-12-17,108,,SAC,1,240,36,85,0.424,23,55,0.418,13,30,0.433,23,28,0.821,108,38,81,0.469,27,55,0.491,11,26,0.423,6,8,0.75,93
1108,PHO,2017-12-16,108,@,MIN,1,240,33,72,0.458,22,48,0.458,11,24,0.458,31,35,0.886,108,40,95,0.421,31,68,0.456,9,27,0.333,17,24,0.708,106
1109,MIL,2017-12-13,108,@,NOP,0,240,44,95,0.463,36,68,0.529,8,27,0.296,12,19,0.632,108,45,80,0.563,32,55,0.582,13,25,0.52,12,15,0.8,115
1110,HOU,2017-12-13,108,,CHO,1,240,39,88,0.443,22,43,0.512,17,45,0.378,13,19,0.684,108,36,87,0.414,32,66,0.485,4,21,0.19,20,27,0.741,96
1111,CHI,2017-12-11,108,,BOS,1,240,39,81,0.481,27,52,0.519,12,29,0.414,18,25,0.72,108,33,83,0.398,23,43,0.535,10,40,0.25,9,14,0.643,85
1112,PHI,2017-12-02,108,,DET,1,240,35,86,0.407,25,58,0.431,10,28,0.357,28,32,0.875,108,34,78,0.436,25,47,0.532,9,31,0.29,26,32,0.813,103
1113,DAL,2017-12-02,108,,LAC,1,240,36,79,0.456,20,44,0.455,16,35,0.457,20,26,0.769,108,30,86,0.349,24,64,0.375,6,22,0.273,16,23,0.696,82
1114,NOP,2017-12-01,108,@,UTA,0,240,42,87,0.483,27,57,0.474,15,30,0.5,9,15,0.6,108,42,85,0.494,30,55,0.545,12,30,0.4,18,25,0.72,114
1115,BOS,2017-11-30,108,,PHI,1,240,40,79,0.506,28,50,0.56,12,29,0.414,16,20,0.8,108,35,84,0.417,19,52,0.365,16,32,0.5,11,18,0.611,97
1116,OKC,2017-11-29,108,@,ORL,0,240,38,96,0.396,26,64,0.406,12,32,0.375,20,30,0.667,108,45,76,0.592,32,46,0.696,13,30,0.433,18,26,0.692,121
1117,CLE,2017-11-28,108,,MIA,1,240,40,81,0.494,29,48,0.604,11,33,0.333,17,23,0.739,108,37,84,0.44,27,53,0.509,10,31,0.323,13,20,0.65,97
1118,BOS,2017-11-27,108,,DET,0,240,40,77,0.519,24,44,0.545,16,33,0.485,12,21,0.571,108,44,85,0.518,33,60,0.55,11,25,0.44,19,23,0.826,118
1119,DAL,2017-11-27,108,@,SAS,0,240,41,85,0.482,27,53,0.509,14,32,0.438,12,17,0.706,108,43,82,0.524,33,58,0.569,10,24,0.417,19,21,0.905,115
1120,PHO,2017-11-26,108,@,MIN,0,240,43,85,0.506,30,59,0.508,13,26,0.5,9,12,0.75,108,49,93,0.527,40,72,0.556,9,21,0.429,12,17,0.706,119
1121,POR,2017-11-25,108,@,WAS,1,240,41,80,0.513,32,56,0.571,9,24,0.375,17,22,0.773,108,41,89,0.461,33,66,0.5,8,23,0.348,15,16,0.938,105
1122,MIL,2017-11-25,108,@,UTA,0,240,41,77,0.532,33,56,0.589,8,21,0.381,18,23,0.783,108,46,81,0.568,28,49,0.571,18,32,0.563,11,19,0.579,121
1123,BOS,2017-11-25,108,@,IND,1,240,45,80,0.563,35,55,0.636,10,25,0.4,8,9,0.889,108,38,78,0.487,31,55,0.564,7,23,0.304,15,15,1.0,98
1124,OKC,2017-11-22,108,,GSW,1,240,41,90,0.456,33,65,0.508,8,25,0.32,18,26,0.692,108,33,80,0.413,23,49,0.469,10,31,0.323,15,18,0.833,91
1125,NYK,2017-11-22,108,,TOR,1,240,43,93,0.462,35,69,0.507,8,24,0.333,14,17,0.824,108,37,87,0.425,23,49,0.469,14,38,0.368,12,18,0.667,100
1126,PHI,2017-11-09,108,@,SAC,0,240,37,87,0.425,22,50,0.44,15,37,0.405,19,27,0.704,108,40,93,0.43,28,66,0.424,12,27,0.444,17,28,0.607,109
1127,NYK,2017-11-05,108,,IND,1,240,44,88,0.5,38,65,0.585,6,23,0.261,14,19,0.737,108,37,79,0.468,25,54,0.463,12,25,0.48,15,17,0.882,101
1128,DEN,2017-11-04,108,,GSW,0,240,40,87,0.46,34,63,0.54,6,24,0.25,22,27,0.815,108,50,91,0.549,32,51,0.627,18,40,0.45,9,17,0.529,127
1129,DET,2017-11-04,108,,SAC,1,240,40,79,0.506,27,55,0.491,13,24,0.542,15,22,0.682,108,40,76,0.526,30,55,0.545,10,21,0.476,9,13,0.692,99
1130,SAS,2017-11-03,108,,CHO,1,240,39,83,0.47,30,56,0.536,9,27,0.333,21,26,0.808,108,33,80,0.413,25,56,0.446,8,24,0.333,27,42,0.643,101
1131,BOS,2017-10-30,108,,SAS,1,240,42,88,0.477,31,57,0.544,11,31,0.355,13,16,0.813,108,36,87,0.414,24,61,0.393,12,26,0.462,10,20,0.5,94
1132,IND,2017-10-21,108,@,MIA,0,240,43,96,0.448,36,77,0.468,7,19,0.368,15,21,0.714,108,45,87,0.517,31,53,0.585,14,34,0.412,8,14,0.571,112
1133,LAC,2017-10-19,108,@,LAL,1,240,42,107,0.393,30,74,0.405,12,33,0.364,12,13,0.923,108,37,91,0.407,33,75,0.44,4,16,0.25,14,23,0.609,92
1134,MIL,2017-10-18,108,@,BOS,1,240,38,76,0.5,31,55,0.564,7,21,0.333,25,30,0.833,108,39,91,0.429,28,63,0.444,11,28,0.393,11,21,0.524,100
1135,OKC,2018-04-03,107,,GSW,0,240,35,93,0.376,26,55,0.473,9,38,0.237,28,37,0.757,107,41,83,0.494,33,54,0.611,8,29,0.276,21,24,0.875,111
1136,DEN,2018-04-03,107,,IND,1,240,41,89,0.461,31,57,0.544,10,32,0.313,15,20,0.75,107,41,84,0.488,32,65,0.492,9,19,0.474,13,16,0.813,104
1137,PHO,2018-04-01,107,@,GSW,0,240,41,90,0.456,30,59,0.508,11,31,0.355,14,16,0.875,107,48,89,0.539,35,61,0.574,13,28,0.464,8,9,0.889,117
1138,WAS,2018-03-31,107,,CHO,1,240,40,88,0.455,22,49,0.449,18,39,0.462,9,12,0.75,107,35,77,0.455,29,54,0.537,6,23,0.261,17,27,0.63,93
1139,UTA,2018-03-30,107,,MEM,1,240,40,74,0.541,28,43,0.651,12,31,0.387,15,26,0.577,107,39,81,0.481,30,58,0.517,9,23,0.391,10,15,0.667,97
1140,CLE,2018-03-30,107,,NOP,1,240,43,90,0.478,33,66,0.5,10,24,0.417,11,15,0.733,107,43,89,0.483,32,63,0.508,11,26,0.423,5,6,0.833,102
1141,GSW,2018-03-29,107,,MIL,0,240,41,75,0.547,31,55,0.564,10,20,0.5,15,15,1.0,107,48,87,0.552,37,67,0.552,11,20,0.55,9,10,0.9,116
1142,POR,2018-03-27,107,@,NOP,1,240,44,105,0.419,34,73,0.466,10,32,0.313,9,10,0.9,107,43,94,0.457,39,70,0.557,4,24,0.167,13,14,0.929,103
1143,MIA,2018-03-25,107,@,IND,0,265,41,86,0.477,27,51,0.529,14,35,0.4,11,14,0.786,107,44,90,0.489,36,67,0.537,8,23,0.348,17,21,0.81,113
1144,HOU,2018-03-17,107,@,NOP,1,240,39,93,0.419,24,52,0.462,15,41,0.366,14,18,0.778,107,41,83,0.494,33,59,0.559,8,24,0.333,11,12,0.917,101
1145,PHO,2018-03-13,107,,CLE,0,240,38,98,0.388,32,66,0.485,6,32,0.188,25,30,0.833,107,43,87,0.494,26,52,0.5,17,35,0.486,26,30,0.867,129
1146,ATL,2018-03-13,107,,OKC,0,240,37,87,0.425,24,56,0.429,13,31,0.419,20,24,0.833,107,42,89,0.472,26,54,0.481,16,35,0.457,19,25,0.76,119
1147,SAS,2018-03-08,107,@,GSW,0,240,43,95,0.453,37,73,0.507,6,22,0.273,15,18,0.833,107,41,95,0.432,33,65,0.508,8,30,0.267,20,23,0.87,110
1148,ORL,2018-03-07,107,@,LAL,0,240,42,84,0.5,30,56,0.536,12,28,0.429,11,19,0.579,107,43,88,0.489,32,55,0.582,11,33,0.333,11,12,0.917,108
1149,DEN,2018-03-06,107,@,DAL,0,240,38,92,0.413,27,56,0.482,11,36,0.306,20,26,0.769,107,43,90,0.478,28,63,0.444,15,27,0.556,17,23,0.739,118
1150,ORL,2018-03-03,107,,MEM,1,240,36,72,0.5,28,47,0.596,8,25,0.32,27,33,0.818,107,38,93,0.409,32,71,0.451,6,22,0.273,18,26,0.692,100
1151,ATL,2018-02-28,107,,IND,1,240,38,87,0.437,29,58,0.5,9,29,0.31,22,27,0.815,107,38,90,0.422,27,58,0.466,11,32,0.344,15,20,0.75,102
1152,WAS,2018-02-27,107,@,MIL,1,240,42,88,0.477,35,68,0.515,7,20,0.35,16,22,0.727,107,35,77,0.455,25,51,0.49,10,26,0.385,24,28,0.857,104
1153,SAC,2018-02-22,107,,OKC,0,240,42,91,0.462,30,64,0.469,12,27,0.444,11,15,0.733,107,38,86,0.442,24,51,0.471,14,35,0.4,20,24,0.833,110
1154,UTA,2018-02-14,107,,PHO,1,240,39,92,0.424,29,58,0.5,10,34,0.294,19,22,0.864,107,34,79,0.43,22,50,0.44,12,29,0.414,17,24,0.708,97
1155,ATL,2018-02-09,107,,CLE,0,240,37,83,0.446,21,39,0.538,16,44,0.364,17,19,0.895,107,46,86,0.535,31,51,0.608,15,35,0.429,16,24,0.667,123
1156,NOP,2018-02-03,107,@,MIN,0,240,42,101,0.416,34,68,0.5,8,33,0.242,15,17,0.882,107,48,95,0.505,38,74,0.514,10,21,0.476,12,16,0.75,118
1157,MIA,2018-02-03,107,@,DET,0,240,44,91,0.484,30,55,0.545,14,36,0.389,5,7,0.714,107,44,84,0.524,35,58,0.603,9,26,0.346,14,17,0.824,111
1158,ORL,2018-01-30,107,@,HOU,0,240,42,83,0.506,27,52,0.519,15,31,0.484,8,10,0.8,107,39,77,0.506,26,42,0.619,13,35,0.371,23,28,0.821,114
1159,MIL,2018-01-29,107,,PHI,1,240,38,80,0.475,27,52,0.519,11,28,0.393,20,22,0.909,107,36,82,0.439,34,56,0.607,2,26,0.077,21,23,0.913,95
1160,NYK,2018-01-26,107,@,PHO,1,240,41,85,0.482,32,60,0.533,9,25,0.36,16,22,0.727,107,33,94,0.351,22,61,0.361,11,33,0.333,8,13,0.615,85
1161,POR,2018-01-26,107,@,DAL,1,240,39,79,0.494,29,49,0.592,10,30,0.333,19,23,0.826,107,35,89,0.393,25,59,0.424,10,30,0.333,13,17,0.765,93
1162,BOS,2018-01-23,107,@,LAL,0,240,42,90,0.467,27,46,0.587,15,44,0.341,8,10,0.8,107,40,91,0.44,33,65,0.508,7,26,0.269,21,36,0.583,108
1163,SAC,2018-01-22,107,@,CHO,0,240,43,97,0.443,33,75,0.44,10,22,0.455,11,15,0.733,107,38,86,0.442,22,46,0.478,16,40,0.4,20,25,0.8,112
1164,NYK,2018-01-21,107,@,LAL,0,240,44,81,0.543,32,56,0.571,12,25,0.48,7,10,0.7,107,51,91,0.56,41,65,0.631,10,26,0.385,15,21,0.714,127
1165,DET,2018-01-15,107,,CHO,0,240,42,86,0.488,27,57,0.474,15,29,0.517,8,11,0.727,107,43,84,0.512,33,63,0.524,10,21,0.476,22,33,0.667,118
1166,LAL,2018-01-13,107,@,DAL,1,265,43,95,0.453,35,69,0.507,8,26,0.308,13,18,0.722,107,34,90,0.378,23,47,0.489,11,43,0.256,22,28,0.786,101
1167,CHI,2018-01-13,107,,DET,1,240,42,87,0.483,25,51,0.49,17,36,0.472,6,9,0.667,107,41,92,0.446,29,63,0.46,12,29,0.414,11,14,0.786,105
1168,UTA,2018-01-10,107,@,WAS,1,240,43,92,0.467,32,59,0.542,11,33,0.333,10,13,0.769,107,41,78,0.526,31,53,0.585,10,25,0.4,12,17,0.706,104
1169,ATL,2018-01-08,107,@,LAC,0,240,38,96,0.396,28,59,0.475,10,37,0.27,21,29,0.724,107,38,85,0.447,29,67,0.433,9,18,0.5,23,34,0.676,108
1170,CHI,2018-01-08,107,,HOU,0,240,40,86,0.465,28,58,0.483,12,28,0.429,15,18,0.833,107,39,86,0.453,19,32,0.594,20,54,0.37,18,24,0.75,116
1171,SAS,2018-01-08,107,@,SAC,1,240,44,90,0.489,33,64,0.516,11,26,0.423,8,13,0.615,107,40,82,0.488,32,59,0.542,8,23,0.348,12,16,0.75,100
1172,MIA,2018-01-05,107,,NYK,1,265,38,94,0.404,26,52,0.5,12,42,0.286,19,20,0.95,107,39,80,0.488,34,67,0.507,5,13,0.385,20,23,0.87,103
1173,MIN,2017-12-31,107,@,IND,1,240,41,86,0.477,37,67,0.552,4,19,0.211,21,25,0.84,107,33,85,0.388,23,60,0.383,10,25,0.4,14,18,0.778,90
1174,PHI,2017-12-30,107,@,DEN,1,240,45,93,0.484,37,69,0.536,8,24,0.333,9,10,0.9,107,35,87,0.402,28,55,0.509,7,32,0.219,25,34,0.735,102
1175,IND,2017-12-29,107,@,CHI,0,240,43,93,0.462,36,71,0.507,7,22,0.318,14,20,0.7,107,43,85,0.506,25,46,0.543,18,39,0.462,15,15,1.0,119
1176,NYK,2017-12-28,107,@,SAS,0,240,41,90,0.456,36,76,0.474,5,14,0.357,20,22,0.909,107,41,80,0.513,32,60,0.533,9,20,0.45,28,39,0.718,119
1177,TOR,2017-12-27,107,@,OKC,0,240,36,85,0.424,25,47,0.532,11,38,0.289,24,26,0.923,107,46,87,0.529,37,62,0.597,9,25,0.36,23,33,0.697,124
1178,DEN,2017-12-26,107,,UTA,1,240,39,81,0.481,28,51,0.549,11,30,0.367,18,22,0.818,107,27,84,0.321,17,49,0.347,10,35,0.286,19,23,0.826,83
1179,MIA,2017-12-26,107,,ORL,1,240,41,91,0.451,30,58,0.517,11,33,0.333,14,17,0.824,107,33,81,0.407,28,61,0.459,5,20,0.25,18,22,0.818,89
1180,DET,2017-12-26,107,,IND,1,240,41,82,0.5,29,48,0.604,12,34,0.353,13,16,0.813,107,34,77,0.442,28,56,0.5,6,21,0.286,9,13,0.692,83
1181,HOU,2017-12-25,107,@,OKC,0,240,35,81,0.432,23,44,0.523,12,37,0.324,25,31,0.806,107,43,79,0.544,35,61,0.574,8,18,0.444,18,23,0.783,112
1182,DAL,2017-12-23,107,@,ATL,0,240,43,85,0.506,34,52,0.654,9,33,0.273,12,15,0.8,107,42,75,0.56,32,51,0.627,10,24,0.417,18,22,0.818,112
1183,OKC,2017-12-20,107,,UTA,1,240,40,77,0.519,32,54,0.593,8,23,0.348,19,22,0.864,107,26,73,0.356,19,42,0.452,7,31,0.226,20,27,0.741,79
1184,POR,2017-12-18,107,@,MIN,0,240,46,84,0.548,36,60,0.6,10,24,0.417,5,5,1.0,107,42,91,0.462,35,72,0.486,7,19,0.368,17,21,0.81,108
1185,UTA,2017-12-15,107,@,BOS,1,240,40,83,0.482,27,58,0.466,13,25,0.52,14,18,0.778,107,35,86,0.407,26,55,0.473,9,31,0.29,16,19,0.842,95
1186,MIA,2017-12-11,107,@,MEM,1,240,37,66,0.561,23,39,0.59,14,27,0.519,19,24,0.792,107,28,72,0.389,20,45,0.444,8,27,0.296,18,27,0.667,82
1187,ATL,2017-12-10,107,@,NYK,0,240,37,77,0.481,28,46,0.609,9,31,0.29,24,30,0.8,107,39,80,0.488,34,63,0.54,5,17,0.294,28,34,0.824,111
1188,MEM,2017-12-08,107,,TOR,0,240,41,82,0.5,32,55,0.582,9,27,0.333,16,22,0.727,107,37,78,0.474,24,47,0.511,13,31,0.419,29,33,0.879,116
1189,LAL,2017-12-07,107,@,PHI,1,240,42,96,0.438,31,68,0.456,11,28,0.393,12,24,0.5,107,39,81,0.481,29,55,0.527,10,26,0.385,16,21,0.762,104
1190,LAC,2017-12-06,107,,MIN,0,240,44,99,0.444,34,67,0.507,10,32,0.313,9,15,0.6,107,45,82,0.549,38,63,0.603,7,19,0.368,16,21,0.762,113
1191,MIN,2017-12-01,107,@,OKC,0,240,39,76,0.513,27,52,0.519,12,24,0.5,17,21,0.81,107,41,79,0.519,33,53,0.623,8,26,0.308,21,22,0.955,111
1192,SAC,2017-12-01,107,@,CHI,1,240,45,85,0.529,39,67,0.582,6,18,0.333,11,14,0.786,107,42,90,0.467,29,54,0.537,13,36,0.361,9,13,0.692,106
1193,LAC,2017-11-30,107,,UTA,0,240,38,70,0.543,28,41,0.683,10,29,0.345,21,30,0.7,107,49,85,0.576,32,50,0.64,17,35,0.486,11,14,0.786,126
1194,PHO,2017-11-29,107,@,DET,0,240,39,84,0.464,32,62,0.516,7,22,0.318,22,28,0.786,107,51,89,0.573,38,61,0.623,13,28,0.464,16,21,0.762,131
1195,IND,2017-11-24,107,,TOR,1,240,38,83,0.458,27,57,0.474,11,26,0.423,20,27,0.741,107,40,81,0.494,31,51,0.608,9,30,0.3,15,20,0.75,104
1196,PHO,2017-11-22,107,,MIL,0,265,37,93,0.398,30,71,0.423,7,22,0.318,26,33,0.788,107,42,97,0.433,34,68,0.5,8,29,0.276,21,31,0.677,113
1197,NOP,2017-11-22,107,,SAS,1,240,39,81,0.481,32,57,0.561,7,24,0.292,22,24,0.917,107,35,88,0.398,29,64,0.453,6,24,0.25,14,15,0.933,90
1198,NYK,2017-11-20,107,,LAC,1,240,35,81,0.432,22,47,0.468,13,34,0.382,24,25,0.96,107,30,80,0.375,20,48,0.417,10,32,0.313,15,21,0.714,85
1199,OKC,2017-11-20,107,@,NOP,0,240,38,89,0.427,27,54,0.5,11,35,0.314,20,26,0.769,107,41,80,0.513,34,55,0.618,7,25,0.28,25,32,0.781,114
1200,PHI,2017-11-20,107,,UTA,1,240,44,85,0.518,40,70,0.571,4,15,0.267,15,22,0.682,107,30,85,0.353,21,57,0.368,9,28,0.321,17,19,0.895,86
1201,IND,2017-11-17,107,,DET,1,240,39,89,0.438,24,61,0.393,15,28,0.536,14,21,0.667,107,39,93,0.419,25,60,0.417,14,33,0.424,8,10,0.8,100
1202,TOR,2017-11-17,107,,NYK,1,240,44,78,0.564,35,52,0.673,9,26,0.346,10,11,0.909,107,30,91,0.33,21,68,0.309,9,23,0.391,15,17,0.882,84
1203,UTA,2017-11-17,107,@,BRK,0,240,39,79,0.494,27,53,0.509,12,26,0.462,17,24,0.708,107,43,84,0.512,26,47,0.553,17,37,0.459,15,20,0.75,118
1204,CHO,2017-11-15,107,,CLE,0,240,41,86,0.477,35,60,0.583,6,26,0.231,19,28,0.679,107,42,95,0.442,29,57,0.509,13,38,0.342,18,20,0.9,115
1205,ORL,2017-11-11,107,@,DEN,0,240,41,87,0.471,30,56,0.536,11,31,0.355,14,20,0.7,107,46,87,0.529,34,58,0.586,12,29,0.414,21,27,0.778,125
1206,BOS,2017-11-08,107,,LAL,1,240,38,98,0.388,31,69,0.449,7,29,0.241,24,31,0.774,107,37,85,0.435,32,61,0.525,5,24,0.208,17,23,0.739,96
1207,LAC,2017-11-07,107,@,SAS,0,240,42,82,0.512,31,52,0.596,11,30,0.367,12,17,0.706,107,45,84,0.536,30,56,0.536,15,28,0.536,15,19,0.789,120
1208,ATL,2017-11-06,107,,BOS,0,240,39,81,0.481,26,55,0.473,13,26,0.5,16,20,0.8,107,39,81,0.481,25,45,0.556,14,36,0.389,18,22,0.818,110
1209,LAL,2017-11-05,107,,MEM,1,240,40,85,0.471,31,58,0.534,9,27,0.333,18,23,0.783,107,40,87,0.46,29,50,0.58,11,37,0.297,11,14,0.786,102
1210,WAS,2017-11-05,107,@,TOR,1,240,40,85,0.471,29,62,0.468,11,23,0.478,16,23,0.696,107,37,80,0.463,32,56,0.571,5,24,0.208,17,27,0.63,96
1211,PHO,2017-11-03,107,@,NYK,0,240,34,97,0.351,25,65,0.385,9,32,0.281,30,37,0.811,107,45,87,0.517,37,61,0.607,8,26,0.308,22,25,0.88,120
1212,CLE,2017-11-01,107,,IND,0,240,43,86,0.5,36,55,0.655,7,31,0.226,14,20,0.7,107,49,90,0.544,33,64,0.516,16,26,0.615,10,13,0.769,124
1213,HOU,2017-10-30,107,,PHI,0,240,33,83,0.398,20,36,0.556,13,47,0.277,28,38,0.737,107,44,80,0.55,34,56,0.607,10,24,0.417,17,24,0.708,115
1214,GSW,2017-10-29,107,,DET,0,240,44,77,0.571,34,50,0.68,10,27,0.37,9,12,0.75,107,43,93,0.462,31,66,0.47,12,27,0.444,17,17,1.0,115
1215,PHO,2017-10-28,107,@,POR,0,240,37,87,0.425,28,61,0.459,9,26,0.346,24,30,0.8,107,40,91,0.44,29,65,0.446,11,26,0.423,23,28,0.821,114
1216,NYK,2017-10-27,107,,BRK,1,240,44,98,0.449,35,71,0.493,9,27,0.333,10,17,0.588,107,30,75,0.4,19,45,0.422,11,30,0.367,15,21,0.714,86
1217,CLE,2017-10-25,107,@,BRK,0,240,39,81,0.481,27,46,0.587,12,35,0.343,17,26,0.654,107,40,93,0.43,23,47,0.489,17,46,0.37,15,21,0.714,112
1218,MIN,2017-10-24,107,,IND,0,240,42,86,0.488,33,62,0.532,9,24,0.375,14,22,0.636,107,56,84,0.667,46,62,0.742,10,22,0.455,8,11,0.727,130
1219,HOU,2017-10-21,107,,DAL,1,240,39,82,0.476,28,35,0.8,11,47,0.234,18,22,0.818,107,31,84,0.369,18,53,0.34,13,31,0.419,16,21,0.762,91
1220,NYK,2017-10-21,107,,DET,0,240,37,81,0.457,29,51,0.569,8,30,0.267,25,31,0.806,107,44,91,0.484,35,61,0.574,9,30,0.3,14,15,0.933,111
1221,SAS,2017-10-18,107,,MIN,1,240,41,89,0.461,33,68,0.485,8,21,0.381,17,19,0.895,107,37,85,0.435,29,66,0.439,8,19,0.421,17,23,0.739,99
1222,DEN,2018-04-11,106,@,MIN,0,265,41,90,0.456,28,58,0.483,13,32,0.406,11,18,0.611,106,42,89,0.472,33,66,0.5,9,23,0.391,19,25,0.76,112
1223,BOS,2018-04-08,106,,ATL,0,240,42,82,0.512,33,59,0.559,9,23,0.391,13,20,0.65,106,43,86,0.5,28,51,0.549,15,35,0.429,11,14,0.786,112
1224,DAL,2018-04-06,106,@,DET,0,265,40,92,0.435,27,53,0.509,13,39,0.333,13,18,0.722,106,46,92,0.5,34,62,0.548,12,30,0.4,9,17,0.529,113
1225,GSW,2018-04-05,106,@,IND,0,240,37,83,0.446,28,54,0.519,9,29,0.31,23,24,0.958,106,50,93,0.538,35,64,0.547,15,29,0.517,11,15,0.733,126
1226,MIL,2018-04-03,106,,BOS,1,240,43,79,0.544,38,59,0.644,5,20,0.25,15,21,0.714,106,38,81,0.469,31,58,0.534,7,23,0.304,19,24,0.792,102
1227,TOR,2018-04-03,106,@,CLE,0,240,42,94,0.447,31,60,0.517,11,34,0.324,11,14,0.786,106,38,77,0.494,25,47,0.532,13,30,0.433,23,26,0.885,112
1228,IND,2018-03-29,106,@,SAC,1,240,40,80,0.5,32,54,0.593,8,26,0.308,18,20,0.9,106,42,78,0.538,29,47,0.617,13,31,0.419,6,9,0.667,103
1229,SAS,2018-03-27,106,@,WAS,0,240,39,87,0.448,29,62,0.468,10,25,0.4,18,33,0.545,106,46,85,0.541,36,61,0.59,10,24,0.417,14,18,0.778,116
1230,LAL,2018-03-26,106,@,DET,0,240,40,85,0.471,34,62,0.548,6,23,0.261,20,25,0.8,106,44,100,0.44,31,67,0.463,13,33,0.394,11,15,0.733,112
1231,MIL,2018-03-25,106,,SAS,1,240,42,86,0.488,33,59,0.559,9,27,0.333,13,18,0.722,106,41,92,0.446,37,75,0.493,4,17,0.235,17,21,0.81,103
1232,TOR,2018-03-25,106,,LAC,0,240,41,92,0.446,25,56,0.446,16,36,0.444,8,14,0.571,106,44,95,0.463,36,77,0.468,8,18,0.444,21,27,0.778,117
1233,GSW,2018-03-23,106,,ATL,1,240,42,93,0.452,30,63,0.476,12,30,0.4,10,11,0.909,106,37,84,0.44,26,52,0.5,11,32,0.344,9,20,0.45,94
1234,DET,2018-03-19,106,@,SAC,1,240,37,79,0.468,23,50,0.46,14,29,0.483,18,22,0.818,106,40,88,0.455,34,65,0.523,6,23,0.261,4,9,0.444,90
1235,DAL,2018-03-17,106,@,BRK,0,240,41,92,0.446,29,70,0.414,12,22,0.545,12,14,0.857,106,43,84,0.512,29,48,0.604,14,36,0.389,14,19,0.737,114
1236,TOR,2018-03-15,106,@,IND,1,240,35,79,0.443,23,47,0.489,12,32,0.375,24,28,0.857,106,40,93,0.43,33,69,0.478,7,24,0.292,12,17,0.706,99
1237,LAL,2018-03-14,106,@,GSW,0,240,38,84,0.452,26,46,0.565,12,38,0.316,18,28,0.643,106,44,81,0.543,38,61,0.623,6,20,0.3,23,28,0.821,117
1238,CHI,2018-03-13,106,,LAC,0,240,43,101,0.426,36,72,0.5,7,29,0.241,13,15,0.867,106,37,76,0.487,29,47,0.617,8,29,0.276,30,41,0.732,112
1239,OKC,2018-03-12,106,,SAC,1,240,38,84,0.452,22,48,0.458,16,36,0.444,14,18,0.778,106,38,93,0.409,26,60,0.433,12,33,0.364,13,16,0.813,101
1240,NYK,2018-03-11,106,,TOR,0,240,40,88,0.455,33,67,0.493,7,21,0.333,19,24,0.792,106,47,93,0.505,31,58,0.534,16,35,0.457,22,25,0.88,132
1241,TOR,2018-03-06,106,,ATL,1,240,34,88,0.386,24,52,0.462,10,36,0.278,28,33,0.848,106,34,80,0.425,28,59,0.475,6,21,0.286,16,21,0.762,90
1242,DET,2018-03-02,106,@,ORL,0,265,40,92,0.435,28,63,0.444,12,29,0.414,14,24,0.583,106,44,86,0.512,31,50,0.62,13,36,0.361,14,19,0.737,115
1243,CHO,2018-02-28,106,@,BOS,0,240,42,91,0.462,33,64,0.516,9,27,0.333,13,22,0.591,106,54,87,0.621,42,67,0.627,12,20,0.6,14,15,0.933,134
1244,POR,2018-02-24,106,@,PHO,1,240,39,99,0.394,33,69,0.478,6,30,0.2,22,30,0.733,106,39,87,0.448,28,61,0.459,11,26,0.423,15,21,0.714,104
1245,SAC,2018-02-11,106,@,MIN,0,240,42,88,0.477,32,63,0.508,10,25,0.4,12,17,0.706,106,37,74,0.5,28,50,0.56,9,24,0.375,28,32,0.875,111
1246,UTA,2018-02-09,106,,CHO,1,240,41,84,0.488,31,55,0.564,10,29,0.345,14,17,0.824,106,35,85,0.412,26,61,0.426,9,24,0.375,15,19,0.789,94
1247,LAL,2018-02-08,106,,OKC,1,240,42,96,0.438,32,65,0.492,10,31,0.323,12,13,0.923,106,32,90,0.356,24,56,0.429,8,34,0.235,9,19,0.474,81
1248,BRK,2018-02-07,106,@,DET,0,240,39,90,0.433,22,39,0.564,17,51,0.333,11,12,0.917,106,44,92,0.478,35,68,0.515,9,24,0.375,18,25,0.72,115
1249,DAL,2018-02-03,106,@,SAC,1,240,41,83,0.494,28,42,0.667,13,41,0.317,11,14,0.786,106,43,82,0.524,35,55,0.636,8,27,0.296,5,6,0.833,99
1250,SAS,2018-01-30,106,,DEN,1,240,46,92,0.5,37,68,0.544,9,24,0.375,5,5,1.0,106,40,86,0.465,30,63,0.476,10,23,0.435,14,14,1.0,104
1251,MIA,2018-01-20,106,@,CHO,1,240,43,87,0.494,30,59,0.508,13,28,0.464,7,12,0.583,106,41,90,0.456,34,63,0.54,7,27,0.259,16,21,0.762,105
1252,MEM,2018-01-19,106,,SAC,1,240,39,88,0.443,29,54,0.537,10,34,0.294,18,23,0.783,106,32,80,0.4,21,53,0.396,11,27,0.407,13,18,0.722,88
1253,MIA,2018-01-17,106,@,MIL,1,240,38,82,0.463,28,58,0.483,10,24,0.417,20,27,0.741,106,33,76,0.434,22,48,0.458,11,28,0.393,24,32,0.75,101
1254,GSW,2018-01-10,106,,LAC,0,240,38,79,0.481,30,56,0.536,8,23,0.348,22,26,0.846,106,46,94,0.489,35,70,0.5,11,24,0.458,22,28,0.786,125
1255,IND,2018-01-10,106,,MIA,0,240,43,87,0.494,42,69,0.609,1,18,0.056,19,29,0.655,106,43,81,0.531,30,51,0.588,13,30,0.433,15,21,0.714,114
1256,OKC,2018-01-09,106,,POR,0,240,37,84,0.44,24,53,0.453,13,31,0.419,19,26,0.731,106,43,81,0.531,33,58,0.569,10,23,0.435,21,26,0.808,117
1257,SAC,2018-01-06,106,,DEN,1,240,42,94,0.447,33,69,0.478,9,25,0.36,13,17,0.765,106,35,76,0.461,22,42,0.524,13,34,0.382,15,21,0.714,98
1258,SAS,2018-01-03,106,@,PHI,0,240,39,87,0.448,31,62,0.5,8,25,0.32,20,23,0.87,106,36,80,0.45,29,58,0.5,7,22,0.318,33,43,0.767,112
1259,LAC,2017-12-31,106,,CHO,1,240,36,76,0.474,26,48,0.542,10,28,0.357,24,27,0.889,106,36,93,0.387,25,60,0.417,11,33,0.333,15,19,0.789,98
1260,LAL,2017-12-29,106,,LAC,0,240,46,94,0.489,43,75,0.573,3,19,0.158,11,16,0.688,106,42,86,0.488,33,54,0.611,9,32,0.281,28,34,0.824,121
1261,MIL,2017-12-26,106,,CHI,0,240,39,83,0.47,29,52,0.558,10,31,0.323,18,24,0.75,106,45,103,0.437,35,75,0.467,10,28,0.357,15,25,0.6,115
1262,MIL,2017-12-23,106,@,CHO,0,240,42,87,0.483,34,61,0.557,8,26,0.308,14,17,0.824,106,36,74,0.486,27,53,0.509,9,21,0.429,30,40,0.75,111
1263,PHO,2017-12-23,106,,MIN,0,240,40,86,0.465,29,54,0.537,11,32,0.344,15,24,0.625,106,42,84,0.5,36,68,0.529,6,16,0.375,25,29,0.862,115
1264,LAL,2017-12-22,106,@,GSW,0,240,40,94,0.426,29,65,0.446,11,29,0.379,15,22,0.682,106,42,85,0.494,35,61,0.574,7,24,0.292,22,27,0.815,113
1265,NOP,2017-12-19,106,@,WAS,0,240,34,80,0.425,29,60,0.483,5,20,0.25,33,40,0.825,106,46,92,0.5,32,57,0.561,14,35,0.4,10,14,0.714,116
1266,CLE,2017-12-17,106,@,WAS,1,240,41,87,0.471,27,53,0.509,14,34,0.412,10,12,0.833,106,39,91,0.429,27,58,0.466,12,33,0.364,9,16,0.563,99
1267,MIN,2017-12-16,106,,PHO,0,240,40,95,0.421,31,68,0.456,9,27,0.333,17,24,0.708,106,33,72,0.458,22,48,0.458,11,24,0.458,31,35,0.886,108
1268,LAC,2017-12-13,106,@,ORL,1,240,39,88,0.443,27,62,0.435,12,26,0.462,16,20,0.8,106,37,88,0.42,28,61,0.459,9,27,0.333,12,21,0.571,95
1269,IND,2017-12-08,106,,CLE,1,240,38,86,0.442,23,47,0.489,15,39,0.385,15,24,0.625,106,37,85,0.435,26,49,0.531,11,36,0.306,17,22,0.773,102
1270,ATL,2017-12-06,106,@,ORL,0,265,40,93,0.43,29,66,0.439,11,27,0.407,15,20,0.75,106,46,98,0.469,40,70,0.571,6,28,0.214,12,18,0.667,110
1271,WAS,2017-12-05,106,@,POR,1,240,42,89,0.472,31,64,0.484,11,25,0.44,11,14,0.786,106,32,78,0.41,20,51,0.392,12,27,0.444,16,21,0.762,92
1272,LAC,2017-12-03,106,@,MIN,0,240,37,73,0.507,22,39,0.564,15,34,0.441,17,22,0.773,106,38,88,0.432,30,62,0.484,8,26,0.308,28,31,0.903,112
1273,CHI,2017-12-01,106,,SAC,0,240,42,90,0.467,29,54,0.537,13,36,0.361,9,13,0.692,106,45,85,0.529,39,67,0.582,6,18,0.333,11,14,0.786,107
1274,UTA,2017-11-28,106,,DEN,1,240,42,87,0.483,28,55,0.509,14,32,0.438,8,9,0.889,106,28,78,0.359,21,44,0.477,7,34,0.206,14,16,0.875,77
1275,GSW,2017-11-27,106,,SAC,0,240,40,80,0.5,24,43,0.558,16,37,0.432,10,14,0.714,106,42,79,0.532,33,62,0.532,9,17,0.529,17,21,0.81,110
1276,SAS,2017-11-25,106,@,CHO,1,240,39,81,0.481,33,56,0.589,6,25,0.24,22,25,0.88,106,31,84,0.369,27,59,0.458,4,25,0.16,20,26,0.769,86
1277,NYK,2017-11-15,106,,UTA,1,240,38,81,0.469,29,60,0.483,9,21,0.429,21,25,0.84,106,34,79,0.43,17,44,0.386,17,35,0.486,16,17,0.941,101
1278,NOP,2017-11-13,106,,ATL,1,240,41,75,0.547,28,42,0.667,13,33,0.394,11,17,0.647,106,40,87,0.46,23,51,0.451,17,36,0.472,8,9,0.889,105
1279,BRK,2017-11-11,106,@,UTA,0,240,35,76,0.461,28,53,0.528,7,23,0.304,29,39,0.744,106,41,85,0.482,30,56,0.536,11,29,0.379,21,25,0.84,114
1280,ATL,2017-10-29,106,,MIL,0,240,36,77,0.468,23,48,0.479,13,29,0.448,21,26,0.808,106,44,81,0.543,31,55,0.564,13,26,0.5,16,21,0.762,117
1281,SAC,2017-10-26,106,,NOP,0,240,38,81,0.469,31,61,0.508,7,20,0.35,23,25,0.92,106,42,86,0.488,29,54,0.537,13,32,0.406,17,23,0.739,114
1282,UTA,2017-10-18,106,,DEN,1,240,41,81,0.506,32,57,0.561,9,24,0.375,15,16,0.938,106,36,77,0.468,23,50,0.46,13,27,0.481,11,12,0.917,96
1283,HOU,2018-04-10,105,@,LAL,1,240,37,88,0.42,21,41,0.512,16,47,0.34,15,16,0.938,105,38,90,0.422,28,54,0.519,10,36,0.278,13,15,0.867,99
1284,CHI,2018-04-09,105,@,BRK,0,240,43,89,0.483,31,61,0.508,12,28,0.429,7,12,0.583,105,41,82,0.5,23,40,0.575,18,42,0.429,14,15,0.933,114
1285,POR,2018-04-07,105,@,SAS,0,240,42,88,0.477,31,60,0.517,11,28,0.393,10,11,0.909,105,47,84,0.56,40,63,0.635,7,21,0.333,15,21,0.714,116
1286,ORL,2018-04-04,105,,DAL,1,240,39,86,0.453,31,57,0.544,8,29,0.276,19,27,0.704,105,39,89,0.438,29,59,0.492,10,30,0.333,12,17,0.706,100
1287,POR,2018-03-30,105,,LAC,1,240,41,95,0.432,33,65,0.508,8,30,0.267,15,16,0.938,105,36,89,0.404,32,76,0.421,4,13,0.308,20,35,0.571,96
1288,CHO,2018-03-28,105,,CLE,0,240,39,76,0.513,34,55,0.618,5,21,0.238,22,24,0.917,105,45,93,0.484,34,65,0.523,11,28,0.393,17,20,0.85,118
1289,LAC,2018-03-27,105,,MIL,1,240,40,86,0.465,25,58,0.431,15,28,0.536,10,18,0.556,105,38,83,0.458,32,60,0.533,6,23,0.261,16,23,0.696,98
1290,OKC,2018-03-25,105,,POR,0,240,37,84,0.44,29,57,0.509,8,27,0.296,23,28,0.821,105,42,90,0.467,33,56,0.589,9,34,0.265,15,19,0.789,108
1291,ORL,2018-03-24,105,,PHO,1,240,37,84,0.44,26,54,0.481,11,30,0.367,20,27,0.741,105,36,89,0.404,29,60,0.483,7,29,0.241,20,26,0.769,99
1292,BOS,2018-03-23,105,@,POR,1,240,35,77,0.455,24,59,0.407,11,18,0.611,24,26,0.923,105,40,91,0.44,32,58,0.552,8,33,0.242,12,15,0.8,100
1293,OKC,2018-03-23,105,,MIA,1,240,36,84,0.429,28,58,0.483,8,26,0.308,25,33,0.758,105,34,87,0.391,21,57,0.368,13,30,0.433,18,20,0.9,99
1294,CHI,2018-03-23,105,,MIL,0,240,36,87,0.414,24,61,0.393,12,26,0.462,21,23,0.913,105,43,87,0.494,28,57,0.491,15,30,0.5,17,19,0.895,118
1295,SAC,2018-03-22,105,,ATL,1,240,43,93,0.462,33,72,0.458,10,21,0.476,9,9,1.0,105,33,84,0.393,21,48,0.438,12,36,0.333,12,18,0.667,90
1296,MEM,2018-03-21,105,@,PHI,0,240,40,99,0.404,31,72,0.431,9,27,0.333,16,20,0.8,105,46,84,0.548,35,53,0.66,11,31,0.355,16,20,0.8,119
1297,BRK,2018-03-21,105,,CHO,0,240,39,93,0.419,26,56,0.464,13,37,0.351,14,21,0.667,105,36,94,0.383,33,78,0.423,3,16,0.188,36,47,0.766,111
1298,DAL,2018-03-20,105,@,NOP,0,240,43,90,0.478,33,55,0.6,10,35,0.286,9,11,0.818,105,48,91,0.527,38,66,0.576,10,25,0.4,9,15,0.6,115
1299,CLE,2018-03-15,105,@,POR,0,240,41,80,0.513,30,47,0.638,11,33,0.333,12,21,0.571,105,43,96,0.448,31,61,0.508,12,35,0.343,15,19,0.789,113
1300,HOU,2018-03-11,105,@,DAL,1,240,39,84,0.464,22,39,0.564,17,45,0.378,10,14,0.714,105,33,94,0.351,28,63,0.444,5,31,0.161,11,18,0.611,82
1301,ORL,2018-03-10,105,@,LAC,0,240,38,84,0.452,30,60,0.5,8,24,0.333,21,27,0.778,105,41,78,0.526,34,60,0.567,7,18,0.389,24,28,0.857,113
1302,HOU,2018-03-09,105,@,TOR,0,240,40,81,0.494,31,54,0.574,9,27,0.333,16,23,0.696,105,41,85,0.482,26,47,0.553,15,38,0.395,11,14,0.786,108
1303,BOS,2018-03-05,105,@,CHI,1,240,41,84,0.488,29,48,0.604,12,36,0.333,11,12,0.917,105,32,81,0.395,20,48,0.417,12,33,0.364,13,20,0.65,89
1304,MIA,2018-03-03,105,,DET,1,240,37,82,0.451,25,53,0.472,12,29,0.414,19,28,0.679,105,37,89,0.416,30,65,0.462,7,24,0.292,15,21,0.714,96
1305,NYK,2018-03-02,105,@,LAC,0,240,41,89,0.461,30,64,0.469,11,25,0.44,12,16,0.75,105,50,89,0.562,41,64,0.641,9,25,0.36,19,24,0.792,128
1306,HOU,2018-02-28,105,@,LAC,1,240,36,85,0.424,23,42,0.548,13,43,0.302,20,24,0.833,105,36,79,0.456,29,56,0.518,7,23,0.304,13,19,0.684,92
1307,ORL,2018-02-26,105,@,OKC,0,240,39,84,0.464,27,55,0.491,12,29,0.414,15,21,0.714,105,42,88,0.477,31,63,0.492,11,25,0.44,17,20,0.85,112
1308,ORL,2018-02-24,105,@,PHI,0,240,38,85,0.447,25,54,0.463,13,31,0.419,16,19,0.842,105,42,81,0.519,33,54,0.611,9,27,0.333,23,27,0.852,116
1309,WAS,2018-02-23,105,,CHO,0,240,40,81,0.494,31,56,0.554,9,25,0.36,16,17,0.941,105,44,90,0.489,27,51,0.529,17,39,0.436,17,20,0.85,122
1310,CHI,2018-02-12,105,,ORL,1,240,40,88,0.455,31,56,0.554,9,32,0.281,16,21,0.762,105,37,84,0.44,27,53,0.509,10,31,0.323,17,19,0.895,101
1311,SAS,2018-02-10,105,@,GSW,0,240,43,94,0.457,38,67,0.567,5,27,0.185,14,19,0.737,105,48,85,0.565,36,58,0.621,12,27,0.444,14,15,0.933,122
1312,GSW,2018-02-06,105,,OKC,0,240,37,76,0.487,29,48,0.604,8,28,0.286,23,31,0.742,105,44,93,0.473,32,62,0.516,12,31,0.387,25,33,0.758,125
1313,POR,2018-02-02,105,@,TOR,0,240,37,73,0.507,30,52,0.577,7,21,0.333,24,33,0.727,105,46,99,0.465,27,59,0.458,19,40,0.475,19,21,0.905,130
1314,LAL,2018-01-31,105,@,ORL,0,240,39,83,0.47,35,63,0.556,4,20,0.2,23,30,0.767,105,44,81,0.543,26,49,0.531,18,32,0.563,21,29,0.724,127
1315,IND,2018-01-31,105,,MEM,1,240,37,70,0.529,27,44,0.614,10,26,0.385,21,31,0.677,105,39,82,0.476,27,56,0.482,12,26,0.462,11,15,0.733,101
1316,IND,2018-01-29,105,,CHO,1,240,45,83,0.542,39,62,0.629,6,21,0.286,9,11,0.818,105,37,83,0.446,28,52,0.538,9,31,0.29,13,20,0.65,96
1317,ATL,2018-01-29,105,,MIN,1,240,39,79,0.494,26,45,0.578,13,34,0.382,14,16,0.875,105,39,83,0.47,32,64,0.5,7,19,0.368,15,18,0.833,100
1318,BOS,2018-01-27,105,@,GSW,0,240,37,85,0.435,23,57,0.404,14,28,0.5,17,24,0.708,105,38,84,0.452,28,57,0.491,10,27,0.37,23,26,0.885,109
1319,SAC,2018-01-23,105,@,ORL,1,240,43,87,0.494,35,61,0.574,8,26,0.308,11,13,0.846,105,36,83,0.434,25,52,0.481,11,31,0.355,16,19,0.842,99
1320,MEM,2018-01-22,105,,PHI,1,240,33,78,0.423,23,52,0.442,10,26,0.385,29,35,0.829,105,32,71,0.451,18,40,0.45,14,31,0.452,23,31,0.742,101
1321,PHO,2018-01-22,105,@,MIL,0,240,39,79,0.494,30,53,0.566,9,26,0.346,18,20,0.9,105,38,71,0.535,33,54,0.611,5,17,0.294,28,37,0.757,109
1322,CHO,2018-01-20,105,,MIA,0,240,41,90,0.456,34,63,0.54,7,27,0.259,16,21,0.762,105,43,87,0.494,30,59,0.508,13,28,0.464,7,12,0.583,106
1323,SAC,2018-01-17,105,,UTA,0,240,38,72,0.528,25,51,0.49,13,21,0.619,16,20,0.8,105,46,81,0.568,34,52,0.654,12,29,0.414,16,20,0.8,120
1324,MEM,2018-01-17,105,,NYK,1,240,41,91,0.451,31,63,0.492,10,28,0.357,13,17,0.765,105,35,82,0.427,28,55,0.509,7,27,0.259,22,23,0.957,99
1325,DEN,2018-01-16,105,,DAL,1,240,40,86,0.465,32,60,0.533,8,26,0.308,17,26,0.654,105,38,78,0.487,30,51,0.588,8,27,0.296,18,22,0.818,102
1326,SAC,2018-01-13,105,@,LAC,0,240,43,85,0.506,37,68,0.544,6,17,0.353,13,22,0.591,105,46,82,0.561,34,51,0.667,12,31,0.387,22,26,0.846,126
1327,DET,2018-01-13,105,@,CHI,0,240,41,92,0.446,29,63,0.46,12,29,0.414,11,14,0.786,105,42,87,0.483,25,51,0.49,17,36,0.472,6,9,0.667,107
1328,ATL,2018-01-12,105,,BRK,0,240,37,80,0.463,26,52,0.5,11,28,0.393,20,26,0.769,105,40,87,0.46,27,53,0.509,13,34,0.382,17,26,0.654,110
1329,MEM,2018-01-10,105,,NOP,1,240,37,88,0.42,32,69,0.464,5,19,0.263,26,32,0.813,105,34,77,0.442,23,42,0.548,11,35,0.314,23,34,0.676,102
1330,LAC,2018-01-06,105,,GSW,0,240,39,91,0.429,36,80,0.45,3,11,0.273,24,30,0.8,105,39,94,0.415,26,55,0.473,13,39,0.333,30,37,0.811,121
1331,MEM,2018-01-02,105,@,LAC,0,240,38,79,0.481,30,53,0.566,8,26,0.308,21,33,0.636,105,39,71,0.549,30,48,0.625,9,23,0.391,26,31,0.839,113
1332,BRK,2017-12-31,105,@,BOS,0,240,39,95,0.411,28,59,0.475,11,36,0.306,16,19,0.842,105,39,79,0.494,25,46,0.543,14,33,0.424,16,25,0.64,108
1333,NYK,2017-12-30,105,@,NOP,1,240,41,94,0.436,36,75,0.48,5,19,0.263,18,21,0.857,105,38,84,0.452,32,58,0.552,6,26,0.231,21,27,0.778,103
1334,PHI,2017-12-25,105,@,NYK,1,240,35,82,0.427,25,54,0.463,10,28,0.357,25,30,0.833,105,38,94,0.404,34,79,0.43,4,15,0.267,18,28,0.643,98
1335,IND,2017-12-20,105,@,ATL,1,240,40,82,0.488,33,61,0.541,7,21,0.333,18,19,0.947,105,35,81,0.432,27,52,0.519,8,29,0.276,17,20,0.85,95
1336,DET,2017-12-14,105,@,ATL,1,240,41,90,0.456,28,60,0.467,13,30,0.433,10,12,0.833,105,32,70,0.457,21,39,0.538,11,31,0.355,16,26,0.615,91
1337,CLE,2017-12-09,105,,PHI,1,240,36,75,0.48,22,46,0.478,14,29,0.483,19,25,0.76,105,37,78,0.474,26,45,0.578,11,33,0.333,13,13,1.0,98
1338,SAS,2017-12-08,105,,BOS,1,240,38,81,0.469,30,54,0.556,8,27,0.296,21,24,0.875,105,38,83,0.458,27,45,0.6,11,38,0.289,15,17,0.882,102
1339,MIA,2017-12-06,105,@,SAS,0,240,39,72,0.542,21,38,0.553,18,34,0.529,9,12,0.75,105,46,87,0.529,33,62,0.532,13,25,0.52,12,14,0.857,117
1340,DEN,2017-12-04,105,@,DAL,0,240,38,91,0.418,24,55,0.436,14,36,0.389,15,23,0.652,105,49,86,0.57,37,60,0.617,12,26,0.462,12,17,0.706,122
1341,ORL,2017-12-03,105,@,NYK,1,240,37,82,0.451,31,54,0.574,6,28,0.214,25,29,0.862,105,43,93,0.462,38,78,0.487,5,15,0.333,9,10,0.9,100
1342,MIA,2017-12-01,105,,CHO,1,240,39,80,0.488,25,45,0.556,14,35,0.4,13,21,0.619,105,38,79,0.481,33,59,0.559,5,20,0.25,19,21,0.905,100
1343,WAS,2017-11-25,105,,POR,0,240,41,89,0.461,33,66,0.5,8,23,0.348,15,16,0.938,105,41,80,0.513,32,56,0.571,9,24,0.375,17,22,0.773,108
1344,IND,2017-11-20,105,@,ORL,1,240,37,89,0.416,29,69,0.42,8,20,0.4,23,29,0.793,105,35,84,0.417,22,46,0.478,13,38,0.342,14,23,0.609,97
1345,CHI,2017-11-19,105,@,PHO,0,240,42,101,0.416,30,65,0.462,12,36,0.333,9,14,0.643,105,45,89,0.506,38,62,0.613,7,27,0.259,16,22,0.727,113
1346,HOU,2017-11-18,105,@,MEM,1,240,35,78,0.449,17,35,0.486,18,43,0.419,17,21,0.81,105,31,86,0.36,24,59,0.407,7,27,0.259,14,19,0.737,83
1347,LAC,2017-11-13,105,,PHI,0,240,36,82,0.439,24,50,0.48,12,32,0.375,21,32,0.656,105,38,77,0.494,31,45,0.689,7,32,0.219,26,35,0.743,109
1348,ATL,2017-11-13,105,@,NOP,0,240,40,87,0.46,23,51,0.451,17,36,0.472,8,9,0.889,105,41,75,0.547,28,42,0.667,13,33,0.394,11,17,0.647,106
1349,IND,2017-11-10,105,@,CHI,1,240,43,84,0.512,31,55,0.564,12,29,0.414,7,12,0.583,105,37,93,0.398,30,66,0.455,7,27,0.259,6,9,0.667,87
1350,CHI,2017-11-03,105,@,ORL,1,240,40,85,0.471,26,56,0.464,14,29,0.483,11,12,0.917,105,35,86,0.407,25,51,0.49,10,35,0.286,3,5,0.6,83
1351,DET,2017-11-03,105,,MIL,1,240,37,78,0.474,29,52,0.558,8,26,0.308,23,28,0.821,105,39,83,0.47,29,58,0.5,10,25,0.4,8,9,0.889,96
1352,DEN,2017-10-27,105,@,ATL,1,240,42,91,0.462,38,71,0.535,4,20,0.2,17,23,0.739,105,37,89,0.416,23,56,0.411,14,33,0.424,12,12,1.0,100
1353,HOU,2017-10-25,105,@,PHI,1,240,36,75,0.48,24,36,0.667,12,39,0.308,21,24,0.875,105,43,97,0.443,31,61,0.508,12,36,0.333,6,10,0.6,104
1354,OKC,2017-10-19,105,,NYK,1,240,39,90,0.433,28,52,0.538,11,38,0.289,16,22,0.727,105,32,79,0.405,25,55,0.455,7,24,0.292,13,19,0.684,84
1355,HOU,2017-10-18,105,@,SAC,1,240,33,83,0.398,21,38,0.553,12,45,0.267,27,29,0.931,105,42,88,0.477,34,65,0.523,8,23,0.348,8,10,0.8,100
1356,CHI,2018-04-06,104,@,BOS,0,240,40,86,0.465,26,56,0.464,14,30,0.467,10,17,0.588,104,45,81,0.556,31,47,0.66,14,34,0.412,7,17,0.412,111
1357,IND,2018-04-03,104,@,DEN,0,240,41,84,0.488,32,65,0.492,9,19,0.474,13,16,0.813,104,41,89,0.461,31,57,0.544,10,32,0.313,15,20,0.75,107
1358,WAS,2018-04-03,104,@,HOU,0,240,38,72,0.528,26,47,0.553,12,25,0.48,16,23,0.696,104,43,84,0.512,27,38,0.711,16,46,0.348,18,27,0.667,120
1359,NOP,2018-04-01,104,,OKC,0,240,38,83,0.458,27,51,0.529,11,32,0.344,17,23,0.739,104,41,95,0.432,32,64,0.5,9,31,0.29,18,25,0.72,109
1360,LAC,2018-04-01,104,,IND,0,240,42,82,0.512,33,57,0.579,9,25,0.36,11,14,0.786,104,42,86,0.488,31,58,0.534,11,28,0.393,16,21,0.762,111
1361,HOU,2018-03-30,104,,PHO,1,240,35,81,0.432,21,43,0.488,14,38,0.368,20,29,0.69,104,41,84,0.488,29,52,0.558,12,32,0.375,9,13,0.692,103
1362,ORL,2018-03-28,104,,BRK,0,240,40,92,0.435,29,61,0.475,11,31,0.355,13,16,0.813,104,40,87,0.46,28,53,0.528,12,34,0.353,19,22,0.864,111
1363,DEN,2018-03-26,104,@,PHI,0,240,36,84,0.429,25,52,0.481,11,32,0.344,21,34,0.618,104,46,91,0.505,33,62,0.532,13,29,0.448,18,25,0.72,123
1364,BOS,2018-03-25,104,@,SAC,1,240,40,72,0.556,28,50,0.56,12,22,0.545,12,17,0.706,104,38,82,0.463,31,56,0.554,7,26,0.269,10,10,1.0,93
1365,LAC,2018-03-23,104,@,IND,0,240,42,76,0.553,32,50,0.64,10,26,0.385,10,14,0.714,104,43,93,0.462,32,62,0.516,11,31,0.355,12,14,0.857,109
1366,NYK,2018-03-23,104,,MIN,0,240,40,92,0.435,28,64,0.438,12,28,0.429,12,17,0.706,104,35,75,0.467,25,49,0.51,10,26,0.385,28,32,0.875,108
1367,SAC,2018-03-11,104,@,DEN,0,240,39,91,0.429,33,60,0.55,6,31,0.194,20,26,0.769,104,50,89,0.562,35,52,0.673,15,37,0.405,15,21,0.714,130
1368,OKC,2018-03-10,104,,SAS,1,240,39,85,0.459,29,57,0.509,10,28,0.357,16,24,0.667,104,40,86,0.465,30,66,0.455,10,20,0.5,4,7,0.571,94
1369,UTA,2018-03-07,104,@,IND,1,240,41,80,0.513,30,49,0.612,11,31,0.355,11,16,0.688,104,34,88,0.386,31,65,0.477,3,23,0.13,13,17,0.765,84
1370,ORL,2018-02-28,104,,TOR,0,240,39,82,0.476,26,52,0.5,13,30,0.433,13,23,0.565,104,45,83,0.542,33,53,0.623,12,30,0.4,15,24,0.625,117
1371,MIL,2018-02-27,104,,WAS,0,240,35,77,0.455,25,51,0.49,10,26,0.385,24,28,0.857,104,42,88,0.477,35,68,0.515,7,20,0.35,16,22,0.727,107
1372,ATL,2018-02-26,104,,LAL,0,240,36,96,0.375,28,60,0.467,8,36,0.222,24,34,0.706,104,47,90,0.522,32,57,0.561,15,33,0.455,14,19,0.737,123
1373,BRK,2018-02-26,104,,CHI,1,240,40,90,0.444,24,48,0.5,16,42,0.381,8,8,1.0,104,33,93,0.355,27,70,0.386,6,23,0.261,15,23,0.652,87
1374,PHO,2018-02-24,104,,POR,0,240,39,87,0.448,28,61,0.459,11,26,0.423,15,21,0.714,104,39,99,0.394,33,69,0.478,6,30,0.2,22,30,0.733,106
1375,CHI,2018-02-24,104,@,MIN,0,240,42,90,0.467,36,67,0.537,6,23,0.261,14,20,0.7,104,46,94,0.489,35,59,0.593,11,35,0.314,19,26,0.731,122
1376,CHO,2018-02-14,104,@,ORL,1,240,38,88,0.432,25,58,0.431,13,30,0.433,15,19,0.789,104,36,86,0.419,21,49,0.429,15,37,0.405,15,17,0.882,102
1377,PHI,2018-02-14,104,,MIA,1,240,39,92,0.424,30,57,0.526,9,35,0.257,17,25,0.68,104,35,77,0.455,24,50,0.48,11,27,0.407,21,29,0.724,102
1378,DET,2018-02-14,104,,ATL,1,240,35,83,0.422,22,50,0.44,13,33,0.394,21,25,0.84,104,38,89,0.427,32,56,0.571,6,33,0.182,16,19,0.842,98
1379,HOU,2018-02-11,104,,DAL,1,240,34,78,0.436,21,33,0.636,13,45,0.289,23,33,0.697,104,38,93,0.409,28,62,0.452,10,31,0.323,11,16,0.688,97
1380,ORL,2018-02-10,104,,MIL,0,240,37,83,0.446,29,53,0.547,8,30,0.267,22,26,0.846,104,43,82,0.524,34,57,0.596,9,25,0.36,16,20,0.8,111
1381,DEN,2018-02-09,104,@,HOU,0,240,42,88,0.477,39,60,0.65,3,28,0.107,17,21,0.81,104,43,86,0.5,24,45,0.533,19,41,0.463,25,34,0.735,130
1382,WAS,2018-02-08,104,,BOS,0,265,38,95,0.4,26,69,0.377,12,26,0.462,16,20,0.8,104,39,84,0.464,30,58,0.517,9,26,0.346,23,34,0.676,110
1383,LAC,2018-02-05,104,,DAL,1,240,42,87,0.483,32,60,0.533,10,27,0.37,10,12,0.833,104,33,80,0.413,16,38,0.421,17,42,0.405,18,20,0.9,101
1384,SAC,2018-02-05,104,,CHI,1,240,37,84,0.44,26,52,0.5,11,32,0.344,19,25,0.76,104,32,80,0.4,18,44,0.409,14,36,0.389,20,24,0.833,98
1385,CHO,2018-02-05,104,@,DEN,0,240,39,77,0.506,28,51,0.549,11,26,0.423,15,24,0.625,104,46,81,0.568,28,47,0.596,18,34,0.529,11,13,0.846,121
1386,OKC,2018-02-04,104,,LAL,0,240,40,89,0.449,33,64,0.516,7,25,0.28,17,25,0.68,104,42,86,0.488,29,56,0.518,13,30,0.433,11,18,0.611,108
1387,SAC,2018-02-02,104,,GSW,0,240,42,95,0.442,32,70,0.457,10,25,0.4,10,15,0.667,104,44,80,0.55,27,47,0.574,17,33,0.515,14,16,0.875,119
1388,DET,2018-02-01,104,,MEM,1,240,35,76,0.461,28,51,0.549,7,25,0.28,27,37,0.73,104,40,96,0.417,32,65,0.492,8,31,0.258,14,14,1.0,102
1389,DEN,2018-01-30,104,@,SAS,0,240,40,86,0.465,30,63,0.476,10,23,0.435,14,14,1.0,104,46,92,0.5,37,68,0.544,9,24,0.375,5,5,1.0,106
1390,MIN,2018-01-30,104,@,TOR,0,240,42,85,0.494,37,73,0.507,5,12,0.417,15,24,0.625,104,39,81,0.481,30,52,0.577,9,29,0.31,22,26,0.846,109
1391,POR,2018-01-30,104,@,LAC,1,240,36,98,0.367,23,68,0.338,13,30,0.433,19,22,0.864,104,35,85,0.412,29,63,0.46,6,22,0.273,20,26,0.769,96
1392,DET,2018-01-28,104,@,CLE,0,240,40,95,0.421,26,59,0.441,14,36,0.389,10,13,0.769,104,42,83,0.506,27,48,0.563,15,35,0.429,22,26,0.846,121
1393,ATL,2018-01-27,104,,WAS,0,240,38,88,0.432,26,45,0.578,12,43,0.279,16,21,0.762,104,49,85,0.576,31,53,0.585,18,32,0.563,13,14,0.929,129
1394,HOU,2018-01-24,104,@,DAL,1,240,36,82,0.439,15,31,0.484,21,51,0.412,11,23,0.478,104,35,82,0.427,20,47,0.426,15,35,0.429,12,18,0.667,97
1395,ATL,2018-01-22,104,,UTA,1,240,40,83,0.482,28,57,0.491,12,26,0.462,12,12,1.0,104,33,76,0.434,29,61,0.475,4,15,0.267,20,28,0.714,90
1396,DEN,2018-01-22,104,,POR,1,240,34,83,0.41,24,53,0.453,10,30,0.333,26,33,0.788,104,36,85,0.424,28,60,0.467,8,25,0.32,21,26,0.808,101
1397,MEM,2018-01-20,104,@,NOP,0,240,37,82,0.451,22,47,0.468,15,35,0.429,15,16,0.938,104,39,78,0.5,32,51,0.627,7,27,0.259,26,32,0.813,111
1398,CLE,2018-01-18,104,,ORL,1,240,38,85,0.447,28,51,0.549,10,34,0.294,18,27,0.667,104,41,88,0.466,36,66,0.545,5,22,0.227,16,21,0.762,103
1399,DEN,2018-01-17,104,@,LAC,0,240,42,97,0.433,37,72,0.514,5,25,0.2,15,18,0.833,104,40,87,0.46,30,57,0.526,10,30,0.333,19,31,0.613,109
1400,BRK,2018-01-15,104,,NYK,0,240,32,87,0.368,21,55,0.382,11,32,0.344,29,36,0.806,104,42,82,0.512,33,66,0.5,9,16,0.563,26,37,0.703,119
1401,BRK,2018-01-15,104,,NYK,0,240,32,87,0.368,21,55,0.382,11,32,0.344,29,36,0.806,104,42,82,0.512,33,66,0.5,9,16,0.563,26,37,0.703,119
1402,WAS,2018-01-10,104,,UTA,0,240,41,78,0.526,31,53,0.585,10,25,0.4,12,17,0.706,104,43,92,0.467,32,59,0.542,11,33,0.333,10,13,0.769,107
1403,MIN,2018-01-10,104,,OKC,1,240,39,80,0.488,32,60,0.533,7,20,0.35,19,27,0.704,104,32,80,0.4,26,55,0.473,6,25,0.24,18,24,0.75,88
1404,DET,2018-01-03,104,@,MIA,0,240,41,86,0.477,32,62,0.516,9,24,0.375,13,16,0.813,104,43,84,0.512,26,50,0.52,17,34,0.5,8,11,0.727,111
1405,PHO,2018-01-02,104,,ATL,1,240,39,77,0.506,32,55,0.582,7,22,0.318,19,26,0.731,104,36,87,0.414,26,56,0.464,10,31,0.323,21,25,0.84,103
1406,UTA,2017-12-30,104,,CLE,1,240,38,82,0.463,28,51,0.549,10,31,0.323,18,21,0.857,104,34,81,0.42,22,41,0.537,12,40,0.3,21,26,0.808,101
1407,ATL,2017-12-30,104,,POR,1,240,40,89,0.449,26,59,0.441,14,30,0.467,10,15,0.667,104,36,85,0.424,29,60,0.483,7,25,0.28,10,13,0.769,89
1408,LAL,2017-12-25,104,,MIN,0,240,40,92,0.435,30,62,0.484,10,30,0.333,14,20,0.7,104,49,84,0.583,38,52,0.731,11,32,0.344,12,14,0.857,121
1409,DET,2017-12-22,104,,NYK,1,240,38,88,0.432,28,63,0.444,10,25,0.4,18,25,0.72,104,44,97,0.454,36,73,0.493,8,24,0.333,5,6,0.833,101
1410,CHO,2017-12-22,104,@,MIL,0,240,39,88,0.443,27,62,0.435,12,26,0.462,14,17,0.824,104,41,87,0.471,33,58,0.569,8,29,0.276,19,23,0.826,109
1411,SAC,2017-12-20,104,@,BRK,1,240,40,82,0.488,33,63,0.524,7,19,0.368,17,20,0.85,104,32,82,0.39,17,40,0.425,15,42,0.357,20,23,0.87,99
1412,DEN,2017-12-20,104,,MIN,0,240,36,72,0.5,23,44,0.523,13,28,0.464,19,24,0.792,104,43,87,0.494,35,63,0.556,8,24,0.333,18,19,0.947,112
1413,MIA,2017-12-18,104,@,ATL,0,240,36,79,0.456,29,54,0.537,7,25,0.28,25,30,0.833,104,38,83,0.458,30,61,0.492,8,22,0.364,26,31,0.839,110
1414,MIA,2017-12-15,104,@,CHO,1,240,39,78,0.5,28,47,0.596,11,31,0.355,15,17,0.882,104,34,83,0.41,24,56,0.429,10,27,0.37,20,27,0.741,98
1415,DET,2017-12-15,104,@,IND,1,240,39,93,0.419,26,61,0.426,13,32,0.406,13,17,0.765,104,35,87,0.402,26,57,0.456,9,30,0.3,19,25,0.76,98
1416,BRK,2017-12-14,104,,NYK,0,240,37,83,0.446,25,41,0.61,12,42,0.286,18,23,0.783,104,41,89,0.461,31,69,0.449,10,20,0.5,19,22,0.864,111
1417,POR,2017-12-11,104,@,GSW,0,240,37,88,0.42,30,60,0.5,7,28,0.25,23,25,0.92,104,44,80,0.55,34,60,0.567,10,20,0.5,13,17,0.765,111
1418,CHI,2017-12-09,104,,NYK,1,240,42,82,0.512,35,57,0.614,7,25,0.28,13,23,0.565,104,43,91,0.473,36,67,0.537,7,24,0.292,9,9,1.0,102
1419,SAS,2017-12-09,104,@,PHO,1,240,40,87,0.46,34,68,0.5,6,19,0.316,18,25,0.72,104,35,80,0.438,28,55,0.509,7,25,0.28,24,30,0.8,101
1420,PHI,2017-12-07,104,,LAL,0,240,39,81,0.481,29,55,0.527,10,26,0.385,16,21,0.762,104,42,96,0.438,31,68,0.456,11,28,0.393,12,24,0.5,107
1421,MIL,2017-12-06,104,,DET,1,240,39,79,0.494,31,57,0.544,8,22,0.364,18,26,0.692,104,36,87,0.414,26,57,0.456,10,30,0.333,18,27,0.667,100
1422,CHO,2017-12-04,104,,ORL,1,240,34,84,0.405,31,67,0.463,3,17,0.176,33,40,0.825,104,36,82,0.439,26,50,0.52,10,32,0.313,12,14,0.857,94
1423,SAC,2017-12-02,104,@,MIL,0,240,37,77,0.481,26,53,0.491,11,24,0.458,19,21,0.905,104,34,69,0.493,28,50,0.56,6,19,0.316,35,42,0.833,109
1424,DAL,2017-11-29,104,,BRK,0,240,39,84,0.464,30,57,0.526,9,27,0.333,17,21,0.81,104,42,90,0.467,31,61,0.508,11,29,0.379,14,25,0.56,109
1425,SAS,2017-11-29,104,,MEM,1,240,38,75,0.507,30,55,0.545,8,20,0.4,20,24,0.833,104,35,77,0.455,24,55,0.436,11,22,0.5,14,16,0.875,95
1426,PHO,2017-11-28,104,@,CHI,1,240,38,87,0.437,27,57,0.474,11,30,0.367,17,23,0.739,104,38,94,0.404,22,54,0.407,16,40,0.4,7,10,0.7,99
1427,NYK,2017-11-24,104,@,ATL,0,240,40,78,0.513,28,48,0.583,12,30,0.4,12,14,0.857,104,47,99,0.475,34,68,0.5,13,31,0.419,9,12,0.75,116
1428,TOR,2017-11-24,104,@,IND,0,240,40,81,0.494,31,51,0.608,9,30,0.3,15,20,0.75,104,38,83,0.458,27,57,0.474,11,26,0.423,20,27,0.741,107
1429,DEN,2017-11-24,104,,MEM,1,240,40,79,0.506,31,47,0.66,9,32,0.281,15,26,0.577,104,36,73,0.493,27,49,0.551,9,24,0.375,11,16,0.688,92
1430,MIA,2017-11-22,104,,BOS,1,240,40,81,0.494,30,53,0.566,10,28,0.357,14,16,0.875,104,35,84,0.417,26,58,0.448,9,26,0.346,19,27,0.704,98
1431,SAS,2017-11-17,104,,OKC,1,240,34,77,0.442,20,42,0.476,14,35,0.4,22,28,0.786,104,39,89,0.438,30,66,0.455,9,23,0.391,14,21,0.667,101
1432,CLE,2017-11-13,104,@,NYK,1,240,35,88,0.398,19,43,0.442,16,45,0.356,18,22,0.818,104,38,88,0.432,30,63,0.476,8,25,0.32,17,22,0.773,101
1433,DAL,2017-11-11,104,,CLE,0,240,39,92,0.424,29,58,0.5,10,34,0.294,16,21,0.762,104,35,81,0.432,23,50,0.46,12,31,0.387,29,35,0.829,111
1434,ATL,2017-11-10,104,@,DET,0,240,44,89,0.494,36,65,0.554,8,24,0.333,8,11,0.727,104,39,89,0.438,27,59,0.458,12,30,0.4,21,27,0.778,111
1435,PHI,2017-11-07,104,@,UTA,1,240,34,81,0.42,22,54,0.407,12,27,0.444,24,30,0.8,104,30,99,0.303,21,60,0.35,9,39,0.231,28,35,0.8,97
1436,BRK,2017-11-07,104,@,DEN,0,240,38,89,0.427,27,54,0.5,11,35,0.314,17,22,0.773,104,44,93,0.473,35,59,0.593,9,34,0.265,15,20,0.75,112
1437,BOS,2017-11-05,104,@,ORL,1,240,39,89,0.438,28,56,0.5,11,33,0.333,15,20,0.75,104,33,91,0.363,27,62,0.435,6,29,0.207,16,18,0.889,88
1438,MIA,2017-11-05,104,@,LAC,1,240,37,84,0.44,23,48,0.479,14,36,0.389,16,19,0.842,104,34,87,0.391,25,56,0.446,9,31,0.29,24,30,0.8,101
1439,LAC,2017-11-04,104,,MEM,0,240,38,83,0.458,34,57,0.596,4,26,0.154,24,31,0.774,104,40,84,0.476,27,53,0.509,13,31,0.419,20,24,0.833,113
1440,ATL,2017-11-03,104,,HOU,0,240,39,81,0.481,28,48,0.583,11,33,0.333,15,18,0.833,104,42,89,0.472,26,42,0.619,16,47,0.34,19,23,0.826,119
1441,MIN,2017-11-01,104,@,NOP,1,240,41,83,0.494,35,61,0.574,6,22,0.273,16,24,0.667,104,36,84,0.429,28,53,0.528,8,31,0.258,18,21,0.857,98
1442,CHO,2017-10-30,104,@,MEM,1,240,37,89,0.416,30,72,0.417,7,17,0.412,23,29,0.793,104,32,93,0.344,24,58,0.414,8,35,0.229,27,33,0.818,99
1443,UTA,2017-10-30,104,,DAL,1,240,38,81,0.469,22,46,0.478,16,35,0.457,12,15,0.8,104,34,76,0.447,22,52,0.423,12,24,0.5,9,11,0.818,89
1444,LAC,2017-10-26,104,@,POR,1,240,36,77,0.468,27,49,0.551,9,28,0.321,23,36,0.639,104,35,89,0.393,21,58,0.362,14,31,0.452,19,22,0.864,103
1445,PHI,2017-10-25,104,,HOU,0,240,43,97,0.443,31,61,0.508,12,36,0.333,6,10,0.6,104,36,75,0.48,24,36,0.667,12,39,0.308,21,24,0.875,105
1446,MIA,2017-10-23,104,,ATL,1,240,39,85,0.459,25,48,0.521,14,37,0.378,12,18,0.667,104,36,76,0.474,29,59,0.492,7,17,0.412,14,18,0.778,93
1447,DEN,2017-10-23,104,,WAS,0,240,39,80,0.488,31,57,0.544,8,23,0.348,18,23,0.783,104,37,84,0.44,28,54,0.519,9,30,0.3,26,28,0.929,109
1448,ATL,2017-10-22,104,@,BRK,0,240,32,94,0.34,25,67,0.373,7,27,0.259,33,36,0.917,104,41,87,0.471,30,60,0.5,11,27,0.407,23,34,0.676,116
1449,PHO,2018-04-06,103,,NOP,0,240,37,94,0.394,28,61,0.459,9,33,0.273,20,26,0.769,103,45,99,0.455,29,61,0.475,16,38,0.421,16,20,0.8,122
1450,ATL,2018-04-06,103,@,WAS,1,240,38,79,0.481,27,46,0.587,11,33,0.333,16,23,0.696,103,35,87,0.402,26,62,0.419,9,25,0.36,18,23,0.783,97
1451,PHO,2018-03-30,103,@,HOU,0,240,41,84,0.488,29,52,0.558,12,32,0.375,9,13,0.692,103,35,81,0.432,21,43,0.488,14,38,0.368,20,29,0.69,104
1452,MIA,2018-03-29,103,,CHI,1,240,37,82,0.451,30,55,0.545,7,27,0.259,22,24,0.917,103,33,90,0.367,27,64,0.422,6,26,0.231,20,26,0.769,92
1453,SAS,2018-03-29,103,,OKC,1,240,34,81,0.42,21,50,0.42,13,31,0.419,22,30,0.733,103,37,85,0.435,26,55,0.473,11,30,0.367,14,21,0.667,99
1454,DET,2018-03-29,103,,WAS,1,240,41,84,0.488,35,63,0.556,6,21,0.286,15,20,0.75,103,37,89,0.416,31,57,0.544,6,32,0.188,12,15,0.8,92
1455,SAC,2018-03-29,103,,IND,0,240,42,78,0.538,29,47,0.617,13,31,0.419,6,9,0.667,103,40,80,0.5,32,54,0.593,8,26,0.308,18,20,0.9,106
1456,POR,2018-03-28,103,@,MEM,0,240,38,79,0.481,30,49,0.612,8,30,0.267,19,30,0.633,103,41,84,0.488,28,59,0.475,13,25,0.52,13,23,0.565,108
1457,LAL,2018-03-28,103,,DAL,1,240,36,77,0.468,27,44,0.614,9,33,0.273,22,32,0.688,103,33,84,0.393,20,40,0.5,13,44,0.295,14,19,0.737,93
1458,NOP,2018-03-27,103,,POR,0,240,43,94,0.457,39,70,0.557,4,24,0.167,13,14,0.929,103,44,105,0.419,34,73,0.466,10,32,0.313,9,10,0.9,107
1459,DAL,2018-03-27,103,@,SAC,1,240,36,80,0.45,22,40,0.55,14,40,0.35,17,25,0.68,103,38,93,0.409,32,70,0.457,6,23,0.261,15,19,0.789,97
1460,SAS,2018-03-25,103,@,MIL,0,240,41,92,0.446,37,75,0.493,4,17,0.235,17,21,0.81,103,42,86,0.488,33,59,0.559,9,27,0.333,13,18,0.722,106
1461,UTA,2018-03-17,103,,SAC,1,240,33,74,0.446,27,50,0.54,6,24,0.25,31,38,0.816,103,37,86,0.43,23,65,0.354,14,21,0.667,9,14,0.643,97
1462,DEN,2018-03-13,103,@,LAL,0,240,38,86,0.442,25,46,0.543,13,40,0.325,14,19,0.737,103,40,90,0.444,25,50,0.5,15,40,0.375,17,25,0.68,112
1463,MEM,2018-03-12,103,,MIL,0,240,42,89,0.472,33,62,0.532,9,27,0.333,10,19,0.526,103,47,81,0.58,35,56,0.625,12,25,0.48,15,22,0.682,121
1464,GSW,2018-03-11,103,@,MIN,0,240,37,91,0.407,27,55,0.491,10,36,0.278,19,21,0.905,103,44,95,0.463,38,75,0.507,6,20,0.3,15,21,0.714,109
1465,LAL,2018-03-05,103,,POR,0,240,34,87,0.391,23,50,0.46,11,37,0.297,24,31,0.774,103,35,83,0.422,25,60,0.417,10,23,0.435,28,38,0.737,108
1466,PHO,2018-03-05,103,@,MIA,0,240,42,87,0.483,32,63,0.508,10,24,0.417,9,18,0.5,103,47,92,0.511,35,56,0.625,12,36,0.333,19,23,0.826,125
1467,TOR,2018-03-04,103,,CHO,1,240,35,83,0.422,23,42,0.548,12,41,0.293,21,27,0.778,103,32,85,0.376,27,64,0.422,5,21,0.238,29,35,0.829,98
1468,IND,2018-03-02,103,@,MIL,1,240,37,83,0.446,31,67,0.463,6,16,0.375,23,30,0.767,103,31,81,0.383,22,56,0.393,9,25,0.36,25,32,0.781,96
1469,CHI,2018-02-27,103,@,CHO,0,240,39,81,0.481,30,57,0.526,9,24,0.375,16,21,0.762,103,44,82,0.537,29,47,0.617,15,35,0.429,15,21,0.714,118
1470,IND,2018-02-26,103,@,DAL,0,240,41,87,0.471,36,67,0.537,5,20,0.25,16,23,0.696,103,40,88,0.455,26,51,0.51,14,37,0.378,15,18,0.833,109
1471,CLE,2018-02-22,103,,WAS,0,240,42,84,0.5,34,49,0.694,8,35,0.229,11,19,0.579,103,44,92,0.478,32,62,0.516,12,30,0.4,10,10,1.0,110
1472,BRK,2018-02-14,103,,IND,0,240,35,83,0.422,22,48,0.458,13,35,0.371,20,27,0.741,103,39,90,0.433,33,75,0.44,6,15,0.4,24,28,0.857,108
1473,DET,2018-02-12,103,,NOP,0,240,35,95,0.368,26,60,0.433,9,35,0.257,24,32,0.75,103,44,100,0.44,30,66,0.455,14,34,0.412,16,16,1.0,118
1474,CHO,2018-02-11,103,,TOR,0,240,38,89,0.427,28,66,0.424,10,23,0.435,17,23,0.739,103,49,87,0.563,31,50,0.62,18,37,0.486,7,10,0.7,123
1475,CHO,2018-02-08,103,@,POR,0,265,38,98,0.388,25,65,0.385,13,33,0.394,14,17,0.824,103,41,90,0.456,32,59,0.542,9,31,0.29,18,22,0.818,109
1476,DAL,2018-02-08,103,@,GSW,0,240,40,92,0.435,31,55,0.564,9,37,0.243,14,17,0.824,103,45,88,0.511,31,59,0.525,14,29,0.483,17,20,0.85,121
1477,MIL,2018-02-06,103,@,NYK,1,240,37,82,0.451,29,56,0.518,8,26,0.308,21,27,0.778,103,37,89,0.416,32,66,0.485,5,23,0.217,10,15,0.667,89
1478,CHI,2018-02-03,103,@,LAC,0,240,35,97,0.361,23,60,0.383,12,37,0.324,21,21,1.0,103,40,88,0.455,31,63,0.492,9,25,0.36,24,28,0.857,113
1479,PHI,2018-02-02,103,,MIA,1,240,42,85,0.494,34,61,0.557,8,24,0.333,11,15,0.733,103,34,87,0.391,22,50,0.44,12,37,0.324,17,26,0.654,97
1480,BOS,2018-01-31,103,,NYK,1,240,40,83,0.482,29,57,0.509,11,26,0.423,12,20,0.6,103,28,87,0.322,25,70,0.357,3,17,0.176,14,21,0.667,73
1481,NOP,2018-01-30,103,,SAC,0,240,39,77,0.506,30,52,0.577,9,25,0.36,16,22,0.727,103,46,97,0.474,36,71,0.507,10,26,0.385,12,14,0.857,114
1482,NOP,2018-01-28,103,,LAC,0,240,38,85,0.447,29,50,0.58,9,35,0.257,18,25,0.72,103,45,96,0.469,36,68,0.529,9,28,0.321,13,18,0.722,112
1483,CHI,2018-01-26,103,,LAL,0,240,35,93,0.376,18,57,0.316,17,36,0.472,16,24,0.667,103,41,91,0.451,36,67,0.537,5,24,0.208,21,28,0.75,108
1484,ORL,2018-01-21,103,@,BOS,1,240,43,92,0.467,37,71,0.521,6,21,0.286,11,16,0.688,103,37,85,0.435,29,58,0.5,8,27,0.296,13,14,0.929,95
1485,ORL,2018-01-18,103,@,CLE,0,240,41,88,0.466,36,66,0.545,5,22,0.227,16,21,0.762,103,38,85,0.447,28,51,0.549,10,34,0.294,18,27,0.667,104
1486,POR,2018-01-14,103,@,MIN,0,240,39,79,0.494,28,54,0.519,11,25,0.44,14,17,0.824,103,43,80,0.538,36,61,0.59,7,19,0.368,27,33,0.818,120
1487,PHI,2018-01-11,103,,BOS,0,240,38,82,0.463,27,54,0.5,11,28,0.393,16,18,0.889,103,43,89,0.483,30,54,0.556,13,35,0.371,15,19,0.789,114
1488,ORL,2018-01-10,103,@,MIL,0,240,39,90,0.433,31,61,0.508,8,29,0.276,17,18,0.944,103,45,82,0.549,41,63,0.651,4,19,0.211,16,25,0.64,110
1489,MIA,2018-01-07,103,,UTA,1,240,40,83,0.482,31,54,0.574,9,29,0.31,14,20,0.7,103,37,82,0.451,27,50,0.54,10,32,0.313,18,20,0.9,102
1490,WAS,2018-01-06,103,,MIL,0,240,37,78,0.474,29,57,0.509,8,21,0.381,21,29,0.724,103,39,80,0.488,32,58,0.552,7,22,0.318,25,30,0.833,110
1491,NYK,2018-01-05,103,@,MIA,0,265,39,80,0.488,34,67,0.507,5,13,0.385,20,23,0.87,103,38,94,0.404,26,52,0.5,12,42,0.286,19,20,0.95,107
1492,SAS,2018-01-05,103,,PHO,1,240,41,87,0.471,30,57,0.526,11,30,0.367,10,18,0.556,103,35,83,0.422,28,53,0.528,7,30,0.233,12,18,0.667,89
1493,NYK,2018-01-03,103,@,WAS,0,240,41,86,0.477,34,67,0.507,7,19,0.368,14,18,0.778,103,48,81,0.593,39,58,0.672,9,23,0.391,16,26,0.615,121
1494,ATL,2018-01-02,103,@,PHO,0,240,36,87,0.414,26,56,0.464,10,31,0.323,21,25,0.84,103,39,77,0.506,32,55,0.582,7,22,0.318,19,26,0.731,104
1495,NOP,2017-12-30,103,,NYK,0,240,38,84,0.452,32,58,0.552,6,26,0.231,21,27,0.778,103,41,94,0.436,36,75,0.48,5,19,0.263,18,21,0.857,105
1496,HOU,2017-12-29,103,@,WAS,0,240,38,89,0.427,24,41,0.585,14,48,0.292,13,16,0.813,103,47,88,0.534,29,52,0.558,18,36,0.5,9,12,0.75,121
1497,BOS,2017-12-25,103,,WAS,0,240,39,81,0.481,25,52,0.481,14,29,0.483,11,17,0.647,103,43,93,0.462,37,67,0.552,6,26,0.231,19,28,0.679,111
1498,ORL,2017-12-23,103,@,WAS,0,240,42,87,0.483,34,61,0.557,8,26,0.308,11,17,0.647,103,47,86,0.547,31,56,0.554,16,30,0.533,20,23,0.87,130
1499,OKC,2017-12-23,103,@,UTA,1,240,39,88,0.443,27,59,0.458,12,29,0.414,13,16,0.813,103,33,72,0.458,27,46,0.587,6,26,0.231,17,20,0.85,89
1500,CHI,2017-12-13,103,,UTA,1,240,41,93,0.441,34,76,0.447,7,17,0.412,14,21,0.667,103,42,91,0.462,33,61,0.541,9,30,0.3,7,7,1.0,100
1501,DEN,2017-12-12,103,@,DET,1,240,40,79,0.506,30,49,0.612,10,30,0.333,13,14,0.929,103,28,79,0.354,19,54,0.352,9,25,0.36,19,22,0.864,84
1502,BRK,2017-12-12,103,,WAS,1,240,34,84,0.405,24,41,0.585,10,43,0.233,25,33,0.758,103,38,95,0.4,34,73,0.466,4,22,0.182,18,22,0.818,98
1503,OKC,2017-12-11,103,,CHO,0,240,35,85,0.412,26,59,0.441,9,26,0.346,24,25,0.96,103,43,81,0.531,30,56,0.536,13,25,0.52,17,24,0.708,116
1504,DEN,2017-12-08,103,@,ORL,1,240,42,85,0.494,36,64,0.563,6,21,0.286,13,16,0.813,103,33,83,0.398,28,62,0.452,5,21,0.238,18,23,0.783,89
1505,DET,2017-12-02,103,@,PHI,0,240,34,78,0.436,25,47,0.532,9,31,0.29,26,32,0.813,103,35,86,0.407,25,58,0.431,10,28,0.357,28,32,0.875,108
1506,MIL,2017-11-30,103,@,POR,1,240,42,87,0.483,36,67,0.537,6,20,0.3,13,15,0.867,103,35,83,0.422,29,60,0.483,6,23,0.261,15,17,0.882,91
1507,BRK,2017-11-27,103,@,HOU,0,240,40,86,0.465,30,47,0.638,10,39,0.256,13,17,0.765,103,42,86,0.488,22,36,0.611,20,50,0.4,13,20,0.65,117
1508,POR,2017-11-27,103,@,NYK,1,240,37,83,0.446,30,62,0.484,7,21,0.333,22,26,0.846,103,35,88,0.398,30,73,0.411,5,15,0.333,16,22,0.727,91
1509,ORL,2017-11-24,103,@,BOS,0,240,41,95,0.432,32,71,0.451,9,24,0.375,12,19,0.632,103,42,91,0.462,25,49,0.51,17,42,0.405,17,25,0.68,118
1510,ATL,2017-11-22,103,,LAC,0,240,40,83,0.482,30,54,0.556,10,29,0.345,13,15,0.867,103,44,76,0.579,29,46,0.63,15,30,0.5,13,19,0.684,116
1511,LAL,2017-11-21,103,,CHI,1,240,36,90,0.4,23,50,0.46,13,40,0.325,18,25,0.72,103,36,94,0.383,25,58,0.431,11,36,0.306,11,16,0.688,94
1512,MEM,2017-11-13,103,@,MIL,0,240,37,76,0.487,26,50,0.52,11,26,0.423,18,21,0.857,103,40,82,0.488,28,60,0.467,12,22,0.545,18,25,0.72,110
1513,MIA,2017-11-12,103,@,DET,0,240,39,90,0.433,26,53,0.491,13,37,0.351,12,16,0.75,103,42,87,0.483,28,59,0.475,14,28,0.5,14,20,0.7,112
1514,LAC,2017-11-11,103,@,NOP,0,240,35,86,0.407,25,60,0.417,10,26,0.385,23,27,0.852,103,43,80,0.538,37,64,0.578,6,16,0.375,19,24,0.792,111
1515,POR,2017-11-05,103,,OKC,1,240,37,74,0.5,30,54,0.556,7,20,0.35,22,28,0.786,103,40,89,0.449,29,56,0.518,11,33,0.333,8,15,0.533,99
1516,POR,2017-11-01,103,@,UTA,0,265,37,93,0.398,28,59,0.475,9,34,0.265,20,27,0.741,103,34,90,0.378,21,61,0.344,13,29,0.448,31,36,0.861,112
1517,MEM,2017-10-28,103,,HOU,1,240,40,85,0.471,26,52,0.5,14,33,0.424,9,12,0.75,103,29,77,0.377,15,39,0.385,14,38,0.368,17,21,0.81,89
1518,POR,2017-10-26,103,,LAC,0,240,35,89,0.393,21,58,0.362,14,31,0.452,19,22,0.864,103,36,77,0.468,27,49,0.551,9,28,0.321,23,36,0.639,104
1519,DAL,2017-10-25,103,,MEM,1,240,36,74,0.486,25,48,0.521,11,26,0.423,20,29,0.69,103,33,72,0.458,21,41,0.512,12,31,0.387,16,24,0.667,94
1520,POR,2017-10-24,103,,NOP,1,240,33,88,0.375,23,59,0.39,10,29,0.345,27,33,0.818,103,30,76,0.395,21,46,0.457,9,30,0.3,24,32,0.75,93
1521,DAL,2017-10-23,103,,GSW,0,240,38,96,0.396,29,67,0.433,9,29,0.31,18,30,0.6,103,48,86,0.558,33,47,0.702,15,39,0.385,22,26,0.846,133
1522,MIL,2017-10-23,103,,CHO,1,240,40,85,0.471,31,59,0.525,9,26,0.346,14,16,0.875,103,33,78,0.423,26,52,0.5,7,26,0.269,21,36,0.583,94
1523,MEM,2017-10-18,103,,NOP,1,240,39,92,0.424,30,63,0.476,9,29,0.31,16,28,0.571,103,30,79,0.38,23,54,0.426,7,25,0.28,24,29,0.828,91
1524,POR,2018-04-11,102,,UTA,1,240,41,89,0.461,32,65,0.492,9,24,0.375,11,16,0.688,102,33,89,0.371,25,66,0.379,8,23,0.348,19,24,0.792,93
1525,MIL,2018-04-09,102,,ORL,1,240,39,91,0.429,30,65,0.462,9,26,0.346,15,18,0.833,102,34,82,0.415,29,58,0.5,5,24,0.208,13,20,0.65,86
1526,NYK,2018-04-07,102,,MIL,0,240,41,95,0.432,32,74,0.432,9,21,0.429,11,11,1.0,102,45,93,0.484,35,68,0.515,10,25,0.4,15,17,0.882,115
1527,HOU,2018-04-07,102,,OKC,0,240,36,76,0.474,22,39,0.564,14,37,0.378,16,23,0.696,102,36,91,0.396,26,58,0.448,10,33,0.303,26,33,0.788,108
1528,BOS,2018-04-03,102,@,MIL,0,240,38,81,0.469,31,58,0.534,7,23,0.304,19,24,0.792,102,43,79,0.544,38,59,0.644,5,20,0.25,15,21,0.714,106
1529,CHO,2018-04-01,102,,PHI,0,240,33,82,0.402,24,52,0.462,9,30,0.3,27,34,0.794,102,48,94,0.511,34,62,0.548,14,32,0.438,9,10,0.9,119
1530,NOP,2018-03-30,102,@,CLE,0,240,43,89,0.483,32,63,0.508,11,26,0.423,5,6,0.833,102,43,90,0.478,33,66,0.5,10,24,0.417,11,15,0.733,107
1531,BOS,2018-03-26,102,@,PHO,1,240,37,87,0.425,23,58,0.397,14,29,0.483,14,14,1.0,102,36,81,0.444,24,46,0.522,12,35,0.343,10,19,0.526,94
1532,CHO,2018-03-24,102,@,DAL,1,240,35,92,0.38,23,67,0.343,12,25,0.48,20,29,0.69,102,36,91,0.396,24,50,0.48,12,41,0.293,14,19,0.737,98
1533,CHI,2018-03-21,102,,DEN,0,240,39,89,0.438,26,51,0.51,13,38,0.342,11,14,0.786,102,51,83,0.614,31,48,0.646,20,35,0.571,13,16,0.813,135
1534,IND,2018-03-17,102,@,WAS,0,240,39,86,0.453,27,62,0.435,12,24,0.5,12,15,0.8,102,40,74,0.541,30,54,0.556,10,20,0.5,19,23,0.826,109
1535,BRK,2018-03-13,102,,TOR,0,240,35,86,0.407,20,50,0.4,15,36,0.417,17,19,0.895,102,44,91,0.484,33,60,0.55,11,31,0.355,17,21,0.81,116
1536,WAS,2018-03-10,102,@,MIA,0,240,34,77,0.442,27,57,0.474,7,20,0.35,27,34,0.794,102,52,88,0.591,42,60,0.7,10,28,0.357,15,21,0.714,129
1537,CLE,2018-03-09,102,@,LAC,0,240,39,87,0.448,27,51,0.529,12,36,0.333,12,18,0.667,102,43,89,0.483,32,61,0.525,11,28,0.393,19,30,0.633,116
1538,SAC,2018-03-04,102,,NYK,1,240,39,86,0.453,26,56,0.464,13,30,0.433,11,11,1.0,102,40,88,0.455,34,67,0.507,6,21,0.286,13,18,0.722,99
1539,MEM,2018-03-02,102,,DEN,0,240,40,91,0.44,30,64,0.469,10,27,0.37,12,15,0.8,102,40,73,0.548,34,51,0.667,6,22,0.273,22,26,0.846,108
1540,TOR,2018-03-02,102,@,WAS,1,240,36,78,0.462,26,45,0.578,10,33,0.303,20,32,0.625,102,36,79,0.456,27,55,0.491,9,24,0.375,14,21,0.667,95
1541,IND,2018-02-28,102,@,ATL,0,240,38,90,0.422,27,58,0.466,11,32,0.344,15,20,0.75,102,38,87,0.437,29,58,0.5,9,29,0.31,22,27,0.815,107
1542,MEM,2018-02-28,102,,PHO,0,240,33,87,0.379,20,56,0.357,13,31,0.419,23,28,0.821,102,38,83,0.458,32,62,0.516,6,21,0.286,28,38,0.737,110
1543,MIA,2018-02-27,102,,PHI,1,240,36,82,0.439,27,55,0.491,9,27,0.333,21,28,0.75,102,35,84,0.417,23,53,0.434,12,31,0.387,19,23,0.826,101
1544,DAL,2018-02-23,102,@,LAL,0,240,37,91,0.407,18,49,0.367,19,42,0.452,9,11,0.818,102,48,93,0.516,35,60,0.583,13,33,0.394,15,20,0.75,124
1545,MIN,2018-02-23,102,@,HOU,0,240,40,94,0.426,30,68,0.441,10,26,0.385,12,16,0.75,102,40,83,0.482,26,45,0.578,14,38,0.368,26,30,0.867,120
1546,MIA,2018-02-14,102,@,PHI,0,240,35,77,0.455,24,50,0.48,11,27,0.407,21,29,0.724,102,39,92,0.424,30,57,0.526,9,35,0.257,17,25,0.68,104
1547,ORL,2018-02-14,102,,CHO,0,240,36,86,0.419,21,49,0.429,15,37,0.405,15,17,0.882,102,38,88,0.432,25,58,0.431,13,30,0.433,15,19,0.789,104
1548,WAS,2018-02-06,102,@,PHI,0,240,41,93,0.441,34,66,0.515,7,27,0.259,13,18,0.722,102,45,82,0.549,31,54,0.574,14,28,0.5,11,14,0.786,115
1549,IND,2018-02-05,102,,WAS,0,240,37,80,0.463,25,51,0.49,12,29,0.414,16,25,0.64,102,45,82,0.549,38,57,0.667,7,25,0.28,14,17,0.824,111
1550,LAL,2018-02-02,102,@,BRK,1,240,39,92,0.424,29,66,0.439,10,26,0.385,14,20,0.7,102,37,82,0.451,28,53,0.528,9,29,0.31,16,23,0.696,99
1551,HOU,2018-02-01,102,@,SAS,1,240,37,83,0.446,23,41,0.561,14,42,0.333,14,17,0.824,102,35,83,0.422,29,59,0.492,6,24,0.25,15,17,0.882,91
1552,MEM,2018-02-01,102,@,DET,0,240,40,96,0.417,32,65,0.492,8,31,0.258,14,14,1.0,102,35,76,0.461,28,51,0.549,7,25,0.28,27,37,0.73,104
1553,PHO,2018-01-31,102,,DAL,1,240,40,83,0.482,29,53,0.547,11,30,0.367,11,15,0.733,102,32,88,0.364,22,52,0.423,10,36,0.278,14,26,0.538,88
1554,WAS,2018-01-30,102,,OKC,1,240,34,89,0.382,27,64,0.422,7,25,0.28,27,29,0.931,102,30,80,0.375,21,48,0.438,9,32,0.281,27,34,0.794,96
1555,PHO,2018-01-28,102,@,HOU,0,240,36,85,0.424,28,52,0.538,8,33,0.242,22,26,0.846,102,32,72,0.444,21,35,0.6,11,37,0.297,38,49,0.776,113
1556,LAC,2018-01-24,102,,BOS,0,240,35,79,0.443,30,58,0.517,5,21,0.238,27,39,0.692,102,39,93,0.419,25,53,0.472,14,40,0.35,21,22,0.955,113
1557,CLE,2018-01-23,102,@,SAS,0,240,35,72,0.486,29,51,0.569,6,21,0.286,26,31,0.839,102,47,94,0.5,39,66,0.591,8,28,0.286,12,16,0.75,114
1558,DAL,2018-01-16,102,@,DEN,0,240,38,78,0.487,30,51,0.588,8,27,0.296,18,22,0.818,102,40,86,0.465,32,60,0.533,8,26,0.308,17,26,0.654,105
1559,MIN,2018-01-16,102,@,ORL,0,240,43,98,0.439,36,82,0.439,7,16,0.438,9,10,0.9,102,40,90,0.444,29,59,0.492,11,31,0.355,17,19,0.895,108
1560,HOU,2018-01-15,102,@,LAC,0,240,38,94,0.404,25,50,0.5,13,44,0.295,13,16,0.813,102,44,79,0.557,34,54,0.63,10,25,0.4,15,20,0.75,113
1561,ATL,2018-01-15,102,,SAS,1,240,40,86,0.465,31,61,0.508,9,25,0.36,13,14,0.929,102,37,87,0.425,29,65,0.446,8,22,0.364,17,20,0.85,99
1562,NOP,2018-01-10,102,@,MEM,0,240,34,77,0.442,23,42,0.548,11,35,0.314,23,34,0.676,102,37,88,0.42,32,69,0.464,5,19,0.263,26,32,0.813,105
1563,UTA,2018-01-07,102,@,MIA,0,240,37,82,0.451,27,50,0.54,10,32,0.313,18,20,0.9,102,40,83,0.482,31,54,0.574,9,29,0.31,14,20,0.7,103
1564,WAS,2018-01-05,102,@,MEM,1,240,33,84,0.393,23,57,0.404,10,27,0.37,26,34,0.765,102,35,86,0.407,25,56,0.446,10,30,0.333,20,26,0.769,100
1565,BOS,2018-01-03,102,,CLE,1,240,41,92,0.446,29,56,0.518,12,36,0.333,8,11,0.727,102,31,89,0.348,23,57,0.404,8,32,0.25,18,18,1.0,88
1566,DEN,2017-12-30,102,,PHI,0,240,35,87,0.402,28,55,0.509,7,32,0.219,25,34,0.735,102,45,93,0.484,37,69,0.536,8,24,0.333,9,10,0.9,107
1567,ORL,2017-12-28,102,,DET,1,240,37,82,0.451,26,56,0.464,11,26,0.423,17,17,1.0,102,35,87,0.402,26,64,0.406,9,23,0.391,10,14,0.714,89
1568,MIL,2017-12-28,102,,MIN,1,240,41,75,0.547,36,60,0.6,5,15,0.333,15,16,0.938,102,34,71,0.479,25,43,0.581,9,28,0.321,19,26,0.731,96
1569,BOS,2017-12-27,102,@,CHO,1,240,37,78,0.474,22,44,0.5,15,34,0.441,13,13,1.0,102,32,87,0.368,25,64,0.391,7,23,0.304,20,29,0.69,91
1570,TOR,2017-12-23,102,,PHI,1,240,35,85,0.412,26,58,0.448,9,27,0.333,23,26,0.885,102,33,80,0.413,26,53,0.491,7,27,0.259,13,20,0.65,86
1571,DEN,2017-12-22,102,@,POR,1,240,42,85,0.494,35,60,0.583,7,25,0.28,11,15,0.733,102,35,83,0.422,29,61,0.475,6,22,0.273,9,16,0.563,85
1572,NYK,2017-12-21,102,,BOS,1,240,36,79,0.456,28,65,0.431,8,14,0.571,22,26,0.846,102,33,86,0.384,20,48,0.417,13,38,0.342,14,19,0.737,93
1573,BOS,2017-12-16,102,@,MEM,1,240,39,80,0.488,25,50,0.5,14,30,0.467,10,14,0.714,102,32,79,0.405,18,45,0.4,14,34,0.412,15,17,0.882,93
1574,POR,2017-12-13,102,@,MIA,1,240,36,72,0.5,26,44,0.591,10,28,0.357,20,23,0.87,102,34,72,0.472,21,42,0.5,13,30,0.433,14,23,0.609,95
1575,TOR,2017-12-10,102,@,SAC,1,240,39,87,0.448,28,50,0.56,11,37,0.297,13,19,0.684,102,35,73,0.479,25,50,0.5,10,23,0.435,7,14,0.5,87
1576,OKC,2017-12-09,102,@,MEM,1,265,36,92,0.391,24,58,0.414,12,34,0.353,18,31,0.581,102,39,88,0.443,26,55,0.473,13,33,0.394,10,17,0.588,101
1577,NYK,2017-12-09,102,@,CHI,0,240,43,91,0.473,36,67,0.537,7,24,0.292,9,9,1.0,102,42,82,0.512,35,57,0.614,7,25,0.28,13,23,0.565,104
1578,DAL,2017-12-08,102,@,MIL,0,240,35,75,0.467,25,51,0.49,10,24,0.417,22,26,0.846,102,36,79,0.456,28,55,0.509,8,24,0.333,29,34,0.853,109
1579,BOS,2017-12-08,102,@,SAS,0,240,38,83,0.458,27,45,0.6,11,38,0.289,15,17,0.882,102,38,81,0.469,30,54,0.556,8,27,0.296,21,24,0.875,105
1580,GSW,2017-12-08,102,@,DET,1,240,39,81,0.481,32,55,0.582,7,26,0.269,17,22,0.773,102,38,92,0.413,26,65,0.4,12,27,0.444,10,19,0.526,98
1581,CLE,2017-12-08,102,@,IND,0,240,37,85,0.435,26,49,0.531,11,36,0.306,17,22,0.773,102,38,86,0.442,23,47,0.489,15,39,0.385,15,24,0.625,106
1582,BRK,2017-12-02,102,,ATL,0,240,34,82,0.415,17,40,0.425,17,42,0.405,17,21,0.81,102,47,99,0.475,37,72,0.514,10,27,0.37,10,14,0.714,114
1583,NOP,2017-11-29,102,,MIN,0,240,39,84,0.464,25,49,0.51,14,35,0.4,10,11,0.909,102,47,81,0.58,38,58,0.655,9,23,0.391,17,19,0.895,120
1584,NYK,2017-11-25,102,@,HOU,0,240,42,85,0.494,38,68,0.559,4,17,0.235,14,19,0.737,102,41,94,0.436,23,47,0.489,18,47,0.383,17,22,0.773,117
1585,LAL,2017-11-22,102,@,SAC,0,240,39,78,0.5,24,49,0.49,15,29,0.517,9,15,0.6,102,47,85,0.553,37,64,0.578,10,21,0.476,9,14,0.643,113
1586,MIN,2017-11-20,102,@,CHO,0,240,37,90,0.411,31,63,0.492,6,27,0.222,22,26,0.846,102,42,85,0.494,31,59,0.525,11,26,0.423,23,29,0.793,118
1587,DAL,2017-11-20,102,,BOS,0,265,39,96,0.406,32,63,0.508,7,33,0.212,17,20,0.85,102,38,84,0.452,25,48,0.521,13,36,0.361,21,26,0.808,110
1588,POR,2017-11-18,102,,SAC,1,240,38,70,0.543,28,49,0.571,10,21,0.476,16,21,0.762,102,34,89,0.382,26,72,0.361,8,17,0.471,14,18,0.778,90
1589,CHO,2017-11-18,102,,LAC,1,240,34,87,0.391,23,61,0.377,11,26,0.423,23,29,0.793,102,33,83,0.398,25,54,0.463,8,29,0.276,13,19,0.684,87
1590,WAS,2017-11-15,102,@,MIA,1,240,32,78,0.41,23,59,0.39,9,19,0.474,29,31,0.935,102,32,78,0.41,19,48,0.396,13,30,0.433,16,19,0.842,93
1591,BRK,2017-11-14,102,,BOS,0,240,39,88,0.443,25,53,0.472,14,35,0.4,10,16,0.625,102,39,86,0.453,30,59,0.508,9,27,0.333,22,27,0.815,109
1592,DEN,2017-11-09,102,,OKC,1,240,38,82,0.463,29,55,0.527,9,27,0.333,17,22,0.773,102,38,90,0.422,27,60,0.45,11,30,0.367,7,14,0.5,94
1593,MEM,2017-11-05,102,@,LAL,0,240,40,87,0.46,29,50,0.58,11,37,0.297,11,14,0.786,102,40,85,0.471,31,58,0.534,9,27,0.333,18,23,0.783,107
1594,LAL,2017-10-25,102,,WAS,1,265,41,92,0.446,34,62,0.548,7,30,0.233,13,16,0.813,102,39,95,0.411,33,69,0.478,6,26,0.231,15,23,0.652,99
1595,LAC,2017-10-24,102,,UTA,1,240,39,83,0.47,29,54,0.537,10,29,0.345,14,21,0.667,102,34,79,0.43,27,51,0.529,7,28,0.25,9,11,0.818,84
1596,BOS,2017-10-20,102,@,PHI,1,240,35,84,0.417,25,55,0.455,10,29,0.345,22,32,0.688,102,35,92,0.38,25,60,0.417,10,32,0.313,12,16,0.75,92
1597,DET,2017-10-18,102,,CHO,1,240,41,96,0.427,32,70,0.457,9,26,0.346,11,12,0.917,102,29,73,0.397,20,43,0.465,9,30,0.3,23,29,0.793,90
1598,CLE,2017-10-17,102,,BOS,1,240,38,83,0.458,33,61,0.541,5,22,0.227,21,25,0.84,102,36,88,0.409,28,56,0.5,8,32,0.25,19,25,0.76,99
1599,ORL,2018-04-11,101,,WAS,1,240,33,77,0.429,20,45,0.444,13,32,0.406,22,27,0.815,101,33,95,0.347,23,61,0.377,10,34,0.294,16,27,0.593,92
1600,BOS,2018-04-10,101,@,WAS,0,240,33,87,0.379,20,54,0.37,13,33,0.394,22,27,0.815,101,41,83,0.494,26,53,0.491,15,30,0.5,16,20,0.8,113
1601,ORL,2018-04-08,101,@,TOR,0,240,42,89,0.472,35,66,0.53,7,23,0.304,10,17,0.588,101,39,78,0.5,22,38,0.579,17,40,0.425,17,24,0.708,112
1602,MIA,2018-04-03,101,,ATL,1,240,41,91,0.451,33,58,0.569,8,33,0.242,11,13,0.846,101,37,88,0.42,24,55,0.436,13,33,0.394,11,15,0.733,98
1603,PHI,2018-03-30,101,@,ATL,1,240,42,95,0.442,34,57,0.596,8,38,0.211,9,13,0.692,101,36,101,0.356,27,62,0.435,9,39,0.231,10,15,0.667,91
1604,NYK,2018-03-28,101,@,PHI,0,240,36,94,0.383,27,63,0.429,9,31,0.29,20,26,0.769,101,45,98,0.459,36,67,0.537,9,31,0.29,19,27,0.704,118
1605,MEM,2018-03-26,101,@,MIN,1,240,40,84,0.476,25,53,0.472,15,31,0.484,6,9,0.667,101,33,79,0.418,25,55,0.455,8,24,0.333,19,24,0.792,93
1606,NYK,2018-03-25,101,@,WAS,1,240,41,88,0.466,35,66,0.53,6,22,0.273,13,15,0.867,101,37,87,0.425,31,68,0.456,6,19,0.316,17,23,0.739,97
1607,CHO,2018-03-17,101,@,NYK,0,240,33,90,0.367,24,57,0.421,9,33,0.273,26,32,0.813,101,49,100,0.49,37,74,0.5,12,26,0.462,14,18,0.778,124
1608,NOP,2018-03-17,101,,HOU,0,240,41,83,0.494,33,59,0.559,8,24,0.333,11,12,0.917,101,39,93,0.419,24,52,0.462,15,41,0.366,14,18,0.778,107
1609,MIN,2018-03-17,101,@,SAS,0,240,39,81,0.481,32,69,0.464,7,12,0.583,16,20,0.8,101,49,96,0.51,43,70,0.614,6,26,0.231,13,14,0.929,117
1610,MEM,2018-03-17,101,,DEN,1,240,33,81,0.407,20,49,0.408,13,32,0.406,22,28,0.786,101,32,87,0.368,23,54,0.426,9,33,0.273,21,29,0.724,94
1611,HOU,2018-03-15,101,,LAC,1,240,35,90,0.389,23,49,0.469,12,41,0.293,19,23,0.826,101,44,97,0.454,40,79,0.506,4,18,0.222,4,8,0.5,96
1612,IND,2018-03-13,101,@,PHI,1,240,38,95,0.4,33,71,0.465,5,24,0.208,20,25,0.8,101,35,75,0.467,25,45,0.556,10,30,0.333,18,22,0.818,98
1613,SAC,2018-03-12,101,@,OKC,0,240,38,93,0.409,26,60,0.433,12,33,0.364,13,16,0.813,101,38,84,0.452,22,48,0.458,16,36,0.444,14,18,0.778,106
1614,SAC,2018-03-07,101,,NOP,0,240,39,93,0.419,30,65,0.462,9,28,0.321,14,17,0.824,101,47,83,0.566,36,57,0.632,11,26,0.423,9,9,1.0,114
1615,BRK,2018-03-06,101,@,GSW,0,240,36,85,0.424,27,51,0.529,9,34,0.265,20,25,0.8,101,47,83,0.566,36,60,0.6,11,23,0.478,9,11,0.818,114
1616,WAS,2018-02-28,101,,GSW,0,240,36,90,0.4,25,58,0.431,11,32,0.344,18,21,0.857,101,37,72,0.514,27,48,0.563,10,24,0.417,25,30,0.833,109
1617,PHI,2018-02-27,101,@,MIA,0,240,35,84,0.417,23,53,0.434,12,31,0.387,19,23,0.826,101,36,82,0.439,27,55,0.491,9,27,0.333,21,28,0.75,102
1618,UTA,2018-02-12,101,,SAS,1,240,35,84,0.417,24,60,0.4,11,24,0.458,20,30,0.667,101,38,85,0.447,32,60,0.533,6,25,0.24,17,25,0.68,99
1619,BRK,2018-02-12,101,,LAC,0,240,41,89,0.461,29,49,0.592,12,40,0.3,7,10,0.7,101,48,85,0.565,42,69,0.609,6,16,0.375,12,14,0.857,114
1620,ORL,2018-02-12,101,@,CHI,0,240,37,84,0.44,27,53,0.509,10,31,0.323,17,19,0.895,101,40,88,0.455,31,56,0.554,9,32,0.281,16,21,0.762,105
1621,WAS,2018-02-10,101,@,CHI,1,240,38,82,0.463,25,44,0.568,13,38,0.342,12,14,0.857,101,34,80,0.425,25,48,0.521,9,32,0.281,13,16,0.813,90
1622,MIA,2018-02-07,101,,HOU,0,240,39,88,0.443,26,56,0.464,13,32,0.406,10,12,0.833,101,38,74,0.514,26,43,0.605,12,31,0.387,21,26,0.808,109
1623,DAL,2018-02-05,101,@,LAC,0,240,33,80,0.413,16,38,0.421,17,42,0.405,18,20,0.9,101,42,87,0.483,32,60,0.533,10,27,0.37,10,12,0.833,104
1624,TOR,2018-02-04,101,,MEM,1,240,41,89,0.461,35,54,0.648,6,35,0.171,13,15,0.867,101,29,81,0.358,21,56,0.375,8,25,0.32,20,23,0.87,86
1625,MEM,2018-01-31,101,@,IND,0,240,39,82,0.476,27,56,0.482,12,26,0.462,11,15,0.733,101,37,70,0.529,27,44,0.614,10,26,0.385,21,31,0.677,105
1626,NOP,2018-01-24,101,@,CHO,1,240,39,87,0.448,30,61,0.492,9,26,0.346,14,18,0.778,101,36,85,0.424,30,64,0.469,6,21,0.286,18,31,0.581,96
1627,PHO,2018-01-24,101,@,IND,0,240,35,84,0.417,26,49,0.531,9,35,0.257,22,29,0.759,101,45,80,0.563,36,56,0.643,9,24,0.375,17,25,0.68,116
1628,CHI,2018-01-24,101,@,PHI,0,240,36,94,0.383,25,57,0.439,11,37,0.297,18,22,0.818,101,42,81,0.519,26,49,0.531,16,32,0.5,15,20,0.75,115
1629,PHI,2018-01-22,101,@,MEM,0,240,32,71,0.451,18,40,0.45,14,31,0.452,23,31,0.742,101,33,78,0.423,23,52,0.442,10,26,0.385,29,35,0.829,105
1630,POR,2018-01-22,101,@,DEN,0,240,36,85,0.424,28,60,0.467,8,25,0.32,21,26,0.808,101,34,83,0.41,24,53,0.453,10,30,0.333,26,33,0.788,104
1631,BRK,2018-01-21,101,@,DET,1,240,37,80,0.463,24,49,0.49,13,31,0.419,14,20,0.7,101,38,90,0.422,29,61,0.475,9,29,0.31,15,17,0.882,100
1632,BRK,2018-01-19,101,,MIA,1,240,36,76,0.474,27,44,0.614,9,32,0.281,20,26,0.769,101,35,84,0.417,28,62,0.452,7,22,0.318,18,25,0.72,95
1633,MIL,2018-01-17,101,,MIA,0,240,33,76,0.434,22,48,0.458,11,28,0.393,24,32,0.75,101,38,82,0.463,28,58,0.483,10,24,0.417,20,27,0.741,106
1634,OKC,2018-01-13,101,@,CHO,1,240,39,97,0.402,31,71,0.437,8,26,0.308,15,20,0.75,101,33,83,0.398,24,55,0.436,9,28,0.321,16,23,0.696,91
1635,DAL,2018-01-13,101,,LAL,0,265,34,90,0.378,23,47,0.489,11,43,0.256,22,28,0.786,101,43,95,0.453,35,69,0.507,8,26,0.308,13,18,0.722,107
1636,HOU,2018-01-06,101,@,DET,0,240,38,90,0.422,23,43,0.535,15,47,0.319,10,11,0.909,101,38,75,0.507,26,50,0.52,12,25,0.48,20,27,0.741,108
1637,IND,2018-01-03,101,@,MIL,0,240,41,84,0.488,38,69,0.551,3,15,0.2,16,19,0.842,101,44,75,0.587,35,58,0.603,9,17,0.529,25,28,0.893,122
1638,CLE,2017-12-30,101,@,UTA,0,240,34,81,0.42,22,41,0.537,12,40,0.3,21,26,0.808,101,38,82,0.463,28,51,0.549,10,31,0.323,18,21,0.857,104
1639,SAC,2017-12-29,101,,PHO,0,240,37,80,0.463,29,57,0.509,8,23,0.348,19,23,0.826,101,41,85,0.482,28,55,0.509,13,30,0.433,16,24,0.667,111
1640,UTA,2017-12-27,101,@,GSW,0,240,37,92,0.402,31,69,0.449,6,23,0.261,21,27,0.778,101,51,86,0.593,40,63,0.635,11,23,0.478,13,17,0.765,126
1641,DAL,2017-12-22,101,@,MIA,0,240,38,75,0.507,21,40,0.525,17,35,0.486,8,11,0.727,101,46,72,0.639,30,47,0.638,16,25,0.64,5,6,0.833,113
1642,NYK,2017-12-22,101,@,DET,0,240,44,97,0.454,36,73,0.493,8,24,0.333,5,6,0.833,101,38,88,0.432,28,63,0.444,10,25,0.4,18,25,0.72,104
1643,SAC,2017-12-19,101,@,PHI,1,240,41,91,0.451,34,64,0.531,7,27,0.259,12,23,0.522,101,34,81,0.42,24,46,0.522,10,35,0.286,17,24,0.708,95
1644,MEM,2017-12-09,101,,OKC,0,265,39,88,0.443,26,55,0.473,13,33,0.394,10,17,0.588,101,36,92,0.391,24,58,0.414,12,34,0.353,18,31,0.581,102
1645,MIA,2017-12-09,101,@,BRK,1,240,42,90,0.467,34,63,0.54,8,27,0.296,9,14,0.643,101,33,81,0.407,26,54,0.481,7,27,0.259,16,19,0.842,89
1646,PHO,2017-12-09,101,,SAS,0,240,35,80,0.438,28,55,0.509,7,25,0.28,24,30,0.8,101,40,87,0.46,34,68,0.5,6,19,0.316,18,25,0.72,104
1647,UTA,2017-12-07,101,,HOU,0,240,34,77,0.442,23,47,0.489,11,30,0.367,22,27,0.815,101,38,81,0.469,20,39,0.513,18,42,0.429,18,24,0.75,112
1648,CLE,2017-12-06,101,,SAC,1,240,37,78,0.474,23,39,0.59,14,39,0.359,13,21,0.619,101,39,86,0.453,29,54,0.537,10,32,0.313,7,13,0.538,95
1649,GSW,2017-12-06,101,@,CHO,1,240,40,84,0.476,29,54,0.537,11,30,0.367,10,13,0.769,101,34,97,0.351,28,78,0.359,6,19,0.316,13,17,0.765,87
1650,PHI,2017-12-04,101,,PHO,0,240,39,91,0.429,32,61,0.525,7,30,0.233,16,16,1.0,101,44,91,0.484,34,69,0.493,10,22,0.455,17,22,0.773,115
1651,PHI,2017-11-22,101,,POR,1,240,39,90,0.433,28,58,0.483,11,32,0.344,12,17,0.706,101,30,89,0.337,23,63,0.365,7,26,0.269,14,24,0.583,81
1652,OKC,2017-11-17,101,@,SAS,0,240,39,89,0.438,30,66,0.455,9,23,0.391,14,21,0.667,101,34,77,0.442,20,42,0.476,14,35,0.4,22,28,0.786,104
1653,UTA,2017-11-15,101,@,NYK,0,240,34,79,0.43,17,44,0.386,17,35,0.486,16,17,0.941,101,38,81,0.469,29,60,0.483,9,21,0.429,21,25,0.84,106
1654,NYK,2017-11-13,101,,CLE,0,240,38,88,0.432,30,63,0.476,8,25,0.32,17,22,0.773,101,35,88,0.398,19,43,0.442,16,45,0.356,18,22,0.818,104
1655,BRK,2017-11-10,101,@,POR,1,240,39,91,0.429,27,53,0.509,12,38,0.316,11,19,0.579,101,40,95,0.421,32,72,0.444,8,23,0.348,9,11,0.818,97
1656,MIN,2017-11-08,101,@,GSW,0,240,38,92,0.413,33,68,0.485,5,24,0.208,20,27,0.741,101,48,85,0.565,33,49,0.673,15,36,0.417,14,18,0.778,125
1657,LAC,2017-11-05,101,,MIA,0,240,34,87,0.391,25,56,0.446,9,31,0.29,24,30,0.8,101,37,84,0.44,23,48,0.479,14,36,0.389,16,19,0.842,104
1658,IND,2017-11-05,101,@,NYK,0,240,37,79,0.468,25,54,0.463,12,25,0.48,15,17,0.882,101,44,88,0.5,38,65,0.585,6,23,0.261,14,19,0.737,108
1659,BOS,2017-11-03,101,@,OKC,1,240,36,84,0.429,23,56,0.411,13,28,0.464,16,24,0.667,101,35,87,0.402,22,52,0.423,13,35,0.371,11,14,0.786,94
1660,CHO,2017-11-03,101,@,SAS,0,240,33,80,0.413,25,56,0.446,8,24,0.333,27,42,0.643,101,39,83,0.47,30,56,0.536,9,27,0.333,21,26,0.808,108
1661,ORL,2017-11-01,101,@,MEM,1,240,38,75,0.507,25,46,0.543,13,29,0.448,12,14,0.857,101,39,82,0.476,29,52,0.558,10,30,0.333,11,16,0.688,99
1662,IND,2017-10-31,101,,SAC,1,240,36,85,0.424,24,56,0.429,12,29,0.414,17,22,0.773,101,37,88,0.42,35,74,0.473,2,14,0.143,7,14,0.5,83
1663,CLE,2017-10-28,101,@,NOP,0,240,36,78,0.462,24,46,0.522,12,32,0.375,17,23,0.739,101,49,95,0.516,36,62,0.581,13,33,0.394,12,16,0.75,123
1664,OKC,2017-10-28,101,@,CHI,1,240,39,88,0.443,26,54,0.481,13,34,0.382,10,14,0.714,101,22,78,0.282,12,41,0.293,10,37,0.27,15,20,0.75,69
1665,TOR,2017-10-27,101,@,LAL,1,240,40,93,0.43,33,64,0.516,7,29,0.241,14,20,0.7,101,36,79,0.456,33,56,0.589,3,23,0.13,17,24,0.708,92
1666,MIN,2017-10-25,101,@,DET,0,240,37,85,0.435,28,60,0.467,9,25,0.36,18,21,0.857,101,48,92,0.522,33,58,0.569,15,34,0.441,11,17,0.647,122
1667,SAS,2017-10-23,101,,TOR,1,240,40,90,0.444,35,70,0.5,5,20,0.25,16,23,0.696,101,34,80,0.425,24,43,0.558,10,37,0.27,19,24,0.792,97
1668,GSW,2017-10-21,101,@,MEM,0,240,33,84,0.393,21,46,0.457,12,38,0.316,23,27,0.852,101,36,77,0.468,26,50,0.52,10,27,0.37,29,37,0.784,111
1669,LAC,2018-04-11,100,,LAL,0,240,41,83,0.494,35,65,0.538,6,18,0.333,12,28,0.429,100,42,88,0.477,25,49,0.51,17,39,0.436,14,16,0.875,115
1670,LAC,2018-04-09,100,,NOP,0,240,45,98,0.459,43,81,0.531,2,17,0.118,8,19,0.421,100,44,95,0.463,33,65,0.508,11,30,0.367,14,20,0.7,113
1671,PHO,2018-04-08,100,,GSW,0,240,39,92,0.424,29,57,0.509,10,35,0.286,12,16,0.75,100,47,90,0.522,34,58,0.586,13,32,0.406,10,15,0.667,117
1672,ORL,2018-04-06,100,,CHO,0,240,42,94,0.447,33,71,0.465,9,23,0.391,7,13,0.538,100,48,86,0.558,31,55,0.564,17,31,0.548,24,26,0.923,137
1673,DEN,2018-04-05,100,,MIN,1,240,35,89,0.393,24,53,0.453,11,36,0.306,19,22,0.864,100,39,91,0.429,33,67,0.493,6,24,0.25,12,16,0.75,96
1674,DAL,2018-04-04,100,@,ORL,0,240,39,89,0.438,29,59,0.492,10,30,0.333,12,17,0.706,100,39,86,0.453,31,57,0.544,8,29,0.276,19,27,0.704,105
1675,SAS,2018-04-01,100,,HOU,1,240,40,81,0.494,34,64,0.531,6,17,0.353,14,21,0.667,100,26,77,0.338,19,46,0.413,7,31,0.226,24,29,0.828,83
1676,LAL,2018-03-24,100,@,MEM,1,240,35,86,0.407,22,48,0.458,13,38,0.342,17,25,0.68,100,35,84,0.417,30,55,0.545,5,29,0.172,18,22,0.818,93
1677,POR,2018-03-23,100,,BOS,0,240,40,91,0.44,32,58,0.552,8,33,0.242,12,15,0.8,100,35,77,0.455,24,59,0.407,11,18,0.611,24,26,0.923,105
1678,WAS,2018-03-23,100,,DEN,0,240,38,80,0.475,24,52,0.462,14,28,0.5,10,14,0.714,100,37,85,0.435,20,51,0.392,17,34,0.5,17,18,0.944,108
1679,HOU,2018-03-22,100,,DET,1,265,35,99,0.354,23,48,0.479,12,51,0.235,18,28,0.643,100,40,95,0.421,34,57,0.596,6,38,0.158,10,19,0.526,96
1680,BOS,2018-03-20,100,,OKC,1,240,36,87,0.414,23,51,0.451,13,36,0.361,15,16,0.938,100,35,85,0.412,25,58,0.431,10,27,0.37,19,29,0.655,99
1681,LAL,2018-03-19,100,@,IND,0,240,38,86,0.442,30,53,0.566,8,33,0.242,16,23,0.696,100,43,87,0.494,37,66,0.561,6,21,0.286,18,19,0.947,110
1682,POR,2018-03-17,100,,DET,1,240,38,87,0.437,30,56,0.536,8,31,0.258,16,18,0.889,100,31,80,0.388,21,55,0.382,10,25,0.4,15,20,0.75,87
1683,SAS,2018-03-05,100,,MEM,1,240,35,76,0.461,29,54,0.537,6,22,0.273,24,31,0.774,100,42,80,0.525,34,58,0.586,8,22,0.364,6,9,0.667,98
1684,MEM,2018-03-03,100,@,ORL,0,240,38,93,0.409,32,71,0.451,6,22,0.273,18,26,0.692,100,36,72,0.5,28,47,0.596,8,25,0.32,27,33,0.818,107
1685,OKC,2018-03-03,100,@,POR,0,240,40,91,0.44,34,64,0.531,6,27,0.222,14,21,0.667,100,39,88,0.443,28,55,0.509,11,33,0.333,19,23,0.826,108
1686,DAL,2018-03-02,100,@,CHI,0,240,35,84,0.417,22,55,0.4,13,29,0.448,17,21,0.81,100,42,89,0.472,32,62,0.516,10,27,0.37,14,20,0.7,108
1687,SAC,2018-02-26,100,,MIN,0,240,40,84,0.476,32,62,0.516,8,22,0.364,12,13,0.923,100,39,76,0.513,32,60,0.533,7,16,0.438,33,36,0.917,118
1688,POR,2018-02-23,100,@,UTA,1,240,39,87,0.448,30,63,0.476,9,24,0.375,13,14,0.929,100,33,78,0.423,27,53,0.509,6,25,0.24,9,11,0.818,81
1689,HOU,2018-02-14,100,,SAC,1,240,33,83,0.398,19,34,0.559,14,49,0.286,20,22,0.909,100,38,87,0.437,28,55,0.509,10,32,0.313,5,8,0.625,91
1690,PHI,2018-02-09,100,,NOP,1,240,39,93,0.419,25,59,0.424,14,34,0.412,8,9,0.889,100,33,95,0.347,25,64,0.391,8,31,0.258,8,16,0.5,82
1691,SAC,2018-02-09,100,,POR,0,240,38,90,0.422,29,67,0.433,9,23,0.391,15,21,0.714,100,43,88,0.489,28,53,0.528,15,35,0.429,17,18,0.944,118
1692,ORL,2018-02-08,100,,ATL,1,240,36,84,0.429,27,55,0.491,9,29,0.31,19,22,0.864,100,37,87,0.425,25,57,0.439,12,30,0.4,12,18,0.667,98
1693,IND,2018-02-03,100,,PHI,1,240,35,79,0.443,26,52,0.5,9,27,0.333,21,25,0.84,100,33,87,0.379,23,55,0.418,10,32,0.313,16,24,0.667,92
1694,OKC,2018-02-02,100,,NOP,0,240,37,97,0.381,28,61,0.459,9,36,0.25,17,20,0.85,100,46,90,0.511,33,66,0.5,13,24,0.542,9,13,0.692,114
1695,MIN,2018-01-29,100,@,ATL,0,240,39,83,0.47,32,64,0.5,7,19,0.368,15,18,0.833,100,39,79,0.494,26,45,0.578,13,34,0.382,14,16,0.875,105
1696,MEM,2018-01-26,100,,LAC,0,240,39,81,0.481,31,54,0.574,8,27,0.296,14,18,0.778,100,39,80,0.488,29,53,0.547,10,27,0.37,21,29,0.724,109
1697,DET,2018-01-21,100,,BRK,0,240,38,90,0.422,29,61,0.475,9,29,0.31,15,17,0.882,100,37,80,0.463,24,49,0.49,13,31,0.419,14,20,0.7,101
1698,DEN,2018-01-19,100,,PHO,0,240,35,78,0.449,21,42,0.5,14,36,0.389,16,21,0.762,100,40,81,0.494,26,48,0.542,14,33,0.424,14,20,0.7,108
1699,POR,2018-01-18,100,,IND,1,240,37,94,0.394,27,62,0.435,10,32,0.313,16,16,1.0,100,36,91,0.396,29,65,0.446,7,26,0.269,7,13,0.538,86
1700,SAS,2018-01-17,100,@,BRK,1,240,34,82,0.415,25,63,0.397,9,19,0.474,23,31,0.742,100,35,83,0.422,22,47,0.468,13,36,0.361,12,18,0.667,95
1701,SAC,2018-01-08,100,,SAS,0,240,40,82,0.488,32,59,0.542,8,23,0.348,12,16,0.75,100,44,90,0.489,33,64,0.516,11,26,0.423,8,13,0.615,107
1702,OKC,2018-01-07,100,@,PHO,0,240,40,86,0.465,32,59,0.542,8,27,0.296,12,21,0.571,100,39,88,0.443,22,49,0.449,17,39,0.436,19,23,0.826,114
1703,NYK,2018-01-07,100,@,DAL,1,240,38,83,0.458,32,67,0.478,6,16,0.375,18,20,0.9,100,35,92,0.38,29,68,0.426,6,24,0.25,20,24,0.833,96
1704,MEM,2018-01-05,100,,WAS,0,240,35,86,0.407,25,56,0.446,10,30,0.333,20,26,0.769,100,33,84,0.393,23,57,0.404,10,27,0.37,26,34,0.765,102
1705,SAS,2018-01-02,100,@,NYK,1,240,31,82,0.378,21,55,0.382,10,27,0.37,28,34,0.824,100,35,87,0.402,28,65,0.431,7,22,0.318,14,18,0.778,91
1706,GSW,2017-12-29,100,,CHO,0,240,40,87,0.46,32,65,0.492,8,22,0.364,12,13,0.923,100,41,89,0.461,35,69,0.507,6,20,0.3,23,34,0.676,111
1707,UTA,2017-12-21,100,,SAS,1,240,34,74,0.459,22,48,0.458,12,26,0.462,20,24,0.833,100,34,78,0.436,24,57,0.421,10,21,0.476,11,16,0.688,89
1708,UTA,2017-12-16,100,@,CLE,0,240,37,81,0.457,20,47,0.426,17,34,0.5,9,14,0.643,100,42,79,0.532,32,57,0.561,10,22,0.455,15,17,0.882,109
1709,WAS,2017-12-15,100,,LAC,1,240,39,88,0.443,32,57,0.561,7,31,0.226,15,23,0.652,100,33,86,0.384,26,62,0.419,7,24,0.292,18,29,0.621,91
1710,UTA,2017-12-13,100,@,CHI,0,240,42,91,0.462,33,61,0.541,9,30,0.3,7,7,1.0,100,41,93,0.441,34,76,0.447,7,17,0.412,14,21,0.667,103
1711,OKC,2017-12-13,100,@,IND,1,240,36,88,0.409,23,59,0.39,13,29,0.448,15,24,0.625,100,40,89,0.449,29,58,0.5,11,31,0.355,4,6,0.667,95
1712,UTA,2017-12-09,100,@,MIL,0,240,33,76,0.434,25,53,0.472,8,23,0.348,26,37,0.703,100,44,81,0.543,37,64,0.578,7,17,0.412,22,26,0.846,117
1713,BRK,2017-12-07,100,,OKC,1,240,35,80,0.438,24,43,0.558,11,37,0.297,19,30,0.633,100,38,98,0.388,31,74,0.419,7,24,0.292,12,23,0.522,95
1714,DET,2017-12-06,100,@,MIL,0,240,36,87,0.414,26,57,0.456,10,30,0.333,18,27,0.667,100,39,79,0.494,31,57,0.544,8,22,0.364,18,26,0.692,104
1715,OKC,2017-12-05,100,,UTA,1,240,39,81,0.481,35,63,0.556,4,18,0.222,18,26,0.692,100,34,79,0.43,23,46,0.5,11,33,0.333,15,21,0.714,94
1716,MIL,2017-12-04,100,@,BOS,0,240,35,78,0.449,26,57,0.456,9,21,0.429,21,24,0.875,100,43,78,0.551,33,56,0.589,10,22,0.455,15,19,0.789,111
1717,NYK,2017-12-03,100,,ORL,0,240,43,93,0.462,38,78,0.487,5,15,0.333,9,10,0.9,100,37,82,0.451,31,54,0.574,6,28,0.214,25,29,0.862,105
1718,LAL,2017-12-02,100,@,DEN,0,240,38,86,0.442,29,56,0.518,9,30,0.3,15,21,0.714,100,40,87,0.46,28,56,0.5,12,31,0.387,23,28,0.821,115
1719,CHO,2017-12-01,100,@,MIA,0,240,38,79,0.481,33,59,0.559,5,20,0.25,19,21,0.905,100,39,80,0.488,25,45,0.556,14,35,0.4,13,21,0.619,105
1720,MIA,2017-11-26,100,@,CHI,1,240,34,75,0.453,21,43,0.488,13,32,0.406,19,23,0.826,100,33,89,0.371,19,56,0.339,14,33,0.424,13,16,0.813,93
1721,CLE,2017-11-24,100,,CHO,1,240,38,83,0.458,25,44,0.568,13,39,0.333,11,15,0.733,100,36,94,0.383,25,65,0.385,11,29,0.379,16,27,0.593,99
1722,TOR,2017-11-22,100,@,NYK,0,240,37,87,0.425,23,49,0.469,14,38,0.368,12,18,0.667,100,43,93,0.462,35,69,0.507,8,24,0.333,14,17,0.824,108
1723,POR,2017-11-20,100,@,MEM,1,240,33,83,0.398,27,68,0.397,6,15,0.4,28,32,0.875,100,33,86,0.384,25,56,0.446,8,30,0.267,18,23,0.783,92
1724,DET,2017-11-19,100,@,MIN,1,240,39,83,0.47,31,58,0.534,8,25,0.32,14,20,0.7,100,40,78,0.513,35,56,0.625,5,22,0.227,12,18,0.667,97
1725,TOR,2017-11-19,100,,WAS,1,240,40,90,0.444,30,51,0.588,10,39,0.256,10,14,0.714,100,34,81,0.42,23,62,0.371,11,19,0.579,12,21,0.571,91
1726,DET,2017-11-17,100,@,IND,0,240,39,93,0.419,25,60,0.417,14,33,0.424,8,10,0.8,100,39,89,0.438,24,61,0.393,15,28,0.536,14,21,0.667,107
1727,ORL,2017-11-13,100,@,GSW,0,240,37,88,0.42,27,56,0.482,10,32,0.313,16,18,0.889,100,44,88,0.5,36,65,0.554,8,23,0.348,14,16,0.875,110
1728,LAL,2017-11-13,100,@,PHO,1,240,39,92,0.424,25,59,0.424,14,33,0.424,8,13,0.615,100,37,95,0.389,30,69,0.435,7,26,0.269,12,20,0.6,93
1729,UTA,2017-11-03,100,,TOR,0,240,35,80,0.438,27,57,0.474,8,23,0.348,22,24,0.917,100,38,71,0.535,27,41,0.659,11,30,0.367,22,28,0.786,109
1730,ATL,2017-10-27,100,,DEN,0,240,37,89,0.416,23,56,0.411,14,33,0.424,12,12,1.0,100,42,91,0.462,38,71,0.535,4,20,0.2,17,23,0.739,105
1731,MIA,2017-10-25,100,,SAS,0,240,37,80,0.463,28,54,0.519,9,26,0.346,17,18,0.944,100,42,76,0.553,32,59,0.542,10,17,0.588,23,30,0.767,117
1732,MIN,2017-10-20,100,,UTA,1,240,36,81,0.444,29,59,0.492,7,22,0.318,21,26,0.808,100,37,77,0.481,28,55,0.509,9,22,0.409,14,17,0.824,97
1733,CHI,2017-10-19,100,@,TOR,0,240,37,89,0.416,27,57,0.474,10,32,0.313,16,18,0.889,100,39,83,0.47,26,54,0.481,13,29,0.448,26,28,0.929,117
1734,BOS,2017-10-18,100,,MIL,0,240,39,91,0.429,28,63,0.444,11,28,0.393,11,21,0.524,100,38,76,0.5,31,55,0.564,7,21,0.333,25,30,0.833,108
1735,SAC,2017-10-18,100,,HOU,0,240,42,88,0.477,34,65,0.523,8,23,0.348,8,10,0.8,100,33,83,0.398,21,38,0.553,12,45,0.267,27,29,0.931,105
1736,LAL,2018-04-10,99,,HOU,0,240,38,90,0.422,28,54,0.519,10,36,0.278,13,15,0.867,99,37,88,0.42,21,41,0.512,16,47,0.34,15,16,0.938,105
1737,TOR,2018-03-31,99,@,BOS,0,240,37,80,0.463,29,45,0.644,8,35,0.229,17,22,0.773,99,40,88,0.455,33,71,0.465,7,17,0.412,23,27,0.852,110
1738,OKC,2018-03-29,99,@,SAS,0,240,37,85,0.435,26,55,0.473,11,30,0.367,14,21,0.667,99,34,81,0.42,21,50,0.42,13,31,0.419,22,30,0.733,103
1739,PHO,2018-03-28,99,,LAC,0,240,38,88,0.432,28,54,0.519,10,34,0.294,13,18,0.722,99,43,80,0.538,35,63,0.556,8,17,0.471,17,25,0.68,111
1740,ATL,2018-03-25,99,@,HOU,0,240,39,88,0.443,28,48,0.583,11,40,0.275,10,11,0.909,99,44,90,0.489,24,38,0.632,20,52,0.385,10,11,0.909,118
1741,PHO,2018-03-24,99,@,ORL,0,240,36,89,0.404,29,60,0.483,7,29,0.241,20,26,0.769,99,37,84,0.44,26,54,0.481,11,30,0.367,20,27,0.741,105
1742,MIA,2018-03-23,99,@,OKC,0,240,34,87,0.391,21,57,0.368,13,30,0.433,18,20,0.9,99,36,84,0.429,28,58,0.483,8,26,0.308,25,33,0.758,105
1743,ATL,2018-03-20,99,@,UTA,1,240,38,94,0.404,29,61,0.475,9,33,0.273,14,19,0.737,99,33,89,0.371,27,55,0.491,6,34,0.176,22,25,0.88,94
1744,OKC,2018-03-20,99,@,BOS,0,240,35,85,0.412,25,58,0.431,10,27,0.37,19,29,0.655,99,36,87,0.414,23,51,0.451,13,36,0.361,15,16,0.938,100
1745,IND,2018-03-15,99,,TOR,0,240,40,93,0.43,33,69,0.478,7,24,0.292,12,17,0.706,99,35,79,0.443,23,47,0.489,12,32,0.375,24,28,0.857,106
1746,MIA,2018-03-12,99,@,POR,0,240,39,91,0.429,29,60,0.483,10,31,0.323,11,16,0.688,99,38,83,0.458,24,47,0.511,14,36,0.389,25,30,0.833,115
1747,NOP,2018-03-11,99,,UTA,0,240,41,93,0.441,35,72,0.486,6,21,0.286,11,13,0.846,99,40,96,0.417,28,64,0.438,12,32,0.375,24,25,0.96,116
1748,IND,2018-03-11,99,@,BOS,1,240,39,81,0.481,27,59,0.458,12,22,0.545,9,10,0.9,99,34,81,0.42,22,44,0.5,12,37,0.324,17,21,0.81,97
1749,DET,2018-03-09,99,,CHI,1,240,38,81,0.469,29,54,0.537,9,27,0.333,14,18,0.778,99,33,93,0.355,24,62,0.387,9,31,0.29,8,10,0.8,83
1750,PHI,2018-03-08,99,@,MIA,0,240,34,86,0.395,19,49,0.388,15,37,0.405,16,21,0.762,99,42,89,0.472,28,63,0.444,14,26,0.538,10,18,0.556,108
1751,MIL,2018-03-07,99,,HOU,0,240,38,83,0.458,29,55,0.527,9,28,0.321,14,19,0.737,99,39,82,0.476,25,42,0.595,14,40,0.35,18,27,0.667,110
1752,NYK,2018-03-04,99,@,SAC,0,240,40,88,0.455,34,67,0.507,6,21,0.286,13,18,0.722,99,39,86,0.453,26,56,0.464,13,30,0.433,11,11,1.0,102
1753,CHO,2018-03-02,99,@,PHI,0,240,34,81,0.42,23,57,0.404,11,24,0.458,20,32,0.625,99,41,81,0.506,32,57,0.561,9,24,0.375,19,25,0.76,110
1754,MIN,2018-03-01,99,@,POR,0,240,38,85,0.447,34,65,0.523,4,20,0.2,19,21,0.905,99,36,92,0.391,27,62,0.435,9,30,0.3,27,35,0.771,108
1755,SAC,2018-02-27,99,@,POR,0,240,39,88,0.443,32,66,0.485,7,22,0.318,14,15,0.933,99,44,84,0.524,29,50,0.58,15,34,0.441,13,17,0.765,116
1756,SAS,2018-02-12,99,@,UTA,0,240,38,85,0.447,32,60,0.533,6,25,0.24,17,25,0.68,99,35,84,0.417,24,60,0.4,11,24,0.458,20,30,0.667,101
1757,BOS,2018-02-11,99,,CLE,0,240,36,89,0.404,26,51,0.51,10,38,0.263,17,22,0.773,99,45,84,0.536,29,54,0.537,16,30,0.533,15,20,0.75,121
1758,ATL,2018-02-04,99,@,NYK,1,240,35,87,0.402,20,54,0.37,15,33,0.455,14,19,0.737,99,41,94,0.436,36,71,0.507,5,23,0.217,9,15,0.6,96
1759,SAC,2018-02-03,99,,DAL,0,240,43,82,0.524,35,55,0.636,8,27,0.296,5,6,0.833,99,41,83,0.494,28,42,0.667,13,41,0.317,11,14,0.786,106
1760,BRK,2018-02-02,99,,LAL,0,240,37,82,0.451,28,53,0.528,9,29,0.31,16,23,0.696,99,39,92,0.424,29,66,0.439,10,26,0.385,14,20,0.7,102
1761,GSW,2018-01-30,99,@,UTA,0,240,39,85,0.459,34,60,0.567,5,25,0.2,16,21,0.762,99,53,91,0.582,39,63,0.619,14,28,0.5,9,14,0.643,129
1762,ORL,2018-01-23,99,,SAC,0,240,36,83,0.434,25,52,0.481,11,31,0.355,16,19,0.842,99,43,87,0.494,35,61,0.574,8,26,0.308,11,13,0.846,105
1763,HOU,2018-01-22,99,,MIA,1,240,36,81,0.444,21,44,0.477,15,37,0.405,12,18,0.667,99,39,82,0.476,32,52,0.615,7,30,0.233,5,9,0.556,90
1764,LAL,2018-01-19,99,,IND,1,240,44,80,0.55,35,52,0.673,9,28,0.321,2,14,0.143,99,37,97,0.381,35,72,0.486,2,25,0.08,10,13,0.769,86
1765,NYK,2018-01-17,99,@,MEM,0,240,35,82,0.427,28,55,0.509,7,27,0.259,22,23,0.957,99,41,91,0.451,31,63,0.492,10,28,0.357,13,17,0.765,105
1766,SAS,2018-01-15,99,@,ATL,0,240,37,87,0.425,29,65,0.446,8,22,0.364,17,20,0.85,99,40,86,0.465,31,61,0.508,9,25,0.36,13,14,0.929,102
1767,CHO,2018-01-12,99,,UTA,1,240,32,78,0.41,23,51,0.451,9,27,0.333,26,34,0.765,99,28,77,0.364,16,42,0.381,12,35,0.343,20,23,0.87,88
1768,CLE,2018-01-11,99,@,TOR,0,240,34,89,0.382,28,63,0.444,6,26,0.231,25,30,0.833,99,53,106,0.5,35,64,0.547,18,42,0.429,9,13,0.692,133
1769,LAL,2018-01-09,99,,SAC,1,240,37,77,0.481,25,42,0.595,12,35,0.343,13,21,0.619,99,30,87,0.345,22,66,0.333,8,21,0.381,18,27,0.667,86
1770,ORL,2018-01-09,99,@,DAL,0,240,36,79,0.456,25,50,0.5,11,29,0.379,16,22,0.727,99,43,83,0.518,34,57,0.596,9,26,0.346,19,22,0.864,114
1771,CLE,2018-01-08,99,@,MIN,0,240,37,84,0.44,24,46,0.522,13,38,0.342,12,16,0.75,99,52,100,0.52,42,69,0.609,10,31,0.323,13,17,0.765,127
1772,DEN,2018-01-05,99,,UTA,1,240,38,86,0.442,24,51,0.471,14,35,0.4,9,15,0.6,99,38,84,0.452,26,51,0.51,12,33,0.364,3,6,0.5,91
1773,BOS,2017-12-28,99,,HOU,1,240,37,82,0.451,29,53,0.547,8,29,0.276,17,24,0.708,99,30,80,0.375,16,37,0.432,14,43,0.326,24,31,0.774,98
1774,LAL,2017-12-27,99,,MEM,0,240,35,93,0.376,27,65,0.415,8,28,0.286,21,33,0.636,99,35,71,0.493,30,50,0.6,5,21,0.238,34,39,0.872,109
1775,WAS,2017-12-27,99,@,ATL,0,240,35,81,0.432,26,57,0.456,9,24,0.375,20,26,0.769,99,41,94,0.436,30,57,0.526,11,37,0.297,20,29,0.69,113
1776,PHO,2017-12-26,99,,MEM,1,240,32,72,0.444,24,50,0.48,8,22,0.364,27,35,0.771,99,35,87,0.402,32,67,0.478,3,20,0.15,24,29,0.828,97
1777,GSW,2017-12-25,99,,CLE,1,240,38,82,0.463,28,45,0.622,10,37,0.27,13,17,0.765,99,28,88,0.318,13,52,0.25,15,36,0.417,21,25,0.84,92
1778,SAC,2017-12-23,99,,SAS,0,240,40,86,0.465,28,64,0.438,12,22,0.545,7,11,0.636,99,44,88,0.5,33,65,0.508,11,23,0.478,9,11,0.818,108
1779,BRK,2017-12-20,99,,SAC,0,240,32,82,0.39,17,40,0.425,15,42,0.357,20,23,0.87,99,40,82,0.488,33,63,0.524,7,19,0.368,17,20,0.85,104
1780,UTA,2017-12-18,99,@,HOU,0,240,42,91,0.462,34,64,0.531,8,27,0.296,7,8,0.875,99,40,77,0.519,23,34,0.676,17,43,0.395,23,27,0.852,120
1781,WAS,2017-12-17,99,,CLE,0,240,39,91,0.429,27,58,0.466,12,33,0.364,9,16,0.563,99,41,87,0.471,27,53,0.509,14,34,0.412,10,12,0.833,106
1782,SAC,2017-12-12,99,,PHO,1,240,38,89,0.427,31,67,0.463,7,22,0.318,16,22,0.727,99,37,90,0.411,30,58,0.517,7,32,0.219,11,14,0.786,92
1783,CHO,2017-12-09,99,,LAL,0,240,41,93,0.441,33,68,0.485,8,25,0.32,9,14,0.643,99,43,85,0.506,34,58,0.586,9,27,0.333,15,21,0.714,110
1784,PHO,2017-12-07,99,,WAS,0,240,36,78,0.462,29,55,0.527,7,23,0.304,20,28,0.714,99,41,81,0.506,33,60,0.55,8,21,0.381,19,25,0.76,109
1785,NYK,2017-12-06,99,,MEM,1,240,35,67,0.522,26,53,0.491,9,14,0.643,20,27,0.741,99,29,70,0.414,17,42,0.405,12,28,0.429,18,22,0.818,88
1786,CHI,2017-11-28,99,,PHO,0,240,38,94,0.404,22,54,0.407,16,40,0.4,7,10,0.7,99,38,87,0.437,27,57,0.474,11,30,0.367,17,23,0.739,104
1787,DET,2017-11-24,99,@,OKC,1,240,39,84,0.464,25,47,0.532,14,37,0.378,7,9,0.778,99,42,98,0.429,34,66,0.515,8,32,0.25,6,8,0.75,98
1788,CHO,2017-11-24,99,@,CLE,0,240,36,94,0.383,25,65,0.385,11,29,0.379,16,27,0.593,99,38,83,0.458,25,44,0.568,13,39,0.333,11,15,0.733,100
1789,WAS,2017-11-20,99,@,MIL,1,240,39,74,0.527,30,50,0.6,9,24,0.375,12,17,0.706,99,35,79,0.443,31,57,0.544,4,22,0.182,14,19,0.737,88
1790,ATL,2017-11-18,99,,BOS,0,240,37,78,0.474,28,54,0.519,9,24,0.375,16,20,0.8,99,39,82,0.476,23,48,0.479,16,34,0.471,16,20,0.8,110
1791,POR,2017-11-15,99,,ORL,1,240,38,87,0.437,24,60,0.4,14,27,0.519,9,13,0.692,99,37,79,0.468,26,50,0.52,11,29,0.379,9,9,1.0,94
1792,MIL,2017-11-15,99,,DET,1,240,38,78,0.487,30,56,0.536,8,22,0.364,15,20,0.75,99,30,85,0.353,15,48,0.313,15,37,0.405,20,23,0.87,95
1793,POR,2017-11-13,99,,DEN,1,240,38,73,0.521,31,52,0.596,7,21,0.333,16,18,0.889,99,30,84,0.357,21,52,0.404,9,32,0.281,13,15,0.867,82
1794,DAL,2017-11-12,99,@,OKC,0,240,37,87,0.425,26,50,0.52,11,37,0.297,14,18,0.778,99,36,72,0.5,21,40,0.525,15,32,0.469,25,33,0.758,112
1795,NYK,2017-11-08,99,@,ORL,0,240,42,80,0.525,37,68,0.544,5,12,0.417,10,13,0.769,99,43,80,0.538,30,52,0.577,13,28,0.464,13,22,0.591,112
1796,WAS,2017-11-07,99,,DAL,0,240,32,75,0.427,22,50,0.44,10,25,0.4,25,32,0.781,99,43,91,0.473,32,61,0.525,11,30,0.367,16,20,0.8,113
1797,OKC,2017-11-05,99,@,POR,0,240,40,89,0.449,29,56,0.518,11,33,0.333,8,15,0.533,99,37,74,0.5,30,54,0.556,7,20,0.35,22,28,0.786,103
1798,SAC,2017-11-04,99,@,DET,0,240,40,76,0.526,30,55,0.545,10,21,0.476,9,13,0.692,99,40,79,0.506,27,55,0.491,13,24,0.542,15,22,0.682,108
1799,DAL,2017-11-04,99,@,MIN,0,240,40,87,0.46,30,60,0.5,10,27,0.37,9,12,0.75,99,43,79,0.544,33,55,0.6,10,24,0.417,16,20,0.8,112
1800,NOP,2017-11-03,99,@,DAL,1,240,36,89,0.404,29,60,0.483,7,29,0.241,20,26,0.769,99,34,88,0.386,25,54,0.463,9,34,0.265,17,22,0.773,94
1801,MEM,2017-11-01,99,,ORL,0,240,39,82,0.476,29,52,0.558,10,30,0.333,11,16,0.688,99,38,75,0.507,25,46,0.543,13,29,0.448,12,14,0.857,101
1802,NOP,2017-10-30,99,,ORL,0,240,39,85,0.459,32,57,0.561,7,28,0.25,14,18,0.778,99,43,85,0.506,27,51,0.529,16,34,0.471,13,18,0.722,115
1803,MEM,2017-10-30,99,,CHO,0,240,32,93,0.344,24,58,0.414,8,35,0.229,27,33,0.818,99,37,89,0.416,30,72,0.417,7,17,0.412,23,29,0.793,104
1804,TOR,2017-10-30,99,@,POR,1,240,39,87,0.448,31,63,0.492,8,24,0.333,13,17,0.765,99,31,80,0.388,23,54,0.426,8,26,0.308,15,19,0.789,85
1805,WAS,2017-10-25,99,@,LAL,0,265,39,95,0.411,33,69,0.478,6,26,0.231,15,23,0.652,99,41,92,0.446,34,62,0.548,7,30,0.233,13,16,0.813,102
1806,MIN,2017-10-18,99,@,SAS,0,240,37,85,0.435,29,66,0.439,8,19,0.421,17,23,0.739,99,41,89,0.461,33,68,0.485,8,21,0.381,17,19,0.895,107
1807,BOS,2017-10-17,99,@,CLE,0,240,36,88,0.409,28,56,0.5,8,32,0.25,19,25,0.76,99,38,83,0.458,33,61,0.541,5,22,0.227,21,25,0.84,102
1808,CLE,2018-04-11,98,,NYK,0,240,37,94,0.394,31,70,0.443,6,24,0.25,18,28,0.643,98,43,85,0.506,31,58,0.534,12,27,0.444,12,13,0.923,110
1809,SAS,2018-04-11,98,@,NOP,0,240,37,92,0.402,29,68,0.426,8,24,0.333,16,19,0.842,98,52,88,0.591,47,69,0.681,5,19,0.263,13,19,0.684,122
1810,SAS,2018-04-09,98,,SAC,1,240,34,82,0.415,28,55,0.509,6,27,0.222,24,29,0.828,98,33,81,0.407,25,63,0.397,8,18,0.444,11,17,0.647,85
1811,DET,2018-04-09,98,,TOR,0,240,35,78,0.449,26,48,0.542,9,30,0.3,19,25,0.76,98,46,87,0.529,34,48,0.708,12,39,0.308,4,4,1.0,108
1812,MIA,2018-04-06,98,@,NYK,0,240,35,88,0.398,28,61,0.459,7,27,0.259,21,22,0.955,98,45,89,0.506,27,52,0.519,18,37,0.486,14,21,0.667,122
1813,ATL,2018-04-03,98,@,MIA,0,240,37,88,0.42,24,55,0.436,13,33,0.394,11,15,0.733,98,41,91,0.451,33,58,0.569,8,33,0.242,11,13,0.846,101
1814,MEM,2018-04-01,98,@,POR,0,240,40,88,0.455,31,67,0.463,9,21,0.429,9,12,0.75,98,39,84,0.464,27,46,0.587,12,38,0.316,23,25,0.92,113
1815,CLE,2018-04-01,98,,DAL,1,240,35,85,0.412,24,59,0.407,11,26,0.423,17,23,0.739,98,32,79,0.405,19,42,0.452,13,37,0.351,10,11,0.909,87
1816,MIA,2018-03-27,98,,CLE,1,240,37,78,0.474,28,49,0.571,9,29,0.31,15,20,0.75,98,31,85,0.365,27,59,0.458,4,26,0.154,13,19,0.684,79
1817,MIL,2018-03-27,98,@,LAC,0,240,38,83,0.458,32,60,0.533,6,23,0.261,16,23,0.696,98,40,86,0.465,25,58,0.431,15,28,0.536,10,18,0.556,105
1818,DAL,2018-03-24,98,,CHO,0,240,36,91,0.396,24,50,0.48,12,41,0.293,14,19,0.737,98,35,92,0.38,23,67,0.343,12,25,0.48,20,29,0.69,102
1819,ORL,2018-03-22,98,,PHI,0,240,37,91,0.407,27,58,0.466,10,33,0.303,14,22,0.636,98,42,89,0.472,27,52,0.519,15,37,0.405,19,24,0.792,118
1820,NYK,2018-03-21,98,@,MIA,0,240,39,89,0.438,29,58,0.5,10,31,0.323,10,12,0.833,98,45,81,0.556,30,47,0.638,15,34,0.441,14,19,0.737,119
1821,SAS,2018-03-21,98,,WAS,1,240,39,79,0.494,32,56,0.571,7,23,0.304,13,18,0.722,98,35,83,0.422,27,58,0.466,8,25,0.32,12,16,0.75,90
1822,SAC,2018-03-16,98,@,GSW,1,240,36,83,0.434,22,52,0.423,14,31,0.452,12,17,0.706,98,34,81,0.42,22,55,0.4,12,26,0.462,13,18,0.722,93
1823,SAS,2018-03-15,98,,NOP,1,240,37,99,0.374,30,73,0.411,7,26,0.269,17,19,0.895,98,36,90,0.4,30,74,0.405,6,16,0.375,15,16,0.938,93
1824,PHI,2018-03-13,98,,IND,0,240,35,75,0.467,25,45,0.556,10,30,0.333,18,22,0.818,98,38,95,0.4,33,71,0.465,5,24,0.208,20,25,0.8,101
1825,MEM,2018-03-05,98,@,SAS,0,240,42,80,0.525,34,58,0.586,8,22,0.364,6,9,0.667,98,35,76,0.461,29,54,0.537,6,22,0.273,24,31,0.774,100
1826,IND,2018-03-04,98,@,WAS,1,240,34,77,0.442,26,52,0.5,8,25,0.32,22,24,0.917,98,35,83,0.422,25,56,0.446,10,27,0.37,15,19,0.789,95
1827,CHO,2018-03-04,98,@,TOR,0,240,32,85,0.376,27,64,0.422,5,21,0.238,29,35,0.829,98,35,83,0.422,23,42,0.548,12,41,0.293,21,27,0.778,103
1828,UTA,2018-03-03,98,@,SAC,1,240,34,82,0.415,23,50,0.46,11,32,0.344,19,29,0.655,98,34,89,0.382,25,59,0.424,9,30,0.3,14,17,0.824,91
1829,MEM,2018-02-26,98,@,BOS,0,240,34,78,0.436,29,55,0.527,5,23,0.217,25,32,0.781,98,39,86,0.453,27,49,0.551,12,37,0.324,19,27,0.704,109
1830,DET,2018-02-25,98,@,CHO,0,240,42,85,0.494,38,67,0.567,4,18,0.222,10,14,0.714,98,42,88,0.477,26,53,0.491,16,35,0.457,14,23,0.609,114
1831,DET,2018-02-23,98,,BOS,0,240,37,85,0.435,27,52,0.519,10,33,0.303,14,21,0.667,98,41,85,0.482,24,46,0.522,17,39,0.436,11,18,0.611,110
1832,CHI,2018-02-14,98,,TOR,0,240,39,91,0.429,35,67,0.522,4,24,0.167,16,20,0.8,98,48,92,0.522,34,54,0.63,14,38,0.368,12,15,0.8,122
1833,ATL,2018-02-14,98,@,DET,0,240,38,89,0.427,32,56,0.571,6,33,0.182,16,19,0.842,98,35,83,0.422,22,50,0.44,13,33,0.394,21,25,0.84,104
1834,LAC,2018-02-10,98,@,PHI,0,240,38,88,0.432,30,56,0.536,8,32,0.25,14,23,0.609,98,43,90,0.478,30,57,0.526,13,33,0.394,13,17,0.765,112
1835,ATL,2018-02-08,98,@,ORL,0,240,37,87,0.425,25,57,0.439,12,30,0.4,12,18,0.667,98,36,84,0.429,27,55,0.491,9,29,0.31,19,22,0.864,100
1836,CLE,2018-02-06,98,@,ORL,0,240,36,84,0.429,24,47,0.511,12,37,0.324,14,20,0.7,98,46,88,0.523,40,66,0.606,6,22,0.273,18,27,0.667,116
1837,CHI,2018-02-05,98,@,SAC,0,240,32,80,0.4,18,44,0.409,14,36,0.389,20,24,0.833,98,37,84,0.44,26,52,0.5,11,32,0.344,19,25,0.76,104
1838,ORL,2018-02-03,98,,WAS,0,240,34,77,0.442,24,45,0.533,10,32,0.313,20,22,0.909,98,46,85,0.541,39,59,0.661,7,26,0.269,16,18,0.889,115
1839,SAC,2018-01-28,98,@,SAS,0,240,35,82,0.427,17,48,0.354,18,34,0.529,10,11,0.909,98,45,90,0.5,34,65,0.523,11,25,0.44,12,17,0.706,113
1840,UTA,2018-01-24,98,@,DET,1,265,38,96,0.396,28,65,0.431,10,31,0.323,12,16,0.75,98,38,97,0.392,31,66,0.47,7,31,0.226,12,18,0.667,95
1841,DAL,2018-01-22,98,,WAS,1,240,38,87,0.437,28,56,0.5,10,31,0.323,12,17,0.706,98,26,86,0.302,19,54,0.352,7,32,0.219,16,27,0.593,75
1842,MIN,2018-01-18,98,@,HOU,0,240,38,81,0.469,30,57,0.526,8,24,0.333,14,21,0.667,98,42,88,0.477,25,49,0.51,17,39,0.436,15,17,0.882,116
1843,NOP,2018-01-06,98,@,MIN,0,240,33,78,0.423,27,49,0.551,6,29,0.207,26,28,0.929,98,44,90,0.489,35,72,0.486,9,18,0.5,19,21,0.905,116
1844,DEN,2018-01-06,98,@,SAC,0,240,35,76,0.461,22,42,0.524,13,34,0.382,15,21,0.714,98,42,94,0.447,33,69,0.478,9,25,0.36,13,17,0.765,106
1845,BRK,2018-01-03,98,,MIN,1,240,37,72,0.514,23,42,0.548,14,30,0.467,10,11,0.909,98,36,80,0.45,35,69,0.507,1,11,0.091,24,30,0.8,97
1846,UTA,2018-01-03,98,,NOP,0,240,38,84,0.452,31,52,0.596,7,32,0.219,15,17,0.882,98,41,82,0.5,27,52,0.519,14,30,0.467,12,12,1.0,108
1847,ORL,2018-01-03,98,,HOU,0,240,35,91,0.385,29,60,0.483,6,31,0.194,22,25,0.88,98,42,89,0.472,27,55,0.491,15,34,0.441,17,21,0.81,116
1848,BRK,2018-01-01,98,,ORL,1,240,36,82,0.439,27,57,0.474,9,25,0.36,17,23,0.739,98,35,96,0.365,29,65,0.446,6,31,0.194,19,25,0.76,95
1849,CHO,2017-12-31,98,@,LAC,0,240,36,93,0.387,25,60,0.417,11,33,0.333,15,19,0.789,98,36,76,0.474,26,48,0.542,10,28,0.357,24,27,0.889,106
1850,ATL,2017-12-29,98,@,TOR,0,240,38,88,0.432,29,64,0.453,9,24,0.375,13,20,0.65,98,46,105,0.438,33,68,0.485,13,37,0.351,6,8,0.75,111
1851,HOU,2017-12-28,98,@,BOS,0,240,30,80,0.375,16,37,0.432,14,43,0.326,24,31,0.774,98,37,82,0.451,29,53,0.547,8,29,0.276,17,24,0.708,99
1852,DAL,2017-12-27,98,@,IND,1,240,40,78,0.513,32,49,0.653,8,29,0.276,10,15,0.667,98,38,79,0.481,28,54,0.519,10,25,0.4,8,10,0.8,94
1853,DAL,2017-12-26,98,,TOR,1,240,40,94,0.426,34,70,0.486,6,24,0.25,12,16,0.75,98,30,89,0.337,21,58,0.362,9,31,0.29,24,32,0.75,93
1854,NYK,2017-12-25,98,,PHI,0,240,38,94,0.404,34,79,0.43,4,15,0.267,18,28,0.643,98,35,82,0.427,25,54,0.463,10,28,0.357,25,30,0.833,105
1855,SAS,2017-12-16,98,,DAL,1,240,39,86,0.453,34,61,0.557,5,25,0.2,15,18,0.833,98,39,80,0.488,29,52,0.558,10,28,0.357,8,9,0.889,96
1856,CHO,2017-12-15,98,,MIA,0,240,34,83,0.41,24,56,0.429,10,27,0.37,20,27,0.741,98,39,78,0.5,28,47,0.596,11,31,0.355,15,17,0.882,104
1857,IND,2017-12-15,98,,DET,0,240,35,87,0.402,26,57,0.456,9,30,0.3,19,25,0.76,98,39,93,0.419,26,61,0.426,13,32,0.406,13,17,0.765,104
1858,WAS,2017-12-12,98,@,BRK,0,240,38,95,0.4,34,73,0.466,4,22,0.182,18,22,0.818,98,34,84,0.405,24,41,0.585,10,43,0.233,25,33,0.758,103
1859,PHI,2017-12-09,98,@,CLE,0,240,37,78,0.474,26,45,0.578,11,33,0.333,13,13,1.0,98,36,75,0.48,22,46,0.478,14,29,0.483,19,25,0.76,105
1860,DET,2017-12-08,98,,GSW,0,240,38,92,0.413,26,65,0.4,12,27,0.444,10,19,0.526,98,39,81,0.481,32,55,0.582,7,26,0.269,17,22,0.773,102
1861,IND,2017-12-06,98,,CHI,1,240,39,87,0.448,27,53,0.509,12,34,0.353,8,10,0.8,98,39,83,0.47,29,57,0.509,10,26,0.385,8,16,0.5,96
1862,BRK,2017-11-26,98,@,MEM,1,240,33,74,0.446,20,45,0.444,13,29,0.448,19,23,0.826,98,32,80,0.4,24,55,0.436,8,25,0.32,16,18,0.889,88
1863,IND,2017-11-25,98,,BOS,0,240,38,78,0.487,31,55,0.564,7,23,0.304,15,15,1.0,98,45,80,0.563,35,55,0.636,10,25,0.4,8,9,0.889,108
1864,OKC,2017-11-24,98,,DET,0,240,42,98,0.429,34,66,0.515,8,32,0.25,6,8,0.75,98,39,84,0.464,25,47,0.532,14,37,0.378,7,9,0.778,99
1865,BOS,2017-11-22,98,@,MIA,0,240,35,84,0.417,26,58,0.448,9,26,0.346,19,27,0.704,98,40,81,0.494,30,53,0.566,10,28,0.357,14,16,0.875,104
1866,SAC,2017-11-20,98,,DEN,0,240,41,86,0.477,33,66,0.5,8,20,0.4,8,9,0.889,98,42,86,0.488,27,54,0.5,15,32,0.469,15,20,0.75,114
1867,MIN,2017-11-15,98,,SAS,1,240,39,87,0.448,30,69,0.435,9,18,0.5,11,16,0.688,98,33,79,0.418,26,55,0.473,7,24,0.292,13,15,0.867,86
1868,UTA,2017-11-13,98,,MIN,0,240,37,84,0.44,23,44,0.523,14,40,0.35,10,11,0.909,98,37,71,0.521,27,51,0.529,10,20,0.5,25,29,0.862,109
1869,MIL,2017-11-11,98,,LAL,1,240,35,85,0.412,29,62,0.468,6,23,0.261,22,26,0.846,98,31,74,0.419,25,52,0.481,6,22,0.273,22,37,0.595,90
1870,MEM,2017-11-07,98,@,POR,1,240,35,73,0.479,28,54,0.519,7,19,0.368,21,25,0.84,98,36,81,0.444,30,62,0.484,6,19,0.316,19,20,0.95,97
1871,BRK,2017-11-06,98,@,PHO,1,240,35,87,0.402,27,55,0.491,8,32,0.25,20,29,0.69,98,30,86,0.349,24,61,0.393,6,25,0.24,26,35,0.743,92
1872,NOP,2017-11-01,98,,MIN,0,240,36,84,0.429,28,53,0.528,8,31,0.258,18,21,0.857,98,41,83,0.494,35,61,0.574,6,22,0.273,16,24,0.667,104
1873,DAL,2017-11-01,98,@,LAC,0,240,35,89,0.393,23,53,0.434,12,36,0.333,16,20,0.8,98,41,78,0.526,28,50,0.56,13,28,0.464,24,29,0.828,119
1874,MEM,2017-10-23,98,@,HOU,1,240,29,68,0.426,23,49,0.469,6,19,0.316,34,37,0.919,98,32,77,0.416,23,39,0.59,9,38,0.237,17,23,0.739,90
1875,BRK,2018-04-11,97,@,BOS,0,240,37,91,0.407,26,51,0.51,11,40,0.275,12,16,0.75,97,46,102,0.451,40,78,0.513,6,24,0.25,12,15,0.8,110
1876,DAL,2018-04-10,97,,PHO,0,240,37,97,0.381,29,64,0.453,8,33,0.242,15,22,0.682,97,48,76,0.632,35,50,0.7,13,26,0.5,15,21,0.714,124
1877,LAL,2018-04-08,97,,UTA,0,240,37,93,0.398,32,68,0.471,5,25,0.2,18,22,0.818,97,42,83,0.506,29,47,0.617,13,36,0.361,15,22,0.682,112
1878,DAL,2018-04-08,97,@,PHI,0,240,40,94,0.426,29,54,0.537,11,40,0.275,6,13,0.462,97,46,91,0.505,38,64,0.594,8,27,0.296,9,14,0.643,109
1879,WAS,2018-04-06,97,,ATL,0,240,35,87,0.402,26,62,0.419,9,25,0.36,18,23,0.783,97,38,79,0.481,27,46,0.587,11,33,0.333,16,23,0.696,103
1880,PHO,2018-04-03,97,,SAC,1,240,35,77,0.455,29,60,0.483,6,17,0.353,21,33,0.636,97,33,89,0.371,22,62,0.355,11,27,0.407,17,23,0.739,94
1881,ORL,2018-04-03,97,@,NYK,1,240,37,88,0.42,26,52,0.5,11,36,0.306,12,18,0.667,97,30,86,0.349,26,59,0.441,4,27,0.148,9,12,0.75,73
1882,MIN,2018-04-01,97,,UTA,0,240,38,90,0.422,30,66,0.455,8,24,0.333,13,14,0.929,97,46,76,0.605,35,48,0.729,11,28,0.393,18,25,0.72,121
1883,MEM,2018-03-30,97,@,UTA,0,240,39,81,0.481,30,58,0.517,9,23,0.391,10,15,0.667,97,40,74,0.541,28,43,0.651,12,31,0.387,15,26,0.577,107
1884,BOS,2018-03-28,97,@,UTA,1,240,35,79,0.443,23,58,0.397,12,21,0.571,15,20,0.75,97,34,82,0.415,25,49,0.51,9,33,0.273,17,21,0.81,94
1885,SAC,2018-03-27,97,,DAL,0,240,38,93,0.409,32,70,0.457,6,23,0.261,15,19,0.789,97,36,80,0.45,22,40,0.55,14,40,0.35,17,25,0.68,103
1886,WAS,2018-03-25,97,,NYK,0,240,37,87,0.425,31,68,0.456,6,19,0.316,17,23,0.739,97,41,88,0.466,35,66,0.53,6,22,0.273,13,15,0.867,101
1887,SAC,2018-03-17,97,@,UTA,0,240,37,86,0.43,23,65,0.354,14,21,0.667,9,14,0.643,97,33,74,0.446,27,50,0.54,6,24,0.25,31,38,0.816,103
1888,NYK,2018-03-13,97,,DAL,0,240,40,82,0.488,32,57,0.561,8,25,0.32,9,12,0.75,97,40,89,0.449,26,54,0.481,14,35,0.4,16,18,0.889,110
1889,BRK,2018-03-11,97,,PHI,0,240,33,85,0.388,23,57,0.404,10,28,0.357,21,24,0.875,97,50,95,0.526,41,69,0.594,9,26,0.346,11,18,0.611,120
1890,BOS,2018-03-11,97,,IND,0,240,34,81,0.42,22,44,0.5,12,37,0.324,17,21,0.81,97,39,81,0.481,27,59,0.458,12,22,0.545,9,10,0.9,99
1891,NOP,2018-03-09,97,,WAS,0,240,38,82,0.463,32,62,0.516,6,20,0.3,15,18,0.833,97,46,96,0.479,37,70,0.529,9,26,0.346,15,20,0.75,116
1892,CLE,2018-03-01,97,,PHI,0,240,36,87,0.414,27,55,0.491,9,32,0.281,16,23,0.696,97,40,90,0.444,30,60,0.5,10,30,0.333,18,27,0.667,108
1893,UTA,2018-02-24,97,,DAL,1,240,34,85,0.4,25,53,0.472,9,32,0.281,20,26,0.769,97,34,83,0.41,24,48,0.5,10,35,0.286,12,14,0.857,90
1894,PHO,2018-02-14,97,@,UTA,0,240,34,79,0.43,22,50,0.44,12,29,0.414,17,24,0.708,97,39,92,0.424,29,58,0.5,10,34,0.294,19,22,0.864,107
1895,MIL,2018-02-13,97,,ATL,1,240,38,88,0.432,30,63,0.476,8,25,0.32,13,17,0.765,97,33,86,0.384,21,51,0.412,12,35,0.343,14,20,0.7,92
1896,DAL,2018-02-11,97,@,HOU,0,240,38,93,0.409,28,62,0.452,10,31,0.323,11,16,0.688,97,34,78,0.436,21,33,0.636,13,45,0.289,23,33,0.697,104
1897,IND,2018-02-09,97,@,BOS,1,240,37,83,0.446,32,63,0.508,5,20,0.25,18,22,0.818,97,34,89,0.382,27,62,0.435,7,27,0.259,16,20,0.8,91
1898,BOS,2018-02-04,97,,POR,1,240,35,85,0.412,20,49,0.408,15,36,0.417,12,17,0.706,97,36,91,0.396,23,60,0.383,13,31,0.419,11,14,0.786,96
1899,PHO,2018-02-02,97,,UTA,0,240,36,87,0.414,27,54,0.5,9,33,0.273,16,19,0.842,97,51,90,0.567,36,61,0.59,15,29,0.517,12,17,0.706,129
1900,MIA,2018-02-02,97,@,PHI,0,240,34,87,0.391,22,50,0.44,12,37,0.324,17,26,0.654,97,42,85,0.494,34,61,0.557,8,24,0.333,11,15,0.733,103
1901,BRK,2018-01-27,97,@,MIN,0,240,38,82,0.463,29,52,0.558,9,30,0.3,12,15,0.8,97,42,96,0.438,38,75,0.507,4,21,0.19,23,26,0.885,111
1902,PHI,2018-01-26,97,@,SAS,1,240,38,79,0.481,29,58,0.5,9,21,0.429,12,18,0.667,97,30,75,0.4,27,51,0.529,3,24,0.125,15,18,0.833,78
1903,UTA,2018-01-26,97,@,TOR,1,240,36,87,0.414,26,66,0.394,10,21,0.476,15,21,0.714,97,37,95,0.389,30,68,0.441,7,27,0.259,12,17,0.706,93
1904,DAL,2018-01-24,97,,HOU,0,240,35,82,0.427,20,47,0.426,15,35,0.429,12,18,0.667,97,36,82,0.439,15,31,0.484,21,51,0.412,11,23,0.478,104
1905,ATL,2018-01-20,97,,CHI,0,240,35,92,0.38,24,44,0.545,11,48,0.229,16,23,0.696,97,40,80,0.5,26,48,0.542,14,32,0.438,19,21,0.905,113
1906,MIA,2018-01-14,97,,MIL,1,240,35,76,0.461,24,47,0.511,11,29,0.379,16,20,0.8,97,25,79,0.316,21,51,0.412,4,28,0.143,25,27,0.926,79
1907,PHO,2018-01-14,97,,IND,0,240,35,85,0.412,26,48,0.542,9,37,0.243,18,24,0.75,97,48,88,0.545,37,65,0.569,11,23,0.478,13,14,0.929,120
1908,IND,2018-01-12,97,,CLE,1,240,39,85,0.459,29,64,0.453,10,21,0.476,9,12,0.75,97,37,85,0.435,30,51,0.588,7,34,0.206,14,19,0.737,95
1909,DEN,2018-01-10,97,,ATL,0,240,38,95,0.4,29,58,0.5,9,37,0.243,12,20,0.6,97,40,80,0.5,28,53,0.528,12,27,0.444,18,18,1.0,110
1910,MIN,2018-01-03,97,@,BRK,0,240,36,80,0.45,35,69,0.507,1,11,0.091,24,30,0.8,97,37,72,0.514,23,42,0.548,14,30,0.467,10,11,0.909,98
1911,MIL,2017-12-29,97,@,OKC,1,240,40,85,0.471,31,56,0.554,9,29,0.31,8,17,0.471,97,38,83,0.458,31,58,0.534,7,25,0.28,12,20,0.6,95
1912,BRK,2017-12-26,97,@,SAS,0,240,39,93,0.419,27,61,0.443,12,32,0.375,7,9,0.778,97,41,80,0.513,34,64,0.531,7,16,0.438,20,24,0.833,109
1913,MEM,2017-12-26,97,@,PHO,0,240,35,87,0.402,32,67,0.478,3,20,0.15,24,29,0.828,97,32,72,0.444,24,50,0.48,8,22,0.364,27,35,0.771,99
1914,ORL,2017-12-22,97,,NOP,0,240,36,85,0.424,32,65,0.492,4,20,0.2,21,29,0.724,97,43,86,0.5,33,56,0.589,10,30,0.333,15,24,0.625,111
1915,PHO,2017-12-21,97,,MEM,1,240,33,81,0.407,23,55,0.418,10,26,0.385,21,27,0.778,97,39,90,0.433,34,64,0.531,5,26,0.192,12,16,0.75,95
1916,GSW,2017-12-20,97,,MEM,1,240,34,74,0.459,27,53,0.509,7,21,0.333,22,25,0.88,97,28,84,0.333,16,53,0.302,12,31,0.387,16,19,0.842,84
1917,PHO,2017-12-18,97,@,DAL,1,240,35,79,0.443,25,54,0.463,10,25,0.4,17,22,0.773,97,32,88,0.364,21,51,0.412,11,37,0.297,16,17,0.941,91
1918,BRK,2017-12-17,97,,IND,0,240,34,81,0.42,22,48,0.458,12,33,0.364,17,21,0.81,97,43,76,0.566,35,58,0.603,8,18,0.444,15,19,0.789,109
1919,DAL,2017-12-14,97,@,GSW,0,240,37,82,0.451,27,53,0.509,10,29,0.345,13,17,0.765,97,47,78,0.603,36,56,0.643,11,22,0.5,7,9,0.778,112
1920,MIN,2017-12-10,97,,DAL,1,240,36,72,0.5,29,53,0.547,7,19,0.368,18,23,0.783,97,37,81,0.457,26,50,0.52,11,31,0.355,7,9,0.778,92
1921,BOS,2017-12-06,97,,DAL,1,240,36,87,0.414,24,53,0.453,12,34,0.353,13,17,0.765,97,34,86,0.395,25,58,0.431,9,28,0.321,13,17,0.765,90
1922,NYK,2017-12-04,97,@,IND,0,240,40,91,0.44,34,68,0.5,6,23,0.261,11,16,0.688,97,46,86,0.535,35,60,0.583,11,26,0.423,12,15,0.8,115
1923,PHI,2017-11-30,97,@,BOS,0,240,35,84,0.417,19,52,0.365,16,32,0.5,11,18,0.611,97,40,79,0.506,28,50,0.56,12,29,0.414,16,20,0.8,108
1924,IND,2017-11-29,97,@,HOU,0,240,42,88,0.477,35,60,0.583,7,28,0.25,6,6,1.0,97,42,86,0.488,24,46,0.522,18,40,0.45,16,21,0.762,118
1925,MIA,2017-11-28,97,@,CLE,0,240,37,84,0.44,27,53,0.509,10,31,0.323,13,20,0.65,97,40,81,0.494,29,48,0.604,11,33,0.333,17,23,0.739,108
1926,LAC,2017-11-25,97,@,SAC,1,240,38,80,0.475,29,52,0.558,9,28,0.321,12,13,0.923,97,38,83,0.458,27,62,0.435,11,21,0.524,8,9,0.889,95
1927,DAL,2017-11-25,97,,OKC,1,240,37,75,0.493,22,40,0.55,15,35,0.429,8,11,0.727,97,29,80,0.363,16,45,0.356,13,35,0.371,10,13,0.769,81
1928,MIN,2017-11-24,97,,MIA,0,240,37,84,0.44,30,67,0.448,7,17,0.412,16,26,0.615,97,38,80,0.475,19,41,0.463,19,39,0.487,14,16,0.875,109
1929,ORL,2017-11-20,97,,IND,0,240,35,84,0.417,22,46,0.478,13,38,0.342,14,23,0.609,97,37,89,0.416,29,69,0.42,8,20,0.4,23,29,0.793,105
1930,MIN,2017-11-19,97,,DET,0,240,40,78,0.513,35,56,0.625,5,22,0.227,12,18,0.667,97,39,83,0.47,31,58,0.534,8,25,0.32,14,20,0.7,100
1931,SAS,2017-11-14,97,@,DAL,1,240,35,79,0.443,29,53,0.547,6,26,0.231,21,27,0.778,97,33,81,0.407,23,47,0.489,10,34,0.294,15,18,0.833,91
1932,POR,2017-11-10,97,,BRK,0,240,40,95,0.421,32,72,0.444,8,23,0.348,9,11,0.818,97,39,91,0.429,27,53,0.509,12,38,0.316,11,19,0.579,101
1933,IND,2017-11-08,97,@,DET,0,240,38,88,0.432,31,64,0.484,7,24,0.292,14,18,0.778,97,43,83,0.518,31,56,0.554,12,27,0.444,16,25,0.64,114
1934,UTA,2017-11-07,97,,PHI,0,240,30,99,0.303,21,60,0.35,9,39,0.231,28,35,0.8,97,34,81,0.42,22,54,0.407,12,27,0.444,24,30,0.8,104
1935,POR,2017-11-07,97,,MEM,0,240,36,81,0.444,30,62,0.484,6,19,0.316,19,20,0.95,97,35,73,0.479,28,54,0.519,7,19,0.368,21,25,0.84,98
1936,GSW,2017-11-06,97,,MIA,1,240,32,87,0.368,21,55,0.382,11,32,0.344,22,24,0.917,97,30,83,0.361,22,57,0.386,8,26,0.308,12,17,0.706,80
1937,MIA,2017-11-01,97,,CHI,1,240,34,83,0.41,22,52,0.423,12,31,0.387,17,19,0.895,97,36,89,0.404,29,61,0.475,7,28,0.25,12,19,0.632,91
1938,NYK,2017-11-01,97,,HOU,0,240,39,90,0.433,31,64,0.484,8,26,0.308,11,13,0.846,97,42,88,0.477,23,36,0.639,19,52,0.365,16,21,0.762,119
1939,IND,2017-10-29,97,,SAS,1,240,36,77,0.468,26,55,0.473,10,22,0.455,15,20,0.75,97,36,90,0.4,27,62,0.435,9,28,0.321,13,18,0.722,94
1940,PHO,2017-10-25,97,,UTA,1,240,42,96,0.438,36,77,0.468,6,19,0.316,7,9,0.778,97,32,77,0.416,26,52,0.5,6,25,0.24,18,25,0.72,88
1941,PHI,2017-10-23,97,@,DET,1,240,35,75,0.467,26,51,0.51,9,24,0.375,18,24,0.75,97,33,85,0.388,27,55,0.491,6,30,0.2,14,19,0.737,86
1942,TOR,2017-10-23,97,@,SAS,0,240,34,80,0.425,24,43,0.558,10,37,0.27,19,24,0.792,97,40,90,0.444,35,70,0.5,5,20,0.25,16,23,0.696,101
1943,UTA,2017-10-20,97,@,MIN,0,240,37,77,0.481,28,55,0.509,9,22,0.409,14,17,0.824,97,36,81,0.444,29,59,0.492,7,22,0.318,21,26,0.808,100
1944,MIL,2017-10-20,97,,CLE,0,240,38,82,0.463,27,47,0.574,11,35,0.314,10,12,0.833,97,44,81,0.543,33,55,0.6,11,26,0.423,17,17,1.0,116
1945,SAC,2018-04-11,96,,HOU,1,240,38,80,0.475,31,54,0.574,7,26,0.269,13,20,0.65,96,31,82,0.378,18,36,0.5,13,46,0.283,8,12,0.667,83
1946,CHI,2018-04-07,96,,BRK,0,240,36,88,0.409,30,59,0.508,6,29,0.207,18,21,0.857,96,46,92,0.5,22,37,0.595,24,55,0.436,8,11,0.727,124
1947,LAL,2018-04-06,96,,MIN,0,240,31,79,0.392,23,55,0.418,8,24,0.333,26,32,0.813,96,43,100,0.43,35,74,0.473,8,26,0.308,19,26,0.731,113
1948,HOU,2018-04-05,96,,POR,1,240,34,73,0.466,21,36,0.583,13,37,0.351,15,24,0.625,96,39,85,0.459,32,63,0.508,7,22,0.318,9,14,0.643,94
1949,MIN,2018-04-05,96,@,DEN,0,240,39,91,0.429,33,67,0.493,6,24,0.25,12,16,0.75,96,35,89,0.393,24,53,0.453,11,36,0.306,19,22,0.864,100
1950,TOR,2018-04-04,96,,BOS,1,240,40,92,0.435,30,59,0.508,10,33,0.303,6,8,0.75,96,25,75,0.333,22,53,0.415,3,22,0.136,25,28,0.893,78
1951,BRK,2018-04-01,96,,DET,0,240,37,87,0.425,25,44,0.568,12,43,0.279,10,15,0.667,96,38,84,0.452,31,65,0.477,7,19,0.368,25,32,0.781,108
1952,SAC,2018-03-31,96,,GSW,0,240,36,87,0.414,28,59,0.475,8,28,0.286,16,19,0.842,96,41,83,0.494,32,57,0.561,9,26,0.346,21,28,0.75,112
1953,LAC,2018-03-30,96,@,POR,0,240,36,89,0.404,32,76,0.421,4,13,0.308,20,35,0.571,96,41,95,0.432,33,65,0.508,8,30,0.267,15,16,0.938,105
1954,DET,2018-03-22,96,@,HOU,0,265,40,95,0.421,34,57,0.596,6,38,0.158,10,19,0.526,96,35,99,0.354,23,48,0.479,12,51,0.235,18,28,0.643,100
1955,NOP,2018-03-21,96,,IND,1,240,34,79,0.43,26,56,0.464,8,23,0.348,20,24,0.833,96,34,93,0.366,27,71,0.38,7,22,0.318,17,18,0.944,92
1956,LAC,2018-03-15,96,@,HOU,0,240,44,97,0.454,40,79,0.506,4,18,0.222,4,8,0.5,96,35,90,0.389,23,49,0.469,12,41,0.293,19,23,0.826,101
1957,DET,2018-03-03,96,@,MIA,0,240,37,89,0.416,30,65,0.462,7,24,0.292,15,21,0.714,96,37,82,0.451,25,53,0.472,12,29,0.414,19,28,0.679,105
1958,MIL,2018-03-02,96,,IND,0,240,31,81,0.383,22,56,0.393,9,25,0.36,25,32,0.781,96,37,83,0.446,31,67,0.463,6,16,0.375,23,30,0.767,103
1959,HOU,2018-02-26,96,@,UTA,1,240,34,79,0.43,25,46,0.543,9,33,0.273,19,25,0.76,96,31,71,0.437,24,42,0.571,7,29,0.241,16,22,0.727,85
1960,BRK,2018-02-22,96,@,CHO,0,240,36,93,0.387,22,50,0.44,14,43,0.326,10,14,0.714,96,42,87,0.483,31,66,0.47,11,21,0.524,16,20,0.8,111
1961,POR,2018-02-11,96,,UTA,0,240,33,81,0.407,24,56,0.429,9,25,0.36,21,25,0.84,96,41,88,0.466,28,62,0.452,13,26,0.5,20,22,0.909,115
1962,POR,2018-02-04,96,@,BOS,0,240,36,91,0.396,23,60,0.383,13,31,0.419,11,14,0.786,96,35,85,0.412,20,49,0.408,15,36,0.417,12,17,0.706,97
1963,NYK,2018-02-04,96,,ATL,0,240,41,94,0.436,36,71,0.507,5,23,0.217,9,15,0.6,96,35,87,0.402,20,54,0.37,15,33,0.455,14,19,0.737,99
1964,LAC,2018-01-30,96,,POR,0,240,35,85,0.412,29,63,0.46,6,22,0.273,20,26,0.769,96,36,98,0.367,23,68,0.338,13,30,0.433,19,22,0.864,104
1965,OKC,2018-01-30,96,@,WAS,0,240,30,80,0.375,21,48,0.438,9,32,0.281,27,34,0.794,96,34,89,0.382,27,64,0.422,7,25,0.28,27,29,0.931,102
1966,CHO,2018-01-29,96,@,IND,0,240,37,83,0.446,28,52,0.538,9,31,0.29,13,20,0.65,96,45,83,0.542,39,62,0.629,6,21,0.286,9,11,0.818,105
1967,CHI,2018-01-28,96,,MIL,0,240,36,87,0.414,24,53,0.453,12,34,0.353,12,15,0.8,96,41,77,0.532,28,49,0.571,13,28,0.464,15,25,0.6,110
1968,CHO,2018-01-24,96,,NOP,0,240,36,85,0.424,30,64,0.469,6,21,0.286,18,31,0.581,96,39,87,0.448,30,61,0.492,9,26,0.346,14,18,0.778,101
1969,TOR,2018-01-17,96,,DET,1,240,34,80,0.425,23,49,0.469,11,31,0.355,17,23,0.739,96,37,88,0.42,27,60,0.45,10,28,0.357,7,15,0.467,91
1970,MIL,2018-01-08,96,@,IND,0,240,34,74,0.459,27,47,0.574,7,27,0.259,21,27,0.778,96,44,79,0.557,37,57,0.649,7,22,0.318,14,20,0.7,109
1971,DAL,2018-01-07,96,,NYK,0,240,35,92,0.38,29,68,0.426,6,24,0.25,20,24,0.833,96,38,83,0.458,32,67,0.478,6,16,0.375,18,20,0.9,100
1972,LAL,2018-01-03,96,,OKC,0,240,38,92,0.413,27,59,0.458,11,33,0.333,9,15,0.6,96,56,93,0.602,42,63,0.667,14,30,0.467,7,9,0.778,133
1973,LAL,2018-01-01,96,@,MIN,0,240,34,76,0.447,26,50,0.52,8,26,0.308,20,29,0.69,96,40,81,0.494,33,61,0.541,7,20,0.35,27,30,0.9,114
1974,SAC,2017-12-31,96,,MEM,0,240,37,86,0.43,28,62,0.452,9,24,0.375,13,25,0.52,96,41,76,0.539,27,46,0.587,14,30,0.467,18,24,0.75,114
1975,MIN,2017-12-28,96,@,MIL,0,240,34,71,0.479,25,43,0.581,9,28,0.321,19,26,0.731,96,41,75,0.547,36,60,0.6,5,15,0.333,15,16,0.938,102
1976,DEN,2017-12-23,96,@,GSW,1,240,38,82,0.463,31,54,0.574,7,28,0.25,13,15,0.867,96,32,84,0.381,29,57,0.509,3,27,0.111,14,17,0.824,81
1977,OKC,2017-12-16,96,@,NYK,0,240,36,85,0.424,24,58,0.414,12,27,0.444,12,20,0.6,96,38,69,0.551,24,46,0.522,14,23,0.609,21,26,0.808,111
1978,DAL,2017-12-16,96,@,SAS,0,240,39,80,0.488,29,52,0.558,10,28,0.357,8,9,0.889,96,39,86,0.453,34,61,0.557,5,25,0.2,15,18,0.833,98
1979,MEM,2017-12-15,96,,ATL,1,240,36,78,0.462,24,53,0.453,12,25,0.48,12,17,0.706,96,34,77,0.442,22,46,0.478,12,31,0.387,14,16,0.875,94
1980,SAC,2017-12-14,96,@,MIN,0,240,36,87,0.414,22,54,0.407,14,33,0.424,10,12,0.833,96,46,82,0.561,36,61,0.59,10,21,0.476,17,20,0.85,119
1981,CHO,2017-12-13,96,@,HOU,0,240,36,87,0.414,32,66,0.485,4,21,0.19,20,27,0.741,96,39,88,0.443,22,43,0.512,17,45,0.378,13,19,0.684,108
1982,LAC,2017-12-11,96,,TOR,1,240,34,92,0.37,26,56,0.464,8,36,0.222,20,24,0.833,96,32,80,0.4,25,51,0.49,7,29,0.241,20,26,0.769,91
1983,CHI,2017-12-06,96,@,IND,0,240,39,83,0.47,29,57,0.509,10,26,0.385,8,16,0.5,96,39,87,0.448,27,53,0.509,12,34,0.353,8,10,0.8,98
1984,SAS,2017-12-04,96,,DET,1,240,35,82,0.427,21,51,0.412,14,31,0.452,12,12,1.0,96,35,85,0.412,27,58,0.466,8,27,0.296,15,24,0.625,93
1985,SAS,2017-11-20,96,,ATL,1,240,40,89,0.449,30,58,0.517,10,31,0.323,6,6,1.0,96,37,85,0.435,29,55,0.527,8,30,0.267,3,8,0.375,85
1986,MEM,2017-11-11,96,@,HOU,0,240,38,79,0.481,32,59,0.542,6,20,0.3,14,18,0.778,96,37,83,0.446,21,38,0.553,16,45,0.356,21,28,0.75,111
1987,LAL,2017-11-08,96,@,BOS,0,240,37,85,0.435,32,61,0.525,5,24,0.208,17,23,0.739,96,38,98,0.388,31,69,0.449,7,29,0.241,24,31,0.774,107
1988,TOR,2017-11-05,96,,WAS,0,240,37,80,0.463,32,56,0.571,5,24,0.208,17,27,0.63,96,40,85,0.471,29,62,0.468,11,23,0.478,16,23,0.696,107
1989,NOP,2017-11-04,96,@,CHI,1,265,35,87,0.402,26,56,0.464,9,31,0.29,17,22,0.773,96,35,99,0.354,24,57,0.421,11,42,0.262,9,12,0.75,90
1990,MIL,2017-11-03,96,@,DET,0,240,39,83,0.47,29,58,0.5,10,25,0.4,8,9,0.889,96,37,78,0.474,29,52,0.558,8,26,0.308,23,28,0.821,105
1991,BOS,2017-10-28,96,@,MIA,1,240,34,81,0.42,28,58,0.483,6,23,0.261,22,26,0.846,96,34,79,0.43,27,48,0.563,7,31,0.226,15,16,0.938,90
1992,UTA,2017-10-28,96,,LAL,1,240,37,79,0.468,24,48,0.5,13,31,0.419,9,13,0.692,96,31,81,0.383,26,59,0.441,5,22,0.227,14,20,0.7,81
1993,MEM,2017-10-26,96,,DAL,1,240,30,73,0.411,20,39,0.513,10,34,0.294,26,30,0.867,96,32,94,0.34,22,60,0.367,10,34,0.294,17,20,0.85,91
1994,BOS,2017-10-26,96,@,MIL,1,240,33,78,0.423,22,48,0.458,11,30,0.367,19,22,0.864,96,35,77,0.455,24,52,0.462,11,25,0.44,8,14,0.571,89
1995,IND,2017-10-25,96,@,OKC,0,240,28,83,0.337,18,54,0.333,10,29,0.345,30,35,0.857,96,43,89,0.483,33,62,0.532,10,27,0.37,18,26,0.692,114
1996,UTA,2017-10-21,96,,OKC,1,240,38,77,0.494,29,48,0.604,9,29,0.31,11,14,0.786,96,32,78,0.41,21,45,0.467,11,33,0.333,12,19,0.632,87
1997,DEN,2017-10-21,96,,SAC,1,240,37,85,0.435,27,55,0.491,10,30,0.333,12,20,0.6,96,31,85,0.365,23,63,0.365,8,22,0.364,9,13,0.692,79
1998,IND,2017-10-20,96,,POR,0,240,35,78,0.449,31,60,0.517,4,18,0.222,22,33,0.667,96,46,95,0.484,37,76,0.487,9,19,0.474,13,17,0.765,114
1999,DEN,2017-10-18,96,@,UTA,0,240,36,77,0.468,23,50,0.46,13,27,0.481,11,12,0.917,96,41,81,0.506,32,57,0.561,9,24,0.375,15,16,0.938,106
2000,MIL,2018-04-11,95,@,PHI,0,240,37,90,0.411,30,65,0.462,7,25,0.28,14,16,0.875,95,52,105,0.495,37,69,0.536,15,36,0.417,11,15,0.733,130
2001,LAC,2018-04-05,95,@,UTA,0,240,35,79,0.443,32,62,0.516,3,17,0.176,22,28,0.786,95,44,83,0.53,34,56,0.607,10,27,0.37,19,28,0.679,117
2002,MEM,2018-04-04,95,@,NOP,0,240,37,93,0.398,27,61,0.443,10,32,0.313,11,15,0.733,95,45,86,0.523,29,50,0.58,16,36,0.444,17,19,0.895,123
2003,BRK,2018-04-03,95,@,PHI,0,240,34,81,0.42,17,39,0.436,17,42,0.405,10,23,0.435,95,50,91,0.549,41,70,0.586,9,21,0.429,12,18,0.667,121
2004,CHI,2018-03-24,95,@,DET,0,240,39,97,0.402,28,62,0.452,11,35,0.314,6,9,0.667,95,43,87,0.494,27,45,0.6,16,42,0.381,15,18,0.833,117
2005,PHO,2018-03-23,95,@,CLE,0,240,38,87,0.437,31,59,0.525,7,28,0.25,12,20,0.6,95,47,95,0.495,39,66,0.591,8,29,0.276,18,24,0.75,120
2006,UTA,2018-03-09,95,@,MEM,1,240,33,74,0.446,20,42,0.476,13,32,0.406,16,22,0.727,95,31,83,0.373,25,61,0.41,6,22,0.273,10,14,0.714,78
2007,WAS,2018-03-04,95,,IND,0,240,35,83,0.422,25,56,0.446,10,27,0.37,15,19,0.789,95,34,77,0.442,26,52,0.5,8,25,0.32,22,24,0.917,98
2008,WAS,2018-03-02,95,,TOR,0,240,36,79,0.456,27,55,0.491,9,24,0.375,14,21,0.667,95,36,78,0.462,26,45,0.578,10,33,0.303,20,32,0.625,102
2009,DET,2018-02-09,95,,LAC,0,240,36,88,0.409,26,57,0.456,10,31,0.323,13,17,0.765,95,42,91,0.462,32,61,0.525,10,30,0.333,14,15,0.933,108
2010,BRK,2018-01-30,95,@,NYK,0,240,36,87,0.414,27,50,0.54,9,37,0.243,14,16,0.875,95,39,89,0.438,26,63,0.413,13,26,0.5,20,25,0.8,111
2011,MIA,2018-01-29,95,@,DAL,1,240,34,75,0.453,22,44,0.5,12,31,0.387,15,19,0.789,95,33,86,0.384,25,57,0.439,8,29,0.276,14,16,0.875,88
2012,PHI,2018-01-29,95,@,MIL,0,240,36,82,0.439,34,56,0.607,2,26,0.077,21,23,0.913,95,38,80,0.475,27,52,0.519,11,28,0.393,20,22,0.909,107
2013,MIA,2018-01-27,95,,CHO,1,240,38,85,0.447,30,59,0.508,8,26,0.308,11,18,0.611,95,29,84,0.345,24,60,0.4,5,24,0.208,28,35,0.8,91
2014,DET,2018-01-24,95,,UTA,0,265,38,97,0.392,31,66,0.47,7,31,0.226,12,18,0.667,95,38,96,0.396,28,65,0.431,10,31,0.323,12,16,0.75,98
2015,BOS,2018-01-21,95,,ORL,0,240,37,85,0.435,29,58,0.5,8,27,0.296,13,14,0.929,95,43,92,0.467,37,71,0.521,6,21,0.286,11,16,0.688,103
2016,MIA,2018-01-19,95,@,BRK,0,240,35,84,0.417,28,62,0.452,7,22,0.318,18,25,0.72,95,36,76,0.474,27,44,0.614,9,32,0.281,20,26,0.769,101
2017,BRK,2018-01-17,95,,SAS,0,240,35,83,0.422,22,47,0.468,13,36,0.361,12,18,0.667,95,34,82,0.415,25,63,0.397,9,19,0.474,23,31,0.742,100
2018,WAS,2018-01-15,95,,MIL,0,240,32,76,0.421,26,55,0.473,6,21,0.286,25,31,0.806,95,38,81,0.469,30,65,0.462,8,16,0.5,20,29,0.69,104
2019,OKC,2018-01-15,95,,SAC,1,240,36,86,0.419,27,56,0.482,9,30,0.3,14,29,0.483,95,33,84,0.393,26,54,0.481,7,30,0.233,15,25,0.6,88
2020,CLE,2018-01-12,95,@,IND,0,240,37,85,0.435,30,51,0.588,7,34,0.206,14,19,0.737,95,39,85,0.459,29,64,0.453,10,21,0.476,9,12,0.75,97
2021,PHO,2018-01-12,95,,HOU,0,240,37,80,0.463,23,47,0.489,14,33,0.424,7,9,0.778,95,39,94,0.415,24,47,0.511,15,47,0.319,19,22,0.864,112
2022,ORL,2018-01-01,95,@,BRK,0,240,35,96,0.365,29,65,0.446,6,31,0.194,19,25,0.76,95,36,82,0.439,27,57,0.474,9,25,0.36,17,23,0.739,98
2023,OKC,2017-12-29,95,,MIL,0,240,38,83,0.458,31,58,0.534,7,25,0.28,12,20,0.6,95,40,85,0.471,31,56,0.554,9,29,0.31,8,17,0.471,97
2024,CLE,2017-12-27,95,@,SAC,0,240,32,74,0.432,20,43,0.465,12,31,0.387,19,25,0.76,95,41,79,0.519,29,49,0.592,12,30,0.4,15,18,0.833,109
2025,SAC,2017-12-26,95,@,LAC,0,240,40,96,0.417,33,74,0.446,7,22,0.318,8,12,0.667,95,44,81,0.543,31,50,0.62,13,31,0.419,21,27,0.778,122
2026,POR,2017-12-23,95,@,LAL,1,240,39,95,0.411,29,70,0.414,10,25,0.4,7,14,0.5,95,36,85,0.424,28,60,0.467,8,25,0.32,12,20,0.6,92
2027,MEM,2017-12-21,95,@,PHO,0,240,39,90,0.433,34,64,0.531,5,26,0.192,12,16,0.75,95,33,81,0.407,23,55,0.418,10,26,0.385,21,27,0.778,97
2028,PHO,2017-12-20,95,@,LAC,0,240,35,97,0.361,27,62,0.435,8,35,0.229,17,19,0.895,95,41,87,0.471,31,57,0.544,10,30,0.333,16,24,0.667,108
2029,ATL,2017-12-20,95,,IND,0,240,35,81,0.432,27,52,0.519,8,29,0.276,17,20,0.85,95,40,82,0.488,33,61,0.541,7,21,0.333,18,19,0.947,105
2030,PHI,2017-12-19,95,,SAC,0,240,34,81,0.42,24,46,0.522,10,35,0.286,17,24,0.708,95,41,91,0.451,34,64,0.531,7,27,0.259,12,23,0.522,101
2031,OKC,2017-12-18,95,,DEN,1,240,39,81,0.481,32,57,0.561,7,24,0.292,10,15,0.667,95,37,86,0.43,25,49,0.51,12,37,0.324,8,12,0.667,94
2032,BOS,2017-12-15,95,,UTA,0,240,35,86,0.407,26,55,0.473,9,31,0.29,16,19,0.842,95,40,83,0.482,27,58,0.466,13,25,0.52,14,18,0.778,107
2033,POR,2017-12-15,95,@,ORL,1,240,37,86,0.43,29,68,0.426,8,18,0.444,13,15,0.867,95,32,84,0.381,22,55,0.4,10,29,0.345,14,19,0.737,88
2034,IND,2017-12-13,95,,OKC,0,240,40,89,0.449,29,58,0.5,11,31,0.355,4,6,0.667,95,36,88,0.409,23,59,0.39,13,29,0.448,15,24,0.625,100
2035,MIA,2017-12-13,95,,POR,0,240,34,72,0.472,21,42,0.5,13,30,0.433,14,23,0.609,95,36,72,0.5,26,44,0.591,10,28,0.357,20,23,0.87,102
2036,ORL,2017-12-13,95,,LAC,0,240,37,88,0.42,28,61,0.459,9,27,0.333,12,21,0.571,95,39,88,0.443,27,62,0.435,12,26,0.462,16,20,0.8,106
2037,DAL,2017-12-12,95,,SAS,1,240,38,89,0.427,29,65,0.446,9,24,0.375,10,12,0.833,95,35,87,0.402,28,59,0.475,7,28,0.25,12,19,0.632,89
2038,OKC,2017-12-07,95,@,BRK,0,240,38,98,0.388,31,74,0.419,7,24,0.292,12,23,0.522,95,35,80,0.438,24,43,0.558,11,37,0.297,19,30,0.633,100
2039,SAC,2017-12-06,95,@,CLE,0,240,39,86,0.453,29,54,0.537,10,32,0.313,7,13,0.538,95,37,78,0.474,23,39,0.59,14,39,0.359,13,21,0.619,101
2040,MEM,2017-12-04,95,,MIN,1,240,34,72,0.472,28,51,0.549,6,21,0.286,21,24,0.875,95,35,79,0.443,31,62,0.5,4,17,0.235,18,19,0.947,92
2041,MIA,2017-12-03,95,,GSW,0,240,33,81,0.407,19,44,0.432,14,37,0.378,15,17,0.882,95,47,84,0.56,36,54,0.667,11,30,0.367,18,24,0.75,123
2042,LAL,2017-12-03,95,,HOU,0,240,32,84,0.381,23,56,0.411,9,28,0.321,22,30,0.733,95,45,90,0.5,31,53,0.585,14,37,0.378,14,17,0.824,118
2043,SAS,2017-12-01,95,@,MEM,1,240,31,70,0.443,20,43,0.465,11,27,0.407,22,32,0.688,95,30,74,0.405,25,59,0.424,5,15,0.333,14,18,0.778,79
2044,MEM,2017-11-29,95,@,SAS,0,240,35,77,0.455,24,55,0.436,11,22,0.5,14,16,0.875,95,38,75,0.507,30,55,0.545,8,20,0.4,20,24,0.833,104
2045,SAC,2017-11-25,95,,LAC,0,240,38,83,0.458,27,62,0.435,11,21,0.524,8,9,0.889,95,38,80,0.475,29,52,0.558,9,28,0.321,12,13,0.923,97
2046,NOP,2017-11-25,95,@,GSW,0,240,34,84,0.405,23,53,0.434,11,31,0.355,16,23,0.696,95,39,94,0.415,29,61,0.475,10,33,0.303,22,27,0.815,110
2047,DAL,2017-11-22,95,@,MEM,1,240,39,91,0.429,30,63,0.476,9,28,0.321,8,16,0.5,95,37,81,0.457,30,52,0.577,7,29,0.241,13,14,0.929,94
2048,DEN,2017-11-22,95,@,HOU,0,240,35,87,0.402,25,54,0.463,10,33,0.303,15,23,0.652,95,45,82,0.549,27,41,0.659,18,41,0.439,17,23,0.739,125
2049,MIA,2017-11-19,95,,IND,0,240,35,83,0.422,22,46,0.478,13,37,0.351,12,14,0.857,95,51,85,0.6,40,62,0.645,11,23,0.478,7,8,0.875,120
2050,DET,2017-11-15,95,@,MIL,0,240,30,85,0.353,15,48,0.313,15,37,0.405,20,23,0.87,95,38,78,0.487,30,56,0.536,8,22,0.364,15,20,0.75,99
2051,BOS,2017-11-12,95,,TOR,1,240,35,87,0.402,25,61,0.41,10,26,0.385,15,19,0.789,95,32,69,0.464,22,45,0.489,10,24,0.417,20,23,0.87,94
2052,IND,2017-11-12,95,,HOU,0,240,37,83,0.446,29,61,0.475,8,22,0.364,13,21,0.619,95,43,90,0.478,26,43,0.605,17,47,0.362,15,18,0.833,118
2053,LAL,2017-11-09,95,@,WAS,0,240,31,86,0.36,28,63,0.444,3,23,0.13,30,41,0.732,95,43,83,0.518,36,62,0.581,7,21,0.333,18,20,0.9,111
2054,PHO,2017-11-05,95,@,SAS,0,240,37,81,0.457,29,58,0.5,8,23,0.348,13,22,0.591,95,44,88,0.5,33,66,0.5,11,22,0.5,13,18,0.722,112
2055,DEN,2017-11-03,95,,MIA,1,240,36,80,0.45,27,57,0.474,9,23,0.391,14,25,0.56,95,36,77,0.468,21,40,0.525,15,37,0.405,7,11,0.636,94
2056,CLE,2017-10-29,95,,NYK,0,240,31,81,0.383,21,48,0.438,10,33,0.303,23,27,0.852,95,42,89,0.472,29,61,0.475,13,28,0.464,17,21,0.81,114
2057,DET,2017-10-28,95,@,LAC,1,240,36,88,0.409,27,60,0.45,9,28,0.321,14,21,0.667,95,28,84,0.333,13,46,0.283,15,38,0.395,16,22,0.727,87
2058,MEM,2018-04-09,94,@,MIN,0,240,35,85,0.412,30,67,0.448,5,18,0.278,19,21,0.905,94,42,87,0.483,35,65,0.538,7,22,0.318,22,26,0.846,113
2059,SAC,2018-04-06,94,@,MEM,1,240,40,85,0.471,34,61,0.557,6,24,0.25,8,12,0.667,94,37,84,0.44,31,60,0.517,6,24,0.25,13,18,0.722,93
2060,POR,2018-04-05,94,@,HOU,0,240,39,85,0.459,32,63,0.508,7,22,0.318,9,14,0.643,94,34,73,0.466,21,36,0.583,13,37,0.351,15,24,0.625,96
2061,SAC,2018-04-03,94,@,PHO,0,240,33,89,0.371,22,62,0.355,11,27,0.407,17,23,0.739,94,35,77,0.455,29,60,0.483,6,17,0.353,21,33,0.636,97
2062,WAS,2018-04-01,94,@,CHI,0,240,37,81,0.457,29,51,0.569,8,30,0.267,12,12,1.0,94,43,82,0.524,25,48,0.521,18,34,0.529,9,13,0.692,113
2063,ATL,2018-04-01,94,,ORL,1,240,41,85,0.482,30,49,0.612,11,36,0.306,1,1,1.0,94,33,96,0.344,23,60,0.383,10,36,0.278,12,13,0.923,88
2064,UTA,2018-03-28,94,,BOS,0,240,34,82,0.415,25,49,0.51,9,33,0.273,17,21,0.81,94,35,79,0.443,23,58,0.397,12,21,0.571,15,20,0.75,97
2065,PHO,2018-03-26,94,,BOS,0,240,36,81,0.444,24,46,0.522,12,35,0.343,10,19,0.526,94,37,87,0.425,23,58,0.397,14,29,0.483,14,14,1.0,102
2066,ATL,2018-03-23,94,@,GSW,0,240,37,84,0.44,26,52,0.5,11,32,0.344,9,20,0.45,94,42,93,0.452,30,63,0.476,12,30,0.4,10,11,0.909,106
2067,UTA,2018-03-20,94,,ATL,0,240,33,89,0.371,27,55,0.491,6,34,0.176,22,25,0.88,94,38,94,0.404,29,61,0.475,9,33,0.273,14,19,0.737,99
2068,CHO,2018-03-19,94,@,PHI,0,240,32,84,0.381,26,62,0.419,6,22,0.273,24,30,0.8,94,42,93,0.452,24,49,0.49,18,44,0.409,6,8,0.75,108
2069,DEN,2018-03-17,94,@,MEM,0,240,32,87,0.368,23,54,0.426,9,33,0.273,21,29,0.724,94,33,81,0.407,20,49,0.408,13,32,0.406,22,28,0.786,101
2070,SAS,2018-03-10,94,@,OKC,0,240,40,86,0.465,30,66,0.455,10,20,0.5,4,7,0.571,94,39,85,0.459,29,57,0.509,10,28,0.357,16,24,0.667,104
2071,SAC,2018-03-09,94,,ORL,1,240,36,83,0.434,27,58,0.466,9,25,0.36,13,15,0.867,94,33,78,0.423,24,49,0.49,9,29,0.31,13,16,0.813,88
2072,UTA,2018-03-05,94,,ORL,1,240,36,73,0.493,26,42,0.619,10,31,0.323,12,18,0.667,94,29,85,0.341,18,51,0.353,11,34,0.324,11,14,0.786,80
2073,DET,2018-02-26,94,@,TOR,0,240,36,94,0.383,29,72,0.403,7,22,0.318,15,20,0.75,94,42,80,0.525,25,42,0.595,17,38,0.447,22,23,0.957,123
2074,CLE,2018-02-25,94,,SAS,0,240,38,91,0.418,30,57,0.526,8,34,0.235,10,14,0.714,94,38,86,0.442,29,67,0.433,9,19,0.474,25,32,0.781,110
2075,PHI,2018-02-25,94,@,WAS,0,240,31,86,0.36,22,53,0.415,9,33,0.273,23,31,0.742,94,43,79,0.544,31,54,0.574,12,25,0.48,11,12,0.917,109
2076,CHO,2018-02-09,94,@,UTA,0,240,35,85,0.412,26,61,0.426,9,24,0.375,15,19,0.789,94,41,84,0.488,31,55,0.564,10,29,0.345,14,17,0.824,106
2077,BRK,2018-02-04,94,,MIL,0,240,37,90,0.411,28,61,0.459,9,29,0.31,11,14,0.786,94,42,81,0.519,34,62,0.548,8,19,0.421,17,21,0.81,109
2078,IND,2018-01-21,94,@,SAS,1,240,37,84,0.44,33,65,0.508,4,19,0.211,16,17,0.941,94,35,82,0.427,26,48,0.542,9,34,0.265,7,12,0.583,86
2079,MIL,2018-01-20,94,@,PHI,0,240,33,82,0.402,23,50,0.46,10,32,0.313,18,22,0.818,94,45,85,0.529,35,60,0.583,10,25,0.4,16,19,0.842,116
2080,ATL,2018-01-17,94,,NOP,1,240,37,89,0.416,27,49,0.551,10,40,0.25,10,13,0.769,94,35,80,0.438,25,53,0.472,10,27,0.37,13,19,0.684,93
2081,UTA,2018-01-15,94,,IND,0,240,36,81,0.444,27,48,0.563,9,33,0.273,13,17,0.765,94,41,77,0.532,27,51,0.529,14,26,0.538,13,15,0.867,109
2082,MIL,2018-01-12,94,,GSW,0,240,36,85,0.424,25,57,0.439,11,28,0.393,11,12,0.917,94,44,79,0.557,39,64,0.609,5,15,0.333,15,18,0.833,108
2083,LAL,2018-01-05,94,,CHO,0,240,38,94,0.404,29,58,0.5,9,36,0.25,9,12,0.75,94,42,99,0.424,30,66,0.455,12,33,0.364,12,16,0.75,108
2084,IND,2017-12-27,94,,DAL,0,240,38,79,0.481,28,54,0.519,10,25,0.4,8,10,0.8,94,40,78,0.513,32,49,0.653,8,29,0.276,10,15,0.667,98
2085,MIA,2017-12-23,94,,NOP,0,240,36,85,0.424,26,53,0.491,10,32,0.313,12,15,0.8,94,39,73,0.534,24,48,0.5,15,25,0.6,16,19,0.842,109
2086,ORL,2017-12-20,94,@,CHI,0,240,35,89,0.393,30,62,0.484,5,27,0.185,19,23,0.826,94,44,87,0.506,33,55,0.6,11,32,0.344,13,14,0.929,112
2087,DEN,2017-12-18,94,@,OKC,0,240,37,86,0.43,25,49,0.51,12,37,0.324,8,12,0.667,94,39,81,0.481,32,57,0.561,7,24,0.292,10,15,0.667,95
2088,ATL,2017-12-15,94,@,MEM,0,240,34,77,0.442,22,46,0.478,12,31,0.387,14,16,0.875,94,36,78,0.462,24,53,0.453,12,25,0.48,12,17,0.706,96
2089,UTA,2017-12-05,94,@,OKC,0,240,34,79,0.43,23,46,0.5,11,33,0.333,15,21,0.714,94,39,81,0.481,35,63,0.556,4,18,0.222,18,26,0.692,100
2090,ORL,2017-12-04,94,@,CHO,0,240,36,82,0.439,26,50,0.52,10,32,0.313,12,14,0.857,94,34,84,0.405,31,67,0.463,3,17,0.176,33,40,0.825,104
2091,CHI,2017-11-24,94,@,GSW,0,240,35,99,0.354,22,63,0.349,13,36,0.361,11,15,0.733,94,53,91,0.582,37,55,0.673,16,36,0.444,21,21,1.0,143
2092,MEM,2017-11-22,94,,DAL,0,240,37,81,0.457,30,52,0.577,7,29,0.241,13,14,0.929,94,39,91,0.429,30,63,0.476,9,28,0.321,8,16,0.5,95
2093,CHI,2017-11-21,94,@,LAL,0,240,36,94,0.383,25,58,0.431,11,36,0.306,11,16,0.688,94,36,90,0.4,23,50,0.46,13,40,0.325,18,25,0.72,103
2094,ORL,2017-11-15,94,@,POR,0,240,37,79,0.468,26,50,0.52,11,29,0.379,9,9,1.0,94,38,87,0.437,24,60,0.4,14,27,0.519,9,13,0.692,99
2095,TOR,2017-11-12,94,@,BOS,0,240,32,69,0.464,22,45,0.489,10,24,0.417,20,23,0.87,94,35,87,0.402,25,61,0.41,10,26,0.385,15,19,0.789,95
2096,ATL,2017-11-11,94,@,WAS,0,240,34,83,0.41,20,50,0.4,14,33,0.424,12,17,0.706,94,42,78,0.538,35,54,0.648,7,24,0.292,22,28,0.786,113
2097,CHI,2017-11-11,94,@,SAS,0,240,40,86,0.465,34,63,0.54,6,23,0.261,8,13,0.615,94,51,85,0.6,33,58,0.569,18,27,0.667,13,16,0.813,133
2098,MIL,2017-11-10,94,@,SAS,1,240,41,89,0.461,36,71,0.507,5,18,0.278,7,14,0.5,94,34,80,0.425,25,51,0.49,9,29,0.31,10,11,0.909,87
2099,OKC,2017-11-09,94,@,DEN,0,240,38,90,0.422,27,60,0.45,11,30,0.367,7,14,0.5,94,38,82,0.463,29,55,0.527,9,27,0.333,17,22,0.773,102
2100,SAC,2017-11-07,94,,OKC,1,240,37,79,0.468,28,55,0.509,9,24,0.375,11,12,0.917,94,29,86,0.337,19,49,0.388,10,37,0.27,18,23,0.783,86
2101,CHO,2017-11-05,94,@,MIN,0,240,37,89,0.416,28,61,0.459,9,28,0.321,11,21,0.524,94,38,83,0.458,28,59,0.475,10,24,0.417,26,30,0.867,112
2102,MIA,2017-11-03,94,@,DEN,0,240,36,77,0.468,21,40,0.525,15,37,0.405,7,11,0.636,94,36,80,0.45,27,57,0.474,9,23,0.391,14,25,0.56,95
2103,OKC,2017-11-03,94,,BOS,0,240,35,87,0.402,22,52,0.423,13,35,0.371,11,14,0.786,94,36,84,0.429,23,56,0.411,13,28,0.464,16,24,0.667,101
2104,DAL,2017-11-03,94,,NOP,0,240,34,88,0.386,25,54,0.463,9,34,0.265,17,22,0.773,94,36,89,0.404,29,60,0.483,7,29,0.241,20,26,0.769,99
2105,SAS,2017-10-30,94,@,BOS,0,240,36,87,0.414,24,61,0.393,12,26,0.462,10,20,0.5,94,42,88,0.477,31,57,0.544,11,31,0.355,13,16,0.813,108
2106,SAS,2017-10-29,94,@,IND,0,240,36,90,0.4,27,62,0.435,9,28,0.321,13,18,0.722,94,36,77,0.468,26,55,0.473,10,22,0.455,15,20,0.75,97
2107,MEM,2017-10-25,94,@,DAL,0,240,33,72,0.458,21,41,0.512,12,31,0.387,16,24,0.667,94,36,74,0.486,25,48,0.521,11,26,0.423,20,29,0.69,103
2108,CHO,2017-10-23,94,@,MIL,0,240,33,78,0.423,26,52,0.5,7,26,0.269,21,36,0.583,94,40,85,0.471,31,59,0.525,9,26,0.346,14,16,0.875,103
2109,PHI,2017-10-21,94,@,TOR,0,240,32,82,0.39,24,58,0.414,8,24,0.333,22,36,0.611,94,42,89,0.472,29,45,0.644,13,44,0.295,31,37,0.838,128
2110,UTA,2018-04-11,93,@,POR,0,240,33,89,0.371,25,66,0.379,8,23,0.348,19,24,0.792,93,41,89,0.461,32,65,0.492,9,24,0.375,11,16,0.688,102
2111,IND,2018-04-10,93,,CHO,0,240,40,99,0.404,32,68,0.471,8,31,0.258,5,8,0.625,93,46,99,0.465,28,57,0.491,18,42,0.429,9,12,0.75,119
2112,MIA,2018-04-09,93,,OKC,0,240,40,87,0.46,35,65,0.538,5,22,0.227,8,14,0.571,93,35,81,0.432,21,46,0.457,14,35,0.4,31,38,0.816,115
2113,MEM,2018-04-06,93,,SAC,0,240,37,84,0.44,31,60,0.517,6,24,0.25,13,18,0.722,93,40,85,0.471,34,61,0.557,6,24,0.25,8,12,0.667,94
2114,CHO,2018-03-31,93,@,WAS,0,240,35,77,0.455,29,54,0.537,6,23,0.261,17,27,0.63,93,40,88,0.455,22,49,0.449,18,39,0.462,9,12,0.75,107
2115,MIN,2018-03-30,93,@,DAL,1,240,35,83,0.422,27,58,0.466,8,25,0.32,15,17,0.882,93,38,86,0.442,27,58,0.466,11,28,0.393,5,7,0.714,92
2116,DAL,2018-03-28,93,@,LAL,0,240,33,84,0.393,20,40,0.5,13,44,0.295,14,19,0.737,93,36,77,0.468,27,44,0.614,9,33,0.273,22,32,0.688,103
2117,MIN,2018-03-26,93,,MEM,0,240,33,79,0.418,25,55,0.455,8,24,0.333,19,24,0.792,93,40,84,0.476,25,53,0.472,15,31,0.484,6,9,0.667,101
2118,SAC,2018-03-25,93,,BOS,0,240,38,82,0.463,31,56,0.554,7,26,0.269,10,10,1.0,93,40,72,0.556,28,50,0.56,12,22,0.545,12,17,0.706,104
2119,MEM,2018-03-24,93,,LAL,0,240,35,84,0.417,30,55,0.545,5,29,0.172,18,22,0.818,93,35,86,0.407,22,48,0.458,13,38,0.342,17,25,0.68,100
2120,TOR,2018-03-20,93,@,ORL,1,240,35,77,0.455,21,41,0.512,14,36,0.389,9,17,0.529,93,37,90,0.411,28,65,0.431,9,25,0.36,3,5,0.6,86
2121,GSW,2018-03-16,93,,SAC,0,240,34,81,0.42,22,55,0.4,12,26,0.462,13,18,0.722,93,36,83,0.434,22,52,0.423,14,31,0.452,12,17,0.706,98
2122,NOP,2018-03-15,93,@,SAS,0,240,36,90,0.4,30,74,0.405,6,16,0.375,15,16,0.938,93,37,99,0.374,30,73,0.411,7,26,0.269,17,19,0.895,98
2123,SAS,2018-03-12,93,@,HOU,0,240,33,81,0.407,22,53,0.415,11,28,0.393,16,23,0.696,93,39,80,0.488,26,36,0.722,13,44,0.295,18,23,0.783,109
2124,ATL,2018-02-23,93,@,IND,0,240,37,82,0.451,30,51,0.588,7,31,0.226,12,19,0.632,93,48,101,0.475,39,73,0.534,9,28,0.321,11,13,0.846,116
2125,PHO,2018-02-06,93,@,LAL,0,240,36,94,0.383,28,65,0.431,8,29,0.276,13,23,0.565,93,39,83,0.47,28,57,0.491,11,26,0.423,23,26,0.885,112
2126,DAL,2018-01-26,93,,POR,0,240,35,89,0.393,25,59,0.424,10,30,0.333,13,17,0.765,93,39,79,0.494,29,49,0.592,10,30,0.333,19,23,0.826,107
2127,TOR,2018-01-26,93,,UTA,0,240,37,95,0.389,30,68,0.441,7,27,0.259,12,17,0.706,93,36,87,0.414,26,66,0.394,10,21,0.476,15,21,0.714,97
2128,ATL,2018-01-24,93,,TOR,0,240,37,94,0.394,30,73,0.411,7,21,0.333,12,17,0.706,93,39,89,0.438,25,53,0.472,14,36,0.389,16,25,0.64,108
2129,NOP,2018-01-17,93,@,ATL,0,240,35,80,0.438,25,53,0.472,10,27,0.37,13,19,0.684,93,37,89,0.416,27,49,0.551,10,40,0.25,10,13,0.769,94
2130,LAL,2018-01-11,93,,SAS,1,240,36,87,0.414,23,49,0.469,13,38,0.342,8,14,0.571,93,31,76,0.408,23,56,0.411,8,20,0.4,11,15,0.733,81
2131,DET,2017-12-30,93,,SAS,1,240,36,81,0.444,28,57,0.491,8,24,0.333,13,16,0.813,93,31,84,0.369,26,58,0.448,5,26,0.192,12,13,0.923,79
2132,TOR,2017-12-26,93,@,DAL,0,240,30,89,0.337,21,58,0.362,9,31,0.29,24,32,0.75,93,40,94,0.426,34,70,0.486,6,24,0.25,12,16,0.75,98
2133,BOS,2017-12-21,93,@,NYK,0,240,33,86,0.384,20,48,0.417,13,38,0.342,14,19,0.737,93,36,79,0.456,28,65,0.431,8,14,0.571,22,26,0.846,102
2134,DET,2017-12-20,93,@,DAL,0,240,33,77,0.429,26,53,0.491,7,24,0.292,20,22,0.909,93,40,75,0.533,26,45,0.578,14,30,0.467,16,20,0.8,110
2135,SAS,2017-12-20,93,@,POR,1,240,41,79,0.519,35,62,0.565,6,17,0.353,5,6,0.833,93,38,96,0.396,32,71,0.451,6,25,0.24,9,14,0.643,91
2136,SAC,2017-12-17,93,@,TOR,0,240,38,81,0.469,27,55,0.491,11,26,0.423,6,8,0.75,93,36,85,0.424,23,55,0.418,13,30,0.433,23,28,0.821,108
2137,POR,2017-12-16,93,@,CHO,1,240,37,79,0.468,27,55,0.491,10,24,0.417,9,18,0.5,93,33,96,0.344,26,65,0.4,7,31,0.226,18,28,0.643,91
2138,MEM,2017-12-16,93,,BOS,0,240,32,79,0.405,18,45,0.4,14,34,0.412,15,17,0.882,93,39,80,0.488,25,50,0.5,14,30,0.467,10,14,0.714,102
2139,WAS,2017-12-13,93,,MEM,1,240,36,77,0.468,27,55,0.491,9,22,0.409,12,24,0.5,93,31,81,0.383,21,53,0.396,10,28,0.357,15,16,0.938,87
2140,DET,2017-12-04,93,@,SAS,0,240,35,85,0.412,27,58,0.466,8,27,0.296,15,24,0.625,93,35,82,0.427,21,51,0.412,14,31,0.452,12,12,1.0,96
2141,CHI,2017-11-26,93,,MIA,0,240,33,89,0.371,19,56,0.339,14,33,0.424,13,16,0.813,93,34,75,0.453,21,43,0.488,13,32,0.406,19,23,0.826,100
2142,MIA,2017-11-15,93,,WAS,0,240,32,78,0.41,19,48,0.396,13,30,0.433,16,19,0.842,93,32,78,0.41,23,59,0.39,9,19,0.474,29,31,0.935,102
2143,PHO,2017-11-13,93,,LAL,0,240,37,95,0.389,30,69,0.435,7,26,0.269,12,20,0.6,93,39,92,0.424,25,59,0.424,14,33,0.424,8,13,0.615,100
2144,DET,2017-10-31,93,@,LAL,0,240,41,94,0.436,31,61,0.508,10,33,0.303,1,3,0.333,93,45,91,0.495,33,65,0.508,12,26,0.462,11,14,0.786,113
2145,CHO,2017-10-27,93,,HOU,0,240,33,88,0.375,22,59,0.373,11,29,0.379,16,28,0.571,93,38,85,0.447,16,28,0.571,22,57,0.386,11,13,0.846,109
2146,DEN,2017-10-25,93,@,CHO,0,240,38,100,0.38,30,69,0.435,8,31,0.258,9,15,0.6,93,38,81,0.469,25,50,0.5,13,31,0.419,21,26,0.808,110
2147,NOP,2017-10-24,93,@,POR,0,240,30,76,0.395,21,46,0.457,9,30,0.3,24,32,0.75,93,33,88,0.375,23,59,0.39,10,29,0.345,27,33,0.818,103
2148,ATL,2017-10-23,93,@,MIA,0,240,36,76,0.474,29,59,0.492,7,17,0.412,14,18,0.778,93,39,85,0.459,25,48,0.521,14,37,0.378,12,18,0.667,104
2149,CLE,2017-10-21,93,,ORL,0,240,33,86,0.384,26,61,0.426,7,25,0.28,20,27,0.741,93,40,90,0.444,23,55,0.418,17,35,0.486,17,20,0.85,114
2150,SAC,2017-10-20,93,@,DAL,1,240,37,87,0.425,27,64,0.422,10,23,0.435,9,13,0.692,93,31,75,0.413,20,42,0.476,11,33,0.333,15,21,0.714,88
2151,WAS,2018-04-11,92,@,ORL,0,240,33,95,0.347,23,61,0.377,10,34,0.294,16,27,0.593,92,33,77,0.429,20,45,0.444,13,32,0.406,22,27,0.815,101
2152,TOR,2018-04-06,92,,IND,1,240,36,84,0.429,27,54,0.5,9,30,0.3,11,16,0.688,92,26,87,0.299,19,66,0.288,7,21,0.333,14,20,0.7,73
2153,DAL,2018-03-30,92,,MIN,0,240,38,86,0.442,27,58,0.466,11,28,0.393,5,7,0.714,92,35,83,0.422,27,58,0.466,8,25,0.32,15,17,0.882,93
2154,CHI,2018-03-29,92,@,MIA,0,240,33,90,0.367,27,64,0.422,6,26,0.231,20,26,0.769,92,37,82,0.451,30,55,0.545,7,27,0.259,22,24,0.917,103
2155,WAS,2018-03-29,92,@,DET,0,240,37,89,0.416,31,57,0.544,6,32,0.188,12,15,0.8,92,41,84,0.488,35,63,0.556,6,21,0.286,15,20,0.75,103
2156,IND,2018-03-27,92,@,GSW,1,240,39,81,0.481,33,60,0.55,6,21,0.286,8,12,0.667,92,35,86,0.407,30,69,0.435,5,17,0.294,6,9,0.667,81
2157,IND,2018-03-21,92,@,NOP,0,240,34,93,0.366,27,71,0.38,7,22,0.318,17,18,0.944,92,34,79,0.43,26,56,0.464,8,23,0.348,20,24,0.833,96
2158,CHI,2018-03-19,92,@,NYK,0,240,33,92,0.359,30,62,0.484,3,30,0.1,23,31,0.742,92,43,96,0.448,32,61,0.525,11,35,0.314,13,17,0.765,110
2159,MIA,2018-03-16,92,@,LAL,1,240,36,94,0.383,26,58,0.448,10,36,0.278,10,14,0.714,92,32,76,0.421,23,57,0.404,9,19,0.474,18,22,0.818,91
2160,BOS,2018-03-16,92,@,ORL,1,240,31,82,0.378,22,56,0.393,9,26,0.346,21,28,0.75,92,34,87,0.391,29,59,0.492,5,28,0.179,10,11,0.909,83
2161,IND,2018-03-05,92,,MIL,1,240,33,77,0.429,23,60,0.383,10,17,0.588,16,21,0.762,92,34,76,0.447,27,53,0.509,7,23,0.304,14,16,0.875,89
2162,LAC,2018-02-28,92,,HOU,0,240,36,79,0.456,29,56,0.518,7,23,0.304,13,19,0.684,92,36,85,0.424,23,42,0.548,13,43,0.302,20,24,0.833,105
2163,ATL,2018-02-13,92,@,MIL,0,240,33,86,0.384,21,51,0.412,12,35,0.343,14,20,0.7,92,38,88,0.432,30,63,0.476,8,25,0.32,13,17,0.765,97
2164,NYK,2018-02-12,92,@,PHI,0,240,31,79,0.392,25,55,0.455,6,24,0.25,24,28,0.857,92,41,75,0.547,31,56,0.554,10,19,0.526,16,24,0.667,108
2165,MEM,2018-02-11,92,@,OKC,0,240,32,82,0.39,26,54,0.481,6,28,0.214,22,24,0.917,92,34,77,0.442,18,40,0.45,16,37,0.432,26,40,0.65,110
2166,UTA,2018-02-07,92,@,MEM,1,240,29,69,0.42,23,47,0.489,6,22,0.273,28,33,0.848,92,34,81,0.42,26,58,0.448,8,23,0.348,12,16,0.75,88
2167,PHI,2018-02-03,92,@,IND,0,240,33,87,0.379,23,55,0.418,10,32,0.313,16,24,0.667,92,35,79,0.443,26,52,0.5,9,27,0.333,21,25,0.84,100
2168,MIL,2018-02-02,92,,NYK,1,240,33,76,0.434,26,52,0.5,7,24,0.292,19,26,0.731,92,36,89,0.404,31,64,0.484,5,25,0.2,13,17,0.765,90
2169,CHI,2017-12-27,92,,NYK,1,240,35,86,0.407,25,58,0.431,10,28,0.357,12,16,0.75,92,37,91,0.407,33,68,0.485,4,23,0.174,9,13,0.692,87
2170,CLE,2017-12-25,92,@,GSW,0,240,28,88,0.318,13,52,0.25,15,36,0.417,21,25,0.84,92,38,82,0.463,28,45,0.622,10,37,0.27,13,17,0.765,99
2171,CHI,2017-12-23,92,@,BOS,0,240,34,86,0.395,27,67,0.403,7,19,0.368,17,25,0.68,92,44,92,0.478,32,60,0.533,12,32,0.375,17,21,0.81,117
2172,LAL,2017-12-23,92,,POR,0,240,36,85,0.424,28,60,0.467,8,25,0.32,12,20,0.6,92,39,95,0.411,29,70,0.414,10,25,0.4,7,14,0.5,95
2173,PHO,2017-12-12,92,@,SAC,0,240,37,90,0.411,30,58,0.517,7,32,0.219,11,14,0.786,92,38,89,0.427,31,67,0.463,7,22,0.318,16,22,0.727,99
2174,DAL,2017-12-10,92,@,MIN,0,240,37,81,0.457,26,50,0.52,11,31,0.355,7,9,0.778,92,36,72,0.5,29,53,0.547,7,19,0.368,18,23,0.783,97
2175,POR,2017-12-05,92,,WAS,0,240,32,78,0.41,20,51,0.392,12,27,0.444,16,21,0.762,92,42,89,0.472,31,64,0.484,11,25,0.44,11,14,0.786,106
2176,MIN,2017-12-04,92,@,MEM,0,240,35,79,0.443,31,62,0.5,4,17,0.235,18,19,0.947,92,34,72,0.472,28,51,0.549,6,21,0.286,21,24,0.875,95
2177,WAS,2017-11-28,92,@,MIN,1,240,36,83,0.434,26,55,0.473,10,28,0.357,10,17,0.588,92,35,85,0.412,25,55,0.455,10,30,0.333,9,14,0.643,89
2178,MEM,2017-11-24,92,@,DEN,0,240,36,73,0.493,27,49,0.551,9,24,0.375,11,16,0.688,92,40,79,0.506,31,47,0.66,9,32,0.281,15,26,0.577,104
2179,MEM,2017-11-20,92,,POR,0,240,33,86,0.384,25,56,0.446,8,30,0.267,18,23,0.783,92,33,83,0.398,27,68,0.397,6,15,0.4,28,32,0.875,100
2180,BOS,2017-11-16,92,,GSW,1,240,26,79,0.329,19,47,0.404,7,32,0.219,33,38,0.868,92,33,82,0.402,23,50,0.46,10,32,0.313,12,19,0.632,88
2181,OKC,2017-11-15,92,,CHI,1,240,26,72,0.361,18,42,0.429,8,30,0.267,32,37,0.865,92,26,75,0.347,15,46,0.326,11,29,0.379,16,20,0.8,79
2182,SAC,2017-11-13,92,@,WAS,0,240,34,84,0.405,22,61,0.361,12,23,0.522,12,18,0.667,92,44,86,0.512,33,52,0.635,11,34,0.324,11,12,0.917,110
2183,PHO,2017-11-06,92,,BRK,0,240,30,86,0.349,24,61,0.393,6,25,0.24,26,35,0.743,92,35,87,0.402,27,55,0.491,8,32,0.25,20,29,0.69,98
2184,SAS,2017-11-02,92,,GSW,0,240,34,87,0.391,27,63,0.429,7,24,0.292,17,23,0.739,92,43,83,0.518,29,55,0.527,14,28,0.5,12,16,0.75,112
2185,LAL,2017-10-27,92,,TOR,0,240,36,79,0.456,33,56,0.589,3,23,0.13,17,24,0.708,92,40,93,0.43,33,64,0.516,7,29,0.241,14,20,0.7,101
2186,PHI,2017-10-20,92,,BOS,0,240,35,92,0.38,25,60,0.417,10,32,0.313,12,16,0.75,92,35,84,0.417,25,55,0.455,10,29,0.345,22,32,0.688,102
2187,LAL,2017-10-19,92,,LAC,0,240,37,91,0.407,33,75,0.44,4,16,0.25,14,23,0.609,92,42,107,0.393,30,74,0.405,12,33,0.364,12,13,0.923,108
2188,ATL,2018-03-30,91,,PHI,0,240,36,101,0.356,27,62,0.435,9,39,0.231,10,15,0.667,91,42,95,0.442,34,57,0.596,8,38,0.211,9,13,0.692,101
2189,GSW,2018-03-25,91,,UTA,0,240,38,91,0.418,32,76,0.421,6,15,0.4,9,10,0.9,91,42,87,0.483,30,59,0.508,12,28,0.429,14,18,0.778,110
2190,NOP,2018-03-24,91,@,HOU,0,240,38,96,0.396,32,75,0.427,6,21,0.286,9,12,0.75,91,45,93,0.484,27,46,0.587,18,47,0.383,6,8,0.75,114
2191,LAL,2018-03-16,91,,MIA,0,240,32,76,0.421,23,57,0.404,9,19,0.474,18,22,0.818,91,36,94,0.383,26,58,0.448,10,36,0.278,10,14,0.714,92
2192,SAC,2018-03-03,91,,UTA,0,240,34,89,0.382,25,59,0.424,9,30,0.3,14,17,0.824,91,34,82,0.415,23,50,0.46,11,32,0.344,19,29,0.655,98
2193,SAC,2018-02-14,91,@,HOU,0,240,38,87,0.437,28,55,0.509,10,32,0.313,5,8,0.625,91,33,83,0.398,19,34,0.559,14,49,0.286,20,22,0.909,100
2194,MIA,2018-02-09,91,,MIL,1,240,32,88,0.364,22,62,0.355,10,26,0.385,17,18,0.944,91,32,76,0.421,26,56,0.464,6,20,0.3,15,17,0.882,85
2195,BOS,2018-02-09,91,,IND,0,240,34,89,0.382,27,62,0.435,7,27,0.259,16,20,0.8,91,37,83,0.446,32,63,0.508,5,20,0.25,18,22,0.818,97
2196,BOS,2018-02-06,91,@,TOR,0,240,33,83,0.398,23,60,0.383,10,23,0.435,15,20,0.75,91,40,80,0.5,23,44,0.523,17,36,0.472,14,17,0.824,111
2197,POR,2018-02-05,91,@,DET,0,240,37,94,0.394,27,61,0.443,10,33,0.303,7,8,0.875,91,44,88,0.5,29,58,0.5,15,30,0.5,8,12,0.667,111
2198,SAS,2018-02-01,91,,HOU,0,240,35,83,0.422,29,59,0.492,6,24,0.25,15,17,0.882,91,37,83,0.446,23,41,0.561,14,42,0.333,14,17,0.824,102
2199,CLE,2018-01-31,91,,MIA,1,240,28,80,0.35,22,54,0.407,6,26,0.231,29,38,0.763,91,36,83,0.434,33,55,0.6,3,28,0.107,14,25,0.56,89
2200,CHO,2018-01-27,91,@,MIA,0,240,29,84,0.345,24,60,0.4,5,24,0.208,28,35,0.8,91,38,85,0.447,30,59,0.508,8,26,0.308,11,18,0.611,95
2201,DEN,2018-01-27,91,,DAL,1,240,34,81,0.42,22,48,0.458,12,33,0.364,11,15,0.733,91,34,85,0.4,23,54,0.426,11,31,0.355,10,19,0.526,89
2202,BRK,2018-01-26,91,@,MIL,0,240,33,89,0.371,25,55,0.455,8,34,0.235,17,20,0.85,91,43,83,0.518,31,60,0.517,12,23,0.522,18,20,0.9,116
2203,DET,2018-01-17,91,@,TOR,0,240,37,88,0.42,27,60,0.45,10,28,0.357,7,15,0.467,91,34,80,0.425,23,49,0.469,11,31,0.355,17,23,0.739,96
2204,CHO,2018-01-13,91,,OKC,0,240,33,83,0.398,24,55,0.436,9,28,0.321,16,23,0.696,91,39,97,0.402,31,71,0.437,8,26,0.308,15,20,0.75,101
2205,UTA,2018-01-05,91,@,DEN,0,240,38,84,0.452,26,51,0.51,12,33,0.364,3,6,0.5,91,38,86,0.442,24,51,0.471,14,35,0.4,9,15,0.6,99
2206,BOS,2018-01-05,91,,MIN,1,240,38,94,0.404,32,58,0.552,6,36,0.167,9,13,0.692,91,28,76,0.368,21,53,0.396,7,23,0.304,21,28,0.75,84
2207,NYK,2018-01-02,91,,SAS,0,240,35,87,0.402,28,65,0.431,7,22,0.318,14,18,0.778,91,31,82,0.378,21,55,0.382,10,27,0.37,28,34,0.824,100
2208,CHO,2017-12-27,91,,BOS,0,240,32,87,0.368,25,64,0.391,7,23,0.304,20,29,0.69,91,37,78,0.474,22,44,0.5,15,34,0.441,13,13,1.0,102
2209,POR,2017-12-20,91,,SAS,0,240,38,96,0.396,32,71,0.451,6,25,0.24,9,14,0.643,91,41,79,0.519,35,62,0.565,6,17,0.353,5,6,0.833,93
2210,LAC,2017-12-18,91,@,SAS,0,240,37,84,0.44,28,55,0.509,9,29,0.31,8,16,0.5,91,40,82,0.488,31,58,0.534,9,24,0.375,20,25,0.8,109
2211,DAL,2017-12-18,91,,PHO,0,240,32,88,0.364,21,51,0.412,11,37,0.297,16,17,0.941,91,35,79,0.443,25,54,0.463,10,25,0.4,17,22,0.773,97
2212,NYK,2017-12-18,91,@,CHO,0,240,36,86,0.419,33,68,0.485,3,18,0.167,16,20,0.8,91,43,88,0.489,34,68,0.5,9,20,0.45,14,16,0.875,109
2213,CHO,2017-12-16,91,,POR,0,240,33,96,0.344,26,65,0.4,7,31,0.226,18,28,0.643,91,37,79,0.468,27,55,0.491,10,24,0.417,9,18,0.5,93
2214,LAC,2017-12-15,91,@,WAS,0,240,33,86,0.384,26,62,0.419,7,24,0.292,18,29,0.621,91,39,88,0.443,32,57,0.561,7,31,0.226,15,23,0.652,100
2215,ATL,2017-12-14,91,,DET,0,240,32,70,0.457,21,39,0.538,11,31,0.355,16,26,0.615,91,41,90,0.456,28,60,0.467,13,30,0.433,10,12,0.833,105
2216,TOR,2017-12-11,91,@,LAC,0,240,32,80,0.4,25,51,0.49,7,29,0.241,20,26,0.769,91,34,92,0.37,26,56,0.464,8,36,0.222,20,24,0.833,96
2217,BOS,2017-12-10,91,@,DET,1,240,33,79,0.418,22,49,0.449,11,30,0.367,14,18,0.778,91,28,84,0.333,18,51,0.353,10,33,0.303,15,19,0.789,81
2218,CHI,2017-12-04,91,,CLE,0,240,34,82,0.415,25,48,0.521,9,34,0.265,14,18,0.778,91,42,81,0.519,29,45,0.644,13,36,0.361,16,17,0.941,113
2219,DET,2017-12-01,91,@,WAS,0,240,35,79,0.443,26,49,0.531,9,30,0.3,12,19,0.632,91,43,89,0.483,36,68,0.529,7,21,0.333,16,19,0.842,109
2220,POR,2017-11-30,91,,MIL,0,240,35,83,0.422,29,60,0.483,6,23,0.261,15,17,0.882,91,42,87,0.483,36,67,0.537,6,20,0.3,13,15,0.867,103
2221,NYK,2017-11-27,91,,POR,0,240,35,88,0.398,30,73,0.411,5,15,0.333,16,22,0.727,91,37,83,0.446,30,62,0.484,7,21,0.333,22,26,0.846,103
2222,PHI,2017-11-27,91,,CLE,0,240,36,96,0.375,33,68,0.485,3,28,0.107,16,20,0.8,91,41,86,0.477,26,49,0.531,15,37,0.405,16,20,0.8,113
2223,PHO,2017-11-24,91,,NOP,0,240,37,94,0.394,35,74,0.473,2,20,0.1,15,18,0.833,91,45,91,0.495,36,64,0.563,9,27,0.333,16,22,0.727,115
2224,GSW,2017-11-22,91,@,OKC,0,240,33,80,0.413,23,49,0.469,10,31,0.323,15,18,0.833,91,41,90,0.456,33,65,0.508,8,25,0.32,18,26,0.692,108
2225,WAS,2017-11-19,91,@,TOR,0,240,34,81,0.42,23,62,0.371,11,19,0.579,12,21,0.571,91,40,90,0.444,30,51,0.588,10,39,0.256,10,14,0.714,100
2226,MIA,2017-11-17,91,@,WAS,1,240,34,83,0.41,24,48,0.5,10,35,0.286,13,18,0.722,91,32,84,0.381,22,49,0.449,10,35,0.286,14,16,0.875,88
2227,DAL,2017-11-14,91,,SAS,0,240,33,81,0.407,23,47,0.489,10,34,0.294,15,18,0.833,91,35,79,0.443,29,53,0.547,6,26,0.231,21,27,0.778,97
2228,SAC,2017-11-11,91,@,NYK,0,240,30,80,0.375,23,58,0.397,7,22,0.318,24,30,0.8,91,47,90,0.522,35,63,0.556,12,27,0.444,12,15,0.8,118
2229,CHI,2017-11-01,91,@,MIA,0,240,36,89,0.404,29,61,0.475,7,28,0.25,12,19,0.632,91,34,83,0.41,22,52,0.423,12,31,0.387,17,19,0.895,97
2230,MIL,2017-10-31,91,,OKC,0,240,32,77,0.416,23,46,0.5,9,31,0.29,18,22,0.818,91,40,81,0.494,28,53,0.528,12,28,0.429,18,21,0.857,110
2231,DAL,2017-10-26,91,@,MEM,0,240,32,94,0.34,22,60,0.367,10,34,0.294,17,20,0.85,91,30,73,0.411,20,39,0.513,10,34,0.294,26,30,0.867,96
2232,CHI,2017-10-26,91,,ATL,1,240,31,86,0.36,24,54,0.444,7,32,0.219,22,29,0.759,91,32,81,0.395,21,53,0.396,11,28,0.393,11,13,0.846,86
2233,DAL,2017-10-21,91,@,HOU,0,240,31,84,0.369,18,53,0.34,13,31,0.419,16,21,0.762,91,39,82,0.476,28,35,0.8,11,47,0.234,18,22,0.818,107
2234,ATL,2017-10-20,91,@,CHO,0,240,36,95,0.379,29,65,0.446,7,30,0.233,12,14,0.857,91,37,86,0.43,26,50,0.52,11,36,0.306,24,30,0.8,109
2235,NOP,2017-10-18,91,@,MEM,0,240,30,79,0.38,23,54,0.426,7,25,0.28,24,29,0.828,91,39,92,0.424,30,63,0.476,9,29,0.31,16,28,0.571,103
2236,CHI,2018-03-30,90,@,ORL,1,240,30,84,0.357,16,43,0.372,14,41,0.341,16,23,0.696,90,31,94,0.33,24,55,0.436,7,39,0.179,13,14,0.929,82
2237,ATL,2018-03-22,90,@,SAC,0,240,33,84,0.393,21,48,0.438,12,36,0.333,12,18,0.667,90,43,93,0.462,33,72,0.458,10,21,0.476,9,9,1.0,105
2238,WAS,2018-03-21,90,@,SAS,0,240,35,83,0.422,27,58,0.466,8,25,0.32,12,16,0.75,90,39,79,0.494,32,56,0.571,7,23,0.304,13,18,0.722,98
2239,SAC,2018-03-19,90,,DET,0,240,40,88,0.455,34,65,0.523,6,23,0.261,4,9,0.444,90,37,79,0.468,23,50,0.46,14,29,0.483,18,22,0.818,106
2240,ATL,2018-03-06,90,@,TOR,0,240,34,80,0.425,28,59,0.475,6,21,0.286,16,21,0.762,90,34,88,0.386,24,52,0.462,10,36,0.278,28,33,0.848,106
2241,DET,2018-03-05,90,@,CLE,0,240,34,87,0.391,22,53,0.415,12,34,0.353,10,15,0.667,90,43,88,0.489,31,55,0.564,12,33,0.364,14,17,0.824,112
2242,DAL,2018-02-24,90,@,UTA,0,240,34,83,0.41,24,48,0.5,10,35,0.286,12,14,0.857,90,34,85,0.4,25,53,0.472,9,32,0.281,20,26,0.769,97
2243,CHI,2018-02-10,90,,WAS,0,240,34,80,0.425,25,48,0.521,9,32,0.281,13,16,0.813,90,38,82,0.463,25,44,0.568,13,38,0.342,12,14,0.857,101
2244,NYK,2018-02-02,90,@,MIL,0,240,36,89,0.404,31,64,0.484,5,25,0.2,13,17,0.765,90,33,76,0.434,26,52,0.5,7,24,0.292,19,26,0.731,92
2245,MIA,2018-01-22,90,@,HOU,0,240,39,82,0.476,32,52,0.615,7,30,0.233,5,9,0.556,90,36,81,0.444,21,44,0.477,15,37,0.405,12,18,0.667,99
2246,UTA,2018-01-22,90,@,ATL,0,240,33,76,0.434,29,61,0.475,4,15,0.267,20,28,0.714,90,40,83,0.482,28,57,0.491,12,26,0.462,12,12,1.0,104
2247,LAL,2018-01-17,90,@,OKC,0,240,38,81,0.469,28,55,0.509,10,26,0.385,4,4,1.0,90,46,95,0.484,34,60,0.567,12,35,0.343,10,12,0.833,114
2248,MIA,2018-01-09,90,@,TOR,1,240,39,97,0.402,35,75,0.467,4,22,0.182,8,10,0.8,90,35,90,0.389,28,69,0.406,7,21,0.333,12,15,0.8,89
2249,IND,2017-12-31,90,,MIN,0,240,33,85,0.388,23,60,0.383,10,25,0.4,14,18,0.778,90,41,86,0.477,37,67,0.552,4,19,0.211,21,25,0.84,107
2250,MIA,2017-12-20,90,@,BOS,1,240,33,75,0.44,23,47,0.489,10,28,0.357,14,25,0.56,90,30,80,0.375,17,48,0.354,13,32,0.406,16,21,0.762,89
2251,MIA,2017-12-16,90,,LAC,1,240,31,82,0.378,19,47,0.404,12,35,0.343,16,21,0.762,90,35,80,0.438,27,52,0.519,8,28,0.286,7,14,0.5,85
2252,DAL,2017-12-06,90,@,BOS,0,240,34,86,0.395,25,58,0.431,9,28,0.321,13,17,0.765,90,36,87,0.414,24,53,0.453,12,34,0.353,13,17,0.765,97
2253,ATL,2017-12-04,90,,BRK,0,240,30,82,0.366,21,52,0.404,9,30,0.3,21,27,0.778,90,41,85,0.482,26,49,0.531,15,36,0.417,13,15,0.867,110
2254,OKC,2017-12-03,90,,SAS,1,240,37,87,0.425,31,65,0.477,6,22,0.273,10,21,0.476,90,31,76,0.408,23,48,0.479,8,28,0.286,17,23,0.739,87
2255,SAS,2017-11-22,90,@,NOP,0,240,35,88,0.398,29,64,0.453,6,24,0.25,14,15,0.933,90,39,81,0.481,32,57,0.561,7,24,0.292,22,24,0.917,107
2256,SAC,2017-11-18,90,@,POR,0,240,34,89,0.382,26,72,0.361,8,17,0.471,14,18,0.778,90,38,70,0.543,28,49,0.571,10,21,0.476,16,21,0.762,102
2257,LAL,2017-11-11,90,@,MIL,0,240,31,74,0.419,25,52,0.481,6,22,0.273,22,37,0.595,90,35,85,0.412,29,62,0.468,6,23,0.261,22,26,0.846,98
2258,BOS,2017-11-10,90,,CHO,1,240,30,84,0.357,21,53,0.396,9,31,0.29,21,25,0.84,90,31,80,0.388,25,58,0.431,6,22,0.273,19,33,0.576,87
2259,CHI,2017-11-04,90,,NOP,0,265,35,99,0.354,24,57,0.421,11,42,0.262,9,12,0.75,90,35,87,0.402,26,56,0.464,9,31,0.29,17,22,0.773,96
2260,MIA,2017-10-28,90,,BOS,0,240,34,79,0.43,27,48,0.563,7,31,0.226,15,16,0.938,90,34,81,0.42,28,58,0.483,6,23,0.261,22,26,0.846,96
2261,HOU,2017-10-23,90,,MEM,0,240,32,77,0.416,23,39,0.59,9,38,0.237,17,23,0.739,90,29,68,0.426,23,49,0.469,6,19,0.316,34,37,0.919,98
2262,CHO,2017-10-18,90,@,DET,0,240,29,73,0.397,20,43,0.465,9,30,0.3,23,29,0.793,90,41,96,0.427,32,70,0.457,9,26,0.346,11,12,0.917,102
2263,SAS,2018-03-19,89,,GSW,1,240,33,82,0.402,25,59,0.424,8,23,0.348,15,21,0.714,89,30,74,0.405,27,55,0.491,3,19,0.158,12,16,0.75,75
2264,BOS,2018-03-18,89,@,NOP,0,240,35,87,0.402,26,61,0.426,9,26,0.346,10,20,0.5,89,41,82,0.5,35,64,0.547,6,18,0.333,20,25,0.8,108
2265,MIL,2018-03-05,89,@,IND,0,240,34,76,0.447,27,53,0.509,7,23,0.304,14,16,0.875,89,33,77,0.429,23,60,0.383,10,17,0.588,16,21,0.762,92
2266,CHI,2018-03-05,89,,BOS,0,240,32,81,0.395,20,48,0.417,12,33,0.364,13,20,0.65,89,41,84,0.488,29,48,0.604,12,36,0.333,11,12,0.917,105
2267,MEM,2018-02-24,89,@,MIA,0,240,35,80,0.438,30,69,0.435,5,11,0.455,14,17,0.824,89,41,89,0.461,29,56,0.518,12,33,0.364,21,27,0.778,115
2268,MEM,2018-02-23,89,,CLE,0,240,33,84,0.393,24,60,0.4,9,24,0.375,14,18,0.778,89,40,87,0.46,29,58,0.5,11,29,0.379,21,22,0.955,112
2269,NYK,2018-02-06,89,,MIL,0,240,37,89,0.416,32,66,0.485,5,23,0.217,10,15,0.667,89,37,82,0.451,29,56,0.518,8,26,0.308,21,27,0.778,103
2270,MIL,2018-02-01,89,@,MIN,0,240,32,85,0.376,26,56,0.464,6,29,0.207,19,25,0.76,89,42,78,0.538,35,59,0.593,7,19,0.368,17,20,0.85,108
2271,MIA,2018-01-31,89,@,CLE,0,240,36,83,0.434,33,55,0.6,3,28,0.107,14,25,0.56,89,28,80,0.35,22,54,0.407,6,26,0.231,29,38,0.763,91
2272,DAL,2018-01-27,89,@,DEN,0,240,34,85,0.4,23,54,0.426,11,31,0.355,10,19,0.526,89,34,81,0.42,22,48,0.458,12,33,0.364,11,15,0.733,91
2273,SAC,2018-01-25,89,@,MIA,1,240,38,81,0.469,33,69,0.478,5,12,0.417,8,14,0.571,89,31,82,0.378,19,48,0.396,12,34,0.353,14,18,0.778,88
2274,PHI,2018-01-18,89,@,BOS,1,240,34,73,0.466,28,56,0.5,6,17,0.353,15,17,0.882,89,30,74,0.405,23,45,0.511,7,29,0.241,13,17,0.765,80
2275,TOR,2018-01-09,89,,MIA,0,240,35,90,0.389,28,69,0.406,7,21,0.333,12,15,0.8,89,39,97,0.402,35,75,0.467,4,22,0.182,8,10,0.8,90
2276,PHO,2018-01-05,89,@,SAS,0,240,35,83,0.422,28,53,0.528,7,30,0.233,12,18,0.667,89,41,87,0.471,30,57,0.526,11,30,0.367,10,18,0.556,103
2277,ATL,2018-01-05,89,@,POR,0,240,30,83,0.361,22,57,0.386,8,26,0.308,21,25,0.84,89,43,80,0.538,30,50,0.6,13,30,0.433,11,14,0.786,110
2278,POR,2017-12-30,89,@,ATL,0,240,36,85,0.424,29,60,0.483,7,25,0.28,10,13,0.769,89,40,89,0.449,26,59,0.441,14,30,0.467,10,15,0.667,104
2279,DET,2017-12-28,89,@,ORL,0,240,35,87,0.402,26,64,0.406,9,23,0.391,10,14,0.714,89,37,82,0.451,26,56,0.464,11,26,0.423,17,17,1.0,102
2280,ORL,2017-12-26,89,@,MIA,0,240,33,81,0.407,28,61,0.459,5,20,0.25,18,22,0.818,89,41,91,0.451,30,58,0.517,11,33,0.333,14,17,0.824,107
2281,UTA,2017-12-23,89,,OKC,0,240,33,72,0.458,27,46,0.587,6,26,0.231,17,20,0.85,89,39,88,0.443,27,59,0.458,12,29,0.414,13,16,0.813,103
2282,SAS,2017-12-21,89,@,UTA,0,240,34,78,0.436,24,57,0.421,10,21,0.476,11,16,0.688,89,34,74,0.459,22,48,0.458,12,26,0.462,20,24,0.833,100
2283,BOS,2017-12-20,89,,MIA,0,240,30,80,0.375,17,48,0.354,13,32,0.406,16,21,0.762,89,33,75,0.44,23,47,0.489,10,28,0.357,14,25,0.56,90
2284,SAS,2017-12-12,89,@,DAL,0,240,35,87,0.402,28,59,0.475,7,28,0.25,12,19,0.632,89,38,89,0.427,29,65,0.446,9,24,0.375,10,12,0.833,95
2285,BRK,2017-12-09,89,,MIA,0,240,33,81,0.407,26,54,0.481,7,27,0.259,16,19,0.842,89,42,90,0.467,34,63,0.54,8,27,0.296,9,14,0.643,101
2286,ORL,2017-12-08,89,,DEN,0,240,33,83,0.398,28,62,0.452,5,21,0.238,18,23,0.783,89,42,85,0.494,36,64,0.563,6,21,0.286,13,16,0.813,103
2287,MIN,2017-11-28,89,,WAS,0,240,35,85,0.412,25,55,0.455,10,30,0.333,9,14,0.643,89,36,83,0.434,26,55,0.473,10,28,0.357,10,17,0.588,92
2288,DAL,2017-10-30,89,@,UTA,0,240,34,76,0.447,22,52,0.423,12,24,0.5,9,11,0.818,89,38,81,0.469,22,46,0.478,16,35,0.457,12,15,0.8,104
2289,HOU,2017-10-28,89,@,MEM,0,240,29,77,0.377,15,39,0.385,14,38,0.368,17,21,0.81,89,40,85,0.471,26,52,0.5,14,33,0.424,9,12,0.75,103
2290,MIL,2017-10-26,89,,BOS,0,240,35,77,0.455,24,52,0.462,11,25,0.44,8,14,0.571,89,33,78,0.423,22,48,0.458,11,30,0.367,19,22,0.864,96
2291,NYK,2017-10-24,89,@,BOS,0,240,36,85,0.424,35,73,0.479,1,12,0.083,16,25,0.64,89,37,75,0.493,23,46,0.5,14,29,0.483,22,27,0.815,110
2292,DEN,2018-04-09,88,,POR,1,240,31,83,0.373,25,57,0.439,6,26,0.231,20,26,0.769,88,31,94,0.33,24,61,0.393,7,33,0.212,13,18,0.722,82
2293,ORL,2018-04-01,88,@,ATL,0,240,33,96,0.344,23,60,0.383,10,36,0.278,12,13,0.923,88,41,85,0.482,30,49,0.612,11,36,0.306,1,1,1.0,94
2294,PHO,2018-03-20,88,,DET,0,240,34,90,0.378,27,56,0.482,7,34,0.206,13,20,0.65,88,43,97,0.443,28,61,0.459,15,36,0.417,14,16,0.875,115
2295,PHO,2018-03-15,88,@,UTA,0,240,32,83,0.386,25,67,0.373,7,16,0.438,17,24,0.708,88,42,97,0.433,30,61,0.492,12,36,0.333,20,32,0.625,116
2296,ORL,2018-03-09,88,@,SAC,0,240,33,78,0.423,24,49,0.49,9,29,0.31,13,16,0.813,88,36,83,0.434,27,58,0.466,9,25,0.36,13,15,0.867,94
2297,NYK,2018-02-08,88,@,TOR,0,240,33,83,0.398,26,56,0.464,7,27,0.259,15,18,0.833,88,43,95,0.453,27,52,0.519,16,43,0.372,11,14,0.786,113
2298,MEM,2018-02-07,88,,UTA,0,240,34,81,0.42,26,58,0.448,8,23,0.348,12,16,0.75,88,29,69,0.42,23,47,0.489,6,22,0.273,28,33,0.848,92
2299,CLE,2018-02-03,88,,HOU,0,240,34,87,0.391,26,57,0.456,8,30,0.267,12,16,0.75,88,44,93,0.473,25,42,0.595,19,51,0.373,13,16,0.813,120
2300,DAL,2018-01-31,88,@,PHO,0,240,32,88,0.364,22,52,0.423,10,36,0.278,14,26,0.538,88,40,83,0.482,29,53,0.547,11,30,0.367,11,15,0.733,102
2301,DAL,2018-01-29,88,,MIA,0,240,33,86,0.384,25,57,0.439,8,29,0.276,14,16,0.875,88,34,75,0.453,22,44,0.5,12,31,0.387,15,19,0.789,95
2302,MIA,2018-01-25,88,,SAC,0,240,31,82,0.378,19,48,0.396,12,34,0.353,14,18,0.778,88,38,81,0.469,33,69,0.478,5,12,0.417,8,14,0.571,89
2303,SAC,2018-01-19,88,@,MEM,0,240,32,80,0.4,21,53,0.396,11,27,0.407,13,18,0.722,88,39,88,0.443,29,54,0.537,10,34,0.294,18,23,0.783,106
2304,SAC,2018-01-15,88,@,OKC,0,240,33,84,0.393,26,54,0.481,7,30,0.233,15,25,0.6,88,36,86,0.419,27,56,0.482,9,30,0.3,14,29,0.483,95
2305,UTA,2018-01-12,88,@,CHO,0,240,28,77,0.364,16,42,0.381,12,35,0.343,20,23,0.87,88,32,78,0.41,23,51,0.451,9,27,0.333,26,34,0.765,99
2306,OKC,2018-01-10,88,@,MIN,0,240,32,80,0.4,26,55,0.473,6,25,0.24,18,24,0.75,88,39,80,0.488,32,60,0.533,7,20,0.35,19,27,0.704,104
2307,CLE,2018-01-03,88,@,BOS,0,240,31,89,0.348,23,57,0.404,8,32,0.25,18,18,1.0,88,41,92,0.446,29,56,0.518,12,36,0.333,8,11,0.727,102
2308,ORL,2017-12-15,88,,POR,0,240,32,84,0.381,22,55,0.4,10,29,0.345,14,19,0.737,88,37,86,0.43,29,68,0.426,8,18,0.444,13,15,0.867,95
2309,MEM,2017-12-06,88,@,NYK,0,240,29,70,0.414,17,42,0.405,12,28,0.429,18,22,0.818,88,35,67,0.522,26,53,0.491,9,14,0.643,20,27,0.741,99
2310,MEM,2017-11-26,88,,BRK,0,240,32,80,0.4,24,55,0.436,8,25,0.32,16,18,0.889,88,33,74,0.446,20,45,0.444,13,29,0.448,19,23,0.826,98
2311,MIL,2017-11-20,88,,WAS,0,240,35,79,0.443,31,57,0.544,4,22,0.182,14,19,0.737,88,39,74,0.527,30,50,0.6,9,24,0.375,12,17,0.706,99
2312,DET,2017-11-20,88,,CLE,0,240,34,77,0.442,21,47,0.447,13,30,0.433,7,13,0.538,88,42,80,0.525,26,47,0.553,16,33,0.485,16,17,0.941,116
2313,WAS,2017-11-17,88,,MIA,0,240,32,84,0.381,22,49,0.449,10,35,0.286,14,16,0.875,88,34,83,0.41,24,48,0.5,10,35,0.286,13,18,0.722,91
2314,GSW,2017-11-16,88,@,BOS,0,240,33,82,0.402,23,50,0.46,10,32,0.313,12,19,0.632,88,26,79,0.329,19,47,0.404,7,32,0.219,33,38,0.868,92
2315,ORL,2017-11-05,88,,BOS,0,240,33,91,0.363,27,62,0.435,6,29,0.207,16,18,0.889,88,39,89,0.438,28,56,0.5,11,33,0.333,15,20,0.75,104
2316,UTA,2017-10-25,88,@,PHO,0,240,32,77,0.416,26,52,0.5,6,25,0.24,18,25,0.72,88,42,96,0.438,36,77,0.468,6,19,0.316,7,9,0.778,97
2317,PHO,2017-10-21,88,@,LAC,0,240,27,71,0.38,21,47,0.447,6,24,0.25,28,38,0.737,88,48,88,0.545,36,62,0.581,12,26,0.462,22,30,0.733,130
2318,DAL,2017-10-20,88,,SAC,0,240,31,75,0.413,20,42,0.476,11,33,0.333,15,21,0.714,88,37,87,0.425,27,64,0.422,10,23,0.435,9,13,0.692,93
2319,CHI,2018-04-11,87,,DET,0,240,32,86,0.372,21,52,0.404,11,34,0.324,12,18,0.667,87,47,89,0.528,32,54,0.593,15,35,0.429,10,10,1.0,119
2320,DAL,2018-04-01,87,@,CLE,0,240,32,79,0.405,19,42,0.452,13,37,0.351,10,11,0.909,87,35,85,0.412,24,59,0.407,11,26,0.423,17,23,0.739,98
2321,DET,2018-03-17,87,@,POR,0,240,31,80,0.388,21,55,0.382,10,25,0.4,15,20,0.75,87,38,87,0.437,30,56,0.536,8,31,0.258,16,18,0.889,100
2322,ATL,2018-03-09,87,@,IND,0,240,34,82,0.415,24,49,0.49,10,33,0.303,9,10,0.9,87,45,91,0.495,31,63,0.492,14,28,0.5,8,10,0.8,112
2323,PHO,2018-03-08,87,@,OKC,0,240,31,92,0.337,22,55,0.4,9,37,0.243,16,18,0.889,87,42,80,0.525,29,47,0.617,13,33,0.394,18,27,0.667,115
2324,NYK,2018-03-06,87,@,POR,0,240,35,83,0.422,28,64,0.438,7,19,0.368,10,15,0.667,87,35,81,0.432,15,48,0.313,20,33,0.606,21,24,0.875,111
2325,MIL,2018-02-28,87,@,DET,0,240,28,73,0.384,20,49,0.408,8,24,0.333,23,28,0.821,87,42,95,0.442,33,66,0.5,9,29,0.31,17,22,0.773,110
2326,CHI,2018-02-26,87,@,BRK,0,240,33,93,0.355,27,70,0.386,6,23,0.261,15,23,0.652,87,40,90,0.444,24,48,0.5,16,42,0.381,8,8,1.0,104
2327,DEN,2018-01-12,87,,MEM,1,240,27,70,0.386,20,48,0.417,7,22,0.318,26,32,0.813,87,30,77,0.39,23,53,0.434,7,24,0.292,11,14,0.786,78
2328,BOS,2018-01-06,87,@,BRK,1,240,37,98,0.378,32,80,0.4,5,18,0.278,8,15,0.533,87,30,91,0.33,24,60,0.4,6,31,0.194,19,22,0.864,85
2329,MIA,2017-12-29,87,,BRK,0,240,30,89,0.337,27,63,0.429,3,26,0.115,24,31,0.774,87,39,79,0.494,28,53,0.528,11,26,0.423,22,25,0.88,111
2330,NYK,2017-12-27,87,@,CHI,0,240,37,91,0.407,33,68,0.485,4,23,0.174,9,13,0.692,87,35,86,0.407,25,58,0.431,10,28,0.357,12,16,0.75,92
2331,BRK,2017-12-15,87,@,TOR,0,240,32,76,0.421,25,53,0.472,7,23,0.304,16,19,0.842,87,54,97,0.557,47,69,0.681,7,28,0.25,5,9,0.556,120
2332,MEM,2017-12-13,87,@,WAS,0,240,31,81,0.383,21,53,0.396,10,28,0.357,15,16,0.938,87,36,77,0.468,27,55,0.491,9,22,0.409,12,24,0.5,93
2333,SAC,2017-12-10,87,,TOR,0,240,35,73,0.479,25,50,0.5,10,23,0.435,7,14,0.5,87,39,87,0.448,28,50,0.56,11,37,0.297,13,19,0.684,102
2334,CHO,2017-12-06,87,,GSW,0,240,34,97,0.351,28,78,0.359,6,19,0.316,13,17,0.765,87,40,84,0.476,29,54,0.537,11,30,0.367,10,13,0.769,101
2335,SAS,2017-12-03,87,@,OKC,0,240,31,76,0.408,23,48,0.479,8,28,0.286,17,23,0.739,87,37,87,0.425,31,65,0.477,6,22,0.273,10,21,0.476,90
2336,SAC,2017-11-28,87,,MIL,0,240,31,77,0.403,26,60,0.433,5,17,0.294,20,29,0.69,87,42,71,0.592,33,49,0.673,9,22,0.409,19,31,0.613,112
2337,LAC,2017-11-18,87,@,CHO,0,240,33,83,0.398,25,54,0.463,8,29,0.276,13,19,0.684,87,34,87,0.391,23,61,0.377,11,26,0.423,23,29,0.793,102
2338,DAL,2017-11-17,87,,MIN,0,240,32,86,0.372,24,48,0.5,8,38,0.211,15,17,0.882,87,39,84,0.464,26,54,0.481,13,30,0.433,20,23,0.87,111
2339,SAS,2017-11-10,87,,MIL,0,240,34,80,0.425,25,51,0.49,9,29,0.31,10,11,0.909,87,41,89,0.461,36,71,0.507,5,18,0.278,7,14,0.5,94
2340,CHI,2017-11-10,87,,IND,0,240,37,93,0.398,30,66,0.455,7,27,0.259,6,9,0.667,87,43,84,0.512,31,55,0.564,12,29,0.414,7,12,0.583,105
2341,CHO,2017-11-10,87,@,BOS,0,240,31,80,0.388,25,58,0.431,6,22,0.273,19,33,0.576,87,30,84,0.357,21,53,0.396,9,31,0.29,21,25,0.84,90
2342,LAC,2017-10-28,87,,DET,0,240,28,84,0.333,13,46,0.283,15,38,0.395,16,22,0.727,87,36,88,0.409,27,60,0.45,9,28,0.321,14,21,0.667,95
2343,SAS,2017-10-27,87,@,ORL,0,240,30,89,0.337,26,65,0.4,4,24,0.167,23,27,0.852,87,48,84,0.571,37,61,0.607,11,23,0.478,7,14,0.5,114
2344,OKC,2017-10-21,87,@,UTA,0,240,32,78,0.41,21,45,0.467,11,33,0.333,12,19,0.632,87,38,77,0.494,29,48,0.604,9,29,0.31,11,14,0.786,96
2345,SAS,2017-10-21,87,@,CHI,1,240,38,93,0.409,37,81,0.457,1,12,0.083,10,16,0.625,87,31,82,0.378,23,54,0.426,8,28,0.286,7,9,0.778,77
2346,ORL,2018-04-09,86,@,MIL,0,240,34,82,0.415,29,58,0.5,5,24,0.208,13,20,0.65,86,39,91,0.429,30,65,0.462,9,26,0.346,15,18,0.833,102
2347,ATL,2018-04-04,86,,MIA,0,240,33,90,0.367,24,60,0.4,9,30,0.3,11,17,0.647,86,42,94,0.447,25,56,0.446,17,38,0.447,14,17,0.824,115
2348,CHI,2018-03-27,86,@,HOU,0,240,34,89,0.382,26,52,0.5,8,37,0.216,10,17,0.588,86,41,93,0.441,23,36,0.639,18,57,0.316,18,21,0.857,118
2349,ORL,2018-03-20,86,,TOR,0,240,37,90,0.411,28,65,0.431,9,25,0.36,3,5,0.6,86,35,77,0.455,21,41,0.512,14,36,0.389,9,17,0.529,93
2350,MEM,2018-02-04,86,@,TOR,0,240,29,81,0.358,21,56,0.375,8,25,0.32,20,23,0.87,86,41,89,0.461,35,54,0.648,6,35,0.171,13,15,0.867,101
2351,SAS,2018-01-21,86,,IND,0,240,35,82,0.427,26,48,0.542,9,34,0.265,7,12,0.583,86,37,84,0.44,33,65,0.508,4,19,0.211,16,17,0.941,94
2352,TOR,2018-01-19,86,,SAS,1,240,34,85,0.4,25,59,0.424,9,26,0.346,9,14,0.643,86,31,91,0.341,26,71,0.366,5,20,0.25,16,20,0.8,83
2353,IND,2018-01-19,86,@,LAL,0,240,37,97,0.381,35,72,0.486,2,25,0.08,10,13,0.769,86,44,80,0.55,35,52,0.673,9,28,0.321,2,14,0.143,99
2354,IND,2018-01-18,86,@,POR,0,240,36,91,0.396,29,65,0.446,7,26,0.269,7,13,0.538,86,37,94,0.394,27,62,0.435,10,32,0.313,16,16,1.0,100
2355,SAC,2018-01-09,86,@,LAL,0,240,30,87,0.345,22,66,0.333,8,21,0.381,18,27,0.667,86,37,77,0.481,25,42,0.595,12,35,0.343,13,21,0.619,99
2356,CHI,2018-01-06,86,@,IND,0,240,30,80,0.375,20,48,0.417,10,32,0.313,16,20,0.8,86,48,86,0.558,33,55,0.6,15,31,0.484,14,18,0.778,125
2357,PHI,2017-12-23,86,@,TOR,0,240,33,80,0.413,26,53,0.491,7,27,0.259,13,20,0.65,86,35,85,0.412,26,58,0.448,9,27,0.333,23,26,0.885,102
2358,MIA,2017-11-29,86,@,NYK,0,240,32,84,0.381,22,46,0.478,10,38,0.263,12,20,0.6,86,44,73,0.603,39,60,0.65,5,13,0.385,22,26,0.846,115
2359,CHO,2017-11-25,86,,SAS,0,240,31,84,0.369,27,59,0.458,4,25,0.16,20,26,0.769,86,39,81,0.481,33,56,0.589,6,25,0.24,22,25,0.88,106
2360,UTA,2017-11-20,86,@,PHI,0,240,30,85,0.353,21,57,0.368,9,28,0.321,17,19,0.895,86,44,85,0.518,40,70,0.571,4,15,0.267,15,22,0.682,107
2361,SAC,2017-11-17,86,,POR,1,240,36,85,0.424,32,71,0.451,4,14,0.286,10,15,0.667,86,30,81,0.37,23,56,0.411,7,25,0.28,15,16,0.938,82
2362,SAS,2017-11-15,86,@,MIN,0,240,33,79,0.418,26,55,0.473,7,24,0.292,13,15,0.867,86,39,87,0.448,30,69,0.435,9,18,0.5,11,16,0.688,98
2363,OKC,2017-11-07,86,@,SAC,0,240,29,86,0.337,19,49,0.388,10,37,0.27,18,23,0.783,86,37,79,0.468,28,55,0.509,9,24,0.375,11,12,0.917,94
2364,SAC,2017-11-01,86,@,BOS,0,240,35,81,0.432,29,61,0.475,6,20,0.3,10,12,0.833,86,40,82,0.488,23,41,0.561,17,41,0.415,16,19,0.842,113
2365,BRK,2017-10-27,86,@,NYK,0,240,30,75,0.4,19,45,0.422,11,30,0.367,15,21,0.714,86,44,98,0.449,35,71,0.493,9,27,0.333,10,17,0.588,107
2366,ATL,2017-10-26,86,@,CHI,0,240,32,81,0.395,21,53,0.396,11,28,0.393,11,13,0.846,86,31,86,0.36,24,54,0.444,7,32,0.219,22,29,0.759,91
2367,DET,2017-10-23,86,,PHI,0,240,33,85,0.388,27,55,0.491,6,30,0.2,14,19,0.737,86,35,75,0.467,26,51,0.51,9,24,0.375,18,24,0.75,97
2368,SAC,2018-04-09,85,@,SAS,0,240,33,81,0.407,25,63,0.397,8,18,0.444,11,17,0.647,85,34,82,0.415,28,55,0.509,6,27,0.222,24,29,0.828,98
2369,UTA,2018-02-26,85,,HOU,0,240,31,71,0.437,24,42,0.571,7,29,0.241,16,22,0.727,85,34,79,0.43,25,46,0.543,9,33,0.273,19,25,0.76,96
2370,MIL,2018-02-09,85,@,MIA,0,240,32,76,0.421,26,56,0.464,6,20,0.3,15,17,0.882,85,32,88,0.364,22,62,0.355,10,26,0.385,17,18,0.944,91
2371,PHO,2018-01-26,85,,NYK,0,240,33,94,0.351,22,61,0.361,11,33,0.333,8,13,0.615,85,41,85,0.482,32,60,0.533,9,25,0.36,16,22,0.727,107
2372,MEM,2018-01-24,85,,SAS,0,240,36,83,0.434,34,65,0.523,2,18,0.111,11,14,0.786,85,38,82,0.463,28,58,0.483,10,24,0.417,22,25,0.88,108
2373,BRK,2018-01-06,85,,BOS,0,240,30,91,0.33,24,60,0.4,6,31,0.194,19,22,0.864,85,37,98,0.378,32,80,0.4,5,18,0.278,8,15,0.533,87
2374,POR,2017-12-22,85,,DEN,0,240,35,83,0.422,29,61,0.475,6,22,0.273,9,16,0.563,85,42,85,0.494,35,60,0.583,7,25,0.28,11,15,0.733,102
2375,LAC,2017-12-16,85,@,MIA,0,240,35,80,0.438,27,52,0.519,8,28,0.286,7,14,0.5,85,31,82,0.378,19,47,0.404,12,35,0.343,16,21,0.762,90
2376,BOS,2017-12-11,85,@,CHI,0,240,33,83,0.398,23,43,0.535,10,40,0.25,9,14,0.643,85,39,81,0.481,27,52,0.519,12,29,0.414,18,25,0.72,108
2377,LAC,2017-11-20,85,@,NYK,0,240,30,80,0.375,20,48,0.417,10,32,0.313,15,21,0.714,85,35,81,0.432,22,47,0.468,13,34,0.382,24,25,0.96,107
2378,ATL,2017-11-20,85,@,SAS,0,240,37,85,0.435,29,55,0.527,8,30,0.267,3,8,0.375,85,40,89,0.449,30,58,0.517,10,31,0.323,6,6,1.0,96
2379,ORL,2017-11-18,85,,UTA,0,240,31,81,0.383,23,52,0.442,8,29,0.276,15,23,0.652,85,47,98,0.48,33,64,0.516,14,34,0.412,17,18,0.944,125
2380,POR,2017-10-30,85,,TOR,0,240,31,80,0.388,23,54,0.426,8,26,0.308,15,19,0.789,85,39,87,0.448,31,63,0.492,8,24,0.333,13,17,0.765,99
2381,SAC,2018-04-01,84,@,LAL,1,240,35,92,0.38,28,68,0.412,7,24,0.292,7,14,0.5,84,30,75,0.4,23,43,0.535,7,32,0.219,16,25,0.64,83
2382,IND,2018-03-07,84,,UTA,0,240,34,88,0.386,31,65,0.477,3,23,0.13,13,17,0.765,84,41,80,0.513,30,49,0.612,11,31,0.355,11,16,0.688,104
2383,MIN,2018-01-05,84,@,BOS,0,240,28,76,0.368,21,53,0.396,7,23,0.304,21,28,0.75,84,38,94,0.404,32,58,0.552,6,36,0.167,9,13,0.692,91
2384,WAS,2017-12-22,84,@,BRK,0,240,34,93,0.366,29,73,0.397,5,20,0.25,11,15,0.733,84,44,88,0.5,30,47,0.638,14,41,0.341,17,21,0.81,119
2385,MEM,2017-12-20,84,@,GSW,0,240,28,84,0.333,16,53,0.302,12,31,0.387,16,19,0.842,84,34,74,0.459,27,53,0.509,7,21,0.333,22,25,0.88,97
2386,DET,2017-12-12,84,,DEN,0,240,28,79,0.354,19,54,0.352,9,25,0.36,19,22,0.864,84,40,79,0.506,30,49,0.612,10,30,0.333,13,14,0.929,103
2387,NYK,2017-11-17,84,@,TOR,0,240,30,91,0.33,21,68,0.309,9,23,0.391,15,17,0.882,84,44,78,0.564,35,52,0.673,9,26,0.346,10,11,0.909,107
2388,MIA,2017-11-10,84,@,UTA,1,240,30,77,0.39,20,52,0.385,10,25,0.4,14,18,0.778,84,25,74,0.338,20,53,0.377,5,21,0.238,19,22,0.864,74
2389,UTA,2017-10-24,84,@,LAC,0,240,34,79,0.43,27,51,0.529,7,28,0.25,9,11,0.818,84,39,83,0.47,29,54,0.537,10,29,0.345,14,21,0.667,102
2390,NYK,2017-10-19,84,@,OKC,0,240,32,79,0.405,25,55,0.455,7,24,0.292,13,19,0.684,84,39,90,0.433,28,52,0.538,11,38,0.289,16,22,0.727,105
2391,HOU,2018-04-11,83,@,SAC,0,240,31,82,0.378,18,36,0.5,13,46,0.283,8,12,0.667,83,38,80,0.475,31,54,0.574,7,26,0.269,13,20,0.65,96
2392,LAL,2018-04-01,83,,SAC,0,240,30,75,0.4,23,43,0.535,7,32,0.219,16,25,0.64,83,35,92,0.38,28,68,0.412,7,24,0.292,7,14,0.5,84
2393,HOU,2018-04-01,83,@,SAS,0,240,26,77,0.338,19,46,0.413,7,31,0.226,24,29,0.828,83,40,81,0.494,34,64,0.531,6,17,0.353,14,21,0.667,100
2394,ORL,2018-03-16,83,,BOS,0,240,34,87,0.391,29,59,0.492,5,28,0.179,10,11,0.909,83,31,82,0.378,22,56,0.393,9,26,0.346,21,28,0.75,92
2395,CHI,2018-03-09,83,@,DET,0,240,33,93,0.355,24,62,0.387,9,31,0.29,8,10,0.8,83,38,81,0.469,29,54,0.537,9,27,0.333,14,18,0.778,99
2396,PHO,2018-02-12,83,@,GSW,0,240,33,95,0.347,30,72,0.417,3,23,0.13,14,22,0.636,83,52,89,0.584,41,63,0.651,11,26,0.423,14,21,0.667,129
2397,SAS,2018-01-19,83,@,TOR,0,240,31,91,0.341,26,71,0.366,5,20,0.25,16,20,0.8,83,34,85,0.4,25,59,0.424,9,26,0.346,9,14,0.643,86
2398,IND,2017-12-26,83,@,DET,0,240,34,77,0.442,28,56,0.5,6,21,0.286,9,13,0.692,83,41,82,0.5,29,48,0.604,12,34,0.353,13,16,0.813,107
2399,UTA,2017-12-26,83,@,DEN,0,240,27,84,0.321,17,49,0.347,10,35,0.286,19,23,0.826,83,39,81,0.481,28,51,0.549,11,30,0.367,18,22,0.818,107
2400,MEM,2017-11-18,83,,HOU,0,240,31,86,0.36,24,59,0.407,7,27,0.259,14,19,0.737,83,35,78,0.449,17,35,0.486,18,43,0.419,17,21,0.81,105
2401,ORL,2017-11-03,83,,CHI,0,240,35,86,0.407,25,51,0.49,10,35,0.286,3,5,0.6,83,40,85,0.471,26,56,0.464,14,29,0.483,11,12,0.917,105
2402,SAC,2017-10-31,83,@,IND,0,240,37,88,0.42,35,74,0.473,2,14,0.143,7,14,0.5,83,36,85,0.424,24,56,0.429,12,29,0.414,17,22,0.773,101
2403,SAC,2017-10-29,83,,WAS,0,240,32,82,0.39,26,60,0.433,6,22,0.273,13,16,0.813,83,40,85,0.471,23,51,0.451,17,34,0.5,13,20,0.65,110
2404,POR,2018-04-09,82,@,DEN,0,240,31,94,0.33,24,61,0.393,7,33,0.212,13,18,0.722,82,31,83,0.373,25,57,0.439,6,26,0.231,20,26,0.769,88
2405,ORL,2018-03-30,82,,CHI,0,240,31,94,0.33,24,55,0.436,7,39,0.179,13,14,0.929,82,30,84,0.357,16,43,0.372,14,41,0.341,16,23,0.696,90
2406,DAL,2018-03-11,82,,HOU,0,240,33,94,0.351,28,63,0.444,5,31,0.161,11,18,0.611,82,39,84,0.464,22,39,0.564,17,45,0.378,10,14,0.714,105
2407,NOP,2018-02-09,82,@,PHI,0,240,33,95,0.347,25,64,0.391,8,31,0.258,8,16,0.5,82,39,93,0.419,25,59,0.424,14,34,0.412,8,9,0.889,100
2408,MEM,2018-02-06,82,@,ATL,0,240,34,79,0.43,30,57,0.526,4,22,0.182,10,13,0.769,82,42,83,0.506,34,58,0.586,8,25,0.32,16,21,0.762,108
2409,MEM,2017-12-11,82,,MIA,0,240,28,72,0.389,20,45,0.444,8,27,0.296,18,27,0.667,82,37,66,0.561,23,39,0.59,14,27,0.519,19,24,0.792,107
2410,LAC,2017-12-02,82,@,DAL,0,240,30,86,0.349,24,64,0.375,6,22,0.273,16,23,0.696,82,36,79,0.456,20,44,0.455,16,35,0.457,20,26,0.769,108
2411,POR,2017-11-17,82,@,SAC,0,240,30,81,0.37,23,56,0.411,7,25,0.28,15,16,0.938,82,36,85,0.424,32,71,0.451,4,14,0.286,10,15,0.667,86
2412,DEN,2017-11-13,82,@,POR,0,240,30,84,0.357,21,52,0.404,9,32,0.281,13,15,0.867,82,38,73,0.521,31,52,0.596,7,21,0.333,16,18,0.889,99
2413,GSW,2018-03-27,81,,IND,0,240,35,86,0.407,30,69,0.435,5,17,0.294,6,9,0.667,81,39,81,0.481,33,60,0.55,6,21,0.286,8,12,0.667,92
2414,UTA,2018-02-23,81,,POR,0,240,33,78,0.423,27,53,0.509,6,25,0.24,9,11,0.818,81,39,87,0.448,30,63,0.476,9,24,0.375,13,14,0.929,100
2415,OKC,2018-02-08,81,@,LAL,0,240,32,90,0.356,24,56,0.429,8,34,0.235,9,19,0.474,81,42,96,0.438,32,65,0.492,10,31,0.323,12,13,0.923,106
2416,PHO,2018-02-07,81,,SAS,0,240,33,97,0.34,30,65,0.462,3,32,0.094,12,18,0.667,81,46,93,0.495,30,61,0.492,16,32,0.5,21,27,0.778,129
2417,SAS,2018-01-11,81,@,LAL,0,240,31,76,0.408,23,56,0.411,8,20,0.4,11,15,0.733,81,36,87,0.414,23,49,0.469,13,38,0.342,8,14,0.571,93
2418,GSW,2017-12-23,81,,DEN,0,240,32,84,0.381,29,57,0.509,3,27,0.111,14,17,0.824,81,38,82,0.463,31,54,0.574,7,28,0.25,13,15,0.867,96
2419,DET,2017-12-10,81,,BOS,0,240,28,84,0.333,18,51,0.353,10,33,0.303,15,19,0.789,81,33,79,0.418,22,49,0.449,11,30,0.367,14,18,0.778,91
2420,OKC,2017-11-25,81,@,DAL,0,240,29,80,0.363,16,45,0.356,13,35,0.371,10,13,0.769,81,37,75,0.493,22,40,0.55,15,35,0.429,8,11,0.727,97
2421,POR,2017-11-22,81,@,PHI,0,240,30,89,0.337,23,63,0.365,7,26,0.269,14,24,0.583,81,39,90,0.433,28,58,0.483,11,32,0.344,12,17,0.706,101
2422,LAL,2017-10-28,81,@,UTA,0,240,31,81,0.383,26,59,0.441,5,22,0.227,14,20,0.7,81,37,79,0.468,24,48,0.5,13,31,0.419,9,13,0.692,96
2423,MEM,2018-03-10,80,@,DAL,0,240,30,84,0.357,23,66,0.348,7,18,0.389,13,17,0.765,80,37,77,0.481,27,48,0.563,10,29,0.345,30,35,0.857,114
2424,ORL,2018-03-05,80,@,UTA,0,240,29,85,0.341,18,51,0.353,11,34,0.324,11,14,0.786,80,36,73,0.493,26,42,0.619,10,31,0.323,12,18,0.667,94
2425,OKC,2018-02-24,80,@,GSW,0,240,29,88,0.33,20,54,0.37,9,34,0.265,13,21,0.619,80,42,89,0.472,25,51,0.49,17,38,0.447,11,13,0.846,112
2426,BOS,2018-01-18,80,,PHI,0,240,30,74,0.405,23,45,0.511,7,29,0.241,13,17,0.765,80,34,73,0.466,28,56,0.5,6,17,0.353,15,17,0.882,89
2427,DEN,2018-01-13,80,@,SAS,0,240,29,83,0.349,22,55,0.4,7,28,0.25,15,17,0.882,80,41,79,0.519,27,52,0.519,14,27,0.519,16,18,0.889,112
2428,BRK,2018-01-10,80,,DET,0,240,27,74,0.365,15,37,0.405,12,37,0.324,14,15,0.933,80,48,93,0.516,38,72,0.528,10,21,0.476,8,12,0.667,114
2429,CHI,2017-11-22,80,@,UTA,0,240,29,78,0.372,24,57,0.421,5,21,0.238,17,20,0.85,80,40,86,0.465,26,51,0.51,14,35,0.4,16,19,0.842,110
2430,SAC,2017-11-15,80,@,ATL,0,240,31,88,0.352,25,60,0.417,6,28,0.214,12,20,0.6,80,50,79,0.633,34,47,0.723,16,32,0.5,10,16,0.625,126
2431,MIA,2017-11-06,80,@,GSW,0,240,30,83,0.361,22,57,0.386,8,26,0.308,12,17,0.706,80,32,87,0.368,21,55,0.382,11,32,0.344,22,24,0.917,97
2432,GSW,2018-04-10,79,@,UTA,0,240,30,86,0.349,25,67,0.373,5,19,0.263,14,16,0.875,79,48,90,0.533,35,55,0.636,13,35,0.371,10,13,0.769,119
2433,CLE,2018-03-27,79,@,MIA,0,240,31,85,0.365,27,59,0.458,4,26,0.154,13,19,0.684,79,37,78,0.474,28,49,0.571,9,29,0.31,15,20,0.75,98
2434,MEM,2018-03-22,79,@,CHO,0,240,30,78,0.385,26,60,0.433,4,18,0.222,15,21,0.714,79,49,92,0.533,30,52,0.577,19,40,0.475,23,27,0.852,140
2435,DET,2018-03-13,79,@,UTA,0,240,30,80,0.375,25,55,0.455,5,25,0.2,14,19,0.737,79,42,76,0.553,29,42,0.69,13,34,0.382,13,23,0.565,110
2436,MIL,2018-01-14,79,@,MIA,0,240,25,79,0.316,21,51,0.412,4,28,0.143,25,27,0.926,79,35,76,0.461,24,47,0.511,11,29,0.379,16,20,0.8,97
2437,SAS,2017-12-30,79,@,DET,0,240,31,84,0.369,26,58,0.448,5,26,0.192,12,13,0.923,79,36,81,0.444,28,57,0.491,8,24,0.333,13,16,0.813,93
2438,UTA,2017-12-20,79,@,OKC,0,240,26,73,0.356,19,42,0.452,7,31,0.226,20,27,0.741,79,40,77,0.519,32,54,0.593,8,23,0.348,19,22,0.864,107
2439,MEM,2017-12-01,79,,SAS,0,240,30,74,0.405,25,59,0.424,5,15,0.333,14,18,0.778,79,31,70,0.443,20,43,0.465,11,27,0.407,22,32,0.688,95
2440,MIL,2017-11-18,79,@,DAL,0,240,28,74,0.378,22,49,0.449,6,25,0.24,17,31,0.548,79,38,79,0.481,19,41,0.463,19,38,0.5,16,19,0.842,111
2441,CHI,2017-11-15,79,@,OKC,0,240,26,75,0.347,15,46,0.326,11,29,0.379,16,20,0.8,79,26,72,0.361,18,42,0.429,8,30,0.267,32,37,0.865,92
2442,SAC,2017-10-21,79,@,DEN,0,240,31,85,0.365,23,63,0.365,8,22,0.364,9,13,0.692,79,37,85,0.435,27,55,0.491,10,30,0.333,12,20,0.6,96
2443,BOS,2018-04-04,78,@,TOR,0,240,25,75,0.333,22,53,0.415,3,22,0.136,25,28,0.893,78,40,92,0.435,30,59,0.508,10,33,0.303,6,8,0.75,96
2444,MEM,2018-03-09,78,,UTA,0,240,31,83,0.373,25,61,0.41,6,22,0.273,10,14,0.714,78,33,74,0.446,20,42,0.476,13,32,0.406,16,22,0.727,95
2445,SAS,2018-01-26,78,,PHI,0,240,30,75,0.4,27,51,0.529,3,24,0.125,15,18,0.833,78,38,79,0.481,29,58,0.5,9,21,0.429,12,18,0.667,97
2446,MEM,2018-01-12,78,@,DEN,0,240,30,77,0.39,23,53,0.434,7,24,0.292,11,14,0.786,78,27,70,0.386,20,48,0.417,7,22,0.318,26,32,0.813,87
2447,DET,2018-01-05,78,@,PHI,0,240,30,78,0.385,23,56,0.411,7,22,0.318,11,19,0.579,78,44,90,0.489,30,60,0.5,14,30,0.467,12,13,0.923,114
2448,ATL,2017-11-25,78,,TOR,0,240,26,75,0.347,20,48,0.417,6,27,0.222,20,23,0.87,78,46,84,0.548,33,52,0.635,13,32,0.406,7,9,0.778,112
2449,DEN,2017-11-28,77,@,UTA,0,240,28,78,0.359,21,44,0.477,7,34,0.206,14,16,0.875,77,42,87,0.483,28,55,0.509,14,32,0.438,8,9,0.889,106
2450,CHI,2017-10-21,77,,SAS,0,240,31,82,0.378,23,54,0.426,8,28,0.286,7,9,0.778,77,38,93,0.409,37,81,0.457,1,12,0.083,10,16,0.625,87
2451,PHO,2017-10-18,76,,POR,0,240,28,89,0.315,21,62,0.339,7,27,0.259,13,18,0.722,76,44,90,0.489,30,66,0.455,14,24,0.583,22,28,0.786,124
2452,GSW,2018-03-19,75,@,SAS,0,240,30,74,0.405,27,55,0.491,3,19,0.158,12,16,0.75,75,33,82,0.402,25,59,0.424,8,23,0.348,15,21,0.714,89
2453,WAS,2018-01-22,75,@,DAL,0,240,26,86,0.302,19,54,0.352,7,32,0.219,16,27,0.593,75,38,87,0.437,28,56,0.5,10,31,0.323,12,17,0.706,98
2454,UTA,2017-11-10,74,,MIA,0,240,25,74,0.338,20,53,0.377,5,21,0.238,19,22,0.864,74,30,77,0.39,20,52,0.385,10,25,0.4,14,18,0.778,84
2455,IND,2018-04-06,73,@,TOR,0,240,26,87,0.299,19,66,0.288,7,21,0.333,14,20,0.7,73,36,84,0.429,27,54,0.5,9,30,0.3,11,16,0.688,92
2456,NYK,2018-04-03,73,,ORL,0,240,30,86,0.349,26,59,0.441,4,27,0.148,9,12,0.75,73,37,88,0.42,26,52,0.5,11,36,0.306,12,18,0.667,97
2457,NYK,2018-01-31,73,@,BOS,0,240,28,87,0.322,25,70,0.357,3,17,0.176,14,21,0.667,73,40,83,0.482,29,57,0.509,11,26,0.423,12,20,0.6,103
2458,ORL,2018-03-13,72,@,SAS,0,240,28,82,0.341,21,59,0.356,7,23,0.304,9,9,1.0,72,40,84,0.476,31,65,0.477,9,19,0.474,19,23,0.826,108
2459,WAS,2017-12-04,69,@,UTA,0,240,23,80,0.288,19,60,0.317,4,20,0.2,19,23,0.826,69,43,76,0.566,27,42,0.643,16,34,0.471,14,18,0.778,116
2460,CHI,2017-10-28,69,,OKC,0,240,22,78,0.282,12,41,0.293,10,37,0.27,15,20,0.75,69,39,88,0.443,26,54,0.481,13,34,0.382,10,14,0.714,101
