Rk,Team,Date,PTS,Unnamed: 4,Opp,Result,MP,FG,FGA,FG%,2P,2PA,2P%,3P,3PA,3P%,FT,FTA,FT%,PTS.1,FG.1,FGA.1,FG%.1,2P.1,2PA.1,2P%.1,3P.1,3PA.1,3P%.1,FT.1,FTA.1,FT%.1,PTS.2
1,CHO,2022-01-26,158,@,IND,1,240,54,93,0.581,30,48,0.625,24,45,0.533,26,33,0.788,158,44,92,0.478,34,58,0.586,10,34,0.294,28,34,0.824,126
2,SAS,2022-02-25,157,@,WAS,1,290,57,105,0.543,48,76,0.632,9,29,0.31,34,43,0.791,157,59,108,0.546,43,70,0.614,16,38,0.421,19,24,0.792,153
3,LAC,2022-04-01,153,@,MIL,1,240,56,92,0.609,33,49,0.673,23,43,0.535,18,24,0.75,153,50,94,0.532,42,69,0.609,8,25,0.32,11,18,0.611,119
4,WAS,2022-02-25,153,,SAS,0,290,59,108,0.546,43,70,0.614,16,38,0.421,19,24,0.792,153,57,105,0.543,48,76,0.632,9,29,0.31,34,43,0.791,157
5,MEM,2021-12-02,152,,OKC,1,240,60,96,0.625,41,60,0.683,19,36,0.528,13,18,0.722,152,25,76,0.329,14,38,0.368,11,38,0.289,18,22,0.818,79
6,BRK,2022-03-15,150,@,ORL,1,240,53,88,0.602,37,61,0.607,16,27,0.593,28,34,0.824,150,36,95,0.379,21,54,0.389,15,41,0.366,21,27,0.778,108
7,MIN,2022-03-14,149,@,SAS,1,240,52,90,0.578,35,57,0.614,17,33,0.515,28,32,0.875,149,52,97,0.536,39,62,0.629,13,35,0.371,22,26,0.846,139
8,LAL,2022-04-10,146,@,DEN,1,265,44,94,0.468,28,51,0.549,16,43,0.372,42,47,0.894,146,49,100,0.49,34,53,0.642,15,47,0.319,28,36,0.778,141
9,HOU,2021-11-27,146,,CHO,1,265,51,95,0.537,28,46,0.609,23,49,0.469,21,31,0.677,146,48,103,0.466,28,53,0.528,20,50,0.4,27,30,0.9,143
10,BOS,2021-12-04,145,@,POR,1,240,49,87,0.563,28,50,0.56,21,37,0.568,26,29,0.897,145,42,89,0.472,34,60,0.567,8,29,0.276,25,32,0.781,117
11,MIA,2022-04-05,144,,CHO,1,240,48,84,0.571,25,42,0.595,23,42,0.548,25,29,0.862,144,45,85,0.529,33,47,0.702,12,38,0.316,13,18,0.722,115
12,BOS,2022-04-03,144,,WAS,1,240,56,91,0.615,33,47,0.702,23,44,0.523,9,13,0.692,144,38,82,0.463,30,61,0.492,8,21,0.381,18,20,0.9,102
13,PHI,2022-04-02,144,,CHO,1,240,53,87,0.609,32,44,0.727,21,43,0.488,17,21,0.81,144,42,87,0.483,31,57,0.544,11,30,0.367,19,24,0.792,114
14,CLE,2021-12-26,144,,TOR,1,240,56,106,0.528,34,54,0.63,22,52,0.423,10,12,0.833,144,37,89,0.416,28,53,0.528,9,36,0.25,16,23,0.696,99
15,SAS,2021-12-26,144,,DET,1,240,51,91,0.56,38,64,0.594,13,27,0.481,29,37,0.784,144,38,98,0.388,30,66,0.455,8,32,0.25,25,34,0.735,109
16,CHO,2021-11-27,143,@,HOU,0,265,48,103,0.466,28,53,0.528,20,50,0.4,27,30,0.9,143,51,95,0.537,28,46,0.609,23,49,0.469,21,31,0.677,146
17,CHO,2022-03-11,142,@,NOP,1,240,52,87,0.598,30,40,0.75,22,47,0.468,16,20,0.8,142,43,86,0.5,28,47,0.596,15,39,0.385,19,25,0.76,120
18,MIL,2022-03-08,142,@,OKC,1,240,53,100,0.53,33,60,0.55,20,40,0.5,16,20,0.8,142,42,84,0.5,26,45,0.578,16,39,0.41,15,21,0.714,115
19,LAC,2022-02-17,142,,HOU,1,240,51,92,0.554,33,57,0.579,18,35,0.514,22,26,0.846,142,42,91,0.462,29,54,0.537,13,37,0.351,14,19,0.737,111
20,SAC,2021-12-08,142,,ORL,1,240,53,97,0.546,38,63,0.603,15,34,0.441,21,25,0.84,142,48,97,0.495,32,63,0.508,16,34,0.471,18,23,0.783,130
21,DEN,2022-04-10,141,,LAL,0,265,49,100,0.49,34,53,0.642,15,47,0.319,28,36,0.778,141,44,94,0.468,28,51,0.549,16,43,0.372,42,47,0.894,146
22,MEM,2022-04-09,141,,NOP,1,240,53,90,0.589,35,55,0.636,18,35,0.514,17,23,0.739,141,41,91,0.451,35,61,0.574,6,30,0.2,26,35,0.743,114
23,CHO,2022-02-11,141,@,DET,1,240,54,97,0.557,36,55,0.655,18,42,0.429,15,23,0.652,141,48,102,0.471,36,67,0.537,12,35,0.343,11,18,0.611,119
24,MIN,2022-01-09,141,@,HOU,1,240,55,108,0.509,40,66,0.606,15,42,0.357,16,21,0.762,141,46,97,0.474,32,54,0.593,14,43,0.326,17,28,0.607,123
25,SAC,2021-11-26,141,@,LAL,1,315,54,120,0.45,40,75,0.533,14,45,0.311,19,29,0.655,141,51,102,0.5,36,58,0.621,15,44,0.341,20,28,0.714,137
26,PHO,2022-03-24,140,@,DEN,1,240,52,86,0.605,39,59,0.661,13,27,0.481,23,29,0.793,140,48,81,0.593,33,49,0.673,15,32,0.469,19,27,0.704,130
27,PHO,2022-03-13,140,,LAL,1,240,58,102,0.569,46,69,0.667,12,33,0.364,12,14,0.857,140,36,81,0.444,20,41,0.488,16,40,0.4,23,31,0.742,111
28,DEN,2022-01-13,140,,POR,1,240,52,83,0.627,31,41,0.756,21,42,0.5,15,20,0.75,140,39,86,0.453,26,46,0.565,13,40,0.325,17,28,0.607,108
29,CHO,2022-01-05,140,,DET,1,240,48,81,0.593,24,39,0.615,24,42,0.571,20,29,0.69,140,43,92,0.467,29,50,0.58,14,42,0.333,11,20,0.55,111
30,SAC,2021-11-05,140,,CHO,1,240,48,87,0.552,26,43,0.605,22,44,0.5,22,26,0.846,140,43,92,0.467,32,57,0.561,11,35,0.314,13,21,0.619,110
31,BOS,2021-10-25,140,@,CHO,1,265,50,101,0.495,31,51,0.608,19,50,0.38,21,25,0.84,140,46,103,0.447,27,59,0.458,19,44,0.432,18,28,0.643,129
32,BOS,2022-04-10,139,@,MEM,1,240,54,99,0.545,36,51,0.706,18,48,0.375,13,13,1.0,139,39,102,0.382,24,55,0.436,15,47,0.319,17,27,0.63,110
33,MIN,2022-04-03,139,@,HOU,1,240,51,86,0.593,34,45,0.756,17,41,0.415,20,25,0.8,139,48,85,0.565,32,45,0.711,16,40,0.4,20,29,0.69,132
34,SAS,2022-03-14,139,,MIN,0,240,52,97,0.536,39,62,0.629,13,35,0.371,22,26,0.846,139,52,90,0.578,35,57,0.614,17,33,0.515,28,32,0.875,149
35,HOU,2022-03-09,139,,LAL,1,265,52,102,0.51,35,62,0.565,17,40,0.425,18,19,0.947,139,47,101,0.465,29,54,0.537,18,47,0.383,18,26,0.692,130
36,TOR,2022-02-10,139,@,HOU,1,240,53,97,0.546,38,58,0.655,15,39,0.385,18,22,0.818,139,43,82,0.524,27,44,0.614,16,38,0.421,18,30,0.6,120
37,LAC,2022-01-17,139,,IND,1,240,45,82,0.549,27,46,0.587,18,36,0.5,31,36,0.861,139,50,97,0.515,37,64,0.578,13,33,0.394,20,23,0.87,133
38,LAL,2021-12-31,139,,POR,1,240,47,85,0.553,28,44,0.636,19,41,0.463,26,30,0.867,139,36,102,0.353,24,60,0.4,12,42,0.286,22,27,0.815,106
39,DAL,2021-12-01,139,@,NOP,1,240,57,83,0.687,39,49,0.796,18,34,0.529,7,9,0.778,139,40,89,0.449,27,52,0.519,13,37,0.351,14,16,0.875,107
40,LAC,2022-04-10,138,,OKC,1,240,54,97,0.557,36,62,0.581,18,35,0.514,12,14,0.857,138,37,98,0.378,28,64,0.438,9,34,0.265,5,9,0.556,88
41,MIN,2022-03-19,138,,MIL,1,240,47,92,0.511,25,45,0.556,22,47,0.468,22,26,0.846,138,43,97,0.443,24,45,0.533,19,52,0.365,14,17,0.824,119
42,DEN,2022-03-06,138,,NOP,1,265,47,87,0.54,37,54,0.685,10,33,0.303,34,43,0.791,138,48,101,0.475,34,68,0.5,14,33,0.424,20,29,0.69,130
43,MIN,2022-03-04,138,@,OKC,1,240,49,91,0.538,27,44,0.614,22,47,0.468,18,23,0.783,138,37,86,0.43,28,51,0.549,9,35,0.257,18,21,0.857,101
44,GSW,2022-01-14,138,@,CHI,1,240,53,94,0.564,34,52,0.654,19,42,0.452,13,17,0.765,138,37,87,0.425,27,49,0.551,10,38,0.263,12,18,0.667,96
45,BRK,2022-01-12,138,@,CHI,1,240,49,87,0.563,32,55,0.582,17,32,0.531,23,28,0.821,138,38,81,0.469,27,51,0.529,11,30,0.367,25,31,0.806,112
46,SAS,2021-12-23,138,@,LAL,1,240,46,95,0.484,28,56,0.5,18,39,0.462,28,33,0.848,138,44,94,0.468,39,67,0.582,5,27,0.185,17,30,0.567,110
47,MIN,2021-11-20,138,,MEM,1,240,49,91,0.538,29,50,0.58,20,41,0.488,20,28,0.714,138,29,83,0.349,20,51,0.392,9,32,0.281,28,35,0.8,95
48,NYK,2021-10-20,138,,BOS,1,290,51,105,0.486,34,60,0.567,17,45,0.378,19,27,0.704,138,48,117,0.41,27,60,0.45,21,57,0.368,17,23,0.739,134
49,UTA,2022-04-06,137,,OKC,1,240,49,84,0.583,34,48,0.708,15,36,0.417,24,32,0.75,137,37,90,0.411,21,53,0.396,16,37,0.432,11,17,0.647,101
50,MIL,2022-02-06,137,@,LAC,1,240,48,88,0.545,29,50,0.58,19,38,0.5,22,27,0.815,137,40,96,0.417,22,50,0.44,18,46,0.391,15,16,0.938,113
51,MIL,2022-02-05,137,@,POR,1,240,49,92,0.533,26,42,0.619,23,50,0.46,16,22,0.727,137,41,85,0.482,27,40,0.675,14,45,0.311,12,21,0.571,108
52,PHO,2021-12-19,137,,CHO,1,240,54,95,0.568,34,54,0.63,20,41,0.488,9,13,0.692,137,36,100,0.36,26,55,0.473,10,45,0.222,24,28,0.857,106
53,UTA,2021-12-03,137,,BOS,1,240,45,81,0.556,18,30,0.6,27,51,0.529,20,23,0.87,137,47,91,0.516,33,52,0.635,14,39,0.359,22,22,1.0,130
54,LAL,2021-11-26,137,,SAC,0,315,51,102,0.5,36,58,0.621,15,44,0.341,20,28,0.714,137,54,120,0.45,40,75,0.533,14,45,0.311,19,29,0.655,141
55,MIA,2021-10-21,137,,MIL,1,240,51,96,0.531,36,61,0.59,15,35,0.429,20,31,0.645,137,32,84,0.381,20,42,0.476,12,42,0.286,19,29,0.655,95
56,MIN,2022-04-01,136,@,DEN,1,240,43,86,0.5,24,46,0.522,19,40,0.475,31,36,0.861,136,46,86,0.535,34,51,0.667,12,35,0.343,26,29,0.897,130
57,ATL,2022-03-30,136,@,OKC,1,240,49,91,0.538,31,52,0.596,18,39,0.462,20,22,0.909,136,41,87,0.471,24,46,0.522,17,41,0.415,19,27,0.704,118
58,SAS,2022-02-11,136,@,ATL,1,240,50,90,0.556,32,58,0.552,18,32,0.563,18,21,0.857,136,47,103,0.456,33,60,0.55,14,43,0.326,13,15,0.867,121
59,DEN,2022-01-30,136,@,MIL,1,240,53,88,0.602,30,45,0.667,23,43,0.535,7,10,0.7,136,37,78,0.474,27,48,0.563,10,30,0.333,16,22,0.727,100
60,MIN,2022-01-23,136,,BRK,1,240,48,92,0.522,34,60,0.567,14,32,0.438,26,31,0.839,136,48,95,0.505,33,57,0.579,15,38,0.395,14,15,0.933,125
61,POR,2022-01-03,136,,ATL,1,240,47,89,0.528,29,48,0.604,18,41,0.439,24,28,0.857,136,48,88,0.545,34,47,0.723,14,41,0.341,21,24,0.875,131
62,MIL,2022-01-01,136,,NOP,1,240,49,92,0.533,26,44,0.591,23,48,0.479,15,18,0.833,136,39,95,0.411,23,44,0.523,16,51,0.314,19,30,0.633,113
63,MIL,2021-12-30,136,@,ORL,1,240,45,91,0.495,32,58,0.552,13,33,0.394,33,36,0.917,136,42,87,0.483,29,51,0.569,13,36,0.361,21,27,0.778,118
64,UTA,2021-12-08,136,@,MIN,1,240,50,88,0.568,25,34,0.735,25,54,0.463,11,15,0.733,136,38,95,0.4,21,48,0.438,17,47,0.362,11,17,0.647,104
65,MEM,2021-11-15,136,,HOU,1,240,52,96,0.542,36,55,0.655,16,41,0.39,16,20,0.8,136,36,95,0.379,25,57,0.439,11,38,0.289,19,26,0.731,102
66,SAS,2021-11-10,136,,SAC,1,240,49,92,0.533,31,60,0.517,18,32,0.563,20,31,0.645,136,47,91,0.516,37,55,0.673,10,36,0.278,13,16,0.813,117
67,WAS,2022-04-01,135,,DAL,1,240,49,90,0.544,32,57,0.561,17,33,0.515,20,22,0.909,135,34,78,0.436,23,40,0.575,11,38,0.289,24,26,0.923,103
68,CHI,2022-03-31,135,,LAC,1,265,50,102,0.49,40,73,0.548,10,29,0.345,25,32,0.781,135,45,90,0.5,29,54,0.537,16,36,0.444,24,26,0.923,130
69,MIL,2022-03-16,135,@,SAC,1,240,47,89,0.528,29,54,0.537,18,35,0.514,23,32,0.719,135,46,94,0.489,30,51,0.588,16,43,0.372,18,21,0.857,126
70,MEM,2022-03-15,135,@,IND,1,240,54,105,0.514,39,65,0.6,15,40,0.375,12,20,0.6,135,41,98,0.418,35,68,0.515,6,30,0.2,14,19,0.737,102
71,MIN,2022-03-05,135,,POR,1,240,48,85,0.565,33,48,0.688,15,37,0.405,24,29,0.828,135,40,85,0.471,24,47,0.511,16,38,0.421,25,30,0.833,121
72,BOS,2022-02-15,135,@,PHI,1,240,46,82,0.561,21,37,0.568,25,45,0.556,18,22,0.818,135,23,80,0.288,15,48,0.313,8,32,0.25,33,39,0.846,87
73,UTA,2022-02-14,135,,HOU,1,240,49,89,0.551,31,49,0.633,18,40,0.45,19,22,0.864,135,35,83,0.422,23,46,0.5,12,37,0.324,19,28,0.679,101
74,MEM,2022-02-08,135,,LAC,1,240,53,103,0.515,44,77,0.571,9,26,0.346,20,25,0.8,135,40,89,0.449,29,58,0.5,11,31,0.355,18,24,0.75,109
75,MEM,2022-02-05,135,@,ORL,1,240,53,105,0.505,40,66,0.606,13,39,0.333,16,22,0.727,135,39,90,0.433,22,42,0.524,17,48,0.354,20,29,0.69,115
76,PHO,2022-01-16,135,@,DET,1,240,51,87,0.586,40,60,0.667,11,27,0.407,22,30,0.733,135,38,82,0.463,29,57,0.509,9,25,0.36,23,34,0.676,108
77,MIN,2022-01-07,135,@,OKC,1,240,50,90,0.556,33,49,0.673,17,41,0.415,18,25,0.72,135,36,89,0.404,21,45,0.467,15,44,0.341,18,23,0.783,105
78,WAS,2021-10-22,135,,IND,1,265,49,94,0.521,30,56,0.536,19,38,0.5,18,19,0.947,135,52,97,0.536,37,63,0.587,15,34,0.441,15,20,0.75,134
79,BRK,2022-04-10,134,,IND,1,240,52,81,0.642,44,59,0.746,8,22,0.364,22,25,0.88,134,47,104,0.452,28,58,0.483,19,46,0.413,13,19,0.684,126
80,OKC,2022-03-28,134,@,POR,1,265,48,90,0.533,28,45,0.622,20,45,0.444,18,25,0.72,134,51,112,0.455,31,62,0.5,20,50,0.4,9,13,0.692,131
81,BOS,2022-03-27,134,,MIN,1,240,49,87,0.563,32,48,0.667,17,39,0.436,19,21,0.905,134,45,84,0.536,31,52,0.596,14,32,0.438,8,12,0.667,112
82,DET,2022-03-17,134,@,ORL,1,240,47,94,0.5,27,51,0.529,20,43,0.465,20,31,0.645,134,47,97,0.485,36,67,0.537,11,30,0.367,15,21,0.714,120
83,CHO,2022-03-14,134,@,OKC,1,240,49,91,0.538,29,56,0.518,20,35,0.571,16,21,0.762,134,42,90,0.467,26,46,0.565,16,44,0.364,16,19,0.842,116
84,UTA,2022-03-12,134,,SAC,1,240,48,86,0.558,32,45,0.711,16,41,0.39,22,31,0.71,134,47,94,0.5,34,61,0.557,13,33,0.394,18,21,0.857,125
85,CHI,2022-02-11,134,,MIN,1,240,55,87,0.632,41,56,0.732,14,31,0.452,10,13,0.769,134,48,96,0.5,35,56,0.625,13,40,0.325,13,16,0.813,122
86,MIN,2022-02-08,134,@,SAC,1,240,50,104,0.481,28,60,0.467,22,44,0.5,12,17,0.706,134,41,83,0.494,32,58,0.552,9,25,0.36,23,26,0.885,114
87,PHO,2022-01-28,134,,MIN,1,240,43,84,0.512,23,45,0.511,20,39,0.513,28,37,0.757,134,44,90,0.489,30,51,0.588,14,39,0.359,22,27,0.815,124
88,SAS,2022-01-25,134,@,HOU,1,240,58,101,0.574,46,69,0.667,12,32,0.375,6,6,1.0,134,39,95,0.411,30,61,0.492,9,34,0.265,17,25,0.68,104
89,ATL,2022-01-19,134,,MIN,1,240,45,86,0.523,30,48,0.625,15,38,0.395,29,33,0.879,134,42,97,0.433,25,51,0.49,17,46,0.37,21,29,0.724,122
90,LAL,2022-01-07,134,,ATL,1,240,50,101,0.495,33,60,0.55,17,41,0.415,17,19,0.895,134,43,96,0.448,30,60,0.5,13,36,0.361,19,27,0.704,118
91,POR,2021-10-23,134,,PHO,1,240,51,94,0.543,30,44,0.682,21,50,0.42,11,17,0.647,134,43,89,0.483,34,61,0.557,9,28,0.321,10,15,0.667,105
92,IND,2021-10-22,134,@,WAS,0,265,52,97,0.536,37,63,0.587,15,34,0.441,15,20,0.75,134,49,94,0.521,30,56,0.536,19,38,0.5,18,19,0.947,135
93,BOS,2021-10-20,134,@,NYK,0,290,48,117,0.41,27,60,0.45,21,57,0.368,17,23,0.739,134,51,105,0.486,34,60,0.567,17,45,0.378,19,27,0.704,138
94,CLE,2022-04-10,133,,MIL,1,240,51,94,0.543,32,56,0.571,19,38,0.5,12,17,0.706,133,39,88,0.443,27,58,0.466,12,30,0.4,25,32,0.781,115
95,PHI,2022-04-09,133,,IND,1,240,50,90,0.556,38,56,0.679,12,34,0.353,21,27,0.778,133,41,78,0.526,31,55,0.564,10,23,0.435,28,36,0.778,120
96,CHO,2022-04-08,133,@,CHI,1,240,52,86,0.605,33,46,0.717,19,40,0.475,10,10,1.0,133,44,82,0.537,31,58,0.534,13,24,0.542,16,20,0.8,117
97,MEM,2022-03-24,133,,IND,1,240,50,93,0.538,29,51,0.569,21,42,0.5,12,17,0.706,133,39,92,0.424,30,59,0.508,9,33,0.273,16,23,0.696,103
98,SAS,2022-03-23,133,@,POR,1,240,46,94,0.489,27,50,0.54,19,44,0.432,22,24,0.917,133,36,94,0.383,29,68,0.426,7,26,0.269,17,18,0.944,96
99,WAS,2022-03-06,133,,IND,1,240,45,86,0.523,28,44,0.636,17,42,0.405,26,32,0.813,133,44,85,0.518,34,54,0.63,10,31,0.323,25,29,0.862,123
100,TOR,2022-02-28,133,@,BRK,1,240,51,99,0.515,33,61,0.541,18,38,0.474,13,22,0.591,133,33,86,0.384,21,51,0.412,12,35,0.343,19,24,0.792,97
101,MIA,2022-02-26,133,,SAS,1,240,47,83,0.566,35,55,0.636,12,28,0.429,27,38,0.711,133,50,90,0.556,36,59,0.61,14,31,0.452,15,19,0.789,129
102,PHI,2022-02-25,133,@,MIN,1,240,42,82,0.512,23,43,0.535,19,39,0.487,30,36,0.833,133,36,86,0.419,27,47,0.574,9,39,0.231,21,25,0.84,102
103,ATL,2022-02-08,133,,IND,1,240,52,90,0.578,35,57,0.614,17,33,0.515,12,16,0.75,133,37,93,0.398,27,62,0.435,10,31,0.323,28,33,0.848,112
104,MIL,2022-01-22,133,,SAC,1,240,45,91,0.495,24,49,0.49,21,42,0.5,22,25,0.88,133,51,97,0.526,36,60,0.6,15,37,0.405,10,16,0.625,127
105,DET,2022-01-19,133,@,SAC,1,240,46,91,0.505,31,55,0.564,15,36,0.417,26,30,0.867,133,44,84,0.524,32,57,0.561,12,27,0.444,31,44,0.705,131
106,IND,2022-01-17,133,@,LAC,0,240,50,97,0.515,37,64,0.578,13,33,0.394,20,23,0.87,133,45,82,0.549,27,46,0.587,18,36,0.5,31,36,0.861,139
107,DEN,2022-01-15,133,,LAL,1,240,47,91,0.516,24,51,0.471,23,40,0.575,16,17,0.941,133,36,82,0.439,26,52,0.5,10,30,0.333,14,19,0.737,96
108,CHI,2022-01-11,133,,DET,1,240,50,92,0.543,32,58,0.552,18,34,0.529,15,19,0.789,133,30,89,0.337,24,54,0.444,6,35,0.171,21,27,0.778,87
109,PHI,2022-01-03,133,,HOU,1,240,50,96,0.521,33,56,0.589,17,40,0.425,16,17,0.941,133,37,89,0.416,22,45,0.489,15,44,0.341,24,33,0.727,113
110,PHO,2022-01-02,133,@,CHO,1,240,52,103,0.505,35,62,0.565,17,41,0.415,12,12,1.0,133,39,85,0.459,30,50,0.6,9,35,0.257,12,21,0.571,99
111,CHI,2021-12-20,133,,HOU,1,240,47,88,0.534,31,53,0.585,16,35,0.457,23,24,0.958,133,44,78,0.564,32,45,0.711,12,33,0.364,18,24,0.75,118
112,DEN,2021-12-17,133,@,ATL,1,240,50,86,0.581,33,48,0.688,17,38,0.447,16,18,0.889,133,41,88,0.466,34,64,0.531,7,24,0.292,26,34,0.765,115
113,CHI,2021-11-29,133,,CHO,1,240,53,89,0.596,39,59,0.661,14,30,0.467,13,19,0.684,133,42,88,0.477,24,49,0.49,18,39,0.462,17,21,0.81,119
114,CHO,2021-11-26,133,,MIN,1,240,49,88,0.557,26,48,0.542,23,40,0.575,12,15,0.8,133,45,100,0.45,34,65,0.523,11,35,0.314,14,19,0.737,115
115,WAS,2022-04-05,132,@,MIN,1,240,56,101,0.554,43,71,0.606,13,30,0.433,7,14,0.5,132,41,91,0.451,27,50,0.54,14,41,0.341,18,25,0.72,114
116,HOU,2022-04-03,132,,MIN,0,240,48,85,0.565,32,45,0.711,16,40,0.4,20,29,0.69,132,51,86,0.593,34,45,0.756,17,41,0.415,20,25,0.8,139
117,ATL,2022-03-28,132,@,IND,1,240,47,86,0.547,30,51,0.588,17,35,0.486,21,26,0.808,132,45,87,0.517,28,51,0.549,17,36,0.472,16,18,0.889,123
118,MEM,2022-03-23,132,,BRK,1,240,47,101,0.465,28,63,0.444,19,38,0.5,19,22,0.864,132,43,87,0.494,34,62,0.548,9,25,0.36,25,27,0.926,120
119,BOS,2022-03-21,132,@,OKC,1,240,44,86,0.512,29,46,0.63,15,40,0.375,29,34,0.853,132,48,93,0.516,31,56,0.554,17,37,0.459,10,14,0.714,123
120,MIN,2022-03-09,132,,OKC,1,240,45,86,0.523,23,34,0.676,22,52,0.423,20,26,0.769,132,36,87,0.414,22,44,0.5,14,43,0.326,16,24,0.667,102
121,MEM,2022-03-08,132,,NOP,1,240,48,101,0.475,32,57,0.561,16,44,0.364,20,24,0.833,132,41,88,0.466,30,54,0.556,11,34,0.324,18,27,0.667,111
122,BRK,2022-03-08,132,@,CHO,1,240,46,82,0.561,28,47,0.596,18,35,0.514,22,29,0.759,132,45,92,0.489,32,51,0.627,13,41,0.317,18,22,0.818,121
123,MIL,2022-03-06,132,,PHO,1,240,47,87,0.54,32,55,0.582,15,32,0.469,23,29,0.793,132,50,93,0.538,36,62,0.581,14,31,0.452,8,11,0.727,122
124,LAC,2022-03-03,132,,LAL,1,240,51,93,0.548,34,66,0.515,17,27,0.63,13,15,0.867,132,41,84,0.488,29,49,0.592,12,35,0.343,17,22,0.773,111
125,UTA,2022-03-02,132,@,HOU,1,265,50,91,0.549,35,49,0.714,15,42,0.357,17,24,0.708,132,43,86,0.5,22,35,0.629,21,51,0.412,20,30,0.667,127
126,GSW,2022-02-24,132,@,POR,1,240,45,88,0.511,30,47,0.638,15,41,0.366,27,32,0.844,132,31,79,0.392,22,44,0.5,9,35,0.257,24,29,0.828,95
127,PHO,2022-02-12,132,,ORL,1,240,55,105,0.524,40,71,0.563,15,34,0.441,7,10,0.7,132,37,87,0.425,22,46,0.478,15,41,0.366,16,24,0.667,105
128,MEM,2022-02-10,132,@,DET,1,240,44,92,0.478,29,62,0.468,15,30,0.5,29,42,0.69,132,41,94,0.436,34,59,0.576,7,35,0.2,18,21,0.857,107
129,SAC,2022-02-09,132,,MIN,1,240,48,93,0.516,36,63,0.571,12,30,0.4,24,27,0.889,132,44,98,0.449,28,52,0.538,16,46,0.348,15,18,0.833,119
130,DEN,2022-02-08,132,,NYK,1,240,46,85,0.541,30,46,0.652,16,39,0.41,24,31,0.774,132,45,101,0.446,30,58,0.517,15,43,0.349,10,12,0.833,115
131,DAL,2022-01-29,132,,IND,1,240,51,96,0.531,35,62,0.565,16,34,0.471,14,22,0.636,132,40,91,0.44,31,58,0.534,9,33,0.273,16,23,0.696,105
132,DAL,2022-01-26,132,@,POR,1,240,48,88,0.545,32,52,0.615,16,36,0.444,20,26,0.769,132,42,82,0.512,28,44,0.636,14,38,0.368,14,23,0.609,112
133,LAL,2021-12-28,132,@,HOU,1,240,48,92,0.522,34,58,0.586,14,34,0.412,22,29,0.759,132,44,83,0.53,28,48,0.583,16,35,0.457,19,25,0.76,123
134,DAL,2021-12-27,132,@,POR,1,240,48,84,0.571,36,51,0.706,12,33,0.364,24,33,0.727,132,35,82,0.427,23,42,0.548,12,40,0.3,35,42,0.833,117
135,HOU,2021-12-13,132,@,ATL,1,240,46,96,0.479,27,50,0.54,19,46,0.413,21,27,0.778,132,42,85,0.494,27,46,0.587,15,39,0.385,27,31,0.871,126
136,ATL,2021-11-26,132,@,MEM,1,240,52,89,0.584,39,62,0.629,13,27,0.481,15,21,0.714,132,37,91,0.407,25,53,0.472,12,38,0.316,14,19,0.737,100
137,MEM,2021-10-20,132,,CLE,1,240,53,100,0.53,39,67,0.582,14,33,0.424,12,12,1.0,132,47,93,0.505,33,55,0.6,14,38,0.368,13,18,0.722,121
138,MIL,2022-04-08,131,@,DET,1,240,50,101,0.495,39,64,0.609,11,37,0.297,20,23,0.87,131,35,90,0.389,25,42,0.595,10,48,0.208,21,23,0.913,101
139,DAL,2022-04-06,131,@,DET,1,240,45,80,0.563,30,47,0.638,15,33,0.455,26,34,0.765,131,35,82,0.427,24,52,0.462,11,30,0.367,32,35,0.914,113
140,PHI,2022-04-05,131,@,IND,1,240,47,87,0.54,24,47,0.511,23,40,0.575,14,18,0.778,131,45,95,0.474,33,55,0.6,12,40,0.3,20,21,0.952,122
141,ATL,2022-03-31,131,,CLE,1,240,45,91,0.495,28,52,0.538,17,39,0.436,24,28,0.857,131,39,90,0.433,32,60,0.533,7,30,0.233,22,28,0.786,107
142,POR,2022-03-28,131,,OKC,0,265,51,112,0.455,31,62,0.5,20,50,0.4,9,13,0.692,131,48,90,0.533,28,45,0.622,20,45,0.444,18,25,0.72,134
143,TOR,2022-03-26,131,,IND,1,240,51,84,0.607,36,52,0.692,15,32,0.469,14,19,0.737,131,33,79,0.418,22,43,0.512,11,36,0.306,14,20,0.7,91
144,LAL,2022-03-21,131,@,CLE,1,240,53,94,0.564,41,62,0.661,12,32,0.375,13,16,0.813,131,45,86,0.523,31,47,0.66,14,39,0.359,16,19,0.842,120
145,PHO,2022-03-15,131,@,NOP,1,240,49,90,0.544,31,56,0.554,18,34,0.529,15,15,1.0,131,43,86,0.5,31,52,0.596,12,34,0.353,17,24,0.708,115
146,ATL,2022-03-13,131,,IND,1,240,46,84,0.548,29,46,0.63,17,38,0.447,22,24,0.917,131,46,89,0.517,31,54,0.574,15,35,0.429,21,26,0.808,128
147,NYK,2022-03-07,131,@,SAC,1,240,47,92,0.511,29,50,0.58,18,42,0.429,19,23,0.826,131,39,80,0.488,28,48,0.583,11,32,0.344,26,36,0.722,115
148,DEN,2022-03-07,131,,GSW,1,240,46,84,0.548,36,52,0.692,10,32,0.313,29,41,0.707,131,45,88,0.511,28,48,0.583,17,40,0.425,17,23,0.739,124
149,SAC,2022-02-28,131,@,OKC,1,240,49,87,0.563,39,56,0.696,10,31,0.323,23,30,0.767,131,40,86,0.465,29,51,0.569,11,35,0.314,19,27,0.704,110
150,PHO,2022-02-10,131,,MIL,1,240,51,90,0.567,42,60,0.7,9,30,0.3,20,29,0.69,131,40,88,0.455,30,50,0.6,10,38,0.263,17,25,0.68,107
151,MIL,2022-02-08,131,@,LAL,1,240,52,96,0.542,37,60,0.617,15,36,0.417,12,20,0.6,131,44,85,0.518,34,53,0.642,10,32,0.313,18,30,0.6,116
152,SAS,2022-02-04,131,,HOU,1,240,51,89,0.573,38,61,0.623,13,28,0.464,16,20,0.8,131,36,83,0.434,25,50,0.5,11,33,0.333,23,29,0.793,106
153,SAS,2022-01-28,131,,CHI,1,240,50,95,0.526,34,58,0.586,16,37,0.432,15,18,0.833,131,46,88,0.523,38,58,0.655,8,30,0.267,22,26,0.846,122
154,SAC,2022-01-19,131,,DET,0,240,44,84,0.524,32,57,0.561,12,27,0.444,31,44,0.705,131,46,91,0.505,31,55,0.564,15,36,0.417,26,30,0.867,133
155,ATL,2022-01-03,131,@,POR,0,240,48,88,0.545,34,47,0.723,14,41,0.341,21,24,0.875,131,47,89,0.528,29,48,0.604,18,41,0.439,24,28,0.857,136
156,CHI,2021-12-29,131,,ATL,1,240,52,84,0.619,42,62,0.677,10,22,0.455,17,22,0.773,131,44,92,0.478,33,66,0.5,11,26,0.423,18,26,0.692,117
157,CHO,2021-12-15,131,@,SAS,1,240,51,86,0.593,33,52,0.635,18,34,0.529,11,16,0.688,131,39,90,0.433,27,53,0.509,12,37,0.324,25,25,1.0,115
158,BRK,2021-12-14,131,,TOR,1,265,50,103,0.485,36,64,0.563,14,39,0.359,17,23,0.739,131,48,105,0.457,30,53,0.566,18,52,0.346,15,19,0.789,129
159,IND,2021-11-01,131,,SAS,1,240,52,91,0.571,34,53,0.642,18,38,0.474,9,12,0.75,131,47,89,0.528,33,61,0.541,14,28,0.5,10,14,0.714,118
160,ATL,2022-04-10,130,@,HOU,1,240,45,87,0.517,24,49,0.49,21,38,0.553,19,24,0.792,130,41,89,0.461,24,43,0.558,17,46,0.37,15,20,0.75,114
161,DAL,2022-04-10,130,,SAS,1,240,46,85,0.541,26,49,0.531,20,36,0.556,18,23,0.783,130,43,89,0.483,32,58,0.552,11,31,0.355,23,23,1.0,120
162,SAS,2022-04-01,130,,POR,1,240,46,81,0.568,30,44,0.682,16,37,0.432,22,28,0.786,130,41,92,0.446,26,57,0.456,15,35,0.429,14,20,0.7,111
163,DEN,2022-04-01,130,,MIN,0,240,46,86,0.535,34,51,0.667,12,35,0.343,26,29,0.897,130,43,86,0.5,24,46,0.522,19,40,0.475,31,36,0.861,136
164,LAC,2022-03-31,130,@,CHI,0,265,45,90,0.5,29,54,0.537,16,36,0.444,24,26,0.923,130,50,102,0.49,40,73,0.548,10,29,0.345,25,32,0.781,135
165,BRK,2022-03-29,130,,DET,1,240,42,76,0.553,27,48,0.563,15,28,0.536,31,34,0.912,130,48,99,0.485,32,61,0.525,16,38,0.421,11,13,0.846,123
166,DEN,2022-03-24,130,,PHO,0,240,48,81,0.593,33,49,0.673,15,32,0.469,19,27,0.704,130,52,86,0.605,39,59,0.661,13,27,0.481,23,29,0.793,140
167,NOP,2022-03-13,130,,HOU,1,240,48,93,0.516,38,61,0.623,10,32,0.313,24,34,0.706,130,39,77,0.506,27,46,0.587,12,31,0.387,15,25,0.6,105
168,LAL,2022-03-09,130,@,HOU,0,265,47,101,0.465,29,54,0.537,18,47,0.383,18,26,0.692,130,52,102,0.51,35,62,0.565,17,40,0.425,18,19,0.947,139
169,NOP,2022-03-06,130,@,DEN,0,265,48,101,0.475,34,68,0.5,14,33,0.424,20,29,0.69,130,47,87,0.54,37,54,0.685,10,33,0.303,34,43,0.791,138
170,ATL,2022-03-03,130,,CHI,1,240,44,84,0.524,26,44,0.591,18,40,0.45,24,28,0.857,130,52,88,0.591,38,62,0.613,14,26,0.538,6,7,0.857,124
171,MIL,2022-02-28,130,,CHO,1,240,40,91,0.44,22,46,0.478,18,45,0.4,32,37,0.865,130,36,93,0.387,22,54,0.407,14,39,0.359,20,32,0.625,106
172,ATL,2022-02-16,130,@,ORL,1,240,45,90,0.5,27,57,0.474,18,33,0.545,22,28,0.786,130,42,98,0.429,29,57,0.509,13,41,0.317,12,13,0.923,109
173,MIN,2022-02-01,130,,DEN,1,240,46,93,0.495,27,48,0.563,19,45,0.422,19,25,0.76,130,38,89,0.427,24,45,0.533,14,44,0.318,25,28,0.893,115
174,CHI,2022-01-30,130,,POR,1,240,50,90,0.556,37,58,0.638,13,32,0.406,17,18,0.944,130,43,83,0.518,25,44,0.568,18,39,0.462,12,16,0.75,116
175,GSW,2022-01-25,130,,DAL,1,240,49,92,0.533,32,49,0.653,17,43,0.395,15,18,0.833,130,32,91,0.352,22,51,0.431,10,40,0.25,18,18,1.0,92
176,DEN,2022-01-19,130,,LAC,1,265,48,98,0.49,35,60,0.583,13,38,0.342,21,25,0.84,130,52,97,0.536,37,58,0.638,15,39,0.385,9,12,0.75,128
177,OKC,2022-01-13,130,@,BRK,1,240,47,91,0.516,27,46,0.587,20,45,0.444,16,18,0.889,130,41,98,0.418,34,66,0.515,7,32,0.219,20,22,0.909,109
178,DAL,2022-01-07,130,@,HOU,1,240,49,90,0.544,32,52,0.615,17,38,0.447,15,28,0.536,130,37,87,0.425,25,44,0.568,12,43,0.279,20,29,0.69,106
179,CHI,2022-01-07,130,,WAS,1,240,48,91,0.527,33,58,0.569,15,33,0.455,19,21,0.905,130,45,88,0.511,38,64,0.594,7,24,0.292,25,26,0.962,122
180,CHI,2021-12-27,130,@,ATL,1,240,51,94,0.543,33,57,0.579,18,37,0.486,10,14,0.714,130,40,89,0.449,25,55,0.455,15,34,0.441,23,26,0.885,118
181,ORL,2021-12-08,130,@,SAC,0,240,48,97,0.495,32,63,0.508,16,34,0.471,18,23,0.783,130,53,97,0.546,38,63,0.603,15,34,0.441,21,25,0.84,142
182,CHO,2021-12-05,130,@,ATL,1,240,46,86,0.535,29,49,0.592,17,37,0.459,21,28,0.75,130,48,93,0.516,31,56,0.554,17,37,0.459,14,18,0.778,127
183,BOS,2021-12-03,130,@,UTA,0,240,47,91,0.516,33,52,0.635,14,39,0.359,22,22,1.0,130,45,81,0.556,18,30,0.6,27,51,0.529,20,23,0.87,137
184,BOS,2021-11-19,130,,LAL,1,240,44,88,0.5,33,58,0.569,11,30,0.367,31,38,0.816,130,39,84,0.464,27,54,0.5,12,30,0.4,18,24,0.75,108
185,DEN,2022-04-03,129,@,LAL,1,240,47,82,0.573,35,51,0.686,12,31,0.387,23,29,0.793,129,49,92,0.533,43,72,0.597,6,20,0.3,14,21,0.667,118
186,IND,2022-03-20,129,,POR,1,240,48,84,0.571,33,49,0.673,15,35,0.429,18,21,0.857,129,38,81,0.469,29,48,0.604,9,33,0.273,13,18,0.722,98
187,CHO,2022-03-19,129,,DAL,1,240,44,88,0.5,24,46,0.522,20,42,0.476,21,27,0.778,129,39,89,0.438,25,51,0.49,14,38,0.368,16,20,0.8,108
188,PHO,2022-03-18,129,,CHI,1,240,47,84,0.56,36,59,0.61,11,25,0.44,24,26,0.923,129,35,85,0.412,28,58,0.483,7,27,0.259,25,31,0.806,102
189,PHO,2022-03-16,129,@,HOU,1,240,53,95,0.558,40,62,0.645,13,33,0.394,10,13,0.769,129,42,85,0.494,26,46,0.565,16,39,0.41,12,19,0.632,112
190,BRK,2022-03-10,129,@,PHI,1,240,51,91,0.56,33,51,0.647,18,40,0.45,9,17,0.529,129,30,93,0.323,16,57,0.281,14,36,0.389,26,30,0.867,100
191,MIN,2022-03-01,129,,GSW,1,240,47,89,0.528,31,49,0.633,16,40,0.4,19,23,0.826,129,41,90,0.456,28,45,0.622,13,45,0.289,19,22,0.864,114
192,SAS,2022-02-26,129,@,MIA,0,240,50,90,0.556,36,59,0.61,14,31,0.452,15,19,0.789,129,47,83,0.566,35,55,0.636,12,28,0.429,27,38,0.711,133
193,OKC,2022-02-25,129,@,IND,1,265,50,101,0.495,39,70,0.557,11,31,0.355,18,24,0.75,129,49,101,0.485,35,64,0.547,14,37,0.378,13,22,0.591,125
194,BOS,2022-02-24,129,@,BRK,1,240,46,85,0.541,29,43,0.674,17,42,0.405,20,27,0.741,129,39,94,0.415,32,65,0.492,7,29,0.241,21,28,0.75,106
195,MIN,2022-02-13,129,@,IND,1,240,43,84,0.512,25,50,0.5,18,34,0.529,25,28,0.893,129,45,102,0.441,32,57,0.561,13,45,0.289,17,22,0.773,120
196,ATL,2022-01-30,129,,LAL,1,240,49,84,0.583,39,53,0.736,10,31,0.323,21,32,0.656,129,47,87,0.54,32,52,0.615,15,35,0.429,12,23,0.522,121
197,BRK,2022-01-05,129,@,IND,1,240,49,86,0.57,44,65,0.677,5,21,0.238,26,29,0.897,129,41,82,0.5,28,43,0.651,13,39,0.333,26,28,0.929,121
198,TOR,2022-01-04,129,,SAS,1,240,45,96,0.469,27,52,0.519,18,44,0.409,21,29,0.724,129,41,95,0.432,32,60,0.533,9,35,0.257,13,19,0.684,104
199,TOR,2021-12-14,129,@,BRK,0,265,48,105,0.457,30,53,0.566,18,52,0.346,15,19,0.789,129,50,103,0.485,36,64,0.563,14,39,0.359,17,23,0.739,131
200,UTA,2021-11-29,129,,POR,1,240,47,89,0.528,28,43,0.651,19,46,0.413,16,23,0.696,129,42,91,0.462,31,60,0.517,11,31,0.355,12,17,0.706,107
201,SAC,2021-11-15,129,@,DET,1,240,52,98,0.531,36,65,0.554,16,33,0.485,9,11,0.818,129,39,96,0.406,26,49,0.531,13,47,0.277,16,17,0.941,107
202,ATL,2021-11-15,129,,ORL,1,240,47,85,0.553,33,55,0.6,14,30,0.467,21,32,0.656,129,43,95,0.453,27,52,0.519,16,43,0.372,9,14,0.643,111
203,LAC,2021-11-13,129,,MIN,1,240,53,99,0.535,37,59,0.627,16,40,0.4,7,9,0.778,129,40,102,0.392,29,66,0.439,11,36,0.306,11,16,0.688,102
204,MIA,2021-10-30,129,@,MEM,1,240,46,88,0.523,25,51,0.49,21,37,0.568,16,19,0.842,129,34,88,0.386,18,38,0.474,16,50,0.32,19,21,0.905,103
205,CHO,2021-10-25,129,,BOS,0,265,46,103,0.447,27,59,0.458,19,44,0.432,18,28,0.643,129,50,101,0.495,31,51,0.608,19,50,0.38,21,25,0.84,140
206,GSW,2022-04-10,128,@,NOP,1,240,49,81,0.605,30,48,0.625,19,33,0.576,11,13,0.846,128,42,99,0.424,28,59,0.475,14,40,0.35,9,12,0.75,107
207,DAL,2022-04-08,128,,POR,1,240,42,79,0.532,22,34,0.647,20,45,0.444,24,31,0.774,128,31,83,0.373,24,51,0.471,7,32,0.219,9,12,0.75,78
208,CHO,2022-04-07,128,,ORL,1,240,48,92,0.522,36,58,0.621,12,34,0.353,20,27,0.741,128,38,95,0.4,23,47,0.489,15,48,0.313,10,13,0.769,101
209,GSW,2022-04-07,128,,LAL,1,240,51,97,0.526,35,65,0.538,16,32,0.5,10,10,1.0,128,37,83,0.446,28,51,0.549,9,32,0.281,29,38,0.763,112
210,BOS,2022-04-01,128,,IND,1,240,45,83,0.542,33,50,0.66,12,33,0.364,26,28,0.929,128,42,81,0.519,25,45,0.556,17,36,0.472,22,23,0.957,123
211,DAL,2022-03-29,128,,LAL,1,240,45,87,0.517,25,41,0.61,20,46,0.435,18,23,0.783,128,40,89,0.449,28,45,0.622,12,44,0.273,18,22,0.818,110
212,BRK,2022-03-18,128,,POR,1,240,45,77,0.584,35,52,0.673,10,25,0.4,28,33,0.848,128,48,96,0.5,35,61,0.574,13,35,0.371,14,24,0.583,123
213,LAL,2022-03-18,128,@,TOR,1,265,47,96,0.49,28,53,0.528,19,43,0.442,15,21,0.714,128,49,97,0.505,37,60,0.617,12,37,0.324,13,20,0.65,123
214,NYK,2022-03-16,128,,POR,1,240,40,80,0.5,24,42,0.571,16,38,0.421,32,39,0.821,128,40,91,0.44,29,57,0.509,11,34,0.324,7,14,0.5,98
215,IND,2022-03-13,128,@,ATL,0,240,46,89,0.517,31,54,0.574,15,35,0.429,21,26,0.808,128,46,84,0.548,29,46,0.63,17,38,0.447,22,24,0.917,131
216,IND,2022-02-27,128,,BOS,1,240,47,90,0.522,30,57,0.526,17,33,0.515,17,20,0.85,128,39,91,0.429,27,48,0.563,12,43,0.279,17,20,0.85,107
217,DEN,2022-02-24,128,@,SAC,1,240,48,86,0.558,33,51,0.647,15,35,0.429,17,20,0.85,128,43,86,0.5,34,57,0.596,9,29,0.31,15,18,0.833,110
218,MIL,2022-02-15,128,,IND,1,240,48,86,0.558,38,57,0.667,10,29,0.345,22,30,0.733,128,47,93,0.505,30,52,0.577,17,41,0.415,8,19,0.421,119
219,MIN,2022-02-03,128,@,DET,1,240,44,87,0.506,29,53,0.547,15,34,0.441,25,28,0.893,128,40,91,0.44,25,45,0.556,15,46,0.326,22,28,0.786,117
220,BOS,2022-01-25,128,,SAC,1,240,51,103,0.495,31,58,0.534,20,45,0.444,6,7,0.857,128,29,95,0.305,23,62,0.371,6,33,0.182,11,15,0.733,75
221,LAC,2022-01-19,128,@,DEN,0,265,52,97,0.536,37,58,0.638,15,39,0.385,9,12,0.75,128,48,98,0.49,35,60,0.583,13,38,0.342,21,25,0.84,130
222,HOU,2022-01-12,128,@,SAS,1,240,45,82,0.549,29,46,0.63,16,36,0.444,22,32,0.688,128,43,99,0.434,26,53,0.491,17,46,0.37,21,27,0.778,124
223,NOP,2022-01-11,128,,MIN,1,240,42,76,0.553,26,43,0.605,16,33,0.485,28,37,0.757,128,42,86,0.488,24,47,0.511,18,39,0.462,23,31,0.742,125
224,UTA,2021-12-23,128,,MIN,1,240,48,90,0.533,32,51,0.627,16,39,0.41,16,22,0.727,128,45,101,0.446,28,56,0.5,17,45,0.378,9,12,0.75,116
225,SAS,2021-12-17,128,@,UTA,1,240,50,100,0.5,35,59,0.593,15,41,0.366,13,18,0.722,128,46,93,0.495,33,56,0.589,13,37,0.351,21,26,0.808,126
226,MEM,2021-11-28,128,,SAC,1,240,50,104,0.481,37,65,0.569,13,39,0.333,15,20,0.75,128,33,97,0.34,24,55,0.436,9,42,0.214,26,37,0.703,101
227,CHI,2021-11-01,128,@,BOS,1,240,49,86,0.57,36,55,0.655,13,31,0.419,17,18,0.944,128,42,96,0.438,27,63,0.429,15,33,0.455,15,20,0.75,114
228,CHI,2021-10-22,128,,NOP,1,240,47,89,0.528,33,61,0.541,14,28,0.5,20,25,0.8,128,42,87,0.483,27,58,0.466,15,29,0.517,13,16,0.813,112
229,MIN,2022-04-07,127,,SAS,1,240,41,96,0.427,21,43,0.488,20,53,0.377,25,31,0.806,127,43,89,0.483,33,61,0.541,10,28,0.357,25,34,0.735,121
230,MIL,2022-04-07,127,,BOS,1,240,49,97,0.505,35,59,0.593,14,38,0.368,15,21,0.714,127,43,87,0.494,22,37,0.595,21,50,0.42,14,19,0.737,121
231,NOP,2022-04-07,127,,POR,1,240,44,93,0.473,31,56,0.554,13,37,0.351,26,31,0.839,127,36,69,0.522,25,38,0.658,11,31,0.355,11,13,0.846,94
232,MIL,2022-04-05,127,@,CHI,1,240,46,87,0.529,34,52,0.654,12,35,0.343,23,25,0.92,127,42,98,0.429,33,65,0.508,9,33,0.273,13,13,1.0,106
233,MIA,2022-04-02,127,@,CHI,1,240,44,82,0.537,27,48,0.563,17,34,0.5,22,27,0.815,127,37,86,0.43,28,52,0.538,9,34,0.265,26,29,0.897,109
234,WAS,2022-03-30,127,,ORL,1,240,47,92,0.511,34,56,0.607,13,36,0.361,20,26,0.769,127,40,96,0.417,29,62,0.468,11,34,0.324,19,22,0.864,110
235,MEM,2022-03-26,127,,MIL,1,240,49,102,0.48,36,65,0.554,13,37,0.351,16,23,0.696,127,37,93,0.398,30,61,0.492,7,32,0.219,21,26,0.808,102
236,DEN,2022-03-22,127,,LAC,1,240,45,83,0.542,29,51,0.569,16,32,0.5,21,23,0.913,127,42,86,0.488,32,54,0.593,10,32,0.313,21,26,0.808,115
237,PHO,2022-03-20,127,@,SAC,1,265,46,92,0.5,34,64,0.531,12,28,0.429,23,27,0.852,127,39,91,0.429,23,57,0.404,16,34,0.471,30,36,0.833,124
238,WAS,2022-03-19,127,,LAL,1,240,44,85,0.518,31,54,0.574,13,31,0.419,26,31,0.839,127,48,91,0.527,35,56,0.625,13,35,0.371,10,11,0.909,119
239,DEN,2022-03-16,127,@,WAS,1,240,46,90,0.511,31,53,0.585,15,37,0.405,20,21,0.952,127,41,87,0.471,36,64,0.563,5,23,0.217,22,31,0.71,109
240,POR,2022-03-12,127,,WAS,1,240,48,93,0.516,37,63,0.587,11,30,0.367,20,22,0.909,127,39,83,0.47,25,49,0.51,14,34,0.412,26,27,0.963,118
241,TOR,2022-03-12,127,@,DEN,1,240,48,102,0.471,36,71,0.507,12,31,0.387,19,25,0.76,127,43,78,0.551,32,51,0.627,11,27,0.407,18,24,0.75,115
242,CLE,2022-03-08,127,@,IND,1,240,47,94,0.5,38,62,0.613,9,32,0.281,24,27,0.889,127,49,91,0.538,33,59,0.559,16,32,0.5,10,15,0.667,124
243,HOU,2022-03-02,127,,UTA,0,265,43,86,0.5,22,35,0.629,21,51,0.412,20,30,0.667,127,50,91,0.549,35,49,0.714,15,42,0.357,17,24,0.708,132
244,MIN,2022-02-28,127,@,CLE,1,240,47,86,0.547,29,44,0.659,18,42,0.429,15,19,0.789,127,39,74,0.527,24,37,0.649,15,37,0.405,29,34,0.853,122
245,DET,2022-02-27,127,@,CHO,1,265,50,110,0.455,36,70,0.514,14,40,0.35,13,18,0.722,127,45,89,0.506,32,58,0.552,13,31,0.419,23,34,0.676,126
246,ATL,2022-02-26,127,,TOR,1,240,48,83,0.578,35,52,0.673,13,31,0.419,18,22,0.818,127,38,95,0.4,28,63,0.444,10,32,0.313,14,19,0.737,100
247,OKC,2022-02-14,127,@,NYK,1,265,48,96,0.5,35,62,0.565,13,34,0.382,18,27,0.667,127,45,108,0.417,30,58,0.517,15,50,0.3,18,22,0.818,123
248,PHO,2022-02-07,127,@,CHI,1,240,49,90,0.544,37,58,0.638,12,32,0.375,17,19,0.895,127,43,90,0.478,33,64,0.516,10,26,0.385,28,31,0.903,124
249,TOR,2022-02-03,127,,CHI,1,265,48,113,0.425,34,77,0.442,14,36,0.389,17,19,0.895,127,43,90,0.478,31,61,0.508,12,29,0.414,22,24,0.917,120
250,SAC,2022-01-22,127,@,MIL,0,240,51,97,0.526,36,60,0.6,15,37,0.405,10,16,0.625,127,45,91,0.495,24,49,0.49,21,42,0.5,22,25,0.88,133
251,MEM,2022-01-09,127,@,LAL,1,240,47,86,0.547,36,56,0.643,11,30,0.367,22,32,0.688,127,45,97,0.464,31,64,0.484,14,33,0.424,15,19,0.789,119
252,MIL,2021-12-28,127,@,ORL,1,240,47,85,0.553,30,48,0.625,17,37,0.459,16,22,0.727,127,38,83,0.458,26,44,0.591,12,39,0.308,22,26,0.846,110
253,MEM,2021-12-26,127,@,SAC,1,240,47,100,0.47,38,70,0.543,9,30,0.3,24,30,0.8,127,34,81,0.42,24,52,0.462,10,29,0.345,24,27,0.889,102
254,DEN,2021-12-11,127,@,SAS,1,240,47,93,0.505,27,50,0.54,20,43,0.465,13,14,0.929,127,41,89,0.461,31,62,0.5,10,27,0.37,20,29,0.69,112
255,PHI,2021-12-06,127,@,CHO,1,265,46,87,0.529,31,51,0.608,15,36,0.417,20,27,0.741,127,48,107,0.449,32,61,0.525,16,46,0.348,12,17,0.706,124
256,ATL,2021-12-05,127,,CHO,0,240,48,93,0.516,31,56,0.554,17,37,0.459,14,18,0.778,127,46,86,0.535,29,49,0.592,17,37,0.459,21,28,0.75,130
257,MIL,2021-12-01,127,,CHO,1,240,46,94,0.489,32,58,0.552,14,36,0.389,21,26,0.808,127,43,87,0.494,22,36,0.611,21,51,0.412,18,21,0.857,125
258,UTA,2021-11-27,127,,NOP,1,240,45,80,0.563,25,45,0.556,20,35,0.571,17,22,0.773,127,40,93,0.43,32,58,0.552,8,35,0.229,17,21,0.81,105
259,NOP,2021-11-24,127,,WAS,1,240,44,96,0.458,32,67,0.478,12,29,0.414,27,32,0.844,127,36,84,0.429,29,53,0.547,7,31,0.226,23,36,0.639,102
260,DET,2021-11-13,127,@,TOR,1,240,43,79,0.544,28,44,0.636,15,35,0.429,26,30,0.867,127,44,87,0.506,31,53,0.585,13,34,0.382,20,31,0.645,121
261,GSW,2021-11-08,127,,ATL,1,240,44,92,0.478,26,48,0.542,18,44,0.409,21,22,0.955,127,38,82,0.463,21,39,0.538,17,43,0.395,20,26,0.769,113
262,MIL,2021-10-19,127,,BRK,1,240,48,105,0.457,31,60,0.517,17,45,0.378,14,18,0.778,127,37,84,0.44,20,52,0.385,17,32,0.531,13,23,0.565,104
263,IND,2022-04-10,126,@,BRK,0,240,47,104,0.452,28,58,0.483,19,46,0.413,13,19,0.684,126,52,81,0.642,44,59,0.746,8,22,0.364,22,25,0.88,134
264,NOP,2022-03-24,126,,CHI,1,240,41,83,0.494,29,54,0.537,12,29,0.414,32,34,0.941,126,40,78,0.513,26,44,0.591,14,34,0.412,15,19,0.789,109
265,PHI,2022-03-23,126,@,LAL,1,240,47,91,0.516,37,64,0.578,10,27,0.37,22,28,0.786,126,50,97,0.515,39,67,0.582,11,30,0.367,10,16,0.625,121
266,MIL,2022-03-22,126,,CHI,1,240,50,82,0.61,38,54,0.704,12,28,0.429,14,20,0.7,126,39,92,0.424,26,59,0.441,13,33,0.394,7,13,0.538,98
267,BOS,2022-03-18,126,@,SAC,1,240,46,82,0.561,24,42,0.571,22,40,0.55,12,17,0.706,126,33,79,0.418,20,43,0.465,13,36,0.361,18,24,0.75,97
268,SAC,2022-03-16,126,,MIL,0,240,46,94,0.489,30,51,0.588,16,43,0.372,18,21,0.857,126,47,89,0.528,29,54,0.537,18,35,0.514,23,32,0.719,135
269,GSW,2022-03-14,126,,WAS,1,240,45,84,0.536,27,39,0.692,18,45,0.4,18,22,0.818,126,42,82,0.512,32,56,0.571,10,26,0.385,18,23,0.783,112
270,BOS,2022-03-06,126,,BRK,1,240,40,83,0.482,23,47,0.489,17,36,0.472,29,38,0.763,126,45,89,0.506,33,62,0.532,12,27,0.444,18,20,0.9,120
271,CHO,2022-02-27,126,,DET,0,265,45,89,0.506,32,58,0.552,13,31,0.419,23,34,0.676,126,50,110,0.455,36,70,0.514,14,40,0.35,13,18,0.722,127
272,BRK,2022-02-26,126,@,MIL,1,240,44,92,0.478,31,58,0.534,13,34,0.382,25,33,0.758,126,41,78,0.526,25,40,0.625,16,38,0.421,25,38,0.658,123
273,MIN,2022-02-15,126,,CHO,1,265,43,109,0.394,30,54,0.556,13,55,0.236,27,43,0.628,126,42,102,0.412,34,69,0.493,8,33,0.242,28,37,0.757,120
274,BOS,2022-02-08,126,@,BRK,1,240,50,91,0.549,36,51,0.706,14,40,0.35,12,16,0.75,126,38,99,0.384,28,63,0.444,10,36,0.278,5,13,0.385,91
275,GSW,2022-02-03,126,,SAC,1,240,47,84,0.56,27,42,0.643,20,42,0.476,12,16,0.75,126,42,80,0.525,31,49,0.633,11,31,0.355,19,23,0.826,114
276,CHI,2022-02-01,126,,ORL,1,240,46,90,0.511,35,60,0.583,11,30,0.367,23,29,0.793,126,46,93,0.495,32,54,0.593,14,39,0.359,9,11,0.818,115
277,MIN,2022-01-30,126,,UTA,1,240,49,89,0.551,36,58,0.621,13,31,0.419,15,18,0.833,126,38,81,0.469,23,41,0.561,15,40,0.375,15,21,0.714,106
278,IND,2022-01-26,126,,CHO,0,240,44,92,0.478,34,58,0.586,10,34,0.294,28,34,0.824,126,54,93,0.581,30,48,0.625,24,45,0.533,26,33,0.788,158
279,MIL,2022-01-19,126,,MEM,1,240,46,97,0.474,33,60,0.55,13,37,0.351,21,22,0.955,126,44,106,0.415,35,66,0.53,9,40,0.225,17,25,0.68,114
280,SAC,2022-01-14,126,,HOU,1,240,48,96,0.5,35,59,0.593,13,37,0.351,17,24,0.708,126,44,101,0.436,31,58,0.534,13,43,0.302,13,16,0.813,114
281,DET,2022-01-10,126,,UTA,1,240,48,93,0.516,29,56,0.518,19,37,0.514,11,12,0.917,126,44,86,0.512,33,53,0.623,11,33,0.333,17,22,0.773,116
282,MIL,2021-12-22,126,,HOU,1,240,45,103,0.437,28,57,0.491,17,46,0.37,19,21,0.905,126,36,86,0.419,23,41,0.561,13,45,0.289,21,31,0.677,106
283,UTA,2021-12-17,126,,SAS,0,240,46,93,0.495,33,56,0.589,13,37,0.351,21,26,0.808,126,50,100,0.5,35,59,0.593,15,41,0.366,13,18,0.722,128
284,ATL,2021-12-13,126,,HOU,0,240,42,85,0.494,27,46,0.587,15,39,0.385,27,31,0.871,126,46,96,0.479,27,50,0.54,19,46,0.413,21,27,0.778,132
285,MEM,2021-12-13,126,,PHI,1,240,47,89,0.528,33,55,0.6,14,34,0.412,18,23,0.783,126,37,83,0.446,33,61,0.541,4,22,0.182,13,19,0.684,91
286,GSW,2021-12-06,126,,ORL,1,240,43,87,0.494,23,47,0.489,20,40,0.5,20,29,0.69,126,33,76,0.434,22,38,0.579,11,38,0.289,18,22,0.818,95
287,TOR,2021-11-24,126,@,MEM,1,240,47,89,0.528,33,59,0.559,14,30,0.467,18,21,0.857,126,42,82,0.512,33,53,0.623,9,29,0.31,20,26,0.769,113
288,PHO,2021-11-21,126,,DEN,1,240,46,87,0.529,35,51,0.686,11,36,0.306,23,26,0.885,126,33,90,0.367,22,52,0.423,11,38,0.289,20,28,0.714,97
289,LAL,2021-11-08,126,,CHO,1,265,44,91,0.484,31,59,0.525,13,32,0.406,25,35,0.714,126,43,99,0.434,29,57,0.509,14,42,0.333,23,28,0.821,123
290,CLE,2021-11-07,126,@,NYK,1,240,49,90,0.544,30,55,0.545,19,35,0.543,9,11,0.818,126,39,85,0.459,30,54,0.556,9,31,0.29,22,24,0.917,109
291,GSW,2021-11-05,126,,NOP,1,240,47,91,0.516,27,41,0.659,20,50,0.4,12,14,0.857,126,31,88,0.352,20,44,0.455,11,44,0.25,12,16,0.75,85
292,LAC,2021-11-03,126,@,MIN,1,240,47,78,0.603,26,42,0.619,21,36,0.583,11,12,0.917,126,43,94,0.457,29,54,0.537,14,40,0.35,15,16,0.938,115
293,ORL,2022-04-10,125,,MIA,1,240,45,91,0.495,22,33,0.667,23,58,0.397,12,14,0.857,125,40,94,0.426,21,44,0.477,19,50,0.38,12,16,0.75,111
294,TOR,2022-03-30,125,,MIN,1,240,48,96,0.5,30,60,0.5,18,36,0.5,11,15,0.733,125,37,92,0.402,26,55,0.473,11,37,0.297,17,23,0.739,102
295,DEN,2022-03-30,125,@,IND,1,240,50,80,0.625,38,52,0.731,12,28,0.429,13,14,0.929,125,44,97,0.454,32,57,0.561,12,40,0.3,18,23,0.783,118
296,CHO,2022-03-30,125,@,NYK,1,240,49,90,0.544,37,55,0.673,12,35,0.343,15,17,0.882,125,40,85,0.471,24,41,0.585,16,44,0.364,18,26,0.692,114
297,HOU,2022-03-25,125,@,POR,1,240,43,83,0.518,24,38,0.632,19,45,0.422,20,23,0.87,125,43,85,0.506,40,65,0.615,3,20,0.15,17,23,0.739,106
298,BOS,2022-03-23,125,,UTA,1,240,50,84,0.595,31,48,0.646,19,36,0.528,6,7,0.857,125,35,88,0.398,27,52,0.519,8,36,0.222,19,21,0.905,97
299,PHO,2022-03-23,125,@,MIN,1,240,45,86,0.523,33,53,0.623,12,33,0.364,23,29,0.793,125,42,95,0.442,29,52,0.558,13,43,0.302,19,22,0.864,116
300,UTA,2022-03-16,125,,CHI,1,240,42,83,0.506,23,44,0.523,19,39,0.487,22,29,0.759,125,43,91,0.473,31,57,0.544,12,34,0.353,12,17,0.706,110
301,MEM,2022-03-13,125,@,OKC,1,240,48,102,0.471,37,73,0.507,11,29,0.379,18,20,0.9,125,41,97,0.423,28,56,0.5,13,41,0.317,23,28,0.821,118
302,SAC,2022-03-12,125,@,UTA,0,240,47,94,0.5,34,61,0.557,13,33,0.394,18,21,0.857,125,48,86,0.558,32,45,0.711,16,41,0.39,22,31,0.71,134
303,PHI,2022-03-04,125,,CLE,1,240,41,75,0.547,27,42,0.643,14,33,0.424,29,32,0.906,125,44,82,0.537,34,54,0.63,10,28,0.357,21,24,0.875,119
304,NOP,2022-03-02,125,,SAC,1,240,52,88,0.591,41,59,0.695,11,29,0.379,10,12,0.833,125,35,89,0.393,27,54,0.5,8,35,0.229,17,25,0.68,95
305,PHI,2022-02-27,125,@,NYK,1,240,38,78,0.487,28,45,0.622,10,33,0.303,39,44,0.886,125,38,85,0.447,27,52,0.519,11,33,0.333,22,35,0.629,109
306,CHO,2022-02-25,125,,TOR,1,240,52,94,0.553,37,54,0.685,15,40,0.375,6,9,0.667,125,37,84,0.44,31,61,0.508,6,23,0.261,13,23,0.565,93
307,IND,2022-02-25,125,,OKC,0,265,49,101,0.485,35,64,0.547,14,37,0.378,13,22,0.591,125,50,101,0.495,39,70,0.557,11,31,0.355,18,24,0.75,129
308,DAL,2022-02-17,125,@,NOP,1,240,44,82,0.537,25,42,0.595,19,40,0.475,18,25,0.72,125,46,92,0.5,34,64,0.531,12,28,0.429,14,21,0.667,118
309,CHI,2022-02-16,125,,SAC,1,240,47,94,0.5,35,65,0.538,12,29,0.414,19,20,0.95,125,43,84,0.512,31,54,0.574,12,30,0.4,20,22,0.909,118
310,MEM,2022-02-12,125,@,CHO,1,240,47,96,0.49,36,63,0.571,11,33,0.333,20,33,0.606,125,39,97,0.402,25,52,0.481,14,45,0.311,26,33,0.788,118
311,TOR,2022-02-04,125,,ATL,1,240,46,81,0.568,29,54,0.537,17,27,0.63,16,18,0.889,125,43,93,0.462,34,64,0.531,9,29,0.31,19,21,0.905,114
312,UTA,2022-02-04,125,,BRK,1,240,48,85,0.565,31,47,0.66,17,38,0.447,12,14,0.857,125,41,99,0.414,29,65,0.446,12,34,0.353,8,11,0.727,102
313,POR,2022-01-28,125,@,HOU,1,240,46,81,0.568,29,42,0.69,17,39,0.436,16,20,0.8,125,38,79,0.481,28,38,0.737,10,41,0.244,24,31,0.774,110
314,TOR,2022-01-25,125,,CHO,1,240,43,82,0.524,27,48,0.563,16,34,0.471,23,29,0.793,125,40,82,0.488,30,51,0.588,10,31,0.323,23,32,0.719,113
315,BRK,2022-01-23,125,@,MIN,0,240,48,95,0.505,33,57,0.579,15,38,0.395,14,15,0.933,125,48,92,0.522,34,60,0.567,14,32,0.438,26,31,0.839,136
316,UTA,2022-01-16,125,@,DEN,1,240,44,84,0.524,29,45,0.644,15,39,0.385,22,29,0.759,125,42,95,0.442,31,52,0.596,11,43,0.256,7,8,0.875,102
317,SAC,2022-01-12,125,,LAL,1,240,49,89,0.551,38,59,0.644,11,30,0.367,16,19,0.842,125,42,98,0.429,26,51,0.51,16,47,0.34,16,24,0.667,116
318,MIN,2022-01-11,125,@,NOP,0,240,42,86,0.488,24,47,0.511,18,39,0.462,23,31,0.742,125,42,76,0.553,26,43,0.605,16,33,0.485,28,37,0.757,128
319,IND,2022-01-08,125,,UTA,1,240,44,80,0.55,30,51,0.588,14,29,0.483,23,32,0.719,125,40,84,0.476,25,49,0.51,15,35,0.429,18,19,0.947,113
320,MIA,2021-12-21,125,,IND,1,240,47,95,0.495,25,46,0.543,22,49,0.449,9,11,0.818,125,31,87,0.356,20,56,0.357,11,31,0.355,23,28,0.821,96
321,POR,2021-12-17,125,,CHO,1,240,44,85,0.518,23,38,0.605,21,47,0.447,16,18,0.889,125,44,92,0.478,31,55,0.564,13,37,0.351,15,18,0.833,116
322,CHO,2021-12-01,125,@,MIL,0,240,43,87,0.494,22,36,0.611,21,51,0.412,18,21,0.857,125,46,94,0.489,32,58,0.552,14,36,0.389,21,26,0.808,127
323,SAC,2021-11-24,125,,POR,1,240,45,86,0.523,33,53,0.623,12,33,0.364,23,34,0.676,125,44,94,0.468,32,56,0.571,12,38,0.316,21,25,0.84,121
324,MEM,2021-11-08,125,,MIN,1,265,46,92,0.5,35,64,0.547,11,28,0.393,22,26,0.846,125,41,97,0.423,24,52,0.462,17,45,0.378,19,23,0.826,118
325,MIA,2021-11-02,125,@,DAL,1,240,43,83,0.518,30,58,0.517,13,25,0.52,26,30,0.867,125,37,84,0.44,23,42,0.548,14,42,0.333,22,31,0.71,110
326,CHO,2021-10-31,125,,POR,1,240,46,89,0.517,26,47,0.553,20,42,0.476,13,21,0.619,125,43,97,0.443,26,43,0.605,17,54,0.315,10,11,0.909,113
327,LAL,2021-10-26,125,@,SAS,1,265,50,105,0.476,42,75,0.56,8,30,0.267,17,22,0.773,125,48,108,0.444,35,72,0.486,13,36,0.361,12,22,0.545,121
328,CHI,2022-04-10,124,@,MIN,1,240,44,83,0.53,34,62,0.548,10,21,0.476,26,33,0.788,124,46,91,0.505,35,60,0.583,11,31,0.355,17,22,0.773,120
329,CHO,2022-04-10,124,,WAS,1,240,48,89,0.539,30,56,0.536,18,33,0.545,10,14,0.714,124,42,94,0.447,34,71,0.479,8,23,0.348,16,26,0.615,108
330,BOS,2022-03-20,124,@,DEN,1,240,47,82,0.573,28,42,0.667,19,40,0.475,11,11,1.0,124,35,87,0.402,21,48,0.438,14,39,0.359,20,25,0.8,104
331,SAC,2022-03-20,124,,PHO,0,265,39,91,0.429,23,57,0.404,16,34,0.471,30,36,0.833,124,46,92,0.5,34,64,0.531,12,28,0.429,23,27,0.852,127
332,NOP,2022-03-18,124,@,SAS,1,240,48,96,0.5,34,62,0.548,14,34,0.412,14,18,0.778,124,32,89,0.36,21,45,0.467,11,44,0.25,16,20,0.8,91
333,MIN,2022-03-16,124,,LAL,1,240,40,90,0.444,23,48,0.479,17,42,0.405,27,31,0.871,124,39,93,0.419,29,49,0.592,10,44,0.227,16,23,0.696,104
334,MIL,2022-03-09,124,,ATL,1,240,47,94,0.5,35,59,0.593,12,35,0.343,18,23,0.783,124,43,86,0.5,32,48,0.667,11,38,0.289,18,22,0.818,115
335,IND,2022-03-08,124,,CLE,0,240,49,91,0.538,33,59,0.559,16,32,0.5,10,15,0.667,124,47,94,0.5,38,62,0.613,9,32,0.281,24,27,0.889,127
336,MIN,2022-03-07,124,,POR,1,240,38,92,0.413,25,49,0.51,13,43,0.302,35,44,0.795,124,23,83,0.277,16,55,0.291,7,28,0.25,28,38,0.737,81
337,GSW,2022-03-07,124,@,DEN,0,240,45,88,0.511,28,48,0.583,17,40,0.425,17,23,0.739,124,46,84,0.548,36,52,0.692,10,32,0.313,29,41,0.707,131
338,LAL,2022-03-05,124,,GSW,1,240,44,89,0.494,26,48,0.542,18,41,0.439,18,21,0.857,124,46,92,0.5,31,58,0.534,15,34,0.441,9,19,0.474,116
339,MEM,2022-03-05,124,,ORL,1,240,46,92,0.5,32,58,0.552,14,34,0.412,18,27,0.667,124,37,86,0.43,26,51,0.51,11,35,0.314,11,16,0.688,96
340,NOP,2022-03-04,124,,UTA,1,240,50,97,0.515,39,61,0.639,11,36,0.306,13,17,0.765,124,31,89,0.348,20,48,0.417,11,41,0.268,17,26,0.654,90
341,CHI,2022-03-03,124,@,ATL,0,240,52,88,0.591,38,62,0.613,14,26,0.538,6,7,0.857,124,44,84,0.524,26,44,0.591,18,40,0.45,24,28,0.857,130
342,DEN,2022-02-27,124,@,POR,1,240,44,86,0.512,32,49,0.653,12,37,0.324,24,31,0.774,124,34,91,0.374,28,55,0.509,6,36,0.167,18,26,0.692,92
343,PHO,2022-02-24,124,@,OKC,1,240,46,86,0.535,33,52,0.635,13,34,0.382,19,21,0.905,124,44,93,0.473,38,62,0.613,6,31,0.194,10,11,0.909,104
344,PHO,2022-02-16,124,,HOU,1,240,44,86,0.512,37,62,0.597,7,24,0.292,29,36,0.806,124,42,97,0.433,29,53,0.547,13,44,0.295,24,28,0.857,121
345,ATL,2022-02-15,124,,CLE,1,240,43,80,0.538,29,47,0.617,14,33,0.424,24,27,0.889,124,45,88,0.511,29,47,0.617,16,41,0.39,10,12,0.833,116
346,SAS,2022-02-12,124,@,NOP,1,240,47,93,0.505,33,56,0.589,14,37,0.378,16,19,0.842,124,43,87,0.494,32,55,0.582,11,32,0.344,17,20,0.85,114
347,CHI,2022-02-07,124,,PHO,0,240,43,90,0.478,33,64,0.516,10,26,0.385,28,31,0.903,124,49,90,0.544,37,58,0.638,12,32,0.375,17,19,0.895,127
348,DEN,2022-02-06,124,,BRK,1,240,49,94,0.521,39,62,0.629,10,32,0.313,16,21,0.762,124,36,87,0.414,20,46,0.435,16,41,0.39,16,22,0.727,104
349,ATL,2022-02-03,124,,PHO,1,240,44,84,0.524,24,44,0.545,20,40,0.5,16,22,0.727,124,46,88,0.523,37,56,0.661,9,32,0.281,14,18,0.778,115
350,GSW,2022-02-01,124,@,SAS,1,240,43,96,0.448,23,50,0.46,20,46,0.435,18,18,1.0,124,46,83,0.554,30,50,0.6,16,33,0.485,12,17,0.706,120
351,TOR,2022-01-29,124,@,MIA,1,315,47,107,0.439,31,62,0.5,16,45,0.356,14,18,0.778,124,45,110,0.409,29,60,0.483,16,50,0.32,14,20,0.7,120
352,MIN,2022-01-28,124,@,PHO,0,240,44,90,0.489,30,51,0.588,14,39,0.359,22,27,0.815,124,43,84,0.512,23,45,0.511,20,39,0.513,28,37,0.757,134
353,GSW,2022-01-27,124,,MIN,1,240,44,82,0.537,23,46,0.5,21,36,0.583,15,21,0.714,124,42,95,0.442,32,51,0.627,10,44,0.227,21,27,0.778,115
354,DEN,2022-01-26,124,@,BRK,1,240,42,89,0.472,27,53,0.509,15,36,0.417,25,27,0.926,124,43,88,0.489,31,59,0.525,12,29,0.414,20,26,0.769,118
355,MIA,2022-01-14,124,,ATL,1,240,41,77,0.532,27,47,0.574,14,30,0.467,28,30,0.933,124,38,79,0.481,22,41,0.537,16,38,0.421,26,30,0.867,118
356,SAS,2022-01-12,124,,HOU,0,240,43,99,0.434,26,53,0.491,17,46,0.37,21,27,0.778,124,45,82,0.549,29,46,0.63,16,36,0.444,22,32,0.688,128
357,WAS,2022-01-03,124,,CHO,1,240,40,87,0.46,24,49,0.49,16,38,0.421,28,31,0.903,124,50,104,0.481,36,66,0.545,14,38,0.368,7,13,0.538,121
358,DEN,2022-01-01,124,@,HOU,1,240,46,86,0.535,36,54,0.667,10,32,0.313,22,27,0.815,124,37,85,0.435,21,43,0.488,16,42,0.381,21,24,0.875,111
359,BRK,2021-12-27,124,@,LAC,1,240,50,88,0.568,37,54,0.685,13,34,0.382,11,16,0.688,124,37,97,0.381,23,60,0.383,14,37,0.378,20,27,0.741,108
360,WAS,2021-12-23,124,@,NYK,1,240,42,75,0.56,26,38,0.684,16,37,0.432,24,32,0.75,124,42,93,0.452,29,51,0.569,13,42,0.31,20,23,0.87,117
361,MEM,2021-12-17,124,@,SAC,1,240,45,97,0.464,32,73,0.438,13,24,0.542,21,27,0.778,124,36,88,0.409,23,53,0.434,13,35,0.371,20,26,0.769,105
362,MIN,2021-12-15,124,@,DEN,1,240,45,88,0.511,22,40,0.55,23,48,0.479,11,16,0.688,124,38,84,0.452,24,45,0.533,14,39,0.359,17,23,0.739,107
363,UTA,2021-12-15,124,,LAC,1,240,47,89,0.528,32,52,0.615,15,37,0.405,15,20,0.75,124,40,85,0.471,30,55,0.545,10,30,0.333,13,20,0.65,103
364,CLE,2021-12-15,124,,HOU,1,240,45,80,0.563,27,40,0.675,18,40,0.45,16,24,0.667,124,30,78,0.385,25,49,0.51,5,29,0.172,24,35,0.686,89
365,TOR,2021-12-13,124,,SAC,1,240,53,98,0.541,42,67,0.627,11,31,0.355,7,10,0.7,124,38,94,0.404,27,60,0.45,11,34,0.324,14,21,0.667,101
366,CHO,2021-12-10,124,,SAC,1,240,48,87,0.552,34,52,0.654,14,35,0.4,14,20,0.7,124,48,101,0.475,34,60,0.567,14,41,0.341,13,17,0.765,123
367,CHO,2021-12-06,124,,PHI,0,265,48,107,0.449,32,61,0.525,16,46,0.348,12,17,0.706,124,46,87,0.529,31,51,0.608,15,36,0.417,20,27,0.741,127
368,MIL,2021-12-04,124,,MIA,1,240,44,98,0.449,26,48,0.542,18,50,0.36,18,20,0.9,124,34,84,0.405,17,41,0.415,17,43,0.395,17,24,0.708,102
369,SAC,2021-12-01,124,@,LAC,1,240,46,88,0.523,31,50,0.62,15,38,0.395,17,20,0.85,124,47,100,0.47,38,69,0.551,9,31,0.29,12,16,0.75,115
370,ATL,2021-11-24,124,@,SAS,1,240,45,88,0.511,33,62,0.532,12,26,0.462,22,24,0.917,124,43,100,0.43,31,67,0.463,12,33,0.364,8,10,0.8,106
371,LAL,2021-11-24,124,@,IND,1,265,42,95,0.442,27,58,0.466,15,37,0.405,25,29,0.862,124,42,104,0.404,29,58,0.5,13,46,0.283,19,24,0.792,116
372,DEN,2021-11-14,124,,POR,1,240,47,90,0.522,28,50,0.56,19,40,0.475,11,14,0.786,124,35,80,0.438,22,41,0.537,13,39,0.333,12,13,0.923,95
373,HOU,2021-10-22,124,,OKC,1,240,48,95,0.505,31,57,0.544,17,38,0.447,11,14,0.786,124,34,91,0.374,20,48,0.417,14,43,0.326,9,16,0.563,91
374,MIN,2021-10-20,124,,HOU,1,240,42,87,0.483,26,49,0.531,16,38,0.421,24,31,0.774,124,40,88,0.455,29,55,0.527,11,33,0.333,15,22,0.682,106
375,SAC,2021-10-20,124,@,POR,1,240,42,92,0.457,25,51,0.49,17,41,0.415,23,29,0.793,124,45,93,0.484,33,58,0.569,12,35,0.343,19,22,0.864,121
376,NOP,2022-04-05,123,@,SAC,1,240,45,88,0.511,33,63,0.524,12,25,0.48,21,26,0.808,123,39,76,0.513,28,46,0.609,11,30,0.367,20,22,0.909,109
377,IND,2022-04-01,123,@,BOS,0,240,42,81,0.519,25,45,0.556,17,36,0.472,22,23,0.957,123,45,83,0.542,33,50,0.66,12,33,0.364,26,28,0.929,128
378,DET,2022-03-29,123,@,BRK,0,240,48,99,0.485,32,61,0.525,16,38,0.421,11,13,0.846,123,42,76,0.553,27,48,0.563,15,28,0.536,31,34,0.912,130
379,SAS,2022-03-28,123,@,HOU,1,240,47,100,0.47,40,71,0.563,7,29,0.241,22,28,0.786,123,38,92,0.413,18,43,0.419,20,49,0.408,24,28,0.857,120
380,MEM,2022-03-28,123,,GSW,1,240,43,92,0.467,31,62,0.5,12,30,0.4,25,35,0.714,123,33,81,0.407,24,52,0.462,9,29,0.31,20,26,0.769,95
381,MIA,2022-03-28,123,,SAC,1,240,49,90,0.544,30,50,0.6,19,40,0.475,6,6,1.0,123,37,81,0.457,25,46,0.543,12,35,0.343,14,18,0.778,100
382,IND,2022-03-28,123,,ATL,0,240,45,87,0.517,28,51,0.549,17,36,0.472,16,18,0.889,123,47,86,0.547,30,51,0.588,17,35,0.486,21,26,0.808,132
383,WAS,2022-03-27,123,,GSW,1,240,44,84,0.524,28,56,0.5,16,28,0.571,19,22,0.864,123,38,89,0.427,30,56,0.536,8,33,0.242,31,39,0.795,115
384,OKC,2022-03-21,123,,BOS,0,240,48,93,0.516,31,56,0.554,17,37,0.459,10,14,0.714,123,44,86,0.512,29,46,0.63,15,40,0.375,29,34,0.853,132
385,POR,2022-03-18,123,@,BRK,0,240,48,96,0.5,35,61,0.574,13,35,0.371,14,24,0.583,123,45,77,0.584,35,52,0.673,10,25,0.4,28,33,0.848,128
386,TOR,2022-03-18,123,,LAL,0,265,49,97,0.505,37,60,0.617,12,37,0.324,13,20,0.65,123,47,96,0.49,28,53,0.528,19,43,0.442,15,21,0.714,128
387,UTA,2022-03-09,123,,POR,1,240,42,81,0.519,25,35,0.714,17,46,0.37,22,27,0.815,123,29,89,0.326,20,53,0.377,9,36,0.25,18,22,0.818,85
388,MIA,2022-03-07,123,,HOU,1,240,49,91,0.538,35,60,0.583,14,31,0.452,11,14,0.786,123,39,88,0.443,26,45,0.578,13,43,0.302,15,22,0.682,106
389,IND,2022-03-06,123,@,WAS,0,240,44,85,0.518,34,54,0.63,10,31,0.323,25,29,0.862,123,45,86,0.523,28,44,0.636,17,42,0.405,26,32,0.813,133
390,HOU,2022-03-06,123,,MEM,1,240,43,82,0.524,30,48,0.625,13,34,0.382,24,36,0.667,123,44,97,0.454,39,71,0.549,5,26,0.192,19,27,0.704,112
391,CHO,2022-03-05,123,,SAS,1,240,42,91,0.462,26,49,0.531,16,42,0.381,23,29,0.793,123,45,98,0.459,34,61,0.557,11,37,0.297,16,20,0.8,117
392,PHI,2022-03-02,123,,NYK,1,240,39,75,0.52,22,39,0.564,17,36,0.472,28,33,0.848,123,39,91,0.429,31,63,0.492,8,28,0.286,22,32,0.688,108
393,NOP,2022-02-27,123,@,LAL,1,240,47,92,0.511,34,62,0.548,13,30,0.433,16,25,0.64,123,35,84,0.417,28,50,0.56,7,34,0.206,18,20,0.9,95
394,MIL,2022-02-26,123,,BRK,0,240,41,78,0.526,25,40,0.625,16,38,0.421,25,38,0.658,123,44,92,0.478,31,58,0.534,13,34,0.382,25,33,0.758,126
395,PHI,2022-02-17,123,@,MIL,1,240,44,88,0.5,32,54,0.593,12,34,0.353,23,27,0.852,123,42,95,0.442,28,51,0.549,14,44,0.318,22,28,0.786,120
396,POR,2022-02-16,123,@,MEM,1,240,43,85,0.506,30,53,0.566,13,32,0.406,24,32,0.75,123,37,85,0.435,26,55,0.473,11,30,0.367,34,42,0.81,119
397,NYK,2022-02-14,123,,OKC,0,265,45,108,0.417,30,58,0.517,15,50,0.3,18,22,0.818,123,48,96,0.5,35,62,0.565,13,34,0.382,18,27,0.667,127
398,SAC,2022-02-12,123,@,WAS,1,240,43,76,0.566,31,48,0.646,12,28,0.429,25,29,0.862,123,41,88,0.466,28,50,0.56,13,38,0.342,15,21,0.714,110
399,MIL,2022-01-28,123,,NYK,1,240,41,89,0.461,27,46,0.587,14,43,0.326,27,31,0.871,123,39,84,0.464,25,44,0.568,14,40,0.35,16,28,0.571,108
400,PHI,2022-01-19,123,,ORL,1,240,45,83,0.542,35,55,0.636,10,28,0.357,23,27,0.852,123,40,90,0.444,22,55,0.4,18,35,0.514,12,16,0.75,110
401,HOU,2022-01-09,123,,MIN,0,240,46,97,0.474,32,54,0.593,14,43,0.326,17,28,0.607,123,55,108,0.509,40,66,0.606,15,42,0.357,16,21,0.762,141
402,MEM,2022-01-08,123,@,LAC,1,240,44,100,0.44,32,62,0.516,12,38,0.316,23,31,0.742,123,39,96,0.406,29,64,0.453,10,32,0.313,20,24,0.833,108
403,MIA,2022-01-08,123,@,PHO,1,240,44,88,0.5,22,44,0.5,22,44,0.5,13,15,0.867,123,30,79,0.38,16,45,0.356,14,34,0.412,26,29,0.897,100
404,PHO,2022-01-04,123,@,NOP,1,240,46,85,0.541,29,54,0.537,17,31,0.548,14,20,0.7,123,36,89,0.404,26,56,0.464,10,33,0.303,28,32,0.875,110
405,GSW,2022-01-01,123,@,UTA,1,240,46,86,0.535,29,54,0.537,17,32,0.531,14,21,0.667,123,40,92,0.435,26,48,0.542,14,44,0.318,22,28,0.786,116
406,BOS,2021-12-31,123,,PHO,1,240,45,83,0.542,35,56,0.625,10,27,0.37,23,26,0.885,123,41,100,0.41,30,65,0.462,11,35,0.314,15,16,0.938,108
407,HOU,2021-12-28,123,,LAL,0,240,44,83,0.53,28,48,0.583,16,35,0.457,19,25,0.76,123,48,92,0.522,34,58,0.586,14,34,0.412,22,29,0.759,132
408,CHO,2021-12-27,123,,HOU,1,240,47,88,0.534,29,47,0.617,18,41,0.439,11,14,0.786,123,36,87,0.414,21,41,0.512,15,46,0.326,12,18,0.667,99
409,UTA,2021-12-11,123,@,WAS,1,240,48,93,0.516,35,54,0.648,13,39,0.333,14,17,0.824,123,41,89,0.461,33,64,0.516,8,25,0.32,8,14,0.571,98
410,CLE,2021-12-10,123,@,MIN,1,240,46,85,0.541,33,52,0.635,13,33,0.394,18,22,0.818,123,36,92,0.391,25,53,0.472,11,39,0.282,23,28,0.821,106
411,MIL,2021-12-10,123,@,HOU,1,240,42,83,0.506,27,44,0.614,15,39,0.385,24,32,0.75,123,42,89,0.472,23,43,0.535,19,46,0.413,11,20,0.55,114
412,SAC,2021-12-10,123,@,CHO,0,240,48,101,0.475,34,60,0.567,14,41,0.341,13,17,0.765,123,48,87,0.552,34,52,0.654,14,35,0.4,14,20,0.7,124
413,SAS,2021-12-09,123,,DEN,1,240,46,88,0.523,31,53,0.585,15,35,0.429,16,22,0.727,123,42,94,0.447,27,55,0.491,15,39,0.385,12,13,0.923,111
414,NOP,2021-11-29,123,@,LAC,1,240,48,94,0.511,34,59,0.576,14,35,0.4,13,16,0.813,123,37,72,0.514,23,36,0.639,14,36,0.389,16,21,0.762,104
415,CHI,2021-11-26,123,@,ORL,1,240,48,86,0.558,31,52,0.596,17,34,0.5,10,16,0.625,123,30,80,0.375,23,48,0.479,7,32,0.219,21,30,0.7,88
416,BRK,2021-11-24,123,@,BOS,1,240,43,85,0.506,29,50,0.58,14,35,0.4,23,30,0.767,123,34,91,0.374,23,43,0.535,11,48,0.229,25,28,0.893,104
417,MIL,2021-11-22,123,,ORL,1,240,44,94,0.468,26,49,0.531,18,45,0.4,17,24,0.708,123,34,93,0.366,23,52,0.442,11,41,0.268,13,18,0.722,92
418,UTA,2021-11-20,123,@,SAC,1,240,46,91,0.505,29,52,0.558,17,39,0.436,14,17,0.824,123,41,91,0.451,31,60,0.517,10,31,0.323,13,21,0.619,105
419,DAL,2021-11-12,123,@,SAS,1,240,46,100,0.46,28,55,0.509,18,45,0.4,13,19,0.684,123,41,84,0.488,28,54,0.519,13,30,0.433,14,20,0.7,109
420,GSW,2021-11-10,123,,MIN,1,240,40,85,0.471,29,45,0.644,11,40,0.275,32,40,0.8,123,39,95,0.411,22,51,0.431,17,44,0.386,15,20,0.75,110
421,BRK,2021-11-10,123,@,ORL,1,240,46,91,0.505,30,54,0.556,16,37,0.432,15,17,0.882,123,35,92,0.38,31,59,0.525,4,33,0.121,16,24,0.667,90
422,CHO,2021-11-08,123,@,LAL,0,265,43,99,0.434,29,57,0.509,14,42,0.333,23,28,0.821,123,44,91,0.484,31,59,0.525,13,32,0.406,25,35,0.714,126
423,PHO,2021-11-04,123,,HOU,1,240,44,93,0.473,30,62,0.484,14,31,0.452,21,23,0.913,123,38,88,0.432,27,56,0.482,11,32,0.344,24,28,0.857,111
424,NYK,2021-10-30,123,@,NOP,1,240,42,81,0.519,23,48,0.479,19,33,0.576,20,25,0.8,123,42,92,0.457,31,59,0.525,11,33,0.333,22,24,0.917,117
425,OKC,2021-10-27,123,,LAL,1,240,43,86,0.5,28,49,0.571,15,37,0.405,22,29,0.759,123,46,92,0.5,35,57,0.614,11,35,0.314,12,14,0.857,115
426,CHO,2021-10-22,123,@,CLE,1,240,48,91,0.527,35,59,0.593,13,32,0.406,14,17,0.824,123,43,84,0.512,34,53,0.642,9,31,0.29,17,20,0.85,112
427,SAS,2021-10-20,123,,ORL,1,240,49,98,0.5,36,68,0.529,13,30,0.433,12,18,0.667,123,35,86,0.407,26,57,0.456,9,29,0.31,18,23,0.783,97
428,CHO,2021-10-20,123,,IND,1,240,46,107,0.43,33,76,0.434,13,31,0.419,18,27,0.667,123,42,90,0.467,25,43,0.581,17,47,0.362,21,24,0.875,122
429,DEN,2022-04-07,122,,MEM,1,240,44,80,0.55,32,50,0.64,12,30,0.4,22,25,0.88,122,42,89,0.472,31,61,0.508,11,28,0.393,14,19,0.737,109
430,IND,2022-04-05,122,,PHI,0,240,45,95,0.474,33,55,0.6,12,40,0.3,20,21,0.952,122,47,87,0.54,24,47,0.511,23,40,0.575,14,18,0.778,131
431,ATL,2022-04-02,122,,BRK,1,240,36,86,0.419,23,45,0.511,13,41,0.317,37,49,0.755,122,42,99,0.424,25,62,0.403,17,37,0.459,14,19,0.737,115
432,SAC,2022-04-01,122,@,HOU,1,240,42,81,0.519,30,53,0.566,12,28,0.429,26,34,0.765,122,41,97,0.423,24,52,0.462,17,45,0.378,18,26,0.692,117
433,MEM,2022-04-01,122,,PHO,1,240,46,102,0.451,39,78,0.5,7,24,0.292,23,28,0.821,122,47,86,0.547,37,59,0.627,10,27,0.37,10,17,0.588,114
434,UTA,2022-03-31,122,,LAL,1,240,46,90,0.511,31,46,0.674,15,44,0.341,15,24,0.625,122,41,83,0.494,34,58,0.586,7,25,0.28,20,28,0.714,109
435,PHI,2022-03-25,122,@,LAC,1,240,43,92,0.467,28,57,0.491,15,35,0.429,21,24,0.875,122,34,85,0.4,26,60,0.433,8,25,0.32,21,25,0.84,97
436,DET,2022-03-23,122,,ATL,1,240,44,88,0.5,32,55,0.582,12,33,0.364,22,25,0.88,122,37,92,0.402,23,48,0.479,14,44,0.318,13,15,0.867,101
437,MEM,2022-03-20,122,@,HOU,1,240,46,96,0.479,30,62,0.484,16,34,0.471,14,17,0.824,122,37,86,0.43,27,55,0.491,10,31,0.323,14,24,0.583,98
438,SAS,2022-03-16,122,,OKC,1,240,43,98,0.439,24,57,0.421,19,41,0.463,17,20,0.85,122,43,82,0.524,30,47,0.638,13,35,0.371,21,29,0.724,120
439,ATL,2022-03-14,122,,POR,1,240,40,109,0.367,28,61,0.459,12,48,0.25,30,32,0.938,122,44,88,0.5,34,64,0.531,10,24,0.417,15,21,0.714,113
440,GSW,2022-03-12,122,,MIL,1,240,45,93,0.484,27,48,0.563,18,45,0.4,14,15,0.933,122,38,92,0.413,21,48,0.438,17,44,0.386,16,23,0.696,109
441,LAL,2022-03-11,122,,WAS,1,240,48,91,0.527,34,60,0.567,14,31,0.452,12,17,0.706,122,39,85,0.459,30,58,0.517,9,27,0.333,22,33,0.667,109
442,PHO,2022-03-06,122,@,MIL,0,240,50,93,0.538,36,62,0.581,14,31,0.452,8,11,0.727,122,47,87,0.54,32,55,0.582,15,32,0.469,23,29,0.793,132
443,DAL,2022-03-03,122,,GSW,1,240,45,85,0.529,28,48,0.583,17,37,0.459,15,20,0.75,122,44,81,0.543,29,51,0.569,15,30,0.5,10,13,0.769,113
444,IND,2022-03-02,122,@,ORL,1,265,41,94,0.436,29,57,0.509,12,37,0.324,28,35,0.8,122,44,97,0.454,34,65,0.523,10,32,0.313,16,20,0.8,114
445,CLE,2022-02-28,122,,MIN,0,240,39,74,0.527,24,37,0.649,15,37,0.405,29,34,0.853,122,47,86,0.547,29,44,0.659,18,42,0.429,15,19,0.789,127
446,POR,2022-02-14,122,@,MIL,1,240,45,99,0.455,27,56,0.482,18,43,0.419,14,19,0.737,122,38,89,0.427,25,48,0.521,13,41,0.317,18,24,0.75,107
447,MIN,2022-02-11,122,@,CHI,0,240,48,96,0.5,35,56,0.625,13,40,0.325,13,16,0.813,122,55,87,0.632,41,56,0.732,14,31,0.452,10,13,0.769,134
448,LAL,2022-02-05,122,,NYK,1,265,48,102,0.471,39,68,0.574,9,34,0.265,17,28,0.607,122,39,98,0.398,28,60,0.467,11,38,0.289,26,36,0.722,115
449,CHI,2022-02-04,122,@,IND,1,240,49,90,0.544,43,64,0.672,6,26,0.231,18,23,0.783,122,47,95,0.495,35,68,0.515,12,27,0.444,9,9,1.0,115
450,PHI,2022-01-31,122,,MEM,1,265,49,100,0.49,38,69,0.551,11,31,0.355,13,15,0.867,122,47,102,0.461,41,72,0.569,6,30,0.2,19,28,0.679,119
451,IND,2022-01-31,122,,LAC,1,240,50,95,0.526,36,66,0.545,14,29,0.483,8,12,0.667,122,45,96,0.469,30,52,0.577,15,44,0.341,11,13,0.846,116
452,GSW,2022-01-31,122,@,HOU,1,240,43,80,0.538,26,40,0.65,17,40,0.425,19,23,0.826,122,36,84,0.429,20,41,0.488,16,43,0.372,20,29,0.69,108
453,BOS,2022-01-31,122,,MIA,1,240,44,84,0.524,28,42,0.667,16,42,0.381,18,27,0.667,122,34,87,0.391,17,43,0.395,17,44,0.386,7,10,0.7,92
454,CHI,2022-01-28,122,@,SAS,0,240,46,88,0.523,38,58,0.655,8,30,0.267,22,26,0.846,122,50,95,0.526,34,58,0.586,16,37,0.432,15,18,0.833,131
455,MEM,2022-01-21,122,@,DEN,1,240,43,82,0.524,32,57,0.561,11,25,0.44,25,40,0.625,122,43,91,0.473,30,59,0.508,13,32,0.406,19,23,0.826,118
456,MIN,2022-01-19,122,@,ATL,0,240,42,97,0.433,25,51,0.49,17,46,0.37,21,29,0.724,122,45,86,0.523,30,48,0.625,15,38,0.395,29,33,0.879,134
457,WAS,2022-01-11,122,,OKC,1,240,47,87,0.54,36,54,0.667,11,33,0.333,17,23,0.739,122,47,98,0.48,36,59,0.61,11,39,0.282,13,15,0.867,118
458,WAS,2022-01-07,122,@,CHI,0,240,45,88,0.511,38,64,0.594,7,24,0.292,25,26,0.962,122,48,91,0.527,33,58,0.569,15,33,0.455,19,21,0.905,130
459,TOR,2022-01-07,122,,UTA,1,240,45,100,0.45,33,59,0.559,12,41,0.293,20,25,0.8,122,39,81,0.481,22,43,0.512,17,38,0.447,13,18,0.722,108
460,LAL,2022-01-04,122,,SAC,1,240,49,99,0.495,38,67,0.567,11,32,0.344,13,20,0.65,122,43,83,0.518,29,49,0.592,14,34,0.412,14,18,0.778,114
461,MIN,2022-01-03,122,@,LAC,1,240,49,93,0.527,33,48,0.688,16,45,0.356,8,9,0.889,122,39,78,0.5,28,46,0.609,11,32,0.344,15,17,0.882,104
462,BRK,2021-12-25,122,@,LAL,1,240,43,89,0.483,29,57,0.509,14,32,0.438,22,27,0.815,122,40,96,0.417,30,61,0.492,10,35,0.286,25,28,0.893,115
463,IND,2021-12-16,122,,DET,1,240,45,91,0.495,38,59,0.644,7,32,0.219,25,28,0.893,122,40,81,0.494,33,56,0.589,7,25,0.28,26,30,0.867,113
464,IND,2021-12-08,122,,NYK,1,240,46,86,0.535,36,59,0.61,10,27,0.37,20,25,0.8,122,36,86,0.419,27,56,0.482,9,30,0.3,21,23,0.913,102
465,BOS,2021-11-12,122,,MIL,1,265,47,96,0.49,35,55,0.636,12,41,0.293,16,18,0.889,122,44,98,0.449,28,51,0.549,16,47,0.34,9,11,0.818,113
466,PHI,2021-10-30,122,,ATL,1,240,46,86,0.535,34,48,0.708,12,38,0.316,18,19,0.947,122,36,95,0.379,28,73,0.384,8,22,0.364,14,19,0.737,94
467,WAS,2021-10-28,122,,ATL,1,240,46,99,0.465,33,65,0.508,13,34,0.382,17,21,0.81,122,48,88,0.545,42,67,0.627,6,21,0.286,9,14,0.643,111
468,UTA,2021-10-28,122,@,HOU,1,240,41,85,0.482,25,39,0.641,16,46,0.348,24,30,0.8,122,31,95,0.326,22,51,0.431,9,44,0.205,20,23,0.87,91
469,UTA,2021-10-26,122,,DEN,1,240,44,85,0.518,32,46,0.696,12,39,0.308,22,29,0.759,122,42,83,0.506,32,55,0.582,10,28,0.357,16,24,0.667,110
470,ATL,2021-10-25,122,,DET,1,240,46,90,0.511,34,58,0.586,12,32,0.375,18,21,0.857,122,40,91,0.44,31,58,0.534,9,33,0.273,15,18,0.833,104
471,IND,2021-10-20,122,@,CHO,0,240,42,90,0.467,25,43,0.581,17,47,0.362,21,24,0.875,122,46,107,0.43,33,76,0.434,13,31,0.419,18,27,0.667,123
472,SAS,2022-04-07,121,@,MIN,0,240,43,89,0.483,33,61,0.541,10,28,0.357,25,34,0.735,121,41,96,0.427,21,43,0.488,20,53,0.377,25,31,0.806,127
473,BOS,2022-04-07,121,@,MIL,0,240,43,87,0.494,22,37,0.595,21,50,0.42,14,19,0.737,121,49,97,0.505,35,59,0.593,14,38,0.368,15,21,0.714,127
474,PHO,2022-04-05,121,,LAL,1,240,50,102,0.49,36,63,0.571,14,39,0.359,7,9,0.778,121,39,86,0.453,30,57,0.526,9,29,0.31,23,30,0.767,110
475,UTA,2022-04-05,121,,MEM,1,265,40,96,0.417,28,58,0.483,12,38,0.316,29,43,0.674,121,39,101,0.386,26,70,0.371,13,31,0.419,24,29,0.828,115
476,DET,2022-04-03,121,@,IND,1,240,43,99,0.434,22,58,0.379,21,41,0.512,14,18,0.778,121,45,94,0.479,33,56,0.589,12,38,0.316,15,19,0.789,117
477,SAC,2022-03-30,121,@,HOU,1,240,44,95,0.463,37,69,0.536,7,26,0.269,26,36,0.722,121,43,94,0.457,30,52,0.577,13,42,0.31,19,25,0.76,118
478,LAC,2022-03-29,121,,UTA,1,240,41,83,0.494,26,47,0.553,15,36,0.417,24,28,0.857,121,43,78,0.551,31,47,0.66,12,31,0.387,17,29,0.586,115
479,ATL,2022-03-25,121,,GSW,1,240,46,89,0.517,32,52,0.615,14,37,0.378,15,19,0.789,121,43,90,0.478,29,49,0.592,14,41,0.341,10,13,0.769,110
480,LAL,2022-03-23,121,,PHI,0,240,50,97,0.515,39,67,0.582,11,30,0.367,10,16,0.625,121,47,91,0.516,37,64,0.578,10,27,0.37,22,28,0.786,126
481,NYK,2022-03-23,121,@,CHO,1,240,43,83,0.518,23,38,0.605,20,45,0.444,15,17,0.882,121,42,89,0.472,29,43,0.674,13,46,0.283,9,17,0.529,106
482,UTA,2022-03-18,121,,LAC,1,240,47,97,0.485,31,53,0.585,16,44,0.364,11,14,0.786,121,31,86,0.36,20,51,0.392,11,35,0.314,19,21,0.905,92
483,IND,2022-03-18,121,@,HOU,1,240,47,101,0.465,33,58,0.569,14,43,0.326,13,19,0.684,121,39,79,0.494,27,52,0.519,12,27,0.444,28,32,0.875,118
484,CHO,2022-03-08,121,,BRK,0,240,45,92,0.489,32,51,0.627,13,41,0.317,18,22,0.818,121,46,82,0.561,28,47,0.596,18,35,0.514,22,29,0.759,132
485,PHI,2022-03-07,121,,CHI,1,240,41,84,0.488,29,54,0.537,12,30,0.4,27,34,0.794,121,39,87,0.448,31,63,0.492,8,24,0.333,20,26,0.769,106
486,POR,2022-03-05,121,@,MIN,0,240,40,85,0.471,24,47,0.511,16,38,0.421,25,30,0.833,121,48,85,0.565,33,48,0.688,15,37,0.405,24,29,0.828,135
487,HOU,2022-02-16,121,@,PHO,0,240,42,97,0.433,29,53,0.547,13,44,0.295,24,28,0.857,121,44,86,0.512,37,62,0.597,7,24,0.292,29,36,0.806,124
488,MEM,2022-02-15,121,@,NOP,1,240,47,94,0.5,37,60,0.617,10,34,0.294,17,27,0.63,121,44,88,0.5,40,62,0.645,4,26,0.154,17,20,0.85,109
489,DEN,2022-02-14,121,,ORL,1,240,42,88,0.477,26,48,0.542,16,40,0.4,21,23,0.913,121,40,91,0.44,29,52,0.558,11,39,0.282,20,23,0.87,111
490,ATL,2022-02-11,121,,SAS,0,240,47,103,0.456,33,60,0.55,14,43,0.326,13,15,0.867,121,50,90,0.556,32,58,0.552,18,32,0.563,18,21,0.857,136
491,CHI,2022-02-09,121,@,CHO,1,240,46,82,0.561,30,49,0.612,16,33,0.485,13,19,0.684,121,40,93,0.43,27,50,0.54,13,43,0.302,16,23,0.696,109
492,MIA,2022-02-07,121,@,WAS,1,240,43,76,0.566,25,44,0.568,18,32,0.563,17,21,0.81,121,36,80,0.45,29,49,0.592,7,31,0.226,21,23,0.913,100
493,PHO,2022-02-01,121,,BRK,1,240,42,76,0.553,31,45,0.689,11,31,0.355,26,31,0.839,121,40,81,0.494,24,41,0.585,16,40,0.4,15,21,0.714,111
494,LAL,2022-01-30,121,@,ATL,0,240,47,87,0.54,32,52,0.615,15,35,0.429,12,23,0.522,121,49,84,0.583,39,53,0.736,10,31,0.323,21,32,0.656,129
495,MIA,2022-01-28,121,,LAC,1,240,40,85,0.471,25,51,0.49,15,34,0.441,26,27,0.963,121,41,92,0.446,32,57,0.561,9,35,0.257,23,32,0.719,114
496,ATL,2022-01-26,121,,SAC,1,240,48,90,0.533,36,54,0.667,12,36,0.333,13,17,0.765,121,39,93,0.419,27,53,0.509,12,40,0.3,14,19,0.737,104
497,CHO,2022-01-21,121,,OKC,1,240,45,99,0.455,28,50,0.56,17,49,0.347,14,20,0.7,121,37,98,0.378,25,54,0.463,12,44,0.273,12,15,0.8,98
498,IND,2022-01-20,121,@,GSW,1,265,41,95,0.432,26,60,0.433,15,35,0.429,24,34,0.706,121,42,94,0.447,33,52,0.635,9,42,0.214,24,29,0.828,117
499,ATL,2022-01-17,121,,MIL,1,240,38,86,0.442,23,50,0.46,15,36,0.417,30,32,0.938,121,39,88,0.443,23,50,0.46,16,38,0.421,20,24,0.833,114
500,PHO,2022-01-17,121,@,SAS,1,240,49,95,0.516,40,63,0.635,9,32,0.281,14,20,0.7,121,41,92,0.446,32,62,0.516,9,30,0.3,16,22,0.727,107
501,BRK,2022-01-09,121,,SAS,1,265,47,98,0.48,39,70,0.557,8,28,0.286,19,22,0.864,121,46,107,0.43,33,75,0.44,13,32,0.406,14,18,0.778,119
502,MIL,2022-01-07,121,@,BRK,1,240,44,96,0.458,28,51,0.549,16,45,0.356,17,21,0.81,121,42,92,0.457,36,65,0.554,6,27,0.222,19,20,0.95,109
503,DEN,2022-01-07,121,,SAC,1,240,47,85,0.553,35,51,0.686,12,34,0.353,15,24,0.625,121,40,92,0.435,29,63,0.46,11,29,0.379,20,24,0.833,111
504,IND,2022-01-05,121,,BRK,0,240,41,82,0.5,28,43,0.651,13,39,0.333,26,28,0.929,121,49,86,0.57,44,65,0.677,5,21,0.238,26,29,0.897,129
505,CHO,2022-01-03,121,@,WAS,0,240,50,104,0.481,36,66,0.545,14,38,0.368,7,13,0.538,121,40,87,0.46,24,49,0.49,16,38,0.421,28,31,0.903,124
506,ATL,2021-12-31,121,@,CLE,1,240,43,97,0.443,27,59,0.458,16,38,0.421,19,21,0.905,121,48,84,0.571,40,59,0.678,8,25,0.32,14,24,0.583,118
507,SAC,2021-12-19,121,,SAS,1,240,46,91,0.505,32,66,0.485,14,25,0.56,15,18,0.833,121,45,91,0.495,33,66,0.5,12,25,0.48,12,13,0.923,114
508,NYK,2021-12-07,121,@,SAS,1,240,43,91,0.473,25,53,0.472,18,38,0.474,17,19,0.895,121,41,92,0.446,29,61,0.475,12,31,0.387,15,20,0.75,109
509,ATL,2021-12-06,121,@,MIN,1,240,40,90,0.444,15,41,0.366,25,49,0.51,16,19,0.842,121,39,98,0.398,22,58,0.379,17,40,0.425,15,19,0.789,110
510,MIN,2021-11-27,121,@,PHI,1,290,48,96,0.5,34,60,0.567,14,36,0.389,11,16,0.688,121,39,93,0.419,27,59,0.458,12,34,0.353,30,39,0.769,120
511,POR,2021-11-24,121,@,SAC,0,240,44,94,0.468,32,56,0.571,12,38,0.316,21,25,0.84,121,45,86,0.523,33,53,0.623,12,33,0.364,23,34,0.676,125
512,LAL,2021-11-21,121,@,DET,1,240,45,92,0.489,35,61,0.574,10,31,0.323,21,27,0.778,121,43,97,0.443,29,57,0.509,14,40,0.35,16,21,0.762,116
513,CHO,2021-11-19,121,,IND,1,240,44,81,0.543,32,50,0.64,12,31,0.387,21,28,0.75,121,41,88,0.466,30,52,0.577,11,36,0.306,25,32,0.781,118
514,CHI,2021-11-15,121,@,LAL,1,240,49,89,0.551,34,55,0.618,15,34,0.441,8,11,0.727,121,36,79,0.456,30,47,0.638,6,32,0.188,25,31,0.806,103
515,TOR,2021-11-13,121,,DET,0,240,44,87,0.506,31,53,0.585,13,34,0.382,20,31,0.645,121,43,79,0.544,28,44,0.636,15,35,0.429,26,30,0.867,127
516,PHO,2021-11-06,121,,ATL,1,240,45,88,0.511,31,45,0.689,14,43,0.326,17,21,0.81,121,42,97,0.433,29,64,0.453,13,33,0.394,20,23,0.87,117
517,SAS,2021-10-26,121,,LAL,0,265,48,108,0.444,35,72,0.486,13,36,0.361,12,22,0.545,121,50,105,0.476,42,75,0.56,8,30,0.267,17,22,0.773,125
518,LAL,2021-10-24,121,,MEM,1,240,45,84,0.536,29,54,0.537,16,30,0.533,15,22,0.682,121,45,100,0.45,32,65,0.492,13,35,0.371,15,18,0.833,118
519,MIL,2021-10-23,121,@,SAS,1,240,44,83,0.53,29,48,0.604,15,35,0.429,18,22,0.818,121,48,99,0.485,38,60,0.633,10,39,0.256,5,6,0.833,111
520,NYK,2021-10-22,121,@,ORL,1,240,44,88,0.5,20,34,0.588,24,54,0.444,9,17,0.529,121,33,83,0.398,16,40,0.4,17,43,0.395,13,15,0.867,96
521,CLE,2021-10-20,121,@,MEM,0,240,47,93,0.505,33,55,0.6,14,38,0.368,13,18,0.722,121,53,100,0.53,39,67,0.582,14,33,0.424,12,12,1.0,132
522,POR,2021-10-20,121,,SAC,0,240,45,93,0.484,33,58,0.569,12,35,0.343,19,22,0.864,121,42,92,0.457,25,51,0.49,17,41,0.415,23,29,0.793,124
523,GSW,2021-10-19,121,@,LAL,1,240,41,93,0.441,27,54,0.5,14,39,0.359,25,30,0.833,121,45,95,0.474,30,53,0.566,15,42,0.357,9,19,0.474,114
524,SAS,2022-04-10,120,@,DAL,0,240,43,89,0.483,32,58,0.552,11,31,0.355,23,23,1.0,120,46,85,0.541,26,49,0.531,20,36,0.556,18,23,0.783,130
525,MIN,2022-04-10,120,,CHI,0,240,46,91,0.505,35,60,0.583,11,31,0.355,17,22,0.773,120,44,83,0.53,34,62,0.548,10,21,0.476,26,33,0.788,124
526,IND,2022-04-09,120,@,PHI,0,240,41,78,0.526,31,55,0.564,10,23,0.435,28,36,0.778,120,50,90,0.556,38,56,0.679,12,34,0.353,21,27,0.778,133
527,LAL,2022-04-08,120,,OKC,1,240,41,82,0.5,32,51,0.627,9,31,0.29,29,39,0.744,120,40,88,0.455,34,59,0.576,6,29,0.207,15,19,0.789,101
528,ORL,2022-04-05,120,,CLE,1,240,47,93,0.505,31,58,0.534,16,35,0.457,10,15,0.667,120,42,86,0.488,26,50,0.52,16,36,0.444,15,22,0.682,115
529,MIL,2022-03-31,120,@,BRK,1,265,40,89,0.449,28,48,0.583,12,41,0.293,28,34,0.824,120,45,97,0.464,27,60,0.45,18,37,0.486,11,16,0.688,119
530,DAL,2022-03-30,120,@,CLE,1,240,46,88,0.523,30,46,0.652,16,42,0.381,12,15,0.8,120,42,83,0.506,31,58,0.534,11,25,0.44,17,22,0.773,112
531,HOU,2022-03-28,120,,SAS,0,240,38,92,0.413,18,43,0.419,20,49,0.408,24,28,0.857,120,47,100,0.47,40,71,0.563,7,29,0.241,22,28,0.786,123
532,BRK,2022-03-23,120,@,MEM,0,240,43,87,0.494,34,62,0.548,9,25,0.36,25,27,0.926,120,47,101,0.465,28,63,0.444,19,38,0.5,19,22,0.864,132
533,CLE,2022-03-21,120,,LAL,0,240,45,86,0.523,31,47,0.66,14,39,0.359,16,19,0.842,120,53,94,0.564,41,62,0.661,12,32,0.375,13,16,0.813,131
534,MIA,2022-03-18,120,,OKC,1,240,46,95,0.484,28,44,0.636,18,51,0.353,10,12,0.833,120,40,84,0.476,30,50,0.6,10,34,0.294,18,23,0.783,108
535,ATL,2022-03-18,120,,MEM,1,240,45,91,0.495,32,63,0.508,13,28,0.464,17,21,0.81,120,40,86,0.465,32,64,0.5,8,22,0.364,17,23,0.739,105
536,ORL,2022-03-17,120,,DET,0,240,47,97,0.485,36,67,0.537,11,30,0.367,15,21,0.714,120,47,94,0.5,27,51,0.529,20,43,0.465,20,31,0.645,134
537,OKC,2022-03-16,120,@,SAS,0,240,43,82,0.524,30,47,0.638,13,35,0.371,21,29,0.724,120,43,98,0.439,24,57,0.421,19,41,0.463,17,20,0.85,122
538,CLE,2022-03-14,120,,LAC,1,265,41,86,0.477,26,56,0.464,15,30,0.5,23,32,0.719,120,43,98,0.439,31,62,0.5,12,36,0.333,13,17,0.765,111
539,NOP,2022-03-11,120,,CHO,0,240,43,86,0.5,28,47,0.596,15,39,0.385,19,25,0.76,120,52,87,0.598,30,40,0.75,22,47,0.468,16,20,0.8,142
540,BRK,2022-03-06,120,@,BOS,0,240,45,89,0.506,33,62,0.532,12,27,0.444,18,20,0.9,120,40,83,0.482,23,47,0.489,17,36,0.472,29,38,0.763,126
541,BOS,2022-03-03,120,,MEM,1,240,46,89,0.517,30,52,0.577,16,37,0.432,12,15,0.8,120,42,99,0.424,29,59,0.492,13,40,0.325,10,13,0.769,107
542,PHO,2022-03-02,120,,POR,1,240,40,80,0.5,26,44,0.591,14,36,0.389,26,31,0.839,120,30,78,0.385,19,47,0.404,11,31,0.355,19,25,0.76,90
543,MIL,2022-03-02,120,,MIA,1,240,41,91,0.451,27,55,0.491,14,36,0.389,24,27,0.889,120,44,97,0.454,23,53,0.434,21,44,0.477,10,12,0.833,119
544,MIL,2022-02-17,120,,PHI,0,240,42,95,0.442,28,51,0.549,14,44,0.318,22,28,0.786,120,44,88,0.5,32,54,0.593,12,34,0.353,23,27,0.852,123
545,CHO,2022-02-15,120,@,MIN,0,265,42,102,0.412,34,69,0.493,8,33,0.242,28,37,0.757,120,43,109,0.394,30,54,0.556,13,55,0.236,27,43,0.628,126
546,CHI,2022-02-14,120,,SAS,1,240,46,88,0.523,36,64,0.563,10,24,0.417,18,21,0.857,120,44,92,0.478,38,72,0.528,6,20,0.3,15,21,0.714,109
547,NOP,2022-02-14,120,,TOR,1,240,45,77,0.584,29,42,0.69,16,35,0.457,14,16,0.875,120,29,95,0.305,21,61,0.344,8,34,0.235,24,31,0.774,90
548,IND,2022-02-13,120,,MIN,0,240,45,102,0.441,32,57,0.561,13,45,0.289,17,22,0.773,120,43,84,0.512,25,50,0.5,18,34,0.529,25,28,0.893,129
549,CLE,2022-02-11,120,@,IND,1,240,43,81,0.531,34,57,0.596,9,24,0.375,25,30,0.833,120,42,89,0.472,24,51,0.471,18,38,0.474,11,16,0.688,113
550,HOU,2022-02-10,120,,TOR,0,240,43,82,0.524,27,44,0.614,16,38,0.421,18,30,0.6,120,53,97,0.546,38,58,0.655,15,39,0.385,18,22,0.818,139
551,NOP,2022-02-06,120,@,HOU,1,240,41,77,0.532,29,48,0.604,12,29,0.414,26,36,0.722,120,40,84,0.476,24,39,0.615,16,45,0.356,11,16,0.688,107
552,CHI,2022-02-03,120,@,TOR,0,265,43,90,0.478,31,61,0.508,12,29,0.414,22,24,0.917,120,48,113,0.425,34,77,0.442,14,36,0.389,17,19,0.895,127
553,MEM,2022-02-02,120,@,NYK,1,240,44,102,0.431,28,63,0.444,16,39,0.41,16,23,0.696,120,38,88,0.432,26,52,0.5,12,36,0.333,20,26,0.769,108
554,OKC,2022-02-02,120,@,DAL,1,265,41,86,0.477,24,49,0.49,17,37,0.459,21,25,0.84,120,46,98,0.469,32,55,0.582,14,43,0.326,8,10,0.8,114
555,SAS,2022-02-01,120,,GSW,0,240,46,83,0.554,30,50,0.6,16,33,0.485,12,17,0.706,120,43,96,0.448,23,50,0.46,20,46,0.435,18,18,1.0,124
556,MIA,2022-01-29,120,,TOR,0,315,45,110,0.409,29,60,0.483,16,50,0.32,14,20,0.7,120,47,107,0.439,31,62,0.5,16,45,0.356,14,18,0.778,124
557,BRK,2022-01-15,120,,NOP,1,240,46,84,0.548,34,57,0.596,12,27,0.444,16,17,0.941,120,40,87,0.46,31,56,0.554,9,31,0.29,16,24,0.667,105
558,TOR,2022-01-02,120,,NYK,1,240,41,86,0.477,28,52,0.538,13,34,0.382,25,30,0.833,120,35,78,0.449,23,42,0.548,12,36,0.333,23,28,0.821,105
559,CHI,2022-01-01,120,@,WAS,1,240,41,84,0.488,24,50,0.48,17,34,0.5,21,25,0.84,120,46,87,0.529,40,60,0.667,6,27,0.222,21,26,0.808,119
560,LAC,2022-01-01,120,@,BRK,1,240,42,86,0.488,28,50,0.56,14,36,0.389,22,31,0.71,120,42,97,0.433,31,64,0.484,11,33,0.333,21,25,0.84,116
561,UTA,2021-12-31,120,,MIN,1,240,37,78,0.474,26,49,0.531,11,29,0.379,35,41,0.854,120,40,93,0.43,26,52,0.5,14,41,0.341,14,22,0.636,108
562,MIA,2021-12-31,120,@,HOU,1,240,40,86,0.465,26,53,0.491,14,33,0.424,26,31,0.839,120,41,93,0.441,27,51,0.529,14,42,0.333,14,17,0.824,110
563,UTA,2021-12-29,120,@,POR,1,240,46,87,0.529,38,58,0.655,8,29,0.276,20,32,0.625,120,37,88,0.42,23,48,0.479,14,40,0.35,17,24,0.708,105
564,UTA,2021-12-25,120,,DAL,1,240,40,90,0.444,28,54,0.519,12,36,0.333,28,37,0.757,120,38,89,0.427,28,59,0.475,10,30,0.333,30,35,0.857,116
565,DAL,2021-12-13,120,,CHO,1,240,43,83,0.518,24,42,0.571,19,41,0.463,15,17,0.882,120,34,86,0.395,21,49,0.429,13,37,0.351,15,24,0.625,96
566,DEN,2021-12-08,120,@,NOP,1,265,45,88,0.511,36,56,0.643,9,32,0.281,21,27,0.778,120,47,90,0.522,36,60,0.6,11,30,0.367,9,12,0.75,114
567,DEN,2021-11-29,120,@,MIA,1,240,43,74,0.581,25,39,0.641,18,35,0.514,16,21,0.762,120,43,91,0.473,28,47,0.596,15,44,0.341,10,15,0.667,111
568,PHI,2021-11-27,120,,MIN,0,290,39,93,0.419,27,59,0.458,12,34,0.353,30,39,0.769,120,48,96,0.5,34,60,0.567,14,36,0.389,11,16,0.688,121
569,WAS,2021-11-27,120,@,DAL,1,240,45,78,0.577,36,54,0.667,9,24,0.375,21,26,0.808,120,42,89,0.472,28,51,0.549,14,38,0.368,16,22,0.727,114
570,MIL,2021-11-26,120,@,DEN,1,240,46,73,0.63,30,40,0.75,16,33,0.485,12,20,0.6,120,40,92,0.435,23,45,0.511,17,47,0.362,12,14,0.857,109
571,PHO,2021-11-24,120,@,CLE,1,240,45,86,0.523,37,64,0.578,8,22,0.364,22,28,0.786,120,43,97,0.443,31,58,0.534,12,39,0.308,17,25,0.68,115
572,MEM,2021-11-18,120,,LAC,1,240,52,96,0.542,41,70,0.586,11,26,0.423,5,6,0.833,120,42,90,0.467,26,51,0.51,16,39,0.41,8,8,1.0,108
573,UTA,2021-11-16,120,,PHI,1,240,46,89,0.517,30,51,0.588,16,38,0.421,12,19,0.632,120,33,90,0.367,27,61,0.443,6,29,0.207,13,17,0.765,85
574,BRK,2021-11-14,120,@,OKC,1,240,41,82,0.5,23,39,0.59,18,43,0.419,20,21,0.952,120,36,90,0.4,22,45,0.489,14,45,0.311,10,11,0.909,96
575,ATL,2021-11-14,120,,MIL,1,240,47,97,0.485,32,62,0.516,15,35,0.429,11,13,0.846,120,38,84,0.452,24,43,0.558,14,41,0.341,10,16,0.625,100
576,BRK,2021-11-12,120,@,NOP,1,240,41,82,0.5,23,48,0.479,18,34,0.529,20,27,0.741,120,43,88,0.489,30,56,0.536,13,32,0.406,13,16,0.813,112
577,LAL,2021-11-10,120,,MIA,1,265,46,92,0.5,28,54,0.519,18,38,0.474,10,16,0.625,120,40,96,0.417,30,59,0.508,10,37,0.27,27,35,0.771,117
578,LAC,2021-11-07,120,,CHO,1,240,41,86,0.477,23,38,0.605,18,48,0.375,20,21,0.952,120,41,101,0.406,31,68,0.456,10,33,0.303,14,18,0.778,106
579,GSW,2021-11-07,120,,HOU,1,240,44,85,0.518,29,39,0.744,15,46,0.326,17,20,0.85,120,36,79,0.456,26,46,0.565,10,33,0.303,25,37,0.676,107
580,CHO,2021-10-27,120,@,ORL,1,240,43,83,0.518,29,53,0.547,14,30,0.467,20,24,0.833,120,43,88,0.489,28,48,0.583,15,40,0.375,10,13,0.769,111
581,MEM,2021-10-23,120,@,LAC,1,240,42,90,0.467,27,54,0.5,15,36,0.417,21,25,0.84,120,43,99,0.434,30,60,0.5,13,39,0.333,15,17,0.882,114
582,TOR,2022-04-07,119,,PHI,1,240,45,91,0.495,30,58,0.517,15,33,0.455,14,18,0.778,119,37,75,0.493,18,39,0.462,19,36,0.528,21,25,0.84,114
583,LAC,2022-04-03,119,,NOP,1,240,45,95,0.474,24,51,0.471,21,44,0.477,8,10,0.8,119,35,87,0.402,26,63,0.413,9,24,0.375,21,27,0.778,100
584,CLE,2022-04-02,119,@,NYK,1,240,44,81,0.543,29,47,0.617,15,34,0.441,16,21,0.762,119,31,77,0.403,18,47,0.383,13,30,0.433,26,34,0.765,101
585,MIL,2022-04-01,119,,LAC,0,240,50,94,0.532,42,69,0.609,8,25,0.32,11,18,0.611,119,56,92,0.609,33,49,0.673,23,43,0.535,18,24,0.75,153
586,BRK,2022-03-31,119,,MIL,0,265,45,97,0.464,27,60,0.45,18,37,0.486,11,16,0.688,119,40,89,0.449,28,48,0.583,12,41,0.293,28,34,0.824,120
587,CHO,2022-03-27,119,@,BRK,1,240,42,98,0.429,25,66,0.379,17,32,0.531,18,23,0.783,119,43,97,0.443,36,63,0.571,7,34,0.206,17,26,0.654,110
588,POR,2022-03-21,119,@,DET,1,240,37,88,0.42,29,60,0.483,8,28,0.286,37,49,0.755,119,36,85,0.424,27,50,0.54,9,35,0.257,34,41,0.829,115
589,MIL,2022-03-19,119,@,MIN,0,240,43,97,0.443,24,45,0.533,19,52,0.365,14,17,0.824,119,47,92,0.511,25,45,0.556,22,47,0.468,22,26,0.846,138
590,LAL,2022-03-19,119,@,WAS,0,240,48,91,0.527,35,56,0.625,13,35,0.371,10,11,0.909,119,44,85,0.518,31,54,0.574,13,31,0.419,26,31,0.839,127
591,CLE,2022-03-18,119,,DEN,1,265,44,98,0.449,30,61,0.492,14,37,0.378,17,26,0.654,119,46,92,0.5,36,59,0.61,10,33,0.303,14,18,0.778,116
592,IND,2022-03-12,119,@,SAS,1,240,45,92,0.489,31,56,0.554,14,36,0.389,15,15,1.0,119,42,102,0.412,31,68,0.456,11,34,0.324,13,16,0.813,108
593,TOR,2022-03-09,119,@,SAS,1,240,41,85,0.482,30,55,0.545,11,30,0.367,26,28,0.929,119,38,84,0.452,29,52,0.558,9,32,0.281,19,20,0.95,104
594,CLE,2022-03-04,119,@,PHI,0,240,44,82,0.537,34,54,0.63,10,28,0.357,21,24,0.875,119,41,75,0.547,27,42,0.643,14,33,0.424,29,32,0.906,125
595,OKC,2022-03-02,119,@,DEN,1,240,44,87,0.506,28,58,0.483,16,29,0.552,15,21,0.714,119,40,90,0.444,28,44,0.636,12,46,0.261,15,17,0.882,107
596,MIA,2022-03-02,119,@,MIL,0,240,44,97,0.454,23,53,0.434,21,44,0.477,10,12,0.833,119,41,91,0.451,27,55,0.491,14,36,0.389,24,27,0.889,120
597,CHO,2022-03-02,119,@,CLE,1,240,43,85,0.506,26,47,0.553,17,38,0.447,16,22,0.727,119,37,79,0.468,27,48,0.563,10,31,0.323,14,21,0.667,98
598,ORL,2022-02-28,119,,IND,1,240,45,96,0.469,33,59,0.559,12,37,0.324,17,22,0.773,119,35,72,0.486,20,36,0.556,15,36,0.417,18,25,0.72,103
599,ORL,2022-02-25,119,,HOU,1,240,42,83,0.506,29,47,0.617,13,36,0.361,22,29,0.759,119,44,94,0.468,30,47,0.638,14,47,0.298,9,20,0.45,111
600,MIN,2022-02-24,119,,MEM,1,240,43,93,0.462,27,51,0.529,16,42,0.381,17,25,0.68,119,38,98,0.388,29,67,0.433,9,31,0.29,29,40,0.725,114
601,MEM,2022-02-16,119,,POR,0,240,37,85,0.435,26,55,0.473,11,30,0.367,34,42,0.81,119,43,85,0.506,30,53,0.566,13,32,0.406,24,32,0.75,123
602,IND,2022-02-15,119,@,MIL,0,240,47,93,0.505,30,52,0.577,17,41,0.415,8,19,0.421,119,48,86,0.558,38,57,0.667,10,29,0.345,22,30,0.733,128
603,LAC,2022-02-14,119,,GSW,1,240,48,85,0.565,33,51,0.647,15,34,0.441,8,15,0.533,119,39,86,0.453,23,45,0.511,16,41,0.39,10,13,0.769,104
604,DET,2022-02-11,119,,CHO,0,240,48,102,0.471,36,67,0.537,12,35,0.343,11,18,0.611,119,54,97,0.557,36,55,0.655,18,42,0.429,15,23,0.652,141
605,MIN,2022-02-09,119,@,SAC,0,240,44,98,0.449,28,52,0.538,16,46,0.348,15,18,0.833,119,48,93,0.516,36,63,0.571,12,30,0.4,24,27,0.889,132
606,PHI,2022-02-06,119,@,CHI,1,240,45,84,0.536,33,60,0.55,12,24,0.5,17,21,0.81,119,39,81,0.481,32,55,0.582,7,26,0.269,23,26,0.885,108
607,ORL,2022-02-02,119,@,IND,1,240,42,95,0.442,31,60,0.517,11,35,0.314,24,26,0.923,119,44,98,0.449,30,66,0.455,14,32,0.438,16,23,0.696,118
608,MEM,2022-01-31,119,@,PHI,0,265,47,102,0.461,41,72,0.569,6,30,0.2,19,28,0.679,119,49,100,0.49,38,69,0.551,11,31,0.355,13,15,0.867,122
609,MEM,2022-01-28,119,,UTA,1,240,46,82,0.561,37,59,0.627,9,23,0.391,18,24,0.75,119,37,85,0.435,20,39,0.513,17,46,0.37,18,21,0.857,109
610,ORL,2022-01-28,119,,DET,1,240,41,83,0.494,29,58,0.5,12,25,0.48,25,26,0.962,119,32,87,0.368,22,58,0.379,10,29,0.345,29,37,0.784,103
611,BRK,2022-01-19,119,@,WAS,1,240,47,89,0.528,39,64,0.609,8,25,0.32,17,20,0.85,119,41,86,0.477,31,57,0.544,10,29,0.345,26,32,0.813,118
612,MEM,2022-01-17,119,,CHI,1,240,47,92,0.511,37,67,0.552,10,25,0.4,15,20,0.75,119,40,92,0.435,27,61,0.443,13,31,0.419,13,15,0.867,106
613,MIN,2022-01-16,119,,GSW,1,240,45,91,0.495,29,48,0.604,16,43,0.372,13,20,0.65,119,32,82,0.39,19,40,0.475,13,42,0.31,22,29,0.759,99
614,BOS,2022-01-12,119,@,IND,1,240,40,78,0.513,22,40,0.55,18,38,0.474,21,25,0.84,119,40,86,0.465,33,50,0.66,7,36,0.194,13,20,0.65,100
615,LAL,2022-01-09,119,,MEM,0,240,45,97,0.464,31,64,0.484,14,33,0.424,15,19,0.789,119,47,86,0.547,36,56,0.643,11,30,0.367,22,32,0.688,127
616,SAS,2022-01-09,119,@,BRK,0,265,46,107,0.43,33,75,0.44,13,32,0.406,14,18,0.778,119,47,98,0.48,39,70,0.557,8,28,0.286,19,22,0.864,121
617,PHI,2022-01-07,119,,SAS,1,240,45,87,0.517,37,64,0.578,8,23,0.348,21,27,0.778,119,38,92,0.413,29,62,0.468,9,30,0.3,15,20,0.75,100
618,WAS,2022-01-01,119,,CHI,0,240,46,87,0.529,40,60,0.667,6,27,0.222,21,26,0.808,119,41,84,0.488,24,50,0.48,17,34,0.5,21,25,0.84,120
619,MIA,2021-12-28,119,,WAS,1,240,41,92,0.446,25,58,0.431,16,34,0.471,21,23,0.913,119,42,85,0.494,25,43,0.581,17,42,0.405,11,14,0.786,112
620,TOR,2021-12-18,119,,GSW,1,240,45,90,0.5,31,52,0.596,14,38,0.368,15,23,0.652,119,37,79,0.468,26,43,0.605,11,36,0.306,15,21,0.714,100
621,CLE,2021-12-18,119,@,MIL,1,240,45,90,0.5,29,45,0.644,16,45,0.356,13,14,0.929,119,35,89,0.393,23,51,0.451,12,38,0.316,8,11,0.727,90
622,SAC,2021-12-15,119,,WAS,1,240,45,82,0.549,37,56,0.661,8,26,0.308,21,29,0.724,119,42,89,0.472,37,65,0.569,5,24,0.208,16,21,0.762,105
623,WAS,2021-12-08,119,@,DET,1,265,42,88,0.477,30,56,0.536,12,32,0.375,23,28,0.821,119,37,79,0.468,24,55,0.436,13,24,0.542,29,35,0.829,116
624,LAC,2021-12-03,119,@,LAL,1,240,41,81,0.506,25,46,0.543,16,35,0.457,21,24,0.875,119,45,90,0.5,33,57,0.579,12,33,0.364,13,21,0.619,115
625,CHI,2021-12-02,119,@,NYK,1,240,44,89,0.494,33,60,0.55,11,29,0.379,20,21,0.952,119,42,82,0.512,33,56,0.589,9,26,0.346,22,27,0.815,115
626,CHO,2021-11-29,119,@,CHI,0,240,42,88,0.477,24,49,0.49,18,39,0.462,17,21,0.81,119,53,89,0.596,39,59,0.661,14,30,0.467,13,19,0.684,133
627,POR,2021-11-23,119,,DEN,1,240,45,88,0.511,30,49,0.612,15,39,0.385,14,20,0.7,119,38,78,0.487,23,45,0.511,15,33,0.455,9,11,0.818,100
628,MEM,2021-11-22,119,@,UTA,1,240,42,95,0.442,29,60,0.483,13,35,0.371,22,27,0.815,119,41,87,0.471,24,44,0.545,17,43,0.395,19,25,0.76,118
629,GSW,2021-11-21,119,,TOR,1,240,39,79,0.494,17,34,0.5,22,45,0.489,19,24,0.792,119,39,99,0.394,24,62,0.387,15,37,0.405,11,20,0.55,104
630,UTA,2021-11-18,119,,TOR,1,240,44,80,0.55,25,34,0.735,19,46,0.413,12,13,0.923,119,39,94,0.415,29,56,0.518,10,38,0.263,15,17,0.882,103
631,PHO,2021-11-12,119,@,MEM,1,240,46,94,0.489,28,57,0.491,18,37,0.486,9,9,1.0,119,37,98,0.378,30,65,0.462,7,33,0.212,13,23,0.565,94
632,GSW,2021-11-12,119,,CHI,1,240,45,93,0.484,30,47,0.638,15,46,0.326,14,16,0.875,119,34,78,0.436,26,51,0.51,8,27,0.296,17,22,0.773,93
633,PHO,2021-11-10,119,,POR,1,240,49,94,0.521,38,66,0.576,11,28,0.393,10,12,0.833,119,44,91,0.484,37,61,0.607,7,30,0.233,14,16,0.875,109
634,LAL,2021-11-02,119,,HOU,1,240,49,93,0.527,43,68,0.632,6,25,0.24,15,20,0.75,119,48,91,0.527,32,49,0.653,16,42,0.381,5,12,0.417,117
635,UTA,2021-11-02,119,,SAC,1,240,43,98,0.439,29,50,0.58,14,48,0.292,19,27,0.704,119,42,93,0.452,30,62,0.484,12,31,0.387,17,24,0.708,113
636,MIL,2021-10-25,119,@,IND,1,240,41,85,0.482,30,53,0.566,11,32,0.344,26,31,0.839,119,40,90,0.444,26,54,0.481,14,36,0.389,15,17,0.882,109
637,GSW,2021-10-24,119,@,SAC,1,240,43,97,0.443,30,60,0.5,13,37,0.351,20,24,0.833,119,42,86,0.488,27,40,0.675,15,46,0.326,8,13,0.615,107
638,PHI,2022-04-10,118,,DET,1,240,46,88,0.523,41,63,0.651,5,25,0.2,21,23,0.913,118,38,83,0.458,27,49,0.551,11,34,0.324,19,29,0.655,106
639,BRK,2022-04-08,118,,CLE,1,240,43,92,0.467,31,60,0.517,12,32,0.375,20,21,0.952,118,40,82,0.488,32,55,0.582,8,27,0.296,19,24,0.792,107
640,ATL,2022-04-06,118,,WAS,1,240,43,92,0.467,27,53,0.509,16,39,0.41,16,19,0.842,118,42,86,0.488,32,51,0.627,10,35,0.286,9,11,0.818,103
641,TOR,2022-04-05,118,,ATL,1,240,44,101,0.436,35,66,0.53,9,35,0.257,21,31,0.677,118,43,94,0.457,29,57,0.509,14,37,0.378,8,12,0.667,108
642,BRK,2022-04-05,118,,HOU,1,240,39,86,0.453,24,49,0.49,15,37,0.405,25,27,0.926,118,40,99,0.404,29,56,0.518,11,43,0.256,14,25,0.56,105
643,DAL,2022-04-03,118,@,MIL,1,240,39,76,0.513,23,38,0.605,16,38,0.421,24,27,0.889,118,42,95,0.442,27,55,0.491,15,40,0.375,13,18,0.722,112
644,NYK,2022-04-03,118,@,ORL,1,240,45,93,0.484,30,49,0.612,15,44,0.341,13,16,0.813,118,30,85,0.353,18,41,0.439,12,44,0.273,16,27,0.593,88
645,LAL,2022-04-03,118,,DEN,0,240,49,92,0.533,43,72,0.597,6,20,0.3,14,21,0.667,118,47,82,0.573,35,51,0.686,12,31,0.387,23,29,0.793,129
646,OKC,2022-03-30,118,,ATL,0,240,41,87,0.471,24,46,0.522,17,41,0.415,19,27,0.704,118,49,91,0.538,31,52,0.596,18,39,0.462,20,22,0.909,136
647,IND,2022-03-30,118,,DEN,0,240,44,97,0.454,32,57,0.561,12,40,0.3,18,23,0.783,118,50,80,0.625,38,52,0.731,12,28,0.429,13,14,0.929,125
648,HOU,2022-03-30,118,,SAC,0,240,43,94,0.457,30,52,0.577,13,42,0.31,19,25,0.76,118,44,95,0.463,37,69,0.536,7,26,0.269,26,36,0.722,121
649,MIL,2022-03-29,118,@,PHI,1,240,44,88,0.5,30,50,0.6,14,38,0.368,16,23,0.696,118,43,89,0.483,27,48,0.563,16,41,0.39,14,18,0.778,116
650,GSW,2022-03-23,118,@,MIA,1,240,40,77,0.519,25,41,0.61,15,36,0.417,23,27,0.852,118,37,85,0.435,23,49,0.469,14,36,0.389,16,21,0.762,104
651,OKC,2022-03-23,118,,ORL,1,240,38,79,0.481,21,38,0.553,17,41,0.415,25,30,0.833,118,36,93,0.387,19,42,0.452,17,51,0.333,13,16,0.813,102
652,HOU,2022-03-18,118,,IND,0,240,39,79,0.494,27,52,0.519,12,27,0.444,28,32,0.875,118,47,101,0.465,33,58,0.569,14,43,0.326,13,19,0.684,121
653,PHI,2022-03-16,118,@,CLE,1,240,41,79,0.519,29,47,0.617,12,32,0.375,24,28,0.857,118,39,80,0.488,30,52,0.577,9,28,0.321,27,32,0.844,114
654,OKC,2022-03-13,118,,MEM,0,240,41,97,0.423,28,56,0.5,13,41,0.317,23,28,0.821,118,48,102,0.471,37,73,0.507,11,29,0.379,18,20,0.9,125
655,WAS,2022-03-12,118,@,POR,0,240,39,83,0.47,25,49,0.51,14,34,0.412,26,27,0.963,118,48,93,0.516,37,63,0.587,11,30,0.367,20,22,0.909,127
656,MEM,2022-03-11,118,,NYK,1,240,46,104,0.442,37,78,0.474,9,26,0.346,17,29,0.586,118,38,90,0.422,28,65,0.431,10,25,0.4,28,37,0.757,114
657,ORL,2022-03-11,118,,MIN,1,240,40,86,0.465,24,46,0.522,16,40,0.4,22,25,0.88,118,41,90,0.456,26,45,0.578,15,45,0.333,13,13,1.0,110
658,MIL,2022-03-04,118,@,CHI,1,240,43,88,0.489,33,57,0.579,10,31,0.323,22,33,0.667,118,47,94,0.5,37,68,0.544,10,26,0.385,8,11,0.727,112
659,MEM,2022-02-28,118,,SAS,1,240,48,89,0.539,37,63,0.587,11,26,0.423,11,19,0.579,118,41,99,0.414,32,67,0.478,9,32,0.281,14,19,0.737,105
660,UTA,2022-02-27,118,@,PHO,1,240,44,94,0.468,27,54,0.5,17,40,0.425,13,20,0.65,118,44,86,0.512,31,58,0.534,13,28,0.464,13,16,0.813,114
661,NOP,2022-02-17,118,,DAL,0,240,46,92,0.5,34,64,0.531,12,28,0.429,14,21,0.667,118,44,82,0.537,25,42,0.595,19,40,0.475,18,25,0.72,125
662,SAC,2022-02-16,118,@,CHI,0,240,43,84,0.512,31,54,0.574,12,30,0.4,20,22,0.909,118,47,94,0.5,35,65,0.538,12,29,0.414,19,20,0.95,125
663,CHO,2022-02-12,118,,MEM,0,240,39,97,0.402,25,52,0.481,14,45,0.311,26,33,0.788,118,47,96,0.49,36,63,0.571,11,33,0.333,20,33,0.606,125
664,MIN,2022-02-06,118,,DET,1,240,42,91,0.462,25,55,0.455,17,36,0.472,17,21,0.81,118,40,95,0.421,28,63,0.444,12,32,0.375,13,19,0.684,105
665,IND,2022-02-02,118,,ORL,0,240,44,98,0.449,30,66,0.455,14,32,0.438,16,23,0.696,118,42,95,0.442,31,60,0.517,11,35,0.314,24,26,0.923,119
666,BRK,2022-01-26,118,,DEN,0,240,43,88,0.489,31,59,0.525,12,29,0.414,20,26,0.769,118,42,89,0.472,27,53,0.509,15,36,0.417,25,27,0.926,124
667,MEM,2022-01-26,118,@,SAS,1,240,46,90,0.511,39,67,0.582,7,23,0.304,19,26,0.731,118,43,94,0.457,34,57,0.596,9,37,0.243,15,19,0.789,110
668,DEN,2022-01-21,118,,MEM,0,240,43,91,0.473,30,59,0.508,13,32,0.406,19,23,0.826,118,43,82,0.524,32,57,0.561,11,25,0.44,25,40,0.625,122
669,WAS,2022-01-19,118,,BRK,0,240,41,86,0.477,31,57,0.544,10,29,0.345,26,32,0.813,118,47,89,0.528,39,64,0.609,8,25,0.32,17,20,0.85,119
670,SAS,2022-01-19,118,,OKC,1,240,47,96,0.49,32,56,0.571,15,40,0.375,9,14,0.643,118,38,98,0.388,30,67,0.448,8,31,0.258,12,15,0.8,96
671,HOU,2022-01-16,118,@,SAC,1,240,41,76,0.539,25,36,0.694,16,40,0.4,20,24,0.833,118,41,91,0.451,29,53,0.547,12,38,0.316,18,24,0.75,112
672,ATL,2022-01-14,118,@,MIA,0,240,38,79,0.481,22,41,0.537,16,38,0.421,26,30,0.867,118,41,77,0.532,27,47,0.574,14,30,0.467,28,30,0.933,124
673,MIL,2022-01-13,118,,GSW,1,240,44,86,0.512,26,45,0.578,18,41,0.439,12,18,0.667,118,33,95,0.347,17,47,0.362,16,48,0.333,17,24,0.708,99
674,OKC,2022-01-11,118,@,WAS,0,240,47,98,0.48,36,59,0.61,11,39,0.282,13,15,0.867,118,47,87,0.54,36,54,0.667,11,33,0.333,17,23,0.739,122
675,ATL,2022-01-07,118,@,LAL,0,240,43,96,0.448,30,60,0.5,13,36,0.361,19,27,0.704,118,50,101,0.495,33,60,0.55,17,41,0.415,17,19,0.895,134
676,MEM,2022-01-06,118,,DET,1,240,48,98,0.49,38,66,0.576,10,32,0.313,12,19,0.632,118,34,99,0.343,24,55,0.436,10,44,0.227,10,13,0.769,88
677,MEM,2022-01-03,118,@,BRK,1,240,48,102,0.471,38,67,0.567,10,35,0.286,12,21,0.571,118,37,82,0.451,28,51,0.549,9,31,0.29,21,26,0.808,104
678,MEM,2021-12-31,118,,SAS,1,240,49,102,0.48,39,76,0.513,10,26,0.385,10,16,0.625,118,39,90,0.433,27,55,0.491,12,35,0.343,15,24,0.625,105
679,CLE,2021-12-31,118,,ATL,0,240,48,84,0.571,40,59,0.678,8,25,0.32,14,24,0.583,118,43,97,0.443,27,59,0.458,16,38,0.421,19,21,0.905,121
680,ORL,2021-12-30,118,,MIL,0,240,42,87,0.483,29,51,0.569,13,36,0.361,21,27,0.778,118,45,91,0.495,32,58,0.552,13,33,0.394,33,36,0.917,136
681,ATL,2021-12-27,118,,CHI,0,240,40,89,0.449,25,55,0.455,15,34,0.441,23,26,0.885,118,51,94,0.543,33,57,0.579,18,37,0.486,10,14,0.714,130
682,IND,2021-12-23,118,,HOU,1,240,46,88,0.523,33,50,0.66,13,38,0.342,13,19,0.684,118,35,80,0.438,20,43,0.465,15,37,0.405,21,26,0.808,106
683,HOU,2021-12-20,118,@,CHI,0,240,44,78,0.564,32,45,0.711,12,33,0.364,18,24,0.75,118,47,88,0.534,31,53,0.585,16,35,0.457,23,24,0.958,133
684,PHO,2021-12-16,118,,WAS,1,240,42,79,0.532,33,50,0.66,9,29,0.31,25,26,0.962,118,40,82,0.488,34,61,0.557,6,21,0.286,12,19,0.632,98
685,MIA,2021-12-11,118,,CHI,1,240,46,93,0.495,27,50,0.54,19,43,0.442,7,9,0.778,118,31,83,0.373,14,43,0.326,17,40,0.425,13,20,0.65,92
686,UTA,2021-12-09,118,@,PHI,1,240,43,91,0.473,28,51,0.549,15,40,0.375,17,24,0.708,118,38,88,0.432,32,55,0.582,6,33,0.182,14,15,0.933,96
687,HOU,2021-12-05,118,,NOP,1,240,39,79,0.494,22,39,0.564,17,40,0.425,23,29,0.793,118,40,94,0.426,30,56,0.536,10,38,0.263,18,25,0.72,108
688,HOU,2021-12-03,118,,ORL,1,240,44,92,0.478,27,45,0.6,17,47,0.362,13,15,0.867,118,42,86,0.488,29,49,0.592,13,37,0.351,19,21,0.905,116
689,GSW,2021-12-03,118,,PHO,1,240,45,92,0.489,26,53,0.491,19,39,0.487,9,12,0.75,118,31,81,0.383,23,59,0.39,8,22,0.364,26,35,0.743,96
690,MIL,2021-11-28,118,@,IND,1,240,46,90,0.511,38,55,0.691,8,35,0.229,18,22,0.818,118,38,92,0.413,26,47,0.553,12,45,0.267,12,16,0.75,100
691,PHO,2021-11-26,118,@,NYK,1,240,44,79,0.557,31,51,0.608,13,28,0.464,17,21,0.81,118,34,92,0.37,22,53,0.415,12,39,0.308,17,22,0.773,97
692,GSW,2021-11-26,118,,POR,1,240,47,87,0.54,35,50,0.7,12,37,0.324,12,16,0.75,118,36,86,0.419,23,48,0.479,13,38,0.342,18,23,0.783,103
693,HOU,2021-11-24,118,,CHI,1,240,42,84,0.5,25,48,0.521,17,36,0.472,17,22,0.773,118,44,96,0.458,29,61,0.475,15,35,0.429,10,12,0.833,113
694,UTA,2021-11-22,118,,MEM,0,240,41,87,0.471,24,44,0.545,17,43,0.395,19,25,0.76,118,42,95,0.442,29,60,0.483,13,35,0.371,22,27,0.815,119
695,POR,2021-11-20,118,,PHI,1,240,40,80,0.5,25,46,0.543,15,34,0.441,23,23,1.0,118,41,81,0.506,31,53,0.585,10,28,0.357,19,21,0.905,111
696,IND,2021-11-19,118,@,CHO,0,240,41,88,0.466,30,52,0.577,11,36,0.306,25,32,0.781,118,44,81,0.543,32,50,0.64,12,31,0.387,21,28,0.75,121
697,POR,2021-11-15,118,,TOR,1,240,46,82,0.561,30,46,0.652,16,36,0.444,10,14,0.714,118,41,89,0.461,26,56,0.464,15,33,0.455,16,18,0.889,113
698,IND,2021-11-13,118,,PHI,1,240,47,82,0.573,33,54,0.611,14,28,0.5,10,15,0.667,118,38,89,0.427,26,66,0.394,12,23,0.522,25,29,0.862,113
699,CHO,2021-11-10,118,@,MEM,1,240,41,90,0.456,26,54,0.481,15,36,0.417,21,24,0.875,118,45,107,0.421,36,69,0.522,9,38,0.237,9,15,0.6,108
700,MIL,2021-11-09,118,@,PHI,1,240,44,95,0.463,29,56,0.518,15,39,0.385,15,21,0.714,118,42,103,0.408,28,60,0.467,14,43,0.326,11,12,0.917,109
701,CHI,2021-11-08,118,,BRK,1,240,46,98,0.469,37,67,0.552,9,31,0.29,17,20,0.85,118,34,86,0.395,23,53,0.434,11,33,0.333,16,19,0.842,95
702,MIN,2021-11-08,118,@,MEM,0,265,41,97,0.423,24,52,0.462,17,45,0.378,19,23,0.826,118,46,92,0.5,35,64,0.547,11,28,0.393,22,26,0.846,125
703,MIA,2021-11-06,118,,UTA,1,240,47,78,0.603,36,57,0.632,11,21,0.524,13,17,0.765,118,43,83,0.518,28,38,0.737,15,45,0.333,14,19,0.737,115
704,SAS,2021-11-01,118,@,IND,0,240,47,89,0.528,33,61,0.541,14,28,0.5,10,14,0.714,118,52,91,0.571,34,53,0.642,18,38,0.474,9,12,0.75,131
705,ATL,2021-11-01,118,,WAS,1,240,38,83,0.458,25,49,0.51,13,34,0.382,29,29,1.0,118,41,86,0.477,28,47,0.596,13,39,0.333,16,16,1.0,111
706,TOR,2021-10-27,118,,IND,1,240,46,100,0.46,32,70,0.457,14,30,0.467,12,19,0.632,118,38,79,0.481,28,50,0.56,10,29,0.345,14,17,0.824,100
707,MEM,2021-10-24,118,@,LAL,0,240,45,100,0.45,32,65,0.492,13,35,0.371,15,18,0.833,118,45,84,0.536,29,54,0.537,16,30,0.533,15,22,0.682,121
708,LAC,2022-04-09,117,,SAC,1,240,42,86,0.488,21,43,0.488,21,43,0.488,12,15,0.8,117,38,86,0.442,31,58,0.534,7,28,0.25,15,24,0.625,98
709,TOR,2022-04-08,117,,HOU,1,240,44,96,0.458,37,67,0.552,7,29,0.241,22,23,0.957,117,43,81,0.531,33,52,0.635,10,29,0.345,19,24,0.792,115
710,CHI,2022-04-08,117,,CHO,0,240,44,82,0.537,31,58,0.534,13,24,0.542,16,20,0.8,117,52,86,0.605,33,46,0.717,19,40,0.475,10,10,1.0,133
711,BOS,2022-04-06,117,@,CHI,1,240,43,88,0.489,26,51,0.51,17,37,0.459,14,22,0.636,117,35,80,0.438,28,57,0.491,7,23,0.304,17,23,0.739,94
712,OKC,2022-04-03,117,,PHO,1,240,43,87,0.494,26,46,0.565,17,41,0.415,14,18,0.778,117,37,89,0.416,30,51,0.588,7,38,0.184,15,17,0.882,96
713,IND,2022-04-03,117,,DET,0,240,45,94,0.479,33,56,0.589,12,38,0.316,15,19,0.789,117,43,99,0.434,22,58,0.379,21,41,0.512,14,18,0.778,121
714,HOU,2022-04-01,117,,SAC,0,240,41,97,0.423,24,52,0.462,17,45,0.378,18,26,0.692,117,42,81,0.519,30,53,0.566,12,28,0.429,26,34,0.765,122
715,NOP,2022-03-30,117,@,POR,1,240,40,78,0.513,34,54,0.63,6,24,0.25,31,39,0.795,117,39,85,0.459,25,43,0.581,14,42,0.333,15,18,0.833,107
716,TOR,2022-03-24,117,,CLE,1,240,42,89,0.472,26,52,0.5,16,37,0.432,17,19,0.895,117,37,79,0.468,25,49,0.51,12,30,0.4,18,22,0.818,104
717,ATL,2022-03-22,117,@,NYK,1,240,40,81,0.494,25,45,0.556,15,36,0.417,22,27,0.815,117,42,86,0.488,29,52,0.558,13,34,0.382,14,26,0.538,111
718,NOP,2022-03-20,117,@,ATL,1,240,43,96,0.448,36,75,0.48,7,21,0.333,24,27,0.889,117,41,87,0.471,31,55,0.564,10,32,0.313,20,23,0.87,112
719,MIL,2022-03-14,117,@,UTA,1,240,40,86,0.465,28,55,0.509,12,31,0.387,25,29,0.862,117,37,93,0.398,20,45,0.444,17,48,0.354,20,24,0.833,111
720,TOR,2022-03-11,117,@,PHO,1,240,42,94,0.447,28,62,0.452,14,32,0.438,19,21,0.905,117,44,88,0.5,33,52,0.635,11,36,0.306,13,17,0.765,112
721,MIA,2022-03-11,117,,CLE,1,240,41,86,0.477,30,51,0.588,11,35,0.314,24,27,0.889,117,35,79,0.443,27,54,0.5,8,25,0.32,27,29,0.931,105
722,SAS,2022-03-07,117,,LAL,1,240,46,84,0.548,37,58,0.638,9,26,0.346,16,30,0.533,117,43,91,0.473,35,65,0.538,8,26,0.308,16,23,0.696,110
723,SAS,2022-03-05,117,@,CHO,0,240,45,98,0.459,34,61,0.557,11,37,0.297,16,20,0.8,117,42,91,0.462,26,49,0.531,16,42,0.381,23,29,0.793,123
724,ATL,2022-03-04,117,@,WAS,1,240,38,91,0.418,25,55,0.455,13,36,0.361,28,34,0.824,117,46,85,0.541,32,56,0.571,14,29,0.483,8,9,0.889,114
725,NOP,2022-02-25,117,@,PHO,1,240,38,87,0.437,30,58,0.517,8,29,0.276,33,41,0.805,117,36,82,0.439,24,42,0.571,12,40,0.3,18,24,0.75,102
726,WAS,2022-02-17,117,@,BRK,1,240,46,83,0.554,34,59,0.576,12,24,0.5,13,16,0.813,117,36,89,0.404,22,51,0.431,14,38,0.368,17,24,0.708,103
727,DEN,2022-02-16,117,@,GSW,1,240,43,91,0.473,29,55,0.527,14,36,0.389,17,21,0.81,117,45,87,0.517,35,53,0.66,10,34,0.294,16,24,0.667,116
728,GSW,2022-02-12,117,,LAL,1,240,40,90,0.444,28,52,0.538,12,38,0.316,25,34,0.735,117,41,88,0.466,30,61,0.492,11,27,0.407,22,33,0.667,115
729,TOR,2022-02-09,117,@,OKC,1,240,45,88,0.511,32,53,0.604,13,35,0.371,14,14,1.0,117,36,87,0.414,22,40,0.55,14,47,0.298,12,14,0.857,98
730,DET,2022-02-03,117,,MIN,0,240,40,91,0.44,25,45,0.556,15,46,0.326,22,28,0.786,117,44,87,0.506,29,53,0.547,15,34,0.441,25,28,0.893,128
731,CHO,2022-01-28,117,,LAL,1,240,43,83,0.518,32,47,0.681,11,36,0.306,20,28,0.714,117,38,91,0.418,23,51,0.451,15,40,0.375,23,32,0.719,114
732,PHI,2022-01-25,117,,NOP,1,240,39,84,0.464,29,53,0.547,10,31,0.323,29,31,0.935,117,40,83,0.482,31,61,0.508,9,22,0.409,18,26,0.692,107
733,NOP,2022-01-24,117,,IND,1,240,41,88,0.466,35,58,0.603,6,30,0.2,29,31,0.935,117,38,87,0.437,19,41,0.463,19,46,0.413,18,25,0.72,113
734,DEN,2022-01-23,117,,DET,1,240,44,85,0.518,32,50,0.64,12,35,0.343,17,23,0.739,117,42,75,0.56,31,46,0.674,11,29,0.379,16,19,0.842,111
735,BRK,2022-01-21,117,@,SAS,1,240,48,100,0.48,39,75,0.52,9,25,0.36,12,12,1.0,117,37,95,0.389,29,66,0.439,8,29,0.276,20,24,0.833,102
736,GSW,2022-01-20,117,,IND,0,265,42,94,0.447,33,52,0.635,9,42,0.214,24,29,0.828,117,41,95,0.432,26,60,0.433,15,35,0.429,24,34,0.706,121
737,CHI,2022-01-19,117,,CLE,1,240,47,86,0.547,37,64,0.578,10,22,0.455,13,18,0.722,117,40,77,0.519,31,50,0.62,9,27,0.333,15,22,0.682,104
738,WAS,2022-01-17,117,,PHI,1,240,42,87,0.483,33,57,0.579,9,30,0.3,24,32,0.75,117,35,86,0.407,28,60,0.467,7,26,0.269,21,25,0.84,98
739,NYK,2022-01-15,117,@,ATL,1,240,42,83,0.506,29,52,0.558,13,31,0.419,20,26,0.769,117,40,80,0.5,24,36,0.667,16,44,0.364,12,17,0.706,108
740,TOR,2022-01-05,117,@,MIL,1,240,42,89,0.472,26,53,0.491,16,36,0.444,17,25,0.68,117,38,85,0.447,21,46,0.457,17,39,0.436,18,26,0.692,111
741,DET,2022-01-01,117,,SAS,1,265,41,101,0.406,32,66,0.485,9,35,0.257,26,33,0.788,117,42,102,0.412,30,62,0.484,12,40,0.3,20,28,0.714,116
742,ATL,2021-12-29,117,@,CHI,0,240,44,92,0.478,33,66,0.5,11,26,0.423,18,26,0.692,117,52,84,0.619,42,62,0.677,10,22,0.455,17,22,0.773,131
743,SAC,2021-12-28,117,,OKC,1,240,40,95,0.421,23,56,0.411,17,39,0.436,20,27,0.741,117,35,90,0.389,24,57,0.421,11,33,0.333,30,36,0.833,111
744,POR,2021-12-27,117,,DAL,0,240,35,82,0.427,23,42,0.548,12,40,0.3,35,42,0.833,117,48,84,0.571,36,51,0.706,12,33,0.364,24,33,0.727,132
745,OKC,2021-12-26,117,,NOP,1,240,41,86,0.477,28,50,0.56,13,36,0.361,22,31,0.71,117,39,94,0.415,29,53,0.547,10,41,0.244,24,28,0.857,112
746,PHI,2021-12-26,117,@,WAS,1,240,43,86,0.5,31,55,0.564,12,31,0.387,19,22,0.864,117,35,90,0.389,27,57,0.474,8,33,0.242,18,28,0.643,96
747,MIL,2021-12-25,117,,BOS,1,240,43,91,0.473,31,58,0.534,12,33,0.364,19,27,0.704,117,38,89,0.427,21,44,0.477,17,45,0.378,20,24,0.833,113
748,NYK,2021-12-23,117,,WAS,0,240,42,93,0.452,29,51,0.569,13,42,0.31,20,23,0.87,117,42,75,0.56,26,38,0.684,16,37,0.432,24,32,0.75,124
749,BOS,2021-12-13,117,,MIL,1,240,43,86,0.5,23,39,0.59,20,47,0.426,11,13,0.846,117,40,90,0.444,29,54,0.537,11,36,0.306,12,15,0.8,103
750,CLE,2021-12-11,117,,SAC,1,240,41,88,0.466,29,57,0.509,12,31,0.387,23,28,0.821,117,41,93,0.441,34,65,0.523,7,28,0.25,14,22,0.636,103
751,LAL,2021-12-07,117,,BOS,1,240,48,93,0.516,40,66,0.606,8,27,0.296,13,17,0.765,117,36,82,0.439,26,49,0.531,10,33,0.303,20,29,0.69,102
752,POR,2021-12-04,117,,BOS,0,240,42,89,0.472,34,60,0.567,8,29,0.276,25,32,0.781,117,49,87,0.563,28,50,0.56,21,37,0.568,26,29,0.897,145
753,LAL,2021-11-30,117,@,SAC,1,240,46,92,0.5,35,64,0.547,11,28,0.393,14,20,0.7,117,35,79,0.443,29,50,0.58,6,29,0.207,16,22,0.727,92
754,BRK,2021-11-22,117,@,CLE,1,240,45,95,0.474,34,60,0.567,11,35,0.314,16,18,0.889,117,36,93,0.387,22,49,0.449,14,44,0.318,26,29,0.897,112
755,MIL,2021-11-20,117,,ORL,1,240,37,82,0.451,18,42,0.429,19,40,0.475,24,37,0.649,117,39,98,0.398,20,47,0.426,19,51,0.373,11,14,0.786,108
756,GSW,2021-11-16,117,@,BRK,1,240,41,79,0.519,28,39,0.718,13,40,0.325,22,28,0.786,117,34,88,0.386,24,52,0.462,10,36,0.278,21,27,0.778,99
757,SAC,2021-11-10,117,@,SAS,0,240,47,91,0.516,37,55,0.673,10,36,0.278,13,16,0.813,117,49,92,0.533,31,60,0.517,18,32,0.563,20,31,0.645,136
758,MIA,2021-11-10,117,@,LAL,0,265,40,96,0.417,30,59,0.508,10,37,0.27,27,35,0.771,117,46,92,0.5,28,54,0.519,18,38,0.474,10,16,0.625,120
759,CHI,2021-11-10,117,,DAL,1,240,45,89,0.506,30,58,0.517,15,31,0.484,12,14,0.857,117,38,83,0.458,26,50,0.52,12,33,0.364,19,24,0.792,107
760,LAC,2021-11-09,117,,POR,1,240,44,85,0.518,28,55,0.509,16,30,0.533,13,19,0.684,117,43,91,0.473,29,54,0.537,14,37,0.378,9,12,0.75,109
761,ATL,2021-11-06,117,@,PHO,0,240,42,97,0.433,29,64,0.453,13,33,0.394,20,23,0.87,117,45,88,0.511,31,45,0.689,14,43,0.326,17,21,0.81,121
762,BRK,2021-11-03,117,,ATL,1,240,43,88,0.489,21,40,0.525,22,48,0.458,9,12,0.75,117,41,94,0.436,28,59,0.475,13,35,0.371,13,15,0.867,108
763,MIL,2021-11-02,117,@,DET,1,240,42,84,0.5,25,47,0.532,17,37,0.459,16,21,0.762,117,30,93,0.323,22,46,0.478,8,47,0.17,21,30,0.7,89
764,HOU,2021-11-02,117,@,LAL,0,240,48,91,0.527,32,49,0.653,16,42,0.381,5,12,0.417,117,49,93,0.527,43,68,0.632,6,25,0.24,15,20,0.75,119
765,BRK,2021-10-31,117,,DET,1,240,47,72,0.653,34,47,0.723,13,25,0.52,10,16,0.625,117,32,79,0.405,20,46,0.435,12,33,0.364,15,22,0.682,91
766,NOP,2021-10-30,117,,NYK,0,240,42,92,0.457,31,59,0.525,11,33,0.333,22,24,0.917,117,42,81,0.519,23,48,0.479,19,33,0.576,20,25,0.8,123
767,PHI,2021-10-20,117,@,NOP,1,240,44,85,0.518,31,60,0.517,13,25,0.52,16,20,0.8,117,39,93,0.419,26,63,0.413,13,30,0.433,6,9,0.667,97
768,SAC,2022-04-10,116,@,PHO,1,240,40,76,0.526,26,50,0.52,14,26,0.538,22,30,0.733,116,42,103,0.408,28,56,0.5,14,47,0.298,11,15,0.733,109
769,SAS,2022-04-05,116,@,DEN,1,240,44,89,0.494,32,63,0.508,12,26,0.462,16,24,0.667,116,41,98,0.418,34,65,0.523,7,33,0.212,8,12,0.667,97
770,PHI,2022-03-29,116,,MIL,0,240,43,89,0.483,27,48,0.563,16,41,0.39,14,18,0.778,116,44,88,0.5,30,50,0.6,14,38,0.368,16,23,0.696,118
771,NOP,2022-03-27,116,,LAL,1,240,44,91,0.484,35,64,0.547,9,27,0.333,19,24,0.792,116,42,80,0.525,28,45,0.622,14,35,0.4,10,16,0.625,108
772,MIN,2022-03-25,116,,DAL,1,240,43,84,0.512,32,52,0.615,11,32,0.344,19,24,0.792,116,35,90,0.389,25,47,0.532,10,43,0.233,15,19,0.789,95
773,MIN,2022-03-23,116,,PHO,0,240,42,95,0.442,29,52,0.558,13,43,0.302,19,22,0.864,116,45,86,0.523,33,53,0.623,12,33,0.364,23,29,0.793,125
774,DEN,2022-03-18,116,@,CLE,0,265,46,92,0.5,36,59,0.61,10,33,0.303,14,18,0.778,116,44,98,0.449,30,61,0.492,14,37,0.378,17,26,0.654,119
775,CHO,2022-03-16,116,,ATL,1,240,43,87,0.494,32,52,0.615,11,35,0.314,19,23,0.826,116,40,93,0.43,27,56,0.482,13,37,0.351,13,14,0.929,106
776,OKC,2022-03-14,116,,CHO,0,240,42,90,0.467,26,46,0.565,16,44,0.364,16,19,0.842,116,49,91,0.538,29,56,0.518,20,35,0.571,16,21,0.762,134
777,PHI,2022-03-13,116,@,ORL,1,265,35,92,0.38,21,55,0.382,14,37,0.378,32,37,0.865,116,41,91,0.451,23,48,0.479,18,43,0.419,14,20,0.7,114
778,UTA,2022-03-06,116,@,OKC,1,240,40,89,0.449,17,37,0.459,23,52,0.442,13,17,0.765,116,39,92,0.424,31,52,0.596,8,40,0.2,17,19,0.895,103
779,NYK,2022-03-06,116,@,LAC,1,240,42,89,0.472,29,60,0.483,13,29,0.448,19,30,0.633,116,33,88,0.375,22,54,0.407,11,34,0.324,16,22,0.727,93
780,GSW,2022-03-05,116,@,LAL,0,240,46,92,0.5,31,58,0.534,15,34,0.441,9,19,0.474,116,44,89,0.494,26,48,0.542,18,41,0.439,18,21,0.857,124
781,DEN,2022-03-04,116,,HOU,1,240,39,86,0.453,26,53,0.491,13,33,0.394,25,31,0.806,116,38,83,0.458,28,47,0.596,10,36,0.278,15,22,0.682,101
782,WAS,2022-03-01,116,,DET,1,240,41,82,0.5,28,56,0.5,13,26,0.5,21,26,0.808,116,43,90,0.478,35,63,0.556,8,27,0.296,19,23,0.826,113
783,MEM,2022-02-26,116,@,CHI,1,240,44,100,0.44,37,77,0.481,7,23,0.304,21,26,0.808,116,39,93,0.419,30,73,0.411,9,20,0.45,23,30,0.767,110
784,GSW,2022-02-16,116,,DEN,0,240,45,87,0.517,35,53,0.66,10,34,0.294,16,24,0.667,116,43,91,0.473,29,55,0.527,14,36,0.389,17,21,0.81,117
785,CLE,2022-02-15,116,@,ATL,0,240,45,88,0.511,29,47,0.617,16,41,0.39,10,12,0.833,116,43,80,0.538,29,47,0.617,14,33,0.424,24,27,0.889,124
786,NYK,2022-02-10,116,@,GSW,1,240,39,90,0.433,25,54,0.463,14,36,0.389,24,33,0.727,116,42,91,0.462,27,46,0.587,15,45,0.333,15,17,0.882,114
787,DAL,2022-02-08,116,,DET,1,240,40,79,0.506,22,43,0.512,18,36,0.5,18,23,0.783,116,33,87,0.379,28,57,0.491,5,30,0.167,15,22,0.682,86
788,LAL,2022-02-08,116,,MIL,0,240,44,85,0.518,34,53,0.642,10,32,0.313,18,30,0.6,116,52,96,0.542,37,60,0.617,15,36,0.417,12,20,0.6,131
789,TOR,2022-02-07,116,@,CHO,1,240,41,84,0.488,26,49,0.531,15,35,0.429,19,29,0.655,116,39,95,0.411,30,55,0.545,9,40,0.225,14,16,0.875,101
790,BOS,2022-02-06,116,@,ORL,1,240,45,99,0.455,32,53,0.604,13,46,0.283,13,14,0.929,116,29,81,0.358,24,55,0.436,5,26,0.192,20,21,0.952,83
791,LAC,2022-01-31,116,@,IND,0,240,45,96,0.469,30,52,0.577,15,44,0.341,11,13,0.846,116,50,95,0.526,36,66,0.545,14,29,0.483,8,12,0.667,122
792,NYK,2022-01-31,116,,SAC,1,240,40,80,0.5,27,45,0.6,13,35,0.371,23,29,0.793,116,37,86,0.43,26,48,0.542,11,38,0.289,11,22,0.5,96
793,POR,2022-01-30,116,@,CHI,0,240,43,83,0.518,25,44,0.568,18,39,0.462,12,16,0.75,116,50,90,0.556,37,58,0.638,13,32,0.406,17,18,0.944,130
794,DEN,2022-01-28,116,@,NOP,1,240,41,82,0.5,29,49,0.592,12,33,0.364,22,25,0.88,116,35,90,0.389,30,56,0.536,5,34,0.147,30,33,0.909,105
795,LAC,2022-01-25,116,@,WAS,1,240,39,94,0.415,28,65,0.431,11,29,0.379,27,31,0.871,116,37,80,0.463,28,53,0.528,9,27,0.333,32,40,0.8,115
796,BOS,2022-01-23,116,@,WAS,1,240,40,90,0.444,21,51,0.412,19,39,0.487,17,21,0.81,116,33,93,0.355,25,59,0.424,8,34,0.235,13,16,0.813,87
797,LAL,2022-01-21,116,@,ORL,1,240,42,85,0.494,29,55,0.527,13,30,0.433,19,23,0.826,116,36,81,0.444,25,41,0.61,11,40,0.275,22,29,0.759,105
798,HOU,2022-01-19,116,@,UTA,1,240,41,96,0.427,19,51,0.373,22,45,0.489,12,17,0.706,116,42,89,0.472,32,51,0.627,10,38,0.263,17,20,0.85,111
799,ORL,2022-01-14,116,@,CHO,1,240,45,87,0.517,30,42,0.714,15,45,0.333,11,15,0.733,116,40,97,0.412,28,55,0.509,12,42,0.286,17,21,0.81,109
800,MEM,2022-01-13,116,,MIN,1,240,42,92,0.457,34,60,0.567,8,32,0.25,24,35,0.686,116,41,96,0.427,26,48,0.542,15,48,0.313,11,14,0.786,108
801,LAL,2022-01-12,116,@,SAC,0,240,42,98,0.429,26,51,0.51,16,47,0.34,16,24,0.667,116,49,89,0.551,38,59,0.644,11,30,0.367,16,19,0.842,125
802,MEM,2022-01-11,116,,GSW,1,240,44,100,0.44,30,66,0.455,14,34,0.412,14,18,0.778,116,35,82,0.427,22,46,0.478,13,36,0.361,25,29,0.862,108
803,UTA,2022-01-10,116,@,DET,0,240,44,86,0.512,33,53,0.623,11,33,0.333,17,22,0.773,116,48,93,0.516,29,56,0.518,19,37,0.514,11,12,0.917,126
804,PHI,2022-01-05,116,@,ORL,1,240,43,85,0.506,31,57,0.544,12,28,0.429,18,24,0.75,116,40,90,0.444,28,51,0.549,12,39,0.308,14,20,0.7,106
805,BOS,2022-01-02,116,,ORL,1,265,39,86,0.453,26,50,0.52,13,36,0.361,25,28,0.893,116,40,95,0.421,31,68,0.456,9,27,0.333,22,27,0.815,111
806,SAS,2022-01-01,116,@,DET,0,265,42,102,0.412,30,62,0.484,12,40,0.3,20,28,0.714,116,41,101,0.406,32,66,0.485,9,35,0.257,26,33,0.788,117
807,UTA,2022-01-01,116,,GSW,0,240,40,92,0.435,26,48,0.542,14,44,0.318,22,28,0.786,116,46,86,0.535,29,54,0.537,17,32,0.531,14,21,0.667,123
808,BRK,2022-01-01,116,,LAC,0,240,42,97,0.433,31,64,0.484,11,33,0.333,21,25,0.84,116,42,86,0.488,28,50,0.56,14,36,0.389,22,31,0.71,120
809,TOR,2021-12-31,116,,LAC,1,240,40,96,0.417,29,61,0.475,11,35,0.314,25,33,0.758,116,38,78,0.487,23,44,0.523,15,34,0.441,17,19,0.895,108
810,CHO,2021-12-29,116,@,IND,1,240,44,85,0.518,35,59,0.593,9,26,0.346,19,32,0.594,116,36,86,0.419,19,41,0.463,17,45,0.378,19,29,0.655,108
811,GSW,2021-12-25,116,@,PHO,1,240,42,85,0.494,28,48,0.583,14,37,0.378,18,21,0.857,116,40,83,0.482,29,53,0.547,11,30,0.367,16,16,1.0,107
812,DAL,2021-12-25,116,@,UTA,0,240,38,89,0.427,28,59,0.475,10,30,0.333,30,35,0.857,116,40,90,0.444,28,54,0.519,12,36,0.333,28,37,0.757,120
813,MIN,2021-12-23,116,@,UTA,0,240,45,101,0.446,28,56,0.5,17,45,0.378,9,12,0.75,116,48,90,0.533,32,51,0.627,16,39,0.41,16,22,0.727,128
814,SAS,2021-12-20,116,@,LAC,1,240,50,114,0.439,38,77,0.494,12,37,0.324,4,6,0.667,116,34,87,0.391,25,55,0.455,9,32,0.281,15,20,0.75,92
815,HOU,2021-12-18,116,@,DET,1,240,46,93,0.495,32,55,0.582,14,38,0.368,10,17,0.588,116,43,93,0.462,33,57,0.579,10,36,0.278,11,16,0.688,107
816,CHO,2021-12-17,116,@,POR,0,240,44,92,0.478,31,55,0.564,13,37,0.351,15,18,0.833,116,44,85,0.518,23,38,0.605,21,47,0.447,16,18,0.889,125
817,NOP,2021-12-17,116,,MIL,1,265,42,89,0.472,29,52,0.558,13,37,0.351,19,30,0.633,116,45,104,0.433,31,57,0.544,14,47,0.298,8,10,0.8,112
818,NYK,2021-12-16,116,@,HOU,1,240,39,83,0.47,22,47,0.468,17,36,0.472,21,25,0.84,116,34,68,0.5,23,36,0.639,11,32,0.344,24,30,0.8,103
819,MIN,2021-12-12,116,@,POR,1,240,38,85,0.447,24,49,0.49,14,36,0.389,26,32,0.813,116,37,81,0.457,19,33,0.576,18,48,0.375,19,28,0.679,111
820,BRK,2021-12-12,116,@,DET,1,240,41,87,0.471,30,59,0.508,11,28,0.393,23,25,0.92,116,39,92,0.424,25,55,0.455,14,37,0.378,12,18,0.667,104
821,LAL,2021-12-10,116,@,OKC,1,240,41,87,0.471,22,45,0.489,19,42,0.452,15,20,0.75,116,38,96,0.396,28,52,0.538,10,44,0.227,9,14,0.643,95
822,DET,2021-12-08,116,,WAS,0,265,37,79,0.468,24,55,0.436,13,24,0.542,29,35,0.829,116,42,88,0.477,30,56,0.536,12,32,0.375,23,28,0.821,119
823,IND,2021-12-06,116,,WAS,1,240,43,82,0.524,34,59,0.576,9,23,0.391,21,22,0.955,116,43,81,0.531,36,66,0.545,7,15,0.467,17,21,0.81,110
824,CLE,2021-12-03,116,@,WAS,1,240,42,89,0.472,29,59,0.492,13,30,0.433,19,25,0.76,116,38,82,0.463,28,51,0.549,10,31,0.323,15,19,0.789,101
825,ORL,2021-12-03,116,@,HOU,0,240,42,86,0.488,29,49,0.592,13,37,0.351,19,21,0.905,116,44,92,0.478,27,45,0.6,17,47,0.362,13,15,0.867,118
826,SAS,2021-11-29,116,,WAS,1,240,49,92,0.533,41,74,0.554,8,18,0.444,10,16,0.625,116,41,92,0.446,32,61,0.525,9,31,0.29,8,13,0.615,99
827,GSW,2021-11-24,116,,PHI,1,240,42,80,0.525,27,42,0.643,15,38,0.395,17,24,0.708,116,34,80,0.425,26,52,0.5,8,28,0.286,20,22,0.909,96
828,IND,2021-11-24,116,,LAL,0,265,42,104,0.404,29,58,0.5,13,46,0.283,19,24,0.792,116,42,95,0.442,27,58,0.466,15,37,0.405,25,29,0.862,124
829,DET,2021-11-21,116,,LAL,0,240,43,97,0.443,29,57,0.509,14,40,0.35,16,21,0.762,116,45,92,0.489,35,61,0.574,10,31,0.323,21,27,0.778,121
830,BRK,2021-11-07,116,@,TOR,1,240,41,80,0.513,24,42,0.571,17,38,0.447,17,20,0.85,116,41,87,0.471,34,57,0.596,7,30,0.233,14,18,0.778,103
831,UTA,2021-11-04,116,@,ATL,1,240,41,81,0.506,24,40,0.6,17,41,0.415,17,23,0.739,116,35,82,0.427,28,54,0.519,7,28,0.25,21,26,0.808,98
832,POR,2021-10-27,116,,MEM,1,240,39,84,0.464,24,48,0.5,15,36,0.417,23,31,0.742,116,35,96,0.365,18,46,0.391,17,50,0.34,9,19,0.474,96
833,WAS,2021-10-27,116,@,BOS,1,240,43,84,0.512,34,59,0.576,9,25,0.36,21,29,0.724,116,37,85,0.435,27,56,0.482,10,29,0.345,23,28,0.821,107
834,DAL,2021-10-26,116,,HOU,1,240,43,93,0.462,31,50,0.62,12,43,0.279,18,25,0.72,116,36,86,0.419,20,47,0.426,16,39,0.41,18,26,0.692,106
835,LAC,2021-10-25,116,,POR,1,240,44,93,0.473,30,50,0.6,14,43,0.326,14,19,0.737,116,32,85,0.376,24,48,0.5,8,37,0.216,14,18,0.778,86
836,MIL,2022-04-10,115,@,CLE,0,240,39,88,0.443,27,58,0.466,12,30,0.4,25,32,0.781,115,51,94,0.543,32,56,0.571,19,38,0.5,12,17,0.706,133
837,HOU,2022-04-08,115,@,TOR,0,240,43,81,0.531,33,52,0.635,10,29,0.345,19,24,0.792,115,44,96,0.458,37,67,0.552,7,29,0.241,22,23,0.957,117
838,CLE,2022-04-05,115,@,ORL,0,240,42,86,0.488,26,50,0.52,16,36,0.444,15,22,0.682,115,47,93,0.505,31,58,0.534,16,35,0.457,10,15,0.667,120
839,MEM,2022-04-05,115,@,UTA,0,265,39,101,0.386,26,70,0.371,13,31,0.419,24,29,0.828,115,40,96,0.417,28,58,0.483,12,38,0.316,29,43,0.674,121
840,CHO,2022-04-05,115,@,MIA,0,240,45,85,0.529,33,47,0.702,12,38,0.316,13,18,0.722,115,48,84,0.571,25,42,0.595,23,42,0.548,25,29,0.862,144
841,BRK,2022-04-02,115,@,ATL,0,240,42,99,0.424,25,62,0.403,17,37,0.459,14,19,0.737,115,36,86,0.419,23,45,0.511,13,41,0.317,37,49,0.755,122
842,UTA,2022-03-29,115,@,LAC,0,240,43,78,0.551,31,47,0.66,12,31,0.387,17,29,0.586,115,41,83,0.494,26,47,0.553,15,36,0.417,24,28,0.857,121
843,TOR,2022-03-28,115,,BOS,1,265,46,106,0.434,36,67,0.537,10,39,0.256,13,18,0.722,115,39,95,0.411,27,55,0.491,12,40,0.3,22,28,0.786,112
844,GSW,2022-03-27,115,@,WAS,0,240,38,89,0.427,30,56,0.536,8,33,0.242,31,39,0.795,115,44,84,0.524,28,56,0.5,16,28,0.571,19,22,0.864,123
845,HOU,2022-03-26,115,@,POR,1,240,44,84,0.524,29,49,0.592,15,35,0.429,12,18,0.667,115,37,93,0.398,25,53,0.472,12,40,0.3,12,17,0.706,98
846,LAC,2022-03-22,115,@,DEN,0,240,42,86,0.488,32,54,0.593,10,32,0.313,21,26,0.808,115,45,83,0.542,29,51,0.569,16,32,0.5,21,23,0.913,127
847,HOU,2022-03-21,115,,WAS,1,240,42,85,0.494,22,46,0.478,20,39,0.513,11,13,0.846,115,35,85,0.412,29,56,0.518,6,29,0.207,21,24,0.875,97
848,DET,2022-03-21,115,,POR,0,240,36,85,0.424,27,50,0.54,9,35,0.257,34,41,0.829,115,37,88,0.42,29,60,0.483,8,28,0.286,37,49,0.755,119
849,NOP,2022-03-15,115,,PHO,0,240,43,86,0.5,31,52,0.596,12,34,0.353,17,24,0.708,115,49,90,0.544,31,56,0.554,18,34,0.529,15,15,1.0,131
850,DEN,2022-03-12,115,,TOR,0,240,43,78,0.551,32,51,0.627,11,27,0.407,18,24,0.75,115,48,102,0.471,36,71,0.507,12,31,0.387,19,25,0.76,127
851,ATL,2022-03-09,115,@,MIL,0,240,43,86,0.5,32,48,0.667,11,38,0.289,18,22,0.818,115,47,94,0.5,35,59,0.593,12,35,0.343,18,23,0.783,124
852,BOS,2022-03-09,115,@,CHO,1,240,46,93,0.495,34,56,0.607,12,37,0.324,11,14,0.786,115,36,85,0.424,28,52,0.538,8,33,0.242,21,28,0.75,101
853,LAC,2022-03-09,115,,WAS,1,240,43,86,0.5,27,54,0.5,16,32,0.5,13,13,1.0,115,41,87,0.471,31,60,0.517,10,27,0.37,17,20,0.85,109
854,OKC,2022-03-08,115,,MIL,0,240,42,84,0.5,26,45,0.578,16,39,0.41,15,21,0.714,115,53,100,0.53,33,60,0.55,20,40,0.5,16,20,0.8,142
855,SAC,2022-03-07,115,,NYK,0,240,39,80,0.488,28,48,0.583,11,32,0.344,26,36,0.722,115,47,92,0.511,29,50,0.58,18,42,0.429,19,23,0.826,131
856,PHO,2022-03-04,115,,NYK,1,240,38,85,0.447,21,51,0.412,17,34,0.5,22,27,0.815,115,40,86,0.465,27,57,0.474,13,29,0.448,21,30,0.7,114
857,SAC,2022-03-03,115,@,SAS,1,240,39,85,0.459,29,53,0.547,10,32,0.313,27,32,0.844,115,46,93,0.495,34,61,0.557,12,32,0.375,8,16,0.5,112
858,DEN,2022-02-26,115,,SAC,1,240,38,82,0.463,22,39,0.564,16,43,0.372,23,29,0.793,115,38,89,0.427,29,59,0.492,9,30,0.3,25,33,0.758,110
859,MIA,2022-02-25,115,@,NYK,1,240,39,83,0.47,28,51,0.549,11,32,0.344,26,35,0.743,115,30,75,0.4,16,35,0.457,14,40,0.35,26,36,0.722,100
860,LAL,2022-02-12,115,@,GSW,0,240,41,88,0.466,30,61,0.492,11,27,0.407,22,33,0.667,115,40,90,0.444,28,52,0.538,12,38,0.316,25,34,0.735,117
861,MIA,2022-02-12,115,,BRK,1,240,41,82,0.5,31,53,0.585,10,29,0.345,23,29,0.793,115,42,93,0.452,30,53,0.566,12,40,0.3,15,22,0.682,111
862,NYK,2022-02-08,115,@,DEN,0,240,45,101,0.446,30,58,0.517,15,43,0.349,10,12,0.833,115,46,85,0.541,30,46,0.652,16,39,0.41,24,31,0.774,132
863,ORL,2022-02-05,115,,MEM,0,240,39,90,0.433,22,42,0.524,17,48,0.354,20,29,0.69,115,53,105,0.505,40,66,0.606,13,39,0.333,16,22,0.727,135
864,NYK,2022-02-05,115,@,LAL,0,265,39,98,0.398,28,60,0.467,11,38,0.289,26,36,0.722,115,48,102,0.471,39,68,0.574,9,34,0.265,17,28,0.607,122
865,IND,2022-02-04,115,,CHI,0,240,47,95,0.495,35,68,0.515,12,27,0.444,9,9,1.0,115,49,90,0.544,43,64,0.672,6,26,0.231,18,23,0.783,122
866,PHO,2022-02-03,115,@,ATL,0,240,46,88,0.523,37,56,0.661,9,32,0.281,14,18,0.778,115,44,84,0.524,24,44,0.545,20,40,0.5,16,22,0.727,124
867,HOU,2022-02-02,115,,CLE,1,240,39,82,0.476,25,42,0.595,14,40,0.35,23,33,0.697,115,41,80,0.513,34,59,0.576,7,21,0.333,15,27,0.556,104
868,ORL,2022-02-01,115,@,CHI,0,240,46,93,0.495,32,54,0.593,14,39,0.359,9,11,0.818,115,46,90,0.511,35,60,0.583,11,30,0.367,23,29,0.793,126
869,DEN,2022-02-01,115,@,MIN,0,240,38,89,0.427,24,45,0.533,14,44,0.318,25,28,0.893,115,46,93,0.495,27,48,0.563,19,45,0.422,19,25,0.76,130
870,LAC,2022-01-30,115,@,CHO,1,240,44,84,0.524,33,56,0.589,11,28,0.393,16,19,0.842,115,32,98,0.327,24,64,0.375,8,34,0.235,18,27,0.667,90
871,DET,2022-01-30,115,,CLE,1,240,42,91,0.462,32,65,0.492,10,26,0.385,21,25,0.84,115,38,82,0.463,25,48,0.521,13,34,0.382,16,25,0.64,105
872,PHO,2022-01-30,115,,SAS,1,240,48,97,0.495,37,65,0.569,11,32,0.344,8,12,0.667,115,45,100,0.45,32,63,0.508,13,37,0.351,7,8,0.875,110
873,MEM,2022-01-29,115,,WAS,1,240,46,100,0.46,33,69,0.478,13,31,0.419,10,12,0.833,115,35,84,0.417,25,55,0.455,10,29,0.345,15,21,0.714,95
874,MIN,2022-01-27,115,@,GSW,0,240,42,95,0.442,32,51,0.627,10,44,0.227,21,27,0.778,115,44,82,0.537,23,46,0.5,21,36,0.583,15,21,0.714,124
875,CLE,2022-01-26,115,,MIL,1,240,41,87,0.471,22,45,0.489,19,42,0.452,14,17,0.824,115,37,80,0.463,28,48,0.583,9,32,0.281,16,18,0.889,99
876,WAS,2022-01-25,115,,LAC,0,240,37,80,0.463,28,53,0.528,9,27,0.333,32,40,0.8,115,39,94,0.415,28,65,0.431,11,29,0.379,27,31,0.871,116
877,PHO,2022-01-24,115,,UTA,1,240,47,99,0.475,34,63,0.54,13,36,0.361,8,15,0.533,115,40,81,0.494,26,50,0.52,14,31,0.452,15,22,0.682,109
878,PHI,2022-01-23,115,@,SAS,1,240,44,92,0.478,37,76,0.487,7,16,0.438,20,23,0.87,115,42,89,0.472,32,59,0.542,10,30,0.333,15,22,0.682,109
879,POR,2022-01-15,115,@,WAS,1,240,39,85,0.459,26,46,0.565,13,39,0.333,24,35,0.686,115,39,90,0.433,27,53,0.509,12,37,0.324,20,23,0.87,110
880,MIA,2022-01-12,115,@,ATL,1,240,43,90,0.478,27,45,0.6,16,45,0.356,13,14,0.929,115,31,82,0.378,18,37,0.486,13,45,0.289,16,23,0.696,91
881,UTA,2022-01-05,115,@,DEN,1,240,43,92,0.467,29,51,0.569,14,41,0.341,15,18,0.833,115,42,88,0.477,31,52,0.596,11,36,0.306,14,15,0.933,109
882,MIA,2022-01-05,115,@,POR,1,240,37,82,0.451,18,41,0.439,19,41,0.463,22,29,0.759,115,33,78,0.423,18,40,0.45,15,38,0.395,28,36,0.778,109
883,UTA,2022-01-03,115,@,NOP,1,240,41,85,0.482,22,46,0.478,19,39,0.487,14,17,0.824,115,39,97,0.402,27,51,0.529,12,46,0.261,14,22,0.636,104
884,DET,2022-01-03,115,@,MIL,1,240,44,91,0.484,26,48,0.542,18,43,0.419,9,14,0.643,115,39,92,0.424,28,46,0.609,11,46,0.239,17,22,0.773,106
885,GSW,2022-01-03,115,,MIA,1,240,45,92,0.489,31,54,0.574,14,38,0.368,11,13,0.846,115,37,90,0.411,20,48,0.417,17,42,0.405,17,19,0.895,108
886,SAC,2022-01-02,115,,MIA,1,240,40,78,0.513,27,44,0.614,13,34,0.382,22,27,0.815,115,46,105,0.438,37,72,0.514,9,33,0.273,12,12,1.0,113
887,PHO,2021-12-29,115,,OKC,1,240,41,89,0.461,29,55,0.527,12,34,0.353,21,28,0.75,115,38,96,0.396,31,61,0.508,7,35,0.2,14,16,0.875,97
888,LAL,2021-12-25,115,,BRK,0,240,40,96,0.417,30,61,0.492,10,35,0.286,25,28,0.893,115,43,89,0.483,29,57,0.509,14,32,0.438,22,27,0.815,122
889,MIA,2021-12-23,115,,DET,1,240,43,88,0.489,31,56,0.554,12,32,0.375,17,19,0.895,115,36,80,0.45,18,40,0.45,18,40,0.45,22,25,0.88,112
890,CHO,2021-12-23,115,@,DEN,1,240,39,94,0.415,23,47,0.489,16,47,0.34,21,24,0.875,115,40,96,0.417,26,56,0.464,14,40,0.35,13,17,0.765,107
891,CHI,2021-12-19,115,,LAL,1,240,40,93,0.43,30,63,0.476,10,30,0.333,25,31,0.806,115,42,82,0.512,30,48,0.625,12,34,0.353,14,22,0.636,110
892,MIA,2021-12-17,115,@,ORL,1,240,41,82,0.5,22,47,0.468,19,35,0.543,14,19,0.737,115,43,89,0.483,32,57,0.561,11,32,0.344,8,10,0.8,105
893,ATL,2021-12-17,115,,DEN,0,240,41,88,0.466,34,64,0.531,7,24,0.292,26,34,0.765,115,50,86,0.581,33,48,0.688,17,38,0.447,16,18,0.889,133
894,SAS,2021-12-15,115,,CHO,0,240,39,90,0.433,27,53,0.509,12,37,0.324,25,25,1.0,115,51,86,0.593,33,52,0.635,18,34,0.529,11,16,0.688,131
895,CLE,2021-12-08,115,,CHI,1,240,44,80,0.55,31,52,0.596,13,28,0.464,14,16,0.875,115,35,84,0.417,28,58,0.483,7,26,0.269,15,21,0.714,92
896,LAL,2021-12-03,115,,LAC,0,240,45,90,0.5,33,57,0.579,12,33,0.364,13,21,0.619,115,41,81,0.506,25,46,0.543,16,35,0.457,21,24,0.875,119
897,NYK,2021-12-02,115,,CHI,0,240,42,82,0.512,33,56,0.589,9,26,0.346,22,27,0.815,115,44,89,0.494,33,60,0.55,11,29,0.379,20,21,0.952,119
898,LAC,2021-12-01,115,,SAC,0,240,47,100,0.47,38,69,0.551,9,31,0.29,12,16,0.75,115,46,88,0.523,31,50,0.62,15,38,0.395,17,20,0.85,124
899,WAS,2021-12-01,115,,MIN,1,240,45,91,0.495,35,59,0.593,10,32,0.313,15,21,0.714,115,37,88,0.42,26,51,0.51,11,37,0.297,22,26,0.846,107
900,MIN,2021-11-26,115,@,CHO,0,240,45,100,0.45,34,65,0.523,11,35,0.314,14,19,0.737,115,49,88,0.557,26,48,0.542,23,40,0.575,12,15,0.8,133
901,CLE,2021-11-24,115,,PHO,0,240,43,97,0.443,31,58,0.534,12,39,0.308,17,25,0.68,115,45,86,0.523,37,64,0.578,8,22,0.364,22,28,0.786,120
902,PHO,2021-11-22,115,@,SAS,1,240,45,88,0.511,33,61,0.541,12,27,0.444,13,16,0.813,115,49,93,0.527,44,73,0.603,5,20,0.25,8,16,0.5,111
903,ATL,2021-11-20,115,,CHO,1,240,43,82,0.524,31,48,0.646,12,34,0.353,17,21,0.81,115,43,102,0.422,33,62,0.532,10,40,0.25,9,15,0.6,105
904,BRK,2021-11-19,115,,ORL,1,240,41,91,0.451,31,58,0.534,10,33,0.303,23,25,0.92,115,40,89,0.449,26,51,0.51,14,38,0.368,19,25,0.76,113
905,MIN,2021-11-18,115,,SAS,1,240,41,86,0.477,20,37,0.541,21,49,0.429,12,15,0.8,115,35,84,0.417,29,52,0.558,6,32,0.188,14,19,0.737,90
906,PHO,2021-11-14,115,@,HOU,1,240,42,97,0.433,28,57,0.491,14,40,0.35,17,20,0.85,115,35,85,0.412,28,53,0.528,7,32,0.219,12,18,0.667,89
907,TOR,2021-11-11,115,@,PHI,1,240,42,96,0.438,28,63,0.444,14,33,0.424,17,17,1.0,115,40,88,0.455,29,54,0.537,11,34,0.324,18,19,0.947,109
908,UTA,2021-11-06,115,@,MIA,0,240,43,83,0.518,28,38,0.737,15,45,0.333,14,19,0.737,115,47,78,0.603,36,57,0.632,11,21,0.524,13,17,0.765,118
909,WAS,2021-11-05,115,,MEM,1,240,49,84,0.583,39,59,0.661,10,25,0.4,7,13,0.538,115,34,96,0.354,28,65,0.431,6,31,0.194,13,17,0.765,87
910,MIN,2021-11-03,115,,LAC,0,240,43,94,0.457,29,54,0.537,14,40,0.35,15,16,0.938,115,47,78,0.603,26,42,0.619,21,36,0.583,11,12,0.917,126
911,ORL,2021-11-01,115,@,MIN,1,240,37,82,0.451,20,39,0.513,17,43,0.395,24,30,0.8,115,36,97,0.371,22,46,0.478,14,51,0.275,11,19,0.579,97
912,WAS,2021-10-30,115,,BOS,1,290,38,104,0.365,28,68,0.412,10,36,0.278,29,36,0.806,115,44,107,0.411,42,81,0.519,2,26,0.077,22,25,0.88,112
913,LAL,2021-10-27,115,@,OKC,0,240,46,92,0.5,35,57,0.614,11,35,0.314,12,14,0.857,115,43,86,0.5,28,49,0.571,15,37,0.405,22,29,0.759,123
914,PHI,2021-10-24,115,@,OKC,1,240,41,88,0.466,24,47,0.511,17,41,0.415,16,20,0.8,115,40,84,0.476,32,53,0.604,8,31,0.258,15,19,0.789,103
915,TOR,2021-10-22,115,@,BOS,1,240,42,100,0.42,32,65,0.492,10,35,0.286,21,21,1.0,115,32,82,0.39,21,48,0.438,11,34,0.324,8,11,0.727,83
916,PHO,2021-10-22,115,@,LAL,1,240,42,86,0.488,32,54,0.593,10,32,0.313,21,28,0.75,115,34,86,0.395,19,52,0.365,15,34,0.441,22,29,0.759,105
917,GSW,2021-10-21,115,,LAC,1,240,43,83,0.518,28,52,0.538,15,31,0.484,14,22,0.636,115,42,96,0.438,28,56,0.5,14,40,0.35,15,21,0.714,113
918,HOU,2022-04-10,114,,ATL,0,240,41,89,0.461,24,43,0.558,17,46,0.37,15,20,0.75,114,45,87,0.517,24,49,0.49,21,38,0.553,19,24,0.792,130
919,NOP,2022-04-09,114,@,MEM,0,240,41,91,0.451,35,61,0.574,6,30,0.2,26,35,0.743,114,53,90,0.589,35,55,0.636,18,35,0.514,17,23,0.739,141
920,NYK,2022-04-08,114,@,WAS,1,240,41,88,0.466,25,49,0.51,16,39,0.41,16,20,0.8,114,35,69,0.507,26,41,0.634,9,28,0.321,13,17,0.765,92
921,PHI,2022-04-07,114,@,TOR,0,240,37,75,0.493,18,39,0.462,19,36,0.528,21,25,0.84,114,45,91,0.495,30,58,0.517,15,33,0.455,14,18,0.778,119
922,MIN,2022-04-05,114,,WAS,0,240,41,91,0.451,27,50,0.54,14,41,0.341,18,25,0.72,114,56,101,0.554,43,71,0.606,13,30,0.433,7,14,0.5,132
923,MIA,2022-04-03,114,@,TOR,1,240,41,79,0.519,23,41,0.561,18,38,0.474,14,22,0.636,114,35,83,0.422,23,44,0.523,12,39,0.308,27,34,0.794,109
924,CHO,2022-04-02,114,@,PHI,0,240,42,87,0.483,31,57,0.544,11,30,0.367,19,24,0.792,114,53,87,0.609,32,44,0.727,21,43,0.488,17,21,0.81,144
925,PHO,2022-04-01,114,@,MEM,0,240,47,86,0.547,37,59,0.627,10,27,0.37,10,17,0.588,114,46,102,0.451,39,78,0.5,7,24,0.292,23,28,0.821,122
926,NOP,2022-04-01,114,@,LAL,1,240,41,79,0.519,34,53,0.642,7,26,0.269,25,29,0.862,114,39,82,0.476,28,55,0.509,11,27,0.407,22,31,0.71,111
927,NYK,2022-03-30,114,,CHO,0,240,40,85,0.471,24,41,0.585,16,44,0.364,18,26,0.692,114,49,90,0.544,37,55,0.673,12,35,0.343,15,17,0.882,125
928,DAL,2022-03-27,114,,UTA,1,240,40,77,0.519,23,43,0.535,17,34,0.5,17,24,0.708,114,41,89,0.461,29,55,0.527,12,34,0.353,6,10,0.6,100
929,PHO,2022-03-27,114,,PHI,1,240,45,87,0.517,32,60,0.533,13,27,0.481,11,17,0.647,114,37,89,0.416,27,53,0.509,10,36,0.278,20,26,0.769,104
930,SAC,2022-03-26,114,@,ORL,1,265,42,98,0.429,31,62,0.5,11,36,0.306,19,24,0.792,114,45,106,0.425,32,70,0.457,13,36,0.361,7,7,1.0,110
931,MIL,2022-03-24,114,,WAS,1,240,42,81,0.519,26,46,0.565,16,35,0.457,14,16,0.875,114,43,92,0.467,32,54,0.593,11,38,0.289,5,9,0.556,102
932,BRK,2022-03-21,114,,UTA,1,240,45,83,0.542,34,53,0.642,11,30,0.367,13,15,0.867,114,37,83,0.446,23,44,0.523,14,39,0.359,18,22,0.818,106
933,CLE,2022-03-16,114,,PHI,0,240,39,80,0.488,30,52,0.577,9,28,0.321,27,32,0.844,114,41,79,0.519,29,47,0.617,12,32,0.375,24,28,0.857,118
934,DEN,2022-03-14,114,@,PHI,1,240,44,82,0.537,31,49,0.633,13,33,0.394,13,20,0.65,114,36,84,0.429,24,51,0.471,12,33,0.364,26,32,0.813,110
935,TOR,2022-03-14,114,@,LAL,1,240,39,96,0.406,29,59,0.492,10,37,0.27,26,36,0.722,114,34,87,0.391,21,45,0.467,13,42,0.31,22,29,0.759,103
936,ORL,2022-03-13,114,,PHI,0,265,41,91,0.451,23,48,0.479,18,43,0.419,14,20,0.7,114,35,92,0.38,21,55,0.382,14,37,0.378,32,37,0.865,116
937,BOS,2022-03-11,114,,DET,1,240,42,90,0.467,36,58,0.621,6,32,0.188,24,30,0.8,114,35,83,0.422,25,49,0.51,10,34,0.294,23,24,0.958,103
938,NYK,2022-03-11,114,@,MEM,0,240,38,90,0.422,28,65,0.431,10,25,0.4,28,37,0.757,114,46,104,0.442,37,78,0.474,9,26,0.346,17,29,0.586,118
939,CHI,2022-03-09,114,@,DET,1,240,40,76,0.526,37,61,0.607,3,15,0.2,31,35,0.886,114,42,82,0.512,31,51,0.608,11,31,0.355,13,17,0.765,108
940,DAL,2022-03-05,114,,SAC,1,240,40,84,0.476,26,48,0.542,14,36,0.389,20,27,0.741,114,46,94,0.489,37,69,0.536,9,25,0.36,12,18,0.667,113
941,NYK,2022-03-04,114,@,PHO,0,240,40,86,0.465,27,57,0.474,13,29,0.448,21,30,0.7,114,38,85,0.447,21,51,0.412,17,34,0.5,22,27,0.815,115
942,WAS,2022-03-04,114,,ATL,0,240,46,85,0.541,32,56,0.571,14,29,0.483,8,9,0.889,114,38,91,0.418,25,55,0.455,13,36,0.361,28,34,0.824,117
943,ORL,2022-03-02,114,,IND,0,265,44,97,0.454,34,65,0.523,10,32,0.313,16,20,0.8,114,41,94,0.436,29,57,0.509,12,37,0.324,28,35,0.8,122
944,GSW,2022-03-01,114,@,MIN,0,240,41,90,0.456,28,45,0.622,13,45,0.289,19,22,0.864,114,47,89,0.528,31,49,0.633,16,40,0.4,19,23,0.826,129
945,PHO,2022-02-27,114,,UTA,0,240,44,86,0.512,31,58,0.534,13,28,0.464,13,16,0.813,114,44,94,0.468,27,54,0.5,17,40,0.425,13,20,0.65,118
946,UTA,2022-02-25,114,,DAL,1,240,40,74,0.541,24,36,0.667,16,38,0.421,18,22,0.818,114,42,88,0.477,25,49,0.51,17,39,0.436,8,8,1.0,109
947,MEM,2022-02-24,114,@,MIN,0,240,38,98,0.388,29,67,0.433,9,31,0.29,29,40,0.725,114,43,93,0.462,27,51,0.529,16,42,0.381,17,25,0.68,119
948,SAS,2022-02-16,114,@,OKC,1,240,43,98,0.439,33,64,0.516,10,34,0.294,18,22,0.818,114,41,105,0.39,30,73,0.411,11,32,0.344,13,19,0.684,106
949,NOP,2022-02-12,114,,SAS,0,240,43,87,0.494,32,55,0.582,11,32,0.344,17,20,0.85,114,47,93,0.505,33,56,0.589,14,37,0.378,16,19,0.842,124
950,UTA,2022-02-11,114,,ORL,1,240,40,89,0.449,27,48,0.563,13,41,0.317,21,24,0.875,114,37,84,0.44,24,49,0.49,13,35,0.371,12,16,0.75,99
951,GSW,2022-02-10,114,,NYK,0,240,42,91,0.462,27,46,0.587,15,45,0.333,15,17,0.882,114,39,90,0.433,25,54,0.463,14,36,0.389,24,33,0.727,116
952,SAC,2022-02-08,114,,MIN,0,240,41,83,0.494,32,58,0.552,9,25,0.36,23,26,0.885,114,50,104,0.481,28,60,0.467,22,44,0.5,12,17,0.706,134
953,PHO,2022-02-08,114,@,PHI,1,240,43,95,0.453,37,69,0.536,6,26,0.231,22,24,0.917,114,41,89,0.461,31,57,0.544,10,32,0.313,17,18,0.944,109
954,ATL,2022-02-04,114,@,TOR,0,240,43,93,0.462,34,64,0.531,9,29,0.31,19,21,0.905,114,46,81,0.568,29,54,0.537,17,27,0.63,16,18,0.889,125
955,SAC,2022-02-03,114,@,GSW,0,240,42,80,0.525,31,49,0.633,11,31,0.355,19,23,0.826,114,47,84,0.56,27,42,0.643,20,42,0.476,12,16,0.75,126
956,DAL,2022-02-02,114,,OKC,0,265,46,98,0.469,32,55,0.582,14,43,0.326,8,10,0.8,114,41,86,0.477,24,49,0.49,17,37,0.459,21,25,0.84,120
957,LAL,2022-01-28,114,@,CHO,0,240,38,91,0.418,23,51,0.451,15,40,0.375,23,32,0.719,114,43,83,0.518,32,47,0.681,11,36,0.306,20,28,0.714,117
958,LAC,2022-01-28,114,@,MIA,0,240,41,92,0.446,32,57,0.561,9,35,0.257,23,32,0.719,114,40,85,0.471,25,51,0.49,15,34,0.441,26,27,0.963,121
959,ORL,2022-01-23,114,,CHI,1,240,42,80,0.525,30,54,0.556,12,26,0.462,18,23,0.783,114,33,76,0.434,28,55,0.509,5,21,0.238,24,32,0.75,95
960,POR,2022-01-23,114,@,TOR,1,240,45,85,0.529,27,53,0.509,18,32,0.563,6,13,0.462,114,39,98,0.398,21,44,0.477,18,54,0.333,9,14,0.643,105
961,MEM,2022-01-19,114,@,MIL,0,240,44,106,0.415,35,66,0.53,9,40,0.225,17,25,0.68,114,46,97,0.474,33,60,0.55,13,37,0.351,21,22,0.955,126
962,CLE,2022-01-17,114,,BRK,1,240,42,81,0.519,31,49,0.633,11,32,0.344,19,21,0.905,114,41,83,0.494,29,53,0.547,12,30,0.4,13,18,0.722,107
963,MIL,2022-01-17,114,@,ATL,0,240,39,88,0.443,23,50,0.46,16,38,0.421,20,24,0.833,114,38,86,0.442,23,50,0.46,15,36,0.417,30,32,0.938,121
964,BOS,2022-01-15,114,,CHI,1,240,44,90,0.489,35,64,0.547,9,26,0.346,17,19,0.895,114,44,87,0.506,32,58,0.552,12,29,0.414,12,15,0.8,112
965,HOU,2022-01-14,114,@,SAC,0,240,44,101,0.436,31,58,0.534,13,43,0.302,13,16,0.813,114,48,96,0.5,35,59,0.593,13,37,0.351,17,24,0.708,126
966,CLE,2022-01-14,114,@,SAS,1,240,46,95,0.484,38,75,0.507,8,20,0.4,14,24,0.583,114,42,92,0.457,27,58,0.466,15,34,0.441,10,13,0.769,109
967,POR,2022-01-10,114,,BRK,1,240,40,86,0.465,25,48,0.521,15,38,0.395,19,26,0.731,114,42,91,0.462,30,59,0.508,12,32,0.375,12,15,0.8,108
968,CHO,2022-01-08,114,,MIL,1,240,44,99,0.444,28,51,0.549,16,48,0.333,10,17,0.588,114,35,90,0.389,23,53,0.434,12,37,0.324,24,26,0.923,106
969,CLE,2022-01-07,114,@,POR,1,240,39,80,0.488,22,41,0.537,17,39,0.436,19,29,0.655,114,37,92,0.402,21,57,0.368,16,35,0.457,11,19,0.579,101
970,HOU,2022-01-05,114,@,WAS,1,240,40,85,0.471,31,59,0.525,9,26,0.346,25,32,0.781,114,40,91,0.44,30,52,0.577,10,39,0.256,21,26,0.808,111
971,SAC,2022-01-04,114,@,LAL,0,240,43,83,0.518,29,49,0.592,14,34,0.412,14,18,0.778,114,49,99,0.495,38,67,0.567,11,32,0.344,13,20,0.65,122
972,PHI,2021-12-28,114,@,TOR,1,240,34,77,0.442,20,47,0.426,14,30,0.467,32,38,0.842,114,38,87,0.437,23,46,0.5,15,41,0.366,18,22,0.818,109
973,MEM,2021-12-27,114,@,PHO,1,240,45,88,0.511,34,59,0.576,11,29,0.379,13,17,0.765,114,41,90,0.456,30,59,0.508,11,31,0.355,20,23,0.87,113
974,DAL,2021-12-21,114,,MIN,1,240,42,86,0.488,31,52,0.596,11,34,0.324,19,23,0.826,114,36,79,0.456,23,39,0.59,13,40,0.325,17,20,0.85,102
975,SAS,2021-12-19,114,@,SAC,0,240,45,91,0.495,33,66,0.5,12,25,0.48,12,13,0.923,114,46,91,0.505,32,66,0.485,14,25,0.56,15,18,0.833,121
976,BOS,2021-12-18,114,,NYK,1,240,42,89,0.472,25,44,0.568,17,45,0.378,13,17,0.765,114,35,80,0.438,22,44,0.5,13,36,0.361,24,30,0.8,107
977,BRK,2021-12-16,114,,PHI,1,240,44,89,0.494,33,66,0.5,11,23,0.478,15,16,0.938,114,39,89,0.438,29,55,0.527,10,34,0.294,17,20,0.85,105
978,MIL,2021-12-15,114,,IND,1,240,44,90,0.489,30,61,0.492,14,29,0.483,12,15,0.8,114,39,83,0.47,28,45,0.622,11,38,0.289,10,11,0.909,99
979,HOU,2021-12-10,114,,MIL,0,240,42,89,0.472,23,43,0.535,19,46,0.413,11,20,0.55,114,42,83,0.506,27,44,0.614,15,39,0.385,24,32,0.75,123
980,LAC,2021-12-08,114,,BOS,1,240,40,85,0.471,26,53,0.491,14,32,0.438,20,22,0.909,114,41,86,0.477,31,54,0.574,10,32,0.313,19,21,0.905,111
981,HOU,2021-12-08,114,,BRK,1,240,40,81,0.494,26,40,0.65,14,41,0.341,20,29,0.69,114,35,89,0.393,27,56,0.482,8,33,0.242,26,31,0.839,104
982,NOP,2021-12-08,114,,DEN,0,265,47,90,0.522,36,60,0.6,11,30,0.367,9,12,0.75,114,45,88,0.511,36,56,0.643,9,32,0.281,21,27,0.778,120
983,OKC,2021-12-06,114,@,DET,1,240,41,82,0.5,32,57,0.561,9,25,0.36,23,30,0.767,114,41,99,0.414,25,58,0.431,16,41,0.39,5,6,0.833,103
984,PHO,2021-12-02,114,,DET,1,240,43,79,0.544,31,58,0.534,12,21,0.571,16,23,0.696,114,36,80,0.45,25,53,0.472,11,27,0.407,20,26,0.769,103
985,SAS,2021-12-02,114,@,POR,1,240,44,91,0.484,30,55,0.545,14,36,0.389,12,16,0.75,114,29,82,0.354,17,48,0.354,12,34,0.353,13,17,0.765,83
986,HOU,2021-12-01,114,@,OKC,1,240,40,79,0.506,25,42,0.595,15,37,0.405,19,22,0.864,114,40,85,0.471,32,53,0.604,8,32,0.25,22,29,0.759,110
987,ATL,2021-12-01,114,@,IND,1,240,44,86,0.512,28,53,0.528,16,33,0.485,10,12,0.833,114,44,90,0.489,34,57,0.596,10,33,0.303,13,16,0.813,111
988,CLE,2021-11-29,114,@,DAL,1,240,45,80,0.563,35,61,0.574,10,19,0.526,14,18,0.778,114,39,89,0.438,27,50,0.54,12,39,0.308,6,15,0.4,96
989,DAL,2021-11-27,114,,WAS,0,240,42,89,0.472,28,51,0.549,14,38,0.368,16,22,0.727,114,45,78,0.577,36,54,0.667,9,24,0.375,21,26,0.808,120
990,IND,2021-11-26,114,,TOR,1,240,47,97,0.485,36,58,0.621,11,39,0.282,9,11,0.818,114,37,89,0.416,30,59,0.508,7,30,0.233,16,22,0.727,97
991,MIL,2021-11-24,114,,DET,1,240,42,87,0.483,27,51,0.529,15,36,0.417,15,17,0.882,114,34,95,0.358,23,50,0.46,11,45,0.244,14,19,0.737,93
992,CHI,2021-11-19,114,@,DEN,1,240,41,93,0.441,33,62,0.532,8,31,0.258,24,24,1.0,114,39,82,0.476,25,45,0.556,14,37,0.378,16,20,0.8,108
993,LAL,2021-11-14,114,,SAS,1,240,43,83,0.518,28,52,0.538,15,31,0.484,13,17,0.765,114,40,90,0.444,24,54,0.444,16,36,0.444,10,15,0.667,106
994,PHI,2021-11-06,114,@,CHI,1,240,43,81,0.531,30,55,0.545,13,26,0.5,15,19,0.789,114,37,92,0.402,30,63,0.476,7,29,0.241,24,30,0.8,105
995,GSW,2021-11-03,114,,CHO,1,240,42,86,0.488,24,41,0.585,18,45,0.4,12,18,0.667,114,34,91,0.374,24,55,0.436,10,36,0.278,14,19,0.737,92
996,BOS,2021-11-01,114,,CHI,0,240,42,96,0.438,27,63,0.429,15,33,0.455,15,20,0.75,114,49,86,0.57,36,55,0.655,13,31,0.419,17,18,0.944,128
997,MIA,2021-10-29,114,,CHO,1,240,43,91,0.473,34,56,0.607,9,35,0.257,19,19,1.0,114,35,90,0.389,22,53,0.415,13,37,0.351,16,22,0.727,99
998,LAC,2021-10-23,114,,MEM,0,240,43,99,0.434,30,60,0.5,13,39,0.333,15,17,0.882,114,42,90,0.467,27,54,0.5,15,36,0.417,21,25,0.84,120
999,BRK,2021-10-22,114,@,PHI,1,240,41,88,0.466,29,50,0.58,12,38,0.316,20,24,0.833,114,43,91,0.473,29,55,0.527,14,36,0.389,9,11,0.818,109
1000,LAL,2021-10-19,114,,GSW,0,240,45,95,0.474,30,53,0.566,15,42,0.357,9,19,0.474,114,41,93,0.441,27,54,0.5,14,39,0.359,25,30,0.833,121
1001,MIA,2022-04-08,113,,ATL,1,240,40,72,0.556,29,46,0.63,11,26,0.423,22,28,0.786,113,42,88,0.477,34,54,0.63,8,34,0.235,17,19,0.895,109
1002,LAC,2022-04-06,113,,PHO,1,240,33,75,0.44,21,41,0.512,12,34,0.353,35,44,0.795,113,42,108,0.389,25,60,0.417,17,48,0.354,8,12,0.667,109
1003,DET,2022-04-06,113,,DAL,0,240,35,82,0.427,24,52,0.462,11,30,0.367,32,35,0.914,113,45,80,0.563,30,47,0.638,15,33,0.455,26,34,0.765,131
1004,SAS,2022-04-03,113,,POR,1,240,38,84,0.452,24,42,0.571,14,42,0.333,23,30,0.767,113,33,84,0.393,17,39,0.436,16,45,0.356,10,15,0.667,92
1005,DEN,2022-03-28,113,@,CHO,1,240,40,86,0.465,28,53,0.528,12,33,0.364,21,28,0.75,113,44,93,0.473,31,51,0.608,13,42,0.31,8,12,0.667,109
1006,DEN,2022-03-26,113,,OKC,1,240,41,85,0.482,33,54,0.611,8,31,0.258,23,24,0.958,113,39,84,0.464,25,48,0.521,14,36,0.389,15,16,0.938,107
1007,PHI,2022-03-21,113,,MIA,1,240,43,86,0.5,28,49,0.571,15,37,0.405,12,16,0.75,113,38,80,0.475,28,47,0.596,10,33,0.303,20,20,1.0,106
1008,CHI,2022-03-21,113,,TOR,1,240,44,90,0.489,33,62,0.532,11,28,0.393,14,24,0.583,113,40,91,0.44,34,59,0.576,6,32,0.188,13,15,0.867,99
1009,CLE,2022-03-19,113,,DET,1,240,45,88,0.511,35,62,0.565,10,26,0.385,13,23,0.565,113,41,85,0.482,28,55,0.509,13,30,0.433,14,19,0.737,109
1010,DAL,2022-03-16,113,@,BRK,1,240,41,83,0.494,29,49,0.592,12,34,0.353,19,19,1.0,113,45,91,0.495,36,65,0.554,9,26,0.346,12,15,0.8,111
1011,POR,2022-03-14,113,@,ATL,0,240,44,88,0.5,34,64,0.531,10,24,0.417,15,21,0.714,113,40,109,0.367,28,61,0.459,12,48,0.25,30,32,0.938,122
1012,MIN,2022-03-12,113,@,MIA,1,240,35,83,0.422,20,41,0.488,15,42,0.357,28,32,0.875,113,35,88,0.398,20,43,0.465,15,45,0.333,19,25,0.76,104
1013,DAL,2022-03-11,113,@,HOU,1,240,40,88,0.455,29,52,0.558,11,36,0.306,22,28,0.786,113,41,86,0.477,35,56,0.625,6,30,0.2,12,19,0.632,100
1014,GSW,2022-03-10,113,@,DEN,1,240,42,88,0.477,28,46,0.609,14,42,0.333,15,20,0.75,113,35,84,0.417,28,53,0.528,7,31,0.226,25,32,0.781,102
1015,DET,2022-03-07,113,,ATL,1,265,43,93,0.462,31,60,0.517,12,33,0.364,15,23,0.652,113,42,93,0.452,31,55,0.564,11,38,0.289,15,22,0.682,110
1016,SAC,2022-03-05,113,@,DAL,0,240,46,94,0.489,37,69,0.536,9,25,0.36,12,18,0.667,113,40,84,0.476,26,48,0.542,14,36,0.389,20,27,0.741,114
1017,GSW,2022-03-03,113,@,DAL,0,240,44,81,0.543,29,51,0.569,15,30,0.5,10,13,0.769,113,45,85,0.529,28,48,0.583,17,37,0.459,15,20,0.75,122
1018,MIA,2022-03-03,113,@,BRK,1,240,40,77,0.519,30,47,0.638,10,30,0.333,23,28,0.821,113,39,83,0.47,27,52,0.519,12,31,0.387,17,22,0.773,107
1019,DET,2022-03-01,113,@,WAS,0,240,43,90,0.478,35,63,0.556,8,27,0.296,19,23,0.826,113,41,82,0.5,28,56,0.5,13,26,0.5,21,26,0.808,116
1020,LAC,2022-03-01,113,@,HOU,1,240,42,96,0.438,29,65,0.446,13,31,0.419,16,17,0.941,113,38,96,0.396,25,57,0.439,13,39,0.333,11,17,0.647,100
1021,BOS,2022-02-26,113,@,DET,1,240,42,88,0.477,32,62,0.516,10,26,0.385,19,21,0.905,113,39,87,0.448,32,60,0.533,7,27,0.259,19,22,0.864,104
1022,IND,2022-02-16,113,,WAS,1,240,45,83,0.542,41,63,0.651,4,20,0.2,19,29,0.655,113,39,91,0.429,22,54,0.407,17,37,0.459,13,16,0.813,108
1023,IND,2022-02-11,113,,CLE,0,240,42,89,0.472,24,51,0.471,18,38,0.474,11,16,0.688,113,43,81,0.531,34,57,0.596,9,24,0.375,25,30,0.833,120
1024,WAS,2022-02-10,113,,BRK,1,240,43,85,0.506,32,54,0.593,11,31,0.355,16,18,0.889,113,39,84,0.464,29,55,0.527,10,29,0.345,24,28,0.857,112
1025,ORL,2022-02-08,113,@,POR,1,240,44,90,0.489,25,52,0.481,19,38,0.5,6,8,0.75,113,32,91,0.352,21,53,0.396,11,38,0.289,20,26,0.769,95
1026,UTA,2022-02-07,113,,NYK,1,240,39,93,0.419,27,45,0.6,12,48,0.25,23,27,0.852,113,36,95,0.379,28,62,0.452,8,33,0.242,24,35,0.686,104
1027,LAC,2022-02-06,113,,MIL,0,240,40,96,0.417,22,50,0.44,18,46,0.391,15,16,0.938,113,48,88,0.545,29,50,0.58,19,38,0.5,22,27,0.815,137
1028,SAC,2022-02-05,113,,OKC,1,240,43,83,0.518,31,51,0.608,12,32,0.375,15,22,0.682,113,42,87,0.483,33,57,0.579,9,30,0.3,10,16,0.625,103
1029,NOP,2022-02-04,113,@,DEN,1,240,42,75,0.56,34,50,0.68,8,25,0.32,21,23,0.913,113,35,78,0.449,16,37,0.432,19,41,0.463,16,17,0.941,105
1030,BOS,2022-02-02,113,,CHO,1,240,42,82,0.512,28,46,0.609,14,36,0.389,15,17,0.882,113,37,87,0.425,25,47,0.532,12,40,0.3,21,27,0.778,107
1031,IND,2022-01-28,113,@,OKC,1,265,41,95,0.432,28,56,0.5,13,39,0.333,18,29,0.621,113,43,95,0.453,29,52,0.558,14,43,0.326,10,17,0.588,110
1032,CHO,2022-01-25,113,@,TOR,0,240,40,82,0.488,30,51,0.588,10,31,0.323,23,32,0.719,113,43,82,0.524,27,48,0.563,16,34,0.471,23,29,0.793,125
1033,IND,2022-01-24,113,@,NOP,0,240,38,87,0.437,19,41,0.463,19,46,0.413,18,25,0.72,113,41,88,0.466,35,58,0.603,6,30,0.2,29,31,0.935,117
1034,MIA,2022-01-23,113,,LAL,1,240,40,81,0.494,25,48,0.521,15,33,0.455,18,20,0.9,113,36,79,0.456,25,39,0.641,11,40,0.275,24,30,0.8,107
1035,ATL,2022-01-23,113,@,CHO,1,240,40,88,0.455,25,49,0.51,15,39,0.385,18,24,0.75,113,34,87,0.391,30,51,0.588,4,36,0.111,19,27,0.704,91
1036,PHO,2022-01-22,113,,IND,1,240,47,96,0.49,40,71,0.563,7,25,0.28,12,14,0.857,113,37,84,0.44,27,55,0.491,10,29,0.345,19,27,0.704,103
1037,NOP,2022-01-13,113,,LAC,1,240,43,97,0.443,29,58,0.5,14,39,0.359,13,16,0.813,113,31,81,0.383,21,47,0.447,10,34,0.294,17,20,0.85,89
1038,DAL,2022-01-09,113,,CHI,1,240,44,88,0.5,28,52,0.538,16,36,0.444,9,9,1.0,113,39,90,0.433,28,57,0.491,11,33,0.333,10,13,0.769,99
1039,UTA,2022-01-08,113,@,IND,0,240,40,84,0.476,25,49,0.51,15,35,0.429,18,19,0.947,113,44,80,0.55,30,51,0.588,14,29,0.483,23,32,0.719,125
1040,HOU,2022-01-03,113,@,PHI,0,240,37,89,0.416,22,45,0.489,15,44,0.341,24,33,0.727,113,50,96,0.521,33,56,0.589,17,40,0.425,16,17,0.941,133
1041,MIA,2022-01-02,113,@,SAC,0,240,46,105,0.438,37,72,0.514,9,33,0.273,12,12,1.0,113,40,78,0.513,27,44,0.614,13,34,0.382,22,27,0.815,115
1042,NOP,2022-01-01,113,@,MIL,0,240,39,95,0.411,23,44,0.523,16,51,0.314,19,30,0.633,113,49,92,0.533,26,44,0.591,23,48,0.479,15,18,0.833,136
1043,PHO,2021-12-27,113,,MEM,0,240,41,90,0.456,30,59,0.508,11,31,0.355,20,23,0.87,113,45,88,0.511,34,59,0.576,11,29,0.379,13,17,0.765,114
1044,CHI,2021-12-26,113,,IND,1,240,43,76,0.566,32,53,0.604,11,23,0.478,16,22,0.727,113,41,94,0.436,33,64,0.516,8,30,0.267,15,21,0.714,105
1045,BOS,2021-12-25,113,@,MIL,0,240,38,89,0.427,21,44,0.477,17,45,0.378,20,24,0.833,113,43,91,0.473,31,58,0.534,12,33,0.364,19,27,0.704,117
1046,PHO,2021-12-23,113,,OKC,1,240,45,93,0.484,30,54,0.556,15,39,0.385,8,13,0.615,113,37,96,0.385,26,55,0.473,11,41,0.268,16,21,0.762,101
1047,GSW,2021-12-23,113,,MEM,1,240,40,82,0.488,21,42,0.5,19,40,0.475,14,18,0.778,113,38,90,0.422,30,64,0.469,8,26,0.308,20,24,0.833,104
1048,GSW,2021-12-20,113,,SAC,1,240,46,88,0.523,31,51,0.608,15,37,0.405,6,9,0.667,113,37,83,0.446,24,51,0.471,13,32,0.406,11,16,0.688,98
1049,DET,2021-12-16,113,@,IND,0,240,40,81,0.494,33,56,0.589,7,25,0.28,26,30,0.867,113,45,91,0.495,38,59,0.644,7,32,0.219,25,28,0.893,122
1050,NOP,2021-12-15,113,@,OKC,1,240,39,80,0.488,28,52,0.538,11,28,0.393,24,36,0.667,113,39,93,0.419,26,58,0.448,13,35,0.371,19,19,1.0,110
1051,MEM,2021-12-15,113,@,POR,1,240,39,82,0.476,28,50,0.56,11,32,0.344,24,30,0.8,113,31,82,0.378,16,44,0.364,15,38,0.395,26,28,0.929,103
1052,DEN,2021-12-13,113,,WAS,1,240,37,79,0.468,27,47,0.574,10,32,0.313,29,33,0.879,113,41,90,0.456,29,56,0.518,12,34,0.353,13,21,0.619,107
1053,MEM,2021-12-11,113,,HOU,1,240,40,80,0.5,29,51,0.569,11,29,0.379,22,36,0.611,113,38,77,0.494,27,44,0.614,11,33,0.333,19,29,0.655,106
1054,BRK,2021-12-10,113,@,ATL,1,240,46,93,0.495,40,70,0.571,6,23,0.261,15,16,0.938,113,37,94,0.394,26,60,0.433,11,34,0.324,20,24,0.833,105
1055,MIA,2021-12-08,113,,MIL,1,240,40,77,0.519,18,30,0.6,22,47,0.468,11,12,0.917,113,36,85,0.424,24,46,0.522,12,39,0.308,20,27,0.741,104
1056,DEN,2021-12-04,113,@,NYK,1,240,44,84,0.524,24,41,0.585,20,43,0.465,5,5,1.0,113,35,88,0.398,23,48,0.479,12,40,0.3,17,21,0.81,99
1057,MIA,2021-12-03,113,@,IND,1,240,43,81,0.531,27,47,0.574,16,34,0.471,11,13,0.846,113,35,80,0.438,26,44,0.591,9,36,0.25,25,33,0.758,104
1058,PHO,2021-11-27,113,@,BRK,1,240,41,92,0.446,28,54,0.519,13,38,0.342,18,21,0.857,113,42,84,0.5,35,61,0.574,7,23,0.304,16,21,0.762,107
1059,CHI,2021-11-24,113,@,HOU,0,240,44,96,0.458,29,61,0.475,15,35,0.429,10,12,0.833,113,42,84,0.5,25,48,0.521,17,36,0.472,17,22,0.773,118
1060,MIN,2021-11-24,113,,MIA,1,240,38,93,0.409,20,38,0.526,18,55,0.327,19,21,0.905,113,33,74,0.446,18,32,0.563,15,42,0.357,20,29,0.69,101
1061,MEM,2021-11-24,113,,TOR,0,240,42,82,0.512,33,53,0.623,9,29,0.31,20,26,0.769,113,47,89,0.528,33,59,0.559,14,30,0.467,18,21,0.857,126
1062,ATL,2021-11-22,113,,OKC,1,240,42,87,0.483,28,53,0.528,14,34,0.412,15,16,0.938,113,39,97,0.402,29,59,0.492,10,38,0.263,13,14,0.929,101
1063,ORL,2021-11-19,113,@,BRK,0,240,40,89,0.449,26,51,0.51,14,38,0.368,19,25,0.76,113,41,91,0.451,31,58,0.534,10,33,0.303,23,25,0.92,115
1064,MIA,2021-11-17,113,,NOP,1,240,42,87,0.483,27,47,0.574,15,40,0.375,14,17,0.824,113,33,75,0.44,23,40,0.575,10,35,0.286,22,28,0.786,98
1065,TOR,2021-11-15,113,@,POR,0,240,41,89,0.461,26,56,0.464,15,33,0.455,16,18,0.889,113,46,82,0.561,30,46,0.652,16,36,0.444,10,14,0.714,118
1066,PHI,2021-11-13,113,@,IND,0,240,38,89,0.427,26,66,0.394,12,23,0.522,25,29,0.862,113,47,82,0.573,33,54,0.611,14,28,0.5,10,15,0.667,118
1067,MIL,2021-11-12,113,@,BOS,0,265,44,98,0.449,28,51,0.549,16,47,0.34,9,11,0.818,113,47,96,0.49,35,55,0.636,12,41,0.293,16,18,0.889,122
1068,DEN,2021-11-08,113,,MIA,1,240,42,91,0.462,30,50,0.6,12,41,0.293,17,24,0.708,113,31,78,0.397,18,42,0.429,13,36,0.361,21,25,0.84,96
1069,ATL,2021-11-08,113,@,GSW,0,240,38,82,0.463,21,39,0.538,17,43,0.395,20,26,0.769,113,44,92,0.478,26,48,0.542,18,44,0.409,21,22,0.955,127
1070,NYK,2021-11-05,113,@,MIL,1,240,41,96,0.427,31,56,0.554,10,40,0.25,21,26,0.808,113,33,82,0.402,17,39,0.436,16,43,0.372,16,21,0.762,98
1071,SAC,2021-11-02,113,@,UTA,0,240,42,93,0.452,30,62,0.484,12,31,0.387,17,24,0.708,113,43,98,0.439,29,50,0.58,14,48,0.292,19,27,0.704,119
1072,PHI,2021-11-01,113,,POR,1,240,43,83,0.518,30,47,0.638,13,36,0.361,14,16,0.875,113,40,84,0.476,28,50,0.56,12,34,0.353,11,18,0.611,103
1073,CLE,2021-11-01,113,@,CHO,1,240,39,90,0.433,30,62,0.484,9,28,0.321,26,38,0.684,113,42,101,0.416,27,62,0.435,15,39,0.385,11,15,0.733,110
1074,TOR,2021-11-01,113,@,NYK,1,240,43,99,0.434,29,57,0.509,14,42,0.333,13,14,0.929,113,35,76,0.461,19,38,0.5,16,38,0.421,18,24,0.75,104
1075,POR,2021-10-31,113,@,CHO,0,240,43,97,0.443,26,43,0.605,17,54,0.315,10,11,0.909,113,46,89,0.517,26,47,0.553,20,42,0.476,13,21,0.619,125
1076,LAL,2021-10-29,113,,CLE,1,240,46,84,0.548,34,57,0.596,12,27,0.444,9,10,0.9,113,37,87,0.425,25,53,0.472,12,34,0.353,15,22,0.682,101
1077,SAC,2021-10-29,113,@,NOP,1,240,40,80,0.5,31,53,0.585,9,27,0.333,24,25,0.96,113,42,98,0.429,33,64,0.516,9,34,0.265,16,25,0.64,109
1078,MIN,2021-10-27,113,@,MIL,1,240,43,91,0.473,30,46,0.652,13,45,0.289,14,17,0.824,113,39,95,0.411,25,44,0.568,14,51,0.275,16,21,0.762,108
1079,ATL,2021-10-21,113,,DAL,1,240,45,94,0.479,30,59,0.508,15,35,0.429,8,9,0.889,113,31,93,0.333,18,50,0.36,13,43,0.302,12,13,0.923,87
1080,LAC,2021-10-21,113,@,GSW,0,240,42,96,0.438,28,56,0.5,14,40,0.35,15,21,0.714,113,43,83,0.518,28,52,0.538,15,31,0.484,14,22,0.636,115
1081,LAL,2022-04-07,112,@,GSW,0,240,37,83,0.446,28,51,0.549,9,32,0.281,29,38,0.763,112,51,97,0.526,35,65,0.538,16,32,0.5,10,10,1.0,128
1082,MIL,2022-04-03,112,,DAL,0,240,42,95,0.442,27,55,0.491,15,40,0.375,13,18,0.722,112,39,76,0.513,23,38,0.605,16,38,0.421,24,27,0.889,118
1083,PHI,2022-04-03,112,@,CLE,1,240,33,80,0.413,22,49,0.449,11,31,0.355,35,42,0.833,112,35,78,0.449,20,45,0.444,15,33,0.455,23,31,0.742,108
1084,CLE,2022-03-30,112,,DAL,0,240,42,83,0.506,31,58,0.534,11,25,0.44,17,22,0.773,112,46,88,0.523,30,46,0.652,16,42,0.381,12,15,0.8,120
1085,MEM,2022-03-30,112,@,SAS,1,240,44,91,0.484,28,52,0.538,16,39,0.41,8,11,0.727,112,42,83,0.506,28,48,0.583,14,35,0.4,13,16,0.813,111
1086,BOS,2022-03-28,112,@,TOR,0,265,39,95,0.411,27,55,0.491,12,40,0.3,22,28,0.786,112,46,106,0.434,36,67,0.537,10,39,0.256,13,18,0.722,115
1087,MIN,2022-03-27,112,@,BOS,0,240,45,84,0.536,31,52,0.596,14,32,0.438,8,12,0.667,112,49,87,0.563,32,48,0.667,17,39,0.436,19,21,0.905,134
1088,ATL,2022-03-20,112,,NOP,0,240,41,87,0.471,31,55,0.564,10,32,0.313,20,23,0.87,112,43,96,0.448,36,75,0.48,7,21,0.333,24,27,0.889,117
1089,HOU,2022-03-16,112,,PHO,0,240,42,85,0.494,26,46,0.565,16,39,0.41,12,19,0.632,112,53,95,0.558,40,62,0.645,13,33,0.394,10,13,0.769,129
1090,SAC,2022-03-14,112,,CHI,1,240,39,82,0.476,29,57,0.509,10,25,0.4,24,26,0.923,112,36,88,0.409,26,54,0.481,10,34,0.294,21,22,0.955,103
1091,WAS,2022-03-14,112,@,GSW,0,240,42,82,0.512,32,56,0.571,10,26,0.385,18,23,0.783,112,45,84,0.536,27,39,0.692,18,45,0.4,18,22,0.818,126
1092,PHO,2022-03-11,112,,TOR,0,240,44,88,0.5,33,52,0.635,11,36,0.306,13,17,0.765,112,42,94,0.447,28,62,0.452,14,32,0.438,19,21,0.905,117
1093,ATL,2022-03-11,112,,LAC,1,240,43,90,0.478,34,59,0.576,9,31,0.29,17,19,0.895,112,40,82,0.488,28,50,0.56,12,32,0.375,14,17,0.824,106
1094,GSW,2022-03-08,112,,LAC,1,240,44,92,0.478,31,58,0.534,13,34,0.382,11,13,0.846,112,33,93,0.355,21,54,0.389,12,39,0.308,19,23,0.826,97
1095,MEM,2022-03-06,112,@,HOU,0,240,44,97,0.454,39,71,0.549,5,26,0.192,19,27,0.704,112,43,82,0.524,30,48,0.625,13,34,0.382,24,36,0.667,123
1096,CHI,2022-03-04,112,,MIL,0,240,47,94,0.5,37,68,0.544,10,26,0.385,8,11,0.727,112,43,88,0.489,33,57,0.579,10,31,0.323,22,33,0.667,118
1097,SAS,2022-03-03,112,,SAC,0,240,46,93,0.495,34,61,0.557,12,32,0.375,8,16,0.5,112,39,85,0.459,29,53,0.547,10,32,0.313,27,32,0.844,115
1098,MIA,2022-02-28,112,,CHI,1,240,40,81,0.494,28,50,0.56,12,31,0.387,20,26,0.769,112,41,84,0.488,34,55,0.618,7,29,0.241,10,15,0.667,99
1099,CHI,2022-02-24,112,,ATL,1,240,41,84,0.488,33,57,0.579,8,27,0.296,22,27,0.815,112,41,97,0.423,33,69,0.478,8,28,0.286,18,27,0.667,108
1100,DET,2022-02-16,112,@,BOS,1,240,43,93,0.462,27,63,0.429,16,30,0.533,10,13,0.769,112,42,77,0.545,29,45,0.644,13,32,0.406,14,18,0.778,111
1101,POR,2022-02-12,112,,NYK,1,240,40,84,0.476,25,44,0.568,15,40,0.375,17,20,0.85,112,31,81,0.383,19,42,0.452,12,39,0.308,29,34,0.853,103
1102,BRK,2022-02-10,112,@,WAS,0,240,39,84,0.464,29,55,0.527,10,29,0.345,24,28,0.857,112,43,85,0.506,32,54,0.593,11,31,0.355,16,18,0.889,113
1103,DAL,2022-02-10,112,,LAC,1,240,38,78,0.487,25,39,0.641,13,39,0.333,23,27,0.852,112,39,81,0.481,30,58,0.517,9,23,0.391,18,25,0.72,105
1104,MIA,2022-02-10,112,@,NOP,1,240,39,81,0.481,29,49,0.592,10,32,0.313,24,28,0.857,112,36,85,0.424,25,44,0.568,11,41,0.268,14,16,0.875,97
1105,IND,2022-02-08,112,@,ATL,0,240,37,93,0.398,27,62,0.435,10,31,0.323,28,33,0.848,112,52,90,0.578,35,57,0.614,17,33,0.515,12,16,0.75,133
1106,MIA,2022-02-03,112,@,SAS,1,240,42,83,0.506,30,53,0.566,12,30,0.4,16,18,0.889,112,30,80,0.375,22,47,0.468,8,33,0.242,27,38,0.711,95
1107,SAC,2022-02-02,112,,BRK,1,240,41,93,0.441,27,51,0.529,14,42,0.333,16,18,0.889,112,41,84,0.488,33,59,0.559,8,25,0.32,11,14,0.786,101
1108,MIL,2022-02-01,112,,WAS,1,240,46,92,0.5,34,54,0.63,12,38,0.316,8,9,0.889,112,36,82,0.439,24,47,0.511,12,35,0.343,14,20,0.7,98
1109,POR,2022-01-26,112,,DAL,0,240,42,82,0.512,28,44,0.636,14,38,0.368,14,23,0.609,112,48,88,0.545,32,52,0.615,16,36,0.444,20,26,0.769,132
1110,MIN,2022-01-18,112,@,NYK,1,240,35,81,0.432,22,40,0.55,13,41,0.317,29,38,0.763,112,37,80,0.463,25,42,0.595,12,38,0.316,24,33,0.727,110
1111,SAC,2022-01-16,112,,HOU,0,240,41,91,0.451,29,53,0.547,12,38,0.316,18,24,0.75,112,41,76,0.539,25,36,0.694,16,40,0.4,20,24,0.833,118
1112,CHI,2022-01-15,112,@,BOS,0,240,44,87,0.506,32,58,0.552,12,29,0.414,12,15,0.8,112,44,90,0.489,35,64,0.547,9,26,0.346,17,19,0.895,114
1113,PHO,2022-01-14,112,@,IND,1,240,40,88,0.455,29,60,0.483,11,28,0.393,21,23,0.913,112,34,88,0.386,21,45,0.467,13,43,0.302,13,18,0.722,94
1114,DAL,2022-01-14,112,@,MEM,1,240,47,91,0.516,39,59,0.661,8,32,0.25,10,16,0.625,112,34,89,0.382,27,58,0.466,7,31,0.226,10,13,0.769,85
1115,WAS,2022-01-12,112,,ORL,1,240,43,82,0.524,33,51,0.647,10,31,0.323,16,21,0.762,112,41,99,0.414,30,64,0.469,11,35,0.314,13,16,0.813,106
1116,CHI,2022-01-12,112,,BRK,0,240,38,81,0.469,27,51,0.529,11,30,0.367,25,31,0.806,112,49,87,0.563,32,55,0.582,17,32,0.531,23,28,0.821,138
1117,DAL,2021-12-31,112,@,SAC,1,240,42,81,0.519,33,59,0.559,9,22,0.409,19,22,0.864,112,38,91,0.418,28,62,0.452,10,29,0.345,10,12,0.833,96
1118,WAS,2021-12-28,112,@,MIA,0,240,42,85,0.494,25,43,0.581,17,42,0.405,11,14,0.786,112,41,92,0.446,25,58,0.431,16,34,0.471,21,23,0.913,119
1119,NOP,2021-12-26,112,@,OKC,0,240,39,94,0.415,29,53,0.547,10,41,0.244,24,28,0.857,112,41,86,0.477,28,50,0.56,13,36,0.361,22,31,0.71,117
1120,DET,2021-12-23,112,@,MIA,0,240,36,80,0.45,18,40,0.45,18,40,0.45,22,25,0.88,112,43,88,0.489,31,56,0.554,12,32,0.375,17,19,0.895,115
1121,UTA,2021-12-20,112,,CHO,1,240,34,96,0.354,18,43,0.419,16,53,0.302,28,37,0.757,112,39,101,0.386,24,58,0.414,15,43,0.349,9,9,1.0,102
1122,MIL,2021-12-17,112,@,NOP,0,265,45,104,0.433,31,57,0.544,14,47,0.298,8,10,0.8,112,42,89,0.472,29,52,0.558,13,37,0.351,19,30,0.633,116
1123,SAS,2021-12-12,112,,NOP,1,240,45,91,0.495,38,66,0.576,7,25,0.28,15,20,0.75,112,40,94,0.426,32,65,0.492,8,29,0.276,9,15,0.6,97
1124,MIL,2021-12-12,112,@,NYK,1,240,42,88,0.477,28,47,0.596,14,41,0.341,14,17,0.824,112,35,82,0.427,18,33,0.545,17,49,0.347,10,13,0.769,97
1125,SAS,2021-12-11,112,,DEN,0,240,41,89,0.461,31,62,0.5,10,27,0.37,20,29,0.69,112,47,93,0.505,27,50,0.54,20,43,0.465,13,14,0.929,127
1126,MIL,2021-12-06,112,,CLE,1,240,40,86,0.465,27,54,0.5,13,32,0.406,19,24,0.792,112,35,90,0.389,20,44,0.455,15,46,0.326,19,20,0.95,104
1127,SAS,2021-12-04,112,@,GSW,1,240,42,88,0.477,30,53,0.566,12,35,0.343,16,19,0.842,112,40,90,0.444,27,51,0.529,13,39,0.333,14,21,0.667,107
1128,BRK,2021-11-30,112,,NYK,1,240,41,85,0.482,33,57,0.579,8,28,0.286,22,25,0.88,112,44,91,0.484,33,59,0.559,11,32,0.344,11,12,0.917,110
1129,DAL,2021-11-23,112,@,LAC,1,265,39,89,0.438,27,50,0.54,12,39,0.308,22,27,0.815,112,35,85,0.412,25,53,0.472,10,32,0.313,24,29,0.828,104
1130,CLE,2021-11-22,112,,BRK,0,240,36,93,0.387,22,49,0.449,14,44,0.318,26,29,0.897,112,45,95,0.474,34,60,0.567,11,35,0.314,16,18,0.889,117
1131,PHO,2021-11-19,112,,DAL,1,240,44,85,0.518,30,56,0.536,14,29,0.483,10,14,0.714,112,37,90,0.411,25,50,0.5,12,40,0.3,18,23,0.783,104
1132,MIA,2021-11-18,112,,WAS,1,240,41,82,0.5,31,56,0.554,10,26,0.385,20,24,0.833,112,38,77,0.494,23,41,0.561,15,36,0.417,6,10,0.6,97
1133,POR,2021-11-17,112,,CHI,1,240,37,84,0.44,26,53,0.491,11,31,0.355,27,28,0.964,112,39,83,0.47,26,54,0.481,13,29,0.448,16,20,0.8,107
1134,NOP,2021-11-13,112,,MEM,1,240,38,79,0.481,24,50,0.48,14,29,0.483,22,25,0.88,112,38,88,0.432,30,64,0.469,8,24,0.333,17,21,0.81,101
1135,NOP,2021-11-12,112,,BRK,0,240,43,88,0.489,30,56,0.536,13,32,0.406,13,16,0.813,112,41,82,0.5,23,48,0.479,18,34,0.529,20,27,0.741,120
1136,LAC,2021-11-11,112,,MIA,1,240,43,91,0.473,32,54,0.593,11,37,0.297,15,17,0.882,112,43,97,0.443,34,56,0.607,9,41,0.22,14,17,0.824,109
1137,DET,2021-11-10,112,@,HOU,1,240,42,97,0.433,26,49,0.531,16,48,0.333,12,18,0.667,112,35,82,0.427,23,48,0.479,12,34,0.353,22,34,0.647,104
1138,MIL,2021-11-10,112,@,NYK,1,240,40,90,0.444,14,40,0.35,26,50,0.52,6,9,0.667,112,36,83,0.434,20,46,0.435,16,37,0.432,12,17,0.706,100
1139,SAC,2021-11-03,112,,NOP,1,240,42,80,0.525,32,50,0.64,10,30,0.333,18,22,0.818,112,37,86,0.43,25,52,0.481,12,34,0.353,13,15,0.867,99
1140,PHO,2021-11-02,112,,NOP,1,240,43,82,0.524,34,56,0.607,9,26,0.346,17,18,0.944,112,36,91,0.396,23,52,0.442,13,39,0.333,15,16,0.938,100
1141,BOS,2021-10-30,112,@,WAS,0,290,44,107,0.411,42,81,0.519,2,26,0.077,22,25,0.88,112,38,104,0.365,28,68,0.412,10,36,0.278,29,36,0.806,115
1142,NYK,2021-10-26,112,,PHI,1,240,41,87,0.471,25,50,0.5,16,37,0.432,14,15,0.933,112,36,82,0.439,24,41,0.585,12,41,0.293,15,17,0.882,99
1143,NOP,2021-10-22,112,@,CHI,0,240,42,87,0.483,27,58,0.466,15,29,0.517,13,16,0.813,112,47,89,0.528,33,61,0.541,14,28,0.5,20,25,0.8,128
1144,CLE,2021-10-22,112,,CHO,0,240,43,84,0.512,34,53,0.642,9,31,0.29,17,20,0.85,112,48,91,0.527,35,59,0.593,13,32,0.406,14,17,0.824,123
1145,MIA,2022-04-10,111,@,ORL,0,240,40,94,0.426,21,44,0.477,19,50,0.38,12,16,0.75,111,45,91,0.495,22,33,0.667,23,58,0.397,12,14,0.857,125
1146,UTA,2022-04-10,111,@,POR,1,240,37,82,0.451,28,46,0.609,9,36,0.25,28,38,0.737,111,31,83,0.373,22,49,0.449,9,34,0.265,9,12,0.75,80
1147,PHO,2022-04-08,111,@,UTA,1,240,46,92,0.5,40,73,0.548,6,19,0.316,13,15,0.867,111,35,88,0.398,24,50,0.48,11,38,0.289,24,33,0.727,105
1148,GSW,2022-04-02,111,,UTA,1,240,40,84,0.476,20,36,0.556,20,48,0.417,11,12,0.917,111,38,89,0.427,23,43,0.535,15,46,0.326,16,22,0.727,107
1149,LAL,2022-04-01,111,,NOP,0,240,39,82,0.476,28,55,0.509,11,27,0.407,22,31,0.71,111,41,79,0.519,34,53,0.642,7,26,0.269,25,29,0.862,114
1150,POR,2022-04-01,111,@,SAS,0,240,41,92,0.446,26,57,0.456,15,35,0.429,14,20,0.7,111,46,81,0.568,30,44,0.682,16,37,0.432,22,28,0.786,130
1151,SAS,2022-03-30,111,,MEM,0,240,42,83,0.506,28,48,0.583,14,35,0.4,13,16,0.813,111,44,91,0.484,28,52,0.538,16,39,0.41,8,11,0.727,112
1152,NYK,2022-03-25,111,@,MIA,1,240,36,82,0.439,19,32,0.594,17,50,0.34,22,28,0.786,111,35,70,0.5,23,37,0.622,12,33,0.364,21,25,0.84,103
1153,NYK,2022-03-22,111,,ATL,0,240,42,86,0.488,29,52,0.558,13,34,0.382,14,26,0.538,111,40,81,0.494,25,45,0.556,15,36,0.417,22,27,0.815,117
1154,PHI,2022-03-18,111,,DAL,1,240,37,75,0.493,21,37,0.568,16,38,0.421,21,23,0.913,111,37,80,0.463,25,48,0.521,12,32,0.375,15,21,0.714,101
1155,BRK,2022-03-16,111,,DAL,0,240,45,91,0.495,36,65,0.554,9,26,0.346,12,15,0.8,111,41,83,0.494,29,49,0.592,12,34,0.353,19,19,1.0,113
1156,UTA,2022-03-14,111,,MIL,0,240,37,93,0.398,20,45,0.444,17,48,0.354,20,24,0.833,111,40,86,0.465,28,55,0.509,12,31,0.387,25,29,0.862,117
1157,LAC,2022-03-14,111,@,CLE,0,265,43,98,0.439,31,62,0.5,12,36,0.333,13,17,0.765,111,41,86,0.477,26,56,0.464,15,30,0.5,23,32,0.719,120
1158,LAL,2022-03-13,111,@,PHO,0,240,36,81,0.444,20,41,0.488,16,40,0.4,23,31,0.742,111,58,102,0.569,46,69,0.667,12,33,0.364,12,14,0.857,140
1159,PHO,2022-03-09,111,@,MIA,1,240,45,99,0.455,34,62,0.548,11,37,0.297,10,10,1.0,111,35,88,0.398,25,55,0.455,10,33,0.303,10,13,0.769,90
1160,NOP,2022-03-08,111,@,MEM,0,240,41,88,0.466,30,54,0.556,11,34,0.324,18,27,0.667,111,48,101,0.475,32,57,0.561,16,44,0.364,20,24,0.833,132
1161,DAL,2022-03-07,111,,UTA,1,240,39,88,0.443,22,42,0.524,17,46,0.37,16,20,0.8,111,36,83,0.434,24,52,0.462,12,31,0.387,19,24,0.792,103
1162,DET,2022-03-04,111,,IND,1,240,42,94,0.447,27,64,0.422,15,30,0.5,12,18,0.667,111,39,100,0.39,29,60,0.483,10,40,0.25,18,28,0.643,106
1163,LAL,2022-03-03,111,@,LAC,0,240,41,84,0.488,29,49,0.592,12,35,0.343,17,22,0.773,111,51,93,0.548,34,66,0.515,17,27,0.63,13,15,0.867,132
1164,HOU,2022-02-25,111,@,ORL,0,240,44,94,0.468,30,47,0.638,14,47,0.298,9,20,0.45,111,42,83,0.506,29,47,0.617,13,36,0.361,22,29,0.759,119
1165,MIA,2022-02-17,111,@,CHO,1,290,41,102,0.402,27,54,0.5,14,48,0.292,15,23,0.652,111,38,95,0.4,28,53,0.528,10,42,0.238,21,30,0.7,107
1166,HOU,2022-02-17,111,@,LAC,0,240,42,91,0.462,29,54,0.537,13,37,0.351,14,19,0.737,111,51,92,0.554,33,57,0.579,18,35,0.514,22,26,0.846,142
1167,BRK,2022-02-16,111,@,NYK,1,240,43,98,0.439,32,64,0.5,11,34,0.324,14,23,0.609,111,37,85,0.435,21,42,0.5,16,43,0.372,16,18,0.889,106
1168,BOS,2022-02-16,111,,DET,0,240,42,77,0.545,29,45,0.644,13,32,0.406,14,18,0.778,111,43,93,0.462,27,63,0.429,16,30,0.533,10,13,0.769,112
1169,ORL,2022-02-14,111,@,DEN,0,240,40,91,0.44,29,52,0.558,11,39,0.282,20,23,0.87,111,42,88,0.477,26,48,0.542,16,40,0.4,21,23,0.913,121
1170,BRK,2022-02-12,111,@,MIA,0,240,42,93,0.452,30,53,0.566,12,40,0.3,15,22,0.682,111,41,82,0.5,31,53,0.585,10,29,0.345,23,29,0.793,115
1171,UTA,2022-02-09,111,,GSW,1,240,41,89,0.461,24,38,0.632,17,51,0.333,12,17,0.706,111,28,78,0.359,12,35,0.343,16,43,0.372,13,17,0.765,85
1172,LAC,2022-02-03,111,,LAL,1,240,46,89,0.517,33,59,0.559,13,30,0.433,6,11,0.545,111,41,88,0.466,30,59,0.508,11,29,0.379,17,25,0.68,110
1173,BRK,2022-02-01,111,@,PHO,0,240,40,81,0.494,24,41,0.585,16,40,0.4,15,21,0.714,111,42,76,0.553,31,45,0.689,11,31,0.355,26,31,0.839,121
1174,NOP,2022-02-01,111,@,DET,1,240,39,89,0.438,31,61,0.508,8,28,0.286,25,28,0.893,111,41,84,0.488,33,52,0.635,8,32,0.25,11,14,0.786,101
1175,CHI,2022-01-26,111,,TOR,1,240,46,84,0.548,39,58,0.672,7,26,0.269,12,16,0.75,111,38,79,0.481,26,48,0.542,12,31,0.387,17,28,0.607,105
1176,LAC,2022-01-26,111,@,ORL,1,240,36,81,0.444,21,52,0.404,15,29,0.517,24,27,0.889,111,38,84,0.452,29,49,0.592,9,35,0.257,17,22,0.773,102
1177,CHI,2022-01-24,111,@,OKC,1,240,41,89,0.461,26,50,0.52,15,39,0.385,14,19,0.737,111,38,92,0.413,22,47,0.468,16,45,0.356,18,24,0.75,110
1178,DET,2022-01-23,111,@,DEN,0,240,42,75,0.56,31,46,0.674,11,29,0.379,16,19,0.842,111,44,85,0.518,32,50,0.64,12,35,0.343,17,23,0.739,117
1179,UTA,2022-01-21,111,,DET,1,240,36,79,0.456,26,48,0.542,10,31,0.323,29,34,0.853,111,38,87,0.437,25,55,0.455,13,32,0.406,12,16,0.75,101
1180,CHO,2022-01-19,111,@,BOS,1,240,42,86,0.488,26,47,0.553,16,39,0.41,11,15,0.733,111,39,90,0.433,25,44,0.568,14,46,0.304,10,13,0.769,102
1181,IND,2022-01-19,111,@,LAL,1,240,44,90,0.489,33,60,0.55,11,30,0.367,12,15,0.8,111,40,90,0.444,29,56,0.518,11,34,0.324,13,18,0.722,104
1182,UTA,2022-01-19,111,,HOU,0,240,42,89,0.472,32,51,0.627,10,38,0.263,17,20,0.85,111,41,96,0.427,19,51,0.373,22,45,0.489,12,17,0.706,116
1183,PHI,2022-01-14,111,,BOS,1,240,38,85,0.447,24,44,0.545,14,41,0.341,21,25,0.84,111,37,78,0.474,26,47,0.553,11,31,0.355,14,18,0.778,99
1184,CLE,2022-01-12,111,@,UTA,1,240,43,81,0.531,32,51,0.627,11,30,0.367,14,17,0.824,111,34,85,0.4,18,38,0.474,16,47,0.34,7,11,0.636,91
1185,NYK,2022-01-10,111,,SAS,1,240,40,82,0.488,27,50,0.54,13,32,0.406,18,24,0.75,111,39,95,0.411,31,66,0.47,8,29,0.276,10,15,0.667,96
1186,PHI,2022-01-10,111,@,HOU,1,240,43,94,0.457,33,59,0.559,10,35,0.286,15,18,0.833,111,30,77,0.39,17,35,0.486,13,42,0.31,18,27,0.667,91
1187,SAC,2022-01-07,111,@,DEN,0,240,40,92,0.435,29,63,0.46,11,29,0.379,20,24,0.833,111,47,85,0.553,35,51,0.686,12,34,0.353,15,24,0.625,121
1188,MIL,2022-01-05,111,,TOR,0,240,38,85,0.447,21,46,0.457,17,39,0.436,18,26,0.692,111,42,89,0.472,26,53,0.491,16,36,0.444,17,25,0.68,117
1189,DET,2022-01-05,111,@,CHO,0,240,43,92,0.467,29,50,0.58,14,42,0.333,11,20,0.55,111,48,81,0.593,24,39,0.615,24,42,0.571,20,29,0.69,140
1190,WAS,2022-01-05,111,,HOU,0,240,40,91,0.44,30,52,0.577,10,39,0.256,21,26,0.808,111,40,85,0.471,31,59,0.525,9,26,0.346,25,32,0.781,114
1191,ORL,2022-01-02,111,@,BOS,0,265,40,95,0.421,31,68,0.456,9,27,0.333,22,27,0.815,111,39,86,0.453,26,50,0.52,13,36,0.361,25,28,0.893,116
1192,HOU,2022-01-01,111,,DEN,0,240,37,85,0.435,21,43,0.488,16,42,0.381,21,24,0.875,111,46,86,0.535,36,54,0.667,10,32,0.313,22,27,0.815,124
1193,OKC,2021-12-28,111,@,SAC,0,240,35,90,0.389,24,57,0.421,11,33,0.333,30,36,0.833,111,40,95,0.421,23,56,0.411,17,39,0.436,20,27,0.741,117
1194,BOS,2021-12-22,111,,CLE,1,240,43,92,0.467,32,62,0.516,11,30,0.367,14,18,0.778,111,36,92,0.391,27,54,0.5,9,38,0.237,20,24,0.833,101
1195,NOP,2021-12-21,111,,POR,1,240,42,80,0.525,30,47,0.638,12,33,0.364,15,18,0.833,111,35,78,0.449,22,44,0.5,13,34,0.382,14,19,0.737,97
1196,MIN,2021-12-19,111,,DAL,1,240,36,77,0.468,21,43,0.488,15,34,0.441,24,31,0.774,111,36,82,0.439,24,41,0.585,12,41,0.293,21,22,0.955,105
1197,GSW,2021-12-17,111,@,BOS,1,240,39,90,0.433,23,44,0.523,16,46,0.348,17,21,0.81,111,36,82,0.439,21,41,0.512,15,41,0.366,20,29,0.69,107
1198,ATL,2021-12-15,111,@,ORL,1,240,42,85,0.494,31,54,0.574,11,31,0.355,16,16,1.0,111,35,90,0.389,25,55,0.455,10,35,0.286,19,21,0.905,99
1199,PHO,2021-12-14,111,@,POR,1,265,44,93,0.473,33,62,0.532,11,31,0.355,12,15,0.8,111,40,96,0.417,27,55,0.491,13,41,0.317,14,22,0.636,107
1200,LAC,2021-12-13,111,,PHO,1,240,43,78,0.551,34,57,0.596,9,21,0.429,16,23,0.696,111,36,96,0.375,29,67,0.433,7,29,0.241,16,19,0.842,95
1201,POR,2021-12-12,111,,MIN,0,240,37,81,0.457,19,33,0.576,18,48,0.375,19,28,0.679,111,38,85,0.447,24,49,0.49,14,36,0.389,26,32,0.813,116
1202,PHO,2021-12-10,111,,BOS,1,240,43,96,0.448,29,58,0.5,14,38,0.368,11,11,1.0,111,35,93,0.376,31,67,0.463,4,26,0.154,16,24,0.667,90
1203,DEN,2021-12-09,111,@,SAS,0,240,42,94,0.447,27,55,0.491,15,39,0.385,12,13,0.923,111,46,88,0.523,31,53,0.585,15,35,0.429,16,22,0.727,123
1204,BOS,2021-12-08,111,@,LAC,0,240,41,86,0.477,31,54,0.574,10,32,0.313,19,21,0.905,111,40,85,0.471,26,53,0.491,14,32,0.438,20,22,0.909,114
1205,CHI,2021-12-04,111,@,BRK,1,240,41,86,0.477,31,55,0.564,10,31,0.323,19,27,0.704,111,46,111,0.414,38,86,0.442,8,25,0.32,7,9,0.778,107
1206,CLE,2021-12-01,111,@,MIA,1,240,37,68,0.544,21,37,0.568,16,31,0.516,21,23,0.913,111,32,85,0.376,20,48,0.417,12,37,0.324,9,13,0.692,85
1207,IND,2021-12-01,111,,ATL,0,240,44,90,0.489,34,57,0.596,10,33,0.303,13,16,0.813,111,44,86,0.512,28,53,0.528,16,33,0.485,10,12,0.833,114
1208,MIA,2021-11-29,111,,DEN,0,240,43,91,0.473,28,47,0.596,15,44,0.341,10,15,0.667,111,43,74,0.581,25,39,0.641,18,35,0.514,16,21,0.762,120
1209,SAS,2021-11-22,111,,PHO,0,240,49,93,0.527,44,73,0.603,5,20,0.25,8,16,0.5,111,45,88,0.511,33,61,0.541,12,27,0.444,13,16,0.813,115
1210,IND,2021-11-20,111,,NOP,1,240,42,91,0.462,28,53,0.528,14,38,0.368,13,18,0.722,111,35,88,0.398,29,70,0.414,6,18,0.333,18,19,0.947,94
1211,PHI,2021-11-20,111,@,POR,0,240,41,81,0.506,31,53,0.585,10,28,0.357,19,21,0.905,111,40,80,0.5,25,46,0.543,15,34,0.441,23,23,1.0,118
1212,BOS,2021-11-20,111,,OKC,1,240,41,88,0.466,24,49,0.49,17,39,0.436,12,14,0.857,111,39,96,0.406,21,54,0.389,18,42,0.429,9,16,0.563,105
1213,ORL,2021-11-15,111,@,ATL,0,240,43,95,0.453,27,52,0.519,16,43,0.372,9,14,0.643,111,47,85,0.553,33,55,0.6,14,30,0.467,21,32,0.656,129
1214,DAL,2021-11-15,111,,DEN,1,240,45,90,0.5,31,54,0.574,14,36,0.389,7,10,0.7,111,40,84,0.476,31,52,0.596,9,32,0.281,12,17,0.706,101
1215,MIA,2021-11-13,111,@,UTA,1,240,42,85,0.494,29,52,0.558,13,33,0.394,14,16,0.875,111,35,85,0.412,18,32,0.563,17,53,0.321,18,25,0.72,105
1216,IND,2021-11-11,111,@,UTA,1,240,43,96,0.448,32,65,0.492,11,31,0.355,14,19,0.737,111,39,83,0.47,30,51,0.588,9,32,0.281,13,23,0.565,100
1217,HOU,2021-11-04,111,@,PHO,0,240,38,88,0.432,27,56,0.482,11,32,0.344,24,28,0.857,111,44,93,0.473,30,62,0.484,14,31,0.452,21,23,0.913,123
1218,IND,2021-11-03,111,,NYK,1,240,42,91,0.462,26,50,0.52,16,41,0.39,11,14,0.786,111,36,87,0.414,31,63,0.492,5,24,0.208,21,27,0.778,98
1219,WAS,2021-11-01,111,@,ATL,0,240,41,86,0.477,28,47,0.596,13,39,0.333,16,16,1.0,111,38,83,0.458,25,49,0.51,13,34,0.382,29,29,1.0,118
1220,POR,2021-10-29,111,,LAC,1,240,41,98,0.418,22,57,0.386,19,41,0.463,10,16,0.625,111,34,87,0.391,19,45,0.422,15,42,0.357,9,16,0.563,92
1221,ATL,2021-10-28,111,@,WAS,0,240,48,88,0.545,42,67,0.627,6,21,0.286,9,14,0.643,111,46,99,0.465,33,65,0.508,13,34,0.382,17,21,0.81,122
1222,ORL,2021-10-27,111,,CHO,0,240,43,88,0.489,28,48,0.583,15,40,0.375,10,13,0.769,111,43,83,0.518,29,53,0.547,14,30,0.467,20,24,0.833,120
1223,CHI,2021-10-25,111,@,TOR,1,240,39,81,0.481,27,54,0.5,12,27,0.444,21,22,0.955,111,40,83,0.482,28,53,0.528,12,30,0.4,16,20,0.8,108
1224,CHO,2021-10-24,111,@,BRK,1,240,43,94,0.457,33,64,0.516,10,30,0.333,15,19,0.789,111,38,87,0.437,29,52,0.558,9,35,0.257,10,12,0.833,95
1225,SAS,2021-10-23,111,,MIL,0,240,48,99,0.485,38,60,0.633,10,39,0.256,5,6,0.833,111,44,83,0.53,29,48,0.604,15,35,0.429,18,22,0.818,121
1226,MEM,2022-04-10,110,,BOS,0,240,39,102,0.382,24,55,0.436,15,47,0.319,17,27,0.63,110,54,99,0.545,36,51,0.706,18,48,0.375,13,13,1.0,139
1227,BRK,2022-04-06,110,@,NYK,1,240,41,93,0.441,27,52,0.519,14,41,0.341,14,18,0.778,110,32,83,0.386,19,45,0.422,13,38,0.342,21,36,0.583,98
1228,LAL,2022-04-05,110,@,PHO,0,240,39,86,0.453,30,57,0.526,9,29,0.31,23,30,0.767,110,50,102,0.49,36,63,0.571,14,39,0.359,7,9,0.778,121
1229,DET,2022-04-01,110,@,OKC,1,240,40,94,0.426,25,46,0.543,15,48,0.313,15,18,0.833,110,36,84,0.429,25,50,0.5,11,34,0.324,18,29,0.621,101
1230,ORL,2022-03-30,110,@,WAS,0,240,40,96,0.417,29,62,0.468,11,34,0.324,19,22,0.864,110,47,92,0.511,34,56,0.607,13,36,0.361,20,26,0.769,127
1231,LAL,2022-03-29,110,@,DAL,0,240,40,89,0.449,28,45,0.622,12,44,0.273,18,22,0.818,110,45,87,0.517,25,41,0.61,20,46,0.435,18,23,0.783,128
1232,BRK,2022-03-27,110,,CHO,0,240,43,97,0.443,36,63,0.571,7,34,0.206,17,26,0.654,110,42,98,0.429,25,66,0.379,17,32,0.531,18,23,0.783,119
1233,ORL,2022-03-26,110,,SAC,0,265,45,106,0.425,32,70,0.457,13,36,0.361,7,7,1.0,110,42,98,0.429,31,62,0.5,11,36,0.306,19,24,0.792,114
1234,BRK,2022-03-26,110,@,MIA,1,240,39,83,0.47,28,50,0.56,11,33,0.333,21,26,0.808,110,33,75,0.44,23,41,0.561,10,34,0.294,19,26,0.731,95
1235,GSW,2022-03-25,110,@,ATL,0,240,43,90,0.478,29,49,0.592,14,41,0.341,10,13,0.769,110,46,89,0.517,32,52,0.615,14,37,0.378,15,19,0.789,121
1236,SAC,2022-03-23,110,@,IND,1,240,43,82,0.524,31,45,0.689,12,37,0.324,12,17,0.706,110,42,91,0.462,28,55,0.509,14,36,0.389,11,11,1.0,109
1237,DAL,2022-03-23,110,,HOU,1,240,42,86,0.488,34,53,0.642,8,33,0.242,18,22,0.818,110,33,82,0.402,29,54,0.537,4,28,0.143,21,28,0.75,91
1238,DAL,2022-03-21,110,,MIN,1,240,40,83,0.482,26,37,0.703,14,46,0.304,16,21,0.762,110,36,91,0.396,23,55,0.418,13,36,0.361,23,29,0.793,108
1239,SAS,2022-03-20,110,@,GSW,1,240,38,98,0.388,23,58,0.397,15,40,0.375,19,25,0.76,110,41,90,0.456,30,57,0.526,11,33,0.333,15,21,0.714,108
1240,BOS,2022-03-16,110,@,GSW,1,240,38,81,0.469,23,41,0.561,15,40,0.375,19,22,0.864,110,32,86,0.372,21,38,0.553,11,48,0.229,13,16,0.813,88
1241,CHI,2022-03-16,110,@,UTA,0,240,43,91,0.473,31,57,0.544,12,34,0.353,12,17,0.706,110,42,83,0.506,23,44,0.523,19,39,0.487,22,29,0.759,125
1242,PHI,2022-03-14,110,,DEN,0,240,36,84,0.429,24,51,0.471,12,33,0.364,26,32,0.813,110,44,82,0.537,31,49,0.633,13,33,0.394,13,20,0.65,114
1243,BRK,2022-03-13,110,,NYK,1,240,44,89,0.494,38,60,0.633,6,29,0.207,16,22,0.727,110,39,83,0.47,28,54,0.519,11,29,0.379,18,21,0.857,107
1244,MIN,2022-03-11,110,@,ORL,0,240,41,90,0.456,26,45,0.578,15,45,0.333,13,13,1.0,110,40,86,0.465,24,46,0.522,16,40,0.4,22,25,0.88,118
1245,ATL,2022-03-07,110,@,DET,0,265,42,93,0.452,31,55,0.564,11,38,0.289,15,22,0.682,110,43,93,0.462,31,60,0.517,12,33,0.364,15,23,0.652,113
1246,LAL,2022-03-07,110,@,SAS,0,240,43,91,0.473,35,65,0.538,8,26,0.308,16,23,0.696,110,46,84,0.548,37,58,0.638,9,26,0.346,16,30,0.533,117
1247,OKC,2022-02-28,110,,SAC,0,240,40,86,0.465,29,51,0.569,11,35,0.314,19,27,0.704,110,49,87,0.563,39,56,0.696,10,31,0.323,23,30,0.767,131
1248,SAC,2022-02-26,110,@,DEN,0,240,38,89,0.427,29,59,0.492,9,30,0.3,25,33,0.758,110,38,82,0.463,22,39,0.564,16,43,0.372,23,29,0.793,115
1249,CHI,2022-02-26,110,,MEM,0,240,39,93,0.419,30,73,0.411,9,20,0.45,23,30,0.767,110,44,100,0.44,37,77,0.481,7,23,0.304,21,26,0.808,116
1250,SAC,2022-02-24,110,,DEN,0,240,43,86,0.5,34,57,0.596,9,29,0.31,15,18,0.833,110,48,86,0.558,33,51,0.647,15,35,0.429,17,20,0.85,128
1251,WAS,2022-02-12,110,,SAC,0,240,41,88,0.466,28,50,0.56,13,38,0.342,15,21,0.714,110,43,76,0.566,31,48,0.646,12,28,0.429,25,29,0.862,123
1252,DEN,2022-02-12,110,@,TOR,1,240,39,84,0.464,25,47,0.532,14,37,0.378,18,21,0.857,110,43,88,0.489,31,54,0.574,12,34,0.353,11,17,0.647,109
1253,NOP,2022-02-08,110,,HOU,1,240,42,80,0.525,34,48,0.708,8,32,0.25,18,20,0.9,110,32,86,0.372,19,44,0.432,13,42,0.31,20,31,0.645,97
1254,GSW,2022-02-07,110,@,OKC,1,240,41,82,0.5,26,39,0.667,15,43,0.349,13,17,0.765,110,37,90,0.411,26,54,0.481,11,36,0.306,13,17,0.765,98
1255,LAL,2022-02-03,110,@,LAC,0,240,41,88,0.466,30,59,0.508,11,29,0.379,17,25,0.68,110,46,89,0.517,33,59,0.559,13,30,0.433,6,11,0.545,111
1256,TOR,2022-02-01,110,,MIA,1,240,39,81,0.481,27,55,0.491,12,26,0.462,20,29,0.69,110,38,78,0.487,30,48,0.625,8,30,0.267,22,25,0.88,106
1257,ORL,2022-01-30,110,,DAL,1,240,43,84,0.512,32,50,0.64,11,34,0.324,13,16,0.813,110,39,81,0.481,23,43,0.535,16,38,0.421,14,18,0.778,108
1258,SAS,2022-01-30,110,@,PHO,0,240,45,100,0.45,32,63,0.508,13,37,0.351,7,8,0.875,110,48,97,0.495,37,65,0.569,11,32,0.344,8,12,0.667,115
1259,GSW,2022-01-29,110,,BRK,1,240,40,98,0.408,26,53,0.491,14,45,0.311,16,18,0.889,110,39,98,0.398,28,70,0.4,11,28,0.393,17,21,0.81,106
1260,HOU,2022-01-28,110,,POR,0,240,38,79,0.481,28,38,0.737,10,41,0.244,24,31,0.774,110,46,81,0.568,29,42,0.69,17,39,0.436,16,20,0.8,125
1261,OKC,2022-01-28,110,,IND,0,265,43,95,0.453,29,52,0.558,14,43,0.326,10,17,0.588,110,41,95,0.432,28,56,0.5,13,39,0.333,18,29,0.621,113
1262,SAS,2022-01-26,110,,MEM,0,240,43,94,0.457,34,57,0.596,9,37,0.243,15,19,0.789,110,46,90,0.511,39,67,0.582,7,23,0.304,19,26,0.731,118
1263,MIA,2022-01-26,110,,NYK,1,240,37,74,0.5,21,37,0.568,16,37,0.432,20,22,0.909,110,35,83,0.422,20,39,0.513,15,44,0.341,11,17,0.647,96
1264,DEN,2022-01-25,110,@,DET,1,240,36,84,0.429,25,52,0.481,11,32,0.344,27,31,0.871,110,41,97,0.423,29,61,0.475,12,36,0.333,11,14,0.786,105
1265,OKC,2022-01-24,110,,CHI,0,240,38,92,0.413,22,47,0.468,16,45,0.356,18,24,0.75,110,41,89,0.461,26,50,0.52,15,39,0.385,14,19,0.737,111
1266,NYK,2022-01-23,110,,LAC,1,240,39,91,0.429,23,55,0.418,16,36,0.444,16,19,0.842,110,34,79,0.43,20,38,0.526,14,41,0.341,20,30,0.667,102
1267,ATL,2022-01-21,110,,MIA,1,240,38,68,0.559,24,35,0.686,14,33,0.424,20,24,0.833,110,41,85,0.482,26,45,0.578,15,40,0.375,11,12,0.917,108
1268,ORL,2022-01-19,110,@,PHI,0,240,40,90,0.444,22,55,0.4,18,35,0.514,12,16,0.75,110,45,83,0.542,35,55,0.636,10,28,0.357,23,27,0.852,123
1269,NYK,2022-01-18,110,,MIN,0,240,37,80,0.463,25,42,0.595,12,38,0.316,24,33,0.727,110,35,81,0.432,22,40,0.55,13,41,0.317,29,38,0.763,112
1270,WAS,2022-01-15,110,,POR,0,240,39,90,0.433,27,53,0.509,12,37,0.324,20,23,0.87,110,39,85,0.459,26,46,0.565,13,39,0.333,24,35,0.686,115
1271,NOP,2022-01-04,110,,PHO,0,240,36,89,0.404,26,56,0.464,10,33,0.303,28,32,0.875,110,46,85,0.541,29,54,0.537,17,31,0.548,14,20,0.7,123
1272,MEM,2022-01-04,110,@,CLE,1,240,42,90,0.467,33,63,0.524,9,27,0.333,17,22,0.773,110,40,92,0.435,30,58,0.517,10,34,0.294,16,21,0.762,106
1273,HOU,2021-12-31,110,,MIA,0,240,41,93,0.441,27,51,0.529,14,42,0.333,14,17,0.824,110,40,86,0.465,26,53,0.491,14,33,0.424,26,31,0.839,120
1274,PHI,2021-12-30,110,@,BRK,1,240,42,100,0.42,29,68,0.426,13,32,0.406,13,20,0.65,110,37,81,0.457,30,54,0.556,7,27,0.259,21,27,0.778,102
1275,WAS,2021-12-30,110,,CLE,1,240,45,90,0.5,36,61,0.59,9,29,0.31,11,17,0.647,110,35,83,0.422,27,55,0.491,8,28,0.286,15,23,0.652,93
1276,ORL,2021-12-28,110,,MIL,0,240,38,83,0.458,26,44,0.591,12,39,0.308,22,26,0.846,110,47,85,0.553,30,48,0.625,17,37,0.459,16,22,0.727,127
1277,UTA,2021-12-27,110,@,SAS,1,240,39,86,0.453,30,55,0.545,9,31,0.29,23,30,0.767,110,45,100,0.45,35,70,0.5,10,30,0.333,4,9,0.444,104
1278,LAL,2021-12-23,110,,SAS,0,240,44,94,0.468,39,67,0.582,5,27,0.185,17,30,0.567,110,46,95,0.484,28,56,0.5,18,39,0.462,28,33,0.848,138
1279,NOP,2021-12-23,110,@,ORL,1,240,37,86,0.43,24,56,0.429,13,30,0.433,23,26,0.885,110,38,88,0.432,29,56,0.518,9,32,0.281,19,21,0.905,104
1280,LAL,2021-12-19,110,@,CHI,0,240,42,82,0.512,30,48,0.625,12,34,0.353,14,22,0.636,110,40,93,0.43,30,63,0.476,10,30,0.333,25,31,0.806,115
1281,MIN,2021-12-17,110,,LAL,1,240,41,98,0.418,29,54,0.537,12,44,0.273,16,24,0.667,110,30,78,0.385,18,35,0.514,12,43,0.279,20,29,0.69,92
1282,OKC,2021-12-15,110,,NOP,0,240,39,93,0.419,26,58,0.448,13,35,0.371,19,19,1.0,110,39,80,0.488,28,52,0.538,11,28,0.393,24,36,0.667,113
1283,OKC,2021-12-08,110,@,TOR,1,240,38,84,0.452,21,44,0.477,17,40,0.425,17,20,0.85,110,42,93,0.452,27,52,0.519,15,41,0.366,10,15,0.667,109
1284,PHI,2021-12-08,110,@,CHO,1,240,36,75,0.48,23,41,0.561,13,34,0.382,25,30,0.833,110,39,80,0.488,29,51,0.569,10,29,0.345,18,21,0.857,106
1285,WAS,2021-12-06,110,@,IND,0,240,43,81,0.531,36,66,0.545,7,15,0.467,17,21,0.81,110,43,82,0.524,34,59,0.576,9,23,0.391,21,22,0.955,116
1286,MIN,2021-12-06,110,,ATL,0,240,39,98,0.398,22,58,0.379,17,40,0.425,15,19,0.789,110,40,90,0.444,15,41,0.366,25,49,0.51,16,19,0.842,121
1287,BRK,2021-12-03,110,,MIN,1,240,36,76,0.474,30,53,0.566,6,23,0.261,32,41,0.78,110,36,93,0.387,23,51,0.451,13,42,0.31,20,24,0.833,105
1288,OKC,2021-12-01,110,,HOU,0,240,40,85,0.471,32,53,0.604,8,32,0.25,22,29,0.759,110,40,79,0.506,25,42,0.595,15,37,0.405,19,22,0.864,114
1289,NYK,2021-11-30,110,@,BRK,0,240,44,91,0.484,33,59,0.559,11,32,0.344,11,12,0.917,110,41,85,0.482,33,57,0.579,8,28,0.286,22,25,0.88,112
1290,POR,2021-11-30,110,,DET,1,240,41,96,0.427,27,54,0.5,14,42,0.333,14,18,0.778,110,29,76,0.382,20,41,0.488,9,35,0.257,25,30,0.833,92
1291,LAL,2021-11-28,110,,DET,1,240,43,86,0.5,34,54,0.63,9,32,0.281,15,25,0.6,110,38,89,0.427,25,56,0.446,13,33,0.394,17,19,0.895,106
1292,UTA,2021-11-24,110,@,OKC,1,240,39,86,0.453,24,39,0.615,15,47,0.319,17,20,0.85,110,37,82,0.451,22,46,0.478,15,36,0.417,15,22,0.682,104
1293,MIN,2021-11-22,110,@,NOP,1,240,40,100,0.4,30,56,0.536,10,44,0.227,20,28,0.714,110,37,88,0.42,31,56,0.554,6,32,0.188,16,18,0.889,96
1294,ATL,2021-11-17,110,,BOS,1,240,41,81,0.506,28,44,0.636,13,37,0.351,15,18,0.833,110,37,84,0.44,26,43,0.605,11,41,0.268,14,17,0.824,99
1295,MIN,2021-11-10,110,@,GSW,0,240,39,95,0.411,22,51,0.431,17,44,0.386,15,20,0.75,110,40,85,0.471,29,45,0.644,11,40,0.275,32,40,0.8,123
1296,UTA,2021-11-09,110,,ATL,1,240,41,81,0.506,26,43,0.605,15,38,0.395,13,16,0.813,110,37,85,0.435,19,50,0.38,18,35,0.514,6,10,0.6,98
1297,CHO,2021-11-05,110,@,SAC,0,240,43,92,0.467,32,57,0.561,11,35,0.314,13,21,0.619,110,48,87,0.552,26,43,0.605,22,44,0.5,22,26,0.846,140
1298,POR,2021-11-05,110,,IND,1,240,40,82,0.488,23,43,0.535,17,39,0.436,13,15,0.867,110,43,88,0.489,29,46,0.63,14,42,0.333,6,10,0.6,106
1299,DAL,2021-11-02,110,,MIA,0,240,37,84,0.44,23,42,0.548,14,42,0.333,22,31,0.71,110,43,83,0.518,30,58,0.517,13,25,0.52,26,30,0.867,125
1300,CHO,2021-11-01,110,,CLE,0,240,42,101,0.416,27,62,0.435,15,39,0.385,11,15,0.733,110,39,90,0.433,30,62,0.484,9,28,0.321,26,38,0.684,113
1301,DET,2021-10-30,110,,ORL,1,240,36,89,0.404,22,46,0.478,14,43,0.326,24,30,0.8,110,38,87,0.437,22,55,0.4,16,32,0.5,11,15,0.733,103
1302,TOR,2021-10-29,110,,ORL,1,240,43,86,0.5,34,56,0.607,9,30,0.3,15,22,0.682,110,41,87,0.471,25,53,0.472,16,34,0.471,11,16,0.688,109
1303,PHI,2021-10-28,110,,DET,1,240,38,76,0.5,26,49,0.531,12,27,0.444,22,24,0.917,110,35,86,0.407,22,47,0.468,13,39,0.333,19,27,0.704,102
1304,SAC,2021-10-27,110,@,PHO,1,240,42,95,0.442,27,57,0.474,15,38,0.395,11,15,0.733,110,42,93,0.452,36,71,0.507,6,22,0.273,17,24,0.708,107
1305,DEN,2021-10-26,110,@,UTA,0,240,42,83,0.506,32,55,0.582,10,28,0.357,16,24,0.667,110,44,85,0.518,32,46,0.696,12,39,0.308,22,29,0.759,122
1306,ORL,2021-10-24,110,@,NYK,1,240,36,88,0.409,24,45,0.533,12,43,0.279,26,34,0.765,110,37,100,0.37,24,52,0.462,13,48,0.271,17,25,0.68,104
1307,UTA,2021-10-22,110,@,SAC,1,240,37,90,0.411,21,48,0.438,16,42,0.381,20,23,0.87,110,39,99,0.394,31,63,0.492,8,36,0.222,15,21,0.714,101
1308,DEN,2021-10-20,110,@,PHO,1,240,44,83,0.53,27,44,0.614,17,39,0.436,5,9,0.556,110,36,87,0.414,22,50,0.44,14,37,0.378,12,17,0.706,98
1309,PHO,2022-04-10,109,,SAC,0,240,42,103,0.408,28,56,0.5,14,47,0.298,11,15,0.733,109,40,76,0.526,26,50,0.52,14,26,0.538,22,30,0.733,116
1310,ATL,2022-04-08,109,@,MIA,0,240,42,88,0.477,34,54,0.63,8,34,0.235,17,19,0.895,109,40,72,0.556,29,46,0.63,11,26,0.423,22,28,0.786,113
1311,MEM,2022-04-07,109,@,DEN,0,240,42,89,0.472,31,61,0.508,11,28,0.393,14,19,0.737,109,44,80,0.55,32,50,0.64,12,30,0.4,22,25,0.88,122
1312,PHO,2022-04-06,109,@,LAC,0,240,42,108,0.389,25,60,0.417,17,48,0.354,8,12,0.667,109,33,75,0.44,21,41,0.512,12,34,0.353,35,44,0.795,113
1313,SAC,2022-04-05,109,,NOP,0,240,39,76,0.513,28,46,0.609,11,30,0.367,20,22,0.909,109,45,88,0.511,33,63,0.524,12,25,0.48,21,26,0.808,123
1314,TOR,2022-04-03,109,,MIA,0,240,35,83,0.422,23,44,0.523,12,39,0.308,27,34,0.794,109,41,79,0.519,23,41,0.561,18,38,0.474,14,22,0.636,114
1315,GSW,2022-04-03,109,@,SAC,1,240,41,79,0.519,25,45,0.556,16,34,0.471,11,15,0.733,109,31,81,0.383,24,48,0.5,7,33,0.212,21,24,0.875,90
1316,CHI,2022-04-02,109,,MIA,0,240,37,86,0.43,28,52,0.538,9,34,0.265,26,29,0.897,109,44,82,0.537,27,48,0.563,17,34,0.5,22,27,0.815,127
1317,LAL,2022-03-31,109,@,UTA,0,240,41,83,0.494,34,58,0.586,7,25,0.28,20,28,0.714,109,46,90,0.511,31,46,0.674,15,44,0.341,15,24,0.625,122
1318,CHO,2022-03-28,109,,DEN,0,240,44,93,0.473,31,51,0.608,13,42,0.31,8,12,0.667,109,40,86,0.465,28,53,0.528,12,33,0.364,21,28,0.75,113
1319,NYK,2022-03-28,109,,CHI,1,240,38,89,0.427,26,54,0.481,12,35,0.343,21,35,0.6,109,34,79,0.43,28,56,0.5,6,23,0.261,30,33,0.909,104
1320,CHI,2022-03-24,109,@,NOP,0,240,40,78,0.513,26,44,0.591,14,34,0.412,15,19,0.789,109,41,83,0.494,29,54,0.537,12,29,0.414,32,34,0.941,126
1321,IND,2022-03-23,109,,SAC,0,240,42,91,0.462,28,55,0.509,14,36,0.389,11,11,1.0,109,43,82,0.524,31,45,0.689,12,37,0.324,12,17,0.706,110
1322,DET,2022-03-19,109,@,CLE,0,240,41,85,0.482,28,55,0.509,13,30,0.433,14,19,0.737,109,45,88,0.511,35,62,0.565,10,26,0.385,13,23,0.565,113
1323,WAS,2022-03-16,109,,DEN,0,240,41,87,0.471,36,64,0.563,5,23,0.217,22,31,0.71,109,46,90,0.511,31,53,0.585,15,37,0.405,20,21,0.952,127
1324,MIL,2022-03-12,109,@,GSW,0,240,38,92,0.413,21,48,0.438,17,44,0.386,16,23,0.696,109,45,93,0.484,27,48,0.563,18,45,0.4,14,15,0.933,122
1325,WAS,2022-03-11,109,@,LAL,0,240,39,85,0.459,30,58,0.517,9,27,0.333,22,33,0.667,109,48,91,0.527,34,60,0.567,14,31,0.452,12,17,0.706,122
1326,WAS,2022-03-09,109,@,LAC,0,240,41,87,0.471,31,60,0.517,10,27,0.37,17,20,0.85,109,43,86,0.5,27,54,0.5,16,32,0.5,13,13,1.0,115
1327,TOR,2022-03-01,109,,BRK,1,240,41,90,0.456,34,67,0.507,7,23,0.304,20,23,0.87,109,42,84,0.5,32,59,0.542,10,25,0.4,14,19,0.737,108
1328,DAL,2022-03-01,109,@,LAL,1,240,41,82,0.5,31,47,0.66,10,35,0.286,17,27,0.63,109,37,82,0.451,23,48,0.479,14,34,0.412,16,20,0.8,104
1329,NYK,2022-02-27,109,,PHI,0,240,38,85,0.447,27,52,0.519,11,33,0.333,22,35,0.629,109,38,78,0.487,28,45,0.622,10,33,0.303,39,44,0.886,125
1330,DAL,2022-02-25,109,@,UTA,0,240,42,88,0.477,25,49,0.51,17,39,0.436,8,8,1.0,109,40,74,0.541,24,36,0.667,16,38,0.421,18,22,0.818,114
1331,ORL,2022-02-16,109,,ATL,0,240,42,98,0.429,29,57,0.509,13,41,0.317,12,13,0.923,109,45,90,0.5,27,57,0.474,18,33,0.545,22,28,0.786,130
1332,NOP,2022-02-15,109,,MEM,0,240,44,88,0.5,40,62,0.645,4,26,0.154,17,20,0.85,109,47,94,0.5,37,60,0.617,10,34,0.294,17,27,0.63,121
1333,BRK,2022-02-14,109,,SAC,1,240,43,84,0.512,34,58,0.586,9,26,0.346,14,15,0.933,109,31,90,0.344,22,55,0.4,9,35,0.257,14,18,0.778,85
1334,SAS,2022-02-14,109,@,CHI,0,240,44,92,0.478,38,72,0.528,6,20,0.3,15,21,0.714,109,46,88,0.523,36,64,0.563,10,24,0.417,18,21,0.857,120
1335,TOR,2022-02-12,109,,DEN,0,240,43,88,0.489,31,54,0.574,12,34,0.353,11,17,0.647,109,39,84,0.464,25,47,0.532,14,37,0.378,18,21,0.857,110
1336,CHO,2022-02-09,109,,CHI,0,240,40,93,0.43,27,50,0.54,13,43,0.302,16,23,0.696,109,46,82,0.561,30,49,0.612,16,33,0.485,13,19,0.684,121
1337,PHI,2022-02-08,109,,PHO,0,240,41,89,0.461,31,57,0.544,10,32,0.313,17,18,0.944,109,43,95,0.453,37,69,0.536,6,26,0.231,22,24,0.917,114
1338,LAC,2022-02-08,109,@,MEM,0,240,40,89,0.449,29,58,0.5,11,31,0.355,18,24,0.75,109,53,103,0.515,44,77,0.571,9,26,0.346,20,25,0.8,135
1339,UTA,2022-01-28,109,@,MEM,0,240,37,85,0.435,20,39,0.513,17,46,0.37,18,21,0.857,109,46,82,0.561,37,59,0.627,9,23,0.391,18,24,0.75,119
1340,MIN,2022-01-25,109,@,POR,1,240,36,82,0.439,22,39,0.564,14,43,0.326,23,31,0.742,109,37,94,0.394,21,53,0.396,16,41,0.39,17,20,0.85,107
1341,UTA,2022-01-24,109,@,PHO,0,240,40,81,0.494,26,50,0.52,14,31,0.452,15,22,0.682,109,47,99,0.475,34,63,0.54,13,36,0.361,8,15,0.533,115
1342,SAS,2022-01-23,109,,PHI,0,240,42,89,0.472,32,59,0.542,10,30,0.333,15,22,0.682,109,44,92,0.478,37,76,0.487,7,16,0.438,20,23,0.87,115
1343,POR,2022-01-21,109,@,BOS,1,240,36,76,0.474,20,43,0.465,16,33,0.485,21,30,0.7,109,37,82,0.451,26,45,0.578,11,37,0.297,20,23,0.87,105
1344,TOR,2022-01-21,109,@,WAS,1,240,42,90,0.467,31,60,0.517,11,30,0.367,14,17,0.824,109,43,85,0.506,32,52,0.615,11,33,0.333,8,10,0.8,105
1345,PHO,2022-01-20,109,@,DAL,1,240,39,86,0.453,31,50,0.62,8,36,0.222,23,25,0.92,109,37,85,0.435,26,48,0.542,11,37,0.297,16,20,0.8,101
1346,PHI,2022-01-15,109,@,MIA,1,240,40,79,0.506,27,47,0.574,13,32,0.406,16,21,0.762,109,33,86,0.384,24,51,0.471,9,35,0.257,23,30,0.767,98
1347,CHO,2022-01-14,109,,ORL,0,240,40,97,0.412,28,55,0.509,12,42,0.286,17,21,0.81,109,45,87,0.517,30,42,0.714,15,45,0.333,11,15,0.733,116
1348,SAS,2022-01-14,109,,CLE,0,240,42,92,0.457,27,58,0.466,15,34,0.441,10,13,0.769,109,46,95,0.484,38,75,0.507,8,20,0.4,14,24,0.583,114
1349,BRK,2022-01-13,109,,OKC,0,240,41,98,0.418,34,66,0.515,7,32,0.219,20,22,0.909,109,47,91,0.516,27,46,0.587,20,45,0.444,16,18,0.889,130
1350,CHO,2022-01-12,109,@,PHI,1,240,46,89,0.517,36,55,0.655,10,34,0.294,7,8,0.875,109,34,73,0.466,22,43,0.512,12,30,0.4,18,28,0.643,98
1351,CLE,2022-01-10,109,@,SAC,1,240,43,87,0.494,33,53,0.623,10,34,0.294,13,15,0.867,109,39,91,0.429,25,61,0.41,14,30,0.467,16,22,0.727,108
1352,BRK,2022-01-07,109,,MIL,0,240,42,92,0.457,36,65,0.554,6,27,0.222,19,20,0.95,109,44,96,0.458,28,51,0.549,16,45,0.356,17,21,0.81,121
1353,POR,2022-01-05,109,,MIA,0,240,33,78,0.423,18,40,0.45,15,38,0.395,28,36,0.778,109,37,82,0.451,18,41,0.439,19,41,0.463,22,29,0.759,115
1354,DEN,2022-01-05,109,,UTA,0,240,42,88,0.477,31,52,0.596,11,36,0.306,14,15,0.933,109,43,92,0.467,29,51,0.569,14,41,0.341,15,18,0.833,115
1355,TOR,2021-12-28,109,,PHI,0,240,38,87,0.437,23,46,0.5,15,41,0.366,18,22,0.818,109,34,77,0.442,20,47,0.426,14,30,0.467,32,38,0.842,114
1356,DET,2021-12-26,109,@,SAS,0,240,38,98,0.388,30,66,0.455,8,32,0.25,25,34,0.735,109,51,91,0.56,38,64,0.594,13,27,0.481,29,37,0.784,144
1357,WAS,2021-12-18,109,@,UTA,1,240,42,94,0.447,33,63,0.524,9,31,0.29,16,20,0.8,109,35,81,0.432,21,37,0.568,14,44,0.318,19,30,0.633,103
1358,NOP,2021-12-10,109,,DET,1,240,41,95,0.432,28,58,0.483,13,37,0.351,14,16,0.875,109,35,90,0.389,23,53,0.434,12,37,0.324,11,12,0.917,93
1359,TOR,2021-12-08,109,,OKC,0,240,42,93,0.452,27,52,0.519,15,41,0.366,10,15,0.667,109,38,84,0.452,21,44,0.477,17,40,0.425,17,20,0.85,110
1360,SAS,2021-12-07,109,,NYK,0,240,41,92,0.446,29,61,0.475,12,31,0.387,15,20,0.75,109,43,91,0.473,25,53,0.472,18,38,0.474,17,19,0.895,121
1361,CHI,2021-12-06,109,,DEN,1,240,41,91,0.451,28,56,0.5,13,35,0.371,14,20,0.7,109,38,96,0.396,27,64,0.422,11,32,0.344,10,15,0.667,97
1362,UTA,2021-12-05,109,@,CLE,1,240,40,90,0.444,20,42,0.476,20,48,0.417,9,10,0.9,109,42,91,0.462,28,53,0.528,14,38,0.368,10,13,0.769,108
1363,BOS,2021-11-28,109,@,TOR,1,240,34,82,0.415,22,48,0.458,12,34,0.353,29,31,0.935,109,35,93,0.376,22,51,0.431,13,42,0.31,14,16,0.875,97
1364,DEN,2021-11-26,109,,MIL,0,240,40,92,0.435,23,45,0.511,17,47,0.362,12,14,0.857,109,46,73,0.63,30,40,0.75,16,33,0.485,12,20,0.6,120
1365,IND,2021-11-22,109,@,CHI,1,240,40,90,0.444,27,59,0.458,13,31,0.419,16,18,0.889,109,31,85,0.365,25,57,0.439,6,28,0.214,9,15,0.6,77
1366,CHO,2021-11-22,109,@,WAS,1,240,40,91,0.44,25,60,0.417,15,31,0.484,14,24,0.583,109,36,94,0.383,27,57,0.474,9,37,0.243,22,27,0.815,103
1367,CHI,2021-11-21,109,,NYK,1,240,37,88,0.42,26,59,0.441,11,29,0.379,24,27,0.889,109,35,84,0.417,28,57,0.491,7,27,0.259,26,31,0.839,103
1368,BRK,2021-11-17,109,,CLE,1,240,38,83,0.458,26,51,0.51,12,32,0.375,21,25,0.84,109,35,89,0.393,24,45,0.533,11,44,0.25,18,21,0.857,99
1369,MIL,2021-11-17,109,,LAL,1,240,40,87,0.46,28,50,0.56,12,37,0.324,17,24,0.708,109,40,96,0.417,28,53,0.528,12,43,0.279,10,12,0.833,102
1370,SAS,2021-11-12,109,,DAL,0,240,41,84,0.488,28,54,0.519,13,30,0.433,14,20,0.7,109,46,100,0.46,28,55,0.509,18,45,0.4,13,19,0.684,123
1371,MIA,2021-11-11,109,@,LAC,0,240,43,97,0.443,34,56,0.607,9,41,0.22,14,17,0.824,109,43,91,0.473,32,54,0.593,11,37,0.297,15,17,0.882,112
1372,PHI,2021-11-11,109,,TOR,0,240,40,88,0.455,29,54,0.537,11,34,0.324,18,19,0.947,109,42,96,0.438,28,63,0.444,14,33,0.424,17,17,1.0,115
1373,POR,2021-11-10,109,@,PHO,0,240,44,91,0.484,37,61,0.607,7,30,0.233,14,16,0.875,109,49,94,0.521,38,66,0.576,11,28,0.393,10,12,0.833,119
1374,PHI,2021-11-09,109,,MIL,0,240,42,103,0.408,28,60,0.467,14,43,0.326,11,12,0.917,109,44,95,0.463,29,56,0.518,15,39,0.385,15,21,0.714,118
1375,POR,2021-11-09,109,@,LAC,0,240,43,91,0.473,29,54,0.537,14,37,0.378,9,12,0.75,109,44,85,0.518,28,55,0.509,16,30,0.533,13,19,0.684,117
1376,PHO,2021-11-08,109,@,SAC,1,240,44,93,0.473,32,63,0.508,12,30,0.4,9,11,0.818,109,37,82,0.451,27,58,0.466,10,24,0.417,20,26,0.769,104
1377,NYK,2021-11-07,109,,CLE,0,240,39,85,0.459,30,54,0.556,9,31,0.29,22,24,0.917,109,49,90,0.544,30,55,0.545,19,35,0.543,9,11,0.818,126
1378,PHI,2021-11-04,109,@,DET,1,240,41,83,0.494,29,51,0.569,12,32,0.375,15,22,0.682,109,35,87,0.402,24,51,0.471,11,36,0.306,17,19,0.895,98
1379,DAL,2021-11-03,109,@,SAS,1,240,40,93,0.43,32,59,0.542,8,34,0.235,21,29,0.724,109,43,88,0.489,36,67,0.537,7,21,0.333,15,20,0.75,108
1380,TOR,2021-11-03,109,@,WAS,1,240,41,88,0.466,31,63,0.492,10,25,0.4,17,20,0.85,109,34,78,0.436,26,46,0.565,8,32,0.25,24,30,0.8,100
1381,NOP,2021-10-29,109,,SAC,0,240,42,98,0.429,33,64,0.516,9,34,0.265,16,25,0.64,109,40,80,0.5,31,53,0.585,9,27,0.333,24,25,0.96,113
1382,ORL,2021-10-29,109,@,TOR,0,240,41,87,0.471,25,53,0.472,16,34,0.471,11,16,0.688,109,43,86,0.5,34,56,0.607,9,30,0.3,15,22,0.682,110
1383,IND,2021-10-25,109,,MIL,0,240,40,90,0.444,26,54,0.481,14,36,0.389,15,17,0.882,109,41,85,0.482,30,53,0.566,11,32,0.344,26,31,0.839,119
1384,PHI,2021-10-22,109,,BRK,0,240,43,91,0.473,29,55,0.527,14,36,0.389,9,11,0.818,109,41,88,0.466,29,50,0.58,12,38,0.316,20,24,0.833,114
1385,WAS,2022-04-10,108,@,CHO,0,240,42,94,0.447,34,71,0.479,8,23,0.348,16,26,0.615,108,48,89,0.539,30,56,0.536,18,33,0.545,10,14,0.714,124
1386,ATL,2022-04-05,108,@,TOR,0,240,43,94,0.457,29,57,0.509,14,37,0.378,8,12,0.667,108,44,101,0.436,35,66,0.53,9,35,0.257,21,31,0.677,118
1387,CLE,2022-04-03,108,,PHI,0,240,35,78,0.449,20,45,0.444,15,33,0.455,23,31,0.742,108,33,80,0.413,22,49,0.449,11,31,0.355,35,42,0.833,112
1388,LAL,2022-03-27,108,@,NOP,0,240,42,80,0.525,28,45,0.622,14,35,0.4,10,16,0.625,108,44,91,0.484,35,64,0.547,9,27,0.333,19,24,0.792,116
1389,MIN,2022-03-21,108,@,DAL,0,240,36,91,0.396,23,55,0.418,13,36,0.361,23,29,0.793,108,40,83,0.482,26,37,0.703,14,46,0.304,16,21,0.762,110
1390,GSW,2022-03-20,108,,SAS,0,240,41,90,0.456,30,57,0.526,11,33,0.333,15,21,0.714,108,38,98,0.388,23,58,0.397,15,40,0.375,19,25,0.76,110
1391,UTA,2022-03-20,108,@,NYK,1,240,34,74,0.459,17,28,0.607,17,46,0.37,23,29,0.793,108,31,83,0.373,15,43,0.349,16,40,0.4,15,21,0.714,93
1392,DAL,2022-03-19,108,@,CHO,0,240,39,89,0.438,25,51,0.49,14,38,0.368,16,20,0.8,108,44,88,0.5,24,46,0.522,20,42,0.476,21,27,0.778,129
1393,OKC,2022-03-18,108,@,MIA,0,240,40,84,0.476,30,50,0.6,10,34,0.294,18,23,0.783,108,46,95,0.484,28,44,0.636,18,51,0.353,10,12,0.833,120
1394,ORL,2022-03-15,108,,BRK,0,240,36,95,0.379,21,54,0.389,15,41,0.366,21,27,0.778,108,53,88,0.602,37,61,0.607,16,27,0.593,28,34,0.824,150
1395,SAS,2022-03-12,108,,IND,0,240,42,102,0.412,31,68,0.456,11,34,0.324,13,16,0.813,108,45,92,0.489,31,56,0.554,14,36,0.389,15,15,1.0,119
1396,ORL,2022-03-09,108,@,NOP,1,240,36,76,0.474,22,39,0.564,14,37,0.378,22,26,0.846,108,41,93,0.441,34,62,0.548,7,31,0.226,13,18,0.722,102
1397,DET,2022-03-09,108,,CHI,0,240,42,82,0.512,31,51,0.608,11,31,0.355,13,17,0.765,108,40,76,0.526,37,61,0.607,3,15,0.2,31,35,0.886,114
1398,DET,2022-03-03,108,@,TOR,1,240,38,84,0.452,27,47,0.574,11,37,0.297,21,28,0.75,108,36,83,0.434,29,57,0.509,7,26,0.269,27,36,0.75,106
1399,NYK,2022-03-02,108,@,PHI,0,240,39,91,0.429,31,63,0.492,8,28,0.286,22,32,0.688,108,39,75,0.52,22,39,0.564,17,36,0.472,28,33,0.848,123
1400,BRK,2022-03-01,108,@,TOR,0,240,42,84,0.5,32,59,0.542,10,25,0.4,14,19,0.737,108,41,90,0.456,34,67,0.507,7,23,0.304,20,23,0.87,109
1401,ATL,2022-02-24,108,@,CHI,0,240,41,97,0.423,33,69,0.478,8,28,0.286,18,27,0.667,108,41,84,0.488,33,57,0.579,8,27,0.296,22,27,0.815,112
1402,WAS,2022-02-16,108,@,IND,0,240,39,91,0.429,22,54,0.407,17,37,0.459,13,16,0.813,108,45,83,0.542,41,63,0.651,4,20,0.2,19,29,0.655,113
1403,BOS,2022-02-11,108,,DEN,1,240,38,96,0.396,28,59,0.475,10,37,0.27,22,30,0.733,108,39,90,0.433,28,46,0.609,11,44,0.25,13,18,0.722,102
1404,CHI,2022-02-06,108,,PHI,0,240,39,81,0.481,32,55,0.582,7,26,0.269,23,26,0.885,108,45,84,0.536,33,60,0.55,12,24,0.5,17,21,0.81,119
1405,POR,2022-02-05,108,,MIL,0,240,41,85,0.482,27,40,0.675,14,45,0.311,12,21,0.571,108,49,92,0.533,26,42,0.619,23,50,0.46,16,22,0.727,137
1406,UTA,2022-02-02,108,,DEN,1,240,42,86,0.488,35,57,0.614,7,29,0.241,17,22,0.773,108,42,79,0.532,31,51,0.608,11,28,0.393,9,12,0.75,104
1407,NYK,2022-02-02,108,,MEM,0,240,38,88,0.432,26,52,0.5,12,36,0.333,20,26,0.769,108,44,102,0.431,28,63,0.444,16,39,0.41,16,23,0.696,120
1408,HOU,2022-01-31,108,,GSW,0,240,36,84,0.429,20,41,0.488,16,43,0.372,20,29,0.69,108,43,80,0.538,26,40,0.65,17,40,0.425,19,23,0.826,122
1409,DAL,2022-01-30,108,@,ORL,0,240,39,81,0.481,23,43,0.535,16,38,0.421,14,18,0.778,108,43,84,0.512,32,50,0.64,11,34,0.324,13,16,0.813,110
1410,NYK,2022-01-28,108,@,MIL,0,240,39,84,0.464,25,44,0.568,14,40,0.35,16,28,0.571,108,41,89,0.461,27,46,0.587,14,43,0.326,27,31,0.871,123
1411,ATL,2022-01-28,108,,BOS,1,240,41,89,0.461,29,58,0.5,12,31,0.387,14,20,0.7,108,30,86,0.349,23,50,0.46,7,36,0.194,25,27,0.926,92
1412,MIA,2022-01-21,108,@,ATL,0,240,41,85,0.482,26,45,0.578,15,40,0.375,11,12,0.917,108,38,68,0.559,24,35,0.686,14,33,0.424,20,24,0.833,110
1413,DET,2022-01-16,108,,PHO,0,240,38,82,0.463,29,57,0.509,9,25,0.36,23,34,0.676,108,51,87,0.586,40,60,0.667,11,27,0.407,22,30,0.733,135
1414,DAL,2022-01-15,108,,ORL,1,240,32,78,0.41,20,44,0.455,12,34,0.353,32,38,0.842,108,37,77,0.481,30,51,0.588,7,26,0.269,11,16,0.688,92
1415,ATL,2022-01-15,108,,NYK,0,240,40,80,0.5,24,36,0.667,16,44,0.364,12,17,0.706,108,42,83,0.506,29,52,0.558,13,31,0.419,20,26,0.769,117
1416,POR,2022-01-13,108,@,DEN,0,240,39,86,0.453,26,46,0.565,13,40,0.325,17,28,0.607,108,52,83,0.627,31,41,0.756,21,42,0.5,15,20,0.75,140
1417,MIN,2022-01-13,108,@,MEM,0,240,41,96,0.427,26,48,0.542,15,48,0.313,11,14,0.786,108,42,92,0.457,34,60,0.567,8,32,0.25,24,35,0.686,116
1418,NYK,2022-01-12,108,,DAL,1,240,42,90,0.467,30,63,0.476,12,27,0.444,12,15,0.8,108,32,78,0.41,24,41,0.585,8,37,0.216,13,19,0.684,85
1419,GSW,2022-01-11,108,@,MEM,0,240,35,82,0.427,22,46,0.478,13,36,0.361,25,29,0.862,108,44,100,0.44,30,66,0.455,14,34,0.412,14,18,0.778,116
1420,SAC,2022-01-10,108,,CLE,0,240,39,91,0.429,25,61,0.41,14,30,0.467,16,22,0.727,108,43,87,0.494,33,53,0.623,10,34,0.294,13,15,0.867,109
1421,BRK,2022-01-10,108,@,POR,0,240,42,91,0.462,30,59,0.508,12,32,0.375,12,15,0.8,108,40,86,0.465,25,48,0.521,15,38,0.395,19,26,0.731,114
1422,LAC,2022-01-08,108,,MEM,0,240,39,96,0.406,29,64,0.453,10,32,0.313,20,24,0.833,108,44,100,0.44,32,62,0.516,12,38,0.316,23,31,0.742,123
1423,UTA,2022-01-07,108,@,TOR,0,240,39,81,0.481,22,43,0.512,17,38,0.447,13,18,0.722,108,45,100,0.45,33,59,0.559,12,41,0.293,20,25,0.8,122
1424,NYK,2022-01-06,108,,BOS,1,240,40,90,0.444,22,54,0.407,18,36,0.5,10,15,0.667,108,38,80,0.475,21,35,0.6,17,45,0.378,12,13,0.923,105
1425,ATL,2022-01-05,108,@,SAC,1,240,39,86,0.453,31,56,0.554,8,30,0.267,22,30,0.733,108,38,90,0.422,27,63,0.429,11,27,0.407,15,20,0.75,102
1426,MIA,2022-01-03,108,@,GSW,0,240,37,90,0.411,20,48,0.417,17,42,0.405,17,19,0.895,108,45,92,0.489,31,54,0.574,14,38,0.368,11,13,0.846,115
1427,LAL,2022-01-02,108,,MIN,1,240,36,75,0.48,23,34,0.676,13,41,0.317,23,29,0.793,108,41,92,0.446,32,54,0.593,9,38,0.237,12,16,0.75,103
1428,CLE,2022-01-02,108,,IND,1,240,41,88,0.466,35,62,0.565,6,26,0.231,20,28,0.714,108,37,83,0.446,18,37,0.486,19,46,0.413,11,14,0.786,104
1429,CHI,2021-12-31,108,@,IND,1,240,35,86,0.407,23,59,0.39,12,27,0.444,26,30,0.867,108,38,91,0.418,30,60,0.5,8,31,0.258,22,29,0.759,106
1430,PHO,2021-12-31,108,@,BOS,0,240,41,100,0.41,30,65,0.462,11,35,0.314,15,16,0.938,108,45,83,0.542,35,56,0.625,10,27,0.37,23,26,0.885,123
1431,LAC,2021-12-31,108,@,TOR,0,240,38,78,0.487,23,44,0.523,15,34,0.441,17,19,0.895,108,40,96,0.417,29,61,0.475,11,35,0.314,25,33,0.758,116
1432,MIN,2021-12-31,108,@,UTA,0,240,40,93,0.43,26,52,0.5,14,41,0.341,14,22,0.636,108,37,78,0.474,26,49,0.531,11,29,0.379,35,41,0.854,120
1433,IND,2021-12-29,108,,CHO,0,240,36,86,0.419,19,41,0.463,17,45,0.378,19,29,0.655,108,44,85,0.518,35,59,0.593,9,26,0.346,19,32,0.594,116
1434,NOP,2021-12-28,108,,CLE,1,240,36,80,0.45,20,44,0.455,16,36,0.444,20,26,0.769,108,37,88,0.42,23,47,0.489,14,41,0.341,16,19,0.842,104
1435,MIN,2021-12-27,108,,BOS,1,240,40,90,0.444,26,56,0.464,14,34,0.412,14,19,0.737,108,33,89,0.371,17,42,0.405,16,47,0.34,21,28,0.75,103
1436,LAC,2021-12-27,108,,BRK,0,240,37,97,0.381,23,60,0.383,14,37,0.378,20,27,0.741,108,50,88,0.568,37,54,0.685,13,34,0.382,11,16,0.688,124
1437,OKC,2021-12-22,108,,DEN,1,240,42,94,0.447,34,60,0.567,8,34,0.235,16,19,0.842,108,33,84,0.393,20,40,0.5,13,44,0.295,15,26,0.577,94
1438,PHO,2021-12-21,108,@,LAL,1,240,41,93,0.441,29,52,0.558,12,41,0.293,14,15,0.933,108,34,87,0.391,27,52,0.519,7,35,0.2,15,23,0.652,90
1439,PHI,2021-12-20,108,@,BOS,1,240,36,72,0.5,26,47,0.553,10,25,0.4,26,31,0.839,108,38,82,0.463,31,55,0.564,7,27,0.259,20,25,0.8,103
1440,MEM,2021-12-09,108,,LAL,1,240,41,94,0.436,27,52,0.519,14,42,0.333,12,18,0.667,108,36,78,0.462,24,48,0.5,12,30,0.4,11,17,0.647,95
1441,PHO,2021-12-06,108,,SAS,1,240,43,94,0.457,33,65,0.508,10,29,0.345,12,18,0.667,108,40,93,0.43,29,64,0.453,11,29,0.379,13,19,0.684,104
1442,NOP,2021-12-05,108,@,HOU,0,240,40,94,0.426,30,56,0.536,10,38,0.263,18,25,0.72,108,39,79,0.494,22,39,0.564,17,40,0.425,23,29,0.793,118
1443,CLE,2021-12-05,108,,UTA,0,240,42,91,0.462,28,53,0.528,14,38,0.368,10,13,0.769,108,40,90,0.444,20,42,0.476,20,48,0.417,9,10,0.9,109
1444,ORL,2021-12-01,108,,DEN,1,240,44,81,0.543,38,54,0.704,6,27,0.222,14,19,0.737,108,39,80,0.488,29,46,0.63,10,34,0.294,15,21,0.714,103
1445,BOS,2021-11-22,108,,HOU,1,240,39,92,0.424,27,57,0.474,12,35,0.343,18,19,0.947,108,31,83,0.373,20,41,0.488,11,42,0.262,17,24,0.708,90
1446,ORL,2021-11-20,108,@,MIL,0,240,39,98,0.398,20,47,0.426,19,51,0.373,11,14,0.786,108,37,82,0.451,18,42,0.429,19,40,0.475,24,37,0.649,117
1447,DEN,2021-11-19,108,,CHI,0,240,39,82,0.476,25,45,0.556,14,37,0.378,16,20,0.8,108,41,93,0.441,33,62,0.532,8,31,0.258,24,24,1.0,114
1448,TOR,2021-11-19,108,@,SAC,1,240,38,84,0.452,26,53,0.491,12,31,0.387,20,24,0.833,108,32,84,0.381,23,47,0.489,9,37,0.243,16,25,0.64,89
1449,LAL,2021-11-19,108,@,BOS,0,240,39,84,0.464,27,54,0.5,12,30,0.4,18,24,0.75,108,44,88,0.5,33,58,0.569,11,30,0.367,31,38,0.816,130
1450,LAC,2021-11-18,108,@,MEM,0,240,42,90,0.467,26,51,0.51,16,39,0.41,8,8,1.0,108,52,96,0.542,41,70,0.586,11,26,0.423,5,6,0.833,120
1451,MEM,2021-11-10,108,,CHO,0,240,45,107,0.421,36,69,0.522,9,38,0.237,9,15,0.6,108,41,90,0.456,26,54,0.481,15,36,0.417,21,24,0.875,118
1452,OKC,2021-11-10,108,@,NOP,1,240,37,87,0.425,27,53,0.509,10,34,0.294,24,30,0.8,108,34,97,0.351,25,62,0.403,9,35,0.257,23,32,0.719,100
1453,DAL,2021-11-08,108,,NOP,1,240,43,85,0.506,29,50,0.58,14,35,0.4,8,13,0.615,108,37,87,0.425,28,53,0.528,9,34,0.265,9,11,0.818,92
1454,ATL,2021-11-03,108,@,BRK,0,240,41,94,0.436,28,59,0.475,13,35,0.371,13,15,0.867,108,43,88,0.489,21,40,0.525,22,48,0.458,9,12,0.75,117
1455,MEM,2021-11-03,108,,DEN,1,240,42,81,0.519,26,47,0.553,16,34,0.471,8,14,0.571,108,43,91,0.473,35,64,0.547,8,27,0.296,12,13,0.923,106
1456,SAS,2021-11-03,108,,DAL,0,240,43,88,0.489,36,67,0.537,7,21,0.333,15,20,0.75,108,40,93,0.43,32,59,0.542,8,34,0.235,21,29,0.724,109
1457,MIL,2021-10-27,108,,MIN,0,240,39,95,0.411,25,44,0.568,14,51,0.275,16,21,0.762,108,43,91,0.473,30,46,0.652,13,45,0.289,14,17,0.824,113
1458,TOR,2021-10-25,108,,CHI,0,240,40,83,0.482,28,53,0.528,12,30,0.4,16,20,0.8,108,39,81,0.481,27,54,0.5,12,27,0.444,21,22,0.955,111
1459,NOP,2022-04-10,107,,GSW,0,240,42,99,0.424,28,59,0.475,14,40,0.35,9,12,0.75,107,49,81,0.605,30,48,0.625,19,33,0.576,11,13,0.846,128
1460,CLE,2022-04-08,107,@,BRK,0,240,40,82,0.488,32,55,0.582,8,27,0.296,19,24,0.792,107,43,92,0.467,31,60,0.517,12,32,0.375,20,21,0.952,118
1461,UTA,2022-04-02,107,@,GSW,0,240,38,89,0.427,23,43,0.535,15,46,0.326,16,22,0.727,107,40,84,0.476,20,36,0.556,20,48,0.417,11,12,0.917,111
1462,CLE,2022-03-31,107,@,ATL,0,240,39,90,0.433,32,60,0.533,7,30,0.233,22,28,0.786,107,45,91,0.495,28,52,0.538,17,39,0.436,24,28,0.857,131
1463,PHO,2022-03-30,107,@,GSW,1,240,38,92,0.413,31,64,0.484,7,28,0.25,24,30,0.8,107,35,83,0.422,22,45,0.489,13,38,0.342,20,25,0.8,103
1464,POR,2022-03-30,107,,NOP,0,240,39,85,0.459,25,43,0.581,14,42,0.333,15,18,0.833,107,40,78,0.513,34,54,0.63,6,24,0.25,31,39,0.795,117
1465,CHI,2022-03-29,107,@,WAS,1,240,43,85,0.506,37,67,0.552,6,18,0.333,15,18,0.833,107,38,79,0.481,32,53,0.604,6,26,0.231,12,17,0.706,94
1466,CLE,2022-03-28,107,,ORL,1,240,37,83,0.446,24,42,0.571,13,41,0.317,20,23,0.87,107,42,87,0.483,32,50,0.64,10,37,0.27,7,13,0.538,101
1467,OKC,2022-03-26,107,@,DEN,0,240,39,84,0.464,25,48,0.521,14,36,0.389,15,16,0.938,107,41,85,0.482,33,54,0.611,8,31,0.258,23,24,0.958,113
1468,SAS,2022-03-26,107,@,NOP,1,240,39,92,0.424,32,66,0.485,7,26,0.269,22,25,0.88,107,40,90,0.444,30,58,0.517,10,32,0.313,13,19,0.684,103
1469,CHO,2022-03-25,107,,UTA,1,240,41,88,0.466,28,54,0.519,13,34,0.382,12,17,0.706,107,38,84,0.452,21,37,0.568,17,47,0.362,8,11,0.727,101
1470,NYK,2022-03-13,107,@,BRK,0,240,39,83,0.47,28,54,0.519,11,29,0.379,18,21,0.857,107,44,89,0.494,38,60,0.633,6,29,0.207,16,22,0.727,110
1471,NYK,2022-03-09,107,@,DAL,1,240,36,84,0.429,27,50,0.54,9,34,0.265,26,33,0.788,107,27,86,0.314,21,42,0.5,6,44,0.136,17,25,0.68,77
1472,BRK,2022-03-03,107,,MIA,0,240,39,83,0.47,27,52,0.519,12,31,0.387,17,22,0.773,107,40,77,0.519,30,47,0.638,10,30,0.333,23,28,0.821,113
1473,MEM,2022-03-03,107,@,BOS,0,240,42,99,0.424,29,59,0.492,13,40,0.325,10,13,0.769,107,46,89,0.517,30,52,0.577,16,37,0.432,12,15,0.8,120
1474,DEN,2022-03-02,107,,OKC,0,240,40,90,0.444,28,44,0.636,12,46,0.261,15,17,0.882,107,44,87,0.506,28,58,0.483,16,29,0.552,15,21,0.714,119
1475,BOS,2022-03-01,107,,ATL,1,240,39,83,0.47,28,48,0.583,11,35,0.314,18,19,0.947,107,36,83,0.434,29,52,0.558,7,31,0.226,19,24,0.792,98
1476,DAL,2022-02-27,107,@,GSW,1,240,39,78,0.5,26,44,0.591,13,34,0.382,16,20,0.8,107,39,91,0.429,28,52,0.538,11,39,0.282,12,20,0.6,101
1477,BOS,2022-02-27,107,@,IND,0,240,39,91,0.429,27,48,0.563,12,43,0.279,17,20,0.85,107,47,90,0.522,30,57,0.526,17,33,0.515,17,20,0.85,128
1478,CHO,2022-02-17,107,,MIA,0,290,38,95,0.4,28,53,0.528,10,42,0.238,21,30,0.7,107,41,102,0.402,27,54,0.5,14,48,0.292,15,23,0.652,111
1479,DAL,2022-02-15,107,@,MIA,1,240,34,76,0.447,16,35,0.457,18,41,0.439,21,33,0.636,107,35,84,0.417,28,57,0.491,7,27,0.259,22,27,0.815,99
1480,MIL,2022-02-14,107,,POR,0,240,38,89,0.427,25,48,0.521,13,41,0.317,18,24,0.75,107,45,99,0.455,27,56,0.482,18,43,0.419,14,19,0.737,122
1481,MIL,2022-02-10,107,@,PHO,0,240,40,88,0.455,30,50,0.6,10,38,0.263,17,25,0.68,107,51,90,0.567,42,60,0.7,9,30,0.3,20,29,0.69,131
1482,DET,2022-02-10,107,,MEM,0,240,41,94,0.436,34,59,0.576,7,35,0.2,18,21,0.857,107,44,92,0.478,29,62,0.468,15,30,0.5,29,42,0.69,132
1483,POR,2022-02-09,107,,LAL,1,240,42,89,0.472,32,57,0.561,10,32,0.313,13,16,0.813,107,41,74,0.554,24,37,0.649,17,37,0.459,6,13,0.462,105
1484,HOU,2022-02-06,107,,NOP,0,240,40,84,0.476,24,39,0.615,16,45,0.356,11,16,0.688,107,41,77,0.532,29,48,0.604,12,29,0.414,26,36,0.722,120
1485,DAL,2022-02-04,107,,PHI,1,240,39,85,0.459,29,51,0.569,10,34,0.294,19,23,0.826,107,36,70,0.514,27,43,0.628,9,27,0.333,17,23,0.739,98
1486,CHO,2022-02-02,107,@,BOS,0,240,37,87,0.425,25,47,0.532,12,40,0.3,21,27,0.778,107,42,82,0.512,28,46,0.609,14,36,0.389,15,17,0.882,113
1487,BOS,2022-01-29,107,@,NOP,1,240,43,81,0.531,29,40,0.725,14,41,0.341,7,11,0.636,107,36,82,0.439,28,50,0.56,8,32,0.25,17,23,0.739,97
1488,POR,2022-01-25,107,,MIN,0,240,37,94,0.394,21,53,0.396,16,41,0.39,17,20,0.85,107,36,82,0.439,22,39,0.564,14,43,0.326,23,31,0.742,109
1489,NOP,2022-01-25,107,@,PHI,0,240,40,83,0.482,31,61,0.508,9,22,0.409,18,26,0.692,107,39,84,0.464,29,53,0.547,10,31,0.323,29,31,0.935,117
1490,LAL,2022-01-23,107,@,MIA,0,240,36,79,0.456,25,39,0.641,11,40,0.275,24,30,0.8,107,40,81,0.494,25,48,0.521,15,33,0.455,18,20,0.9,113
1491,SAS,2022-01-17,107,,PHO,0,240,41,92,0.446,32,62,0.516,9,30,0.3,16,22,0.727,107,49,95,0.516,40,63,0.635,9,32,0.281,14,20,0.7,121
1492,BRK,2022-01-17,107,@,CLE,0,240,41,83,0.494,29,53,0.547,12,30,0.4,13,18,0.722,107,42,81,0.519,31,49,0.633,11,32,0.344,19,21,0.905,114
1493,CLE,2022-01-15,107,@,OKC,1,240,40,87,0.46,31,52,0.596,9,35,0.257,18,25,0.72,107,36,83,0.434,26,56,0.464,10,27,0.37,20,22,0.909,102
1494,PHO,2021-12-25,107,,GSW,0,240,40,83,0.482,29,53,0.547,11,30,0.367,16,16,1.0,107,42,85,0.494,28,48,0.583,14,37,0.378,18,21,0.857,116
1495,DEN,2021-12-23,107,,CHO,0,240,40,96,0.417,26,56,0.464,14,40,0.35,13,17,0.765,107,39,94,0.415,23,47,0.489,16,47,0.34,21,24,0.875,115
1496,NYK,2021-12-18,107,@,BOS,0,240,35,80,0.438,22,44,0.5,13,36,0.361,24,30,0.8,107,42,89,0.472,25,44,0.568,17,45,0.378,13,17,0.765,114
1497,DET,2021-12-18,107,,HOU,0,240,43,93,0.462,33,57,0.579,10,36,0.278,11,16,0.688,107,46,93,0.495,32,55,0.582,14,38,0.368,10,17,0.588,116
1498,BOS,2021-12-17,107,,GSW,0,240,36,82,0.439,21,41,0.512,15,41,0.366,20,29,0.69,107,39,90,0.433,23,44,0.523,16,46,0.348,17,21,0.81,111
1499,DEN,2021-12-15,107,,MIN,0,240,38,84,0.452,24,45,0.533,14,39,0.359,17,23,0.739,107,45,88,0.511,22,40,0.55,23,48,0.479,11,16,0.688,124
1500,LAL,2021-12-15,107,@,DAL,1,265,39,90,0.433,24,51,0.471,15,39,0.385,14,18,0.778,107,39,98,0.398,27,54,0.5,12,44,0.273,14,17,0.824,104
1501,POR,2021-12-14,107,,PHO,0,265,40,96,0.417,27,55,0.491,13,41,0.317,14,22,0.636,107,44,93,0.473,33,62,0.532,11,31,0.355,12,15,0.8,111
1502,WAS,2021-12-13,107,@,DEN,0,240,41,90,0.456,29,56,0.518,12,34,0.353,13,21,0.619,107,37,79,0.468,27,47,0.574,10,32,0.313,29,33,0.879,113
1503,BRK,2021-12-04,107,,CHI,0,240,46,111,0.414,38,86,0.442,8,25,0.32,7,9,0.778,107,41,86,0.477,31,55,0.564,10,31,0.323,19,27,0.704,111
1504,GSW,2021-12-04,107,,SAS,0,240,40,90,0.444,27,51,0.529,13,39,0.333,14,21,0.667,107,42,88,0.477,30,53,0.566,12,35,0.343,16,19,0.842,112
1505,NOP,2021-12-03,107,@,DAL,1,240,37,90,0.411,25,60,0.417,12,30,0.4,21,28,0.75,107,32,79,0.405,22,45,0.489,10,34,0.294,17,26,0.654,91
1506,NOP,2021-12-01,107,,DAL,0,240,40,89,0.449,27,52,0.519,13,37,0.351,14,16,0.875,107,57,83,0.687,39,49,0.796,18,34,0.529,7,9,0.778,139
1507,MIN,2021-12-01,107,@,WAS,0,240,37,88,0.42,26,51,0.51,11,37,0.297,22,26,0.846,107,45,91,0.495,35,59,0.593,10,32,0.313,15,21,0.714,115
1508,POR,2021-11-29,107,@,UTA,0,240,42,91,0.462,31,60,0.517,11,31,0.355,12,17,0.706,107,47,89,0.528,28,43,0.651,19,46,0.413,16,23,0.696,129
1509,BRK,2021-11-27,107,,PHO,0,240,42,84,0.5,35,61,0.574,7,23,0.304,16,21,0.762,107,41,92,0.446,28,54,0.519,13,38,0.342,18,21,0.857,113
1510,MIA,2021-11-27,107,@,CHI,1,240,37,86,0.43,23,46,0.5,14,40,0.35,19,22,0.864,107,38,81,0.469,27,42,0.643,11,39,0.282,17,21,0.81,104
1511,LAC,2021-11-26,107,,DET,1,240,39,91,0.429,28,53,0.528,11,38,0.289,18,19,0.947,107,33,90,0.367,25,57,0.439,8,33,0.242,22,26,0.846,96
1512,CHI,2021-11-17,107,@,POR,0,240,39,83,0.47,26,54,0.481,13,29,0.448,16,20,0.8,107,37,84,0.44,26,53,0.491,11,31,0.355,27,28,0.964,112
1513,MIN,2021-11-17,107,,SAC,1,240,41,82,0.5,31,46,0.674,10,36,0.278,15,18,0.833,107,34,93,0.366,24,55,0.436,10,38,0.263,19,25,0.76,97
1514,DET,2021-11-15,107,,SAC,0,240,39,96,0.406,26,49,0.531,13,47,0.277,16,17,0.941,107,52,98,0.531,36,65,0.554,16,33,0.485,9,11,0.818,129
1515,MIN,2021-11-12,107,@,LAL,1,240,43,94,0.457,31,57,0.544,12,37,0.324,9,12,0.75,107,29,82,0.354,20,41,0.488,9,41,0.22,16,20,0.8,83
1516,DAL,2021-11-10,107,@,CHI,0,240,38,83,0.458,26,50,0.52,12,33,0.364,19,24,0.792,107,45,89,0.506,30,58,0.517,15,31,0.484,12,14,0.857,117
1517,ORL,2021-11-07,107,,UTA,1,240,43,87,0.494,31,55,0.564,12,32,0.375,9,11,0.818,107,34,89,0.382,26,47,0.553,8,42,0.19,24,29,0.828,100
1518,HOU,2021-11-07,107,@,GSW,0,240,36,79,0.456,26,46,0.565,10,33,0.303,25,37,0.676,107,44,85,0.518,29,39,0.744,15,46,0.326,17,20,0.85,120
1519,DAL,2021-11-06,107,,BOS,1,240,41,78,0.526,28,39,0.718,13,39,0.333,12,14,0.857,107,42,86,0.488,33,55,0.6,9,31,0.29,11,16,0.688,104
1520,OKC,2021-11-04,107,@,LAL,1,240,37,87,0.425,22,46,0.478,15,41,0.366,18,26,0.692,107,39,94,0.415,27,61,0.443,12,33,0.364,14,17,0.824,104
1521,CLE,2021-11-03,107,,POR,1,240,39,74,0.527,24,44,0.545,15,30,0.5,14,18,0.778,107,40,90,0.444,27,53,0.509,13,37,0.351,11,17,0.647,104
1522,UTA,2021-10-31,107,@,MIL,1,240,35,75,0.467,23,38,0.605,12,37,0.324,25,27,0.926,107,39,96,0.406,27,55,0.491,12,41,0.293,5,6,0.833,95
1523,CHI,2021-10-30,107,,UTA,1,240,39,91,0.429,34,70,0.486,5,21,0.238,24,30,0.8,107,35,92,0.38,24,54,0.444,11,38,0.289,18,19,0.947,99
1524,PHO,2021-10-27,107,,SAC,0,240,42,93,0.452,36,71,0.507,6,22,0.273,17,24,0.708,107,42,95,0.442,27,57,0.474,15,38,0.395,11,15,0.733,110
1525,BOS,2021-10-27,107,,WAS,0,240,37,85,0.435,27,56,0.482,10,29,0.345,23,28,0.821,107,43,84,0.512,34,59,0.576,9,25,0.36,21,29,0.724,116
1526,NOP,2021-10-25,107,@,MIN,1,240,39,87,0.448,29,57,0.509,10,30,0.333,19,23,0.826,107,31,90,0.344,16,40,0.4,15,50,0.3,21,27,0.778,98
1527,MIA,2021-10-25,107,,ORL,1,240,41,87,0.471,35,60,0.583,6,27,0.222,19,19,1.0,107,33,81,0.407,21,37,0.568,12,44,0.273,12,19,0.632,90
1528,SAC,2021-10-24,107,,GSW,0,240,42,86,0.488,27,40,0.675,15,46,0.326,8,13,0.615,107,43,97,0.443,30,60,0.5,13,37,0.351,20,24,0.833,119
1529,BOS,2021-10-24,107,@,HOU,1,240,38,86,0.442,23,39,0.59,15,47,0.319,16,20,0.8,107,32,75,0.427,18,43,0.419,14,32,0.438,19,24,0.792,97
1530,UTA,2021-10-20,107,,OKC,1,240,40,91,0.44,26,44,0.591,14,47,0.298,13,15,0.867,107,34,91,0.374,27,56,0.482,7,35,0.2,11,18,0.611,86
1531,DET,2022-04-10,106,@,PHI,0,240,38,83,0.458,27,49,0.551,11,34,0.324,19,29,0.655,106,46,88,0.523,41,63,0.651,5,25,0.2,21,23,0.913,118
1532,CHI,2022-04-05,106,,MIL,0,240,42,98,0.429,33,65,0.508,9,33,0.273,13,13,1.0,106,46,87,0.529,34,52,0.654,12,35,0.343,23,25,0.92,127
1533,MIA,2022-03-30,106,@,BOS,1,240,38,79,0.481,25,45,0.556,13,34,0.382,17,25,0.68,106,35,85,0.412,24,48,0.5,11,37,0.297,17,23,0.739,98
1534,POR,2022-03-25,106,,HOU,0,240,43,85,0.506,40,65,0.615,3,20,0.15,17,23,0.739,106,43,83,0.518,24,38,0.632,19,45,0.422,20,23,0.87,125
1535,CHO,2022-03-23,106,,NYK,0,240,42,89,0.472,29,43,0.674,13,46,0.283,9,17,0.529,106,43,83,0.518,23,38,0.605,20,45,0.444,15,17,0.882,121
1536,MIA,2022-03-21,106,@,PHI,0,240,38,80,0.475,28,47,0.596,10,33,0.303,20,20,1.0,106,43,86,0.5,28,49,0.571,15,37,0.405,12,16,0.75,113
1537,CHO,2022-03-21,106,,NOP,1,240,40,79,0.506,27,42,0.643,13,37,0.351,13,15,0.867,106,40,90,0.444,31,66,0.47,9,24,0.375,14,16,0.875,103
1538,UTA,2022-03-21,106,@,BRK,0,240,37,83,0.446,23,44,0.523,14,39,0.359,18,22,0.818,106,45,83,0.542,34,53,0.642,11,30,0.367,13,15,0.867,114
1539,ATL,2022-03-16,106,@,CHO,0,240,40,93,0.43,27,56,0.482,13,37,0.351,13,14,0.929,106,43,87,0.494,32,52,0.615,11,35,0.314,19,23,0.826,116
1540,LAC,2022-03-13,106,@,DET,1,240,40,89,0.449,30,59,0.508,10,30,0.333,16,20,0.8,106,36,80,0.45,24,51,0.471,12,29,0.414,18,20,0.9,102
1541,LAC,2022-03-11,106,@,ATL,0,240,40,82,0.488,28,50,0.56,12,32,0.375,14,17,0.824,106,43,90,0.478,34,59,0.576,9,31,0.29,17,19,0.895,112
1542,DEN,2022-03-09,106,@,SAC,1,240,40,82,0.488,31,47,0.66,9,35,0.257,17,19,0.895,106,38,85,0.447,26,51,0.51,12,34,0.353,12,18,0.667,100
1543,HOU,2022-03-07,106,@,MIA,0,240,39,88,0.443,26,45,0.578,13,43,0.302,15,22,0.682,106,49,91,0.538,35,60,0.583,14,31,0.452,11,14,0.786,123
1544,CHI,2022-03-07,106,@,PHI,0,240,39,87,0.448,31,63,0.492,8,24,0.333,20,26,0.769,106,41,84,0.488,29,54,0.537,12,30,0.4,27,34,0.794,121
1545,IND,2022-03-04,106,@,DET,0,240,39,100,0.39,29,60,0.483,10,40,0.25,18,28,0.643,106,42,94,0.447,27,64,0.422,15,30,0.5,12,18,0.667,111
1546,TOR,2022-03-03,106,,DET,0,240,36,83,0.434,29,57,0.509,7,26,0.269,27,36,0.75,106,38,84,0.452,27,47,0.574,11,37,0.297,21,28,0.75,108
1547,CHO,2022-02-28,106,@,MIL,0,240,36,93,0.387,22,54,0.407,14,39,0.359,20,32,0.625,106,40,91,0.44,22,46,0.478,18,45,0.4,32,37,0.865,130
1548,BRK,2022-02-24,106,,BOS,0,240,39,94,0.415,32,65,0.492,7,29,0.241,21,28,0.75,106,46,85,0.541,29,43,0.674,17,42,0.405,20,27,0.741,129
1549,DET,2022-02-24,106,,CLE,1,240,35,86,0.407,24,52,0.462,11,34,0.324,25,28,0.893,106,34,77,0.442,22,42,0.524,12,35,0.343,23,34,0.676,103
1550,NYK,2022-02-16,106,,BRK,0,240,37,85,0.435,21,42,0.5,16,43,0.372,16,18,0.889,106,43,98,0.439,32,64,0.5,11,34,0.324,14,23,0.609,111
1551,OKC,2022-02-16,106,,SAS,0,240,41,105,0.39,30,73,0.411,11,32,0.344,13,19,0.684,106,43,98,0.439,33,64,0.516,10,34,0.294,18,22,0.818,114
1552,LAL,2022-02-16,106,,UTA,1,240,41,86,0.477,31,50,0.62,10,36,0.278,14,22,0.636,106,37,79,0.468,26,46,0.565,11,33,0.333,16,19,0.842,101
1553,CHI,2022-02-12,106,,OKC,1,240,40,89,0.449,33,64,0.516,7,25,0.28,19,23,0.826,106,34,88,0.386,23,52,0.442,11,36,0.306,22,30,0.733,101
1554,HOU,2022-02-04,106,@,SAS,0,240,36,83,0.434,25,50,0.5,11,33,0.333,23,29,0.793,106,51,89,0.573,38,61,0.623,13,28,0.464,16,20,0.8,131
1555,WAS,2022-02-02,106,@,PHI,1,240,41,90,0.456,32,68,0.471,9,22,0.409,15,19,0.789,106,41,91,0.451,30,64,0.469,11,27,0.407,10,13,0.769,103
1556,MIA,2022-02-01,106,@,TOR,0,240,38,78,0.487,30,48,0.625,8,30,0.267,22,25,0.88,106,39,81,0.481,27,55,0.491,12,26,0.462,20,29,0.69,110
1557,TOR,2022-01-31,106,@,ATL,1,240,38,89,0.427,20,53,0.377,18,36,0.5,12,17,0.706,106,37,81,0.457,25,49,0.51,12,32,0.375,14,16,0.875,100
1558,UTA,2022-01-30,106,@,MIN,0,240,38,81,0.469,23,41,0.561,15,40,0.375,15,21,0.714,106,49,89,0.551,36,58,0.621,13,31,0.419,15,18,0.833,126
1559,BRK,2022-01-29,106,@,GSW,0,240,39,98,0.398,28,70,0.4,11,28,0.393,17,21,0.81,106,40,98,0.408,26,53,0.491,14,45,0.311,16,18,0.889,110
1560,LAL,2022-01-25,106,@,BRK,1,240,42,89,0.472,30,51,0.588,12,38,0.316,10,10,1.0,106,37,88,0.42,30,61,0.492,7,27,0.259,15,22,0.682,96
1561,CHI,2022-01-17,106,@,MEM,0,240,40,92,0.435,27,61,0.443,13,31,0.419,13,15,0.867,106,47,92,0.511,37,67,0.552,10,25,0.4,15,20,0.75,119
1562,ORL,2022-01-12,106,@,WAS,0,240,41,99,0.414,30,64,0.469,11,35,0.314,13,16,0.813,106,43,82,0.524,33,51,0.647,10,31,0.323,16,21,0.762,112
1563,LAC,2022-01-09,106,,ATL,1,240,44,92,0.478,32,59,0.542,12,33,0.364,6,7,0.857,106,35,78,0.449,28,52,0.538,7,26,0.269,16,19,0.842,93
1564,MIL,2022-01-08,106,@,CHO,0,240,35,90,0.389,23,53,0.434,12,37,0.324,24,26,0.923,106,44,99,0.444,28,51,0.549,16,48,0.333,10,17,0.588,114
1565,HOU,2022-01-07,106,,DAL,0,240,37,87,0.425,25,44,0.568,12,43,0.279,20,29,0.69,106,49,90,0.544,32,52,0.615,17,38,0.447,15,28,0.536,130
1566,PHO,2022-01-06,106,,LAC,1,240,44,107,0.411,34,76,0.447,10,31,0.323,8,10,0.8,106,31,86,0.36,25,58,0.431,6,28,0.214,21,25,0.84,89
1567,ORL,2022-01-05,106,,PHI,0,240,40,90,0.444,28,51,0.549,12,39,0.308,14,20,0.7,106,43,85,0.506,31,57,0.544,12,28,0.429,18,24,0.75,116
1568,CLE,2022-01-04,106,,MEM,0,240,40,92,0.435,30,58,0.517,10,34,0.294,16,21,0.762,106,42,90,0.467,33,63,0.524,9,27,0.333,17,22,0.773,110
1569,MIL,2022-01-03,106,,DET,0,240,39,92,0.424,28,46,0.609,11,46,0.239,17,22,0.773,106,44,91,0.484,26,48,0.542,18,43,0.419,9,14,0.643,115
1570,POR,2021-12-31,106,@,LAL,0,240,36,102,0.353,24,60,0.4,12,42,0.286,22,27,0.815,106,47,85,0.553,28,44,0.636,19,41,0.463,26,30,0.867,139
1571,IND,2021-12-31,106,,CHI,0,240,38,91,0.418,30,60,0.5,8,31,0.258,22,29,0.759,106,35,86,0.407,23,59,0.39,12,27,0.444,26,30,0.867,108
1572,HOU,2021-12-23,106,@,IND,0,240,35,80,0.438,20,43,0.465,15,37,0.405,21,26,0.808,106,46,88,0.523,33,50,0.66,13,38,0.342,13,19,0.684,118
1573,HOU,2021-12-22,106,@,MIL,0,240,36,86,0.419,23,41,0.561,13,45,0.289,21,31,0.677,106,45,103,0.437,28,57,0.491,17,46,0.37,19,21,0.905,126
1574,CHO,2021-12-19,106,@,PHO,0,240,36,100,0.36,26,55,0.473,10,45,0.222,24,28,0.857,106,54,95,0.568,34,54,0.63,20,41,0.488,9,13,0.692,137
1575,LAL,2021-12-12,106,,ORL,1,240,41,84,0.488,28,56,0.5,13,28,0.464,11,17,0.647,106,33,88,0.375,20,50,0.4,13,38,0.342,15,19,0.789,94
1576,LAC,2021-12-11,106,,ORL,1,240,42,92,0.457,24,56,0.429,18,36,0.5,4,6,0.667,106,35,80,0.438,23,47,0.489,12,33,0.364,22,24,0.917,104
1577,HOU,2021-12-11,106,@,MEM,0,240,38,77,0.494,27,44,0.614,11,33,0.333,19,29,0.655,106,40,80,0.5,29,51,0.569,11,29,0.379,22,36,0.611,113
1578,MIN,2021-12-10,106,,CLE,0,240,36,92,0.391,25,53,0.472,11,39,0.282,23,28,0.821,106,46,85,0.541,33,52,0.635,13,33,0.394,18,22,0.818,123
1579,IND,2021-12-10,106,,DAL,1,240,41,87,0.471,28,51,0.549,13,36,0.361,11,12,0.917,106,39,84,0.464,35,55,0.636,4,29,0.138,11,12,0.917,93
1580,CHO,2021-12-08,106,,PHI,0,240,39,80,0.488,29,51,0.569,10,29,0.345,18,21,0.857,106,36,75,0.48,23,41,0.561,13,34,0.382,25,30,0.833,110
1581,DET,2021-11-28,106,@,LAL,0,240,38,89,0.427,25,56,0.446,13,33,0.394,17,19,0.895,106,43,86,0.5,34,54,0.63,9,32,0.281,15,25,0.6,110
1582,CHO,2021-11-24,106,@,ORL,1,240,39,93,0.419,27,53,0.509,12,40,0.3,16,21,0.762,106,38,93,0.409,23,51,0.451,15,42,0.357,8,10,0.8,99
1583,SAS,2021-11-24,106,,ATL,0,240,43,100,0.43,31,67,0.463,12,33,0.364,8,10,0.8,106,45,88,0.511,33,62,0.532,12,26,0.462,22,24,0.917,124
1584,NYK,2021-11-23,106,,LAL,1,240,37,82,0.451,22,48,0.458,15,34,0.441,17,21,0.81,106,34,91,0.374,23,55,0.418,11,36,0.306,21,30,0.7,100
1585,NYK,2021-11-20,106,,HOU,1,240,33,78,0.423,15,37,0.405,18,41,0.439,22,26,0.846,106,38,84,0.452,28,45,0.622,10,39,0.256,13,22,0.591,99
1586,LAC,2021-11-16,106,,SAS,1,240,37,85,0.435,25,47,0.532,12,38,0.316,20,22,0.909,106,41,95,0.432,36,73,0.493,5,22,0.227,5,7,0.714,92
1587,SAS,2021-11-14,106,@,LAL,0,240,40,90,0.444,24,54,0.444,16,36,0.444,10,15,0.667,106,43,83,0.518,28,52,0.538,15,31,0.484,13,17,0.765,114
1588,CHO,2021-11-14,106,,GSW,1,240,42,88,0.477,28,52,0.538,14,36,0.389,8,12,0.667,106,38,90,0.422,29,51,0.569,9,39,0.231,17,25,0.68,102
1589,CHO,2021-11-07,106,@,LAC,0,240,41,101,0.406,31,68,0.456,10,33,0.303,14,18,0.778,106,41,86,0.477,23,38,0.605,18,48,0.375,20,21,0.952,120
1590,IND,2021-11-05,106,@,POR,0,240,43,88,0.489,29,46,0.63,14,42,0.333,6,10,0.6,106,40,82,0.488,23,43,0.535,17,39,0.436,13,15,0.867,110
1591,DEN,2021-11-03,106,@,MEM,0,240,43,91,0.473,35,64,0.547,8,27,0.296,12,13,0.923,106,42,81,0.519,26,47,0.553,16,34,0.471,8,14,0.571,108
1592,MEM,2021-11-01,106,,DEN,1,240,44,97,0.454,31,63,0.492,13,34,0.382,5,7,0.714,106,39,88,0.443,30,50,0.6,9,38,0.237,10,15,0.667,97
1593,DEN,2021-10-29,106,,DAL,1,240,43,83,0.518,32,47,0.681,11,36,0.306,9,13,0.692,106,23,78,0.295,15,41,0.366,8,37,0.216,21,27,0.778,75
1594,MIA,2021-10-27,106,@,BRK,1,240,38,96,0.396,30,67,0.448,8,29,0.276,22,26,0.846,106,33,85,0.388,19,42,0.452,14,43,0.326,13,14,0.929,93
1595,GSW,2021-10-26,106,@,OKC,1,240,39,83,0.47,25,43,0.581,14,40,0.35,14,18,0.778,106,36,86,0.419,24,52,0.462,12,34,0.353,14,17,0.824,98
1596,HOU,2021-10-26,106,@,DAL,0,240,36,86,0.419,20,47,0.426,16,39,0.41,18,26,0.692,106,43,93,0.462,31,50,0.62,12,43,0.279,18,25,0.72,116
1597,HOU,2021-10-20,106,@,MIN,0,240,40,88,0.455,29,55,0.527,11,33,0.333,15,22,0.682,106,42,87,0.483,26,49,0.531,16,38,0.421,24,31,0.774,124
1598,NYK,2022-04-10,105,,TOR,1,240,40,87,0.46,25,44,0.568,15,43,0.349,10,12,0.833,105,36,92,0.391,24,50,0.48,12,42,0.286,10,11,0.909,94
1599,UTA,2022-04-08,105,,PHO,0,240,35,88,0.398,24,50,0.48,11,38,0.289,24,33,0.727,105,46,92,0.5,40,73,0.548,6,19,0.316,13,15,0.867,111
1600,HOU,2022-04-05,105,@,BRK,0,240,40,99,0.404,29,56,0.518,11,43,0.256,14,25,0.56,105,39,86,0.453,24,49,0.49,15,37,0.405,25,27,0.926,118
1601,MEM,2022-03-18,105,@,ATL,0,240,40,86,0.465,32,64,0.5,8,22,0.364,17,23,0.739,105,45,91,0.495,32,63,0.508,13,28,0.464,17,21,0.81,120
1602,MIA,2022-03-15,105,,DET,1,240,29,72,0.403,17,39,0.436,12,33,0.364,35,39,0.897,105,37,80,0.463,27,46,0.587,10,34,0.294,14,22,0.636,98
1603,HOU,2022-03-13,105,@,NOP,0,240,39,77,0.506,27,46,0.587,12,31,0.387,15,25,0.6,105,48,93,0.516,38,61,0.623,10,32,0.313,24,34,0.706,130
1604,CLE,2022-03-11,105,@,MIA,0,240,35,79,0.443,27,54,0.5,8,25,0.32,27,29,0.931,105,41,86,0.477,30,51,0.588,11,35,0.314,24,27,0.889,117
1605,SAS,2022-02-28,105,@,MEM,0,240,41,99,0.414,32,67,0.478,9,32,0.281,14,19,0.737,105,48,89,0.539,37,63,0.587,11,26,0.423,11,19,0.579,118
1606,LAC,2022-02-25,105,@,LAL,1,240,41,83,0.494,31,57,0.544,10,26,0.385,13,19,0.684,105,39,93,0.419,31,62,0.5,8,31,0.258,16,21,0.762,102
1607,BOS,2022-02-13,105,,ATL,1,240,36,85,0.424,25,47,0.532,11,38,0.289,22,27,0.815,105,34,93,0.366,22,55,0.4,12,38,0.316,15,15,1.0,95
1608,ORL,2022-02-12,105,@,PHO,0,240,37,87,0.425,22,46,0.478,15,41,0.366,16,24,0.667,105,55,105,0.524,40,71,0.563,15,34,0.441,7,10,0.7,132
1609,LAC,2022-02-10,105,@,DAL,0,240,39,81,0.481,30,58,0.517,9,23,0.391,18,25,0.72,105,38,78,0.487,25,39,0.641,13,39,0.333,23,27,0.852,112
1610,CLE,2022-02-09,105,,SAS,1,240,39,82,0.476,30,61,0.492,9,21,0.429,18,24,0.75,105,38,99,0.384,30,66,0.455,8,33,0.242,8,11,0.727,92
1611,LAL,2022-02-09,105,@,POR,0,240,41,74,0.554,24,37,0.649,17,37,0.459,6,13,0.462,105,42,89,0.472,32,57,0.561,10,32,0.313,13,16,0.813,107
1612,DET,2022-02-06,105,@,MIN,0,240,40,95,0.421,28,63,0.444,12,32,0.375,13,19,0.684,105,42,91,0.462,25,55,0.455,17,36,0.472,17,21,0.81,118
1613,DEN,2022-02-04,105,,NOP,0,240,35,78,0.449,16,37,0.432,19,41,0.463,16,17,0.941,105,42,75,0.56,34,50,0.68,8,25,0.32,21,23,0.913,113
1614,CLE,2022-01-30,105,@,DET,0,240,38,82,0.463,25,48,0.521,13,34,0.382,16,25,0.64,105,42,91,0.462,32,65,0.492,10,26,0.385,21,25,0.84,115
1615,IND,2022-01-29,105,@,DAL,0,240,40,91,0.44,31,58,0.534,9,33,0.273,16,23,0.696,105,51,96,0.531,35,62,0.565,16,34,0.471,14,22,0.636,132
1616,NOP,2022-01-28,105,,DEN,0,240,35,90,0.389,30,56,0.536,5,34,0.147,30,33,0.909,105,41,82,0.5,29,49,0.592,12,33,0.364,22,25,0.88,116
1617,PHI,2022-01-27,105,,LAL,1,240,41,82,0.5,28,47,0.596,13,35,0.371,10,17,0.588,105,36,88,0.409,30,59,0.508,6,29,0.207,9,9,1.0,87
1618,TOR,2022-01-26,105,@,CHI,0,240,38,79,0.481,26,48,0.542,12,31,0.387,17,28,0.607,105,46,84,0.548,39,58,0.672,7,26,0.269,12,16,0.75,111
1619,PHO,2022-01-26,105,@,UTA,1,240,40,82,0.488,33,64,0.516,7,18,0.389,18,27,0.667,105,34,79,0.43,22,49,0.449,12,30,0.4,17,23,0.739,97
1620,DET,2022-01-25,105,,DEN,0,240,41,97,0.423,29,61,0.475,12,36,0.333,11,14,0.786,105,36,84,0.429,25,52,0.481,11,32,0.344,27,31,0.871,110
1621,TOR,2022-01-23,105,,POR,0,240,39,98,0.398,21,44,0.477,18,54,0.333,9,14,0.643,105,45,85,0.529,27,53,0.509,18,32,0.563,6,13,0.462,114
1622,GSW,2022-01-21,105,,HOU,1,240,39,81,0.481,29,51,0.569,10,30,0.333,17,22,0.773,105,38,89,0.427,28,54,0.519,10,35,0.286,17,20,0.85,103
1623,BOS,2022-01-21,105,,POR,0,240,37,82,0.451,26,45,0.578,11,37,0.297,20,23,0.87,105,36,76,0.474,20,43,0.465,16,33,0.485,21,30,0.7,109
1624,WAS,2022-01-21,105,,TOR,0,240,43,85,0.506,32,52,0.615,11,33,0.333,8,10,0.8,105,42,90,0.467,31,60,0.517,11,30,0.367,14,17,0.824,109
1625,ORL,2022-01-21,105,,LAL,0,240,36,81,0.444,25,41,0.61,11,40,0.275,22,29,0.759,105,42,85,0.494,29,55,0.527,13,30,0.433,19,23,0.826,116
1626,NOP,2022-01-15,105,@,BRK,0,240,40,87,0.46,31,56,0.554,9,31,0.29,16,24,0.667,105,46,84,0.548,34,57,0.596,12,27,0.444,16,17,0.941,120
1627,TOR,2022-01-09,105,,NOP,1,240,36,85,0.424,22,51,0.431,14,34,0.412,19,20,0.95,105,34,75,0.453,22,42,0.524,12,33,0.364,21,25,0.84,101
1628,OKC,2022-01-07,105,,MIN,0,240,36,89,0.404,21,45,0.467,15,44,0.341,18,23,0.783,105,50,90,0.556,33,49,0.673,17,41,0.415,18,25,0.72,135
1629,BOS,2022-01-06,105,@,NYK,0,240,38,80,0.475,21,35,0.6,17,45,0.378,12,13,0.923,105,40,90,0.444,22,54,0.407,18,36,0.5,10,15,0.667,108
1630,NYK,2022-01-02,105,@,TOR,0,240,35,78,0.449,23,42,0.548,12,36,0.333,23,28,0.821,105,41,86,0.477,28,52,0.538,13,34,0.382,25,30,0.833,120
1631,SAS,2021-12-31,105,@,MEM,0,240,39,90,0.433,27,55,0.491,12,35,0.343,15,24,0.625,105,49,102,0.48,39,76,0.513,10,26,0.385,10,16,0.625,118
1632,POR,2021-12-29,105,,UTA,0,240,37,88,0.42,23,48,0.479,14,40,0.35,17,24,0.708,105,46,87,0.529,38,58,0.655,8,29,0.276,20,32,0.625,120
1633,IND,2021-12-26,105,@,CHI,0,240,41,94,0.436,33,64,0.516,8,30,0.267,15,21,0.714,105,43,76,0.566,32,53,0.604,11,23,0.478,16,22,0.727,113
1634,LAC,2021-12-22,105,@,SAC,1,240,42,82,0.512,35,58,0.603,7,24,0.292,14,16,0.875,105,34,85,0.4,22,47,0.468,12,38,0.316,9,12,0.75,89
1635,NYK,2021-12-21,105,,DET,1,240,40,90,0.444,29,57,0.509,11,33,0.333,14,19,0.737,105,34,94,0.362,26,61,0.426,8,33,0.242,15,19,0.789,91
1636,POR,2021-12-19,105,@,MEM,1,240,35,74,0.473,24,42,0.571,11,32,0.344,24,28,0.857,105,35,91,0.385,26,57,0.456,9,34,0.265,21,25,0.84,100
1637,DAL,2021-12-19,105,@,MIN,0,240,36,82,0.439,24,41,0.585,12,41,0.293,21,22,0.955,105,36,77,0.468,21,43,0.488,15,34,0.441,24,31,0.774,111
1638,SAC,2021-12-17,105,,MEM,0,240,36,88,0.409,23,53,0.434,13,35,0.371,20,26,0.769,105,45,97,0.464,32,73,0.438,13,24,0.542,21,27,0.778,124
1639,ORL,2021-12-17,105,,MIA,0,240,43,89,0.483,32,57,0.561,11,32,0.344,8,10,0.8,105,41,82,0.5,22,47,0.468,19,35,0.543,14,19,0.737,115
1640,PHI,2021-12-16,105,@,BRK,0,240,39,89,0.438,29,55,0.527,10,34,0.294,17,20,0.85,105,44,89,0.494,33,66,0.5,11,23,0.478,15,16,0.938,114
1641,WAS,2021-12-15,105,@,SAC,0,240,42,89,0.472,37,65,0.569,5,24,0.208,16,21,0.762,105,45,82,0.549,37,56,0.661,8,26,0.308,21,29,0.724,119
1642,GSW,2021-12-14,105,@,NYK,1,240,35,77,0.455,20,37,0.541,15,40,0.375,20,27,0.741,105,30,83,0.361,14,41,0.341,16,42,0.381,20,22,0.909,96
1643,CLE,2021-12-13,105,,MIA,1,240,36,81,0.444,20,45,0.444,16,36,0.444,17,18,0.944,105,38,85,0.447,25,45,0.556,13,40,0.325,5,9,0.556,94
1644,ATL,2021-12-10,105,,BRK,0,240,37,94,0.394,26,60,0.433,11,34,0.324,20,24,0.833,105,46,93,0.495,40,70,0.571,6,23,0.261,15,16,0.938,113
1645,MEM,2021-12-06,105,@,MIA,1,240,38,89,0.427,25,56,0.446,13,33,0.394,16,21,0.762,105,35,76,0.461,29,54,0.537,6,22,0.273,14,17,0.824,90
1646,MIN,2021-12-03,105,@,BRK,0,240,36,93,0.387,23,51,0.451,13,42,0.31,20,24,0.833,105,36,76,0.474,30,53,0.566,6,23,0.261,32,41,0.78,110
1647,GSW,2021-11-28,105,@,LAC,1,240,38,86,0.442,21,46,0.457,17,40,0.425,12,22,0.545,105,32,80,0.4,23,52,0.442,9,28,0.321,17,25,0.68,90
1648,NOP,2021-11-27,105,@,UTA,0,240,40,93,0.43,32,58,0.552,8,35,0.229,17,21,0.81,105,45,80,0.563,25,45,0.556,20,35,0.571,17,22,0.773,127
1649,CLE,2021-11-27,105,,ORL,1,240,41,90,0.456,27,51,0.529,14,39,0.359,9,12,0.75,105,35,88,0.398,27,56,0.482,8,32,0.25,14,23,0.609,92
1650,OKC,2021-11-20,105,@,BOS,0,240,39,96,0.406,21,54,0.389,18,42,0.429,9,16,0.563,105,41,88,0.466,24,49,0.49,17,39,0.436,12,14,0.857,111
1651,CHO,2021-11-20,105,@,ATL,0,240,43,102,0.422,33,62,0.532,10,40,0.25,9,15,0.6,105,43,82,0.524,31,48,0.646,12,34,0.353,17,21,0.81,115
1652,SAC,2021-11-20,105,,UTA,0,240,41,91,0.451,31,60,0.517,10,31,0.323,13,21,0.619,105,46,91,0.505,29,52,0.558,17,39,0.436,14,17,0.824,123
1653,GSW,2021-11-19,105,@,DET,1,240,38,80,0.475,26,50,0.52,12,30,0.4,17,21,0.81,105,32,80,0.4,18,38,0.474,14,42,0.333,24,30,0.8,102
1654,PHO,2021-11-17,105,,DAL,1,240,41,93,0.441,28,54,0.519,13,39,0.333,10,14,0.714,105,38,91,0.418,22,59,0.373,16,32,0.5,6,6,1.0,98
1655,WAS,2021-11-15,105,,NOP,1,240,39,84,0.464,29,56,0.518,10,28,0.357,17,25,0.68,105,30,74,0.405,19,53,0.358,11,21,0.524,29,34,0.853,100
1656,UTA,2021-11-13,105,,MIA,0,240,35,85,0.412,18,32,0.563,17,53,0.321,18,25,0.72,105,42,85,0.494,29,52,0.558,13,33,0.394,14,16,0.875,111
1657,DEN,2021-11-12,105,,ATL,1,240,40,90,0.444,30,55,0.545,10,35,0.286,15,20,0.75,105,38,93,0.409,33,65,0.508,5,28,0.179,15,21,0.714,96
1658,OKC,2021-11-12,105,,SAC,1,240,42,99,0.424,32,69,0.464,10,30,0.333,11,15,0.733,105,38,95,0.4,24,54,0.444,14,41,0.341,13,17,0.765,103
1659,CHI,2021-11-06,105,,PHI,0,240,37,92,0.402,30,63,0.476,7,29,0.241,24,30,0.8,105,43,81,0.531,30,55,0.545,13,26,0.5,15,19,0.789,114
1660,POR,2021-11-06,105,,LAL,1,240,36,95,0.379,21,40,0.525,15,55,0.273,18,24,0.75,105,31,90,0.344,22,58,0.379,9,32,0.281,19,24,0.792,90
1661,DAL,2021-10-31,105,,SAC,1,240,40,90,0.444,28,53,0.528,12,37,0.324,13,20,0.65,105,38,96,0.396,31,60,0.517,7,36,0.194,16,20,0.8,99
1662,BRK,2021-10-29,105,,IND,1,240,34,76,0.447,28,50,0.56,6,26,0.231,31,41,0.756,105,37,93,0.398,29,64,0.453,8,29,0.276,16,23,0.696,98
1663,PHO,2021-10-23,105,@,POR,0,240,43,89,0.483,34,61,0.557,9,28,0.321,10,15,0.667,105,51,94,0.543,30,44,0.682,21,50,0.42,11,17,0.647,134
1664,LAL,2021-10-22,105,,PHO,0,240,34,86,0.395,19,52,0.365,15,34,0.441,22,29,0.759,105,42,86,0.488,32,54,0.593,10,32,0.313,21,28,0.75,115
1665,CHI,2022-03-28,104,@,NYK,0,240,34,79,0.43,28,56,0.5,6,23,0.261,30,33,0.909,104,38,89,0.427,26,54,0.481,12,35,0.343,21,35,0.6,109
1666,PHI,2022-03-27,104,@,PHO,0,240,37,89,0.416,27,53,0.509,10,36,0.278,20,26,0.769,104,45,87,0.517,32,60,0.533,13,27,0.481,11,17,0.647,114
1667,NYK,2022-03-27,104,@,DET,1,240,34,85,0.4,21,44,0.477,13,41,0.317,23,29,0.793,104,39,85,0.459,31,56,0.554,8,29,0.276,16,18,0.889,102
1668,CLE,2022-03-24,104,@,TOR,0,240,37,79,0.468,25,49,0.51,12,30,0.4,18,22,0.818,104,42,89,0.472,26,52,0.5,16,37,0.432,17,19,0.895,117
1669,MIA,2022-03-23,104,,GSW,0,240,37,85,0.435,23,49,0.469,14,36,0.389,16,21,0.762,104,40,77,0.519,25,41,0.61,15,36,0.417,23,27,0.852,118
1670,DEN,2022-03-20,104,,BOS,0,240,35,87,0.402,21,48,0.438,14,39,0.359,20,25,0.8,104,47,82,0.573,28,42,0.667,19,40,0.475,11,11,1.0,124
1671,LAL,2022-03-16,104,@,MIN,0,240,39,93,0.419,29,49,0.592,10,44,0.227,16,23,0.696,104,40,90,0.444,23,48,0.479,17,42,0.405,27,31,0.871,124
1672,MIA,2022-03-12,104,,MIN,0,240,35,88,0.398,20,43,0.465,15,45,0.333,19,25,0.76,104,35,83,0.422,20,41,0.488,15,42,0.357,28,32,0.875,113
1673,SAS,2022-03-11,104,,UTA,1,240,34,85,0.4,28,56,0.5,6,29,0.207,30,43,0.698,104,37,92,0.402,24,52,0.462,13,40,0.325,15,23,0.652,102
1674,SAS,2022-03-09,104,,TOR,0,240,38,84,0.452,29,52,0.558,9,32,0.281,19,20,0.95,104,41,85,0.482,30,55,0.545,11,30,0.367,26,28,0.929,119
1675,CLE,2022-03-06,104,,TOR,1,240,39,85,0.459,28,49,0.571,11,36,0.306,15,23,0.652,104,37,94,0.394,31,70,0.443,6,24,0.25,16,26,0.615,96
1676,LAL,2022-03-01,104,,DAL,0,240,37,82,0.451,23,48,0.479,14,34,0.412,16,20,0.8,104,41,82,0.5,31,47,0.66,10,35,0.286,17,27,0.63,109
1677,DET,2022-02-26,104,,BOS,0,240,39,87,0.448,32,60,0.533,7,27,0.259,19,22,0.864,104,42,88,0.477,32,62,0.516,10,26,0.385,19,21,0.905,113
1678,OKC,2022-02-24,104,,PHO,0,240,44,93,0.473,38,62,0.613,6,31,0.194,10,11,0.909,104,46,86,0.535,33,52,0.635,13,34,0.382,19,21,0.905,124
1679,GSW,2022-02-14,104,@,LAC,0,240,39,86,0.453,23,45,0.511,16,41,0.39,10,13,0.769,104,48,85,0.565,33,51,0.647,15,34,0.441,8,15,0.533,119
1680,NYK,2022-02-07,104,@,UTA,0,240,36,95,0.379,28,62,0.452,8,33,0.242,24,35,0.686,104,39,93,0.419,27,45,0.6,12,48,0.25,23,27,0.852,113
1681,BRK,2022-02-06,104,@,DEN,0,240,36,87,0.414,20,46,0.435,16,41,0.39,16,22,0.727,104,49,94,0.521,39,62,0.629,10,32,0.313,16,21,0.762,124
1682,MIA,2022-02-05,104,@,CHO,1,240,38,91,0.418,27,59,0.458,11,32,0.344,17,18,0.944,104,33,86,0.384,23,50,0.46,10,36,0.278,10,16,0.625,86
1683,DEN,2022-02-02,104,@,UTA,0,240,42,79,0.532,31,51,0.608,11,28,0.393,9,12,0.75,104,42,86,0.488,35,57,0.614,7,29,0.241,17,22,0.773,108
1684,CLE,2022-02-02,104,@,HOU,0,240,41,80,0.513,34,59,0.576,7,21,0.333,15,27,0.556,104,39,82,0.476,25,42,0.595,14,40,0.35,23,33,0.697,115
1685,SAC,2022-01-26,104,@,ATL,0,240,39,93,0.419,27,53,0.509,12,40,0.3,14,19,0.737,104,48,90,0.533,36,54,0.667,12,36,0.333,13,17,0.765,121
1686,HOU,2022-01-25,104,,SAS,0,240,39,95,0.411,30,61,0.492,9,34,0.265,17,25,0.68,104,58,101,0.574,46,69,0.667,12,32,0.375,6,6,1.0,134
1687,DAL,2022-01-23,104,,MEM,1,240,36,74,0.486,27,44,0.614,9,30,0.3,23,31,0.742,104,37,99,0.374,33,75,0.44,4,24,0.167,13,19,0.684,91
1688,LAL,2022-01-19,104,,IND,0,240,40,90,0.444,29,56,0.518,11,34,0.324,13,18,0.722,104,44,90,0.489,33,60,0.55,11,30,0.367,12,15,0.8,111
1689,MIA,2022-01-19,104,,POR,1,240,37,80,0.463,25,45,0.556,12,35,0.343,18,25,0.72,104,33,81,0.407,19,35,0.543,14,46,0.304,12,16,0.75,92
1690,CLE,2022-01-19,104,@,CHI,0,240,40,77,0.519,31,50,0.62,9,27,0.333,15,22,0.682,104,47,86,0.547,37,64,0.578,10,22,0.455,13,18,0.722,117
1691,BOS,2022-01-17,104,,NOP,1,240,38,80,0.475,28,48,0.583,10,32,0.313,18,20,0.9,104,36,87,0.414,27,57,0.474,9,30,0.3,11,18,0.611,92
1692,MIA,2022-01-17,104,,TOR,1,240,38,83,0.458,29,59,0.492,9,24,0.375,19,22,0.864,104,37,90,0.411,24,54,0.444,13,36,0.361,12,17,0.706,99
1693,DAL,2022-01-17,104,,OKC,1,240,35,88,0.398,23,51,0.451,12,37,0.324,22,28,0.786,104,36,83,0.434,25,48,0.521,11,35,0.314,19,24,0.792,102
1694,NYK,2022-01-04,104,,IND,1,240,39,80,0.488,33,52,0.635,6,28,0.214,20,28,0.714,104,32,76,0.421,23,38,0.605,9,38,0.237,21,32,0.656,94
1695,SAS,2022-01-04,104,@,TOR,0,240,41,95,0.432,32,60,0.533,9,35,0.257,13,19,0.684,104,45,96,0.469,27,52,0.519,18,44,0.409,21,29,0.724,129
1696,BRK,2022-01-03,104,,MEM,0,240,37,82,0.451,28,51,0.549,9,31,0.29,21,26,0.808,104,48,102,0.471,38,67,0.567,10,35,0.286,12,21,0.571,118
1697,LAC,2022-01-03,104,,MIN,0,240,39,78,0.5,28,46,0.609,11,32,0.344,15,17,0.882,104,49,93,0.527,33,48,0.688,16,45,0.356,8,9,0.889,122
1698,NOP,2022-01-03,104,,UTA,0,240,39,97,0.402,27,51,0.529,12,46,0.261,14,22,0.636,104,41,85,0.482,22,46,0.478,19,39,0.487,14,17,0.824,115
1699,IND,2022-01-02,104,@,CLE,0,240,37,83,0.446,18,37,0.486,19,46,0.413,11,14,0.786,104,41,88,0.466,35,62,0.565,6,26,0.231,20,28,0.714,108
1700,MEM,2021-12-29,104,,LAL,1,240,35,85,0.412,25,55,0.455,10,30,0.333,24,29,0.828,104,39,86,0.453,24,45,0.533,15,41,0.366,6,8,0.75,99
1701,CLE,2021-12-28,104,@,NOP,0,240,37,88,0.42,23,47,0.489,14,41,0.341,16,19,0.842,104,36,80,0.45,20,44,0.455,16,36,0.444,20,26,0.769,108
1702,SAS,2021-12-27,104,,UTA,0,240,45,100,0.45,35,70,0.5,10,30,0.333,4,9,0.444,104,39,86,0.453,30,55,0.545,9,31,0.29,23,30,0.767,110
1703,MEM,2021-12-23,104,@,GSW,0,240,38,90,0.422,30,64,0.469,8,26,0.308,20,24,0.833,104,40,82,0.488,21,42,0.5,19,40,0.475,14,18,0.778,113
1704,ORL,2021-12-23,104,,NOP,0,240,38,88,0.432,29,56,0.518,9,32,0.281,19,21,0.905,104,37,86,0.43,24,56,0.429,13,30,0.433,23,26,0.885,110
1705,ORL,2021-12-22,104,@,ATL,1,240,38,85,0.447,27,48,0.563,11,37,0.297,17,23,0.739,104,32,80,0.4,20,49,0.408,12,31,0.387,22,29,0.759,98
1706,OKC,2021-12-18,104,,LAC,1,240,43,92,0.467,31,61,0.508,12,31,0.387,6,10,0.6,104,37,83,0.446,21,44,0.477,16,39,0.41,13,19,0.684,103
1707,DAL,2021-12-15,104,,LAL,0,265,39,98,0.398,27,54,0.5,12,44,0.273,14,17,0.824,104,39,90,0.433,24,51,0.471,15,39,0.385,14,18,0.778,107
1708,DET,2021-12-12,104,,BRK,0,240,39,92,0.424,25,55,0.455,14,37,0.378,12,18,0.667,104,41,87,0.471,30,59,0.508,11,28,0.393,23,25,0.92,116
1709,ORL,2021-12-11,104,@,LAC,0,240,35,80,0.438,23,47,0.489,12,33,0.364,22,24,0.917,104,42,92,0.457,24,56,0.429,18,36,0.5,4,6,0.667,106
1710,BRK,2021-12-08,104,@,HOU,0,240,35,89,0.393,27,56,0.482,8,33,0.242,26,31,0.839,104,40,81,0.494,26,40,0.65,14,41,0.341,20,29,0.69,114
1711,GSW,2021-12-08,104,,POR,1,240,33,83,0.398,19,37,0.514,14,46,0.304,24,31,0.774,104,33,80,0.413,25,50,0.5,8,30,0.267,20,28,0.714,94
1712,MIL,2021-12-08,104,@,MIA,0,240,36,85,0.424,24,46,0.522,12,39,0.308,20,27,0.741,104,40,77,0.519,18,30,0.6,22,47,0.468,11,12,0.917,113
1713,DAL,2021-12-08,104,@,MEM,1,240,37,77,0.481,25,44,0.568,12,33,0.364,18,23,0.783,104,36,90,0.4,27,59,0.458,9,31,0.29,15,25,0.6,96
1714,MIN,2021-12-08,104,,UTA,0,240,38,95,0.4,21,48,0.438,17,47,0.362,11,17,0.647,104,50,88,0.568,25,34,0.735,25,54,0.463,11,15,0.733,136
1715,CLE,2021-12-06,104,@,MIL,0,240,35,90,0.389,20,44,0.455,15,46,0.326,19,20,0.95,104,40,86,0.465,27,54,0.5,13,32,0.406,19,24,0.792,112
1716,SAS,2021-12-06,104,@,PHO,0,240,40,93,0.43,29,64,0.453,11,29,0.379,13,19,0.684,104,43,94,0.457,33,65,0.508,10,29,0.345,12,18,0.667,108
1717,SAC,2021-12-04,104,,LAC,1,240,36,86,0.419,24,52,0.462,12,34,0.353,20,25,0.8,104,34,89,0.382,21,55,0.382,13,34,0.382,18,27,0.667,99
1718,IND,2021-12-03,104,,MIA,0,240,35,80,0.438,26,44,0.591,9,36,0.25,25,33,0.758,104,43,81,0.531,27,47,0.574,16,34,0.471,11,13,0.846,113
1719,PHO,2021-11-30,104,,GSW,1,240,43,87,0.494,31,57,0.544,12,30,0.4,6,11,0.545,104,36,86,0.419,22,46,0.478,14,40,0.35,10,14,0.714,96
1720,LAC,2021-11-29,104,,NOP,0,240,37,72,0.514,23,36,0.639,14,36,0.389,16,21,0.762,104,48,94,0.511,34,59,0.576,14,35,0.4,13,16,0.813,123
1721,CHI,2021-11-27,104,,MIA,0,240,38,81,0.469,27,42,0.643,11,39,0.282,17,21,0.81,104,37,86,0.43,23,46,0.5,14,40,0.35,19,22,0.864,107
1722,BOS,2021-11-24,104,,BRK,0,240,34,91,0.374,23,43,0.535,11,48,0.229,25,28,0.893,104,43,85,0.506,29,50,0.58,14,35,0.4,23,30,0.767,123
1723,OKC,2021-11-24,104,,UTA,0,240,37,82,0.451,22,46,0.478,15,36,0.417,15,22,0.682,104,39,86,0.453,24,39,0.615,15,47,0.319,17,20,0.85,110
1724,LAC,2021-11-23,104,,DAL,0,265,35,85,0.412,25,53,0.472,10,32,0.313,24,29,0.828,104,39,89,0.438,27,50,0.54,12,39,0.308,22,27,0.815,112
1725,TOR,2021-11-21,104,@,GSW,0,240,39,99,0.394,24,62,0.387,15,37,0.405,11,20,0.55,104,39,79,0.494,17,34,0.5,22,45,0.489,19,24,0.792,119
1726,DAL,2021-11-19,104,@,PHO,0,240,37,90,0.411,25,50,0.5,12,40,0.3,18,23,0.783,104,44,85,0.518,30,56,0.536,14,29,0.483,10,14,0.714,112
1727,GSW,2021-11-18,104,@,CLE,1,240,41,83,0.494,26,40,0.65,15,43,0.349,7,8,0.875,104,34,80,0.425,22,41,0.537,12,39,0.308,9,16,0.563,89
1728,ORL,2021-11-17,104,@,NYK,1,240,39,96,0.406,28,58,0.483,11,38,0.289,15,18,0.833,104,37,88,0.42,21,39,0.538,16,49,0.327,8,12,0.667,98
1729,WAS,2021-11-13,104,@,ORL,1,240,42,84,0.5,30,49,0.612,12,35,0.343,8,10,0.8,104,31,92,0.337,18,52,0.346,13,40,0.325,17,20,0.85,92
1730,CHO,2021-11-12,104,,NYK,1,240,39,90,0.433,29,54,0.537,10,36,0.278,16,24,0.667,104,36,93,0.387,23,58,0.397,13,35,0.371,11,18,0.611,96
1731,POR,2021-11-12,104,@,HOU,1,240,34,87,0.391,23,51,0.451,11,36,0.306,25,31,0.806,104,34,85,0.4,27,53,0.509,7,32,0.219,17,27,0.63,92
1732,BOS,2021-11-10,104,,TOR,1,240,42,94,0.447,32,65,0.492,10,29,0.345,10,15,0.667,104,33,77,0.429,27,52,0.519,6,25,0.24,16,19,0.842,88
1733,HOU,2021-11-10,104,,DET,0,240,35,82,0.427,23,48,0.479,12,34,0.353,22,34,0.647,104,42,97,0.433,26,49,0.531,16,48,0.333,12,18,0.667,112
1734,SAC,2021-11-08,104,,PHO,0,240,37,82,0.451,27,58,0.466,10,24,0.417,20,26,0.769,104,44,93,0.473,32,63,0.508,12,30,0.4,9,11,0.818,109
1735,BOS,2021-11-06,104,@,DAL,0,240,42,86,0.488,33,55,0.6,9,31,0.29,11,16,0.688,104,41,78,0.526,28,39,0.718,13,39,0.333,12,14,0.857,107
1736,LAC,2021-11-05,104,@,MIN,1,240,36,88,0.409,30,60,0.5,6,28,0.214,26,32,0.813,104,31,89,0.348,14,37,0.378,17,52,0.327,5,7,0.714,84
1737,LAL,2021-11-04,104,,OKC,0,240,39,94,0.415,27,61,0.443,12,33,0.364,14,17,0.824,104,37,87,0.425,22,46,0.478,15,41,0.366,18,26,0.692,107
1738,POR,2021-11-03,104,@,CLE,0,240,40,90,0.444,27,53,0.509,13,37,0.351,11,17,0.647,104,39,74,0.527,24,44,0.545,15,30,0.5,14,18,0.778,107
1739,NYK,2021-11-01,104,,TOR,0,240,35,76,0.461,19,38,0.5,16,38,0.421,18,24,0.75,104,43,99,0.434,29,57,0.509,14,42,0.333,13,14,0.929,113
1740,DAL,2021-10-28,104,,SAS,1,240,41,89,0.461,23,44,0.523,18,45,0.4,4,13,0.308,104,39,88,0.443,27,58,0.466,12,30,0.4,9,15,0.6,99
1741,NYK,2021-10-28,104,@,CHI,1,240,39,85,0.459,28,56,0.5,11,29,0.379,15,20,0.75,104,36,84,0.429,25,52,0.481,11,32,0.344,20,22,0.909,103
1742,MEM,2021-10-28,104,@,GSW,1,265,39,97,0.402,27,49,0.551,12,48,0.25,14,14,1.0,104,39,90,0.433,25,50,0.5,14,40,0.35,9,12,0.75,101
1743,DET,2021-10-25,104,@,ATL,0,240,40,91,0.44,31,58,0.534,9,33,0.273,15,18,0.833,104,46,90,0.511,34,58,0.586,12,32,0.375,18,21,0.857,122
1744,BRK,2021-10-25,104,,WAS,1,240,40,94,0.426,30,59,0.508,10,35,0.286,14,17,0.824,104,33,95,0.347,24,56,0.429,9,39,0.231,15,20,0.75,90
1745,NYK,2021-10-24,104,,ORL,0,240,37,100,0.37,24,52,0.462,13,48,0.271,17,25,0.68,104,36,88,0.409,24,45,0.533,12,43,0.279,26,34,0.765,110
1746,BRK,2021-10-19,104,@,MIL,0,240,37,84,0.44,20,52,0.385,17,32,0.531,13,23,0.565,104,48,105,0.457,31,60,0.517,17,45,0.378,14,18,0.778,127
1747,WAS,2022-04-06,103,@,ATL,0,240,42,86,0.488,32,51,0.627,10,35,0.286,9,11,0.818,103,43,92,0.467,27,53,0.509,16,39,0.41,16,19,0.842,118
1748,DAL,2022-04-01,103,@,WAS,0,240,34,78,0.436,23,40,0.575,11,38,0.289,24,26,0.923,103,49,90,0.544,32,57,0.561,17,33,0.515,20,22,0.909,135
1749,GSW,2022-03-30,103,,PHO,0,240,35,83,0.422,22,45,0.489,13,38,0.342,20,25,0.8,103,38,92,0.413,31,64,0.484,7,28,0.25,24,30,0.8,107
1750,NOP,2022-03-26,103,,SAS,0,240,40,90,0.444,30,58,0.517,10,32,0.313,13,19,0.684,103,39,92,0.424,32,66,0.485,7,26,0.269,22,25,0.88,107
1751,MIA,2022-03-25,103,,NYK,0,240,35,70,0.5,23,37,0.622,12,33,0.364,21,25,0.84,103,36,82,0.439,19,32,0.594,17,50,0.34,22,28,0.786,111
1752,IND,2022-03-24,103,@,MEM,0,240,39,92,0.424,30,59,0.508,9,33,0.273,16,23,0.696,103,50,93,0.538,29,51,0.569,21,42,0.5,12,17,0.706,133
1753,NOP,2022-03-21,103,@,CHO,0,240,40,90,0.444,31,66,0.47,9,24,0.375,14,16,0.875,103,40,79,0.506,27,42,0.643,13,37,0.351,13,15,0.867,106
1754,TOR,2022-03-16,103,@,LAC,1,240,38,83,0.458,27,51,0.529,11,32,0.344,16,21,0.762,103,38,78,0.487,27,48,0.563,11,30,0.367,13,15,0.867,100
1755,LAL,2022-03-14,103,,TOR,0,240,34,87,0.391,21,45,0.467,13,42,0.31,22,29,0.759,103,39,96,0.406,29,59,0.492,10,37,0.27,26,36,0.722,114
1756,CHI,2022-03-14,103,@,SAC,0,240,36,88,0.409,26,54,0.481,10,34,0.294,21,22,0.955,103,39,82,0.476,29,57,0.509,10,25,0.4,24,26,0.923,112
1757,DET,2022-03-11,103,@,BOS,0,240,35,83,0.422,25,49,0.51,10,34,0.294,23,24,0.958,103,42,90,0.467,36,58,0.621,6,32,0.188,24,30,0.8,114
1758,UTA,2022-03-07,103,@,DAL,0,240,36,83,0.434,24,52,0.462,12,31,0.387,19,24,0.792,103,39,88,0.443,22,42,0.524,17,46,0.37,16,20,0.8,111
1759,OKC,2022-03-06,103,,UTA,0,240,39,92,0.424,31,52,0.596,8,40,0.2,17,19,0.895,103,40,89,0.449,17,37,0.459,23,52,0.442,13,17,0.765,116
1760,ORL,2022-03-04,103,@,TOR,1,240,36,95,0.379,25,58,0.431,11,37,0.297,20,21,0.952,103,37,93,0.398,25,56,0.446,12,37,0.324,11,17,0.647,97
1761,IND,2022-02-28,103,@,ORL,0,240,35,72,0.486,20,36,0.556,15,36,0.417,18,25,0.72,103,45,96,0.469,33,59,0.559,12,37,0.324,17,22,0.773,119
1762,CLE,2022-02-24,103,@,DET,0,240,34,77,0.442,22,42,0.524,12,35,0.343,23,34,0.676,103,35,86,0.407,24,52,0.462,11,34,0.324,25,28,0.893,106
1763,BRK,2022-02-17,103,,WAS,0,240,36,89,0.404,22,51,0.431,14,38,0.368,17,24,0.708,103,46,83,0.554,34,59,0.576,12,24,0.5,13,16,0.813,117
1764,TOR,2022-02-16,103,@,MIN,1,240,40,88,0.455,32,63,0.508,8,25,0.32,15,19,0.789,103,30,77,0.39,20,35,0.571,10,42,0.238,21,29,0.724,91
1765,PHO,2022-02-15,103,,LAC,1,240,44,90,0.489,36,65,0.554,8,25,0.32,7,10,0.7,103,40,97,0.412,30,62,0.484,10,35,0.286,6,9,0.667,96
1766,WAS,2022-02-14,103,,DET,1,240,40,85,0.471,31,56,0.554,9,29,0.31,14,18,0.778,103,32,85,0.376,24,62,0.387,8,23,0.348,22,27,0.815,94
1767,NYK,2022-02-12,103,@,POR,0,240,31,81,0.383,19,42,0.452,12,39,0.308,29,34,0.853,103,40,84,0.476,25,44,0.568,15,40,0.375,17,20,0.85,112
1768,PHI,2022-02-12,103,,CLE,1,240,38,79,0.481,28,57,0.491,10,22,0.455,17,21,0.81,103,36,77,0.468,28,53,0.528,8,24,0.333,13,15,0.867,93
1769,DAL,2022-02-06,103,,ATL,1,240,38,88,0.432,22,52,0.423,16,36,0.444,11,13,0.846,103,37,95,0.389,32,70,0.457,5,25,0.2,15,16,0.938,94
1770,OKC,2022-02-05,103,@,SAC,0,240,42,87,0.483,33,57,0.579,9,30,0.3,10,16,0.625,103,43,83,0.518,31,51,0.608,12,32,0.375,15,22,0.682,113
1771,PHI,2022-02-02,103,,WAS,0,240,41,91,0.451,30,64,0.469,11,27,0.407,10,13,0.769,103,41,90,0.456,32,68,0.471,9,22,0.409,15,19,0.789,106
1772,PHI,2022-01-29,103,,SAC,1,240,36,70,0.514,24,40,0.6,12,30,0.4,19,26,0.731,103,36,82,0.439,24,47,0.511,12,35,0.343,17,20,0.85,101
1773,DET,2022-01-28,103,@,ORL,0,240,32,87,0.368,22,58,0.379,10,29,0.345,29,37,0.784,103,41,83,0.494,29,58,0.5,12,25,0.48,25,26,0.962,119
1774,IND,2022-01-22,103,@,PHO,0,240,37,84,0.44,27,55,0.491,10,29,0.345,19,27,0.704,103,47,96,0.49,40,71,0.563,7,25,0.28,12,14,0.857,113
1775,HOU,2022-01-21,103,@,GSW,0,240,38,89,0.427,28,54,0.519,10,35,0.286,17,20,0.85,103,39,81,0.481,29,51,0.569,10,30,0.333,17,22,0.773,105
1776,TOR,2022-01-15,103,@,MIL,1,240,40,91,0.44,28,56,0.5,12,35,0.343,11,20,0.55,103,26,77,0.338,14,38,0.368,12,39,0.308,32,35,0.914,96
1777,DET,2022-01-14,103,,TOR,1,240,38,81,0.469,30,54,0.556,8,27,0.296,19,23,0.826,103,28,87,0.322,17,49,0.347,11,38,0.289,20,26,0.769,87
1778,CHO,2022-01-10,103,,MIL,1,240,38,96,0.396,25,52,0.481,13,44,0.295,14,16,0.875,103,37,84,0.44,24,41,0.585,13,43,0.302,12,16,0.75,99
1779,POR,2022-01-09,103,,SAC,1,240,37,88,0.42,20,48,0.417,17,40,0.425,12,15,0.8,103,33,85,0.388,26,54,0.481,7,31,0.226,15,21,0.714,88
1780,DAL,2022-01-03,103,,DEN,1,240,35,78,0.449,21,41,0.512,14,37,0.378,19,21,0.905,103,31,67,0.463,25,42,0.595,6,25,0.24,21,29,0.724,89
1781,MIN,2022-01-02,103,@,LAL,0,240,41,92,0.446,32,54,0.593,9,38,0.237,12,16,0.75,103,36,75,0.48,23,34,0.676,13,41,0.317,23,29,0.793,108
1782,BOS,2021-12-27,103,@,MIN,0,240,33,89,0.371,17,42,0.405,16,47,0.34,21,28,0.75,103,40,90,0.444,26,56,0.464,14,34,0.412,14,19,0.737,108
1783,DEN,2021-12-26,103,@,LAC,1,240,39,95,0.411,24,54,0.444,15,41,0.366,10,11,0.909,103,40,86,0.465,32,60,0.533,8,26,0.308,12,18,0.667,100
1784,BOS,2021-12-20,103,,PHI,0,240,38,82,0.463,31,55,0.564,7,27,0.259,20,25,0.8,103,36,72,0.5,26,47,0.553,10,25,0.4,26,31,0.839,108
1785,LAC,2021-12-18,103,@,OKC,0,240,37,83,0.446,21,44,0.477,16,39,0.41,13,19,0.684,103,43,92,0.467,31,61,0.508,12,31,0.387,6,10,0.6,104
1786,UTA,2021-12-18,103,,WAS,0,240,35,81,0.432,21,37,0.568,14,44,0.318,19,30,0.633,103,42,94,0.447,33,63,0.524,9,31,0.29,16,20,0.8,109
1787,HOU,2021-12-16,103,,NYK,0,240,34,68,0.5,23,36,0.639,11,32,0.344,24,30,0.8,103,39,83,0.47,22,47,0.468,17,36,0.472,21,25,0.84,116
1788,POR,2021-12-15,103,,MEM,0,240,31,82,0.378,16,44,0.364,15,38,0.395,26,28,0.929,103,39,82,0.476,28,50,0.56,11,32,0.344,24,30,0.8,113
1789,LAC,2021-12-15,103,@,UTA,0,240,40,85,0.471,30,55,0.545,10,30,0.333,13,20,0.65,103,47,89,0.528,32,52,0.615,15,37,0.405,15,20,0.75,124
1790,MIL,2021-12-13,103,@,BOS,0,240,40,90,0.444,29,54,0.537,11,36,0.306,12,15,0.8,103,43,86,0.5,23,39,0.59,20,47,0.426,11,13,0.846,117
1791,DAL,2021-12-12,103,@,OKC,1,240,38,90,0.422,29,57,0.509,9,33,0.273,18,23,0.783,103,30,80,0.375,17,43,0.395,13,37,0.351,11,16,0.688,84
1792,SAC,2021-12-11,103,@,CLE,0,240,41,93,0.441,34,65,0.523,7,28,0.25,14,22,0.636,103,41,88,0.466,29,57,0.509,12,31,0.387,23,28,0.821,117
1793,DET,2021-12-06,103,,OKC,0,240,41,99,0.414,25,58,0.431,16,41,0.39,5,6,0.833,103,41,82,0.5,32,57,0.561,9,25,0.36,23,30,0.767,114
1794,DET,2021-12-02,103,@,PHO,0,240,36,80,0.45,25,53,0.472,11,27,0.407,20,26,0.769,103,43,79,0.544,31,58,0.534,12,21,0.571,16,23,0.696,114
1795,DEN,2021-12-01,103,@,ORL,0,240,39,80,0.488,29,46,0.63,10,34,0.294,15,21,0.714,103,44,81,0.543,38,54,0.704,6,27,0.222,14,19,0.737,108
1796,POR,2021-11-26,103,@,GSW,0,240,36,86,0.419,23,48,0.479,13,38,0.342,18,23,0.783,103,47,87,0.54,35,50,0.7,12,37,0.324,12,16,0.75,118
1797,WAS,2021-11-22,103,,CHO,0,240,36,94,0.383,27,57,0.474,9,37,0.243,22,27,0.815,103,40,91,0.44,25,60,0.417,15,31,0.484,14,24,0.583,109
1798,NYK,2021-11-21,103,@,CHI,0,240,35,84,0.417,28,57,0.491,7,27,0.259,26,31,0.839,103,37,88,0.42,26,59,0.441,11,29,0.379,24,27,0.889,109
1799,WAS,2021-11-20,103,,MIA,1,240,36,74,0.486,25,44,0.568,11,30,0.367,20,23,0.87,103,38,81,0.469,31,54,0.574,7,27,0.259,17,20,0.85,100
1800,TOR,2021-11-18,103,@,UTA,0,240,39,94,0.415,29,56,0.518,10,38,0.263,15,17,0.882,103,44,80,0.55,25,34,0.735,19,46,0.413,12,13,0.923,119
1801,PHI,2021-11-18,103,@,DEN,1,240,43,85,0.506,32,56,0.571,11,29,0.379,6,12,0.5,103,32,89,0.36,20,53,0.377,12,36,0.333,13,16,0.813,89
1802,MIA,2021-11-15,103,@,OKC,1,240,37,82,0.451,19,42,0.452,18,40,0.45,11,13,0.846,103,34,83,0.41,19,42,0.452,15,41,0.366,7,10,0.7,90
1803,LAL,2021-11-15,103,,CHI,0,240,36,79,0.456,30,47,0.638,6,32,0.188,25,31,0.806,103,49,89,0.551,34,55,0.618,15,34,0.441,8,11,0.727,121
1804,SAC,2021-11-12,103,@,OKC,0,240,38,95,0.4,24,54,0.444,14,41,0.341,13,17,0.765,103,42,99,0.424,32,69,0.464,10,30,0.333,11,15,0.733,105
1805,NYK,2021-11-08,103,@,PHI,1,240,40,91,0.44,27,51,0.529,13,40,0.325,10,13,0.769,103,35,91,0.385,22,51,0.431,13,40,0.325,13,16,0.813,96
1806,TOR,2021-11-07,103,,BRK,0,240,41,87,0.471,34,57,0.596,7,30,0.233,14,18,0.778,103,41,80,0.513,24,42,0.571,17,38,0.447,17,20,0.85,116
1807,PHI,2021-11-03,103,,CHI,1,240,38,77,0.494,26,49,0.531,12,28,0.429,15,21,0.714,103,38,82,0.463,32,61,0.525,6,21,0.286,16,18,0.889,98
1808,POR,2021-11-01,103,@,PHI,0,240,40,84,0.476,28,50,0.56,12,34,0.353,11,18,0.611,103,43,83,0.518,30,47,0.638,13,36,0.361,14,16,0.875,113
1809,MEM,2021-10-30,103,,MIA,0,240,34,88,0.386,18,38,0.474,16,50,0.32,19,21,0.905,103,46,88,0.523,25,51,0.49,21,37,0.568,16,19,0.842,129
1810,ORL,2021-10-30,103,@,DET,0,240,38,87,0.437,22,55,0.4,16,32,0.5,11,15,0.733,103,36,89,0.404,22,46,0.478,14,43,0.326,24,30,0.8,110
1811,GSW,2021-10-30,103,,OKC,1,240,39,92,0.424,18,38,0.474,21,54,0.389,4,8,0.5,103,29,83,0.349,21,44,0.477,8,39,0.205,16,21,0.762,82
1812,CHI,2021-10-28,103,,NYK,0,240,36,84,0.429,25,52,0.481,11,32,0.344,20,22,0.909,103,39,85,0.459,28,56,0.5,11,29,0.379,15,20,0.75,104
1813,OKC,2021-10-24,103,,PHI,0,240,40,84,0.476,32,53,0.604,8,31,0.258,15,19,0.789,103,41,88,0.466,24,47,0.511,17,41,0.415,16,20,0.8,115
1814,DAL,2021-10-23,103,@,TOR,1,240,38,91,0.418,24,49,0.49,14,42,0.333,13,18,0.722,103,34,85,0.4,23,48,0.479,11,37,0.297,16,23,0.696,95
1815,WAS,2022-04-03,102,@,BOS,0,240,38,82,0.463,30,61,0.492,8,21,0.381,18,20,0.9,102,56,91,0.615,33,47,0.702,23,44,0.523,9,13,0.692,144
1816,TOR,2022-04-01,102,@,ORL,1,240,36,86,0.419,23,44,0.523,13,42,0.31,17,20,0.85,102,34,79,0.43,23,44,0.523,11,35,0.314,10,11,0.909,89
1817,DET,2022-03-31,102,,PHI,1,240,41,82,0.5,31,47,0.66,10,35,0.286,10,15,0.667,102,31,69,0.449,24,43,0.558,7,26,0.269,25,28,0.893,94
1818,MIN,2022-03-30,102,@,TOR,0,240,37,92,0.402,26,55,0.473,11,37,0.297,17,23,0.739,102,48,96,0.5,30,60,0.5,18,36,0.5,11,15,0.733,125
1819,DET,2022-03-27,102,,NYK,0,240,39,85,0.459,31,56,0.554,8,29,0.276,16,18,0.889,102,34,85,0.4,21,44,0.477,13,41,0.317,23,29,0.793,104
1820,MIL,2022-03-26,102,@,MEM,0,240,37,93,0.398,30,61,0.492,7,32,0.219,21,26,0.808,102,49,102,0.48,36,65,0.554,13,37,0.351,16,23,0.696,127
1821,WAS,2022-03-24,102,@,MIL,0,240,43,92,0.467,32,54,0.593,11,38,0.289,5,9,0.556,102,42,81,0.519,26,46,0.565,16,35,0.457,14,16,0.875,114
1822,ORL,2022-03-23,102,@,OKC,0,240,36,93,0.387,19,42,0.452,17,51,0.333,13,16,0.813,102,38,79,0.481,21,38,0.553,17,41,0.415,25,30,0.833,118
1823,CHI,2022-03-18,102,@,PHO,0,240,35,85,0.412,28,58,0.483,7,27,0.259,25,31,0.806,102,47,84,0.56,36,59,0.61,11,25,0.44,24,26,0.923,129
1824,IND,2022-03-15,102,,MEM,0,240,41,98,0.418,35,68,0.515,6,30,0.2,14,19,0.737,102,54,105,0.514,39,65,0.6,15,40,0.375,12,20,0.6,135
1825,DET,2022-03-13,102,,LAC,0,240,36,80,0.45,24,51,0.471,12,29,0.414,18,20,0.9,102,40,89,0.449,30,59,0.508,10,30,0.333,16,20,0.8,106
1826,UTA,2022-03-11,102,@,SAS,0,240,37,92,0.402,24,52,0.462,13,40,0.325,15,23,0.652,102,34,85,0.4,28,56,0.5,6,29,0.207,30,43,0.698,104
1827,DEN,2022-03-10,102,,GSW,0,240,35,84,0.417,28,53,0.528,7,31,0.226,25,32,0.781,102,42,88,0.477,28,46,0.609,14,42,0.333,15,20,0.75,113
1828,NOP,2022-03-09,102,,ORL,0,240,41,93,0.441,34,62,0.548,7,31,0.226,13,18,0.722,102,36,76,0.474,22,39,0.564,14,37,0.378,22,26,0.846,108
1829,OKC,2022-03-09,102,@,MIN,0,240,36,87,0.414,22,44,0.5,14,43,0.326,16,24,0.667,102,45,86,0.523,23,34,0.676,22,52,0.423,20,26,0.769,132
1830,PHO,2022-03-08,102,@,ORL,1,240,35,92,0.38,22,55,0.4,13,37,0.351,19,23,0.826,102,35,92,0.38,28,53,0.528,7,39,0.179,22,25,0.88,99
1831,PHO,2022-02-25,102,,NOP,0,240,36,82,0.439,24,42,0.571,12,40,0.3,18,24,0.75,102,38,87,0.437,30,58,0.517,8,29,0.276,33,41,0.805,117
1832,LAL,2022-02-25,102,,LAC,0,240,39,93,0.419,31,62,0.5,8,31,0.258,16,21,0.762,102,41,83,0.494,31,57,0.544,10,26,0.385,13,19,0.684,105
1833,MIN,2022-02-25,102,,PHI,0,240,36,86,0.419,27,47,0.574,9,39,0.231,21,25,0.84,102,42,82,0.512,23,43,0.535,19,39,0.487,30,36,0.833,133
1834,DEN,2022-02-11,102,@,BOS,0,240,39,90,0.433,28,46,0.609,11,44,0.25,13,18,0.722,102,38,96,0.396,28,59,0.475,10,37,0.27,22,30,0.733,108
1835,BOS,2022-02-04,102,@,DET,1,240,37,82,0.451,28,54,0.519,9,28,0.321,19,25,0.76,102,34,104,0.327,24,78,0.308,10,26,0.385,15,20,0.75,93
1836,CLE,2022-02-04,102,@,CHO,1,240,36,90,0.4,22,55,0.4,14,35,0.4,16,20,0.8,102,38,92,0.413,24,49,0.49,14,43,0.326,11,12,0.917,101
1837,BRK,2022-02-04,102,@,UTA,0,240,41,99,0.414,29,65,0.446,12,34,0.353,8,11,0.727,102,48,85,0.565,31,47,0.66,17,38,0.447,12,14,0.857,125
1838,ORL,2022-01-26,102,,LAC,0,240,38,84,0.452,29,49,0.592,9,35,0.257,17,22,0.773,102,36,81,0.444,21,52,0.404,15,29,0.517,24,27,0.889,111
1839,LAC,2022-01-23,102,@,NYK,0,240,34,79,0.43,20,38,0.526,14,41,0.341,20,30,0.667,102,39,91,0.429,23,55,0.418,16,36,0.444,16,19,0.842,110
1840,LAC,2022-01-21,102,@,PHI,1,240,40,87,0.46,29,55,0.527,11,32,0.344,11,15,0.733,102,38,91,0.418,28,63,0.444,10,28,0.357,15,21,0.714,101
1841,SAS,2022-01-21,102,,BRK,0,240,37,95,0.389,29,66,0.439,8,29,0.276,20,24,0.833,102,48,100,0.48,39,75,0.52,9,25,0.36,12,12,1.0,117
1842,NOP,2022-01-20,102,@,NYK,1,240,38,76,0.5,27,48,0.563,11,28,0.393,15,22,0.682,102,29,77,0.377,20,39,0.513,9,38,0.237,24,36,0.667,91
1843,BOS,2022-01-19,102,,CHO,0,240,39,90,0.433,25,44,0.568,14,46,0.304,10,13,0.769,102,42,86,0.488,26,47,0.553,16,39,0.41,11,15,0.733,111
1844,DAL,2022-01-19,102,,TOR,1,240,37,76,0.487,28,43,0.651,9,33,0.273,19,20,0.95,102,35,91,0.385,27,59,0.458,8,32,0.25,20,25,0.8,98
1845,GSW,2022-01-18,102,,DET,1,240,34,83,0.41,20,41,0.488,14,42,0.333,20,27,0.741,102,30,85,0.353,21,51,0.412,9,34,0.265,17,24,0.708,86
1846,OKC,2022-01-17,102,@,DAL,0,240,36,83,0.434,25,48,0.521,11,35,0.314,19,24,0.792,102,35,88,0.398,23,51,0.451,12,37,0.324,22,28,0.786,104
1847,DEN,2022-01-16,102,,UTA,0,240,42,95,0.442,31,52,0.596,11,43,0.256,7,8,0.875,102,44,84,0.524,29,45,0.644,15,39,0.385,22,29,0.759,125
1848,OKC,2022-01-15,102,,CLE,0,240,36,83,0.434,26,56,0.464,10,27,0.37,20,22,0.909,102,40,87,0.46,31,52,0.596,9,35,0.257,18,25,0.72,107
1849,WAS,2022-01-09,102,@,ORL,1,240,36,88,0.409,25,59,0.424,11,29,0.379,19,24,0.792,102,38,95,0.4,29,67,0.433,9,28,0.321,15,16,0.938,100
1850,SAC,2022-01-05,102,,ATL,0,240,38,90,0.422,27,63,0.429,11,27,0.407,15,20,0.75,102,39,86,0.453,31,56,0.554,8,30,0.267,22,30,0.733,108
1851,CHI,2022-01-03,102,,ORL,1,240,37,86,0.43,26,55,0.473,11,31,0.355,17,23,0.739,102,36,85,0.424,26,58,0.448,10,27,0.37,16,18,0.889,98
1852,BRK,2021-12-30,102,,PHI,0,240,37,81,0.457,30,54,0.556,7,27,0.259,21,27,0.778,102,42,100,0.42,29,68,0.426,13,32,0.406,13,20,0.65,110
1853,SAC,2021-12-26,102,,MEM,0,240,34,81,0.42,24,52,0.462,10,29,0.345,24,27,0.889,102,47,100,0.47,38,70,0.543,9,30,0.3,24,30,0.8,127
1854,MIL,2021-12-23,102,@,DAL,1,240,37,82,0.451,27,46,0.587,10,36,0.278,18,22,0.818,102,35,86,0.407,23,41,0.561,12,45,0.267,13,17,0.765,95
1855,MIN,2021-12-21,102,@,DAL,0,240,36,79,0.456,23,39,0.59,13,40,0.325,17,20,0.85,102,42,86,0.488,31,52,0.596,11,34,0.324,19,23,0.826,114
1856,OKC,2021-12-20,102,@,MEM,1,240,36,84,0.429,25,46,0.543,11,38,0.289,19,28,0.679,102,39,101,0.386,28,69,0.406,11,32,0.344,10,13,0.769,99
1857,CHO,2021-12-20,102,@,UTA,0,240,39,101,0.386,24,58,0.414,15,43,0.349,9,9,1.0,102,34,96,0.354,18,43,0.419,16,53,0.302,28,37,0.757,112
1858,GSW,2021-12-13,102,@,IND,1,240,42,84,0.5,34,54,0.63,8,30,0.267,10,14,0.714,102,35,87,0.402,28,57,0.491,7,30,0.233,23,31,0.742,100
1859,PHI,2021-12-11,102,,GSW,1,240,35,76,0.461,26,49,0.531,9,27,0.333,23,26,0.885,102,34,85,0.4,22,37,0.595,12,48,0.25,13,18,0.722,93
1860,NYK,2021-12-08,102,@,IND,0,240,36,86,0.419,27,56,0.482,9,30,0.3,21,23,0.913,102,46,86,0.535,36,59,0.61,10,27,0.37,20,25,0.8,122
1861,BOS,2021-12-07,102,@,LAL,0,240,36,82,0.439,26,49,0.531,10,33,0.303,20,29,0.69,102,48,93,0.516,40,66,0.606,8,27,0.296,13,17,0.765,117
1862,BRK,2021-12-07,102,@,DAL,1,240,42,83,0.506,34,57,0.596,8,26,0.308,10,13,0.769,102,36,90,0.4,27,44,0.614,9,46,0.196,18,22,0.818,99
1863,LAC,2021-12-06,102,@,POR,1,240,41,92,0.446,30,56,0.536,11,36,0.306,9,14,0.643,102,35,79,0.443,30,57,0.526,5,22,0.227,15,20,0.75,90
1864,TOR,2021-12-05,102,,WAS,1,240,38,85,0.447,30,62,0.484,8,23,0.348,18,24,0.75,102,30,73,0.411,22,48,0.458,8,25,0.32,22,29,0.759,90
1865,MIA,2021-12-04,102,@,MIL,0,240,34,84,0.405,17,41,0.415,17,43,0.395,17,24,0.708,102,44,98,0.449,26,48,0.542,18,50,0.36,18,20,0.9,124
1866,HOU,2021-11-29,102,,OKC,1,240,40,96,0.417,25,50,0.5,15,46,0.326,7,11,0.636,102,31,87,0.356,24,44,0.545,7,43,0.163,20,26,0.769,89
1867,WAS,2021-11-24,102,@,NOP,0,240,36,84,0.429,29,53,0.547,7,31,0.226,23,36,0.639,102,44,96,0.458,32,67,0.478,12,29,0.414,27,32,0.844,127
1868,PHI,2021-11-22,102,@,SAC,1,240,36,85,0.424,27,53,0.509,9,32,0.281,21,27,0.778,102,33,80,0.413,26,49,0.531,7,31,0.226,21,29,0.724,94
1869,DET,2021-11-19,102,,GSW,0,240,32,80,0.4,18,38,0.474,14,42,0.333,24,30,0.8,102,38,80,0.475,26,50,0.52,12,30,0.4,17,21,0.81,105
1870,LAL,2021-11-17,102,@,MIL,0,240,40,96,0.417,28,53,0.528,12,43,0.279,10,12,0.833,102,40,87,0.46,28,50,0.56,12,37,0.324,17,24,0.708,109
1871,HOU,2021-11-15,102,@,MEM,0,240,36,95,0.379,25,57,0.439,11,38,0.289,19,26,0.731,102,52,96,0.542,36,55,0.655,16,41,0.39,16,20,0.8,136
1872,GSW,2021-11-14,102,@,CHO,0,240,38,90,0.422,29,51,0.569,9,39,0.231,17,25,0.68,102,42,88,0.477,28,52,0.538,14,36,0.389,8,12,0.667,106
1873,MIN,2021-11-13,102,@,LAC,0,240,40,102,0.392,29,66,0.439,11,36,0.306,11,16,0.688,102,53,99,0.535,37,59,0.627,16,40,0.4,7,9,0.778,129
1874,CLE,2021-11-05,102,@,TOR,1,240,38,83,0.458,28,53,0.528,10,30,0.333,16,19,0.842,102,42,99,0.424,30,72,0.417,12,27,0.444,5,9,0.556,101
1875,SAS,2021-11-05,102,@,ORL,1,240,40,90,0.444,34,71,0.479,6,19,0.316,16,18,0.889,102,35,89,0.393,23,48,0.479,12,41,0.293,7,10,0.7,89
1876,SAS,2021-10-30,102,@,MIL,1,240,39,95,0.411,32,64,0.5,7,31,0.226,17,24,0.708,102,36,89,0.404,26,50,0.52,10,39,0.256,11,16,0.688,93
1877,DET,2021-10-28,102,@,PHI,0,240,35,86,0.407,22,47,0.468,13,39,0.333,19,27,0.704,102,38,76,0.5,26,49,0.531,12,27,0.444,22,24,0.917,110
1878,ATL,2021-10-27,102,@,NOP,1,240,40,96,0.417,32,66,0.485,8,30,0.267,14,17,0.824,102,40,93,0.43,29,57,0.509,11,36,0.306,8,9,0.889,99
1879,IND,2021-10-23,102,,MIA,1,265,38,97,0.392,28,58,0.483,10,39,0.256,16,21,0.762,102,35,91,0.385,26,58,0.448,9,33,0.273,12,14,0.857,91
1880,DEN,2021-10-22,102,,SAS,1,240,44,86,0.512,35,56,0.625,9,30,0.3,5,8,0.625,102,40,84,0.476,34,60,0.567,6,24,0.25,10,14,0.714,96
1881,OKC,2022-04-08,101,@,LAL,0,240,40,88,0.455,34,59,0.576,6,29,0.207,15,19,0.789,101,41,82,0.5,32,51,0.627,9,31,0.29,29,39,0.744,120
1882,DET,2022-04-08,101,,MIL,0,240,35,90,0.389,25,42,0.595,10,48,0.208,21,23,0.913,101,50,101,0.495,39,64,0.609,11,37,0.297,20,23,0.87,131
1883,ORL,2022-04-07,101,@,CHO,0,240,38,95,0.4,23,47,0.489,15,48,0.313,10,13,0.769,101,48,92,0.522,36,58,0.621,12,34,0.353,20,27,0.741,128
1884,OKC,2022-04-06,101,@,UTA,0,240,37,90,0.411,21,53,0.396,16,37,0.432,11,17,0.647,101,49,84,0.583,34,48,0.708,15,36,0.417,24,32,0.75,137
1885,NYK,2022-04-02,101,,CLE,0,240,31,77,0.403,18,47,0.383,13,30,0.433,26,34,0.765,101,44,81,0.543,29,47,0.617,15,34,0.441,16,21,0.762,119
1886,OKC,2022-04-01,101,,DET,0,240,36,84,0.429,25,50,0.5,11,34,0.324,18,29,0.621,101,40,94,0.426,25,46,0.543,15,48,0.313,15,18,0.833,110
1887,ORL,2022-03-28,101,@,CLE,0,240,42,87,0.483,32,50,0.64,10,37,0.27,7,13,0.538,101,37,83,0.446,24,42,0.571,13,41,0.317,20,23,0.87,107
1888,UTA,2022-03-25,101,@,CHO,0,240,38,84,0.452,21,37,0.568,17,47,0.362,8,11,0.727,101,41,88,0.466,28,54,0.519,13,34,0.382,12,17,0.706,107
1889,ATL,2022-03-23,101,@,DET,0,240,37,92,0.402,23,48,0.479,14,44,0.318,13,15,0.867,101,44,88,0.5,32,55,0.582,12,33,0.364,22,25,0.88,122
1890,DAL,2022-03-18,101,@,PHI,0,240,37,80,0.463,25,48,0.521,12,32,0.375,15,21,0.714,101,37,75,0.493,21,37,0.568,16,38,0.421,21,23,0.913,111
1891,CHI,2022-03-12,101,,CLE,1,240,39,88,0.443,30,67,0.448,9,21,0.429,14,15,0.933,101,36,86,0.419,31,62,0.5,5,24,0.208,14,17,0.824,91
1892,CHO,2022-03-09,101,,BOS,0,240,36,85,0.424,28,52,0.538,8,33,0.242,21,28,0.75,101,46,93,0.495,34,56,0.607,12,37,0.324,11,14,0.786,115
1893,HOU,2022-03-04,101,@,DEN,0,240,38,83,0.458,28,47,0.596,10,36,0.278,15,22,0.682,101,39,86,0.453,26,53,0.491,13,33,0.394,25,31,0.806,116
1894,OKC,2022-03-04,101,,MIN,0,240,37,86,0.43,28,51,0.549,9,35,0.257,18,21,0.857,101,49,91,0.538,27,44,0.614,22,47,0.468,18,23,0.783,138
1895,GSW,2022-02-27,101,,DAL,0,240,39,91,0.429,28,52,0.538,11,39,0.282,12,20,0.6,101,39,78,0.5,26,44,0.591,13,34,0.382,16,20,0.8,107
1896,UTA,2022-02-16,101,@,LAL,0,240,37,79,0.468,26,46,0.565,11,33,0.333,16,19,0.842,101,41,86,0.477,31,50,0.62,10,36,0.278,14,22,0.636,106
1897,HOU,2022-02-14,101,@,UTA,0,240,35,83,0.422,23,46,0.5,12,37,0.324,19,28,0.679,101,49,89,0.551,31,49,0.633,18,40,0.45,19,22,0.864,135
1898,OKC,2022-02-12,101,@,CHI,0,240,34,88,0.386,23,52,0.442,11,36,0.306,22,30,0.733,101,40,89,0.449,33,64,0.516,7,25,0.28,19,23,0.826,106
1899,CHO,2022-02-07,101,,TOR,0,240,39,95,0.411,30,55,0.545,9,40,0.225,14,16,0.875,101,41,84,0.488,26,49,0.531,15,35,0.429,19,29,0.655,116
1900,CHO,2022-02-04,101,,CLE,0,240,38,92,0.413,24,49,0.49,14,43,0.326,11,12,0.917,101,36,90,0.4,22,55,0.4,14,35,0.4,16,20,0.8,102
1901,BRK,2022-02-02,101,@,SAC,0,240,41,84,0.488,33,59,0.559,8,25,0.32,11,14,0.786,101,41,93,0.441,27,51,0.529,14,42,0.333,16,18,0.889,112
1902,DET,2022-02-01,101,,NOP,0,240,41,84,0.488,33,52,0.635,8,32,0.25,11,14,0.786,101,39,89,0.438,31,61,0.508,8,28,0.286,25,28,0.893,111
1903,SAC,2022-01-29,101,@,PHI,0,240,36,82,0.439,24,47,0.511,12,35,0.343,17,20,0.85,101,36,70,0.514,24,40,0.6,12,30,0.4,19,26,0.731,103
1904,DET,2022-01-21,101,@,UTA,0,240,38,87,0.437,25,55,0.455,13,32,0.406,12,16,0.75,101,36,79,0.456,26,48,0.542,10,31,0.323,29,34,0.853,111
1905,PHI,2022-01-21,101,,LAC,0,240,38,91,0.418,28,63,0.444,10,28,0.357,15,21,0.714,101,40,87,0.46,29,55,0.527,11,32,0.344,11,15,0.733,102
1906,DAL,2022-01-20,101,,PHO,0,240,37,85,0.435,26,48,0.542,11,37,0.297,16,20,0.8,101,39,86,0.453,31,50,0.62,8,36,0.222,23,25,0.92,109
1907,LAL,2022-01-17,101,,UTA,1,240,38,86,0.442,27,49,0.551,11,37,0.297,14,23,0.609,101,31,83,0.373,19,37,0.514,12,46,0.261,21,24,0.875,95
1908,SAS,2022-01-15,101,,LAC,1,240,34,83,0.41,23,46,0.5,11,37,0.297,22,27,0.815,101,38,100,0.38,26,62,0.419,12,38,0.316,6,8,0.75,94
1909,BOS,2022-01-10,101,,IND,1,265,35,88,0.398,27,60,0.45,8,28,0.286,23,28,0.821,101,36,94,0.383,25,57,0.439,11,37,0.297,15,17,0.882,98
1910,NOP,2022-01-09,101,@,TOR,0,240,34,75,0.453,22,42,0.524,12,33,0.364,21,25,0.84,101,36,85,0.424,22,51,0.431,14,34,0.412,19,20,0.95,105
1911,POR,2022-01-07,101,,CLE,0,240,37,92,0.402,21,57,0.368,16,35,0.457,11,19,0.579,101,39,80,0.488,22,41,0.537,17,39,0.436,19,29,0.655,114
1912,NOP,2022-01-06,101,,GSW,1,240,35,83,0.422,27,49,0.551,8,34,0.235,23,29,0.793,101,37,87,0.425,30,54,0.556,7,33,0.212,15,18,0.833,96
1913,NYK,2021-12-25,101,,ATL,1,240,38,85,0.447,18,35,0.514,20,50,0.4,5,12,0.417,101,33,87,0.379,20,49,0.408,13,38,0.342,8,14,0.571,87
1914,OKC,2021-12-23,101,@,PHO,0,240,37,96,0.385,26,55,0.473,11,41,0.268,16,21,0.762,101,45,93,0.484,30,54,0.556,15,39,0.385,8,13,0.615,113
1915,CLE,2021-12-22,101,@,BOS,0,240,36,92,0.391,27,54,0.5,9,38,0.237,20,24,0.833,101,43,92,0.467,32,62,0.516,11,30,0.367,14,18,0.778,111
1916,MIA,2021-12-15,101,@,PHI,1,240,35,78,0.449,17,34,0.5,18,44,0.409,13,17,0.765,101,35,79,0.443,23,42,0.548,12,37,0.324,14,17,0.824,96
1917,SAC,2021-12-13,101,@,TOR,0,240,38,94,0.404,27,60,0.45,11,34,0.324,14,21,0.667,101,53,98,0.541,42,67,0.627,11,31,0.355,7,10,0.7,124
1918,WAS,2021-12-03,101,,CLE,0,240,38,82,0.463,28,51,0.549,10,31,0.323,15,19,0.789,101,42,89,0.472,29,59,0.492,13,30,0.433,19,25,0.76,116
1919,PHI,2021-11-29,101,,ORL,1,240,39,97,0.402,29,64,0.453,10,33,0.303,13,18,0.722,101,37,90,0.411,29,57,0.509,8,33,0.242,14,18,0.778,96
1920,SAC,2021-11-28,101,@,MEM,0,240,33,97,0.34,24,55,0.436,9,42,0.214,26,37,0.703,101,50,104,0.481,37,65,0.569,13,39,0.333,15,20,0.75,128
1921,WAS,2021-11-26,101,@,OKC,1,240,38,79,0.481,28,50,0.56,10,29,0.345,15,15,1.0,101,38,94,0.404,27,61,0.443,11,33,0.333,12,14,0.857,99
1922,MIA,2021-11-24,101,@,MIN,0,240,33,74,0.446,18,32,0.563,15,42,0.357,20,29,0.69,101,38,93,0.409,20,38,0.526,18,55,0.327,19,21,0.905,113
1923,OKC,2021-11-22,101,@,ATL,0,240,39,97,0.402,29,59,0.492,10,38,0.263,13,14,0.929,101,42,87,0.483,28,53,0.528,14,34,0.412,15,16,0.938,113
1924,OKC,2021-11-17,101,,HOU,1,240,41,92,0.446,31,53,0.585,10,39,0.256,9,16,0.563,101,32,90,0.356,20,48,0.417,12,42,0.286,13,19,0.684,89
1925,DEN,2021-11-15,101,@,DAL,0,240,40,84,0.476,31,52,0.596,9,32,0.281,12,17,0.706,101,45,90,0.5,31,54,0.574,14,36,0.389,7,10,0.7,111
1926,MEM,2021-11-13,101,@,NOP,0,240,38,88,0.432,30,64,0.469,8,24,0.333,17,21,0.81,101,38,79,0.481,24,50,0.48,14,29,0.483,22,25,0.88,112
1927,DEN,2021-11-10,101,,IND,1,240,36,84,0.429,24,54,0.444,12,30,0.4,17,20,0.85,101,40,84,0.476,29,53,0.547,11,31,0.355,7,11,0.636,98
1928,WAS,2021-11-07,101,,MIL,1,240,41,81,0.506,30,54,0.556,11,27,0.407,8,13,0.615,101,37,94,0.394,27,58,0.466,10,36,0.278,10,18,0.556,94
1929,TOR,2021-11-05,101,,CLE,0,240,42,99,0.424,30,72,0.417,12,27,0.444,5,9,0.556,101,38,83,0.458,28,53,0.528,10,30,0.333,16,19,0.842,102
1930,PHO,2021-10-30,101,,CLE,1,240,39,84,0.464,33,58,0.569,6,26,0.231,17,27,0.63,101,36,91,0.396,22,47,0.468,14,44,0.318,6,7,0.857,92
1931,CLE,2021-10-29,101,@,LAL,0,240,37,87,0.425,25,53,0.472,12,34,0.353,15,22,0.682,101,46,84,0.548,34,57,0.596,12,27,0.444,9,10,0.9,113
1932,GSW,2021-10-28,101,,MEM,0,265,39,90,0.433,25,50,0.5,14,40,0.35,9,12,0.75,101,39,97,0.402,27,49,0.551,12,48,0.25,14,14,1.0,104
1933,CLE,2021-10-23,101,,ATL,1,240,37,89,0.416,30,61,0.492,7,28,0.25,20,27,0.741,101,38,99,0.384,28,65,0.431,10,34,0.294,9,15,0.6,95
1934,SAC,2021-10-22,101,,UTA,0,240,39,99,0.394,31,63,0.492,8,36,0.222,15,21,0.714,101,37,90,0.411,21,48,0.438,16,42,0.381,20,23,0.87,110
1935,GSW,2022-04-09,100,@,SAS,1,240,33,81,0.407,25,49,0.51,8,32,0.25,26,33,0.788,100,32,80,0.4,22,49,0.449,10,31,0.323,20,27,0.741,94
1936,NOP,2022-04-03,100,@,LAC,0,240,35,87,0.402,26,63,0.413,9,24,0.375,21,27,0.778,100,45,95,0.474,24,51,0.471,21,44,0.477,8,10,0.8,119
1937,SAC,2022-03-28,100,@,MIA,0,240,37,81,0.457,25,46,0.543,12,35,0.343,14,18,0.778,100,49,90,0.544,30,50,0.6,19,40,0.475,6,6,1.0,123
1938,UTA,2022-03-27,100,@,DAL,0,240,41,89,0.461,29,55,0.527,12,34,0.353,6,10,0.6,100,40,77,0.519,23,43,0.535,17,34,0.5,17,24,0.708,114
1939,WAS,2022-03-25,100,@,DET,1,240,36,83,0.434,27,53,0.509,9,30,0.3,19,21,0.905,100,39,95,0.411,33,63,0.524,6,32,0.188,13,14,0.929,97
1940,NYK,2022-03-18,100,,WAS,1,240,31,90,0.344,21,57,0.368,10,33,0.303,28,36,0.778,100,34,79,0.43,21,45,0.467,13,34,0.382,16,21,0.762,97
1941,LAC,2022-03-16,100,,TOR,0,240,38,78,0.487,27,48,0.563,11,30,0.367,13,15,0.867,100,38,83,0.458,27,51,0.529,11,32,0.344,16,21,0.762,103
1942,HOU,2022-03-11,100,,DAL,0,240,41,86,0.477,35,56,0.625,6,30,0.2,12,19,0.632,100,40,88,0.455,29,52,0.558,11,36,0.306,22,28,0.786,113
1943,PHI,2022-03-10,100,,BRK,0,240,30,93,0.323,16,57,0.281,14,36,0.389,26,30,0.867,100,51,91,0.56,33,51,0.647,18,40,0.45,9,17,0.529,129
1944,SAC,2022-03-09,100,,DEN,0,240,38,85,0.447,26,51,0.51,12,34,0.353,12,18,0.667,100,40,82,0.488,31,47,0.66,9,35,0.257,17,19,0.895,106
1945,HOU,2022-03-01,100,,LAC,0,240,38,96,0.396,25,57,0.439,13,39,0.333,11,17,0.647,100,42,96,0.438,29,65,0.446,13,31,0.419,16,17,0.941,113
1946,TOR,2022-02-26,100,@,ATL,0,240,38,95,0.4,28,63,0.444,10,32,0.313,14,19,0.737,100,48,83,0.578,35,52,0.673,13,31,0.419,18,22,0.818,127
1947,NYK,2022-02-25,100,,MIA,0,240,30,75,0.4,16,35,0.457,14,40,0.35,26,36,0.722,100,39,83,0.47,28,51,0.549,11,32,0.344,26,35,0.743,115
1948,PHI,2022-02-11,100,,OKC,1,240,36,93,0.387,29,67,0.433,7,26,0.269,21,26,0.808,100,35,90,0.389,29,55,0.527,6,35,0.171,11,12,0.917,87
1949,WAS,2022-02-07,100,,MIA,0,240,36,80,0.45,29,49,0.592,7,31,0.226,21,23,0.913,100,43,76,0.566,25,44,0.568,18,32,0.563,17,21,0.81,121
1950,ATL,2022-01-31,100,,TOR,0,240,37,81,0.457,25,49,0.51,12,32,0.375,14,16,0.875,100,38,89,0.427,20,53,0.377,18,36,0.5,12,17,0.706,106
1951,MIL,2022-01-30,100,,DEN,0,240,37,78,0.474,27,48,0.563,10,30,0.333,16,22,0.727,100,53,88,0.602,30,45,0.667,23,43,0.535,7,10,0.7,136
1952,IND,2022-01-12,100,,BOS,0,240,40,86,0.465,33,50,0.66,7,36,0.194,13,20,0.65,100,40,78,0.513,22,40,0.55,18,38,0.474,21,25,0.84,119
1953,ORL,2022-01-09,100,,WAS,0,240,38,95,0.4,29,67,0.433,9,28,0.321,15,16,0.938,100,36,88,0.409,25,59,0.424,11,29,0.379,19,24,0.792,102
1954,PHO,2022-01-08,100,,MIA,0,240,30,79,0.38,16,45,0.356,14,34,0.412,26,29,0.897,100,44,88,0.5,22,44,0.5,22,44,0.5,13,15,0.867,123
1955,SAS,2022-01-07,100,@,PHI,0,240,38,92,0.413,29,62,0.468,9,30,0.3,15,20,0.75,100,45,87,0.517,37,64,0.578,8,23,0.348,21,27,0.778,119
1956,LAC,2021-12-26,100,,DEN,0,240,40,86,0.465,32,60,0.533,8,26,0.308,12,18,0.667,100,39,95,0.411,24,54,0.444,15,41,0.366,10,11,0.909,103
1957,MEM,2021-12-19,100,,POR,0,240,35,91,0.385,26,57,0.456,9,34,0.265,21,25,0.84,100,35,74,0.473,24,42,0.571,11,32,0.344,24,28,0.857,105
1958,DET,2021-12-19,100,,MIA,1,240,35,75,0.467,27,43,0.628,8,32,0.25,22,30,0.733,100,28,74,0.378,15,31,0.484,13,43,0.302,21,33,0.636,90
1959,ORL,2021-12-18,100,@,BRK,1,240,39,94,0.415,29,63,0.46,10,31,0.323,12,13,0.923,100,39,102,0.382,30,56,0.536,9,46,0.196,6,8,0.75,93
1960,GSW,2021-12-18,100,@,TOR,0,240,37,79,0.468,26,43,0.605,11,36,0.306,15,21,0.714,100,45,90,0.5,31,52,0.596,14,38,0.368,15,23,0.652,119
1961,IND,2021-12-13,100,,GSW,0,240,35,87,0.402,28,57,0.491,7,30,0.233,23,31,0.742,100,42,84,0.5,34,54,0.63,8,30,0.267,10,14,0.714,102
1962,MIN,2021-11-29,100,,IND,1,240,36,82,0.439,27,47,0.574,9,35,0.257,19,26,0.731,100,36,91,0.396,27,54,0.5,9,37,0.243,17,21,0.81,98
1963,IND,2021-11-28,100,,MIL,0,240,38,92,0.413,26,47,0.553,12,45,0.267,12,16,0.75,100,46,90,0.511,38,55,0.691,8,35,0.229,18,22,0.818,118
1964,MEM,2021-11-26,100,,ATL,0,240,37,91,0.407,25,53,0.472,12,38,0.316,14,19,0.737,100,52,89,0.584,39,62,0.629,13,27,0.481,15,21,0.714,132
1965,MIA,2021-11-23,100,@,DET,1,240,35,76,0.461,26,47,0.553,9,29,0.31,21,29,0.724,100,35,84,0.417,25,46,0.543,10,38,0.263,12,14,0.857,92
1966,LAL,2021-11-23,100,@,NYK,0,240,34,91,0.374,23,55,0.418,11,36,0.306,21,30,0.7,100,37,82,0.451,22,48,0.458,15,34,0.441,17,21,0.81,106
1967,DEN,2021-11-23,100,@,POR,0,240,38,78,0.487,23,45,0.511,15,33,0.455,9,11,0.818,100,45,88,0.511,30,49,0.612,15,39,0.385,14,20,0.7,119
1968,MIA,2021-11-20,100,@,WAS,0,240,38,81,0.469,31,54,0.574,7,27,0.259,17,20,0.85,100,36,74,0.486,25,44,0.568,11,30,0.367,20,23,0.87,103
1969,NOP,2021-11-15,100,@,WAS,0,240,30,74,0.405,19,53,0.358,11,21,0.524,29,34,0.853,100,39,84,0.464,29,56,0.518,10,28,0.357,17,25,0.68,105
1970,MIL,2021-11-14,100,@,ATL,0,240,38,84,0.452,24,43,0.558,14,41,0.341,10,16,0.625,100,47,97,0.485,32,62,0.516,15,35,0.429,11,13,0.846,120
1971,CHI,2021-11-14,100,@,LAC,1,240,38,86,0.442,27,57,0.474,11,29,0.379,13,14,0.929,100,29,81,0.358,18,47,0.383,11,34,0.324,21,21,1.0,90
1972,UTA,2021-11-11,100,,IND,0,240,39,83,0.47,30,51,0.588,9,32,0.281,13,23,0.565,100,43,96,0.448,32,65,0.492,11,31,0.355,14,19,0.737,111
1973,NOP,2021-11-10,100,,OKC,0,240,34,97,0.351,25,62,0.403,9,35,0.257,23,32,0.719,100,37,87,0.425,27,53,0.509,10,34,0.294,24,30,0.8,108
1974,NYK,2021-11-10,100,,MIL,0,240,36,83,0.434,20,46,0.435,16,37,0.432,12,17,0.706,100,40,90,0.444,14,40,0.35,26,50,0.52,6,9,0.667,112
1975,UTA,2021-11-07,100,@,ORL,0,240,34,89,0.382,26,47,0.553,8,42,0.19,24,29,0.828,100,43,87,0.494,31,55,0.564,12,32,0.375,9,11,0.818,107
1976,WAS,2021-11-03,100,,TOR,0,240,34,78,0.436,26,46,0.565,8,32,0.25,24,30,0.8,100,41,88,0.466,31,63,0.492,10,25,0.4,17,20,0.85,109
1977,NOP,2021-11-02,100,@,PHO,0,240,36,91,0.396,23,52,0.442,13,39,0.333,15,16,0.938,100,43,82,0.524,34,56,0.607,9,26,0.346,17,18,0.944,112
1978,IND,2021-10-27,100,@,TOR,0,240,38,79,0.481,28,50,0.56,10,29,0.345,14,17,0.824,100,46,100,0.46,32,70,0.457,14,30,0.467,12,19,0.632,118
1979,TOR,2022-03-21,99,@,CHI,0,240,40,91,0.44,34,59,0.576,6,32,0.188,13,15,0.867,99,44,90,0.489,33,62,0.532,11,28,0.393,14,24,0.583,113
1980,ORL,2022-03-08,99,,PHO,0,240,35,92,0.38,28,53,0.528,7,39,0.179,22,25,0.88,99,35,92,0.38,22,55,0.4,13,37,0.351,19,23,0.826,102
1981,MIA,2022-03-05,99,,PHI,1,240,35,72,0.486,22,44,0.5,13,28,0.464,16,19,0.842,99,28,82,0.341,21,41,0.512,7,41,0.171,19,23,0.826,82
1982,CHI,2022-02-28,99,@,MIA,0,240,41,84,0.488,34,55,0.618,7,29,0.241,10,15,0.667,99,40,81,0.494,28,50,0.56,12,31,0.387,20,26,0.769,112
1983,LAC,2022-02-27,99,@,HOU,1,240,34,77,0.442,23,43,0.535,11,34,0.324,20,28,0.714,99,35,92,0.38,18,50,0.36,17,42,0.405,11,18,0.611,98
1984,MIA,2022-02-15,99,,DAL,0,240,35,84,0.417,28,57,0.491,7,27,0.259,22,27,0.815,99,34,76,0.447,16,35,0.457,18,41,0.439,21,33,0.636,107
1985,LAC,2022-02-12,99,@,DAL,1,240,43,82,0.524,36,60,0.6,7,22,0.318,6,11,0.545,99,35,85,0.412,20,46,0.435,15,39,0.385,12,19,0.632,97
1986,ORL,2022-02-11,99,@,UTA,0,240,37,84,0.44,24,49,0.49,13,35,0.371,12,16,0.75,99,40,89,0.449,27,48,0.563,13,41,0.317,21,24,0.875,114
1987,LAL,2022-02-02,99,,POR,1,240,33,78,0.423,22,48,0.458,11,30,0.367,22,33,0.667,99,35,98,0.357,21,56,0.375,14,42,0.333,10,19,0.526,94
1988,MIL,2022-01-26,99,@,CLE,0,240,37,80,0.463,28,48,0.583,9,32,0.281,16,18,0.889,99,41,87,0.471,22,45,0.489,19,42,0.452,14,17,0.824,115
1989,TOR,2022-01-17,99,@,MIA,0,240,37,90,0.411,24,54,0.444,13,36,0.361,12,17,0.706,99,38,83,0.458,29,59,0.492,9,24,0.375,19,22,0.864,104
1990,GSW,2022-01-16,99,@,MIN,0,240,32,82,0.39,19,40,0.475,13,42,0.31,22,29,0.759,99,45,91,0.495,29,48,0.604,16,43,0.372,13,20,0.65,119
1991,BOS,2022-01-14,99,@,PHI,0,240,37,78,0.474,26,47,0.553,11,31,0.355,14,18,0.778,99,38,85,0.447,24,44,0.545,14,41,0.341,21,25,0.84,111
1992,GSW,2022-01-13,99,@,MIL,0,240,33,95,0.347,17,47,0.362,16,48,0.333,17,24,0.708,99,44,86,0.512,26,45,0.578,18,41,0.439,12,18,0.667,118
1993,PHO,2022-01-11,99,@,TOR,1,240,35,74,0.473,24,42,0.571,11,32,0.344,18,22,0.818,99,36,89,0.404,28,52,0.538,8,37,0.216,15,25,0.6,95
1994,MIL,2022-01-10,99,@,CHO,0,240,37,84,0.44,24,41,0.585,13,43,0.302,12,16,0.75,99,38,96,0.396,25,52,0.481,13,44,0.295,14,16,0.875,103
1995,DEN,2022-01-09,99,@,OKC,1,240,37,89,0.416,24,53,0.453,13,36,0.361,12,16,0.75,99,38,88,0.432,29,50,0.58,9,38,0.237,10,12,0.833,95
1996,CHI,2022-01-09,99,@,DAL,0,240,39,90,0.433,28,57,0.491,11,33,0.333,10,13,0.769,99,44,88,0.5,28,52,0.538,16,36,0.444,9,9,1.0,113
1997,BOS,2022-01-08,99,,NYK,1,240,36,76,0.474,24,47,0.511,12,29,0.414,15,17,0.882,99,29,79,0.367,18,48,0.375,11,31,0.355,6,15,0.4,75
1998,DAL,2022-01-05,99,,GSW,1,240,33,87,0.379,21,47,0.447,12,40,0.3,21,26,0.808,99,33,81,0.407,28,53,0.528,5,28,0.179,11,16,0.688,82
1999,SAS,2022-01-05,99,@,BOS,1,240,42,88,0.477,32,62,0.516,10,26,0.385,5,5,1.0,99,40,90,0.444,31,62,0.5,9,28,0.321,8,9,0.889,97
2000,CHO,2022-01-02,99,,PHO,0,240,39,85,0.459,30,50,0.6,9,35,0.257,12,21,0.571,99,52,103,0.505,35,62,0.565,17,41,0.415,12,12,1.0,133
2001,LAL,2021-12-29,99,@,MEM,0,240,39,86,0.453,24,45,0.533,15,41,0.366,6,8,0.75,99,35,85,0.412,25,55,0.455,10,30,0.333,24,29,0.828,104
2002,HOU,2021-12-27,99,@,CHO,0,240,36,87,0.414,21,41,0.512,15,46,0.326,12,18,0.667,99,47,88,0.534,29,47,0.617,18,41,0.439,11,14,0.786,123
2003,TOR,2021-12-26,99,@,CLE,0,240,37,89,0.416,28,53,0.528,9,36,0.25,16,23,0.696,99,56,106,0.528,34,54,0.63,22,52,0.423,10,12,0.833,144
2004,MEM,2021-12-20,99,,OKC,0,240,39,101,0.386,28,69,0.406,11,32,0.344,10,13,0.769,99,36,84,0.429,25,46,0.543,11,38,0.289,19,28,0.679,102
2005,IND,2021-12-15,99,@,MIL,0,240,39,83,0.47,28,45,0.622,11,38,0.289,10,11,0.909,99,44,90,0.489,30,61,0.492,14,29,0.483,12,15,0.8,114
2006,ORL,2021-12-15,99,,ATL,0,240,35,90,0.389,25,55,0.455,10,35,0.286,19,21,0.905,99,42,85,0.494,31,54,0.574,11,31,0.355,16,16,1.0,111
2007,DAL,2021-12-07,99,,BRK,0,240,36,90,0.4,27,44,0.614,9,46,0.196,18,22,0.818,99,42,83,0.506,34,57,0.596,8,26,0.308,10,13,0.769,102
2008,LAC,2021-12-04,99,@,SAC,0,240,34,89,0.382,21,55,0.382,13,34,0.382,18,27,0.667,99,36,86,0.419,24,52,0.462,12,34,0.353,20,25,0.8,104
2009,NYK,2021-12-04,99,,DEN,0,240,35,88,0.398,23,48,0.479,12,40,0.3,17,21,0.81,99,44,84,0.524,24,41,0.585,20,43,0.465,5,5,1.0,113
2010,WAS,2021-11-29,99,@,SAS,0,240,41,92,0.446,32,61,0.525,9,31,0.29,8,13,0.615,99,49,92,0.533,41,74,0.554,8,18,0.444,10,16,0.625,116
2011,NYK,2021-11-27,99,@,ATL,1,240,36,82,0.439,25,53,0.472,11,29,0.379,16,22,0.727,99,33,93,0.355,24,56,0.429,9,37,0.243,15,20,0.75,90
2012,OKC,2021-11-26,99,,WAS,0,240,38,94,0.404,27,61,0.443,11,33,0.333,12,14,0.857,99,38,79,0.481,28,50,0.56,10,29,0.345,15,15,1.0,101
2013,ORL,2021-11-24,99,,CHO,0,240,38,93,0.409,23,51,0.451,15,42,0.357,8,10,0.8,99,39,93,0.419,27,53,0.509,12,40,0.3,16,21,0.762,106
2014,HOU,2021-11-20,99,@,NYK,0,240,38,84,0.452,28,45,0.622,10,39,0.256,13,22,0.591,99,33,78,0.423,15,37,0.405,18,41,0.439,22,26,0.846,106
2015,CLE,2021-11-17,99,@,BRK,0,240,35,89,0.393,24,45,0.533,11,44,0.25,18,21,0.857,99,38,83,0.458,26,51,0.51,12,32,0.375,21,25,0.84,109
2016,BOS,2021-11-17,99,@,ATL,0,240,37,84,0.44,26,43,0.605,11,41,0.268,14,17,0.824,99,41,81,0.506,28,44,0.636,13,37,0.351,15,18,0.833,110
2017,BRK,2021-11-16,99,,GSW,0,240,34,88,0.386,24,52,0.462,10,36,0.278,21,27,0.778,99,41,79,0.519,28,39,0.718,13,40,0.325,22,28,0.786,117
2018,PHO,2021-11-15,99,@,MIN,1,240,32,85,0.376,25,54,0.463,7,31,0.226,28,36,0.778,99,31,85,0.365,18,41,0.439,13,44,0.295,21,27,0.778,96
2019,OKC,2021-11-07,99,,SAS,1,240,35,94,0.372,23,52,0.442,12,42,0.286,17,20,0.85,99,41,100,0.41,35,70,0.5,6,30,0.2,6,9,0.667,94
2020,NOP,2021-11-03,99,@,SAC,0,240,37,86,0.43,25,52,0.481,12,34,0.353,13,15,0.867,99,42,80,0.525,32,50,0.64,10,30,0.333,18,22,0.818,112
2021,LAC,2021-11-01,99,,OKC,1,240,35,92,0.38,20,50,0.4,15,42,0.357,14,19,0.737,99,35,90,0.389,24,53,0.453,11,37,0.297,13,16,0.813,94
2022,SAC,2021-10-31,99,@,DAL,0,240,38,96,0.396,31,60,0.517,7,36,0.194,16,20,0.8,99,40,90,0.444,28,53,0.528,12,37,0.324,13,20,0.65,105
2023,UTA,2021-10-30,99,@,CHI,0,240,35,92,0.38,24,54,0.444,11,38,0.289,18,19,0.947,99,39,91,0.429,34,70,0.486,5,21,0.238,24,30,0.8,107
2024,CHO,2021-10-29,99,@,MIA,0,240,35,90,0.389,22,53,0.415,13,37,0.351,16,22,0.727,99,43,91,0.473,34,56,0.607,9,35,0.257,19,19,1.0,114
2025,SAS,2021-10-28,99,@,DAL,0,240,39,88,0.443,27,58,0.466,12,30,0.4,9,15,0.6,99,41,89,0.461,23,44,0.523,18,45,0.4,4,13,0.308,104
2026,NOP,2021-10-27,99,,ATL,0,240,40,93,0.43,29,57,0.509,11,36,0.306,8,9,0.889,99,40,96,0.417,32,66,0.485,8,30,0.267,14,17,0.824,102
2027,PHI,2021-10-26,99,@,NYK,0,240,36,82,0.439,24,41,0.585,12,41,0.293,15,17,0.882,99,41,87,0.471,25,50,0.5,16,37,0.432,14,15,0.933,112
2028,CLE,2021-10-25,99,@,DEN,1,240,38,82,0.463,31,57,0.544,7,25,0.28,16,20,0.8,99,35,86,0.407,26,48,0.542,9,38,0.237,8,12,0.667,87
2029,SAC,2022-04-09,98,@,LAC,0,240,38,86,0.442,31,58,0.534,7,28,0.25,15,24,0.625,98,42,86,0.488,21,43,0.488,21,43,0.488,12,15,0.8,117
2030,NYK,2022-04-06,98,,BRK,0,240,32,83,0.386,19,45,0.422,13,38,0.342,21,36,0.583,98,41,93,0.441,27,52,0.519,14,41,0.341,14,18,0.778,110
2031,OKC,2022-04-05,98,,POR,1,240,39,81,0.481,30,52,0.577,9,29,0.31,11,22,0.5,98,35,83,0.422,24,51,0.471,11,32,0.344,13,16,0.813,94
2032,BOS,2022-03-30,98,,MIA,0,240,35,85,0.412,24,48,0.5,11,37,0.297,17,23,0.739,98,38,79,0.481,25,45,0.556,13,34,0.382,17,25,0.68,106
2033,POR,2022-03-26,98,,HOU,0,240,37,93,0.398,25,53,0.472,12,40,0.3,12,17,0.706,98,44,84,0.524,29,49,0.592,15,35,0.429,12,18,0.667,115
2034,CHI,2022-03-26,98,@,CLE,1,240,36,75,0.48,31,54,0.574,5,21,0.238,21,25,0.84,98,34,82,0.415,27,51,0.529,7,31,0.226,19,27,0.704,94
2035,CHI,2022-03-22,98,@,MIL,0,240,39,92,0.424,26,59,0.441,13,33,0.394,7,13,0.538,98,50,82,0.61,38,54,0.704,12,28,0.429,14,20,0.7,126
2036,POR,2022-03-20,98,@,IND,0,240,38,81,0.469,29,48,0.604,9,33,0.273,13,18,0.722,98,48,84,0.571,33,49,0.673,15,35,0.429,18,21,0.857,129
2037,HOU,2022-03-20,98,,MEM,0,240,37,86,0.43,27,55,0.491,10,31,0.323,14,24,0.583,98,46,96,0.479,30,62,0.484,16,34,0.471,14,17,0.824,122
2038,POR,2022-03-16,98,@,NYK,0,240,40,91,0.44,29,57,0.509,11,34,0.324,7,14,0.5,98,40,80,0.5,24,42,0.571,16,38,0.421,32,39,0.821,128
2039,DET,2022-03-15,98,@,MIA,0,240,37,80,0.463,27,46,0.587,10,34,0.294,14,22,0.636,98,29,72,0.403,17,39,0.436,12,33,0.364,35,39,0.897,105
2040,CLE,2022-03-02,98,,CHO,0,240,37,79,0.468,27,48,0.563,10,31,0.323,14,21,0.667,98,43,85,0.506,26,47,0.553,17,38,0.447,16,22,0.727,119
2041,ATL,2022-03-01,98,@,BOS,0,240,36,83,0.434,29,52,0.558,7,31,0.226,19,24,0.792,98,39,83,0.47,28,48,0.583,11,35,0.314,18,19,0.947,107
2042,HOU,2022-02-27,98,,LAC,0,240,35,92,0.38,18,50,0.36,17,42,0.405,11,18,0.611,98,34,77,0.442,23,43,0.535,11,34,0.324,20,28,0.714,99
2043,OKC,2022-02-09,98,,TOR,0,240,36,87,0.414,22,40,0.55,14,47,0.298,12,14,0.857,98,45,88,0.511,32,53,0.604,13,35,0.371,14,14,1.0,117
2044,OKC,2022-02-07,98,,GSW,0,240,37,90,0.411,26,54,0.481,11,36,0.306,13,17,0.765,98,41,82,0.5,26,39,0.667,15,43,0.349,13,17,0.765,110
2045,CLE,2022-02-06,98,,IND,1,240,34,84,0.405,23,52,0.442,11,32,0.344,19,28,0.679,98,31,83,0.373,23,52,0.442,8,31,0.258,15,17,0.882,85
2046,PHI,2022-02-04,98,@,DAL,0,240,36,70,0.514,27,43,0.628,9,27,0.333,17,23,0.739,98,39,85,0.459,29,51,0.569,10,34,0.294,19,23,0.826,107
2047,WAS,2022-02-01,98,@,MIL,0,240,36,82,0.439,24,47,0.511,12,35,0.343,14,20,0.7,98,46,92,0.5,34,54,0.63,12,38,0.316,8,9,0.889,112
2048,OKC,2022-01-31,98,,POR,1,240,35,86,0.407,23,45,0.511,12,41,0.293,16,17,0.941,98,34,81,0.42,27,43,0.628,7,38,0.184,6,8,0.75,81
2049,OKC,2022-01-21,98,@,CHO,0,240,37,98,0.378,25,54,0.463,12,44,0.273,12,15,0.8,98,45,99,0.455,28,50,0.56,17,49,0.347,14,20,0.7,121
2050,TOR,2022-01-19,98,@,DAL,0,240,35,91,0.385,27,59,0.458,8,32,0.25,20,25,0.8,98,37,76,0.487,28,43,0.651,9,33,0.273,19,20,0.95,102
2051,PHI,2022-01-17,98,@,WAS,0,240,35,86,0.407,28,60,0.467,7,26,0.269,21,25,0.84,98,42,87,0.483,33,57,0.579,9,30,0.3,24,32,0.75,117
2052,POR,2022-01-17,98,@,ORL,1,240,37,90,0.411,30,56,0.536,7,34,0.206,17,18,0.944,98,34,90,0.378,26,58,0.448,8,32,0.25,12,20,0.6,88
2053,MIA,2022-01-15,98,,PHI,0,240,33,86,0.384,24,51,0.471,9,35,0.257,23,30,0.767,98,40,79,0.506,27,47,0.574,13,32,0.406,16,21,0.762,109
2054,PHI,2022-01-12,98,,CHO,0,240,34,73,0.466,22,43,0.512,12,30,0.4,18,28,0.643,98,46,89,0.517,36,55,0.655,10,34,0.294,7,8,0.875,109
2055,IND,2022-01-10,98,@,BOS,0,265,36,94,0.383,25,57,0.439,11,37,0.297,15,17,0.882,98,35,88,0.398,27,60,0.45,8,28,0.286,23,28,0.821,101
2056,MIN,2022-01-05,98,,OKC,1,240,36,90,0.4,24,46,0.522,12,44,0.273,14,20,0.7,98,33,90,0.367,24,55,0.436,9,35,0.257,15,18,0.833,90
2057,ORL,2022-01-03,98,@,CHI,0,240,36,85,0.424,26,58,0.448,10,27,0.37,16,18,0.889,98,37,86,0.43,26,55,0.473,11,31,0.355,17,23,0.739,102
2058,ATL,2021-12-23,98,@,PHI,1,240,37,82,0.451,30,58,0.517,7,24,0.292,17,19,0.895,98,33,80,0.413,27,53,0.509,6,27,0.222,24,26,0.923,96
2059,ATL,2021-12-22,98,,ORL,0,240,32,80,0.4,20,49,0.408,12,31,0.387,22,29,0.759,98,38,85,0.447,27,48,0.563,11,37,0.297,17,23,0.739,104
2060,SAC,2021-12-20,98,@,GSW,0,240,37,83,0.446,24,51,0.471,13,32,0.406,11,16,0.688,98,46,88,0.523,31,51,0.608,15,37,0.405,6,9,0.667,113
2061,WAS,2021-12-16,98,@,PHO,0,240,40,82,0.488,34,61,0.557,6,21,0.286,12,19,0.632,98,42,79,0.532,33,50,0.66,9,29,0.31,25,26,0.962,118
2062,WAS,2021-12-11,98,,UTA,0,240,41,89,0.461,33,64,0.516,8,25,0.32,8,14,0.571,98,48,93,0.516,35,54,0.648,13,39,0.333,14,17,0.824,123
2063,PHI,2021-12-03,98,@,ATL,1,240,38,81,0.469,29,59,0.492,9,22,0.409,13,17,0.765,98,31,76,0.408,21,48,0.438,10,28,0.357,24,30,0.8,96
2064,MEM,2021-11-30,98,@,TOR,1,240,36,93,0.387,26,59,0.441,10,34,0.294,16,19,0.842,98,36,91,0.396,26,52,0.5,10,39,0.256,9,12,0.75,91
2065,IND,2021-11-29,98,@,MIN,0,240,36,91,0.396,27,54,0.5,9,37,0.243,17,21,0.81,98,36,82,0.439,27,47,0.574,9,35,0.257,19,26,0.731,100
2066,NOP,2021-11-26,98,@,UTA,1,240,38,89,0.427,27,62,0.435,11,27,0.407,11,13,0.846,98,36,80,0.45,23,47,0.489,13,33,0.394,12,18,0.667,97
2067,NYK,2021-11-17,98,,ORL,0,240,37,88,0.42,21,39,0.538,16,49,0.327,8,12,0.667,98,39,96,0.406,28,58,0.483,11,38,0.289,15,18,0.833,104
2068,NOP,2021-11-17,98,@,MIA,0,240,33,75,0.44,23,40,0.575,10,35,0.286,22,28,0.786,98,42,87,0.483,27,47,0.574,15,40,0.375,14,17,0.824,113
2069,DAL,2021-11-17,98,@,PHO,0,240,38,91,0.418,22,59,0.373,16,32,0.5,6,6,1.0,98,41,93,0.441,28,54,0.519,13,39,0.333,10,14,0.714,105
2070,BOS,2021-11-15,98,@,CLE,1,240,36,78,0.462,26,49,0.531,10,29,0.345,16,20,0.8,98,32,83,0.386,16,43,0.372,16,40,0.4,12,16,0.75,92
2071,CLE,2021-11-12,98,,DET,1,240,39,82,0.476,25,41,0.61,14,41,0.341,6,9,0.667,98,29,79,0.367,20,49,0.408,9,30,0.3,11,13,0.846,78
2072,IND,2021-11-10,98,@,DEN,0,240,40,84,0.476,29,53,0.547,11,31,0.355,7,11,0.636,98,36,84,0.429,24,54,0.444,12,30,0.4,17,20,0.85,101
2073,ATL,2021-11-09,98,@,UTA,0,240,37,85,0.435,19,50,0.38,18,35,0.514,6,10,0.6,98,41,81,0.506,26,43,0.605,15,38,0.395,13,16,0.813,110
2074,MIL,2021-11-05,98,,NYK,0,240,33,82,0.402,17,39,0.436,16,43,0.372,16,21,0.762,98,41,96,0.427,31,56,0.554,10,40,0.25,21,26,0.808,113
2075,ATL,2021-11-04,98,,UTA,0,240,35,82,0.427,28,54,0.519,7,28,0.25,21,26,0.808,98,41,81,0.506,24,40,0.6,17,41,0.415,17,23,0.739,116
2076,DET,2021-11-04,98,,PHI,0,240,35,87,0.402,24,51,0.471,11,36,0.306,17,19,0.895,98,41,83,0.494,29,51,0.569,12,32,0.375,15,22,0.682,109
2077,CHI,2021-11-03,98,@,PHI,0,240,38,82,0.463,32,61,0.525,6,21,0.286,16,18,0.889,98,38,77,0.494,26,49,0.531,12,28,0.429,15,21,0.714,103
2078,NYK,2021-11-03,98,@,IND,0,240,36,87,0.414,31,63,0.492,5,24,0.208,21,27,0.778,98,42,91,0.462,26,50,0.52,16,41,0.39,11,14,0.786,111
2079,IND,2021-10-29,98,@,BRK,0,240,37,93,0.398,29,64,0.453,8,29,0.276,16,23,0.696,98,34,76,0.447,28,50,0.56,6,26,0.231,31,41,0.756,105
2080,OKC,2021-10-26,98,,GSW,0,240,36,86,0.419,24,52,0.462,12,34,0.353,14,17,0.824,98,39,83,0.47,25,43,0.581,14,40,0.35,14,18,0.778,106
2081,MIN,2021-10-25,98,,NOP,0,240,31,90,0.344,16,40,0.4,15,50,0.3,21,27,0.778,98,39,87,0.448,29,57,0.509,10,30,0.333,19,23,0.826,107
2082,WAS,2021-10-20,98,@,TOR,1,240,36,81,0.444,31,54,0.574,5,27,0.185,21,26,0.808,98,30,97,0.309,23,63,0.365,7,34,0.206,16,22,0.727,83
2083,PHO,2021-10-20,98,,DEN,0,240,36,87,0.414,22,50,0.44,14,37,0.378,12,17,0.706,98,44,83,0.53,27,44,0.614,17,39,0.436,5,9,0.556,110
2084,DEN,2022-04-05,97,,SAS,0,240,41,98,0.418,34,65,0.523,7,33,0.212,8,12,0.667,97,44,89,0.494,32,63,0.508,12,26,0.462,16,24,0.667,116
2085,DET,2022-03-25,97,,WAS,0,240,39,95,0.411,33,63,0.524,6,32,0.188,13,14,0.929,97,36,83,0.434,27,53,0.509,9,30,0.3,19,21,0.905,100
2086,LAC,2022-03-25,97,,PHI,0,240,34,85,0.4,26,60,0.433,8,25,0.32,21,25,0.84,97,43,92,0.467,28,57,0.491,15,35,0.429,21,24,0.875,122
2087,UTA,2022-03-23,97,@,BOS,0,240,35,88,0.398,27,52,0.519,8,36,0.222,19,21,0.905,97,50,84,0.595,31,48,0.646,19,36,0.528,6,7,0.857,125
2088,WAS,2022-03-21,97,@,HOU,0,240,35,85,0.412,29,56,0.518,6,29,0.207,21,24,0.875,97,42,85,0.494,22,46,0.478,20,39,0.513,11,13,0.846,115
2089,WAS,2022-03-18,97,@,NYK,0,240,34,79,0.43,21,45,0.467,13,34,0.382,16,21,0.762,97,31,90,0.344,21,57,0.368,10,33,0.303,28,36,0.778,100
2090,SAC,2022-03-18,97,,BOS,0,240,33,79,0.418,20,43,0.465,13,36,0.361,18,24,0.75,97,46,82,0.561,24,42,0.571,22,40,0.55,12,17,0.706,126
2091,LAC,2022-03-08,97,@,GSW,0,240,33,93,0.355,21,54,0.389,12,39,0.308,19,23,0.826,97,44,92,0.478,31,58,0.534,13,34,0.382,11,13,0.846,112
2092,TOR,2022-03-04,97,,ORL,0,240,37,93,0.398,25,56,0.446,12,37,0.324,11,17,0.647,97,36,95,0.379,25,58,0.431,11,37,0.297,20,21,0.952,103
2093,BRK,2022-02-28,97,,TOR,0,240,33,86,0.384,21,51,0.412,12,35,0.343,19,24,0.792,97,51,99,0.515,33,61,0.541,18,38,0.474,13,22,0.591,133
2094,DAL,2022-02-12,97,,LAC,0,240,35,85,0.412,20,46,0.435,15,39,0.385,12,19,0.632,97,43,82,0.524,36,60,0.6,7,22,0.318,6,11,0.545,99
2095,NOP,2022-02-10,97,,MIA,0,240,36,85,0.424,25,44,0.568,11,41,0.268,14,16,0.875,97,39,81,0.481,29,49,0.592,10,32,0.313,24,28,0.857,112
2096,HOU,2022-02-08,97,@,NOP,0,240,32,86,0.372,19,44,0.432,13,42,0.31,20,31,0.645,97,42,80,0.525,34,48,0.708,8,32,0.25,18,20,0.9,110
2097,NOP,2022-01-29,97,,BOS,0,240,36,82,0.439,28,50,0.56,8,32,0.25,17,23,0.739,97,43,81,0.531,29,40,0.725,14,41,0.341,7,11,0.636,107
2098,UTA,2022-01-26,97,,PHO,0,240,34,79,0.43,22,49,0.449,12,30,0.4,17,23,0.739,97,40,82,0.488,33,64,0.516,7,18,0.389,18,27,0.667,105
2099,CHO,2022-01-17,97,@,NYK,1,240,36,86,0.419,22,47,0.468,14,39,0.359,11,17,0.647,97,32,80,0.4,20,46,0.435,12,34,0.353,11,21,0.524,87
2100,DET,2022-01-08,97,,ORL,1,240,38,87,0.437,28,54,0.519,10,33,0.303,11,16,0.688,97,29,86,0.337,15,40,0.375,14,46,0.304,20,23,0.87,92
2101,BOS,2022-01-05,97,,SAS,0,240,40,90,0.444,31,62,0.5,9,28,0.321,8,9,0.889,97,42,88,0.477,32,62,0.516,10,26,0.385,5,5,1.0,99
2102,OKC,2021-12-29,97,@,PHO,0,240,38,96,0.396,31,61,0.508,7,35,0.2,14,16,0.875,97,41,89,0.461,29,55,0.527,12,34,0.353,21,28,0.75,115
2103,POR,2021-12-21,97,@,NOP,0,240,35,78,0.449,22,44,0.5,13,34,0.382,14,19,0.737,97,42,80,0.525,30,47,0.638,12,33,0.364,15,18,0.833,111
2104,NYK,2021-12-12,97,,MIL,0,240,35,82,0.427,18,33,0.545,17,49,0.347,10,13,0.769,97,42,88,0.477,28,47,0.596,14,41,0.341,14,17,0.824,112
2105,NOP,2021-12-12,97,@,SAS,0,240,40,94,0.426,32,65,0.492,8,29,0.276,9,15,0.6,97,45,91,0.495,38,66,0.576,7,25,0.28,15,20,0.75,112
2106,DEN,2021-12-06,97,@,CHI,0,240,38,96,0.396,27,64,0.422,11,32,0.344,10,15,0.667,97,41,91,0.451,28,56,0.5,13,35,0.371,14,20,0.7,109
2107,MEM,2021-12-04,97,@,DAL,1,240,37,76,0.487,28,50,0.56,9,26,0.346,14,24,0.583,97,31,92,0.337,16,49,0.327,15,43,0.349,13,19,0.684,90
2108,TOR,2021-12-02,97,,MIL,1,240,37,88,0.42,23,48,0.479,14,40,0.35,9,14,0.643,97,32,85,0.376,21,54,0.389,11,31,0.355,18,25,0.72,93
2109,TOR,2021-11-28,97,,BOS,0,240,35,93,0.376,22,51,0.431,13,42,0.31,14,16,0.875,97,34,82,0.415,22,48,0.458,12,34,0.353,29,31,0.935,109
2110,TOR,2021-11-26,97,@,IND,0,240,37,89,0.416,30,59,0.508,7,30,0.233,16,22,0.727,97,47,97,0.485,36,58,0.621,11,39,0.282,9,11,0.818,114
2111,NYK,2021-11-26,97,,PHO,0,240,34,92,0.37,22,53,0.415,12,39,0.308,17,22,0.773,97,44,79,0.557,31,51,0.608,13,28,0.464,17,21,0.81,118
2112,UTA,2021-11-26,97,,NOP,0,240,36,80,0.45,23,47,0.489,13,33,0.394,12,18,0.667,97,38,89,0.427,27,62,0.435,11,27,0.407,11,13,0.846,98
2113,LAC,2021-11-21,97,,DAL,1,240,36,75,0.48,24,46,0.522,12,29,0.414,13,18,0.722,97,34,83,0.41,28,53,0.528,6,30,0.2,17,18,0.944,91
2114,DEN,2021-11-21,97,@,PHO,0,240,33,90,0.367,22,52,0.423,11,38,0.289,20,28,0.714,97,46,87,0.529,35,51,0.686,11,36,0.306,23,26,0.885,126
2115,WAS,2021-11-18,97,@,MIA,0,240,38,77,0.494,23,41,0.561,15,36,0.417,6,10,0.6,97,41,82,0.5,31,56,0.554,10,26,0.385,20,24,0.833,112
2116,DET,2021-11-17,97,,IND,1,240,34,80,0.425,26,52,0.5,8,28,0.286,21,28,0.75,97,33,79,0.418,24,42,0.571,9,37,0.243,14,19,0.737,89
2117,SAC,2021-11-17,97,@,MIN,0,240,34,93,0.366,24,55,0.436,10,38,0.263,19,25,0.76,97,41,82,0.5,31,46,0.674,10,36,0.278,15,18,0.833,107
2118,CHO,2021-11-17,97,,WAS,1,240,42,96,0.438,32,64,0.5,10,32,0.313,3,6,0.5,97,33,90,0.367,25,48,0.521,8,42,0.19,13,16,0.813,87
2119,WAS,2021-11-10,97,@,CLE,1,240,35,84,0.417,25,56,0.446,10,28,0.357,17,17,1.0,97,35,76,0.461,26,45,0.578,9,31,0.29,15,21,0.714,94
2120,MIN,2021-11-01,97,,ORL,0,240,36,97,0.371,22,46,0.478,14,51,0.275,11,19,0.579,97,37,82,0.451,20,39,0.513,17,43,0.395,24,30,0.8,115
2121,DEN,2021-11-01,97,@,MEM,0,240,39,88,0.443,30,50,0.6,9,38,0.237,10,15,0.667,97,44,97,0.454,31,63,0.492,13,34,0.382,5,7,0.714,106
2122,TOR,2021-10-30,97,@,IND,1,240,39,92,0.424,28,60,0.467,11,32,0.344,8,12,0.667,97,35,81,0.432,22,38,0.579,13,43,0.302,11,16,0.688,94
2123,HOU,2021-10-24,97,,BOS,0,240,32,75,0.427,18,43,0.419,14,32,0.438,19,24,0.792,97,38,86,0.442,23,39,0.59,15,47,0.319,16,20,0.8,107
2124,CHI,2021-10-23,97,,DET,1,240,35,84,0.417,24,58,0.414,11,26,0.423,16,19,0.842,97,34,88,0.386,29,60,0.483,5,28,0.179,9,15,0.6,82
2125,ORL,2021-10-20,97,@,SAS,0,240,35,86,0.407,26,57,0.456,9,29,0.31,18,23,0.783,97,49,98,0.5,36,68,0.529,13,30,0.433,12,18,0.667,123
2126,NOP,2021-10-20,97,,PHI,0,240,39,93,0.419,26,63,0.413,13,30,0.433,6,9,0.667,97,44,85,0.518,31,60,0.517,13,25,0.52,16,20,0.8,117
2127,PHO,2022-04-03,96,@,OKC,0,240,37,89,0.416,30,51,0.588,7,38,0.184,15,17,0.882,96,43,87,0.494,26,46,0.565,17,41,0.415,14,18,0.778,117
2128,POR,2022-03-23,96,,SAS,0,240,36,94,0.383,29,68,0.426,7,26,0.269,17,18,0.944,96,46,94,0.489,27,50,0.54,19,44,0.432,22,24,0.917,133
2129,TOR,2022-03-06,96,@,CLE,0,240,37,94,0.394,31,70,0.443,6,24,0.25,16,26,0.615,96,39,85,0.459,28,49,0.571,11,36,0.306,15,23,0.652,104
2130,ORL,2022-03-05,96,@,MEM,0,240,37,86,0.43,26,51,0.51,11,35,0.314,11,16,0.688,96,46,92,0.5,32,58,0.552,14,34,0.412,18,27,0.667,124
2131,LAC,2022-02-15,96,@,PHO,0,240,40,97,0.412,30,62,0.484,10,35,0.286,6,9,0.667,96,44,90,0.489,36,65,0.554,8,25,0.32,7,10,0.7,103
2132,OKC,2022-02-04,96,@,POR,1,240,33,87,0.379,18,45,0.4,15,42,0.357,15,21,0.714,96,40,101,0.396,34,68,0.5,6,33,0.182,7,10,0.7,93
2133,SAC,2022-01-31,96,@,NYK,0,240,37,86,0.43,26,48,0.542,11,38,0.289,11,22,0.5,96,40,80,0.5,27,45,0.6,13,35,0.371,23,29,0.793,116
2134,NYK,2022-01-26,96,@,MIA,0,240,35,83,0.422,20,39,0.513,15,44,0.341,11,17,0.647,96,37,74,0.5,21,37,0.568,16,37,0.432,20,22,0.909,110
2135,BRK,2022-01-25,96,,LAL,0,240,37,88,0.42,30,61,0.492,7,27,0.259,15,22,0.682,96,42,89,0.472,30,51,0.588,12,38,0.316,10,10,1.0,106
2136,OKC,2022-01-19,96,@,SAS,0,240,38,98,0.388,30,67,0.448,8,31,0.258,12,15,0.8,96,47,96,0.49,32,56,0.571,15,40,0.375,9,14,0.643,118
2137,MIL,2022-01-15,96,,TOR,0,240,26,77,0.338,14,38,0.368,12,39,0.308,32,35,0.914,96,40,91,0.44,28,56,0.5,12,35,0.343,11,20,0.55,103
2138,LAL,2022-01-15,96,@,DEN,0,240,36,82,0.439,26,52,0.5,10,30,0.333,14,19,0.737,96,47,91,0.516,24,51,0.471,23,40,0.575,16,17,0.941,133
2139,CHI,2022-01-14,96,,GSW,0,240,37,87,0.425,27,49,0.551,10,38,0.263,12,18,0.667,96,53,94,0.564,34,52,0.654,19,42,0.452,13,17,0.765,138
2140,SAS,2022-01-10,96,@,NYK,0,240,39,95,0.411,31,66,0.47,8,29,0.276,10,15,0.667,96,40,82,0.488,27,50,0.54,13,32,0.406,18,24,0.75,111
2141,GSW,2022-01-09,96,,CLE,1,240,39,97,0.402,29,55,0.527,10,42,0.238,8,10,0.8,96,32,75,0.427,25,51,0.49,7,24,0.292,11,18,0.611,82
2142,GSW,2022-01-06,96,@,NOP,0,240,37,87,0.425,30,54,0.556,7,33,0.212,15,18,0.833,96,35,83,0.422,27,49,0.551,8,34,0.235,23,29,0.793,101
2143,SAC,2021-12-31,96,,DAL,0,240,38,91,0.418,28,62,0.452,10,29,0.345,10,12,0.833,96,42,81,0.519,33,59,0.559,9,22,0.409,19,22,0.864,112
2144,NYK,2021-12-28,96,@,MIN,1,240,37,90,0.411,21,50,0.42,16,40,0.4,6,16,0.375,96,34,85,0.4,27,47,0.574,7,38,0.184,13,20,0.65,88
2145,WAS,2021-12-26,96,,PHI,0,240,35,90,0.389,27,57,0.474,8,33,0.242,18,28,0.643,96,43,86,0.5,31,55,0.564,12,31,0.387,19,22,0.864,117
2146,PHI,2021-12-23,96,,ATL,0,240,33,80,0.413,27,53,0.509,6,27,0.222,24,26,0.923,96,37,82,0.451,30,58,0.517,7,24,0.292,17,19,0.895,98
2147,IND,2021-12-21,96,@,MIA,0,240,31,87,0.356,20,56,0.357,11,31,0.355,23,28,0.821,96,47,95,0.495,25,46,0.543,22,49,0.449,9,11,0.818,125
2148,PHI,2021-12-15,96,,MIA,0,240,35,79,0.443,23,42,0.548,12,37,0.324,14,17,0.824,96,35,78,0.449,17,34,0.5,18,44,0.409,13,17,0.765,101
2149,NYK,2021-12-14,96,,GSW,0,240,30,83,0.361,14,41,0.341,16,42,0.381,20,22,0.909,96,35,77,0.455,20,37,0.541,15,40,0.375,20,27,0.741,105
2150,CHO,2021-12-13,96,@,DAL,0,240,34,86,0.395,21,49,0.429,13,37,0.351,15,24,0.625,96,43,83,0.518,24,42,0.571,19,41,0.463,15,17,0.882,120
2151,PHI,2021-12-09,96,,UTA,0,240,38,88,0.432,32,55,0.582,6,33,0.182,14,15,0.933,96,43,91,0.473,28,51,0.549,15,40,0.375,17,24,0.708,118
2152,MEM,2021-12-08,96,,DAL,0,240,36,90,0.4,27,59,0.458,9,31,0.29,15,25,0.6,96,37,77,0.481,25,44,0.568,12,33,0.364,18,23,0.783,104
2153,PHO,2021-12-03,96,@,GSW,0,240,31,81,0.383,23,59,0.39,8,22,0.364,26,35,0.743,96,45,92,0.489,26,53,0.491,19,39,0.487,9,12,0.75,118
2154,ATL,2021-12-03,96,,PHI,0,240,31,76,0.408,21,48,0.438,10,28,0.357,24,30,0.8,96,38,81,0.469,29,59,0.492,9,22,0.409,13,17,0.765,98
2155,GSW,2021-11-30,96,@,PHO,0,240,36,86,0.419,22,46,0.478,14,40,0.35,10,14,0.714,96,43,87,0.494,31,57,0.544,12,30,0.4,6,11,0.545,104
2156,ORL,2021-11-29,96,@,PHI,0,240,37,90,0.411,29,57,0.509,8,33,0.242,14,18,0.778,96,39,97,0.402,29,64,0.453,10,33,0.303,13,18,0.722,101
2157,DAL,2021-11-29,96,,CLE,0,240,39,89,0.438,27,50,0.54,12,39,0.308,6,15,0.4,96,45,80,0.563,35,61,0.574,10,19,0.526,14,18,0.778,114
2158,SAS,2021-11-26,96,,BOS,1,240,38,87,0.437,32,63,0.508,6,24,0.25,14,19,0.737,96,34,92,0.37,24,58,0.414,10,34,0.294,10,15,0.667,88
2159,DET,2021-11-26,96,@,LAC,0,240,33,90,0.367,25,57,0.439,8,33,0.242,22,26,0.846,96,39,91,0.429,28,53,0.528,11,38,0.289,18,19,0.947,107
2160,PHI,2021-11-24,96,@,GSW,0,240,34,80,0.425,26,52,0.5,8,28,0.286,20,22,0.909,96,42,80,0.525,27,42,0.643,15,38,0.395,17,24,0.708,116
2161,NOP,2021-11-22,96,,MIN,0,240,37,88,0.42,31,56,0.554,6,32,0.188,16,18,0.889,96,40,100,0.4,30,56,0.536,10,44,0.227,20,28,0.714,110
2162,MIL,2021-11-19,96,,OKC,1,240,31,83,0.373,19,42,0.452,12,41,0.293,22,26,0.846,96,32,91,0.352,20,43,0.465,12,48,0.25,13,21,0.619,89
2163,MIN,2021-11-15,96,,PHO,0,240,31,85,0.365,18,41,0.439,13,44,0.295,21,27,0.778,96,32,85,0.376,25,54,0.463,7,31,0.226,28,36,0.778,99
2164,OKC,2021-11-14,96,,BRK,0,240,36,90,0.4,22,45,0.489,14,45,0.311,10,11,0.909,96,41,82,0.5,23,39,0.59,18,43,0.419,20,21,0.952,120
2165,ATL,2021-11-12,96,@,DEN,0,240,38,93,0.409,33,65,0.508,5,28,0.179,15,21,0.714,96,40,90,0.444,30,55,0.545,10,35,0.286,15,20,0.75,105
2166,NYK,2021-11-12,96,@,CHO,0,240,36,93,0.387,23,58,0.397,13,35,0.371,11,18,0.611,96,39,90,0.433,29,54,0.537,10,36,0.278,16,24,0.667,104
2167,MIA,2021-11-08,96,@,DEN,0,240,31,78,0.397,18,42,0.429,13,36,0.361,21,25,0.84,96,42,91,0.462,30,50,0.6,12,41,0.293,17,24,0.708,113
2168,PHI,2021-11-08,96,,NYK,0,240,35,91,0.385,22,51,0.431,13,40,0.325,13,16,0.813,96,40,91,0.44,27,51,0.529,13,40,0.325,10,13,0.769,103
2169,BRK,2021-11-05,96,@,DET,1,240,36,80,0.45,25,53,0.472,11,27,0.407,13,14,0.929,96,33,87,0.379,22,53,0.415,11,34,0.324,13,18,0.722,90
2170,MEM,2021-10-27,96,@,POR,0,240,35,96,0.365,18,46,0.391,17,50,0.34,9,19,0.474,96,39,84,0.464,24,48,0.5,15,36,0.417,23,31,0.742,116
2171,MIN,2021-10-23,96,,NOP,1,240,39,96,0.406,27,58,0.466,12,38,0.316,6,10,0.6,96,31,89,0.348,22,49,0.449,9,40,0.225,18,23,0.783,89
2172,SAS,2021-10-22,96,@,DEN,0,240,40,84,0.476,34,60,0.567,6,24,0.25,10,14,0.714,96,44,86,0.512,35,56,0.625,9,30,0.3,5,8,0.625,102
2173,ORL,2021-10-22,96,,NYK,0,240,33,83,0.398,16,40,0.4,17,43,0.395,13,15,0.867,96,44,88,0.5,20,34,0.588,24,54,0.444,9,17,0.529,121
2174,GSW,2022-03-28,95,@,MEM,0,240,33,81,0.407,24,52,0.462,9,29,0.31,20,26,0.769,95,43,92,0.467,31,62,0.5,12,30,0.4,25,35,0.714,123
2175,MIA,2022-03-26,95,,BRK,0,240,33,75,0.44,23,41,0.561,10,34,0.294,19,26,0.731,95,39,83,0.47,28,50,0.56,11,33,0.333,21,26,0.808,110
2176,DAL,2022-03-25,95,@,MIN,0,240,35,90,0.389,25,47,0.532,10,43,0.233,15,19,0.789,95,43,84,0.512,32,52,0.615,11,32,0.344,19,24,0.792,116
2177,DAL,2022-03-13,95,@,BOS,1,240,33,74,0.446,18,37,0.486,15,37,0.405,14,19,0.737,95,33,88,0.375,24,51,0.471,9,37,0.243,17,19,0.895,92
2178,SAC,2022-03-02,95,@,NOP,0,240,35,89,0.393,27,54,0.5,8,35,0.229,17,25,0.68,95,52,88,0.591,41,59,0.695,11,29,0.379,10,12,0.833,125
2179,LAL,2022-02-27,95,,NOP,0,240,35,84,0.417,28,50,0.56,7,34,0.206,18,20,0.9,95,47,92,0.511,34,62,0.548,13,30,0.433,16,25,0.64,123
2180,POR,2022-02-24,95,,GSW,0,240,31,79,0.392,22,44,0.5,9,35,0.257,24,29,0.828,95,45,88,0.511,30,47,0.638,15,41,0.366,27,32,0.844,132
2181,ATL,2022-02-13,95,@,BOS,0,240,34,93,0.366,22,55,0.4,12,38,0.316,15,15,1.0,95,36,85,0.424,25,47,0.532,11,38,0.289,22,27,0.815,105
2182,POR,2022-02-08,95,,ORL,0,240,32,91,0.352,21,53,0.396,11,38,0.289,20,26,0.769,95,44,90,0.489,25,52,0.481,19,38,0.5,6,8,0.75,113
2183,PHO,2022-02-05,95,@,WAS,1,240,40,99,0.404,32,68,0.471,8,31,0.258,7,14,0.5,95,30,85,0.353,25,61,0.41,5,24,0.208,15,19,0.789,80
2184,SAS,2022-02-03,95,,MIA,0,240,30,80,0.375,22,47,0.468,8,33,0.242,27,38,0.711,95,42,83,0.506,30,53,0.566,12,30,0.4,16,18,0.889,112
2185,WAS,2022-01-29,95,@,MEM,0,240,35,84,0.417,25,55,0.455,10,29,0.345,15,21,0.714,95,46,100,0.46,33,69,0.478,13,31,0.419,10,12,0.833,115
2186,CLE,2022-01-24,95,,NYK,1,240,35,81,0.432,22,45,0.489,13,36,0.361,12,20,0.6,95,35,84,0.417,23,46,0.5,12,38,0.316,11,21,0.524,93
2187,CHI,2022-01-23,95,@,ORL,0,240,33,76,0.434,28,55,0.509,5,21,0.238,24,32,0.75,95,42,80,0.525,30,54,0.556,12,26,0.462,18,23,0.783,114
2188,UTA,2022-01-17,95,@,LAL,0,240,31,83,0.373,19,37,0.514,12,46,0.261,21,24,0.875,95,38,86,0.442,27,49,0.551,11,37,0.297,14,23,0.609,101
2189,TOR,2022-01-11,95,,PHO,0,240,36,89,0.404,28,52,0.538,8,37,0.216,15,25,0.6,95,35,74,0.473,24,42,0.571,11,32,0.344,18,22,0.818,99
2190,OKC,2022-01-09,95,,DEN,0,240,38,88,0.432,29,50,0.58,9,38,0.237,10,12,0.833,95,37,89,0.416,24,53,0.453,13,36,0.361,12,16,0.75,99
2191,DAL,2022-01-02,95,@,OKC,1,240,38,85,0.447,24,46,0.522,14,39,0.359,5,7,0.714,95,35,85,0.412,25,55,0.455,10,30,0.333,6,9,0.667,86
2192,OKC,2021-12-31,95,,NYK,1,240,36,87,0.414,18,44,0.409,18,43,0.419,5,7,0.714,95,30,81,0.37,22,40,0.55,8,41,0.195,12,22,0.545,80
2193,SAC,2021-12-29,95,,DAL,1,240,36,75,0.48,26,49,0.531,10,26,0.385,13,15,0.867,95,38,81,0.469,29,57,0.509,9,24,0.375,9,13,0.692,94
2194,DAL,2021-12-23,95,,MIL,0,240,35,86,0.407,23,41,0.561,12,45,0.267,13,17,0.765,95,37,82,0.451,27,46,0.587,10,36,0.278,18,22,0.818,102
2195,PHO,2021-12-13,95,@,LAC,0,240,36,96,0.375,29,67,0.433,7,29,0.241,16,19,0.842,95,43,78,0.551,34,57,0.596,9,21,0.429,16,23,0.696,111
2196,OKC,2021-12-10,95,,LAL,0,240,38,96,0.396,28,52,0.538,10,44,0.227,9,14,0.643,95,41,87,0.471,22,45,0.489,19,42,0.452,15,20,0.75,116
2197,LAL,2021-12-09,95,@,MEM,0,240,36,78,0.462,24,48,0.5,12,30,0.4,11,17,0.647,95,41,94,0.436,27,52,0.519,14,42,0.333,12,18,0.667,108
2198,ORL,2021-12-06,95,@,GSW,0,240,33,76,0.434,22,38,0.579,11,38,0.289,18,22,0.818,95,43,87,0.494,23,47,0.489,20,40,0.5,20,29,0.69,126
2199,MEM,2021-11-20,95,@,MIN,0,240,29,83,0.349,20,51,0.392,9,32,0.281,28,35,0.8,95,49,91,0.538,29,50,0.58,20,41,0.488,20,28,0.714,138
2200,POR,2021-11-14,95,@,DEN,0,240,35,80,0.438,22,41,0.537,13,39,0.333,12,13,0.923,95,47,90,0.522,28,50,0.56,19,40,0.475,11,14,0.786,124
2201,BRK,2021-11-08,95,@,CHI,0,240,34,86,0.395,23,53,0.434,11,33,0.333,16,19,0.842,95,46,98,0.469,37,67,0.552,9,31,0.29,17,20,0.85,118
2202,DEN,2021-11-06,95,,HOU,1,240,36,89,0.404,27,49,0.551,9,40,0.225,14,17,0.824,95,35,75,0.467,27,47,0.574,8,28,0.286,16,24,0.667,94
2203,BOS,2021-11-04,95,@,MIA,1,240,31,78,0.397,15,37,0.405,16,41,0.39,17,20,0.85,95,28,81,0.346,19,40,0.475,9,41,0.22,13,19,0.684,78
2204,LAL,2021-10-31,95,,HOU,1,240,39,96,0.406,30,65,0.462,9,31,0.29,8,13,0.615,95,32,76,0.421,26,48,0.542,6,28,0.214,15,29,0.517,85
2205,MIL,2021-10-31,95,,UTA,0,240,39,96,0.406,27,55,0.491,12,41,0.293,5,6,0.833,95,35,75,0.467,23,38,0.605,12,37,0.324,25,27,0.926,107
2206,BRK,2021-10-24,95,,CHO,0,240,38,87,0.437,29,52,0.558,9,35,0.257,10,12,0.833,95,43,94,0.457,33,64,0.516,10,30,0.333,15,19,0.789,111
2207,ATL,2021-10-23,95,@,CLE,0,240,38,99,0.384,28,65,0.431,10,34,0.294,9,15,0.6,95,37,89,0.416,30,61,0.492,7,28,0.25,20,27,0.741,101
2208,TOR,2021-10-23,95,,DAL,0,240,34,85,0.4,23,48,0.479,11,37,0.297,16,23,0.696,95,38,91,0.418,24,49,0.49,14,42,0.333,13,18,0.722,103
2209,MIL,2021-10-21,95,@,MIA,0,240,32,84,0.381,20,42,0.476,12,42,0.286,19,29,0.655,95,51,96,0.531,36,61,0.59,15,35,0.429,20,31,0.645,137
2210,TOR,2022-04-10,94,@,NYK,0,240,36,92,0.391,24,50,0.48,12,42,0.286,10,11,0.909,94,40,87,0.46,25,44,0.568,15,43,0.349,10,12,0.833,105
2211,SAS,2022-04-09,94,,GSW,0,240,32,80,0.4,22,49,0.449,10,31,0.323,20,27,0.741,94,33,81,0.407,25,49,0.51,8,32,0.25,26,33,0.788,100
2212,POR,2022-04-07,94,@,NOP,0,240,36,69,0.522,25,38,0.658,11,31,0.355,11,13,0.846,94,44,93,0.473,31,56,0.554,13,37,0.351,26,31,0.839,127
2213,CHI,2022-04-06,94,,BOS,0,240,35,80,0.438,28,57,0.491,7,23,0.304,17,23,0.739,94,43,88,0.489,26,51,0.51,17,37,0.459,14,22,0.636,117
2214,POR,2022-04-05,94,@,OKC,0,240,35,83,0.422,24,51,0.471,11,32,0.344,13,16,0.813,94,39,81,0.481,30,52,0.577,9,29,0.31,11,22,0.5,98
2215,PHI,2022-03-31,94,@,DET,0,240,31,69,0.449,24,43,0.558,7,26,0.269,25,28,0.893,94,41,82,0.5,31,47,0.66,10,35,0.286,10,15,0.667,102
2216,WAS,2022-03-29,94,,CHI,0,240,38,79,0.481,32,53,0.604,6,26,0.231,12,17,0.706,94,43,85,0.506,37,67,0.552,6,18,0.333,15,18,0.833,107
2217,CLE,2022-03-26,94,,CHI,0,240,34,82,0.415,27,51,0.529,7,31,0.226,19,27,0.704,94,36,75,0.48,31,54,0.574,5,21,0.238,21,25,0.84,98
2218,ORL,2022-03-22,94,,GSW,1,240,34,79,0.43,24,43,0.558,10,36,0.278,16,20,0.8,94,34,85,0.4,23,53,0.434,11,32,0.344,11,16,0.688,90
2219,DET,2022-02-14,94,@,WAS,0,240,32,85,0.376,24,62,0.387,8,23,0.348,22,27,0.815,94,40,85,0.471,31,56,0.554,9,29,0.31,14,18,0.778,103
2220,ATL,2022-02-06,94,@,DAL,0,240,37,95,0.389,32,70,0.457,5,25,0.2,15,16,0.938,94,38,88,0.432,22,52,0.423,16,36,0.444,11,13,0.846,103
2221,POR,2022-02-02,94,@,LAL,0,240,35,98,0.357,21,56,0.375,14,42,0.333,10,19,0.526,94,33,78,0.423,22,48,0.458,11,30,0.367,22,33,0.667,99
2222,GSW,2022-01-23,94,,UTA,1,240,36,83,0.434,23,41,0.561,13,42,0.31,9,10,0.9,94,31,81,0.383,20,46,0.435,11,35,0.314,19,23,0.826,92
2223,CLE,2022-01-22,94,,OKC,1,240,35,76,0.461,29,49,0.592,6,27,0.222,18,35,0.514,94,33,85,0.388,21,44,0.477,12,41,0.293,9,16,0.563,87
2224,MIL,2022-01-21,94,,CHI,1,240,34,88,0.386,28,57,0.491,6,31,0.194,20,28,0.714,94,31,85,0.365,24,47,0.511,7,38,0.184,21,24,0.875,90
2225,LAC,2022-01-15,94,@,SAS,0,240,38,100,0.38,26,62,0.419,12,38,0.316,6,8,0.75,94,34,83,0.41,23,46,0.5,11,37,0.297,22,27,0.815,101
2226,IND,2022-01-14,94,,PHO,0,240,34,88,0.386,21,45,0.467,13,43,0.302,13,18,0.722,94,40,88,0.455,29,60,0.483,11,28,0.393,21,23,0.913,112
2227,IND,2022-01-04,94,@,NYK,0,240,32,76,0.421,23,38,0.605,9,38,0.237,21,32,0.656,94,39,80,0.488,33,52,0.635,6,28,0.214,20,28,0.714,104
2228,DAL,2021-12-29,94,@,SAC,0,240,38,81,0.469,29,57,0.509,9,24,0.375,9,13,0.692,94,36,75,0.48,26,49,0.531,10,26,0.385,13,15,0.867,95
2229,NYK,2021-12-29,94,@,DET,1,240,31,81,0.383,23,50,0.46,8,31,0.258,24,27,0.889,94,30,81,0.37,18,46,0.391,12,35,0.343,13,17,0.765,85
2230,DEN,2021-12-22,94,@,OKC,0,240,33,84,0.393,20,40,0.5,13,44,0.295,15,26,0.577,94,42,94,0.447,34,60,0.567,8,34,0.235,16,19,0.842,108
2231,MIA,2021-12-13,94,@,CLE,0,240,38,85,0.447,25,45,0.556,13,40,0.325,5,9,0.556,94,36,81,0.444,20,45,0.444,16,36,0.444,17,18,0.944,105
2232,ORL,2021-12-12,94,@,LAL,0,240,33,88,0.375,20,50,0.4,13,38,0.342,15,19,0.789,94,41,84,0.488,28,56,0.5,13,28,0.464,11,17,0.647,106
2233,POR,2021-12-08,94,@,GSW,0,240,33,80,0.413,25,50,0.5,8,30,0.267,20,28,0.714,94,33,83,0.398,19,37,0.514,14,46,0.304,24,31,0.774,104
2234,SAC,2021-11-22,94,,PHI,0,240,33,80,0.413,26,49,0.531,7,31,0.226,21,29,0.724,94,36,85,0.424,27,53,0.509,9,32,0.281,21,27,0.778,102
2235,NOP,2021-11-20,94,@,IND,0,240,35,88,0.398,29,70,0.414,6,18,0.333,18,19,0.947,94,42,91,0.462,28,53,0.528,14,38,0.368,13,18,0.722,111
2236,NOP,2021-11-19,94,,LAC,1,240,38,87,0.437,25,57,0.439,13,30,0.433,5,8,0.625,94,34,90,0.378,25,53,0.472,9,37,0.243,4,5,0.8,81
2237,MEM,2021-11-12,94,,PHO,0,240,37,98,0.378,30,65,0.462,7,33,0.212,13,23,0.565,94,46,94,0.489,28,57,0.491,18,37,0.486,9,9,1.0,119
2238,CLE,2021-11-10,94,,WAS,0,240,35,76,0.461,26,45,0.578,9,31,0.29,15,21,0.714,94,35,84,0.417,25,56,0.446,10,28,0.357,17,17,1.0,97
2239,SAS,2021-11-07,94,@,OKC,0,240,41,100,0.41,35,70,0.5,6,30,0.2,6,9,0.667,94,35,94,0.372,23,52,0.442,12,42,0.286,17,20,0.85,99
2240,MIL,2021-11-07,94,@,WAS,0,240,37,94,0.394,27,58,0.466,10,36,0.278,10,18,0.556,94,41,81,0.506,30,54,0.556,11,27,0.407,8,13,0.615,101
2241,IND,2021-11-07,94,@,SAC,1,240,37,83,0.446,31,58,0.534,6,25,0.24,14,18,0.778,94,31,84,0.369,21,50,0.42,10,34,0.294,19,22,0.864,91
2242,HOU,2021-11-06,94,@,DEN,0,240,35,75,0.467,27,47,0.574,8,28,0.286,16,24,0.667,94,36,89,0.404,27,49,0.551,9,40,0.225,14,17,0.824,95
2243,OKC,2021-11-01,94,@,LAC,0,240,35,90,0.389,24,53,0.453,11,37,0.297,13,16,0.813,94,35,92,0.38,20,50,0.4,15,42,0.357,14,19,0.737,99
2244,IND,2021-10-30,94,,TOR,0,240,35,81,0.432,22,38,0.579,13,43,0.302,11,16,0.688,94,39,92,0.424,28,60,0.467,11,32,0.344,8,12,0.667,97
2245,ATL,2021-10-30,94,@,PHI,0,240,36,95,0.379,28,73,0.384,8,22,0.364,14,19,0.737,94,46,86,0.535,34,48,0.708,12,38,0.316,18,19,0.947,122
2246,CHI,2021-10-20,94,@,DET,1,240,37,86,0.43,30,63,0.476,7,23,0.304,13,15,0.867,94,36,90,0.4,30,62,0.484,6,28,0.214,10,13,0.769,88
2247,NYK,2022-03-20,93,,UTA,0,240,31,83,0.373,15,43,0.349,16,40,0.4,15,21,0.714,93,34,74,0.459,17,28,0.607,17,46,0.37,23,29,0.793,108
2248,TOR,2022-03-20,93,@,PHI,1,240,35,93,0.376,28,67,0.418,7,26,0.269,16,23,0.696,93,30,73,0.411,23,46,0.5,7,27,0.259,21,28,0.75,88
2249,LAC,2022-03-06,93,,NYK,0,240,33,88,0.375,22,54,0.407,11,34,0.324,16,22,0.727,93,42,89,0.472,29,60,0.483,13,29,0.448,19,30,0.633,116
2250,TOR,2022-02-25,93,@,CHO,0,240,37,84,0.44,31,61,0.508,6,23,0.261,13,23,0.565,93,52,94,0.553,37,54,0.685,15,40,0.375,6,9,0.667,125
2251,CLE,2022-02-12,93,@,PHI,0,240,36,77,0.468,28,53,0.528,8,24,0.333,13,15,0.867,93,38,79,0.481,28,57,0.491,10,22,0.455,17,21,0.81,103
2252,POR,2022-02-04,93,,OKC,0,240,40,101,0.396,34,68,0.5,6,33,0.182,7,10,0.7,93,33,87,0.379,18,45,0.4,15,42,0.357,15,21,0.714,96
2253,DET,2022-02-04,93,,BOS,0,240,34,104,0.327,24,78,0.308,10,26,0.385,15,20,0.75,93,37,82,0.451,28,54,0.519,9,28,0.321,19,25,0.76,102
2254,CLE,2022-01-31,93,,NOP,1,240,36,84,0.429,27,53,0.509,9,31,0.29,12,14,0.857,93,33,85,0.388,27,55,0.491,6,30,0.2,18,21,0.857,90
2255,NYK,2022-01-24,93,@,CLE,0,240,35,84,0.417,23,46,0.5,12,38,0.316,11,21,0.524,93,35,81,0.432,22,45,0.489,13,36,0.361,12,20,0.6,95
2256,ATL,2022-01-09,93,@,LAC,0,240,35,78,0.449,28,52,0.538,7,26,0.269,16,19,0.842,93,44,92,0.478,32,59,0.542,12,33,0.364,6,7,0.857,106
2257,CLE,2021-12-30,93,@,WAS,0,240,35,83,0.422,27,55,0.491,8,28,0.286,15,23,0.652,93,45,90,0.5,36,61,0.59,9,29,0.31,11,17,0.647,110
2258,MIA,2021-12-26,93,,ORL,1,240,36,89,0.404,26,55,0.473,10,34,0.294,11,18,0.611,93,31,72,0.431,21,40,0.525,10,32,0.313,11,17,0.647,83
2259,BRK,2021-12-18,93,,ORL,0,240,39,102,0.382,30,56,0.536,9,46,0.196,6,8,0.75,93,39,94,0.415,29,63,0.46,10,31,0.323,12,13,0.923,100
2260,GSW,2021-12-11,93,@,PHI,0,240,34,85,0.4,22,37,0.595,12,48,0.25,13,18,0.722,93,35,76,0.461,26,49,0.531,9,27,0.333,23,26,0.885,102
2261,DAL,2021-12-10,93,@,IND,0,240,39,84,0.464,35,55,0.636,4,29,0.138,11,12,0.917,93,41,87,0.471,28,51,0.549,13,36,0.361,11,12,0.917,106
2262,DET,2021-12-10,93,@,NOP,0,240,35,90,0.389,23,53,0.434,12,37,0.324,11,12,0.917,93,41,95,0.432,28,58,0.483,13,37,0.351,14,16,0.875,109
2263,MIL,2021-12-02,93,@,TOR,0,240,32,85,0.376,21,54,0.389,11,31,0.355,18,25,0.72,93,37,88,0.42,23,48,0.479,14,40,0.35,9,14,0.643,97
2264,DET,2021-11-24,93,@,MIL,0,240,34,95,0.358,23,50,0.46,11,45,0.244,14,19,0.737,93,42,87,0.483,27,51,0.529,15,36,0.417,15,17,0.882,114
2265,CHI,2021-11-12,93,@,GSW,0,240,34,78,0.436,26,51,0.51,8,27,0.296,17,22,0.773,93,45,93,0.484,30,47,0.638,15,46,0.326,14,16,0.875,119
2266,DEN,2021-10-30,93,@,MIN,1,240,36,88,0.409,27,51,0.529,9,37,0.243,12,16,0.75,93,35,89,0.393,22,48,0.458,13,41,0.317,8,9,0.889,91
2267,MIL,2021-10-30,93,,SAS,0,240,36,89,0.404,26,50,0.52,10,39,0.256,11,16,0.688,93,39,95,0.411,32,64,0.5,7,31,0.226,17,24,0.708,102
2268,BRK,2021-10-27,93,,MIA,0,240,33,85,0.388,19,42,0.452,14,43,0.326,13,14,0.929,93,38,96,0.396,30,67,0.448,8,29,0.276,22,26,0.846,106
2269,WAS,2022-04-08,92,,NYK,0,240,35,69,0.507,26,41,0.634,9,28,0.321,13,17,0.765,92,41,88,0.466,25,49,0.51,16,39,0.41,16,20,0.8,114
2270,POR,2022-04-03,92,@,SAS,0,240,33,84,0.393,17,39,0.436,16,45,0.356,10,15,0.667,92,38,84,0.452,24,42,0.571,14,42,0.333,23,30,0.767,113
2271,LAC,2022-03-18,92,@,UTA,0,240,31,86,0.36,20,51,0.392,11,35,0.314,19,21,0.905,92,47,97,0.485,31,53,0.585,16,44,0.364,11,14,0.786,121
2272,BOS,2022-03-13,92,,DAL,0,240,33,88,0.375,24,51,0.471,9,37,0.243,17,19,0.895,92,33,74,0.446,18,37,0.486,15,37,0.405,14,19,0.737,95
2273,POR,2022-02-27,92,,DEN,0,240,34,91,0.374,28,55,0.509,6,36,0.167,18,26,0.692,92,44,86,0.512,32,49,0.653,12,37,0.324,24,31,0.774,124
2274,CLE,2022-02-26,92,,WAS,1,240,32,83,0.386,24,58,0.414,8,25,0.32,20,24,0.833,92,35,81,0.432,24,58,0.414,11,23,0.478,5,6,0.833,86
2275,SAS,2022-02-09,92,@,CLE,0,240,38,99,0.384,30,66,0.455,8,33,0.242,8,11,0.727,92,39,82,0.476,30,61,0.492,9,21,0.429,18,24,0.75,105
2276,MIA,2022-01-31,92,@,BOS,0,240,34,87,0.391,17,43,0.395,17,44,0.386,7,10,0.7,92,44,84,0.524,28,42,0.667,16,42,0.381,18,27,0.667,122
2277,BOS,2022-01-28,92,@,ATL,0,240,30,86,0.349,23,50,0.46,7,36,0.194,25,27,0.926,92,41,89,0.461,29,58,0.5,12,31,0.387,14,20,0.7,108
2278,DAL,2022-01-25,92,@,GSW,0,240,32,91,0.352,22,51,0.431,10,40,0.25,18,18,1.0,92,49,92,0.533,32,49,0.653,17,43,0.395,15,18,0.833,130
2279,UTA,2022-01-23,92,@,GSW,0,240,31,81,0.383,20,46,0.435,11,35,0.314,19,23,0.826,92,36,83,0.434,23,41,0.561,13,42,0.31,9,10,0.9,94
2280,POR,2022-01-19,92,@,MIA,0,240,33,81,0.407,19,35,0.543,14,46,0.304,12,16,0.75,92,37,80,0.463,25,45,0.556,12,35,0.343,18,25,0.72,104
2281,NOP,2022-01-17,92,@,BOS,0,240,36,87,0.414,27,57,0.474,9,30,0.3,11,18,0.611,92,38,80,0.475,28,48,0.583,10,32,0.313,18,20,0.9,104
2282,ORL,2022-01-15,92,@,DAL,0,240,37,77,0.481,30,51,0.588,7,26,0.269,11,16,0.688,92,32,78,0.41,20,44,0.455,12,34,0.353,32,38,0.842,108
2283,ORL,2022-01-08,92,@,DET,0,240,29,86,0.337,15,40,0.375,14,46,0.304,20,23,0.87,92,38,87,0.437,28,54,0.519,10,33,0.303,11,16,0.688,97
2284,LAC,2021-12-20,92,,SAS,0,240,34,87,0.391,25,55,0.455,9,32,0.281,15,20,0.75,92,50,114,0.439,38,77,0.494,12,37,0.324,4,6,0.667,116
2285,LAL,2021-12-17,92,@,MIN,0,240,30,78,0.385,18,35,0.514,12,43,0.279,20,29,0.69,92,41,98,0.418,29,54,0.537,12,44,0.273,16,24,0.667,110
2286,CHI,2021-12-11,92,@,MIA,0,240,31,83,0.373,14,43,0.326,17,40,0.425,13,20,0.65,92,46,93,0.495,27,50,0.54,19,43,0.442,7,9,0.778,118
2287,CHI,2021-12-08,92,@,CLE,0,240,35,84,0.417,28,58,0.483,7,26,0.269,15,21,0.714,92,44,80,0.55,31,52,0.596,13,28,0.464,14,16,0.875,115
2288,SAC,2021-11-30,92,,LAL,0,240,35,79,0.443,29,50,0.58,6,29,0.207,16,22,0.727,92,46,92,0.5,35,64,0.547,11,28,0.393,14,20,0.7,117
2289,DET,2021-11-30,92,@,POR,0,240,29,76,0.382,20,41,0.488,9,35,0.257,25,30,0.833,92,41,96,0.427,27,54,0.5,14,42,0.333,14,18,0.778,110
2290,ORL,2021-11-27,92,@,CLE,0,240,35,88,0.398,27,56,0.482,8,32,0.25,14,23,0.609,92,41,90,0.456,27,51,0.529,14,39,0.359,9,12,0.75,105
2291,DET,2021-11-23,92,,MIA,0,240,35,84,0.417,25,46,0.543,10,38,0.263,12,14,0.857,92,35,76,0.461,26,47,0.553,9,29,0.31,21,29,0.724,100
2292,ORL,2021-11-22,92,@,MIL,0,240,34,93,0.366,23,52,0.442,11,41,0.268,13,18,0.722,92,44,94,0.468,26,49,0.531,18,45,0.4,17,24,0.708,123
2293,SAS,2021-11-16,92,@,LAC,0,240,41,95,0.432,36,73,0.493,5,22,0.227,5,7,0.714,92,37,85,0.435,25,47,0.532,12,38,0.316,20,22,0.909,106
2294,NYK,2021-11-15,92,,IND,1,240,37,86,0.43,26,52,0.5,11,34,0.324,7,10,0.7,92,32,86,0.372,24,49,0.49,8,37,0.216,12,16,0.75,84
2295,CLE,2021-11-15,92,,BOS,0,240,32,83,0.386,16,43,0.372,16,40,0.4,12,16,0.75,92,36,78,0.462,26,49,0.531,10,29,0.345,16,20,0.8,98
2296,ORL,2021-11-13,92,,WAS,0,240,31,92,0.337,18,52,0.346,13,40,0.325,17,20,0.85,92,42,84,0.5,30,49,0.612,12,35,0.343,8,10,0.8,104
2297,HOU,2021-11-12,92,,POR,0,240,34,85,0.4,27,53,0.509,7,32,0.219,17,27,0.63,92,34,87,0.391,23,51,0.451,11,36,0.306,25,31,0.806,104
2298,NOP,2021-11-08,92,@,DAL,0,240,37,87,0.425,28,53,0.528,9,34,0.265,9,11,0.818,92,43,85,0.506,29,50,0.58,14,35,0.4,8,13,0.615,108
2299,BOS,2021-11-03,92,@,ORL,1,240,33,79,0.418,23,42,0.548,10,37,0.27,16,25,0.64,92,27,84,0.321,18,41,0.439,9,43,0.209,16,20,0.8,79
2300,CHO,2021-11-03,92,@,GSW,0,240,34,91,0.374,24,55,0.436,10,36,0.278,14,19,0.737,92,42,86,0.488,24,41,0.585,18,45,0.4,12,18,0.667,114
2301,CLE,2021-10-30,92,@,PHO,0,240,36,91,0.396,22,47,0.468,14,44,0.318,6,7,0.857,92,39,84,0.464,33,58,0.569,6,26,0.231,17,27,0.63,101
2302,LAC,2021-10-29,92,@,POR,0,240,34,87,0.391,19,45,0.422,15,42,0.357,9,16,0.563,92,41,98,0.418,22,57,0.386,19,41,0.463,10,16,0.625,111
2303,CLE,2021-10-27,92,@,LAC,1,240,33,81,0.407,30,61,0.492,3,20,0.15,23,27,0.852,92,31,87,0.356,22,46,0.478,9,41,0.22,8,13,0.615,79
2304,IND,2022-03-26,91,@,TOR,0,240,33,79,0.418,22,43,0.512,11,36,0.306,14,20,0.7,91,51,84,0.607,36,52,0.692,15,32,0.469,14,19,0.737,131
2305,HOU,2022-03-23,91,@,DAL,0,240,33,82,0.402,29,54,0.537,4,28,0.143,21,28,0.75,91,42,86,0.488,34,53,0.642,8,33,0.242,18,22,0.818,110
2306,SAS,2022-03-18,91,,NOP,0,240,32,89,0.36,21,45,0.467,11,44,0.25,16,20,0.8,91,48,96,0.5,34,62,0.548,14,34,0.412,14,18,0.778,124
2307,CLE,2022-03-12,91,@,CHI,0,240,36,86,0.419,31,62,0.5,5,24,0.208,14,17,0.824,91,39,88,0.443,30,67,0.448,9,21,0.429,14,15,0.933,101
2308,MIN,2022-02-16,91,,TOR,0,240,30,77,0.39,20,35,0.571,10,42,0.238,21,29,0.724,91,40,88,0.455,32,63,0.508,8,25,0.32,15,19,0.789,103
2309,BRK,2022-02-08,91,,BOS,0,240,38,99,0.384,28,63,0.444,10,36,0.278,5,13,0.385,91,50,91,0.549,36,51,0.706,14,40,0.35,12,16,0.75,126
2310,CHO,2022-01-23,91,,ATL,0,240,34,87,0.391,30,51,0.588,4,36,0.111,19,27,0.704,91,40,88,0.455,25,49,0.51,15,39,0.385,18,24,0.75,113
2311,MEM,2022-01-23,91,@,DAL,0,240,37,99,0.374,33,75,0.44,4,24,0.167,13,19,0.684,91,36,74,0.486,27,44,0.614,9,30,0.3,23,31,0.742,104
2312,NYK,2022-01-20,91,,NOP,0,240,29,77,0.377,20,39,0.513,9,38,0.237,24,36,0.667,91,38,76,0.5,27,48,0.563,11,28,0.393,15,22,0.682,102
2313,UTA,2022-01-12,91,,CLE,0,240,34,85,0.4,18,38,0.474,16,47,0.34,7,11,0.636,91,43,81,0.531,32,51,0.627,11,30,0.367,14,17,0.824,111
2314,ATL,2022-01-12,91,,MIA,0,240,31,82,0.378,18,37,0.486,13,45,0.289,16,23,0.696,91,43,90,0.478,27,45,0.6,16,45,0.356,13,14,0.929,115
2315,HOU,2022-01-10,91,,PHI,0,240,30,77,0.39,17,35,0.486,13,42,0.31,18,27,0.667,91,43,94,0.457,33,59,0.559,10,35,0.286,15,18,0.833,111
2316,LAC,2021-12-29,91,@,BOS,1,240,33,81,0.407,22,53,0.415,11,28,0.393,14,17,0.824,91,35,101,0.347,31,59,0.525,4,42,0.095,8,11,0.727,82
2317,DET,2021-12-21,91,@,NYK,0,240,34,94,0.362,26,61,0.426,8,33,0.242,15,19,0.789,91,40,90,0.444,29,57,0.509,11,33,0.333,14,19,0.737,105
2318,PHI,2021-12-13,91,@,MEM,0,240,37,83,0.446,33,61,0.541,4,22,0.182,13,19,0.684,91,47,89,0.528,33,55,0.6,14,34,0.412,18,23,0.783,126
2319,DAL,2021-12-03,91,,NOP,0,240,32,79,0.405,22,45,0.489,10,34,0.294,17,26,0.654,91,37,90,0.411,25,60,0.417,12,30,0.4,21,28,0.75,107
2320,TOR,2021-11-30,91,,MEM,0,240,36,91,0.396,26,52,0.5,10,39,0.256,9,12,0.75,91,36,93,0.387,26,59,0.441,10,34,0.294,16,19,0.842,98
2321,DAL,2021-11-21,91,@,LAC,0,240,34,83,0.41,28,53,0.528,6,30,0.2,17,18,0.944,91,36,75,0.48,24,46,0.522,12,29,0.414,13,18,0.722,97
2322,CLE,2021-11-13,91,,BOS,1,240,31,81,0.383,21,43,0.488,10,38,0.263,19,22,0.864,91,33,78,0.423,27,55,0.491,6,23,0.261,17,18,0.944,89
2323,SAC,2021-11-07,91,,IND,0,240,31,84,0.369,21,50,0.42,10,34,0.294,19,22,0.864,91,37,83,0.446,31,58,0.534,6,25,0.24,14,18,0.778,94
2324,DET,2021-10-31,91,@,BRK,0,240,32,79,0.405,20,46,0.435,12,33,0.364,15,22,0.682,91,47,72,0.653,34,47,0.723,13,25,0.52,10,16,0.625,117
2325,MIN,2021-10-30,91,,DEN,0,240,35,89,0.393,22,48,0.458,13,41,0.317,8,9,0.889,91,36,88,0.409,27,51,0.529,9,37,0.243,12,16,0.75,93
2326,HOU,2021-10-28,91,,UTA,0,240,31,95,0.326,22,51,0.431,9,44,0.205,20,23,0.87,91,41,85,0.482,25,39,0.641,16,46,0.348,24,30,0.8,122
2327,MIA,2021-10-23,91,@,IND,0,265,35,91,0.385,26,58,0.448,9,33,0.273,12,14,0.857,91,38,97,0.392,28,58,0.483,10,39,0.256,16,21,0.762,102
2328,OKC,2021-10-22,91,@,HOU,0,240,34,91,0.374,20,48,0.417,14,43,0.326,9,16,0.563,91,48,95,0.505,31,57,0.544,17,38,0.447,11,14,0.786,124
2329,SAC,2022-04-03,90,,GSW,0,240,31,81,0.383,24,48,0.5,7,33,0.212,21,24,0.875,90,41,79,0.519,25,45,0.556,16,34,0.471,11,15,0.733,109
2330,GSW,2022-03-22,90,@,ORL,0,240,34,85,0.4,23,53,0.434,11,32,0.344,11,16,0.688,90,34,79,0.43,24,43,0.558,10,36,0.278,16,20,0.8,94
2331,ORL,2022-03-20,90,,OKC,1,240,32,83,0.386,25,52,0.481,7,31,0.226,19,24,0.792,90,30,92,0.326,17,44,0.386,13,48,0.271,12,18,0.667,85
2332,MIA,2022-03-09,90,,PHO,0,240,35,88,0.398,25,55,0.455,10,33,0.303,10,13,0.769,90,45,99,0.455,34,62,0.548,11,37,0.297,10,10,1.0,111
2333,UTA,2022-03-04,90,@,NOP,0,240,31,89,0.348,20,48,0.417,11,41,0.268,17,26,0.654,90,50,97,0.515,39,61,0.639,11,36,0.306,13,17,0.765,124
2334,POR,2022-03-02,90,@,PHO,0,240,30,78,0.385,19,47,0.404,11,31,0.355,19,25,0.76,90,40,80,0.5,26,44,0.591,14,36,0.389,26,31,0.839,120
2335,TOR,2022-02-14,90,@,NOP,0,240,29,95,0.305,21,61,0.344,8,34,0.235,24,31,0.774,90,45,77,0.584,29,42,0.69,16,35,0.457,14,16,0.875,120
2336,NOP,2022-01-31,90,@,CLE,0,240,33,85,0.388,27,55,0.491,6,30,0.2,18,21,0.857,90,36,84,0.429,27,53,0.509,9,31,0.29,12,14,0.857,93
2337,CHO,2022-01-30,90,,LAC,0,240,32,98,0.327,24,64,0.375,8,34,0.235,18,27,0.667,90,44,84,0.524,33,56,0.589,11,28,0.393,16,19,0.842,115
2338,CHI,2022-01-21,90,@,MIL,0,240,31,85,0.365,24,47,0.511,7,38,0.184,21,24,0.875,90,34,88,0.386,28,57,0.491,6,31,0.194,20,28,0.714,94
2339,OKC,2022-01-05,90,@,MIN,0,240,33,90,0.367,24,55,0.436,9,35,0.257,15,18,0.833,90,36,90,0.4,24,46,0.522,12,44,0.273,14,20,0.7,98
2340,LAL,2021-12-21,90,,PHO,0,240,34,87,0.391,27,52,0.519,7,35,0.2,15,23,0.652,90,41,93,0.441,29,52,0.558,12,41,0.293,14,15,0.933,108
2341,MIA,2021-12-19,90,@,DET,0,240,28,74,0.378,15,31,0.484,13,43,0.302,21,33,0.636,90,35,75,0.467,27,43,0.628,8,32,0.25,22,30,0.733,100
2342,MIL,2021-12-18,90,,CLE,0,240,35,89,0.393,23,51,0.451,12,38,0.316,8,11,0.727,90,45,90,0.5,29,45,0.644,16,45,0.356,13,14,0.929,119
2343,TOR,2021-12-10,90,,NYK,1,240,30,87,0.345,18,52,0.346,12,35,0.343,18,23,0.783,90,29,81,0.358,20,47,0.426,9,34,0.265,20,24,0.833,87
2344,BOS,2021-12-10,90,@,PHO,0,240,35,93,0.376,31,67,0.463,4,26,0.154,16,24,0.667,90,43,96,0.448,29,58,0.5,14,38,0.368,11,11,1.0,111
2345,POR,2021-12-06,90,,LAC,0,240,35,79,0.443,30,57,0.526,5,22,0.227,15,20,0.75,90,41,92,0.446,30,56,0.536,11,36,0.306,9,14,0.643,102
2346,MIA,2021-12-06,90,,MEM,0,240,35,76,0.461,29,54,0.537,6,22,0.273,14,17,0.824,90,38,89,0.427,25,56,0.446,13,33,0.394,16,21,0.762,105
2347,WAS,2021-12-05,90,@,TOR,0,240,30,73,0.411,22,48,0.458,8,25,0.32,22,29,0.759,90,38,85,0.447,30,62,0.484,8,23,0.348,18,24,0.75,102
2348,DAL,2021-12-04,90,,MEM,0,240,31,92,0.337,16,49,0.327,15,43,0.349,13,19,0.684,90,37,76,0.487,28,50,0.56,9,26,0.346,14,24,0.583,97
2349,LAC,2021-11-28,90,,GSW,0,240,32,80,0.4,23,52,0.442,9,28,0.321,17,25,0.68,90,38,86,0.442,21,46,0.457,17,40,0.425,12,22,0.545,105
2350,ATL,2021-11-27,90,,NYK,0,240,33,93,0.355,24,56,0.429,9,37,0.243,15,20,0.75,90,36,82,0.439,25,53,0.472,11,29,0.379,16,22,0.727,99
2351,HOU,2021-11-22,90,@,BOS,0,240,31,83,0.373,20,41,0.488,11,42,0.262,17,24,0.708,90,39,92,0.424,27,57,0.474,12,35,0.343,18,19,0.947,108
2352,SAS,2021-11-18,90,@,MIN,0,240,35,84,0.417,29,52,0.558,6,32,0.188,14,19,0.737,90,41,86,0.477,20,37,0.541,21,49,0.429,12,15,0.8,115
2353,OKC,2021-11-15,90,,MIA,0,240,34,83,0.41,19,42,0.452,15,41,0.366,7,10,0.7,90,37,82,0.451,19,42,0.452,18,40,0.45,11,13,0.846,103
2354,LAC,2021-11-14,90,,CHI,0,240,29,81,0.358,18,47,0.383,11,34,0.324,21,21,1.0,90,38,86,0.442,27,57,0.474,11,29,0.379,13,14,0.929,100
2355,ORL,2021-11-10,90,,BRK,0,240,35,92,0.38,31,59,0.525,4,33,0.121,16,24,0.667,90,46,91,0.505,30,54,0.556,16,37,0.432,15,17,0.882,123
2356,LAL,2021-11-06,90,@,POR,0,240,31,90,0.344,22,58,0.379,9,32,0.281,19,24,0.792,90,36,95,0.379,21,40,0.525,15,55,0.273,18,24,0.75,105
2357,DET,2021-11-05,90,,BRK,0,240,33,87,0.379,22,53,0.415,11,34,0.324,13,18,0.722,90,36,80,0.45,25,53,0.472,11,27,0.407,13,14,0.929,96
2358,WAS,2021-10-25,90,@,BRK,0,240,33,95,0.347,24,56,0.429,9,39,0.231,15,20,0.75,90,40,94,0.426,30,59,0.508,10,35,0.286,14,17,0.824,104
2359,ORL,2021-10-25,90,@,MIA,0,240,33,81,0.407,21,37,0.568,12,44,0.273,12,19,0.632,90,41,87,0.471,35,60,0.583,6,27,0.222,19,19,1.0,107
2360,ORL,2022-04-01,89,,TOR,0,240,34,79,0.43,23,44,0.523,11,35,0.314,10,11,0.909,89,36,86,0.419,23,44,0.523,13,42,0.31,17,20,0.85,102
2361,LAC,2022-01-13,89,@,NOP,0,240,31,81,0.383,21,47,0.447,10,34,0.294,17,20,0.85,89,43,97,0.443,29,58,0.5,14,39,0.359,13,16,0.813,113
2362,LAC,2022-01-06,89,@,PHO,0,240,31,86,0.36,25,58,0.431,6,28,0.214,21,25,0.84,89,44,107,0.411,34,76,0.447,10,31,0.323,8,10,0.8,106
2363,DEN,2022-01-03,89,@,DAL,0,240,31,67,0.463,25,42,0.595,6,25,0.24,21,29,0.724,89,35,78,0.449,21,41,0.512,14,37,0.378,19,21,0.905,103
2364,DEN,2021-12-28,89,@,GSW,1,240,34,83,0.41,26,50,0.52,8,33,0.242,13,20,0.65,89,30,72,0.417,20,40,0.5,10,32,0.313,16,31,0.516,86
2365,SAC,2021-12-22,89,,LAC,0,240,34,85,0.4,22,47,0.468,12,38,0.316,9,12,0.75,89,42,82,0.512,35,58,0.603,7,24,0.292,14,16,0.875,105
2366,HOU,2021-12-15,89,@,CLE,0,240,30,78,0.385,25,49,0.51,5,29,0.172,24,35,0.686,89,45,80,0.563,27,40,0.675,18,40,0.45,16,24,0.667,124
2367,OKC,2021-11-29,89,@,HOU,0,240,31,87,0.356,24,44,0.545,7,43,0.163,20,26,0.769,89,40,96,0.417,25,50,0.5,15,46,0.326,7,11,0.636,102
2368,OKC,2021-11-19,89,@,MIL,0,240,32,91,0.352,20,43,0.465,12,48,0.25,13,21,0.619,89,31,83,0.373,19,42,0.452,12,41,0.293,22,26,0.846,96
2369,SAC,2021-11-19,89,,TOR,0,240,32,84,0.381,23,47,0.489,9,37,0.243,16,25,0.64,89,38,84,0.452,26,53,0.491,12,31,0.387,20,24,0.833,108
2370,DEN,2021-11-18,89,,PHI,0,240,32,89,0.36,20,53,0.377,12,36,0.333,13,16,0.813,89,43,85,0.506,32,56,0.571,11,29,0.379,6,12,0.5,103
2371,CLE,2021-11-18,89,,GSW,0,240,34,80,0.425,22,41,0.537,12,39,0.308,9,16,0.563,89,41,83,0.494,26,40,0.65,15,43,0.349,7,8,0.875,104
2372,IND,2021-11-17,89,@,DET,0,240,33,79,0.418,24,42,0.571,9,37,0.243,14,19,0.737,89,34,80,0.425,26,52,0.5,8,28,0.286,21,28,0.75,97
2373,HOU,2021-11-17,89,@,OKC,0,240,32,90,0.356,20,48,0.417,12,42,0.286,13,19,0.684,89,41,92,0.446,31,53,0.585,10,39,0.256,9,16,0.563,101
2374,HOU,2021-11-14,89,,PHO,0,240,35,85,0.412,28,53,0.528,7,32,0.219,12,18,0.667,89,42,97,0.433,28,57,0.491,14,40,0.35,17,20,0.85,115
2375,BOS,2021-11-13,89,@,CLE,0,240,33,78,0.423,27,55,0.491,6,23,0.261,17,18,0.944,89,31,81,0.383,21,43,0.488,10,38,0.263,19,22,0.864,91
2376,ORL,2021-11-05,89,,SAS,0,240,35,89,0.393,23,48,0.479,12,41,0.293,7,10,0.7,89,40,90,0.444,34,71,0.479,6,19,0.316,16,18,0.889,102
2377,DET,2021-11-02,89,,MIL,0,240,30,93,0.323,22,46,0.478,8,47,0.17,21,30,0.7,89,42,84,0.5,25,47,0.532,17,37,0.459,16,21,0.762,117
2378,NOP,2021-10-23,89,@,MIN,0,240,31,89,0.348,22,49,0.449,9,40,0.225,18,23,0.783,89,39,96,0.406,27,58,0.466,12,38,0.316,6,10,0.6,96
2379,OKC,2022-04-10,88,@,LAC,0,240,37,98,0.378,28,64,0.438,9,34,0.265,5,9,0.556,88,54,97,0.557,36,62,0.581,18,35,0.514,12,14,0.857,138
2380,ORL,2022-04-03,88,,NYK,0,240,30,85,0.353,18,41,0.439,12,44,0.273,16,27,0.593,88,45,93,0.484,30,49,0.612,15,44,0.341,13,16,0.813,118
2381,PHI,2022-03-20,88,,TOR,0,240,30,73,0.411,23,46,0.5,7,27,0.259,21,28,0.75,88,35,93,0.376,28,67,0.418,7,26,0.269,16,23,0.696,93
2382,GSW,2022-03-16,88,,BOS,0,240,32,86,0.372,21,38,0.553,11,48,0.229,13,16,0.813,88,38,81,0.469,23,41,0.561,15,40,0.375,19,22,0.864,110
2383,ORL,2022-01-17,88,,POR,0,240,34,90,0.378,26,58,0.448,8,32,0.25,12,20,0.6,88,37,90,0.411,30,56,0.536,7,34,0.206,17,18,0.944,98
2384,SAC,2022-01-09,88,@,POR,0,240,33,85,0.388,26,54,0.481,7,31,0.226,15,21,0.714,88,37,88,0.42,20,48,0.417,17,40,0.425,12,15,0.8,103
2385,DET,2022-01-06,88,@,MEM,0,240,34,99,0.343,24,55,0.436,10,44,0.227,10,13,0.769,88,48,98,0.49,38,66,0.576,10,32,0.313,12,19,0.632,118
2386,MIN,2021-12-28,88,,NYK,0,240,34,85,0.4,27,47,0.574,7,38,0.184,13,20,0.65,88,37,90,0.411,21,50,0.42,16,40,0.4,6,16,0.375,96
2387,BOS,2021-12-01,88,,PHI,1,240,33,79,0.418,22,51,0.431,11,28,0.393,11,15,0.733,88,33,89,0.371,25,58,0.431,8,31,0.258,13,17,0.765,87
2388,ORL,2021-11-26,88,,CHI,0,240,30,80,0.375,23,48,0.479,7,32,0.219,21,30,0.7,88,48,86,0.558,31,52,0.596,17,34,0.5,10,16,0.625,123
2389,BOS,2021-11-26,88,@,SAS,0,240,34,92,0.37,24,58,0.414,10,34,0.294,10,15,0.667,88,38,87,0.437,32,63,0.508,6,24,0.25,14,19,0.737,96
2390,TOR,2021-11-10,88,@,BOS,0,240,33,77,0.429,27,52,0.519,6,25,0.24,16,19,0.842,88,42,94,0.447,32,65,0.492,10,29,0.345,10,15,0.667,104
2391,DET,2021-10-20,88,,CHI,0,240,36,90,0.4,30,62,0.484,6,28,0.214,10,13,0.769,88,37,86,0.43,30,63,0.476,7,23,0.304,13,15,0.867,94
2392,PHI,2022-02-15,87,,BOS,0,240,23,80,0.288,15,48,0.313,8,32,0.25,33,39,0.846,87,46,82,0.561,21,37,0.568,25,45,0.556,18,22,0.818,135
2393,OKC,2022-02-11,87,@,PHI,0,240,35,90,0.389,29,55,0.527,6,35,0.171,11,12,0.917,87,36,93,0.387,29,67,0.433,7,26,0.269,21,26,0.808,100
2394,LAL,2022-01-27,87,@,PHI,0,240,36,88,0.409,30,59,0.508,6,29,0.207,9,9,1.0,87,41,82,0.5,28,47,0.596,13,35,0.371,10,17,0.588,105
2395,WAS,2022-01-23,87,,BOS,0,240,33,93,0.355,25,59,0.424,8,34,0.235,13,16,0.813,87,40,90,0.444,21,51,0.412,19,39,0.487,17,21,0.81,116
2396,OKC,2022-01-22,87,@,CLE,0,240,33,85,0.388,21,44,0.477,12,41,0.293,9,16,0.563,87,35,76,0.461,29,49,0.592,6,27,0.222,18,35,0.514,94
2397,NYK,2022-01-17,87,,CHO,0,240,32,80,0.4,20,46,0.435,12,34,0.353,11,21,0.524,87,36,86,0.419,22,47,0.468,14,39,0.359,11,17,0.647,97
2398,TOR,2022-01-14,87,@,DET,0,240,28,87,0.322,17,49,0.347,11,38,0.289,20,26,0.769,87,38,81,0.469,30,54,0.556,8,27,0.296,19,23,0.826,103
2399,DET,2022-01-11,87,@,CHI,0,240,30,89,0.337,24,54,0.444,6,35,0.171,21,27,0.778,87,50,92,0.543,32,58,0.552,18,34,0.529,15,19,0.789,133
2400,LAC,2022-01-11,87,,DEN,1,240,34,84,0.405,24,50,0.48,10,34,0.294,9,12,0.75,87,32,80,0.4,28,47,0.596,4,33,0.121,17,20,0.85,85
2401,ATL,2021-12-25,87,@,NYK,0,240,33,87,0.379,20,49,0.408,13,38,0.342,8,14,0.571,87,38,85,0.447,18,35,0.514,20,50,0.4,5,12,0.417,101
2402,NYK,2021-12-10,87,@,TOR,0,240,29,81,0.358,20,47,0.426,9,34,0.265,20,24,0.833,87,30,87,0.345,18,52,0.346,12,35,0.343,18,23,0.783,90
2403,PHI,2021-12-01,87,@,BOS,0,240,33,89,0.371,25,58,0.431,8,31,0.258,13,17,0.765,87,33,79,0.418,22,51,0.431,11,28,0.393,11,15,0.733,88
2404,WAS,2021-11-17,87,@,CHO,0,240,33,90,0.367,25,48,0.521,8,42,0.19,13,16,0.813,87,42,96,0.438,32,64,0.5,10,32,0.313,3,6,0.5,97
2405,MEM,2021-11-05,87,@,WAS,0,240,34,96,0.354,28,65,0.431,6,31,0.194,13,17,0.765,87,49,84,0.583,39,59,0.661,10,25,0.4,7,13,0.538,115
2406,DEN,2021-10-25,87,,CLE,0,240,35,86,0.407,26,48,0.542,9,38,0.237,8,12,0.667,87,38,82,0.463,31,57,0.544,7,25,0.28,16,20,0.8,99
2407,DAL,2021-10-21,87,@,ATL,0,240,31,93,0.333,18,50,0.36,13,43,0.302,12,13,0.923,87,45,94,0.479,30,59,0.508,15,35,0.429,8,9,0.889,113
2408,WAS,2022-02-26,86,@,CLE,0,240,35,81,0.432,24,58,0.414,11,23,0.478,5,6,0.833,86,32,83,0.386,24,58,0.414,8,25,0.32,20,24,0.833,92
2409,DET,2022-02-08,86,@,DAL,0,240,33,87,0.379,28,57,0.491,5,30,0.167,15,22,0.682,86,40,79,0.506,22,43,0.512,18,36,0.5,18,23,0.783,116
2410,CHO,2022-02-05,86,,MIA,0,240,33,86,0.384,23,50,0.46,10,36,0.278,10,16,0.625,86,38,91,0.418,27,59,0.458,11,32,0.344,17,18,0.944,104
2411,DET,2022-01-18,86,@,GSW,0,240,30,85,0.353,21,51,0.412,9,34,0.265,17,24,0.708,86,34,83,0.41,20,41,0.488,14,42,0.333,20,27,0.741,102
2412,OKC,2022-01-02,86,,DAL,0,240,35,85,0.412,25,55,0.455,10,30,0.333,6,9,0.667,86,38,85,0.447,24,46,0.522,14,39,0.359,5,7,0.714,95
2413,GSW,2021-12-28,86,,DEN,0,240,30,72,0.417,20,40,0.5,10,32,0.313,16,31,0.516,86,34,83,0.41,26,50,0.52,8,33,0.242,13,20,0.65,89
2414,POR,2021-10-25,86,@,LAC,0,240,32,85,0.376,24,48,0.5,8,37,0.216,14,18,0.778,86,44,93,0.473,30,50,0.6,14,43,0.326,14,19,0.737,116
2415,OKC,2021-10-20,86,@,UTA,0,240,34,91,0.374,27,56,0.482,7,35,0.2,11,18,0.611,86,40,91,0.44,26,44,0.591,14,47,0.298,13,15,0.867,107
2416,OKC,2022-03-20,85,@,ORL,0,240,30,92,0.326,17,44,0.386,13,48,0.271,12,18,0.667,85,32,83,0.386,25,52,0.481,7,31,0.226,19,24,0.792,90
2417,POR,2022-03-09,85,@,UTA,0,240,29,89,0.326,20,53,0.377,9,36,0.25,18,22,0.818,85,42,81,0.519,25,35,0.714,17,46,0.37,22,27,0.815,123
2418,SAC,2022-02-14,85,@,BRK,0,240,31,90,0.344,22,55,0.4,9,35,0.257,14,18,0.778,85,43,84,0.512,34,58,0.586,9,26,0.346,14,15,0.933,109
2419,GSW,2022-02-09,85,@,UTA,0,240,28,78,0.359,12,35,0.343,16,43,0.372,13,17,0.765,85,41,89,0.461,24,38,0.632,17,51,0.333,12,17,0.706,111
2420,IND,2022-02-06,85,@,CLE,0,240,31,83,0.373,23,52,0.442,8,31,0.258,15,17,0.882,85,34,84,0.405,23,52,0.442,11,32,0.344,19,28,0.679,98
2421,MEM,2022-01-14,85,,DAL,0,240,34,89,0.382,27,58,0.466,7,31,0.226,10,13,0.769,85,47,91,0.516,39,59,0.661,8,32,0.25,10,16,0.625,112
2422,DAL,2022-01-12,85,@,NYK,0,240,32,78,0.41,24,41,0.585,8,37,0.216,13,19,0.684,85,42,90,0.467,30,63,0.476,12,27,0.444,12,15,0.8,108
2423,DEN,2022-01-11,85,@,LAC,0,240,32,80,0.4,28,47,0.596,4,33,0.121,17,20,0.85,85,34,84,0.405,24,50,0.48,10,34,0.294,9,12,0.75,87
2424,DET,2021-12-29,85,,NYK,0,240,30,81,0.37,18,46,0.391,12,35,0.343,13,17,0.765,85,31,81,0.383,23,50,0.46,8,31,0.258,24,27,0.889,94
2425,MIA,2021-12-01,85,,CLE,0,240,32,85,0.376,20,48,0.417,12,37,0.324,9,13,0.692,85,37,68,0.544,21,37,0.568,16,31,0.516,21,23,0.913,111
2426,PHI,2021-11-16,85,@,UTA,0,240,33,90,0.367,27,61,0.443,6,29,0.207,13,17,0.765,85,46,89,0.517,30,51,0.588,16,38,0.421,12,19,0.632,120
2427,NOP,2021-11-05,85,@,GSW,0,240,31,88,0.352,20,44,0.455,11,44,0.25,12,16,0.75,85,47,91,0.516,27,41,0.659,20,50,0.4,12,14,0.857,126
2428,HOU,2021-10-31,85,@,LAL,0,240,32,76,0.421,26,48,0.542,6,28,0.214,15,29,0.517,85,39,96,0.406,30,65,0.462,9,31,0.29,8,13,0.615,95
2429,OKC,2021-12-12,84,,DAL,0,240,30,80,0.375,17,43,0.395,13,37,0.351,11,16,0.688,84,38,90,0.422,29,57,0.509,9,33,0.273,18,23,0.783,103
2430,IND,2021-11-15,84,@,NYK,0,240,32,86,0.372,24,49,0.49,8,37,0.216,12,16,0.75,84,37,86,0.43,26,52,0.5,11,34,0.324,7,10,0.7,92
2431,MIN,2021-11-05,84,,LAC,0,240,31,89,0.348,14,37,0.378,17,52,0.327,5,7,0.714,84,36,88,0.409,30,60,0.5,6,28,0.214,26,32,0.813,104
2432,ORL,2022-02-06,83,,BOS,0,240,29,81,0.358,24,55,0.436,5,26,0.192,20,21,0.952,83,45,99,0.455,32,53,0.604,13,46,0.283,13,14,0.929,116
2433,ORL,2021-12-26,83,@,MIA,0,240,31,72,0.431,21,40,0.525,10,32,0.313,11,17,0.647,83,36,89,0.404,26,55,0.473,10,34,0.294,11,18,0.611,93
2434,POR,2021-12-02,83,,SAS,0,240,29,82,0.354,17,48,0.354,12,34,0.353,13,17,0.765,83,44,91,0.484,30,55,0.545,14,36,0.389,12,16,0.75,114
2435,LAL,2021-11-12,83,,MIN,0,240,29,82,0.354,20,41,0.488,9,41,0.22,16,20,0.8,83,43,94,0.457,31,57,0.544,12,37,0.324,9,12,0.75,107
2436,BOS,2021-10-22,83,,TOR,0,240,32,82,0.39,21,48,0.438,11,34,0.324,8,11,0.727,83,42,100,0.42,32,65,0.492,10,35,0.286,21,21,1.0,115
2437,TOR,2021-10-20,83,,WAS,0,240,30,97,0.309,23,63,0.365,7,34,0.206,16,22,0.727,83,36,81,0.444,31,54,0.574,5,27,0.185,21,26,0.808,98
2438,PHI,2022-03-05,82,@,MIA,0,240,28,82,0.341,21,41,0.512,7,41,0.171,19,23,0.826,82,35,72,0.486,22,44,0.5,13,28,0.464,16,19,0.842,99
2439,CLE,2022-01-09,82,@,GSW,0,240,32,75,0.427,25,51,0.49,7,24,0.292,11,18,0.611,82,39,97,0.402,29,55,0.527,10,42,0.238,8,10,0.8,96
2440,GSW,2022-01-05,82,@,DAL,0,240,33,81,0.407,28,53,0.528,5,28,0.179,11,16,0.688,82,33,87,0.379,21,47,0.447,12,40,0.3,21,26,0.808,99
2441,BOS,2021-12-29,82,,LAC,0,240,35,101,0.347,31,59,0.525,4,42,0.095,8,11,0.727,82,33,81,0.407,22,53,0.415,11,28,0.393,14,17,0.824,91
2442,OKC,2021-10-30,82,@,GSW,0,240,29,83,0.349,21,44,0.477,8,39,0.205,16,21,0.762,82,39,92,0.424,18,38,0.474,21,54,0.389,4,8,0.5,103
2443,DET,2021-10-23,82,@,CHI,0,240,34,88,0.386,29,60,0.483,5,28,0.179,9,15,0.6,82,35,84,0.417,24,58,0.414,11,26,0.423,16,19,0.842,97
2444,POR,2022-03-07,81,@,MIN,0,240,23,83,0.277,16,55,0.291,7,28,0.25,28,38,0.737,81,38,92,0.413,25,49,0.51,13,43,0.302,35,44,0.795,124
2445,POR,2022-01-31,81,@,OKC,0,240,34,81,0.42,27,43,0.628,7,38,0.184,6,8,0.75,81,35,86,0.407,23,45,0.511,12,41,0.293,16,17,0.941,98
2446,LAC,2021-11-19,81,@,NOP,0,240,34,90,0.378,25,53,0.472,9,37,0.243,4,5,0.8,81,38,87,0.437,25,57,0.439,13,30,0.433,5,8,0.625,94
2447,POR,2022-04-10,80,,UTA,0,240,31,83,0.373,22,49,0.449,9,34,0.265,9,12,0.75,80,37,82,0.451,28,46,0.609,9,36,0.25,28,38,0.737,111
2448,WAS,2022-02-05,80,,PHO,0,240,30,85,0.353,25,61,0.41,5,24,0.208,15,19,0.789,80,40,99,0.404,32,68,0.471,8,31,0.258,7,14,0.5,95
2449,NYK,2021-12-31,80,@,OKC,0,240,30,81,0.37,22,40,0.55,8,41,0.195,12,22,0.545,80,36,87,0.414,18,44,0.409,18,43,0.419,5,7,0.714,95
2450,OKC,2021-12-02,79,@,MEM,0,240,25,76,0.329,14,38,0.368,11,38,0.289,18,22,0.818,79,60,96,0.625,41,60,0.683,19,36,0.528,13,18,0.722,152
2451,ORL,2021-11-03,79,,BOS,0,240,27,84,0.321,18,41,0.439,9,43,0.209,16,20,0.8,79,33,79,0.418,23,42,0.548,10,37,0.27,16,25,0.64,92
2452,LAC,2021-10-27,79,,CLE,0,240,31,87,0.356,22,46,0.478,9,41,0.22,8,13,0.615,79,33,81,0.407,30,61,0.492,3,20,0.15,23,27,0.852,92
2453,POR,2022-04-08,78,@,DAL,0,240,31,83,0.373,24,51,0.471,7,32,0.219,9,12,0.75,78,42,79,0.532,22,34,0.647,20,45,0.444,24,31,0.774,128
2454,DET,2021-11-12,78,@,CLE,0,240,29,79,0.367,20,49,0.408,9,30,0.3,11,13,0.846,78,39,82,0.476,25,41,0.61,14,41,0.341,6,9,0.667,98
2455,MIA,2021-11-04,78,,BOS,0,240,28,81,0.346,19,40,0.475,9,41,0.22,13,19,0.684,78,31,78,0.397,15,37,0.405,16,41,0.39,17,20,0.85,95
2456,DAL,2022-03-09,77,,NYK,0,240,27,86,0.314,21,42,0.5,6,44,0.136,17,25,0.68,77,36,84,0.429,27,50,0.54,9,34,0.265,26,33,0.788,107
2457,CHI,2021-11-22,77,,IND,0,240,31,85,0.365,25,57,0.439,6,28,0.214,9,15,0.6,77,40,90,0.444,27,59,0.458,13,31,0.419,16,18,0.889,109
2458,SAC,2022-01-25,75,@,BOS,0,240,29,95,0.305,23,62,0.371,6,33,0.182,11,15,0.733,75,51,103,0.495,31,58,0.534,20,45,0.444,6,7,0.857,128
2459,NYK,2022-01-08,75,@,BOS,0,240,29,79,0.367,18,48,0.375,11,31,0.355,6,15,0.4,75,36,76,0.474,24,47,0.511,12,29,0.414,15,17,0.882,99
2460,DAL,2021-10-29,75,@,DEN,0,240,23,78,0.295,15,41,0.366,8,37,0.216,21,27,0.778,75,43,83,0.518,32,47,0.681,11,36,0.306,9,13,0.692,106
