Rk,Team,Date,PTS,Unnamed: 4,Opp,Result,MP,FG,FGA,FG%,2P,2PA,2P%,3P,3PA,3P%,FT,FTA,FT%,PTS.1,FG.1,FGA.1,FG%.1,2P.1,2PA.1,2P%.1,3P.1,3PA.1,3P%.1,FT.1,FTA.1,FT%.1,PTS.2
1,GSW,2016-11-23,149,,LAL,1,240,53,86,0.616,34,50,0.68,19,36,0.528,24,35,0.686,149,40,93,0.43,32,73,0.438,8,20,0.4,18,22,0.818,106
2,GSW,2017-01-28,144,,LAC,1,240,57,92,0.62,40,58,0.69,17,34,0.5,13,16,0.813,144,36,82,0.439,24,54,0.444,12,28,0.429,14,22,0.636,98
3,BRK,2017-01-20,143,@,NOP,1,240,48,83,0.578,33,53,0.623,15,30,0.5,32,35,0.914,143,43,105,0.41,32,71,0.451,11,34,0.324,17,23,0.739,114
4,HOU,2017-02-25,142,,MIN,1,240,44,94,0.468,22,36,0.611,22,58,0.379,32,42,0.762,142,49,94,0.521,40,68,0.588,9,26,0.346,23,28,0.821,130
5,ATL,2017-01-29,142,,NYK,1,340,52,119,0.437,42,88,0.477,10,31,0.323,28,40,0.7,142,51,128,0.398,33,77,0.429,18,51,0.353,19,23,0.826,139
6,GSW,2016-12-05,142,,IND,1,240,54,104,0.519,40,67,0.597,14,37,0.378,20,26,0.769,142,35,85,0.412,32,70,0.457,3,15,0.2,33,35,0.943,106
7,BRK,2017-04-04,141,@,PHI,1,240,48,75,0.64,32,44,0.727,16,31,0.516,29,33,0.879,141,43,97,0.443,31,59,0.525,12,38,0.316,20,27,0.741,118
8,CLE,2017-02-06,140,@,WAS,1,265,49,92,0.533,30,54,0.556,19,38,0.5,23,28,0.821,140,50,99,0.505,38,70,0.543,12,29,0.414,23,26,0.885,135
9,DEN,2017-01-12,140,,IND,1,240,52,90,0.578,37,58,0.638,15,32,0.469,21,23,0.913,140,44,94,0.468,32,65,0.492,12,29,0.414,12,13,0.923,112
10,HOU,2016-12-30,140,,LAC,1,240,45,81,0.556,31,41,0.756,14,40,0.35,36,43,0.837,140,45,96,0.469,32,63,0.508,13,33,0.394,13,16,0.813,116
11,GSW,2017-04-02,139,,WAS,1,240,50,88,0.568,34,52,0.654,16,36,0.444,23,26,0.885,139,43,92,0.467,33,65,0.508,10,27,0.37,19,25,0.76,115
12,HOU,2017-03-15,139,,LAL,1,240,50,91,0.549,32,48,0.667,18,43,0.419,21,32,0.656,139,42,91,0.462,39,66,0.591,3,25,0.12,13,18,0.722,100
13,NYK,2017-01-29,139,@,ATL,0,340,51,128,0.398,33,77,0.429,18,51,0.353,19,23,0.826,139,52,119,0.437,42,88,0.477,10,31,0.323,28,40,0.7,142
14,GSW,2016-12-03,138,,PHO,1,240,49,78,0.628,35,57,0.614,14,21,0.667,26,34,0.765,138,41,91,0.451,30,59,0.508,11,32,0.344,16,21,0.762,109
15,HOU,2017-03-26,137,,OKC,1,240,50,79,0.633,30,40,0.75,20,39,0.513,17,21,0.81,137,47,94,0.5,36,64,0.563,11,30,0.367,20,28,0.714,125
16,PHO,2017-02-15,137,,LAL,1,240,49,88,0.557,39,64,0.609,10,24,0.417,29,34,0.853,137,35,93,0.376,26,67,0.388,9,26,0.346,22,28,0.786,101
17,MIL,2017-02-04,137,@,PHO,1,240,52,82,0.634,45,65,0.692,7,17,0.412,26,35,0.743,137,38,91,0.418,27,63,0.429,11,28,0.393,25,30,0.833,112
18,HOU,2017-01-15,137,@,BRK,1,240,46,92,0.5,25,48,0.521,21,44,0.477,24,32,0.75,137,41,93,0.441,26,49,0.531,15,44,0.341,15,19,0.789,112
19,CLE,2016-11-23,137,,POR,1,240,48,90,0.533,27,54,0.5,21,36,0.583,20,27,0.741,137,47,90,0.522,34,61,0.557,13,29,0.448,18,19,0.947,125
20,DET,2017-03-04,136,@,PHI,1,240,54,95,0.568,44,72,0.611,10,23,0.435,18,21,0.857,136,43,88,0.489,29,54,0.537,14,34,0.412,6,7,0.857,106
21,ORL,2016-12-20,136,@,MIA,1,290,52,105,0.495,41,83,0.494,11,22,0.5,21,31,0.677,136,50,108,0.463,38,78,0.487,12,30,0.4,18,26,0.692,130
22,HOU,2017-04-09,135,@,SAC,1,240,45,80,0.563,27,37,0.73,18,43,0.419,27,31,0.871,135,47,94,0.5,38,63,0.603,9,31,0.29,25,30,0.833,128
23,CLE,2017-04-02,135,,IND,1,290,47,95,0.495,29,52,0.558,18,43,0.419,23,33,0.697,135,48,105,0.457,32,64,0.5,16,41,0.39,18,20,0.9,130
24,CLE,2017-03-03,135,@,ATL,1,240,47,86,0.547,22,40,0.55,25,46,0.543,16,20,0.8,135,49,91,0.538,39,65,0.6,10,26,0.385,22,30,0.733,130
25,WAS,2017-02-06,135,,CLE,0,265,50,99,0.505,38,70,0.543,12,29,0.414,23,26,0.885,135,49,92,0.533,30,54,0.556,19,38,0.5,23,28,0.821,140
26,GSW,2016-12-17,135,,POR,1,240,51,87,0.586,37,59,0.627,14,28,0.5,19,26,0.731,135,34,86,0.395,26,58,0.448,8,28,0.286,14,20,0.7,90
27,DEN,2017-04-04,134,@,NOP,1,240,53,99,0.535,40,69,0.58,13,30,0.433,15,21,0.714,134,51,100,0.51,37,68,0.544,14,32,0.438,15,17,0.882,131
28,SAS,2017-01-12,134,,LAL,1,240,49,81,0.605,39,60,0.65,10,21,0.476,26,29,0.897,134,35,85,0.412,29,65,0.446,6,20,0.3,18,25,0.72,94
29,HOU,2016-12-07,134,,LAL,1,240,51,94,0.543,36,58,0.621,15,36,0.417,17,21,0.81,134,34,87,0.391,29,67,0.433,5,20,0.25,22,27,0.815,95
30,LAC,2017-03-29,133,,WAS,1,240,47,83,0.566,35,53,0.66,12,30,0.4,27,37,0.73,133,46,93,0.495,33,59,0.559,13,34,0.382,19,29,0.655,124
31,LAC,2017-03-21,133,@,LAL,1,240,45,84,0.536,30,51,0.588,15,33,0.455,28,32,0.875,133,43,92,0.467,37,72,0.514,6,20,0.3,17,27,0.63,109
32,HOU,2017-02-11,133,,PHO,1,240,42,85,0.494,24,49,0.49,18,36,0.5,31,39,0.795,133,37,94,0.394,29,72,0.403,8,22,0.364,20,26,0.769,102
33,GSW,2017-02-02,133,@,LAC,1,240,52,99,0.525,38,65,0.585,14,34,0.412,15,18,0.833,133,40,80,0.5,30,55,0.545,10,25,0.4,30,39,0.769,120
34,LAC,2016-12-10,133,,NOP,1,240,54,94,0.574,37,58,0.638,17,36,0.472,8,9,0.889,133,40,83,0.482,32,64,0.5,8,19,0.421,17,26,0.654,105
35,GSW,2016-11-13,133,,PHO,1,240,45,87,0.517,29,54,0.537,16,33,0.485,27,31,0.871,133,46,90,0.511,38,66,0.576,8,24,0.333,20,26,0.769,120
36,DEN,2017-02-13,132,,GSW,1,240,48,88,0.545,24,47,0.511,24,41,0.585,12,16,0.75,132,45,92,0.489,37,60,0.617,8,32,0.25,12,13,0.923,110
37,CLE,2017-02-08,132,@,IND,1,240,46,84,0.548,30,48,0.625,16,36,0.444,24,26,0.923,132,41,82,0.5,28,57,0.491,13,25,0.52,22,26,0.846,117
38,TOR,2017-01-13,132,,BRK,1,240,52,97,0.536,41,69,0.594,11,28,0.393,17,21,0.81,132,40,86,0.465,23,50,0.46,17,36,0.472,16,20,0.8,113
39,DEN,2016-12-15,132,,POR,1,240,43,84,0.512,28,53,0.528,15,31,0.484,31,35,0.886,132,41,88,0.466,33,65,0.508,8,23,0.348,30,36,0.833,120
40,HOU,2016-12-14,132,,SAC,1,240,50,85,0.588,28,43,0.651,22,42,0.524,10,16,0.625,132,39,92,0.424,28,60,0.467,11,32,0.344,9,11,0.818,98
41,HOU,2016-12-01,132,@,GSW,1,290,48,108,0.444,34,64,0.531,14,44,0.318,22,30,0.733,132,43,104,0.413,31,60,0.517,12,44,0.273,29,37,0.784,127
42,OKC,2016-11-25,132,@,DEN,1,265,48,96,0.5,35,70,0.5,13,26,0.5,23,29,0.793,132,48,101,0.475,36,67,0.537,12,34,0.353,21,27,0.778,129
43,NOP,2017-04-04,131,,DEN,0,240,51,100,0.51,37,68,0.544,14,32,0.438,15,17,0.882,131,53,99,0.535,40,69,0.58,13,30,0.433,15,21,0.714,134
44,TOR,2017-03-27,131,,ORL,1,240,49,83,0.59,39,68,0.574,10,15,0.667,23,35,0.657,131,43,88,0.489,39,68,0.574,4,20,0.2,22,28,0.786,112
45,WAS,2017-03-07,131,@,PHO,1,240,41,90,0.456,34,72,0.472,7,18,0.389,42,53,0.792,131,44,88,0.5,31,61,0.508,13,27,0.481,26,33,0.788,127
46,DEN,2017-02-10,131,@,NYK,1,240,54,95,0.568,38,63,0.603,16,32,0.5,7,10,0.7,131,52,93,0.559,36,55,0.655,16,38,0.421,3,5,0.6,123
47,HOU,2016-12-26,131,,PHO,1,240,46,92,0.5,31,49,0.633,15,43,0.349,24,30,0.8,131,43,101,0.426,36,71,0.507,7,30,0.233,22,27,0.815,115
48,ORL,2016-12-13,131,@,ATL,1,240,51,87,0.586,36,53,0.679,15,34,0.441,14,20,0.7,131,45,89,0.506,34,61,0.557,11,28,0.393,19,21,0.905,120
49,POR,2016-11-30,131,,IND,1,240,51,94,0.543,39,62,0.629,12,32,0.375,17,19,0.895,131,36,72,0.5,30,58,0.517,6,14,0.429,31,35,0.886,109
50,IND,2017-04-02,130,@,CLE,0,290,48,105,0.457,32,64,0.5,16,41,0.39,18,20,0.9,130,47,95,0.495,29,52,0.558,18,43,0.419,23,33,0.697,135
51,POR,2017-04-01,130,,PHO,1,240,43,92,0.467,28,55,0.509,15,37,0.405,29,31,0.935,130,44,84,0.524,41,74,0.554,3,10,0.3,26,32,0.813,117
52,LAL,2017-03-24,130,,MIN,1,265,46,88,0.523,32,65,0.492,14,23,0.609,24,28,0.857,130,46,95,0.484,39,74,0.527,7,21,0.333,20,22,0.909,119
53,BOS,2017-03-24,130,,PHO,1,240,44,94,0.468,30,53,0.566,14,41,0.341,28,35,0.8,130,39,86,0.453,33,67,0.493,6,19,0.316,36,49,0.735,120
54,WAS,2017-03-10,130,@,SAC,1,265,52,104,0.5,43,78,0.551,9,26,0.346,17,19,0.895,130,44,92,0.478,32,69,0.464,12,23,0.522,22,28,0.786,122
55,POR,2017-03-04,130,,BRK,1,240,49,86,0.57,33,61,0.541,16,25,0.64,16,22,0.727,130,45,86,0.523,31,56,0.554,14,30,0.467,12,17,0.706,116
56,ATL,2017-03-03,130,,CLE,0,240,49,91,0.538,39,65,0.6,10,26,0.385,22,30,0.733,130,47,86,0.547,22,40,0.55,25,46,0.543,16,20,0.8,135
57,MEM,2017-02-28,130,,PHO,1,240,48,86,0.558,36,61,0.59,12,25,0.48,22,29,0.759,130,43,83,0.518,36,62,0.581,7,21,0.333,19,24,0.792,112
58,MIN,2017-02-25,130,@,HOU,0,240,49,94,0.521,40,68,0.588,9,26,0.346,23,28,0.821,130,44,94,0.468,22,36,0.611,22,58,0.379,32,42,0.762,142
59,GSW,2017-02-11,130,@,OKC,1,240,46,87,0.529,33,56,0.589,13,31,0.419,25,35,0.714,130,40,83,0.482,34,59,0.576,6,24,0.25,28,36,0.778,114
60,MIA,2016-12-20,130,,ORL,0,290,50,108,0.463,38,78,0.487,12,30,0.4,18,26,0.692,130,52,105,0.495,41,83,0.494,11,22,0.5,21,31,0.677,136
61,SAS,2016-12-10,130,,BRK,1,240,50,94,0.532,36,68,0.529,14,26,0.538,16,18,0.889,130,36,87,0.414,29,60,0.483,7,27,0.259,22,25,0.88,101
62,HOU,2016-11-27,130,@,POR,1,240,46,82,0.561,29,46,0.63,17,36,0.472,21,28,0.75,130,40,83,0.482,28,50,0.56,12,33,0.364,22,29,0.759,114
63,IND,2016-10-26,130,,DAL,1,265,47,93,0.505,37,74,0.5,10,19,0.526,26,34,0.765,130,45,104,0.433,27,56,0.482,18,48,0.375,13,18,0.722,121
64,SAC,2017-04-11,129,,PHO,1,240,43,83,0.518,34,64,0.531,9,19,0.474,34,43,0.791,129,41,109,0.376,33,79,0.418,8,30,0.267,14,24,0.583,104
65,WAS,2017-03-24,129,,BRK,1,240,49,97,0.505,39,71,0.549,10,26,0.385,21,22,0.955,129,43,82,0.524,40,67,0.597,3,15,0.2,19,26,0.731,108
66,DEN,2017-03-16,129,,LAC,1,240,46,86,0.535,31,58,0.534,15,28,0.536,22,26,0.846,129,44,84,0.524,28,52,0.538,16,32,0.5,10,15,0.667,114
67,DEN,2017-03-13,129,,LAL,1,240,45,84,0.536,28,46,0.609,17,38,0.447,22,25,0.88,129,42,97,0.433,36,77,0.468,6,20,0.3,11,19,0.579,101
68,DEN,2017-02-24,129,,BRK,1,240,49,97,0.505,35,66,0.53,14,31,0.452,17,24,0.708,129,41,83,0.494,31,53,0.585,10,30,0.333,17,31,0.548,109
69,HOU,2017-02-23,129,@,NOP,1,240,45,91,0.495,25,40,0.625,20,51,0.392,19,24,0.792,129,36,86,0.419,30,55,0.545,6,31,0.194,21,26,0.808,99
70,MIL,2017-02-15,129,@,BRK,1,240,50,88,0.568,43,73,0.589,7,15,0.467,22,32,0.688,129,46,88,0.523,32,52,0.615,14,36,0.389,19,23,0.826,125
71,MIN,2017-01-28,129,,BRK,1,240,47,93,0.505,38,73,0.521,9,20,0.45,26,32,0.813,129,41,85,0.482,34,64,0.531,7,21,0.333,20,25,0.8,109
72,HOU,2017-01-08,129,@,TOR,1,240,46,89,0.517,35,51,0.686,11,38,0.289,26,31,0.839,129,42,78,0.538,31,53,0.585,11,25,0.44,27,30,0.9,122
73,HOU,2016-12-31,129,,NYK,1,240,42,92,0.457,21,37,0.568,21,55,0.382,24,29,0.828,129,47,105,0.448,37,73,0.507,10,32,0.313,18,25,0.72,122
74,DEN,2016-11-25,129,,OKC,0,265,48,101,0.475,36,67,0.537,12,34,0.353,21,27,0.778,129,48,96,0.5,35,70,0.5,13,26,0.5,23,29,0.793,132
75,POR,2016-11-20,129,@,BRK,1,240,49,85,0.576,34,49,0.694,15,36,0.417,16,21,0.762,129,37,93,0.398,27,58,0.466,10,35,0.286,25,31,0.806,109
76,SAS,2016-10-25,129,@,GSW,1,240,47,98,0.48,35,74,0.473,12,24,0.5,23,26,0.885,129,40,85,0.471,33,52,0.635,7,33,0.212,13,18,0.722,100
77,SAC,2017-04-09,128,,HOU,0,240,47,94,0.5,38,63,0.603,9,31,0.29,25,30,0.833,128,45,80,0.563,27,37,0.73,18,43,0.419,27,31,0.871,135
78,NOP,2017-03-17,128,,HOU,1,240,49,92,0.533,37,58,0.638,12,34,0.353,18,24,0.75,128,37,91,0.407,24,51,0.471,13,40,0.325,25,32,0.781,112
79,CLE,2017-03-14,128,,DET,1,240,46,77,0.597,27,47,0.574,19,30,0.633,17,23,0.739,128,37,99,0.374,33,80,0.413,4,19,0.211,18,19,0.947,96
80,CHI,2017-02-24,128,,PHO,1,265,46,98,0.469,34,72,0.472,12,26,0.462,24,31,0.774,128,49,93,0.527,41,69,0.594,8,24,0.333,15,25,0.6,121
81,HOU,2017-02-07,128,,ORL,1,240,44,89,0.494,28,51,0.549,16,38,0.421,24,36,0.667,128,42,88,0.477,36,63,0.571,6,25,0.24,14,20,0.7,104
82,CHI,2017-02-01,128,@,OKC,1,240,49,81,0.605,43,66,0.652,6,15,0.4,24,30,0.8,128,38,100,0.38,28,63,0.444,10,37,0.27,14,17,0.824,100
83,BOS,2017-01-27,128,,ORL,1,240,50,89,0.562,34,55,0.618,16,34,0.471,12,15,0.8,128,38,87,0.437,29,62,0.468,9,25,0.36,13,18,0.722,98
84,MEM,2017-01-06,128,@,GSW,1,265,50,103,0.485,37,70,0.529,13,33,0.394,15,19,0.789,128,41,83,0.494,33,53,0.623,8,30,0.267,29,39,0.744,119
85,TOR,2016-12-03,128,,ATL,1,240,53,92,0.576,40,68,0.588,13,24,0.542,9,11,0.818,128,35,88,0.398,28,60,0.467,7,28,0.25,7,14,0.5,84
86,HOU,2016-12-02,128,@,DEN,1,240,45,88,0.511,28,51,0.549,17,37,0.459,21,25,0.84,128,46,104,0.442,37,73,0.507,9,31,0.29,9,16,0.563,110
87,CLE,2016-11-25,128,,DAL,1,240,43,85,0.506,23,42,0.548,20,43,0.465,22,24,0.917,128,37,91,0.407,29,56,0.518,8,35,0.229,8,12,0.667,90
88,CLE,2016-11-03,128,,BOS,1,240,41,84,0.488,27,50,0.54,14,34,0.412,32,37,0.865,128,46,96,0.479,35,64,0.547,11,32,0.344,19,22,0.864,122
89,CLE,2016-11-01,128,,HOU,1,240,43,83,0.518,27,51,0.529,16,32,0.5,26,31,0.839,128,43,90,0.478,26,46,0.565,17,44,0.386,17,25,0.68,120
90,IND,2017-04-08,127,@,ORL,1,240,51,86,0.593,40,64,0.625,11,22,0.5,14,19,0.737,127,41,84,0.488,27,54,0.5,14,30,0.467,16,22,0.727,112
91,WAS,2017-03-25,127,@,CLE,1,240,49,82,0.598,41,64,0.641,8,18,0.444,21,26,0.808,127,41,83,0.494,29,50,0.58,12,33,0.364,21,27,0.778,115
92,PHO,2017-03-07,127,,WAS,0,240,44,88,0.5,31,61,0.508,13,27,0.481,26,33,0.788,127,41,90,0.456,34,72,0.472,7,18,0.389,42,53,0.792,131
93,UTA,2017-02-08,127,@,NOP,1,240,48,88,0.545,34,56,0.607,14,32,0.438,17,21,0.81,127,35,77,0.455,30,53,0.566,5,24,0.208,19,25,0.76,94
94,DEN,2017-01-26,127,,PHO,1,240,44,86,0.512,35,63,0.556,9,23,0.391,30,35,0.857,127,48,89,0.539,38,65,0.585,10,24,0.417,14,17,0.824,120
95,MIL,2017-01-23,127,,HOU,1,240,47,80,0.588,36,57,0.632,11,23,0.478,22,27,0.815,127,39,77,0.506,25,42,0.595,14,35,0.4,22,28,0.786,114
96,POR,2017-01-21,127,@,BOS,1,265,43,92,0.467,33,67,0.493,10,25,0.4,31,36,0.861,127,42,92,0.457,29,57,0.509,13,35,0.371,26,31,0.839,123
97,DEN,2017-01-17,127,@,LAL,1,240,50,88,0.568,39,62,0.629,11,26,0.423,16,26,0.615,127,47,108,0.435,36,78,0.462,11,30,0.367,16,18,0.889,121
98,GSW,2017-01-12,127,,DET,1,240,50,89,0.562,35,60,0.583,15,29,0.517,12,18,0.667,127,43,88,0.489,37,60,0.617,6,28,0.214,15,20,0.75,107
99,LAL,2017-01-06,127,,MIA,1,240,48,96,0.5,38,68,0.559,10,28,0.357,21,29,0.724,127,38,92,0.413,30,60,0.5,8,32,0.25,16,27,0.593,100
100,SAS,2017-01-05,127,@,DEN,1,240,51,90,0.567,39,66,0.591,12,24,0.5,13,17,0.765,127,39,86,0.453,32,61,0.525,7,25,0.28,14,17,0.824,99
101,GSW,2017-01-02,127,,DEN,1,240,50,95,0.526,39,70,0.557,11,25,0.44,16,21,0.762,127,48,101,0.475,39,66,0.591,9,35,0.257,14,18,0.778,119
102,DEN,2016-12-17,127,,NYK,1,240,50,90,0.556,40,63,0.635,10,27,0.37,17,29,0.586,127,35,80,0.438,27,57,0.474,8,23,0.348,36,39,0.923,114
103,GSW,2016-12-01,127,,HOU,0,290,43,104,0.413,31,60,0.517,12,44,0.273,29,37,0.784,127,48,108,0.444,34,64,0.531,14,44,0.318,22,30,0.733,132
104,BRK,2016-11-29,127,,LAC,1,290,45,104,0.433,32,66,0.485,13,38,0.342,24,36,0.667,127,46,109,0.422,33,69,0.478,13,40,0.325,17,22,0.773,122
105,GSW,2016-11-16,127,@,TOR,1,240,44,87,0.506,31,51,0.608,13,36,0.361,26,28,0.929,127,37,82,0.451,27,57,0.474,10,25,0.4,37,41,0.902,121
106,LAC,2016-11-14,127,,BRK,1,240,48,90,0.533,34,65,0.523,14,25,0.56,17,21,0.81,127,34,77,0.442,24,44,0.545,10,33,0.303,17,22,0.773,95
107,GSW,2016-11-01,127,@,POR,1,240,50,89,0.562,40,63,0.635,10,26,0.385,17,23,0.739,127,37,86,0.43,23,47,0.489,14,39,0.359,16,21,0.762,104
108,ATL,2017-04-09,126,,CLE,1,265,44,94,0.468,35,63,0.556,9,31,0.29,29,37,0.784,126,45,98,0.459,26,52,0.5,19,46,0.413,16,20,0.8,125
109,BRK,2017-03-23,126,,PHO,1,240,43,95,0.453,35,66,0.53,8,29,0.276,32,42,0.762,126,34,93,0.366,27,68,0.397,7,25,0.28,23,34,0.676,98
110,DEN,2017-03-22,126,,CLE,1,240,51,96,0.531,40,70,0.571,11,26,0.423,13,13,1.0,126,43,85,0.506,28,48,0.583,15,37,0.405,12,14,0.857,113
111,POR,2017-03-07,126,@,OKC,1,240,47,85,0.553,36,62,0.581,11,23,0.478,21,27,0.778,126,44,85,0.518,34,60,0.567,10,25,0.4,23,30,0.767,121
112,GSW,2017-02-01,126,,CHO,1,240,47,96,0.49,26,48,0.542,21,48,0.438,11,14,0.786,126,39,88,0.443,30,57,0.526,9,31,0.29,24,26,0.923,111
113,GSW,2017-01-16,126,,CLE,1,240,46,91,0.505,31,57,0.544,15,34,0.441,19,24,0.792,126,31,88,0.352,22,54,0.407,9,34,0.265,20,27,0.741,91
114,SAC,2016-12-20,126,,POR,1,240,40,72,0.556,30,49,0.612,10,23,0.435,36,43,0.837,126,44,86,0.512,40,58,0.69,4,28,0.143,29,40,0.725,121
115,CLE,2016-12-07,126,@,NYK,1,240,39,80,0.488,17,40,0.425,22,40,0.55,26,31,0.839,126,35,87,0.402,24,56,0.429,11,31,0.355,13,15,0.867,94
116,OKC,2016-11-30,126,,WAS,1,265,46,95,0.484,34,65,0.523,12,30,0.4,22,31,0.71,126,44,98,0.449,34,70,0.486,10,28,0.357,17,26,0.654,115
117,HOU,2016-11-17,126,,POR,1,240,46,95,0.484,32,63,0.508,14,32,0.438,20,25,0.8,126,41,90,0.456,31,62,0.5,10,28,0.357,17,21,0.81,109
118,LAL,2016-11-12,126,@,NOP,1,240,52,94,0.553,36,64,0.563,16,30,0.533,6,7,0.857,126,39,90,0.433,33,70,0.471,6,20,0.3,15,19,0.789,99
119,LAC,2017-04-10,125,,HOU,1,240,46,91,0.505,36,65,0.554,10,26,0.385,23,28,0.821,125,33,84,0.393,24,44,0.545,9,40,0.225,21,27,0.778,96
120,CLE,2017-04-09,125,@,ATL,0,265,45,98,0.459,26,52,0.5,19,46,0.413,16,20,0.8,125,44,94,0.468,35,63,0.556,9,31,0.29,29,37,0.784,126
121,OKC,2017-03-26,125,@,HOU,0,240,47,94,0.5,36,64,0.563,11,30,0.367,20,28,0.714,125,50,79,0.633,30,40,0.75,20,39,0.513,17,21,0.81,137
122,DEN,2017-03-24,125,@,IND,1,240,39,82,0.476,32,55,0.582,7,27,0.259,40,43,0.93,125,48,95,0.505,35,71,0.493,13,24,0.542,8,11,0.727,117
123,HOU,2017-03-20,125,,DEN,1,240,45,89,0.506,28,51,0.549,17,38,0.447,18,23,0.783,125,44,86,0.512,32,57,0.561,12,29,0.414,24,26,0.923,124
124,CLE,2017-03-19,125,@,LAL,1,240,45,85,0.529,32,49,0.653,13,36,0.361,22,27,0.815,125,47,91,0.516,36,64,0.563,11,27,0.407,15,19,0.789,120
125,NOP,2017-03-11,125,@,CHO,1,265,50,99,0.505,36,65,0.554,14,34,0.412,11,16,0.688,125,46,102,0.451,33,56,0.589,13,46,0.283,17,20,0.85,122
126,WAS,2017-03-11,125,@,POR,1,265,47,90,0.522,35,65,0.538,12,25,0.48,19,28,0.679,125,48,94,0.511,32,62,0.516,16,32,0.5,12,16,0.75,124
127,MIA,2017-03-01,125,,PHI,1,240,49,90,0.544,36,60,0.6,13,30,0.433,14,21,0.667,125,37,85,0.435,31,68,0.456,6,17,0.353,18,22,0.818,98
128,DEN,2017-02-28,125,@,CHI,1,240,45,80,0.563,32,50,0.64,13,30,0.433,22,24,0.917,125,44,96,0.458,34,70,0.486,10,26,0.385,9,10,0.9,107
129,BRK,2017-02-15,125,,MIL,0,240,46,88,0.523,32,52,0.615,14,36,0.389,19,23,0.826,125,50,88,0.568,43,73,0.589,7,15,0.467,22,32,0.688,129
130,CLE,2017-02-11,125,,DEN,1,240,46,84,0.548,31,54,0.574,15,30,0.5,18,22,0.818,125,39,97,0.402,27,60,0.45,12,37,0.324,19,22,0.864,109
131,MIA,2017-02-04,125,,PHI,1,240,48,82,0.585,36,60,0.6,12,22,0.545,17,23,0.739,125,35,84,0.417,29,61,0.475,6,23,0.261,26,31,0.839,102
132,CLE,2017-02-01,125,,MIN,1,240,48,89,0.539,33,52,0.635,15,37,0.405,14,22,0.636,125,41,94,0.436,34,73,0.466,7,21,0.333,8,10,0.8,97
133,GSW,2017-01-20,125,@,HOU,1,240,47,89,0.528,32,51,0.627,15,38,0.395,16,21,0.762,125,43,96,0.448,36,61,0.59,7,35,0.2,15,18,0.833,108
134,DEN,2017-01-16,125,,ORL,1,240,52,89,0.584,43,62,0.694,9,27,0.333,12,15,0.8,125,45,88,0.511,37,63,0.587,8,25,0.32,14,18,0.778,112
135,DET,2017-01-08,125,@,POR,1,290,54,105,0.514,46,80,0.575,8,25,0.32,9,12,0.75,125,51,98,0.52,36,63,0.571,15,35,0.429,7,12,0.583,124
136,GSW,2017-01-04,125,,POR,1,240,44,87,0.506,31,51,0.608,13,36,0.361,24,29,0.828,125,40,89,0.449,28,63,0.444,12,26,0.462,25,28,0.893,117
137,HOU,2016-12-21,125,@,PHO,1,240,46,86,0.535,28,48,0.583,18,38,0.474,15,26,0.577,125,44,93,0.473,35,68,0.515,9,25,0.36,14,20,0.7,111
138,ATL,2016-12-16,125,@,TOR,1,240,46,86,0.535,35,61,0.574,11,25,0.44,22,32,0.688,125,47,86,0.547,37,65,0.569,10,21,0.476,17,26,0.654,121
139,MIN,2016-12-03,125,@,CHO,1,265,48,106,0.453,38,79,0.481,10,27,0.37,19,22,0.864,125,44,101,0.436,30,65,0.462,14,36,0.389,18,26,0.692,120
140,POR,2016-11-23,125,@,CLE,0,240,47,90,0.522,34,61,0.557,13,29,0.448,18,19,0.947,125,48,90,0.533,27,54,0.5,21,36,0.583,20,27,0.741,137
141,LAL,2016-11-15,125,,BRK,1,240,41,92,0.446,32,64,0.5,9,28,0.321,34,43,0.791,125,45,99,0.455,33,58,0.569,12,41,0.293,16,20,0.8,118
142,MIN,2016-11-13,125,,LAL,1,240,42,80,0.525,29,53,0.547,13,27,0.481,28,42,0.667,125,33,71,0.465,25,47,0.532,8,24,0.333,25,30,0.833,99
143,GSW,2016-11-10,125,@,DEN,1,240,46,85,0.541,32,55,0.582,14,30,0.467,19,20,0.95,125,38,94,0.404,25,58,0.431,13,36,0.361,12,17,0.706,101
144,MIL,2016-11-03,125,,IND,1,240,47,82,0.573,35,55,0.636,12,27,0.444,19,24,0.792,125,38,81,0.469,28,58,0.483,10,23,0.435,21,27,0.778,107
145,MIA,2017-04-10,124,,CLE,1,265,44,95,0.463,32,62,0.516,12,33,0.364,24,34,0.706,124,44,89,0.494,30,54,0.556,14,35,0.4,19,22,0.864,121
146,PHO,2017-04-09,124,,DAL,1,240,44,80,0.55,36,61,0.59,8,19,0.421,28,32,0.875,124,41,97,0.423,25,52,0.481,16,45,0.356,13,19,0.684,111
147,LAC,2017-03-30,124,@,PHO,1,240,44,80,0.55,32,58,0.552,12,22,0.545,24,34,0.706,124,49,92,0.533,42,69,0.609,7,23,0.304,13,24,0.542,118
148,WAS,2017-03-29,124,@,LAC,0,240,46,93,0.495,33,59,0.559,13,34,0.382,19,29,0.655,124,47,83,0.566,35,53,0.66,12,30,0.4,27,37,0.73,133
149,DEN,2017-03-20,124,@,HOU,0,240,44,86,0.512,32,57,0.561,12,29,0.414,24,26,0.923,124,45,89,0.506,28,51,0.549,17,38,0.447,18,23,0.783,125
150,POR,2017-03-11,124,,WAS,0,265,48,94,0.511,32,62,0.516,16,32,0.5,12,16,0.75,124,47,90,0.522,35,65,0.538,12,25,0.48,19,28,0.679,125
151,LAC,2017-02-26,124,,CHO,1,265,45,97,0.464,35,65,0.538,10,32,0.313,24,34,0.706,124,38,80,0.475,20,40,0.5,18,40,0.45,27,30,0.9,121
152,LAC,2017-02-01,124,@,PHO,1,240,44,85,0.518,39,66,0.591,5,19,0.263,31,38,0.816,124,39,96,0.406,32,76,0.421,7,20,0.35,29,35,0.829,114
153,CLE,2017-01-27,124,,BRK,1,240,49,92,0.533,36,56,0.643,13,36,0.361,13,20,0.65,124,43,87,0.494,27,54,0.5,16,33,0.485,14,16,0.875,116
154,NOP,2017-01-23,124,,CLE,1,240,43,87,0.494,27,48,0.563,16,39,0.41,22,30,0.733,124,43,93,0.462,28,56,0.5,15,37,0.405,21,25,0.84,122
155,POR,2017-01-08,124,,DET,0,290,51,98,0.52,36,63,0.571,15,35,0.429,7,12,0.583,124,54,105,0.514,46,80,0.575,8,25,0.32,9,12,0.75,125
156,PHI,2016-12-30,124,@,DEN,1,240,38,87,0.437,22,54,0.407,16,33,0.485,32,40,0.8,124,39,84,0.464,28,57,0.491,11,27,0.407,33,41,0.805,122
157,CLE,2016-12-29,124,,BOS,1,240,43,83,0.518,29,45,0.644,14,38,0.368,24,33,0.727,124,43,85,0.506,31,48,0.646,12,37,0.324,20,21,0.952,118
158,TOR,2016-12-08,124,,MIN,1,240,43,87,0.494,31,60,0.517,12,27,0.444,26,33,0.788,124,45,88,0.511,36,60,0.6,9,28,0.321,11,15,0.733,110
159,ORL,2016-12-06,124,@,WAS,1,240,43,83,0.518,31,57,0.544,12,26,0.462,26,36,0.722,124,44,93,0.473,33,70,0.471,11,23,0.478,17,24,0.708,116
160,LAC,2016-11-23,124,@,DAL,1,240,43,85,0.506,28,53,0.528,15,32,0.469,23,31,0.742,124,38,84,0.452,27,60,0.45,11,24,0.458,17,18,0.944,104
161,GSW,2016-11-19,124,@,MIL,1,240,42,95,0.442,28,57,0.491,14,38,0.368,26,32,0.813,124,46,89,0.517,36,69,0.522,10,20,0.5,19,25,0.76,121
162,OKC,2016-11-18,124,,BRK,1,240,49,89,0.551,42,63,0.667,7,26,0.269,19,24,0.792,124,35,83,0.422,24,54,0.444,11,29,0.379,24,30,0.8,105
163,POR,2016-11-08,124,,PHO,1,240,45,81,0.556,31,50,0.62,14,31,0.452,20,28,0.714,124,43,86,0.5,36,65,0.554,7,21,0.333,28,33,0.848,121
164,HOU,2017-04-12,123,,MIN,1,240,45,97,0.464,26,41,0.634,19,56,0.339,14,22,0.636,123,48,91,0.527,37,68,0.544,11,23,0.478,11,15,0.733,118
165,GSW,2017-04-08,123,,NOP,1,240,49,96,0.51,39,63,0.619,10,33,0.303,15,16,0.938,123,42,86,0.488,37,65,0.569,5,21,0.238,12,19,0.632,101
166,ATL,2017-04-06,123,,BOS,1,240,44,89,0.494,33,66,0.5,11,23,0.478,24,34,0.706,123,37,90,0.411,22,47,0.468,15,43,0.349,27,34,0.794,116
167,HOU,2017-04-02,123,@,PHO,1,240,47,100,0.47,33,62,0.532,14,38,0.368,15,23,0.652,123,42,100,0.42,34,66,0.515,8,34,0.235,24,29,0.828,116
168,SAC,2017-04-01,123,@,MIN,1,240,44,78,0.564,33,59,0.559,11,19,0.579,24,33,0.727,123,39,87,0.448,30,60,0.5,9,27,0.333,30,38,0.789,117
169,NOP,2017-03-19,123,,MIN,1,240,49,90,0.544,35,60,0.583,14,30,0.467,11,15,0.733,123,44,86,0.512,35,61,0.574,9,25,0.36,12,17,0.706,109
170,MIA,2017-03-17,123,,MIN,1,240,50,85,0.588,42,59,0.712,8,26,0.308,15,19,0.789,123,41,82,0.5,39,70,0.557,2,12,0.167,21,22,0.955,105
171,OKC,2017-03-16,123,@,TOR,1,240,47,88,0.534,33,63,0.524,14,25,0.56,15,19,0.789,123,37,81,0.457,32,61,0.525,5,20,0.25,23,30,0.767,102
172,WAS,2017-03-08,123,@,DEN,1,240,50,88,0.568,39,62,0.629,11,26,0.423,12,19,0.632,123,46,87,0.529,33,59,0.559,13,28,0.464,8,17,0.471,113
173,HOU,2017-03-04,123,,MEM,1,240,39,78,0.5,21,36,0.583,18,42,0.429,27,36,0.75,123,43,97,0.443,35,69,0.507,8,28,0.286,14,21,0.667,108
174,GSW,2017-02-23,123,,LAC,1,240,43,81,0.531,30,56,0.536,13,25,0.52,24,26,0.923,123,38,93,0.409,27,65,0.415,11,28,0.393,26,37,0.703,113
175,NYK,2017-02-10,123,,DEN,0,240,52,93,0.559,36,55,0.655,16,38,0.421,3,5,0.6,123,54,95,0.568,38,63,0.603,16,32,0.5,7,10,0.7,131
176,GSW,2017-02-08,123,,CHI,1,240,48,85,0.565,33,57,0.579,15,28,0.536,12,13,0.923,123,37,92,0.402,33,68,0.485,4,24,0.167,14,19,0.737,92
177,DEN,2017-01-28,123,@,PHO,1,240,39,80,0.488,31,55,0.564,8,25,0.32,37,42,0.881,123,41,91,0.451,35,70,0.5,6,21,0.286,24,32,0.75,112
178,HOU,2017-01-27,123,@,PHI,1,240,42,81,0.519,30,50,0.6,12,31,0.387,27,28,0.964,123,42,78,0.538,32,53,0.604,10,25,0.4,24,32,0.75,118
179,WAS,2017-01-24,123,,BOS,1,240,48,84,0.571,39,64,0.609,9,20,0.45,18,21,0.857,123,38,84,0.452,28,51,0.549,10,33,0.303,22,24,0.917,108
180,DEN,2017-01-21,123,,LAC,1,240,46,87,0.529,36,63,0.571,10,24,0.417,21,26,0.808,123,40,96,0.417,30,64,0.469,10,32,0.313,8,8,1.0,98
181,BOS,2017-01-21,123,,POR,0,265,42,92,0.457,29,57,0.509,13,35,0.371,26,31,0.839,123,43,92,0.467,33,67,0.493,10,25,0.4,31,36,0.861,127
182,CHI,2017-01-07,123,,TOR,1,265,38,97,0.392,27,69,0.391,11,28,0.393,36,39,0.923,123,37,85,0.435,29,54,0.537,8,31,0.258,36,43,0.837,118
183,IND,2017-01-07,123,,NYK,1,240,43,86,0.5,32,62,0.516,11,24,0.458,26,28,0.929,123,40,87,0.46,28,56,0.5,12,31,0.387,17,24,0.708,109
184,CHO,2017-01-04,123,,OKC,1,240,37,80,0.463,28,56,0.5,9,24,0.375,40,49,0.816,123,42,96,0.438,33,66,0.5,9,30,0.3,19,23,0.826,112
185,TOR,2017-01-01,123,@,LAL,1,240,42,75,0.56,32,58,0.552,10,17,0.588,29,32,0.906,123,37,92,0.402,22,60,0.367,15,32,0.469,25,31,0.806,114
186,HOU,2016-12-27,123,@,DAL,1,240,41,78,0.526,24,46,0.522,17,32,0.531,24,28,0.857,123,36,87,0.414,21,49,0.429,15,38,0.395,20,25,0.8,107
187,PHO,2016-12-23,123,,PHI,1,240,42,79,0.532,30,53,0.566,12,26,0.462,27,37,0.73,123,42,83,0.506,29,52,0.558,13,31,0.419,19,22,0.864,116
188,MIL,2016-12-23,123,,WAS,1,240,45,80,0.563,36,55,0.655,9,25,0.36,24,27,0.889,123,37,79,0.468,30,55,0.545,7,24,0.292,15,18,0.833,96
189,TOR,2016-12-14,123,@,PHI,1,240,41,87,0.471,31,58,0.534,10,29,0.345,31,36,0.861,123,43,86,0.5,34,57,0.596,9,29,0.31,19,25,0.76,114
190,LAC,2016-11-21,123,,TOR,1,240,39,74,0.527,29,49,0.592,10,25,0.4,35,42,0.833,123,40,80,0.5,32,61,0.525,8,19,0.421,27,32,0.844,115
191,MIN,2016-11-09,123,@,ORL,1,240,45,87,0.517,32,64,0.5,13,23,0.565,20,26,0.769,123,38,85,0.447,30,61,0.492,8,24,0.333,23,30,0.767,107
192,DEN,2016-11-06,123,@,BOS,1,240,44,84,0.524,33,61,0.541,11,23,0.478,24,31,0.774,123,41,90,0.456,33,65,0.508,8,25,0.32,17,21,0.81,107
193,LAL,2016-11-02,123,@,ATL,1,240,48,90,0.533,39,68,0.574,9,22,0.409,18,20,0.9,123,41,85,0.482,30,53,0.566,11,32,0.344,23,29,0.793,116
194,CHI,2017-04-10,122,,ORL,1,240,48,89,0.539,36,63,0.571,12,26,0.462,14,16,0.875,122,29,84,0.345,24,57,0.421,5,27,0.185,12,16,0.75,75
195,DEN,2017-04-07,122,,NOP,1,240,43,78,0.551,30,46,0.652,13,32,0.406,23,32,0.719,122,47,99,0.475,44,76,0.579,3,23,0.13,9,13,0.692,106
196,CLE,2017-04-04,122,,ORL,1,240,44,82,0.537,26,46,0.565,18,36,0.5,16,21,0.762,122,33,86,0.384,22,53,0.415,11,33,0.333,25,26,0.962,102
197,CLE,2017-03-31,122,,PHI,1,240,50,95,0.526,37,66,0.561,13,29,0.448,9,16,0.563,122,40,82,0.488,29,49,0.592,11,33,0.333,14,19,0.737,105
198,CHO,2017-03-31,122,,DEN,1,240,40,86,0.465,23,50,0.46,17,36,0.472,25,30,0.833,122,45,90,0.5,29,57,0.509,16,33,0.485,8,11,0.727,114
199,POR,2017-03-28,122,,DEN,1,240,45,91,0.495,37,64,0.578,8,27,0.296,24,33,0.727,122,44,94,0.468,35,64,0.547,9,30,0.3,16,20,0.8,113
200,OKC,2017-03-22,122,,PHI,1,240,48,88,0.545,44,72,0.611,4,16,0.25,22,30,0.733,122,37,87,0.425,29,62,0.468,8,25,0.32,15,17,0.882,97
201,TOR,2017-03-21,122,,CHI,1,265,47,95,0.495,39,72,0.542,8,23,0.348,20,27,0.741,122,42,90,0.467,28,53,0.528,14,37,0.378,22,27,0.815,120
202,GSW,2017-03-16,122,,ORL,1,240,50,87,0.575,40,61,0.656,10,26,0.385,12,23,0.522,122,35,94,0.372,28,67,0.418,7,27,0.259,15,21,0.714,92
203,OKC,2017-03-14,122,@,BRK,1,240,44,89,0.494,34,67,0.507,10,22,0.455,24,34,0.706,122,33,71,0.465,21,47,0.447,12,24,0.5,26,30,0.867,104
204,CHO,2017-03-11,122,,NOP,0,265,46,102,0.451,33,56,0.589,13,46,0.283,17,20,0.85,122,50,99,0.505,36,65,0.554,14,34,0.412,11,16,0.688,125
205,SAC,2017-03-10,122,,WAS,0,265,44,92,0.478,32,69,0.464,12,23,0.522,22,28,0.786,122,52,104,0.5,43,78,0.551,9,26,0.346,17,19,0.895,130
206,LAL,2017-03-09,122,@,PHO,1,240,47,98,0.48,35,71,0.493,12,27,0.444,16,24,0.667,122,42,91,0.462,36,72,0.5,6,19,0.316,20,25,0.8,110
207,DAL,2017-03-07,122,,LAL,1,240,45,83,0.542,28,52,0.538,17,31,0.548,15,19,0.789,122,42,90,0.467,31,60,0.517,11,30,0.367,16,22,0.727,111
208,BRK,2017-03-06,122,@,MEM,1,240,39,73,0.534,25,43,0.581,14,30,0.467,30,38,0.789,122,34,77,0.442,24,52,0.462,10,25,0.4,31,39,0.795,109
209,HOU,2017-03-01,122,@,LAC,1,240,37,87,0.425,17,35,0.486,20,52,0.385,28,33,0.848,122,42,94,0.447,30,60,0.5,12,34,0.353,7,13,0.538,103
210,LAL,2017-02-10,122,@,MIL,1,240,39,75,0.52,24,44,0.545,15,31,0.484,29,35,0.829,122,40,76,0.526,32,48,0.667,8,28,0.286,26,31,0.839,114
211,GSW,2017-02-10,122,@,MEM,1,240,39,77,0.506,24,44,0.545,15,33,0.455,29,38,0.763,122,34,87,0.391,25,61,0.41,9,26,0.346,30,37,0.811,107
212,NOP,2017-02-10,122,@,MIN,1,240,45,75,0.6,33,50,0.66,12,25,0.48,20,27,0.741,122,38,82,0.463,32,55,0.582,6,27,0.222,24,32,0.75,106
213,PHI,2017-01-30,122,,SAC,1,240,45,83,0.542,34,52,0.654,11,31,0.355,21,26,0.808,122,41,74,0.554,28,45,0.622,13,29,0.448,24,29,0.828,119
214,CLE,2017-01-23,122,@,NOP,0,240,43,93,0.462,28,56,0.5,15,37,0.405,21,25,0.84,122,43,87,0.494,27,48,0.563,16,39,0.41,22,30,0.733,124
215,DAL,2017-01-22,122,,LAL,1,240,43,87,0.494,26,48,0.542,17,39,0.436,19,19,1.0,122,28,73,0.384,25,52,0.481,3,21,0.143,14,17,0.824,73
216,SAS,2017-01-17,122,,MIN,1,240,43,84,0.512,35,66,0.53,8,18,0.444,28,35,0.8,122,36,73,0.493,30,60,0.5,6,13,0.462,36,41,0.878,114
217,OKC,2017-01-15,122,@,SAC,1,240,40,90,0.444,31,62,0.5,9,28,0.321,33,41,0.805,122,37,81,0.457,28,56,0.5,9,25,0.36,35,40,0.875,118
218,TOR,2017-01-08,122,,HOU,0,240,42,78,0.538,31,53,0.585,11,25,0.44,27,30,0.9,122,46,89,0.517,35,51,0.686,11,38,0.289,26,31,0.839,129
219,NYK,2016-12-31,122,@,HOU,0,240,47,105,0.448,37,73,0.507,10,32,0.313,18,25,0.72,122,42,92,0.457,21,37,0.568,21,55,0.382,24,29,0.828,129
220,DEN,2016-12-30,122,,PHI,0,240,39,84,0.464,28,57,0.491,11,27,0.407,33,41,0.805,122,38,87,0.437,22,54,0.407,16,33,0.485,32,40,0.8,124
221,WAS,2016-12-16,122,,DET,1,240,44,77,0.571,32,52,0.615,12,25,0.48,22,27,0.815,122,42,86,0.488,32,58,0.552,10,28,0.357,14,21,0.667,108
222,HOU,2016-12-16,122,,NOP,1,240,42,94,0.447,18,33,0.545,24,61,0.393,14,19,0.737,122,40,98,0.408,31,71,0.437,9,27,0.333,11,20,0.55,100
223,TOR,2016-12-12,122,,MIL,1,240,42,81,0.519,28,56,0.5,14,25,0.56,24,28,0.857,122,42,89,0.472,38,65,0.585,4,24,0.167,12,17,0.706,100
224,HOU,2016-12-12,122,,BRK,1,240,42,91,0.462,25,48,0.521,17,43,0.395,21,36,0.583,122,42,80,0.525,35,60,0.583,7,20,0.35,27,36,0.75,118
225,LAC,2016-11-29,122,@,BRK,0,290,46,109,0.422,33,69,0.478,13,40,0.325,17,22,0.773,122,45,104,0.433,32,66,0.485,13,38,0.342,24,36,0.667,127
226,TOR,2016-11-28,122,,PHI,1,240,42,77,0.545,29,58,0.5,13,19,0.684,25,31,0.806,122,36,86,0.419,22,52,0.423,14,34,0.412,9,13,0.692,95
227,SAC,2016-11-27,122,@,BRK,1,240,46,86,0.535,33,63,0.524,13,23,0.565,17,22,0.773,122,38,87,0.437,22,47,0.468,16,40,0.4,13,14,0.929,105
228,BRK,2016-11-12,122,@,PHO,1,240,40,84,0.476,24,47,0.511,16,37,0.432,26,30,0.867,122,40,107,0.374,32,74,0.432,8,33,0.242,16,21,0.762,104
229,POR,2016-11-11,122,,SAC,1,265,45,86,0.523,32,53,0.604,13,33,0.394,19,27,0.704,122,43,88,0.489,37,67,0.552,6,21,0.286,28,35,0.8,120
230,IND,2016-11-09,122,,PHI,1,265,49,90,0.544,40,71,0.563,9,19,0.474,15,20,0.75,122,46,95,0.484,32,59,0.542,14,36,0.389,9,19,0.474,115
231,CHO,2016-11-07,122,,IND,1,240,41,84,0.488,29,52,0.558,12,32,0.375,28,32,0.875,122,40,94,0.426,31,61,0.508,9,33,0.273,11,15,0.733,100
232,BOS,2016-11-03,122,@,CLE,0,240,46,96,0.479,35,64,0.547,11,32,0.344,19,22,0.864,122,41,84,0.488,27,50,0.54,14,34,0.412,32,37,0.865,128
233,GSW,2016-11-03,122,,OKC,1,240,46,89,0.517,32,59,0.542,14,30,0.467,16,20,0.8,122,35,87,0.402,25,60,0.417,10,27,0.37,16,28,0.571,96
234,GSW,2016-10-28,122,@,NOP,1,240,44,91,0.484,35,63,0.556,9,28,0.321,25,28,0.893,122,47,100,0.47,42,78,0.538,5,22,0.227,15,23,0.652,114
235,BOS,2016-10-26,122,,BRK,1,240,48,89,0.539,37,57,0.649,11,32,0.344,15,18,0.833,122,43,97,0.443,28,53,0.528,15,44,0.341,16,20,0.8,117
236,CLE,2017-04-10,121,@,MIA,0,265,44,89,0.494,30,54,0.556,14,35,0.4,19,22,0.864,121,44,95,0.463,32,62,0.516,12,33,0.364,24,34,0.706,124
237,BOS,2017-04-08,121,@,CHO,1,240,45,87,0.517,28,48,0.583,17,39,0.436,14,17,0.824,121,38,84,0.452,29,56,0.518,9,28,0.321,29,32,0.906,114
238,GSW,2017-04-04,121,,MIN,1,240,44,84,0.524,30,52,0.577,14,32,0.438,19,24,0.792,121,41,96,0.427,37,77,0.481,4,19,0.211,21,26,0.808,107
239,BRK,2017-04-01,121,,ORL,1,240,50,94,0.532,42,63,0.667,8,31,0.258,13,16,0.813,121,45,91,0.495,35,66,0.53,10,25,0.4,11,15,0.733,111
240,NOP,2017-03-29,121,,DAL,1,240,42,84,0.5,30,54,0.556,12,30,0.4,25,33,0.758,121,44,91,0.484,30,64,0.469,14,27,0.519,16,17,0.941,118
241,BRK,2017-03-16,121,@,NYK,1,240,41,86,0.477,31,54,0.574,10,32,0.313,29,35,0.829,121,41,88,0.466,38,70,0.543,3,18,0.167,25,26,0.962,110
242,CHO,2017-03-10,121,,ORL,1,240,47,79,0.595,37,58,0.638,10,21,0.476,17,20,0.85,121,31,76,0.408,26,49,0.531,5,27,0.185,14,22,0.636,81
243,OKC,2017-03-07,121,,POR,0,240,44,85,0.518,34,60,0.567,10,25,0.4,23,30,0.767,121,47,85,0.553,36,62,0.581,11,23,0.478,21,27,0.778,126
244,CHO,2017-02-26,121,@,LAC,0,265,38,80,0.475,20,40,0.5,18,40,0.45,27,30,0.9,121,45,97,0.464,35,65,0.538,10,32,0.313,24,34,0.706,124
245,PHO,2017-02-24,121,@,CHI,0,265,49,93,0.527,41,69,0.594,8,24,0.333,15,25,0.6,121,46,98,0.469,34,72,0.472,12,26,0.462,24,31,0.774,128
246,DET,2017-02-08,121,,LAL,1,240,51,97,0.526,47,81,0.58,4,16,0.25,15,24,0.625,121,37,86,0.43,31,63,0.492,6,23,0.261,22,26,0.846,102
247,LAL,2017-02-06,121,@,NYK,1,240,44,102,0.431,36,74,0.486,8,28,0.286,25,31,0.806,121,37,82,0.451,30,61,0.492,7,21,0.333,26,33,0.788,107
248,SAS,2017-02-04,121,,DEN,1,240,45,79,0.57,35,58,0.603,10,21,0.476,21,26,0.808,121,41,92,0.446,31,66,0.47,10,26,0.385,5,10,0.5,97
249,HOU,2017-02-03,121,,CHI,1,265,44,98,0.449,28,55,0.509,16,43,0.372,17,25,0.68,121,48,100,0.48,40,75,0.533,8,25,0.32,13,18,0.722,117
250,DEN,2017-02-03,121,,MIL,1,240,40,89,0.449,31,61,0.508,9,28,0.321,32,44,0.727,121,45,83,0.542,36,59,0.61,9,24,0.375,18,23,0.783,117
251,CHI,2017-01-29,121,,PHI,1,240,45,89,0.506,37,75,0.493,8,14,0.571,23,28,0.821,121,44,99,0.444,34,71,0.479,10,28,0.357,10,14,0.714,108
252,PHI,2017-01-24,121,,LAC,1,240,45,90,0.5,35,61,0.574,10,29,0.345,21,22,0.955,121,33,71,0.465,15,37,0.405,18,34,0.529,26,41,0.634,110
253,GSW,2017-01-18,121,,OKC,1,240,46,85,0.541,36,64,0.563,10,21,0.476,19,27,0.704,121,38,90,0.422,30,62,0.484,8,28,0.286,16,19,0.842,100
254,LAL,2017-01-17,121,,DEN,0,240,47,108,0.435,36,78,0.462,11,30,0.367,16,18,0.889,121,50,88,0.568,39,62,0.629,11,26,0.423,16,26,0.615,127
255,HOU,2017-01-10,121,,CHO,1,240,40,82,0.488,23,43,0.535,17,39,0.436,24,33,0.727,121,44,92,0.478,25,49,0.51,19,43,0.442,7,9,0.778,114
256,OKC,2017-01-07,121,,DEN,1,240,43,89,0.483,31,53,0.585,12,36,0.333,23,29,0.793,121,40,99,0.404,31,75,0.413,9,24,0.375,17,24,0.708,106
257,IND,2017-01-05,121,,BRK,1,240,48,93,0.516,38,71,0.535,10,22,0.455,15,19,0.789,121,41,90,0.456,24,52,0.462,17,38,0.447,10,13,0.769,109
258,IND,2017-01-03,121,@,DET,1,240,43,74,0.581,34,58,0.586,9,16,0.563,26,30,0.867,121,48,97,0.495,38,68,0.559,10,29,0.345,10,12,0.833,116
259,CLE,2016-12-31,121,@,CHO,1,240,43,85,0.506,29,54,0.537,14,31,0.452,21,25,0.84,121,40,78,0.513,31,54,0.574,9,24,0.375,20,23,0.87,109
260,GSW,2016-12-28,121,,TOR,1,240,46,81,0.568,32,58,0.552,14,23,0.609,15,18,0.833,121,40,103,0.388,27,68,0.397,13,35,0.371,18,22,0.818,111
261,OKC,2016-12-21,121,@,NOP,1,240,45,88,0.511,34,60,0.567,11,28,0.393,20,24,0.833,121,42,88,0.477,34,68,0.5,8,20,0.4,18,23,0.783,110
262,POR,2016-12-20,121,@,SAC,0,240,44,86,0.512,40,58,0.69,4,28,0.143,29,40,0.725,121,40,72,0.556,30,49,0.612,10,23,0.435,36,43,0.837,126
263,TOR,2016-12-16,121,,ATL,0,240,47,86,0.547,37,65,0.569,10,21,0.476,17,26,0.654,121,46,86,0.535,35,61,0.574,11,25,0.44,22,32,0.688,125
264,LAC,2016-12-12,121,,POR,1,240,42,89,0.472,31,66,0.47,11,23,0.478,26,28,0.929,121,44,87,0.506,34,66,0.515,10,21,0.476,22,25,0.88,120
265,DEN,2016-12-10,121,@,ORL,1,240,47,83,0.566,39,64,0.609,8,19,0.421,19,25,0.76,121,43,88,0.489,32,61,0.525,11,27,0.407,16,24,0.667,113
266,DET,2016-12-02,121,@,ATL,1,240,48,89,0.539,31,60,0.517,17,29,0.586,8,12,0.667,121,32,88,0.364,26,64,0.406,6,24,0.25,15,20,0.75,85
267,DET,2016-11-30,121,@,BOS,1,240,48,87,0.552,39,67,0.582,9,20,0.45,16,21,0.762,121,40,91,0.44,25,49,0.51,15,42,0.357,19,20,0.95,114
268,NOP,2016-11-19,121,,CHO,1,265,43,98,0.439,29,62,0.468,14,36,0.389,21,25,0.84,121,40,97,0.412,25,54,0.463,15,43,0.349,21,28,0.75,116
269,MIL,2016-11-19,121,,GSW,0,240,46,89,0.517,36,69,0.522,10,20,0.5,19,25,0.76,121,42,95,0.442,28,57,0.491,14,38,0.368,26,32,0.813,124
270,LAC,2016-11-18,121,@,SAC,1,240,40,76,0.526,27,47,0.574,13,29,0.448,28,34,0.824,121,38,86,0.442,28,60,0.467,10,26,0.385,29,35,0.829,115
271,TOR,2016-11-16,121,,GSW,0,240,37,82,0.451,27,57,0.474,10,25,0.4,37,41,0.902,121,44,87,0.506,31,51,0.608,13,36,0.361,26,28,0.929,127
272,CLE,2016-11-15,121,,TOR,1,240,44,83,0.53,31,50,0.62,13,33,0.394,20,28,0.714,121,46,96,0.479,33,67,0.493,13,29,0.448,12,18,0.667,117
273,PHO,2016-11-08,121,@,POR,0,240,43,86,0.5,36,65,0.554,7,21,0.333,28,33,0.848,121,45,81,0.556,31,50,0.62,14,31,0.452,20,28,0.714,124
274,DAL,2016-10-26,121,@,IND,0,265,45,104,0.433,27,56,0.482,18,48,0.375,13,18,0.722,121,47,93,0.505,37,74,0.5,10,19,0.526,26,34,0.765,130
275,IND,2017-04-10,120,@,PHI,1,240,49,85,0.576,44,69,0.638,5,16,0.313,17,21,0.81,120,35,75,0.467,22,42,0.524,13,33,0.394,28,31,0.903,111
276,PHO,2017-04-07,120,,OKC,1,240,43,83,0.518,35,65,0.538,8,18,0.444,26,31,0.839,120,34,92,0.37,27,62,0.435,7,30,0.233,24,33,0.727,99
277,UTA,2017-04-07,120,,MIN,1,240,45,75,0.6,31,50,0.62,14,25,0.56,16,22,0.727,120,39,79,0.494,32,63,0.508,7,16,0.438,28,28,1.0,113
278,GSW,2017-04-05,120,@,PHO,1,240,45,89,0.506,32,59,0.542,13,30,0.433,17,24,0.708,120,43,103,0.417,36,76,0.474,7,27,0.259,18,26,0.692,111
279,CHO,2017-03-26,120,,PHO,1,240,42,87,0.483,28,57,0.491,14,30,0.467,22,24,0.917,120,41,81,0.506,35,65,0.538,6,16,0.375,18,22,0.818,106
280,PHO,2017-03-24,120,@,BOS,0,240,39,86,0.453,33,67,0.493,6,19,0.316,36,49,0.735,120,44,94,0.468,30,53,0.566,14,41,0.341,28,35,0.8,130
281,CHI,2017-03-21,120,@,TOR,0,265,42,90,0.467,28,53,0.528,14,37,0.378,22,27,0.815,120,47,95,0.495,39,72,0.542,8,23,0.348,20,27,0.741,122
282,LAL,2017-03-19,120,,CLE,0,240,47,91,0.516,36,64,0.563,11,27,0.407,15,19,0.789,120,45,85,0.529,32,49,0.653,13,36,0.361,22,27,0.815,125
283,MIA,2017-03-15,120,,NOP,1,240,44,87,0.506,28,52,0.538,16,35,0.457,16,19,0.842,120,42,88,0.477,33,66,0.5,9,22,0.409,19,28,0.679,112
284,SAC,2017-03-13,120,,ORL,1,240,44,82,0.537,28,52,0.538,16,30,0.533,16,21,0.762,120,45,98,0.459,32,64,0.5,13,34,0.382,12,12,1.0,115
285,BRK,2017-03-12,120,,NYK,1,240,40,87,0.46,21,49,0.429,19,38,0.5,21,29,0.724,120,39,94,0.415,31,71,0.437,8,23,0.348,26,32,0.813,112
286,MIA,2017-03-04,120,,CLE,1,240,46,88,0.523,28,54,0.519,18,34,0.529,10,12,0.833,120,35,73,0.479,24,46,0.522,11,27,0.407,11,18,0.611,92
287,PHO,2017-03-02,120,,CHO,1,240,46,77,0.597,39,58,0.672,7,19,0.368,21,25,0.84,120,35,89,0.393,25,55,0.455,10,34,0.294,23,28,0.821,103
288,DET,2017-02-28,120,,POR,1,265,45,104,0.433,38,79,0.481,7,25,0.28,23,31,0.742,120,44,84,0.524,34,59,0.576,10,25,0.4,15,22,0.682,113
289,PHI,2017-02-24,120,,WAS,1,240,43,87,0.494,33,58,0.569,10,29,0.345,24,30,0.8,120,38,90,0.422,33,66,0.5,5,24,0.208,31,40,0.775,112
290,WAS,2017-02-13,120,,OKC,1,240,42,73,0.575,29,53,0.547,13,20,0.65,23,28,0.821,120,34,96,0.354,27,62,0.435,7,34,0.206,23,30,0.767,98
291,BOS,2017-02-09,120,@,POR,1,240,44,91,0.484,34,61,0.557,10,30,0.333,22,27,0.815,120,39,77,0.506,30,51,0.588,9,26,0.346,24,31,0.774,111
292,UTA,2017-02-06,120,@,ATL,1,240,49,80,0.613,39,54,0.722,10,26,0.385,12,18,0.667,120,33,74,0.446,27,57,0.474,6,17,0.353,23,32,0.719,95
293,LAC,2017-02-02,120,,GSW,0,240,40,80,0.5,30,55,0.545,10,25,0.4,30,39,0.769,120,52,99,0.525,38,65,0.585,14,34,0.412,15,18,0.833,133
294,LAL,2017-01-31,120,,DEN,1,240,47,89,0.528,35,63,0.556,12,26,0.462,14,18,0.778,120,41,99,0.414,26,72,0.361,15,27,0.556,19,23,0.826,116
295,IND,2017-01-29,120,,HOU,1,240,47,87,0.54,42,66,0.636,5,21,0.238,21,26,0.808,120,34,83,0.41,23,44,0.523,11,39,0.282,22,25,0.88,101
296,PHO,2017-01-26,120,@,DEN,0,240,48,89,0.539,38,65,0.585,10,24,0.417,14,17,0.824,120,44,86,0.512,35,63,0.556,9,23,0.391,30,35,0.857,127
297,BOS,2017-01-25,120,,HOU,1,240,47,91,0.516,36,59,0.61,11,32,0.344,15,16,0.938,120,36,77,0.468,26,46,0.565,10,31,0.323,27,38,0.711,109
298,WAS,2017-01-16,120,,POR,1,240,42,86,0.488,29,63,0.46,13,23,0.565,23,25,0.92,120,37,88,0.42,29,62,0.468,8,26,0.308,19,25,0.76,101
299,LAC,2017-01-16,120,,OKC,1,240,45,82,0.549,33,54,0.611,12,28,0.429,18,22,0.818,120,36,85,0.424,26,55,0.473,10,30,0.333,16,19,0.842,98
300,CLE,2017-01-13,120,@,SAC,1,240,44,87,0.506,29,50,0.58,15,37,0.405,17,22,0.773,120,42,80,0.525,33,55,0.6,9,25,0.36,15,19,0.789,108
301,CLE,2017-01-08,120,@,PHO,1,240,44,82,0.537,29,48,0.604,15,34,0.441,17,19,0.895,120,46,87,0.529,37,60,0.617,9,27,0.333,15,19,0.789,116
302,SAC,2017-01-03,120,@,DEN,1,240,46,88,0.523,35,59,0.593,11,29,0.379,17,18,0.944,120,41,82,0.5,23,44,0.523,18,38,0.474,13,13,1.0,113
303,CHO,2016-12-28,120,@,ORL,1,240,46,84,0.548,36,60,0.6,10,24,0.417,18,19,0.947,120,42,86,0.488,33,52,0.635,9,34,0.265,8,10,0.8,101
304,BRK,2016-12-26,120,,CHO,1,240,40,75,0.533,25,44,0.568,15,31,0.484,25,31,0.806,120,44,94,0.468,36,68,0.529,8,26,0.308,22,25,0.88,118
305,POR,2016-12-15,120,@,DEN,0,240,41,88,0.466,33,65,0.508,8,23,0.348,30,36,0.833,120,43,84,0.512,28,53,0.528,15,31,0.484,31,35,0.886,132
306,ATL,2016-12-13,120,,ORL,0,240,45,89,0.506,34,61,0.557,11,28,0.393,19,21,0.905,120,51,87,0.586,36,53,0.679,15,34,0.441,14,20,0.7,131
307,POR,2016-12-12,120,@,LAC,0,240,44,87,0.506,34,66,0.515,10,21,0.476,22,25,0.88,120,42,89,0.472,31,66,0.47,11,23,0.478,26,28,0.929,121
308,NOP,2016-12-11,120,@,PHO,1,265,38,97,0.392,22,57,0.386,16,40,0.4,28,35,0.8,120,44,96,0.458,30,55,0.545,14,41,0.341,17,26,0.654,119
309,SAC,2016-12-07,120,@,DAL,1,240,47,84,0.56,37,62,0.597,10,22,0.455,16,21,0.762,120,32,78,0.41,22,48,0.458,10,30,0.333,15,20,0.75,89
310,CHO,2016-12-03,120,,MIN,0,265,44,101,0.436,30,65,0.462,14,36,0.389,18,26,0.692,120,48,106,0.453,38,79,0.481,10,27,0.37,19,22,0.864,125
311,TOR,2016-11-30,120,,MEM,1,240,38,69,0.551,22,37,0.595,16,32,0.5,28,33,0.848,120,36,82,0.439,25,55,0.455,11,27,0.407,22,26,0.846,105
312,UTA,2016-11-29,120,,HOU,1,240,41,74,0.554,26,46,0.565,15,28,0.536,23,27,0.852,120,37,91,0.407,26,61,0.426,11,30,0.367,16,22,0.727,101
313,DEN,2016-11-27,120,@,PHO,1,240,39,89,0.438,26,60,0.433,13,29,0.448,29,32,0.906,120,36,89,0.404,25,64,0.391,11,25,0.44,31,36,0.861,114
314,GSW,2016-11-21,120,@,IND,1,240,40,90,0.444,27,54,0.5,13,36,0.361,27,32,0.844,120,33,103,0.32,27,80,0.338,6,23,0.261,11,12,0.917,83
315,PHI,2016-11-19,120,,PHO,1,240,45,86,0.523,28,51,0.549,17,35,0.486,13,20,0.65,120,39,92,0.424,33,71,0.465,6,21,0.286,21,34,0.618,105
316,DEN,2016-11-16,120,,PHO,1,240,45,93,0.484,37,76,0.487,8,17,0.471,22,24,0.917,120,39,79,0.494,31,59,0.525,8,20,0.4,18,29,0.621,104
317,PHO,2016-11-13,120,@,GSW,0,240,46,90,0.511,38,66,0.576,8,24,0.333,20,26,0.769,120,45,87,0.517,29,54,0.537,16,33,0.485,27,31,0.871,133
318,SAC,2016-11-11,120,@,POR,0,265,43,88,0.489,37,67,0.552,6,21,0.286,28,35,0.8,120,45,86,0.523,32,53,0.604,13,33,0.394,19,27,0.704,122
319,HOU,2016-11-01,120,@,CLE,0,240,43,90,0.478,26,46,0.565,17,44,0.386,17,25,0.68,120,43,83,0.518,27,51,0.529,16,32,0.5,26,31,0.839,128
320,LAL,2016-10-26,120,,HOU,1,240,45,89,0.506,33,54,0.611,12,35,0.343,18,22,0.818,120,44,86,0.512,37,57,0.649,7,29,0.241,19,27,0.704,114
321,MIN,2017-03-30,119,,LAL,1,240,43,89,0.483,33,68,0.485,10,21,0.476,23,30,0.767,119,40,84,0.476,31,57,0.544,9,27,0.333,15,16,0.938,104
322,WAS,2017-03-28,119,@,LAL,1,240,48,94,0.511,42,71,0.592,6,23,0.261,17,25,0.68,119,43,85,0.506,35,63,0.556,8,22,0.364,14,16,0.875,108
323,MIN,2017-03-24,119,@,LAL,0,265,46,95,0.484,39,74,0.527,7,21,0.333,20,22,0.909,119,46,88,0.523,32,65,0.492,14,23,0.609,24,28,0.857,130
324,MIN,2017-03-13,119,,WAS,1,240,45,86,0.523,35,65,0.538,10,21,0.476,19,22,0.864,119,36,84,0.429,29,58,0.5,7,26,0.269,25,31,0.806,104
325,DEN,2017-03-10,119,,BOS,1,240,45,85,0.529,33,54,0.611,12,31,0.387,17,22,0.773,119,34,81,0.42,22,48,0.458,12,33,0.364,19,23,0.826,99
326,GSW,2017-03-06,119,@,ATL,1,240,41,87,0.471,21,43,0.488,20,44,0.455,17,22,0.773,119,38,82,0.463,25,54,0.463,13,28,0.464,22,31,0.71,111
327,GSW,2017-02-27,119,@,PHI,1,240,40,89,0.449,34,60,0.567,6,29,0.207,33,39,0.846,119,37,82,0.451,27,48,0.563,10,34,0.294,24,27,0.889,108
328,SAS,2017-02-26,119,@,LAL,1,240,49,94,0.521,39,73,0.534,10,21,0.476,11,13,0.846,119,40,87,0.46,33,65,0.508,7,22,0.318,11,18,0.611,98
329,CLE,2017-02-23,119,,NYK,1,240,46,87,0.529,31,49,0.633,15,38,0.395,12,15,0.8,119,42,101,0.416,34,75,0.453,8,26,0.308,12,17,0.706,104
330,LAC,2017-02-08,119,@,NYK,1,240,45,92,0.489,35,67,0.522,10,25,0.4,19,28,0.679,119,46,92,0.5,38,65,0.585,8,27,0.296,15,18,0.833,115
331,MEM,2017-02-01,119,@,DEN,1,240,45,92,0.489,31,62,0.5,14,30,0.467,15,20,0.75,119,32,80,0.4,23,55,0.418,9,25,0.36,26,35,0.743,99
332,SAC,2017-01-30,119,@,PHI,0,240,41,74,0.554,28,45,0.622,13,29,0.448,24,29,0.828,119,45,83,0.542,34,52,0.654,11,31,0.355,21,26,0.808,122
333,NOP,2017-01-27,119,,SAS,1,240,48,93,0.516,35,63,0.556,13,30,0.433,10,14,0.714,119,33,85,0.388,21,57,0.368,12,28,0.429,25,29,0.862,103
334,ATL,2017-01-25,119,@,CHI,1,240,43,83,0.518,26,53,0.491,17,30,0.567,16,19,0.842,119,43,94,0.457,35,67,0.522,8,27,0.296,20,26,0.769,114
335,HOU,2017-01-21,119,@,MEM,1,240,41,80,0.513,25,38,0.658,16,42,0.381,21,25,0.84,119,33,89,0.371,24,55,0.436,9,34,0.265,20,28,0.714,95
336,TOR,2017-01-17,119,@,BRK,1,240,48,92,0.522,38,73,0.521,10,19,0.526,13,16,0.813,119,40,89,0.449,33,63,0.524,7,26,0.269,22,24,0.917,109
337,MIN,2017-01-11,119,,HOU,1,240,44,81,0.543,36,58,0.621,8,23,0.348,23,25,0.92,119,36,87,0.414,21,45,0.467,15,42,0.357,18,22,0.818,105
338,GSW,2017-01-06,119,,MEM,0,265,41,83,0.494,33,53,0.623,8,30,0.267,29,39,0.744,119,50,103,0.485,37,70,0.529,13,33,0.394,15,19,0.789,128
339,DEN,2017-01-02,119,@,GSW,0,240,48,101,0.475,39,66,0.591,9,35,0.257,14,18,0.778,119,50,95,0.526,39,70,0.557,11,25,0.44,16,21,0.762,127
340,MIL,2016-12-28,119,@,DET,1,240,48,84,0.571,37,62,0.597,11,22,0.5,12,16,0.75,119,39,88,0.443,33,64,0.516,6,24,0.25,10,16,0.625,94
341,SAS,2016-12-28,119,,PHO,1,240,47,87,0.54,42,70,0.6,5,17,0.294,20,25,0.8,119,36,74,0.486,29,58,0.5,7,16,0.438,19,24,0.792,98
342,SAS,2016-12-25,119,,CHI,1,240,48,85,0.565,39,67,0.582,9,18,0.5,14,19,0.737,119,39,86,0.453,32,68,0.471,7,18,0.389,15,20,0.75,100
343,BOS,2016-12-25,119,@,NYK,1,240,45,93,0.484,31,57,0.544,14,36,0.389,15,20,0.75,119,41,87,0.471,33,64,0.516,8,23,0.348,24,27,0.889,114
344,GSW,2016-12-23,119,@,DET,1,240,43,77,0.558,32,50,0.64,11,27,0.407,22,24,0.917,119,43,85,0.506,33,56,0.589,10,29,0.345,17,28,0.607,113
345,CLE,2016-12-23,119,,BRK,1,240,45,99,0.455,37,64,0.578,8,35,0.229,21,24,0.875,119,38,85,0.447,30,55,0.545,8,30,0.267,15,18,0.833,99
346,LAC,2016-12-20,119,,DEN,1,240,47,86,0.547,31,50,0.62,16,36,0.444,9,13,0.692,119,39,90,0.433,28,51,0.549,11,39,0.282,13,20,0.65,102
347,CLE,2016-12-17,119,,LAL,1,240,46,89,0.517,31,56,0.554,15,33,0.455,12,18,0.667,119,41,86,0.477,25,49,0.51,16,37,0.432,10,13,0.769,108
348,PHO,2016-12-11,119,,NOP,0,265,44,96,0.458,30,55,0.545,14,41,0.341,17,26,0.654,119,38,97,0.392,22,57,0.386,16,40,0.4,28,35,0.8,120
349,PHO,2016-12-09,119,@,LAL,1,240,45,95,0.474,32,65,0.492,13,30,0.433,16,21,0.762,119,40,87,0.46,31,61,0.508,9,26,0.346,26,34,0.765,115
350,POR,2016-11-25,119,,NOP,1,240,47,100,0.47,35,68,0.515,12,32,0.375,13,17,0.765,119,36,76,0.474,23,53,0.434,13,23,0.565,19,29,0.655,104
351,SAS,2016-11-23,119,@,CHO,1,240,44,86,0.512,31,55,0.564,13,31,0.419,18,20,0.9,119,45,89,0.506,34,69,0.493,11,20,0.55,13,18,0.722,114
352,WAS,2016-11-17,119,,NYK,1,240,44,81,0.543,29,56,0.518,15,25,0.6,16,18,0.889,119,41,86,0.477,29,57,0.509,12,29,0.414,18,20,0.9,112
353,ORL,2016-11-13,119,@,OKC,1,240,46,86,0.535,35,62,0.565,11,24,0.458,16,20,0.8,119,47,92,0.511,40,67,0.597,7,25,0.28,16,26,0.615,117
354,LAC,2016-11-12,119,@,MIN,1,240,40,76,0.526,29,52,0.558,11,24,0.458,28,37,0.757,119,40,89,0.449,32,67,0.478,8,22,0.364,17,21,0.81,105
355,BRK,2016-11-08,119,,MIN,1,240,42,76,0.553,30,43,0.698,12,33,0.364,23,26,0.885,119,39,92,0.424,27,64,0.422,12,28,0.429,20,28,0.714,110
356,LAL,2016-11-06,119,,PHO,1,240,41,90,0.456,31,67,0.463,10,23,0.435,27,35,0.771,119,40,91,0.44,34,71,0.479,6,20,0.3,22,28,0.786,108
357,MIN,2017-04-12,118,@,HOU,0,240,48,91,0.527,37,68,0.544,11,23,0.478,11,15,0.733,118,45,97,0.464,26,41,0.634,19,56,0.339,14,22,0.636,123
358,WAS,2017-04-04,118,,CHO,1,240,43,85,0.506,26,51,0.51,17,34,0.5,15,18,0.833,118,40,79,0.506,28,45,0.622,12,34,0.353,19,22,0.864,111
359,PHI,2017-04-04,118,,BRK,0,240,43,97,0.443,31,59,0.525,12,38,0.316,20,27,0.741,118,48,75,0.64,32,44,0.727,16,31,0.516,29,33,0.879,141
360,PHO,2017-03-30,118,,LAC,0,240,49,92,0.533,42,69,0.609,7,23,0.304,13,24,0.542,118,44,80,0.55,32,58,0.552,12,22,0.545,24,34,0.706,124
361,DAL,2017-03-29,118,@,NOP,0,240,44,91,0.484,30,64,0.469,14,27,0.519,16,17,0.941,118,42,84,0.5,30,54,0.556,12,30,0.4,25,33,0.758,121
362,MIL,2017-03-28,118,@,CHO,1,240,46,74,0.622,32,44,0.727,14,30,0.467,12,17,0.706,118,39,80,0.488,32,52,0.615,7,28,0.25,23,29,0.793,108
363,SAS,2017-03-19,118,,SAC,1,240,43,87,0.494,32,59,0.542,11,28,0.393,21,27,0.778,118,41,83,0.494,34,73,0.466,7,10,0.7,13,17,0.765,102
364,PHI,2017-03-12,118,@,LAL,1,240,41,79,0.519,31,55,0.564,10,24,0.417,26,32,0.813,118,44,88,0.5,40,68,0.588,4,20,0.2,24,28,0.857,116
365,PHO,2017-03-03,118,,OKC,1,240,44,89,0.494,39,68,0.574,5,21,0.238,25,31,0.806,118,37,87,0.425,28,52,0.538,9,35,0.257,28,35,0.8,111
366,OKC,2017-02-26,118,,NOP,1,240,42,88,0.477,36,67,0.537,6,21,0.286,28,37,0.757,118,36,80,0.45,28,59,0.475,8,21,0.381,30,37,0.811,110
367,OKC,2017-02-09,118,,CLE,1,240,50,106,0.472,42,79,0.532,8,27,0.296,10,13,0.769,118,38,79,0.481,28,58,0.483,10,21,0.476,23,30,0.767,109
368,TOR,2017-02-06,118,,LAC,1,240,41,84,0.488,31,60,0.517,10,24,0.417,26,29,0.897,118,42,90,0.467,29,55,0.527,13,35,0.371,12,18,0.667,109
369,DET,2017-02-01,118,,NOP,1,240,48,88,0.545,38,62,0.613,10,26,0.385,12,17,0.706,118,41,82,0.5,36,61,0.59,5,21,0.238,11,14,0.786,98
370,PHI,2017-01-27,118,,HOU,0,240,42,78,0.538,32,53,0.604,10,25,0.4,24,32,0.75,118,42,81,0.519,30,50,0.6,12,31,0.387,27,28,0.964,123
371,GSW,2017-01-22,118,@,ORL,1,240,42,89,0.472,23,47,0.489,19,42,0.452,15,19,0.789,118,42,96,0.438,35,68,0.515,7,28,0.25,7,16,0.438,98
372,SAS,2017-01-21,118,@,CLE,1,265,48,96,0.5,38,70,0.543,10,26,0.385,12,14,0.857,118,45,91,0.495,32,57,0.561,13,34,0.382,12,22,0.545,115
373,CLE,2017-01-19,118,,PHO,1,240,43,85,0.506,24,43,0.558,19,42,0.452,13,19,0.684,118,37,85,0.435,33,66,0.5,4,19,0.211,25,31,0.806,103
374,SAS,2017-01-19,118,,DEN,1,240,44,86,0.512,35,64,0.547,9,22,0.409,21,25,0.84,118,37,91,0.407,27,60,0.45,10,31,0.323,20,26,0.769,104
375,DET,2017-01-18,118,,ATL,1,240,45,91,0.495,35,66,0.53,10,25,0.4,18,28,0.643,118,30,78,0.385,24,53,0.453,6,25,0.24,29,37,0.784,95
376,NOP,2017-01-18,118,,ORL,1,240,46,93,0.495,31,57,0.544,15,36,0.417,11,15,0.733,118,39,88,0.443,28,56,0.5,11,32,0.344,9,11,0.818,98
377,SAC,2017-01-15,118,,OKC,0,240,37,81,0.457,28,56,0.5,9,25,0.36,35,40,0.875,118,40,90,0.444,31,62,0.5,9,28,0.321,33,41,0.805,122
378,TOR,2017-01-07,118,@,CHI,0,265,37,85,0.435,29,54,0.537,8,31,0.258,36,43,0.837,118,38,97,0.392,27,69,0.391,11,28,0.393,36,39,0.923,123
379,POR,2017-01-05,118,,LAL,1,240,43,81,0.531,31,48,0.646,12,33,0.364,20,30,0.667,118,36,86,0.419,26,55,0.473,10,31,0.323,27,33,0.818,109
380,HOU,2017-01-05,118,,OKC,1,240,41,86,0.477,26,47,0.553,15,39,0.385,21,30,0.7,118,41,91,0.451,29,61,0.475,12,30,0.4,22,27,0.815,116
381,CHI,2017-01-02,118,,CHO,1,240,42,90,0.467,35,67,0.522,7,23,0.304,27,29,0.931,118,41,83,0.494,32,64,0.5,9,19,0.474,20,22,0.909,111
382,WAS,2016-12-30,118,,BRK,1,240,47,83,0.566,36,61,0.59,11,22,0.5,13,14,0.929,118,32,74,0.432,22,49,0.449,10,25,0.4,21,25,0.84,95
383,BOS,2016-12-29,118,@,CLE,0,240,43,85,0.506,31,48,0.646,12,37,0.324,20,21,0.952,118,43,83,0.518,29,45,0.644,14,38,0.368,24,33,0.727,124
384,CHO,2016-12-26,118,@,BRK,0,240,44,94,0.468,36,68,0.529,8,26,0.308,22,25,0.88,118,40,75,0.533,25,44,0.568,15,31,0.484,25,31,0.806,120
385,NYK,2016-12-20,118,,IND,1,240,44,88,0.5,31,65,0.477,13,23,0.565,17,21,0.81,118,39,91,0.429,33,68,0.485,6,23,0.261,27,33,0.818,111
386,ORL,2016-12-16,118,,BRK,1,240,39,97,0.402,32,68,0.471,7,29,0.241,33,42,0.786,118,39,83,0.47,28,56,0.5,11,27,0.407,22,26,0.846,111
387,BRK,2016-12-12,118,@,HOU,0,240,42,80,0.525,35,60,0.583,7,20,0.35,27,36,0.75,118,42,91,0.462,25,48,0.521,17,43,0.395,21,36,0.583,122
388,NYK,2016-12-11,118,@,LAL,1,240,41,84,0.488,31,62,0.5,10,22,0.455,26,31,0.839,118,42,88,0.477,32,60,0.533,10,28,0.357,18,22,0.818,112
389,IND,2016-12-10,118,,POR,1,240,40,83,0.482,25,54,0.463,15,29,0.517,23,28,0.821,118,40,82,0.488,24,45,0.533,16,37,0.432,15,16,0.938,111
390,WAS,2016-12-05,118,@,BRK,1,240,45,92,0.489,31,58,0.534,14,34,0.412,14,18,0.778,118,40,81,0.494,29,54,0.537,11,27,0.407,22,30,0.733,113
391,NYK,2016-12-02,118,,MIN,1,240,41,86,0.477,29,55,0.527,12,31,0.387,24,30,0.8,118,41,88,0.466,31,60,0.517,10,28,0.357,22,24,0.917,114
392,MIL,2016-11-29,118,,CLE,1,240,46,86,0.535,39,67,0.582,7,19,0.368,19,23,0.826,118,32,75,0.427,18,36,0.5,14,39,0.359,23,31,0.742,101
393,IND,2016-11-25,118,,BRK,1,240,48,87,0.552,37,61,0.607,11,26,0.423,11,16,0.688,118,36,79,0.456,25,45,0.556,11,34,0.324,14,23,0.609,97
394,CHI,2016-11-20,118,@,LAL,1,240,45,87,0.517,37,65,0.569,8,22,0.364,20,28,0.714,118,41,93,0.441,28,62,0.452,13,31,0.419,15,21,0.714,110
395,BRK,2016-11-15,118,@,LAL,0,240,45,99,0.455,33,58,0.569,12,41,0.293,16,20,0.8,118,41,92,0.446,32,64,0.5,9,28,0.321,34,43,0.791,125
396,TOR,2016-11-12,118,,NYK,1,240,39,83,0.47,32,61,0.525,7,22,0.318,33,38,0.868,118,44,97,0.454,37,74,0.5,7,23,0.304,12,16,0.75,107
397,WAS,2016-11-09,118,,BOS,1,240,46,92,0.5,36,71,0.507,10,21,0.476,16,20,0.8,118,35,81,0.432,25,50,0.5,10,31,0.323,13,22,0.591,93
398,PHO,2016-11-02,118,,POR,1,265,44,103,0.427,39,87,0.448,5,16,0.313,25,30,0.833,118,42,101,0.416,30,68,0.441,12,33,0.364,19,21,0.905,115
399,HOU,2016-11-02,118,@,NYK,1,240,42,89,0.472,27,49,0.551,15,40,0.375,19,27,0.704,118,37,85,0.435,29,65,0.446,8,20,0.4,17,25,0.68,99
400,CHI,2016-10-31,118,@,BRK,1,240,45,89,0.506,34,62,0.548,11,27,0.407,17,18,0.944,118,33,96,0.344,28,65,0.431,5,31,0.161,17,21,0.81,88
401,CHI,2016-10-29,118,,IND,1,240,45,86,0.523,36,65,0.554,9,21,0.429,19,21,0.905,118,43,88,0.489,36,70,0.514,7,18,0.389,8,9,0.889,101
402,CHI,2017-04-02,117,@,NOP,1,240,45,92,0.489,32,66,0.485,13,26,0.5,14,18,0.778,117,33,81,0.407,23,51,0.451,10,30,0.333,34,35,0.971,110
403,PHO,2017-04-01,117,@,POR,0,240,44,84,0.524,41,74,0.554,3,10,0.3,26,32,0.813,117,43,92,0.467,28,55,0.509,15,37,0.405,29,31,0.935,130
404,MIN,2017-04-01,117,,SAC,0,240,39,87,0.448,30,60,0.5,9,27,0.333,30,38,0.789,117,44,78,0.564,33,59,0.559,11,19,0.579,24,33,0.727,123
405,NOP,2017-03-31,117,,SAC,1,240,46,95,0.484,36,62,0.581,10,33,0.303,15,19,0.789,117,35,90,0.389,29,70,0.414,6,20,0.3,13,17,0.765,89
406,BOS,2017-03-31,117,,ORL,1,240,38,84,0.452,26,51,0.51,12,33,0.364,29,34,0.853,117,40,98,0.408,28,68,0.412,12,30,0.4,24,25,0.96,116
407,POR,2017-03-30,117,,HOU,1,240,43,90,0.478,30,57,0.526,13,33,0.394,18,22,0.818,117,40,91,0.44,32,57,0.561,8,34,0.235,19,23,0.826,107
408,HOU,2017-03-24,117,,NOP,1,240,44,93,0.473,30,54,0.556,14,39,0.359,15,20,0.75,117,41,91,0.451,27,53,0.509,14,38,0.368,11,14,0.786,107
409,PHI,2017-03-24,117,@,CHI,1,240,46,83,0.554,38,58,0.655,8,25,0.32,17,23,0.739,117,37,91,0.407,27,67,0.403,10,24,0.417,23,31,0.742,107
410,IND,2017-03-24,117,,DEN,0,240,48,95,0.505,35,71,0.493,13,24,0.542,8,11,0.727,117,39,82,0.476,32,55,0.582,7,27,0.259,40,43,0.93,125
411,CHI,2017-03-22,117,,DET,1,240,47,80,0.588,36,57,0.632,11,23,0.478,12,19,0.632,117,39,88,0.443,32,68,0.471,7,20,0.35,10,17,0.588,95
412,GSW,2017-03-18,117,,MIL,1,240,45,75,0.6,33,52,0.635,12,23,0.522,15,19,0.789,117,36,89,0.404,27,62,0.435,9,27,0.333,11,14,0.786,92
413,BOS,2017-03-15,117,,MIN,1,240,43,79,0.544,30,46,0.652,13,33,0.394,18,21,0.857,117,40,91,0.44,32,64,0.5,8,27,0.296,16,20,0.8,104
414,HOU,2017-03-12,117,,CLE,1,240,41,96,0.427,25,51,0.49,16,45,0.356,19,28,0.679,117,42,80,0.525,25,37,0.676,17,43,0.395,11,13,0.846,112
415,IND,2017-02-27,117,@,HOU,1,240,41,91,0.451,28,61,0.459,13,30,0.433,22,25,0.88,117,32,88,0.364,22,43,0.512,10,45,0.222,34,42,0.81,108
416,CHI,2017-02-25,117,@,CLE,1,240,46,93,0.495,31,63,0.492,15,30,0.5,10,16,0.625,117,37,80,0.463,23,43,0.535,14,37,0.378,11,15,0.733,99
417,MIA,2017-02-15,117,@,HOU,1,240,44,84,0.524,31,49,0.633,13,35,0.371,16,24,0.667,117,36,87,0.414,23,47,0.489,13,40,0.325,24,31,0.774,109
418,MIN,2017-02-12,117,,CHI,1,240,44,81,0.543,38,57,0.667,6,24,0.25,23,26,0.885,117,35,84,0.417,25,59,0.424,10,25,0.4,9,13,0.692,89
419,PHI,2017-02-11,117,,MIA,1,240,39,86,0.453,30,61,0.492,9,25,0.36,30,38,0.789,117,39,85,0.459,32,61,0.525,7,24,0.292,24,28,0.857,109
420,ATL,2017-02-08,117,,DEN,1,240,47,93,0.505,39,66,0.591,8,27,0.296,15,18,0.833,117,40,100,0.4,27,56,0.482,13,44,0.295,13,21,0.619,106
421,IND,2017-02-08,117,,CLE,0,240,41,82,0.5,28,57,0.491,13,25,0.52,22,26,0.846,117,46,84,0.548,30,48,0.625,16,36,0.444,24,26,0.923,132
422,CHI,2017-02-03,117,@,HOU,0,265,48,100,0.48,40,75,0.533,8,25,0.32,13,18,0.722,117,44,98,0.449,28,55,0.509,16,43,0.372,17,25,0.68,121
423,MIL,2017-02-03,117,@,DEN,0,240,45,83,0.542,36,59,0.61,9,24,0.375,18,23,0.783,117,40,89,0.449,31,61,0.508,9,28,0.321,32,44,0.727,121
424,WAS,2017-01-31,117,,NYK,1,240,49,88,0.557,42,66,0.636,7,22,0.318,12,15,0.8,117,34,93,0.366,29,69,0.42,5,24,0.208,28,35,0.8,101
425,NYK,2017-01-18,117,@,BOS,1,240,46,91,0.505,36,66,0.545,10,25,0.4,15,18,0.833,117,35,91,0.385,26,58,0.448,9,33,0.273,27,29,0.931,106
426,BOS,2017-01-11,117,,WAS,1,240,43,85,0.506,26,44,0.591,17,41,0.415,14,18,0.778,117,45,105,0.429,35,79,0.443,10,26,0.385,8,12,0.667,108
427,ATL,2017-01-10,117,@,BRK,1,240,44,92,0.478,37,69,0.536,7,23,0.304,22,38,0.579,117,35,87,0.402,25,58,0.431,10,29,0.345,17,23,0.739,97
428,GSW,2017-01-08,117,@,SAC,1,240,45,89,0.506,35,60,0.583,10,29,0.345,17,20,0.85,117,36,74,0.486,25,46,0.543,11,28,0.393,23,29,0.793,106
429,BOS,2017-01-07,117,,NOP,1,240,40,93,0.43,22,57,0.386,18,36,0.5,19,21,0.905,117,40,85,0.471,30,54,0.556,10,31,0.323,18,23,0.783,108
430,POR,2017-01-04,117,@,GSW,0,240,40,89,0.449,28,63,0.444,12,26,0.462,25,28,0.893,117,44,87,0.506,31,51,0.608,13,36,0.361,24,29,0.828,125
431,IND,2017-01-01,117,,ORL,1,240,43,86,0.5,34,64,0.531,9,22,0.409,22,24,0.917,117,42,97,0.433,32,59,0.542,10,38,0.263,10,11,0.909,104
432,BOS,2016-12-30,117,,MIA,1,240,38,74,0.514,21,42,0.5,17,32,0.531,24,29,0.828,117,48,90,0.533,37,62,0.597,11,28,0.393,7,10,0.7,114
433,OKC,2016-12-23,117,@,BOS,1,240,41,80,0.513,30,54,0.556,11,26,0.423,24,36,0.667,117,41,93,0.441,32,65,0.492,9,28,0.321,21,26,0.808,112
434,GSW,2016-12-22,117,@,BRK,1,240,47,104,0.452,35,67,0.522,12,37,0.324,11,14,0.786,117,38,86,0.442,25,51,0.49,13,35,0.371,12,16,0.75,101
435,CHO,2016-12-20,117,,LAL,1,240,43,94,0.457,32,69,0.464,11,25,0.44,20,24,0.833,117,44,90,0.489,28,57,0.491,16,33,0.485,9,11,0.818,113
436,DEN,2016-12-19,117,,DAL,1,240,45,80,0.563,32,55,0.582,13,25,0.52,14,18,0.778,117,43,80,0.538,29,55,0.527,14,25,0.56,7,9,0.778,107
437,WAS,2016-12-18,117,,LAC,1,240,43,81,0.531,33,62,0.532,10,19,0.526,21,30,0.7,117,43,87,0.494,36,63,0.571,7,24,0.292,17,24,0.708,110
438,DET,2016-12-09,117,@,MIN,1,240,42,84,0.5,28,55,0.509,14,29,0.483,19,23,0.826,117,37,78,0.474,34,62,0.548,3,16,0.188,13,20,0.65,90
439,BOS,2016-12-07,117,@,ORL,1,240,43,84,0.512,36,58,0.621,7,26,0.269,24,29,0.828,117,30,81,0.37,19,55,0.345,11,26,0.423,16,24,0.667,87
440,HOU,2016-11-25,117,@,SAC,1,240,40,85,0.471,19,35,0.543,21,50,0.42,16,20,0.8,117,39,80,0.488,30,48,0.625,9,32,0.281,17,21,0.81,104
441,NOP,2016-11-23,117,,MIN,1,240,45,83,0.542,36,59,0.61,9,24,0.375,18,23,0.783,117,33,86,0.384,30,69,0.435,3,17,0.176,27,33,0.818,96
442,TOR,2016-11-15,117,@,CLE,0,240,46,96,0.479,33,67,0.493,13,29,0.448,12,18,0.667,117,44,83,0.53,31,50,0.62,13,33,0.394,20,28,0.714,121
443,OKC,2016-11-13,117,,ORL,0,240,47,92,0.511,40,67,0.597,7,25,0.28,16,26,0.615,117,46,86,0.535,35,62,0.565,11,24,0.458,16,20,0.8,119
444,ATL,2016-11-12,117,,PHI,1,240,48,95,0.505,35,63,0.556,13,32,0.406,8,14,0.571,117,36,83,0.434,25,54,0.463,11,29,0.379,13,20,0.65,96
445,MIL,2016-11-05,117,,SAC,1,240,41,82,0.5,27,49,0.551,14,33,0.424,21,25,0.84,117,33,84,0.393,23,56,0.411,10,28,0.357,15,19,0.789,91
446,LAL,2016-11-04,117,,GSW,1,240,45,95,0.474,37,65,0.569,8,30,0.267,19,21,0.905,117,39,86,0.453,34,54,0.63,5,32,0.156,14,20,0.7,97
447,NYK,2016-11-04,117,@,CHI,1,240,46,89,0.517,37,68,0.544,9,21,0.429,16,21,0.762,117,37,84,0.44,29,61,0.475,8,23,0.348,22,27,0.815,104
448,MIL,2016-11-01,117,@,NOP,1,240,44,91,0.484,34,59,0.576,10,32,0.313,19,21,0.905,117,36,82,0.439,27,56,0.482,9,26,0.346,32,41,0.78,113
449,BRK,2016-10-26,117,@,BOS,0,240,43,97,0.443,28,53,0.528,15,44,0.341,16,20,0.8,117,48,89,0.539,37,57,0.649,11,32,0.344,15,18,0.833,122
450,CLE,2016-10-25,117,,NYK,1,240,45,94,0.479,32,59,0.542,13,35,0.371,14,19,0.737,117,32,87,0.368,23,60,0.383,9,27,0.333,15,20,0.75,88
451,BOS,2017-04-06,116,@,ATL,0,240,37,90,0.411,22,47,0.468,15,43,0.349,27,34,0.794,116,44,89,0.494,33,66,0.5,11,23,0.478,24,34,0.706,123
452,DEN,2017-04-02,116,@,MIA,1,240,44,87,0.506,39,67,0.582,5,20,0.25,23,27,0.852,116,42,87,0.483,29,60,0.483,13,27,0.481,16,21,0.762,113
453,PHO,2017-04-02,116,,HOU,0,240,42,100,0.42,34,66,0.515,8,34,0.235,24,29,0.828,116,47,100,0.47,33,62,0.532,14,38,0.368,15,23,0.652,123
454,ORL,2017-03-31,116,@,BOS,0,240,40,98,0.408,28,68,0.412,12,30,0.4,24,25,0.96,116,38,84,0.452,26,51,0.51,12,33,0.364,29,34,0.853,117
455,MIL,2017-03-22,116,@,SAC,1,240,43,81,0.531,27,46,0.587,16,35,0.457,14,19,0.737,116,41,84,0.488,31,58,0.534,10,26,0.385,6,10,0.6,98
456,TOR,2017-03-19,116,,IND,1,240,45,91,0.495,33,64,0.516,12,27,0.444,14,16,0.875,116,33,80,0.413,27,57,0.474,6,23,0.261,19,26,0.731,91
457,PHI,2017-03-17,116,,DAL,1,240,42,80,0.525,30,51,0.588,12,29,0.414,20,23,0.87,116,30,87,0.345,25,64,0.391,5,23,0.217,9,17,0.529,74
458,LAL,2017-03-12,116,,PHI,0,240,44,88,0.5,40,68,0.588,4,20,0.2,24,28,0.857,116,41,79,0.519,31,55,0.564,10,24,0.417,26,32,0.813,118
459,CLE,2017-03-11,116,@,ORL,1,240,43,86,0.5,28,47,0.596,15,39,0.385,15,25,0.6,116,38,96,0.396,34,75,0.453,4,21,0.19,24,28,0.857,104
460,LAC,2017-03-06,116,,BOS,1,240,39,73,0.534,30,53,0.566,9,20,0.45,29,47,0.617,116,34,83,0.41,24,48,0.5,10,35,0.286,24,29,0.828,102
461,BRK,2017-03-04,116,@,POR,0,240,45,86,0.523,31,56,0.554,14,30,0.467,12,17,0.706,116,49,86,0.57,33,61,0.541,16,25,0.64,16,22,0.727,130
462,SAC,2017-02-23,116,,DEN,1,240,46,88,0.523,39,74,0.527,7,14,0.5,17,19,0.895,116,39,88,0.443,27,53,0.509,12,35,0.343,10,14,0.714,100
463,BOS,2017-02-15,116,,PHI,1,240,38,80,0.475,25,52,0.481,13,28,0.464,27,36,0.75,116,44,93,0.473,36,62,0.581,8,31,0.258,12,18,0.667,108
464,OKC,2017-02-15,116,,NYK,1,240,41,88,0.466,29,65,0.446,12,23,0.522,22,31,0.71,116,41,86,0.477,30,65,0.462,11,21,0.524,12,14,0.857,105
465,CLE,2017-02-14,116,@,MIN,1,240,44,86,0.512,31,47,0.66,13,39,0.333,15,22,0.682,116,42,86,0.488,33,63,0.524,9,23,0.391,15,19,0.789,108
466,ORL,2017-02-13,116,@,MIA,1,240,44,90,0.489,36,76,0.474,8,14,0.571,20,29,0.69,116,39,83,0.47,33,61,0.541,6,22,0.273,23,27,0.852,107
467,MIL,2017-02-11,116,@,IND,1,240,35,73,0.479,18,42,0.429,17,31,0.548,29,37,0.784,116,35,73,0.479,25,51,0.49,10,22,0.455,20,24,0.833,100
468,DET,2017-02-03,116,,MIN,1,240,44,98,0.449,33,72,0.458,11,26,0.423,17,22,0.773,116,44,89,0.494,39,72,0.542,5,17,0.294,15,19,0.789,108
469,WAS,2017-02-02,116,,LAL,1,240,44,96,0.458,32,63,0.508,12,33,0.364,16,21,0.762,116,40,87,0.46,28,48,0.583,12,39,0.308,16,22,0.727,108
470,MIA,2017-02-01,116,,ATL,1,240,45,93,0.484,33,61,0.541,12,32,0.375,14,19,0.737,116,34,86,0.395,27,60,0.45,7,26,0.269,18,21,0.857,93
471,DEN,2017-01-31,116,@,LAL,0,240,41,99,0.414,26,72,0.361,15,27,0.556,19,23,0.826,116,47,89,0.528,35,63,0.556,12,26,0.462,14,18,0.778,120
472,MIA,2017-01-28,116,,DET,1,240,42,80,0.525,28,52,0.538,14,28,0.5,18,23,0.783,116,46,89,0.517,42,77,0.545,4,12,0.333,7,12,0.583,103
473,BRK,2017-01-27,116,@,CLE,0,240,43,87,0.494,27,54,0.5,16,33,0.485,14,16,0.875,116,49,92,0.533,36,56,0.643,13,36,0.361,13,20,0.65,124
474,SAC,2017-01-25,116,@,CLE,1,265,43,95,0.453,32,64,0.5,11,31,0.355,19,22,0.864,116,40,82,0.488,25,44,0.568,15,38,0.395,17,34,0.5,112
475,TOR,2017-01-15,116,,NYK,1,240,44,89,0.494,36,67,0.537,8,22,0.364,20,23,0.87,116,35,84,0.417,23,55,0.418,12,29,0.414,19,27,0.704,101
476,MIL,2017-01-13,116,,MIA,1,240,40,80,0.5,31,65,0.477,9,15,0.6,27,31,0.871,116,41,83,0.494,29,51,0.569,12,32,0.375,14,18,0.778,108
477,PHO,2017-01-08,116,,CLE,0,240,46,87,0.529,37,60,0.617,9,27,0.333,15,19,0.789,116,44,82,0.537,29,48,0.604,15,34,0.441,17,19,0.895,120
478,NYK,2017-01-06,116,@,MIL,1,240,41,83,0.494,28,60,0.467,13,23,0.565,21,27,0.778,116,39,78,0.5,27,56,0.482,12,22,0.545,21,28,0.75,111
479,CLE,2017-01-06,116,@,BRK,1,240,38,88,0.432,29,55,0.527,9,33,0.273,31,43,0.721,116,41,91,0.451,32,61,0.525,9,30,0.3,17,19,0.895,108
480,OKC,2017-01-05,116,@,HOU,0,240,41,91,0.451,29,61,0.475,12,30,0.4,22,27,0.815,116,41,86,0.477,26,47,0.553,15,39,0.385,21,30,0.7,118
481,LAL,2017-01-03,116,,MEM,1,240,42,82,0.512,25,49,0.51,17,33,0.515,15,28,0.536,116,30,77,0.39,20,46,0.435,10,31,0.323,32,35,0.914,102
482,DET,2017-01-03,116,,IND,0,240,48,97,0.495,38,68,0.559,10,29,0.345,10,12,0.833,116,43,74,0.581,34,58,0.586,9,16,0.563,26,30,0.867,121
483,MIL,2016-12-31,116,@,CHI,1,240,43,76,0.566,34,61,0.557,9,15,0.6,21,27,0.778,116,33,83,0.398,23,56,0.411,10,27,0.37,20,28,0.714,96
484,MIN,2016-12-30,116,,MIL,1,240,43,77,0.558,30,52,0.577,13,25,0.52,17,21,0.81,116,40,74,0.541,32,56,0.571,8,18,0.444,11,17,0.647,99
485,LAC,2016-12-30,116,@,HOU,0,240,45,96,0.469,32,63,0.508,13,33,0.394,13,16,0.813,116,45,81,0.556,31,41,0.756,14,40,0.35,36,43,0.837,140
486,PHI,2016-12-23,116,@,PHO,0,240,42,83,0.506,29,52,0.558,13,31,0.419,19,22,0.864,116,42,79,0.532,30,53,0.566,12,26,0.462,27,37,0.73,123
487,TOR,2016-12-20,116,,BRK,1,240,42,91,0.462,34,73,0.466,8,18,0.444,24,31,0.774,116,36,91,0.396,26,56,0.464,10,35,0.286,22,28,0.786,104
488,SAC,2016-12-12,116,,LAL,1,240,47,84,0.56,37,61,0.607,10,23,0.435,12,21,0.571,116,33,84,0.393,23,61,0.377,10,23,0.435,16,21,0.762,92
489,GSW,2016-12-11,116,@,MIN,1,240,38,83,0.458,25,51,0.49,13,32,0.406,27,30,0.9,116,36,81,0.444,27,57,0.474,9,24,0.375,27,36,0.75,108
490,CLE,2016-12-10,116,,CHO,1,240,42,73,0.575,29,42,0.69,13,31,0.419,19,28,0.679,116,39,86,0.453,29,59,0.492,10,27,0.37,17,24,0.708,105
491,BRK,2016-12-07,116,,DEN,1,240,41,85,0.482,32,59,0.542,9,26,0.346,25,31,0.806,116,42,105,0.4,31,68,0.456,11,37,0.297,16,21,0.762,111
492,WAS,2016-12-06,116,,ORL,0,240,44,93,0.473,33,70,0.471,11,23,0.478,17,24,0.708,116,43,83,0.518,31,57,0.544,12,26,0.462,26,36,0.722,124
493,CLE,2016-12-05,116,@,TOR,1,240,40,84,0.476,26,52,0.5,14,32,0.438,22,27,0.815,116,38,88,0.432,25,56,0.446,13,32,0.406,23,27,0.852,112
494,SAC,2016-11-23,116,,OKC,1,240,44,94,0.468,32,66,0.485,12,28,0.429,16,17,0.941,116,32,76,0.421,25,51,0.49,7,25,0.28,30,38,0.789,101
495,CHO,2016-11-19,116,@,NOP,0,265,40,97,0.412,25,54,0.463,15,43,0.349,21,28,0.75,116,43,98,0.439,29,62,0.468,14,36,0.389,21,25,0.84,121
496,SAS,2016-11-18,116,@,LAL,1,240,44,78,0.564,34,54,0.63,10,24,0.417,18,19,0.947,116,39,87,0.448,27,62,0.435,12,25,0.48,17,21,0.81,107
497,PHO,2016-11-18,116,@,IND,1,240,46,97,0.474,37,71,0.521,9,26,0.346,15,18,0.833,116,36,76,0.474,35,69,0.507,1,7,0.143,23,29,0.793,96
498,GSW,2016-11-09,116,,DAL,1,240,43,74,0.581,26,41,0.634,17,33,0.515,13,22,0.591,116,34,86,0.395,28,58,0.483,6,28,0.214,21,28,0.75,95
499,GSW,2016-11-07,116,,NOP,1,240,45,90,0.5,29,55,0.527,16,35,0.457,10,12,0.833,116,39,80,0.488,32,59,0.542,7,21,0.333,21,27,0.778,106
500,LAC,2016-11-05,116,@,SAS,1,240,47,91,0.516,38,68,0.559,9,23,0.391,13,14,0.929,116,30,74,0.405,20,49,0.408,10,25,0.4,22,25,0.88,92
501,ATL,2016-11-02,116,,LAL,0,240,41,85,0.482,30,53,0.566,11,32,0.344,23,29,0.793,116,48,90,0.533,39,68,0.574,9,22,0.409,18,20,0.9,123
502,MIN,2016-11-01,116,,MEM,1,240,43,78,0.551,31,58,0.534,12,20,0.6,18,23,0.783,116,27,75,0.36,23,51,0.451,4,24,0.167,22,29,0.759,80
503,LAC,2016-10-31,116,,PHO,1,240,40,80,0.5,34,64,0.531,6,16,0.375,30,38,0.789,116,35,84,0.417,30,69,0.435,5,15,0.333,23,31,0.742,98
504,LAC,2017-04-12,115,,SAC,1,240,43,83,0.518,33,55,0.6,10,28,0.357,19,25,0.76,115,40,81,0.494,35,70,0.5,5,11,0.455,10,14,0.714,95
505,ORL,2017-04-06,115,,BRK,1,240,42,90,0.467,33,65,0.508,9,25,0.36,22,26,0.846,115,40,87,0.46,29,57,0.509,11,30,0.367,16,22,0.727,107
506,WAS,2017-04-02,115,@,GSW,0,240,43,92,0.467,33,65,0.508,10,27,0.37,19,25,0.76,115,50,88,0.568,34,52,0.654,16,36,0.444,23,26,0.885,139
507,LAC,2017-04-01,115,,LAL,1,240,38,69,0.551,27,44,0.614,11,25,0.44,28,34,0.824,115,39,90,0.433,33,67,0.493,6,23,0.261,20,30,0.667,104
508,MIN,2017-03-28,115,@,IND,1,240,37,78,0.474,28,58,0.483,9,20,0.45,32,37,0.865,115,40,81,0.494,35,63,0.556,5,18,0.278,29,35,0.829,114
509,NOP,2017-03-26,115,@,DEN,1,240,48,97,0.495,39,70,0.557,9,27,0.333,10,12,0.833,115,36,95,0.379,30,70,0.429,6,25,0.24,12,14,0.857,90
510,CLE,2017-03-25,115,,WAS,0,240,41,83,0.494,29,50,0.58,12,33,0.364,21,27,0.778,115,49,82,0.598,41,64,0.641,8,18,0.444,21,26,0.808,127
511,ORL,2017-03-24,115,,DET,1,240,47,91,0.516,35,65,0.538,12,26,0.462,9,13,0.692,115,34,96,0.354,32,74,0.432,2,22,0.091,17,20,0.85,87
512,POR,2017-03-19,115,@,MIA,1,240,42,83,0.506,29,57,0.509,13,26,0.5,18,24,0.75,115,41,88,0.466,32,58,0.552,9,30,0.3,13,20,0.65,104
513,ORL,2017-03-13,115,@,SAC,0,240,45,98,0.459,32,64,0.5,13,34,0.382,12,12,1.0,115,44,82,0.537,28,52,0.538,16,30,0.533,16,21,0.762,120
514,CHI,2017-03-13,115,@,CHO,1,240,41,92,0.446,27,52,0.519,14,40,0.35,19,22,0.864,115,43,93,0.462,36,64,0.563,7,29,0.241,16,19,0.842,109
515,HOU,2017-03-10,115,@,CHI,1,240,37,89,0.416,22,42,0.524,15,47,0.319,26,32,0.813,115,38,98,0.388,29,59,0.492,9,39,0.231,9,12,0.75,94
516,IND,2017-03-08,115,,DET,1,240,44,88,0.5,33,65,0.508,11,23,0.478,16,19,0.842,115,39,89,0.438,32,63,0.508,7,26,0.269,13,22,0.591,98
517,UTA,2017-03-08,115,@,HOU,1,240,41,76,0.539,29,45,0.644,12,31,0.387,21,24,0.875,115,35,79,0.443,27,47,0.574,8,32,0.25,30,40,0.75,108
518,WAS,2017-03-05,115,,ORL,1,240,39,81,0.481,25,55,0.455,14,26,0.538,23,25,0.92,115,44,89,0.494,30,54,0.556,14,35,0.4,12,19,0.632,114
519,BOS,2017-03-03,115,@,LAL,1,240,43,84,0.512,33,51,0.647,10,33,0.303,19,25,0.76,115,37,87,0.425,31,63,0.492,6,24,0.25,15,20,0.75,95
520,PHO,2017-02-10,115,,CHI,1,240,48,95,0.505,40,76,0.526,8,19,0.421,11,13,0.846,115,37,86,0.43,32,67,0.478,5,19,0.263,18,22,0.818,97
521,NYK,2017-02-08,115,,LAC,0,240,46,92,0.5,38,65,0.585,8,27,0.296,15,18,0.833,115,45,92,0.489,35,67,0.522,10,25,0.4,19,28,0.679,119
522,MIA,2017-02-06,115,@,MIN,1,240,45,86,0.523,30,58,0.517,15,28,0.536,10,14,0.714,115,43,80,0.538,38,69,0.551,5,11,0.455,22,28,0.786,113
523,POR,2017-01-31,115,,CHO,1,240,42,93,0.452,31,62,0.5,11,31,0.355,20,23,0.87,115,33,83,0.398,22,52,0.423,11,31,0.355,21,25,0.84,98
524,MEM,2017-01-30,115,@,PHO,1,240,39,80,0.488,23,52,0.442,16,28,0.571,21,24,0.875,115,31,74,0.419,26,55,0.473,5,19,0.263,29,39,0.744,96
525,IND,2017-01-27,115,,SAC,1,265,38,78,0.487,28,50,0.56,10,28,0.357,29,33,0.879,115,35,70,0.5,22,45,0.489,13,25,0.52,28,36,0.778,111
526,LAC,2017-01-23,115,@,ATL,1,240,42,84,0.5,28,60,0.467,14,24,0.583,17,22,0.773,115,37,88,0.42,28,59,0.475,9,29,0.31,22,26,0.846,105
527,PHO,2017-01-22,115,@,TOR,1,240,40,79,0.506,31,57,0.544,9,22,0.409,26,28,0.929,115,33,83,0.398,26,56,0.464,7,27,0.259,30,35,0.857,103
528,CLE,2017-01-21,115,,SAS,0,265,45,91,0.495,32,57,0.561,13,34,0.382,12,22,0.545,115,48,96,0.5,38,70,0.543,10,26,0.385,12,14,0.857,118
529,ORL,2017-01-13,115,@,POR,1,240,41,83,0.494,31,65,0.477,10,18,0.556,23,26,0.885,115,39,97,0.402,29,63,0.46,10,34,0.294,21,25,0.84,109
530,DET,2017-01-05,115,,CHO,1,240,39,97,0.402,29,69,0.42,10,28,0.357,27,32,0.844,115,37,91,0.407,27,65,0.415,10,26,0.385,30,34,0.882,114
531,LAC,2017-01-04,115,,MEM,1,240,37,73,0.507,28,50,0.56,9,23,0.391,32,45,0.711,115,38,88,0.432,27,60,0.45,11,28,0.393,19,25,0.76,106
532,BOS,2017-01-03,115,,UTA,1,240,41,74,0.554,24,43,0.558,17,31,0.548,16,17,0.941,115,38,82,0.463,27,56,0.482,11,26,0.423,17,21,0.81,104
533,ORL,2017-01-02,115,@,NYK,1,240,45,91,0.495,30,60,0.5,15,31,0.484,10,14,0.714,115,39,83,0.47,31,62,0.5,8,21,0.381,17,24,0.708,103
534,PHO,2016-12-26,115,@,HOU,0,240,43,101,0.426,36,71,0.507,7,30,0.233,22,27,0.815,115,46,92,0.5,31,49,0.633,15,43,0.349,24,30,0.8,131
535,MEM,2016-12-23,115,,HOU,1,240,41,81,0.506,28,56,0.5,13,25,0.52,20,25,0.8,115,38,89,0.427,18,37,0.486,20,52,0.385,13,15,0.867,109
536,MIA,2016-12-22,115,,LAL,1,240,45,84,0.536,34,62,0.548,11,22,0.5,14,21,0.667,115,40,90,0.444,26,52,0.5,14,38,0.368,13,15,0.867,107
537,MIN,2016-12-19,115,,PHO,1,240,42,86,0.488,35,67,0.522,7,19,0.368,24,25,0.96,115,37,82,0.451,28,61,0.459,9,21,0.429,25,35,0.714,108
538,LAL,2016-12-09,115,,PHO,0,240,40,87,0.46,31,61,0.508,9,26,0.346,26,34,0.765,115,45,95,0.474,32,65,0.492,13,30,0.433,16,21,0.762,119
539,GSW,2016-12-07,115,@,LAC,1,240,42,89,0.472,35,58,0.603,7,31,0.226,24,29,0.828,115,36,92,0.391,28,66,0.424,8,26,0.308,18,24,0.75,98
540,MIL,2016-12-07,115,,POR,1,240,40,77,0.519,30,53,0.566,10,24,0.417,25,37,0.676,115,37,85,0.435,20,45,0.444,17,40,0.425,16,19,0.842,107
541,WAS,2016-11-30,115,@,OKC,0,265,44,98,0.449,34,70,0.486,10,28,0.357,17,26,0.654,115,46,95,0.484,34,65,0.523,12,30,0.4,22,31,0.71,126
542,GSW,2016-11-26,115,,MIN,1,240,45,81,0.556,34,59,0.576,11,22,0.5,14,17,0.824,115,41,89,0.461,31,54,0.574,10,35,0.286,10,12,0.833,102
543,TOR,2016-11-23,115,@,HOU,1,240,43,88,0.489,31,65,0.477,12,23,0.522,17,21,0.81,115,38,78,0.487,24,36,0.667,14,42,0.333,12,12,1.0,102
544,TOR,2016-11-21,115,@,LAC,0,240,40,80,0.5,32,61,0.525,8,19,0.421,27,32,0.844,115,39,74,0.527,29,49,0.592,10,25,0.4,35,42,0.833,123
545,IND,2016-11-20,115,@,OKC,1,265,40,89,0.449,29,67,0.433,11,22,0.5,24,31,0.774,115,44,101,0.436,34,65,0.523,10,36,0.278,13,18,0.722,111
546,SAC,2016-11-18,115,,LAC,0,240,38,86,0.442,28,60,0.467,10,26,0.385,29,35,0.829,115,40,76,0.526,27,47,0.574,13,29,0.448,28,34,0.824,121
547,CHO,2016-11-15,115,@,MIN,1,240,43,80,0.538,32,56,0.571,11,24,0.458,18,22,0.818,115,38,89,0.427,23,54,0.426,15,35,0.429,17,21,0.81,108
548,HOU,2016-11-14,115,,PHI,1,240,44,91,0.484,27,51,0.529,17,40,0.425,10,17,0.588,115,34,90,0.378,29,68,0.426,5,22,0.227,15,17,0.882,88
549,BOS,2016-11-11,115,,NYK,1,240,35,90,0.389,24,63,0.381,11,27,0.407,34,43,0.791,115,33,94,0.351,27,71,0.38,6,23,0.261,15,17,0.882,87
550,PHI,2016-11-09,115,@,IND,0,265,46,95,0.484,32,59,0.542,14,36,0.389,9,19,0.474,115,49,90,0.544,40,71,0.563,9,19,0.474,15,20,0.75,122
551,ATL,2016-11-09,115,,CHI,1,240,42,83,0.506,33,63,0.524,9,20,0.45,22,27,0.815,115,41,91,0.451,32,64,0.5,9,27,0.333,16,21,0.762,107
552,POR,2016-11-02,115,@,PHO,0,265,42,101,0.416,30,68,0.441,12,33,0.364,19,21,0.905,115,44,103,0.427,39,87,0.448,5,16,0.313,25,30,0.833,118
553,IND,2016-11-01,115,,LAL,1,240,41,87,0.471,31,59,0.525,10,28,0.357,23,29,0.793,115,40,89,0.449,34,61,0.557,6,28,0.214,22,25,0.88,108
554,POR,2016-10-29,115,@,DEN,1,265,45,98,0.459,35,66,0.53,10,32,0.313,15,21,0.714,115,38,100,0.38,32,77,0.416,6,23,0.261,31,39,0.795,113
555,NYK,2017-04-12,114,,PHI,1,240,41,83,0.494,32,61,0.525,9,22,0.409,23,32,0.719,114,46,93,0.495,39,70,0.557,7,23,0.304,14,20,0.7,113
556,BOS,2017-04-10,114,,BRK,1,240,41,91,0.451,27,53,0.509,14,38,0.368,18,21,0.857,114,31,86,0.36,23,55,0.418,8,31,0.258,35,39,0.897,105
557,CHO,2017-04-08,114,,BOS,0,240,38,84,0.452,29,56,0.518,9,28,0.321,29,32,0.906,114,45,87,0.517,28,48,0.583,17,39,0.436,14,17,0.824,121
558,ATL,2017-04-07,114,@,CLE,1,240,45,89,0.506,29,52,0.558,16,37,0.432,8,8,1.0,114,39,81,0.481,30,45,0.667,9,36,0.25,13,17,0.765,100
559,DET,2017-04-07,114,@,HOU,1,240,46,108,0.426,37,82,0.451,9,26,0.346,13,16,0.813,114,36,87,0.414,20,36,0.556,16,51,0.314,21,28,0.75,109
560,CLE,2017-04-05,114,@,BOS,1,240,43,92,0.467,32,56,0.571,11,36,0.306,17,18,0.944,114,33,81,0.407,26,48,0.542,7,33,0.212,18,29,0.621,91
561,DEN,2017-03-31,114,@,CHO,0,240,45,90,0.5,29,57,0.509,16,33,0.485,8,11,0.727,114,40,86,0.465,23,50,0.46,17,36,0.472,25,30,0.833,122
562,OKC,2017-03-29,114,@,ORL,1,265,43,102,0.422,33,69,0.478,10,33,0.303,18,28,0.643,114,39,97,0.402,30,67,0.448,9,30,0.3,19,27,0.704,106
563,IND,2017-03-28,114,,MIN,0,240,40,81,0.494,35,63,0.556,5,18,0.278,29,35,0.829,114,37,78,0.474,28,58,0.483,9,20,0.45,32,37,0.865,115
564,GSW,2017-03-24,114,,SAC,1,240,44,89,0.494,34,58,0.586,10,31,0.323,16,18,0.889,114,40,83,0.482,30,62,0.484,10,21,0.476,10,13,0.769,100
565,LAC,2017-03-20,114,,NYK,1,240,43,87,0.494,33,56,0.589,10,31,0.323,18,24,0.75,114,40,89,0.449,34,65,0.523,6,24,0.25,19,24,0.792,105
566,LAC,2017-03-16,114,@,DEN,0,240,44,84,0.524,28,52,0.538,16,32,0.5,10,15,0.667,114,46,86,0.535,31,58,0.534,15,28,0.536,22,26,0.846,129
567,UTA,2017-03-13,114,,LAC,1,240,41,78,0.526,27,57,0.474,14,21,0.667,18,22,0.818,114,39,78,0.5,27,48,0.563,12,30,0.4,18,23,0.783,108
568,POR,2017-03-09,114,,PHI,1,265,40,88,0.455,34,67,0.507,6,21,0.286,28,33,0.848,114,41,94,0.436,30,65,0.462,11,29,0.379,15,20,0.75,108
569,LAC,2017-03-09,114,@,MEM,1,240,40,78,0.513,29,48,0.604,11,30,0.367,23,28,0.821,114,37,83,0.446,30,63,0.476,7,20,0.35,17,22,0.773,98
570,SAS,2017-03-08,114,,SAC,1,240,42,84,0.5,28,55,0.509,14,29,0.483,16,21,0.762,114,42,86,0.488,35,67,0.522,7,19,0.368,13,16,0.813,104
571,ORL,2017-03-05,114,@,WAS,0,240,44,89,0.494,30,54,0.556,14,35,0.4,12,19,0.632,114,39,81,0.481,25,55,0.455,14,26,0.538,23,25,0.92,115
572,TOR,2017-03-03,114,@,WAS,1,240,41,81,0.506,30,56,0.536,11,25,0.44,21,27,0.778,114,34,92,0.37,24,62,0.387,10,30,0.333,28,32,0.875,106
573,POR,2017-03-02,114,,OKC,1,240,39,79,0.494,29,54,0.537,10,25,0.4,26,35,0.743,114,34,86,0.395,23,57,0.404,11,29,0.379,30,32,0.938,109
574,ATL,2017-02-27,114,@,BOS,1,240,46,95,0.484,40,70,0.571,6,25,0.24,16,20,0.8,114,34,87,0.391,24,53,0.453,10,34,0.294,20,25,0.8,98
575,DET,2017-02-23,114,,CHO,1,265,44,107,0.411,29,70,0.414,15,37,0.405,11,12,0.917,114,38,92,0.413,31,62,0.5,7,30,0.233,25,26,0.962,108
576,OKC,2017-02-11,114,,GSW,0,240,40,83,0.482,34,59,0.576,6,24,0.25,28,36,0.778,114,46,87,0.529,33,56,0.589,13,31,0.419,25,35,0.714,130
577,MIL,2017-02-10,114,,LAL,0,240,40,76,0.526,32,48,0.667,8,28,0.286,26,31,0.839,114,39,75,0.52,24,44,0.545,15,31,0.484,29,35,0.829,122
578,WAS,2017-02-08,114,@,BRK,1,265,40,97,0.412,31,72,0.431,9,25,0.36,25,33,0.758,114,38,91,0.418,29,58,0.5,9,33,0.273,25,36,0.694,110
579,POR,2017-02-07,114,@,DAL,1,240,42,86,0.488,31,58,0.534,11,28,0.393,19,24,0.792,114,37,75,0.493,25,47,0.532,12,28,0.429,27,32,0.844,113
580,OKC,2017-02-03,114,,MEM,1,240,38,80,0.475,25,54,0.463,13,26,0.5,25,33,0.758,114,40,83,0.482,37,64,0.578,3,19,0.158,19,22,0.864,102
581,PHO,2017-02-01,114,,LAC,0,240,39,96,0.406,32,76,0.421,7,20,0.35,29,35,0.829,114,44,85,0.518,39,66,0.591,5,19,0.263,31,38,0.816,124
582,ORL,2017-01-29,114,@,TOR,1,240,42,79,0.532,32,56,0.571,10,23,0.435,20,26,0.769,114,36,79,0.456,24,51,0.471,12,28,0.429,29,36,0.806,113
583,CHI,2017-01-25,114,,ATL,0,240,43,94,0.457,35,67,0.522,8,27,0.296,20,26,0.769,114,43,83,0.518,26,53,0.491,17,30,0.567,16,19,0.842,119
584,PHI,2017-01-25,114,@,MIL,1,240,40,75,0.533,28,49,0.571,12,26,0.462,22,25,0.88,114,42,91,0.462,35,63,0.556,7,28,0.25,18,23,0.783,109
585,OKC,2017-01-25,114,@,NOP,1,240,42,91,0.462,32,64,0.5,10,27,0.37,20,28,0.714,114,41,96,0.427,30,69,0.435,11,27,0.407,12,19,0.632,105
586,HOU,2017-01-23,114,@,MIL,0,240,39,77,0.506,25,42,0.595,14,35,0.4,22,28,0.786,114,47,80,0.588,36,57,0.632,11,23,0.478,22,27,0.815,127
587,NOP,2017-01-20,114,,BRK,0,240,43,105,0.41,32,71,0.451,11,34,0.324,17,23,0.739,114,48,83,0.578,33,53,0.623,15,30,0.5,32,35,0.914,143
588,MIN,2017-01-17,114,@,SAS,0,240,36,73,0.493,30,60,0.5,6,13,0.462,36,41,0.878,114,43,84,0.512,35,66,0.53,8,18,0.444,28,35,0.8,122
589,UTA,2017-01-14,114,,ORL,1,240,41,83,0.494,34,57,0.596,7,26,0.269,25,36,0.694,114,38,82,0.463,26,48,0.542,12,34,0.353,19,27,0.704,107
590,TOR,2017-01-10,114,,BOS,1,240,41,87,0.471,31,65,0.477,10,22,0.455,22,27,0.815,114,40,85,0.471,31,58,0.534,9,27,0.333,17,20,0.85,106
591,CHO,2017-01-10,114,@,HOU,0,240,44,92,0.478,25,49,0.51,19,43,0.442,7,9,0.778,114,40,82,0.488,23,43,0.535,17,39,0.436,24,33,0.727,121
592,CHO,2017-01-05,114,@,DET,0,240,37,91,0.407,27,65,0.415,10,26,0.385,30,34,0.882,114,39,97,0.402,29,69,0.42,10,28,0.357,27,32,0.844,115
593,LAL,2017-01-01,114,,TOR,0,240,37,92,0.402,22,60,0.367,15,32,0.469,25,31,0.806,114,42,75,0.56,32,58,0.552,10,17,0.588,29,32,0.906,123
594,ATL,2017-01-01,114,,SAS,1,265,42,92,0.457,28,64,0.438,14,28,0.5,16,27,0.593,114,42,90,0.467,33,63,0.524,9,27,0.333,19,22,0.864,112
595,OKC,2016-12-31,114,,LAC,1,240,37,78,0.474,27,49,0.551,10,29,0.345,30,35,0.857,114,31,75,0.413,23,45,0.511,8,30,0.267,18,21,0.857,88
596,MIA,2016-12-30,114,@,BOS,0,240,48,90,0.533,37,62,0.597,11,28,0.393,7,10,0.7,114,38,74,0.514,21,42,0.5,17,32,0.531,24,29,0.828,117
597,MEM,2016-12-29,114,,OKC,1,240,43,82,0.524,30,60,0.5,13,22,0.591,15,20,0.75,114,25,74,0.338,21,52,0.404,4,22,0.182,26,38,0.684,80
598,NYK,2016-12-25,114,,BOS,0,240,41,87,0.471,33,64,0.516,8,23,0.348,24,27,0.889,114,45,93,0.484,31,57,0.544,14,36,0.389,15,20,0.75,119
599,CLE,2016-12-20,114,@,MIL,1,265,37,91,0.407,20,51,0.392,17,40,0.425,23,27,0.852,114,40,87,0.46,33,60,0.55,7,27,0.259,21,29,0.724,108
600,OKC,2016-12-17,114,,PHO,1,240,41,81,0.506,34,65,0.523,7,16,0.438,25,34,0.735,114,39,90,0.433,31,68,0.456,8,22,0.364,15,20,0.75,101
601,NYK,2016-12-17,114,@,DEN,0,240,35,80,0.438,27,57,0.474,8,23,0.348,36,39,0.923,114,50,90,0.556,40,63,0.635,10,27,0.37,17,29,0.586,127
602,PHI,2016-12-14,114,,TOR,0,240,43,86,0.5,34,57,0.596,9,29,0.31,19,25,0.76,114,41,87,0.471,31,58,0.534,10,29,0.345,31,36,0.861,123
603,POR,2016-12-13,114,,OKC,1,240,43,80,0.538,35,57,0.614,8,23,0.348,20,27,0.741,114,33,87,0.379,25,60,0.417,8,27,0.296,21,28,0.75,95
604,CLE,2016-12-09,114,,MIA,1,240,46,83,0.554,37,59,0.627,9,24,0.375,13,19,0.684,114,31,90,0.344,25,63,0.397,6,27,0.222,16,21,0.762,84
605,ATL,2016-12-09,114,@,MIL,1,240,40,84,0.476,28,50,0.56,12,34,0.353,22,29,0.759,114,44,94,0.468,32,66,0.485,12,28,0.429,10,14,0.714,110
606,NYK,2016-12-06,114,@,MIA,1,240,48,98,0.49,41,73,0.562,7,25,0.28,11,16,0.688,114,38,89,0.427,27,64,0.422,11,25,0.44,16,27,0.593,103
607,MIN,2016-12-02,114,@,NYK,0,240,41,88,0.466,31,60,0.517,10,28,0.357,22,24,0.917,114,41,86,0.477,29,55,0.527,12,31,0.387,24,30,0.8,118
608,LAC,2016-12-02,114,@,NOP,1,240,45,88,0.511,35,64,0.547,10,24,0.417,14,16,0.875,114,39,85,0.459,34,65,0.523,5,20,0.25,13,21,0.619,96
609,BOS,2016-11-30,114,,DET,0,240,40,91,0.44,25,49,0.51,15,42,0.357,19,20,0.95,114,48,87,0.552,39,67,0.582,9,20,0.45,16,21,0.762,121
610,PHO,2016-11-27,114,,DEN,0,240,36,89,0.404,25,64,0.391,11,25,0.44,31,36,0.861,114,39,89,0.438,26,60,0.433,13,29,0.448,29,32,0.906,120
611,POR,2016-11-27,114,,HOU,0,240,40,83,0.482,28,50,0.56,12,33,0.364,22,29,0.759,114,46,82,0.561,29,46,0.63,17,36,0.472,21,28,0.75,130
612,CHO,2016-11-23,114,,SAS,0,240,45,89,0.506,34,69,0.493,11,20,0.55,13,18,0.722,114,44,86,0.512,31,55,0.564,13,31,0.419,18,20,0.9,119
613,MIA,2016-11-19,114,@,WAS,1,240,43,85,0.506,30,58,0.517,13,27,0.481,15,26,0.577,114,42,89,0.472,31,62,0.5,11,27,0.407,16,22,0.727,111
614,HOU,2016-11-07,114,@,WAS,1,240,41,79,0.519,24,42,0.571,17,37,0.459,15,18,0.833,114,39,94,0.415,29,67,0.433,10,27,0.37,18,20,0.9,106
615,LAC,2016-11-07,114,,DET,1,240,41,76,0.539,28,51,0.549,13,25,0.52,19,22,0.864,114,30,82,0.366,26,70,0.371,4,12,0.333,18,26,0.692,82
616,UTA,2016-11-06,114,@,NYK,1,240,38,75,0.507,30,50,0.6,8,25,0.32,30,35,0.857,114,42,83,0.506,34,63,0.54,8,20,0.4,17,19,0.895,109
617,NOP,2016-10-28,114,,GSW,0,240,47,100,0.47,42,78,0.538,5,22,0.227,15,23,0.652,114,44,91,0.484,35,63,0.556,9,28,0.321,25,28,0.893,122
618,LAC,2016-10-27,114,@,POR,1,240,37,91,0.407,29,62,0.468,8,29,0.276,32,46,0.696,114,39,85,0.459,35,67,0.522,4,18,0.222,24,32,0.75,106
619,ATL,2016-10-27,114,,WAS,1,240,44,88,0.5,32,62,0.516,12,26,0.462,14,18,0.778,114,40,94,0.426,34,74,0.459,6,20,0.3,13,18,0.722,99
620,HOU,2016-10-26,114,@,LAL,0,240,44,86,0.512,37,57,0.649,7,29,0.241,19,27,0.704,114,45,89,0.506,33,54,0.611,12,35,0.343,18,22,0.818,120
621,ORL,2017-04-12,113,,DET,1,240,42,87,0.483,29,62,0.468,13,25,0.52,16,17,0.941,113,41,106,0.387,30,70,0.429,11,36,0.306,16,28,0.571,109
622,PHI,2017-04-12,113,@,NYK,0,240,46,93,0.495,39,70,0.557,7,23,0.304,14,20,0.7,113,41,83,0.494,32,61,0.525,9,22,0.409,23,32,0.719,114
623,MIN,2017-04-07,113,@,UTA,0,240,39,79,0.494,32,63,0.508,7,16,0.438,28,28,1.0,113,45,75,0.6,31,50,0.62,14,25,0.56,16,22,0.727,120
624,TOR,2017-04-02,113,,PHI,1,240,46,85,0.541,40,66,0.606,6,19,0.316,15,19,0.789,113,36,80,0.45,25,44,0.568,11,36,0.306,22,25,0.88,105
625,MIA,2017-04-02,113,,DEN,0,240,42,87,0.483,29,60,0.483,13,27,0.481,16,21,0.762,113,44,87,0.506,39,67,0.582,5,20,0.25,23,27,0.852,116
626,CHO,2017-04-02,113,@,OKC,1,240,37,77,0.481,26,47,0.553,11,30,0.367,28,32,0.875,113,39,84,0.464,27,53,0.509,12,31,0.387,11,12,0.917,101
627,DEN,2017-03-28,113,@,POR,0,240,44,94,0.468,35,64,0.547,9,30,0.3,16,20,0.8,113,45,91,0.495,37,64,0.578,8,27,0.296,24,33,0.727,122
628,GSW,2017-03-28,113,@,HOU,1,240,45,88,0.511,34,47,0.723,11,41,0.268,12,16,0.75,113,33,85,0.388,28,54,0.519,5,31,0.161,35,39,0.897,106
629,CLE,2017-03-22,113,@,DEN,0,240,43,85,0.506,28,48,0.583,15,37,0.405,12,14,0.857,113,51,96,0.531,40,70,0.571,11,26,0.423,13,13,1.0,126
630,POR,2017-03-18,113,@,ATL,1,240,44,87,0.506,36,69,0.522,8,18,0.444,17,19,0.895,113,32,88,0.364,25,62,0.403,7,26,0.269,26,32,0.813,97
631,MEM,2017-03-13,113,,MIL,1,240,41,79,0.519,27,52,0.519,14,27,0.519,17,23,0.739,113,31,67,0.463,17,41,0.415,14,26,0.538,17,20,0.85,93
632,DEN,2017-03-08,113,,WAS,0,240,46,87,0.529,33,59,0.559,13,28,0.464,8,17,0.471,113,50,88,0.568,39,62,0.629,11,26,0.423,12,19,0.632,123
633,NYK,2017-03-06,113,@,ORL,1,240,40,86,0.465,34,72,0.472,6,14,0.429,27,28,0.964,113,40,85,0.471,31,53,0.585,9,32,0.281,16,24,0.667,105
634,POR,2017-02-28,113,@,DET,0,265,44,84,0.524,34,59,0.576,10,25,0.4,15,22,0.682,113,45,104,0.433,38,79,0.481,7,25,0.28,23,31,0.742,120
635,MIA,2017-02-25,113,,IND,1,240,38,78,0.487,25,47,0.532,13,31,0.419,24,31,0.774,113,34,85,0.4,30,73,0.411,4,12,0.333,23,26,0.885,95
636,LAC,2017-02-23,113,@,GSW,0,240,38,93,0.409,27,65,0.415,11,28,0.393,26,37,0.703,113,43,81,0.531,30,56,0.536,13,25,0.52,24,26,0.923,123
637,CLE,2017-02-15,113,,IND,1,240,39,82,0.476,21,43,0.488,18,39,0.462,17,19,0.895,113,40,86,0.465,28,62,0.452,12,24,0.5,12,14,0.857,104
638,DAL,2017-02-07,113,,POR,0,240,37,75,0.493,25,47,0.532,12,28,0.429,27,32,0.844,113,42,86,0.488,31,58,0.534,11,28,0.393,19,24,0.792,114
639,MIN,2017-02-06,113,,MIA,0,240,43,80,0.538,38,69,0.551,5,11,0.455,22,28,0.786,113,45,86,0.523,30,58,0.517,15,28,0.536,10,14,0.714,115
640,DET,2017-02-06,113,,PHI,1,240,46,99,0.465,41,77,0.532,5,22,0.227,16,17,0.941,113,36,85,0.424,31,57,0.544,5,28,0.179,19,28,0.679,96
641,ATL,2017-02-04,113,,ORL,1,240,41,78,0.526,31,50,0.62,10,28,0.357,21,27,0.778,113,27,78,0.346,20,51,0.392,7,27,0.259,25,28,0.893,86
642,BOS,2017-02-03,113,,LAL,1,240,39,82,0.476,26,47,0.553,13,35,0.371,22,28,0.786,113,37,94,0.394,23,56,0.411,14,38,0.368,19,26,0.731,107
643,ATL,2017-02-02,113,@,HOU,1,240,44,85,0.518,36,55,0.655,8,30,0.267,17,23,0.739,113,35,93,0.376,22,42,0.524,13,51,0.255,25,33,0.758,108
644,DAL,2017-02-01,113,,PHI,1,240,40,86,0.465,30,60,0.5,10,26,0.385,23,28,0.821,113,35,77,0.455,29,55,0.527,6,22,0.273,19,26,0.731,95
645,BOS,2017-01-30,113,,DET,1,240,36,82,0.439,23,50,0.46,13,32,0.406,28,33,0.848,113,43,97,0.443,40,70,0.571,3,27,0.111,20,29,0.69,109
646,TOR,2017-01-29,113,,ORL,0,240,36,79,0.456,24,51,0.471,12,28,0.429,29,36,0.806,113,42,79,0.532,32,56,0.571,10,23,0.435,20,26,0.769,114
647,GSW,2017-01-29,113,@,POR,1,240,36,79,0.456,28,53,0.528,8,26,0.308,33,39,0.846,113,46,93,0.495,36,66,0.545,10,27,0.37,9,12,0.75,111
648,GSW,2017-01-25,113,@,CHO,1,240,39,82,0.476,28,54,0.519,11,28,0.393,24,27,0.889,113,38,92,0.413,31,69,0.449,7,23,0.304,20,21,0.952,103
649,DET,2017-01-21,113,,WAS,1,240,43,87,0.494,32,59,0.542,11,28,0.393,16,22,0.727,113,39,91,0.429,31,65,0.477,8,26,0.308,26,33,0.788,112
650,CHO,2017-01-20,113,,TOR,1,240,40,80,0.5,28,55,0.509,12,25,0.48,21,25,0.84,113,29,86,0.337,22,56,0.393,7,30,0.233,13,14,0.929,78
651,WAS,2017-01-19,113,@,NYK,1,240,44,88,0.5,31,56,0.554,13,32,0.406,12,14,0.857,113,42,90,0.467,35,66,0.53,7,24,0.292,19,22,0.864,110
652,PHI,2017-01-16,113,@,MIL,1,240,35,78,0.449,21,41,0.512,14,37,0.378,29,36,0.806,113,42,89,0.472,37,75,0.493,5,14,0.357,15,22,0.682,104
653,LAC,2017-01-14,113,,LAL,1,240,48,92,0.522,38,64,0.594,10,28,0.357,7,8,0.875,113,36,80,0.45,26,59,0.441,10,21,0.476,15,27,0.556,97
654,BRK,2017-01-13,113,@,TOR,0,240,40,86,0.465,23,50,0.46,17,36,0.472,16,20,0.8,113,52,97,0.536,41,69,0.594,11,28,0.393,17,21,0.81,132
655,DAL,2017-01-12,113,@,PHO,1,240,43,89,0.483,28,55,0.509,15,34,0.441,12,17,0.706,113,38,78,0.487,28,60,0.467,10,18,0.556,22,27,0.815,108
656,DEN,2017-01-03,113,,SAC,0,240,41,82,0.5,23,44,0.523,18,38,0.474,13,13,1.0,113,46,88,0.523,35,59,0.593,11,29,0.379,17,18,0.944,120
657,DAL,2017-01-03,113,,WAS,1,240,37,78,0.474,20,46,0.435,17,32,0.531,22,24,0.917,113,41,92,0.446,30,62,0.484,11,30,0.367,12,14,0.857,105
658,BOS,2016-12-27,113,,MEM,1,240,41,85,0.482,29,54,0.537,12,31,0.387,19,21,0.905,113,37,88,0.42,28,58,0.483,9,30,0.3,20,29,0.69,103
659,DET,2016-12-23,113,,GSW,0,240,43,85,0.506,33,56,0.589,10,29,0.345,17,28,0.607,113,43,77,0.558,32,50,0.64,11,27,0.407,22,24,0.917,119
660,CLE,2016-12-21,113,,MIL,1,240,43,87,0.494,28,60,0.467,15,27,0.556,12,19,0.632,113,36,77,0.468,27,55,0.491,9,22,0.409,21,29,0.724,102
661,LAL,2016-12-20,113,@,CHO,0,240,44,90,0.489,28,57,0.491,16,33,0.485,9,11,0.818,113,43,94,0.457,32,69,0.464,11,25,0.44,20,24,0.833,117
662,CHI,2016-12-19,113,,DET,1,240,49,82,0.598,41,66,0.621,8,16,0.5,7,7,1.0,113,34,83,0.41,31,60,0.517,3,23,0.13,11,13,0.846,82
663,SAS,2016-12-18,113,,NOP,1,240,42,86,0.488,31,64,0.484,11,22,0.5,18,22,0.818,113,41,89,0.461,31,63,0.492,10,26,0.385,8,14,0.571,100
664,LAC,2016-12-14,113,@,ORL,1,240,37,74,0.5,24,49,0.49,13,25,0.52,26,37,0.703,113,42,89,0.472,28,56,0.5,14,33,0.424,10,20,0.5,108
665,PHO,2016-12-13,113,,NYK,1,265,38,93,0.409,29,63,0.46,9,30,0.3,28,33,0.848,113,38,97,0.392,31,77,0.403,7,20,0.35,28,38,0.737,111
666,GSW,2016-12-13,113,@,NOP,1,240,42,95,0.442,28,61,0.459,14,34,0.412,15,19,0.789,113,39,82,0.476,25,47,0.532,14,35,0.4,17,21,0.81,109
667,ORL,2016-12-10,113,,DEN,0,240,43,88,0.489,32,61,0.525,11,27,0.407,16,24,0.667,113,47,83,0.566,39,64,0.609,8,19,0.421,19,25,0.76,121
668,BRK,2016-12-05,113,,WAS,0,240,40,81,0.494,29,54,0.537,11,27,0.407,22,30,0.733,113,45,92,0.489,31,58,0.534,14,34,0.412,14,18,0.778,118
669,TOR,2016-12-02,113,,LAL,1,240,45,83,0.542,33,54,0.611,12,29,0.414,11,13,0.846,113,32,93,0.344,26,67,0.388,6,26,0.231,10,17,0.588,80
670,LAC,2016-12-01,113,@,CLE,1,240,42,89,0.472,29,58,0.5,13,31,0.419,16,24,0.667,113,28,69,0.406,19,45,0.422,9,24,0.375,29,39,0.744,94
671,NYK,2016-11-25,113,,CHO,1,265,45,97,0.464,34,69,0.493,11,28,0.393,12,13,0.923,113,43,93,0.462,35,64,0.547,8,29,0.276,17,27,0.63,111
672,TOR,2016-11-18,113,@,DEN,1,265,43,94,0.457,35,71,0.493,8,23,0.348,19,31,0.613,113,39,83,0.47,35,58,0.603,4,25,0.16,29,39,0.744,111
673,NOP,2016-11-18,113,,POR,1,240,45,82,0.549,36,58,0.621,9,24,0.375,14,20,0.7,113,33,88,0.375,21,54,0.389,12,34,0.353,23,26,0.885,101
674,CHI,2016-11-15,113,@,POR,1,240,41,98,0.418,34,78,0.436,7,20,0.35,24,28,0.857,113,34,95,0.358,25,61,0.41,9,34,0.265,11,18,0.611,88
675,TOR,2016-11-11,113,@,CHO,1,240,43,90,0.478,37,68,0.544,6,22,0.273,21,22,0.955,113,38,93,0.409,21,52,0.404,17,41,0.415,18,24,0.75,111
676,TOR,2016-11-02,113,@,WAS,1,240,43,77,0.558,33,52,0.635,10,25,0.4,17,25,0.68,113,42,72,0.583,39,62,0.629,3,10,0.3,16,24,0.667,103
677,NOP,2016-11-01,113,,MIL,0,240,36,82,0.439,27,56,0.482,9,26,0.346,32,41,0.78,113,44,91,0.484,34,59,0.576,10,32,0.313,19,21,0.905,117
678,OKC,2016-10-30,113,,LAL,1,240,45,95,0.474,36,69,0.522,9,26,0.346,14,17,0.824,113,35,87,0.402,28,55,0.509,7,32,0.219,19,24,0.792,96
679,DEN,2016-10-29,113,,POR,0,265,38,100,0.38,32,77,0.416,6,23,0.261,31,39,0.795,113,45,98,0.459,35,66,0.53,10,32,0.313,15,21,0.714,115
680,OKC,2016-10-28,113,,PHO,1,265,40,96,0.417,35,75,0.467,5,21,0.238,28,38,0.737,113,42,94,0.447,37,66,0.561,5,28,0.179,21,32,0.656,110
681,SAC,2016-10-26,113,@,PHO,1,240,44,86,0.512,38,65,0.585,6,21,0.286,19,26,0.731,113,36,77,0.468,32,61,0.525,4,16,0.25,18,27,0.667,94
682,POR,2016-10-25,113,,UTA,1,240,39,75,0.52,26,56,0.464,13,19,0.684,22,22,1.0,113,40,82,0.488,32,58,0.552,8,24,0.333,16,16,1.0,104
683,CHI,2017-04-12,112,,BRK,1,240,41,95,0.432,27,65,0.415,14,30,0.467,16,21,0.762,112,28,86,0.326,25,53,0.472,3,33,0.091,14,18,0.778,73
684,BOS,2017-04-12,112,,MIL,1,240,41,91,0.451,29,54,0.537,12,37,0.324,18,26,0.692,112,37,84,0.44,31,61,0.508,6,23,0.261,14,17,0.824,94
685,ORL,2017-04-08,112,,IND,0,240,41,84,0.488,27,54,0.5,14,30,0.467,16,22,0.727,112,51,86,0.593,40,64,0.625,11,22,0.5,14,19,0.737,127
686,MIA,2017-04-05,112,@,CHO,1,240,40,84,0.476,19,44,0.432,21,40,0.525,11,12,0.917,112,35,78,0.449,27,53,0.509,8,25,0.32,21,24,0.875,99
687,LAC,2017-04-05,112,,DAL,1,240,38,75,0.507,26,44,0.591,12,31,0.387,24,31,0.774,112,38,86,0.442,27,55,0.491,11,31,0.355,14,18,0.778,101
688,UTA,2017-03-29,112,@,SAC,1,240,42,79,0.532,29,48,0.604,13,31,0.419,15,19,0.789,112,34,75,0.453,32,60,0.533,2,15,0.133,12,18,0.667,82
689,ORL,2017-03-27,112,@,TOR,0,240,43,88,0.489,39,68,0.574,4,20,0.2,22,28,0.786,112,49,83,0.59,39,68,0.574,10,15,0.667,23,35,0.657,131
690,BOS,2017-03-26,112,,MIA,1,240,41,77,0.532,33,53,0.623,8,24,0.333,22,25,0.88,112,41,91,0.451,34,62,0.548,7,29,0.241,19,24,0.792,108
691,POR,2017-03-25,112,,MIN,1,240,45,71,0.634,34,49,0.694,11,22,0.5,11,17,0.647,112,37,76,0.487,35,66,0.53,2,10,0.2,24,32,0.75,100
692,CLE,2017-03-24,112,@,CHO,1,240,41,74,0.554,32,49,0.653,9,25,0.36,21,24,0.875,112,38,90,0.422,28,52,0.538,10,38,0.263,19,24,0.792,105
693,GSW,2017-03-21,112,@,DAL,1,240,43,78,0.551,30,48,0.625,13,30,0.433,13,16,0.813,112,33,92,0.359,22,58,0.379,11,34,0.324,10,12,0.833,87
694,MIA,2017-03-21,112,,PHO,1,240,42,96,0.438,31,69,0.449,11,27,0.407,17,23,0.739,112,36,82,0.439,32,66,0.485,4,16,0.25,21,29,0.724,97
695,ORL,2017-03-20,112,,PHI,1,265,35,94,0.372,31,71,0.437,4,23,0.174,38,46,0.826,112,39,102,0.382,30,68,0.441,9,34,0.265,22,24,0.917,109
696,DET,2017-03-19,112,,PHO,1,240,40,92,0.435,28,67,0.418,12,25,0.48,20,30,0.667,112,35,99,0.354,29,77,0.377,6,22,0.273,19,30,0.633,95
697,WAS,2017-03-17,112,,CHI,1,240,46,101,0.455,36,75,0.48,10,26,0.385,10,12,0.833,112,44,88,0.5,37,61,0.607,7,27,0.259,12,18,0.667,107
698,HOU,2017-03-17,112,@,NOP,0,240,37,91,0.407,24,51,0.471,13,40,0.325,25,32,0.781,112,49,92,0.533,37,58,0.638,12,34,0.353,18,24,0.75,128
699,DAL,2017-03-15,112,@,WAS,1,240,40,79,0.506,26,47,0.553,14,32,0.438,18,25,0.72,112,40,82,0.488,28,52,0.538,12,30,0.4,15,21,0.714,107
700,NOP,2017-03-15,112,@,MIA,0,240,42,88,0.477,33,66,0.5,9,22,0.409,19,28,0.679,112,44,87,0.506,28,52,0.538,16,35,0.457,16,19,0.842,120
701,NYK,2017-03-12,112,@,BRK,0,240,39,94,0.415,31,71,0.437,8,23,0.348,26,32,0.813,112,40,87,0.46,21,49,0.429,19,38,0.5,21,29,0.724,120
702,CLE,2017-03-12,112,@,HOU,0,240,42,80,0.525,25,37,0.676,17,43,0.395,11,13,0.846,112,41,96,0.427,25,51,0.49,16,45,0.356,19,28,0.679,117
703,OKC,2017-03-11,112,,UTA,1,240,43,86,0.5,35,63,0.556,8,23,0.348,18,24,0.75,112,36,75,0.48,27,55,0.491,9,20,0.45,23,28,0.821,104
704,LAC,2017-03-11,112,,PHI,1,240,40,81,0.494,32,56,0.571,8,25,0.32,24,29,0.828,112,40,84,0.476,30,54,0.556,10,30,0.333,10,14,0.714,100
705,DET,2017-03-11,112,,NYK,1,240,46,96,0.479,37,69,0.536,9,27,0.333,11,19,0.579,112,36,82,0.439,23,52,0.442,13,30,0.433,7,11,0.636,92
706,MIL,2017-03-06,112,@,PHI,1,240,41,83,0.494,27,50,0.54,14,33,0.424,16,20,0.8,112,39,89,0.438,31,59,0.525,8,30,0.267,12,19,0.632,98
707,SAS,2017-03-06,112,,HOU,1,240,40,88,0.455,29,60,0.483,11,28,0.393,21,23,0.913,112,41,88,0.466,27,49,0.551,14,39,0.359,14,17,0.824,110
708,GSW,2017-03-05,112,@,NYK,1,240,40,88,0.455,27,53,0.509,13,35,0.371,19,23,0.826,112,39,83,0.47,32,61,0.525,7,22,0.318,20,25,0.8,105
709,CHO,2017-03-04,112,@,DEN,1,240,41,90,0.456,25,63,0.397,16,27,0.593,14,17,0.824,112,36,80,0.45,27,50,0.54,9,30,0.3,21,25,0.84,102
710,UTA,2017-03-03,112,,BRK,1,240,38,74,0.514,26,48,0.542,12,26,0.462,24,34,0.706,112,36,89,0.404,29,59,0.492,7,30,0.233,18,24,0.75,97
711,MIL,2017-03-03,112,,LAC,1,240,44,80,0.55,34,55,0.618,10,25,0.4,14,15,0.933,112,36,64,0.563,28,45,0.622,8,19,0.421,21,36,0.583,101
712,PHO,2017-02-28,112,@,MEM,0,240,43,83,0.518,36,62,0.581,7,21,0.333,19,24,0.792,112,48,86,0.558,36,61,0.59,12,25,0.48,22,29,0.759,130
713,WAS,2017-02-28,112,,GSW,1,240,41,91,0.451,29,63,0.46,12,28,0.429,18,20,0.9,112,39,84,0.464,31,55,0.564,8,29,0.276,22,27,0.815,108
714,TOR,2017-02-26,112,,POR,1,240,42,78,0.538,35,58,0.603,7,20,0.35,21,27,0.778,112,35,79,0.443,26,58,0.448,9,21,0.429,27,35,0.771,106
715,GSW,2017-02-25,112,,BRK,1,240,42,100,0.42,31,69,0.449,11,31,0.355,17,22,0.773,112,38,94,0.404,30,66,0.455,8,28,0.286,11,17,0.647,95
716,WAS,2017-02-24,112,@,PHI,0,240,38,90,0.422,33,66,0.5,5,24,0.208,31,40,0.775,112,43,87,0.494,33,58,0.569,10,29,0.345,24,30,0.8,120
717,POR,2017-02-23,112,@,ORL,1,240,41,81,0.506,32,63,0.508,9,18,0.5,21,27,0.778,112,34,86,0.395,27,64,0.422,7,22,0.318,28,39,0.718,103
718,MIN,2017-02-15,112,@,DEN,1,240,41,86,0.477,35,68,0.515,6,18,0.333,24,28,0.857,112,38,94,0.404,27,60,0.45,11,34,0.324,12,18,0.667,99
719,MEM,2017-02-13,112,@,BRK,1,240,39,77,0.506,30,55,0.545,9,22,0.409,25,27,0.926,112,38,82,0.463,26,45,0.578,12,37,0.324,15,18,0.833,103
720,BOS,2017-02-11,112,@,UTA,1,240,42,71,0.592,29,41,0.707,13,30,0.433,15,23,0.652,112,35,86,0.407,27,55,0.491,8,31,0.258,26,30,0.867,104
721,DAL,2017-02-11,112,,ORL,1,240,45,91,0.495,28,56,0.5,17,35,0.486,5,6,0.833,112,32,82,0.39,29,59,0.492,3,23,0.13,13,18,0.722,80
722,WAS,2017-02-10,112,,IND,1,240,41,88,0.466,31,59,0.525,10,29,0.345,20,30,0.667,112,45,92,0.489,41,71,0.577,4,21,0.19,13,15,0.867,107
723,DAL,2017-02-09,112,,UTA,1,265,44,87,0.506,39,67,0.582,5,20,0.25,19,25,0.76,112,39,85,0.459,26,56,0.464,13,29,0.448,14,17,0.824,105
724,PHI,2017-02-09,112,@,ORL,1,240,40,95,0.421,29,67,0.433,11,28,0.393,21,27,0.778,112,41,84,0.488,31,63,0.492,10,21,0.476,19,24,0.792,111
725,MIN,2017-02-08,112,,TOR,1,240,39,80,0.488,32,61,0.525,7,19,0.368,27,30,0.9,112,42,79,0.532,31,51,0.608,11,28,0.393,14,20,0.7,109
726,CHI,2017-02-06,112,@,SAC,1,240,43,81,0.531,37,62,0.597,6,19,0.316,20,31,0.645,112,41,79,0.519,30,51,0.588,11,28,0.393,14,16,0.875,107
727,PHO,2017-02-04,112,,MIL,0,240,38,91,0.418,27,63,0.429,11,28,0.393,25,30,0.833,112,52,82,0.634,45,65,0.692,7,17,0.412,26,35,0.743,137
728,BOS,2017-01-28,112,@,MIL,1,265,37,89,0.416,23,48,0.479,14,41,0.341,24,30,0.8,112,37,87,0.425,28,66,0.424,9,21,0.429,25,32,0.781,108
729,PHO,2017-01-28,112,,DEN,0,240,41,91,0.451,35,70,0.5,6,21,0.286,24,32,0.75,112,39,80,0.488,31,55,0.564,8,25,0.32,37,42,0.881,123
730,WAS,2017-01-27,112,@,ATL,1,240,43,89,0.483,30,58,0.517,13,31,0.419,13,19,0.684,112,30,83,0.361,21,52,0.404,9,31,0.29,17,25,0.68,86
731,POR,2017-01-27,112,,MEM,1,240,38,81,0.469,22,46,0.478,16,35,0.457,20,21,0.952,112,37,77,0.481,28,51,0.549,9,26,0.346,26,33,0.788,109
732,CLE,2017-01-25,112,,SAC,0,265,40,82,0.488,25,44,0.568,15,38,0.395,17,34,0.5,112,43,95,0.453,32,64,0.5,11,31,0.355,19,22,0.864,116
733,MIN,2017-01-24,112,@,PHO,1,240,44,84,0.524,38,67,0.567,6,17,0.353,18,24,0.75,112,38,86,0.442,31,67,0.463,7,19,0.368,28,32,0.875,111
734,SAS,2017-01-23,112,@,BRK,1,240,45,95,0.474,36,73,0.493,9,22,0.409,13,16,0.813,112,32,81,0.395,27,56,0.482,5,25,0.2,17,18,0.944,86
735,CHO,2017-01-21,112,,BRK,1,240,39,82,0.476,25,52,0.481,14,30,0.467,20,22,0.909,112,38,88,0.432,21,47,0.447,17,41,0.415,12,15,0.8,105
736,WAS,2017-01-21,112,@,DET,0,240,39,91,0.429,31,65,0.477,8,26,0.308,26,33,0.788,112,43,87,0.494,32,59,0.542,11,28,0.393,16,22,0.727,113
737,UTA,2017-01-20,112,@,DAL,1,265,38,83,0.458,30,60,0.5,8,23,0.348,28,39,0.718,112,39,87,0.448,31,64,0.484,8,23,0.348,21,28,0.75,107
738,ORL,2017-01-20,112,,MIL,1,240,40,87,0.46,32,59,0.542,8,28,0.286,24,31,0.774,112,34,83,0.41,24,58,0.414,10,25,0.4,18,26,0.692,96
739,ORL,2017-01-16,112,@,DEN,0,240,45,88,0.511,37,63,0.587,8,25,0.32,14,18,0.778,112,52,89,0.584,43,62,0.694,9,27,0.333,12,15,0.8,125
740,BRK,2017-01-15,112,,HOU,0,240,41,93,0.441,26,49,0.531,15,44,0.341,15,19,0.789,112,46,92,0.5,25,48,0.521,21,44,0.477,24,32,0.75,137
741,IND,2017-01-12,112,@,DEN,0,240,44,94,0.468,32,65,0.492,12,29,0.414,12,13,0.923,112,52,90,0.578,37,58,0.638,15,32,0.469,21,23,0.913,140
742,WAS,2017-01-06,112,,MIN,1,240,46,79,0.582,34,57,0.596,12,22,0.545,8,9,0.889,112,42,88,0.477,35,70,0.5,7,18,0.389,14,17,0.824,105
743,OKC,2017-01-04,112,@,CHO,0,240,42,96,0.438,33,66,0.5,9,30,0.3,19,23,0.826,112,37,80,0.463,28,56,0.5,9,24,0.375,40,49,0.816,123
744,SAS,2017-01-01,112,@,ATL,0,265,42,90,0.467,33,63,0.524,9,27,0.333,19,22,0.864,112,42,92,0.457,28,64,0.438,14,28,0.5,16,27,0.593,114
745,MEM,2016-12-31,112,@,SAC,1,240,44,87,0.506,27,52,0.519,17,35,0.486,7,9,0.778,112,31,72,0.431,20,44,0.455,11,28,0.393,25,28,0.893,98
746,ORL,2016-12-26,112,,MEM,1,240,44,86,0.512,31,60,0.517,13,26,0.5,11,16,0.688,112,35,76,0.461,25,51,0.49,10,25,0.4,22,28,0.786,102
747,OKC,2016-12-25,112,,MIN,1,240,42,82,0.512,34,58,0.586,8,24,0.333,20,24,0.833,112,39,83,0.47,35,71,0.493,4,12,0.333,18,23,0.783,100
748,BOS,2016-12-23,112,,OKC,0,240,41,93,0.441,32,65,0.492,9,28,0.321,21,26,0.808,112,41,80,0.513,30,54,0.556,11,26,0.423,24,36,0.667,117
749,BOS,2016-12-20,112,@,MEM,1,265,33,81,0.407,21,44,0.477,12,37,0.324,34,38,0.895,112,38,94,0.404,26,64,0.406,12,30,0.4,21,26,0.808,109
750,MIA,2016-12-12,112,,WAS,1,240,45,88,0.511,36,62,0.581,9,26,0.346,13,19,0.684,112,39,84,0.464,34,61,0.557,5,23,0.217,18,22,0.818,101
751,DAL,2016-12-12,112,,DEN,1,240,45,77,0.584,33,51,0.647,12,26,0.462,10,12,0.833,112,35,83,0.422,28,58,0.483,7,25,0.28,15,18,0.833,92
752,LAL,2016-12-11,112,,NYK,0,240,42,88,0.477,32,60,0.533,10,28,0.357,18,22,0.818,112,41,84,0.488,31,62,0.5,10,22,0.455,26,31,0.839,118
753,UTA,2016-12-06,112,,PHO,1,240,36,73,0.493,24,46,0.522,12,27,0.444,28,32,0.875,112,39,84,0.464,33,66,0.5,6,18,0.333,21,25,0.84,105
754,POR,2016-12-05,112,@,CHI,1,240,45,93,0.484,36,69,0.522,9,24,0.375,13,18,0.722,112,35,83,0.422,28,60,0.467,7,23,0.304,33,38,0.868,110
755,TOR,2016-12-05,112,,CLE,0,240,38,88,0.432,25,56,0.446,13,32,0.406,23,27,0.852,112,40,84,0.476,26,52,0.5,14,32,0.438,22,27,0.815,116
756,MIL,2016-12-03,112,,BRK,1,240,40,85,0.471,34,61,0.557,6,24,0.25,26,36,0.722,112,34,91,0.374,23,50,0.46,11,41,0.268,24,33,0.727,103
757,DET,2016-11-29,112,@,CHO,1,240,45,92,0.489,33,64,0.516,12,28,0.429,10,11,0.909,112,31,78,0.397,22,51,0.431,9,27,0.333,18,21,0.857,89
758,BOS,2016-11-28,112,@,MIA,1,240,40,83,0.482,29,56,0.518,11,27,0.407,21,26,0.808,112,38,80,0.475,32,50,0.64,6,30,0.2,22,32,0.688,104
759,OKC,2016-11-28,112,@,NYK,1,240,46,92,0.5,38,70,0.543,8,22,0.364,12,18,0.667,112,36,91,0.396,30,72,0.417,6,19,0.316,25,28,0.893,103
760,UTA,2016-11-28,112,@,MIN,1,240,40,79,0.506,36,61,0.59,4,18,0.222,28,34,0.824,112,36,81,0.444,29,62,0.468,7,19,0.368,24,25,0.96,103
761,CLE,2016-11-27,112,@,PHI,1,240,38,92,0.413,26,52,0.5,12,40,0.3,24,28,0.857,112,43,92,0.467,28,58,0.483,15,34,0.441,7,10,0.7,108
762,SAS,2016-11-26,112,@,WAS,1,240,40,75,0.533,31,51,0.608,9,24,0.375,23,29,0.793,112,42,88,0.477,36,66,0.545,6,22,0.273,10,14,0.714,100
763,NOP,2016-11-22,112,@,ATL,1,240,45,86,0.523,34,61,0.557,11,25,0.44,11,12,0.917,112,39,85,0.459,29,56,0.518,10,29,0.345,6,10,0.6,94
764,NYK,2016-11-17,112,@,WAS,0,240,41,86,0.477,29,57,0.509,12,29,0.414,18,20,0.9,112,44,81,0.543,29,56,0.518,15,25,0.6,16,18,0.889,119
765,POR,2016-11-13,112,,DEN,1,240,39,99,0.394,31,70,0.443,8,29,0.276,26,32,0.813,112,36,91,0.396,25,62,0.403,11,29,0.379,22,29,0.759,105
766,NOP,2016-11-10,112,@,MIL,1,240,39,89,0.438,30,64,0.469,9,25,0.36,25,27,0.926,112,40,91,0.44,34,73,0.466,6,18,0.333,20,25,0.8,106
767,TOR,2016-11-09,112,@,OKC,1,240,43,83,0.518,32,57,0.561,11,26,0.423,15,22,0.682,112,31,74,0.419,19,40,0.475,12,34,0.353,28,31,0.903,102
768,CHI,2016-11-07,112,,ORL,1,240,42,89,0.472,39,70,0.557,3,19,0.158,25,31,0.806,112,33,85,0.388,24,55,0.436,9,30,0.3,5,6,0.833,80
769,OKC,2016-11-05,112,,MIN,1,240,45,86,0.523,38,70,0.543,7,16,0.438,15,24,0.625,112,33,84,0.393,29,65,0.446,4,19,0.211,22,29,0.759,92
770,ATL,2016-11-05,112,,HOU,1,240,45,85,0.529,37,65,0.569,8,20,0.4,14,24,0.583,112,37,85,0.435,25,49,0.51,12,36,0.333,11,13,0.846,97
771,PHO,2016-11-04,112,@,NOP,1,265,40,93,0.43,32,69,0.464,8,24,0.333,24,28,0.857,112,43,94,0.457,33,64,0.516,10,30,0.333,15,28,0.536,111
772,MEM,2016-10-30,112,,WAS,1,265,39,88,0.443,24,57,0.421,15,31,0.484,19,26,0.731,112,38,86,0.442,33,61,0.541,5,25,0.2,22,25,0.88,103
773,DEN,2017-04-12,111,@,OKC,1,240,39,85,0.459,32,60,0.533,7,25,0.28,26,32,0.813,111,43,101,0.426,35,76,0.461,8,25,0.32,11,17,0.647,105
774,PHI,2017-04-10,111,,IND,0,240,35,75,0.467,22,42,0.524,13,33,0.394,28,31,0.903,111,49,85,0.576,44,69,0.638,5,16,0.313,17,21,0.81,120
775,DAL,2017-04-09,111,@,PHO,0,240,41,97,0.423,25,52,0.481,16,45,0.356,13,19,0.684,111,44,80,0.55,36,61,0.59,8,19,0.421,28,32,0.875,124
776,PHO,2017-04-05,111,,GSW,0,240,43,103,0.417,36,76,0.474,7,27,0.259,18,26,0.692,111,45,89,0.506,32,59,0.542,13,30,0.433,17,24,0.708,120
777,CHO,2017-04-04,111,@,WAS,0,240,40,79,0.506,28,45,0.622,12,34,0.353,19,22,0.864,111,43,85,0.506,26,51,0.51,17,34,0.5,15,18,0.833,118
778,ORL,2017-04-01,111,@,BRK,0,240,45,91,0.495,35,66,0.53,10,25,0.4,11,15,0.733,111,50,94,0.532,42,63,0.667,8,31,0.258,13,16,0.813,121
779,TOR,2017-03-31,111,,IND,1,240,37,82,0.451,23,55,0.418,14,27,0.519,23,35,0.657,111,36,87,0.414,25,61,0.41,11,26,0.423,17,21,0.81,100
780,GSW,2017-03-20,111,@,OKC,1,240,40,83,0.482,25,50,0.5,15,33,0.455,16,21,0.762,111,37,87,0.425,33,66,0.5,4,21,0.19,17,31,0.548,95
781,DAL,2017-03-19,111,@,BRK,1,240,41,76,0.539,31,51,0.608,10,25,0.4,19,25,0.76,111,31,72,0.431,18,41,0.439,13,31,0.419,29,38,0.763,104
782,LAL,2017-03-07,111,@,DAL,0,240,42,90,0.467,31,60,0.517,11,30,0.367,16,22,0.727,111,45,83,0.542,28,52,0.538,17,31,0.548,15,19,0.789,122
783,ATL,2017-03-06,111,,GSW,0,240,38,82,0.463,25,54,0.463,13,28,0.464,22,31,0.71,111,41,87,0.471,21,43,0.488,20,44,0.455,17,22,0.773,119
784,OKC,2017-03-03,111,@,PHO,0,240,37,87,0.425,28,52,0.538,9,35,0.257,28,35,0.8,111,44,89,0.494,39,68,0.574,5,21,0.238,25,31,0.806,118
785,WAS,2017-02-16,111,@,IND,1,240,43,83,0.518,28,54,0.519,15,29,0.517,10,15,0.667,111,40,80,0.5,36,62,0.581,4,18,0.222,14,18,0.778,98
786,UTA,2017-02-15,111,,POR,1,240,42,81,0.519,31,59,0.525,11,22,0.5,16,23,0.696,111,32,79,0.405,23,57,0.404,9,22,0.409,15,20,0.75,88
787,BOS,2017-02-13,111,@,DAL,1,240,40,81,0.494,24,47,0.511,16,34,0.471,15,18,0.833,111,35,77,0.455,26,50,0.52,9,27,0.333,19,25,0.76,98
788,ORL,2017-02-09,111,,PHI,0,240,41,84,0.488,31,63,0.492,10,21,0.476,19,24,0.792,111,40,95,0.421,29,67,0.433,11,28,0.393,21,27,0.778,112
789,POR,2017-02-09,111,,BOS,0,240,39,77,0.506,30,51,0.588,9,26,0.346,24,31,0.774,111,44,91,0.484,34,61,0.557,10,30,0.333,22,27,0.815,120
790,SAS,2017-02-08,111,@,PHI,1,240,39,74,0.527,28,52,0.538,11,22,0.5,22,25,0.88,111,34,84,0.405,21,50,0.42,13,34,0.382,22,29,0.759,103
791,CHO,2017-02-07,111,,BRK,1,240,40,102,0.392,33,76,0.434,7,26,0.269,24,29,0.828,111,39,86,0.453,27,50,0.54,12,36,0.333,17,21,0.81,107
792,NOP,2017-02-06,111,,PHO,1,240,42,92,0.457,33,66,0.5,9,26,0.346,18,22,0.818,111,40,93,0.43,35,66,0.53,5,27,0.185,21,25,0.84,106
793,CLE,2017-02-04,111,@,NYK,1,240,41,84,0.488,25,44,0.568,16,40,0.4,13,18,0.722,111,39,86,0.453,27,55,0.491,12,31,0.387,14,28,0.5,104
794,CHO,2017-02-01,111,@,GSW,0,240,39,88,0.443,30,57,0.526,9,31,0.29,24,26,0.923,111,47,96,0.49,26,48,0.542,21,48,0.438,11,14,0.786,126
795,MIN,2017-01-30,111,,ORL,1,265,40,91,0.44,28,62,0.452,12,29,0.414,19,26,0.731,111,41,96,0.427,31,61,0.508,10,35,0.286,13,19,0.684,105
796,POR,2017-01-29,111,,GSW,0,240,46,93,0.495,36,66,0.545,10,27,0.37,9,12,0.75,111,36,79,0.456,28,53,0.528,8,26,0.308,33,39,0.846,113
797,SAC,2017-01-27,111,@,IND,0,265,35,70,0.5,22,45,0.489,13,25,0.52,28,36,0.778,111,38,78,0.487,28,50,0.56,10,28,0.357,29,33,0.879,115
798,PHO,2017-01-24,111,,MIN,0,240,38,86,0.442,31,67,0.463,7,19,0.368,28,32,0.875,111,44,84,0.524,38,67,0.567,6,17,0.353,18,24,0.75,112
799,MIN,2017-01-22,111,,DEN,1,240,45,85,0.529,39,70,0.557,6,15,0.4,15,21,0.714,111,42,82,0.512,35,58,0.603,7,24,0.292,17,21,0.81,108
800,HOU,2017-01-18,111,,MIL,1,240,43,95,0.453,29,51,0.569,14,44,0.318,11,15,0.733,111,37,93,0.398,30,65,0.462,7,28,0.25,11,14,0.786,92
801,ATL,2017-01-15,111,,MIL,1,240,42,80,0.525,29,54,0.537,13,26,0.5,14,18,0.778,111,39,79,0.494,33,60,0.55,6,19,0.316,14,18,0.778,98
802,LAL,2017-01-08,111,,ORL,1,240,42,87,0.483,34,55,0.618,8,32,0.25,19,24,0.792,111,34,90,0.378,27,64,0.422,7,26,0.269,20,29,0.69,95
803,MIL,2017-01-06,111,,NYK,0,240,39,78,0.5,27,56,0.482,12,22,0.545,21,28,0.75,111,41,83,0.494,28,60,0.467,13,23,0.565,21,27,0.778,116
804,ATL,2017-01-04,111,@,ORL,1,240,44,81,0.543,34,62,0.548,10,19,0.526,13,18,0.722,111,37,86,0.43,28,58,0.483,9,28,0.321,9,10,0.9,92
805,CHO,2017-01-02,111,@,CHI,0,240,41,83,0.494,32,64,0.5,9,19,0.474,20,22,0.909,111,42,90,0.467,35,67,0.522,7,23,0.304,27,29,0.931,118
806,IND,2016-12-30,111,,CHI,1,240,39,81,0.481,32,62,0.516,7,19,0.368,26,30,0.867,111,35,84,0.417,29,61,0.475,6,23,0.261,25,31,0.806,101
807,TOR,2016-12-28,111,@,GSW,0,240,40,103,0.388,27,68,0.397,13,35,0.371,18,22,0.818,111,46,81,0.568,32,58,0.552,14,23,0.609,15,18,0.833,121
808,WAS,2016-12-28,111,,IND,1,240,38,78,0.487,30,56,0.536,8,22,0.364,27,37,0.73,111,35,79,0.443,24,51,0.471,11,28,0.393,24,29,0.828,105
809,NOP,2016-12-26,111,,DAL,1,240,37,70,0.529,25,45,0.556,12,25,0.48,25,30,0.833,111,37,75,0.493,24,43,0.558,13,32,0.406,17,22,0.773,104
810,LAL,2016-12-25,111,,LAC,1,240,40,84,0.476,32,59,0.542,8,25,0.32,23,30,0.767,111,37,85,0.435,27,56,0.482,10,29,0.345,18,22,0.818,102
811,PHO,2016-12-21,111,,HOU,0,240,44,93,0.473,35,68,0.515,9,25,0.36,14,20,0.7,111,46,86,0.535,28,48,0.583,18,38,0.474,15,26,0.577,125
812,IND,2016-12-20,111,@,NYK,0,240,39,91,0.429,33,68,0.485,6,23,0.261,27,33,0.818,111,44,88,0.5,31,65,0.477,13,23,0.565,17,21,0.81,118
813,HOU,2016-12-17,111,@,MIN,1,265,39,96,0.406,22,45,0.489,17,51,0.333,16,20,0.8,111,41,92,0.446,34,71,0.479,7,21,0.333,20,27,0.741,109
814,BRK,2016-12-16,111,@,ORL,0,240,39,83,0.47,28,56,0.5,11,27,0.407,22,26,0.846,111,39,97,0.402,32,68,0.471,7,29,0.241,33,42,0.786,118
815,NYK,2016-12-13,111,@,PHO,0,265,38,97,0.392,31,77,0.403,7,20,0.35,28,38,0.737,111,38,93,0.409,29,63,0.46,9,30,0.3,28,33,0.848,113
816,POR,2016-12-10,111,@,IND,0,240,40,82,0.488,24,45,0.533,16,37,0.432,15,16,0.938,111,40,83,0.482,25,54,0.463,15,29,0.517,23,28,0.821,118
817,DAL,2016-12-09,111,,IND,1,240,39,80,0.488,24,48,0.5,15,32,0.469,18,24,0.75,111,32,69,0.464,18,44,0.409,14,25,0.56,25,26,0.962,103
818,DEN,2016-12-07,111,@,BRK,0,240,42,105,0.4,31,68,0.456,11,37,0.297,16,21,0.762,111,41,85,0.482,32,59,0.542,9,26,0.346,25,31,0.806,116
819,IND,2016-12-04,111,@,LAC,1,240,39,79,0.494,34,65,0.523,5,14,0.357,28,35,0.8,111,36,81,0.444,26,51,0.51,10,30,0.333,20,28,0.714,102
820,CHI,2016-12-02,111,,CLE,1,240,47,96,0.49,44,78,0.564,3,18,0.167,14,17,0.824,111,45,83,0.542,35,57,0.614,10,26,0.385,5,10,0.5,105
821,MIL,2016-12-01,111,@,BRK,1,240,36,80,0.45,21,46,0.457,15,34,0.441,24,29,0.828,111,34,89,0.382,22,49,0.449,12,40,0.3,13,16,0.813,93
822,MIA,2016-12-01,111,@,UTA,1,240,44,86,0.512,36,67,0.537,8,19,0.421,15,19,0.789,111,40,73,0.548,23,43,0.535,17,30,0.567,13,17,0.765,110
823,CHO,2016-11-25,111,@,NYK,0,265,43,93,0.462,35,64,0.547,8,29,0.276,17,27,0.63,111,45,97,0.464,34,69,0.493,11,28,0.393,12,13,0.923,113
824,BOS,2016-11-23,111,@,BRK,1,240,45,98,0.459,30,60,0.5,15,38,0.395,6,8,0.75,111,34,86,0.395,24,55,0.436,10,31,0.323,14,22,0.636,92
825,LAL,2016-11-22,111,,OKC,1,240,42,83,0.506,28,56,0.5,14,27,0.519,13,16,0.813,111,45,92,0.489,34,65,0.523,11,27,0.407,8,11,0.727,109
826,OKC,2016-11-20,111,,IND,0,265,44,101,0.436,34,65,0.523,10,36,0.278,13,18,0.722,111,40,89,0.449,29,67,0.433,11,22,0.5,24,31,0.774,115
827,HOU,2016-11-19,111,,UTA,1,240,42,94,0.447,30,62,0.484,12,32,0.375,15,20,0.75,111,39,76,0.513,27,49,0.551,12,27,0.444,12,17,0.706,102
828,WAS,2016-11-19,111,,MIA,0,240,42,89,0.472,31,62,0.5,11,27,0.407,16,22,0.727,111,43,85,0.506,30,58,0.517,13,27,0.481,15,26,0.577,114
829,DEN,2016-11-18,111,,TOR,0,265,39,83,0.47,35,58,0.603,4,25,0.16,29,39,0.744,111,43,94,0.457,35,71,0.493,8,23,0.348,19,31,0.613,113
830,MEM,2016-11-16,111,@,LAC,1,240,40,82,0.488,25,56,0.446,15,26,0.577,16,19,0.842,111,37,81,0.457,28,56,0.5,9,25,0.36,24,34,0.706,107
831,CHO,2016-11-11,111,,TOR,0,240,38,93,0.409,21,52,0.404,17,41,0.415,18,24,0.75,111,43,90,0.478,37,68,0.544,6,22,0.273,21,22,0.955,113
832,LAC,2016-11-09,111,,POR,1,240,38,87,0.437,27,55,0.491,11,32,0.344,24,33,0.727,111,31,88,0.352,25,58,0.431,6,30,0.2,12,14,0.857,80
833,IND,2016-11-05,111,,CHI,1,240,46,86,0.535,34,60,0.567,12,26,0.462,7,12,0.583,111,34,79,0.43,28,61,0.459,6,18,0.333,20,25,0.8,94
834,NOP,2016-11-04,111,,PHO,0,265,43,94,0.457,33,64,0.516,10,30,0.333,15,28,0.536,111,40,93,0.43,32,69,0.464,8,24,0.333,24,28,0.857,112
835,NYK,2016-10-29,111,,MEM,1,240,40,76,0.526,34,55,0.618,6,21,0.286,25,39,0.641,111,37,86,0.43,28,61,0.459,9,25,0.36,21,26,0.808,104
836,MIA,2017-04-12,110,,WAS,1,240,46,88,0.523,38,64,0.594,8,24,0.333,10,12,0.833,110,42,87,0.483,35,61,0.574,7,26,0.269,11,14,0.786,102
837,TOR,2017-04-09,110,@,NYK,1,240,40,77,0.519,30,46,0.652,10,31,0.323,20,23,0.87,110,37,82,0.451,28,54,0.519,9,28,0.321,14,15,0.933,97
838,LAL,2017-04-09,110,,MIN,1,240,42,86,0.488,32,59,0.542,10,27,0.37,16,20,0.8,110,40,80,0.5,37,65,0.569,3,15,0.2,26,31,0.839,109
839,HOU,2017-04-05,110,,DEN,1,240,37,87,0.425,27,53,0.509,10,34,0.294,26,38,0.684,110,41,104,0.394,34,66,0.515,7,38,0.184,15,18,0.833,104
840,OKC,2017-04-04,110,,MIL,1,240,40,84,0.476,31,56,0.554,9,28,0.321,21,25,0.84,110,29,81,0.358,26,63,0.413,3,18,0.167,18,26,0.692,79
841,MIN,2017-04-03,110,,POR,1,240,41,84,0.488,37,75,0.493,4,9,0.444,24,28,0.857,110,38,86,0.442,27,54,0.5,11,32,0.344,22,25,0.88,109
842,BOS,2017-04-02,110,@,NYK,1,240,40,72,0.556,28,35,0.8,12,37,0.324,18,26,0.692,110,33,85,0.388,26,60,0.433,7,25,0.28,21,25,0.84,94
843,NOP,2017-04-02,110,,CHI,0,240,33,81,0.407,23,51,0.451,10,30,0.333,34,35,0.971,110,45,92,0.489,32,66,0.485,13,26,0.5,14,18,0.778,117
844,GSW,2017-03-29,110,@,SAS,1,240,43,85,0.506,30,59,0.508,13,26,0.5,11,11,1.0,110,34,83,0.41,25,59,0.424,9,24,0.375,21,26,0.808,98
845,CHO,2017-03-29,110,@,TOR,1,240,39,86,0.453,23,54,0.426,16,32,0.5,16,21,0.762,110,38,83,0.458,27,52,0.519,11,31,0.355,19,24,0.792,106
846,MEM,2017-03-29,110,,IND,1,240,41,88,0.466,29,56,0.518,12,32,0.375,16,18,0.889,110,37,85,0.435,27,60,0.45,10,25,0.4,13,15,0.867,97
847,POR,2017-03-23,110,,NYK,1,240,39,80,0.488,28,59,0.475,11,21,0.524,21,29,0.724,110,36,88,0.409,31,66,0.47,5,22,0.227,18,20,0.9,95
848,BOS,2017-03-20,110,,WAS,1,240,40,93,0.43,30,60,0.5,10,33,0.303,20,28,0.714,110,37,86,0.43,29,51,0.569,8,35,0.229,20,26,0.769,102
849,OKC,2017-03-18,110,,SAC,1,240,41,82,0.5,31,56,0.554,10,26,0.385,18,25,0.72,110,35,85,0.412,30,64,0.469,5,21,0.238,19,23,0.826,94
850,NYK,2017-03-16,110,,BRK,0,240,41,88,0.466,38,70,0.543,3,18,0.167,25,26,0.962,110,41,86,0.477,31,54,0.574,10,32,0.313,29,35,0.829,121
851,POR,2017-03-15,110,@,SAS,1,240,38,80,0.475,29,58,0.5,9,22,0.409,25,28,0.893,110,42,88,0.477,31,62,0.5,11,26,0.423,11,15,0.733,106
852,POR,2017-03-12,110,@,PHO,1,240,43,86,0.5,36,64,0.563,7,22,0.318,17,25,0.68,110,41,93,0.441,36,79,0.456,5,14,0.357,14,20,0.7,101
853,PHO,2017-03-09,110,,LAL,0,240,42,91,0.462,36,72,0.5,6,19,0.316,20,25,0.8,110,47,98,0.48,35,71,0.493,12,27,0.444,16,24,0.667,122
854,ATL,2017-03-08,110,,BRK,1,240,41,95,0.432,37,75,0.493,4,20,0.2,24,32,0.75,110,37,80,0.463,26,47,0.553,11,33,0.333,20,25,0.8,105
855,HOU,2017-03-06,110,@,SAS,0,240,41,88,0.466,27,49,0.551,14,39,0.359,14,17,0.824,110,40,88,0.455,29,60,0.483,11,28,0.393,21,23,0.913,112
856,UTA,2017-03-05,110,@,SAC,1,265,41,90,0.456,31,57,0.544,10,33,0.303,18,27,0.667,110,43,83,0.518,35,66,0.53,8,17,0.471,15,20,0.75,109
857,ORL,2017-03-03,110,,MIA,1,240,45,90,0.5,40,73,0.548,5,17,0.294,15,19,0.789,110,35,91,0.385,27,63,0.429,8,28,0.286,21,25,0.84,99
858,DEN,2017-03-01,110,@,MIL,1,240,41,84,0.488,31,51,0.608,10,33,0.303,18,20,0.9,110,38,83,0.458,29,65,0.446,9,18,0.5,13,15,0.867,98
859,NOP,2017-02-26,110,@,OKC,0,240,36,80,0.45,28,59,0.475,8,21,0.381,30,37,0.811,110,42,88,0.477,36,67,0.537,6,21,0.286,28,37,0.757,118
860,NYK,2017-02-25,110,,PHI,1,240,43,91,0.473,37,70,0.529,6,21,0.286,18,23,0.783,110,40,95,0.421,33,64,0.516,7,31,0.226,22,27,0.815,109
861,OKC,2017-02-24,110,,LAL,1,240,44,97,0.454,34,73,0.466,10,24,0.417,12,17,0.706,110,40,101,0.396,33,66,0.5,7,35,0.2,6,14,0.429,93
862,NOP,2017-02-13,110,@,PHO,1,240,37,78,0.474,29,50,0.58,8,28,0.286,28,35,0.8,110,40,93,0.43,32,70,0.457,8,23,0.348,20,24,0.833,108
863,GSW,2017-02-13,110,@,DEN,0,240,45,92,0.489,37,60,0.617,8,32,0.25,12,13,0.923,110,48,88,0.545,24,47,0.511,24,41,0.585,12,16,0.75,132
864,SAS,2017-02-13,110,@,IND,1,240,40,87,0.46,33,72,0.458,7,15,0.467,23,27,0.852,110,38,78,0.487,29,58,0.5,9,20,0.45,21,30,0.7,106
865,BRK,2017-02-08,110,,WAS,0,265,38,91,0.418,29,58,0.5,9,33,0.273,25,36,0.694,110,40,97,0.412,31,72,0.431,9,25,0.36,25,33,0.758,114
866,MEM,2017-02-08,110,,PHO,1,240,35,72,0.486,21,48,0.438,14,24,0.583,26,34,0.765,110,29,87,0.333,24,64,0.375,5,23,0.217,28,34,0.824,91
867,DEN,2017-02-06,110,,DAL,1,240,42,84,0.5,31,56,0.554,11,28,0.393,15,16,0.938,110,34,79,0.43,26,53,0.491,8,26,0.308,11,17,0.647,87
868,NYK,2017-01-27,110,,CHO,1,240,46,96,0.479,37,69,0.536,9,27,0.333,9,13,0.692,110,40,90,0.444,27,53,0.509,13,37,0.351,14,15,0.933,107
869,LAC,2017-01-24,110,@,PHI,0,240,33,71,0.465,15,37,0.405,18,34,0.529,26,41,0.634,110,45,90,0.5,35,61,0.574,10,29,0.345,21,22,0.955,121
870,ATL,2017-01-21,110,,PHI,1,240,45,91,0.495,38,71,0.535,7,20,0.35,13,23,0.565,110,33,78,0.423,21,49,0.429,12,29,0.414,15,18,0.833,93
871,NYK,2017-01-19,110,,WAS,0,240,42,90,0.467,35,66,0.53,7,24,0.292,19,22,0.864,110,44,88,0.5,31,56,0.554,13,32,0.406,12,14,0.857,113
872,UTA,2017-01-13,110,,DET,1,240,43,80,0.538,27,49,0.551,16,31,0.516,8,13,0.615,110,30,76,0.395,24,59,0.407,6,17,0.353,11,16,0.688,77
873,MEM,2017-01-13,110,@,HOU,1,240,41,76,0.539,31,49,0.633,10,27,0.37,18,27,0.667,110,33,82,0.402,23,41,0.561,10,41,0.244,29,36,0.806,105
874,NOP,2017-01-09,110,@,NYK,1,240,41,84,0.488,29,57,0.509,12,27,0.444,16,19,0.842,110,36,85,0.424,25,56,0.446,11,29,0.379,13,16,0.813,96
875,BOS,2017-01-06,110,,PHI,1,240,35,87,0.402,16,47,0.34,19,40,0.475,21,25,0.84,110,37,79,0.468,28,51,0.549,9,28,0.321,23,26,0.885,106
876,SAS,2017-01-03,110,,TOR,1,240,43,78,0.551,30,54,0.556,13,24,0.542,11,15,0.733,110,31,83,0.373,27,65,0.415,4,18,0.222,16,22,0.727,82
877,SAS,2016-12-30,110,,POR,1,240,39,78,0.5,28,56,0.5,11,22,0.5,21,25,0.84,110,35,77,0.455,29,57,0.509,6,20,0.3,18,21,0.857,94
878,SAS,2016-12-23,110,@,POR,1,240,39,78,0.5,27,58,0.466,12,20,0.6,20,21,0.952,110,35,79,0.443,23,49,0.469,12,30,0.4,8,16,0.5,90
879,NOP,2016-12-21,110,,OKC,0,240,42,88,0.477,34,68,0.5,8,20,0.4,18,23,0.783,110,45,88,0.511,34,60,0.567,11,28,0.393,20,24,0.833,121
880,ATL,2016-12-19,110,@,OKC,1,240,41,75,0.547,32,52,0.615,9,23,0.391,19,24,0.792,110,39,87,0.448,29,52,0.558,10,35,0.286,20,26,0.769,108
881,LAC,2016-12-18,110,@,WAS,0,240,43,87,0.494,36,63,0.571,7,24,0.292,17,24,0.708,110,43,81,0.531,33,62,0.532,10,19,0.526,21,30,0.7,117
882,IND,2016-12-12,110,,CHO,1,240,43,88,0.489,26,52,0.5,17,36,0.472,7,10,0.7,110,28,84,0.333,18,58,0.31,10,26,0.385,28,32,0.875,94
883,MEM,2016-12-10,110,,GSW,1,240,38,87,0.437,30,61,0.492,8,26,0.308,26,29,0.897,110,34,77,0.442,25,50,0.5,9,27,0.333,12,20,0.6,89
884,WAS,2016-12-10,110,,MIL,1,240,40,88,0.455,32,67,0.478,8,21,0.381,22,28,0.786,110,40,79,0.506,27,54,0.5,13,25,0.52,12,15,0.8,105
885,MIL,2016-12-09,110,,ATL,0,240,44,94,0.468,32,66,0.485,12,28,0.429,10,14,0.714,110,40,84,0.476,28,50,0.56,12,34,0.353,22,29,0.759,114
886,MIN,2016-12-08,110,@,TOR,0,240,45,88,0.511,36,60,0.6,9,28,0.321,11,15,0.733,110,43,87,0.494,31,60,0.517,12,27,0.444,26,33,0.788,124
887,MEM,2016-12-05,110,@,NOP,1,290,42,104,0.404,29,70,0.414,13,34,0.382,13,21,0.619,110,39,99,0.394,29,67,0.433,10,32,0.313,20,21,0.952,108
888,CHI,2016-12-05,110,,POR,0,240,35,83,0.422,28,60,0.467,7,23,0.304,33,38,0.868,110,45,93,0.484,36,69,0.522,9,24,0.375,13,18,0.722,112
889,DEN,2016-12-02,110,,HOU,0,240,46,104,0.442,37,73,0.507,9,31,0.29,9,16,0.563,110,45,88,0.511,28,51,0.549,17,37,0.459,21,25,0.84,128
890,UTA,2016-12-01,110,,MIA,0,240,40,73,0.548,23,43,0.535,17,30,0.567,13,17,0.765,110,44,86,0.512,36,67,0.537,8,19,0.421,15,19,0.789,111
891,MEM,2016-11-26,110,@,MIA,1,240,37,73,0.507,28,48,0.583,9,25,0.36,27,33,0.818,110,40,81,0.494,29,50,0.58,11,31,0.355,16,24,0.667,107
892,DEN,2016-11-22,110,,CHI,1,240,43,100,0.43,33,78,0.423,10,22,0.455,14,17,0.824,110,43,95,0.453,37,77,0.481,6,18,0.333,15,18,0.833,107
893,LAL,2016-11-20,110,,CHI,0,240,41,93,0.441,28,62,0.452,13,31,0.419,15,21,0.714,110,45,87,0.517,37,65,0.569,8,22,0.364,20,28,0.714,118
894,MIN,2016-11-17,110,,PHI,1,240,43,84,0.512,37,59,0.627,6,25,0.24,18,20,0.9,110,31,83,0.373,22,51,0.431,9,32,0.281,15,19,0.789,86
895,SAS,2016-11-16,110,@,SAC,1,240,43,88,0.489,32,58,0.552,11,30,0.367,13,17,0.765,110,36,76,0.474,27,56,0.482,9,20,0.45,24,31,0.774,105
896,LAC,2016-11-11,110,@,OKC,1,240,39,86,0.453,28,59,0.475,11,27,0.407,21,35,0.6,110,38,88,0.432,22,60,0.367,16,28,0.571,16,19,0.842,108
897,NYK,2016-11-09,110,,BRK,1,240,44,92,0.478,34,62,0.548,10,30,0.333,12,17,0.706,110,33,79,0.418,22,46,0.478,11,33,0.333,19,27,0.704,96
898,MIN,2016-11-08,110,@,BRK,0,240,39,92,0.424,27,64,0.422,12,28,0.429,20,28,0.714,110,42,76,0.553,30,43,0.698,12,33,0.364,23,26,0.885,119
899,ATL,2016-11-08,110,@,CLE,1,240,41,81,0.506,30,52,0.577,11,29,0.379,17,24,0.708,110,37,99,0.374,26,57,0.456,11,42,0.262,21,25,0.84,106
900,MIL,2016-10-29,110,,BRK,1,240,41,88,0.466,33,66,0.5,8,22,0.364,20,24,0.833,110,37,84,0.44,26,50,0.52,11,34,0.324,23,28,0.821,108
901,PHO,2016-10-28,110,@,OKC,0,265,42,94,0.447,37,66,0.561,5,28,0.179,21,32,0.656,110,40,96,0.417,35,75,0.467,5,21,0.238,28,38,0.737,113
902,DET,2017-04-12,109,@,ORL,0,240,41,106,0.387,30,70,0.429,11,36,0.306,16,28,0.571,109,42,87,0.483,29,62,0.468,13,25,0.52,16,17,0.941,113
903,GSW,2017-04-12,109,,LAL,1,240,41,90,0.456,29,54,0.537,12,36,0.333,15,22,0.682,109,41,93,0.441,37,76,0.487,4,17,0.235,8,14,0.571,94
904,DEN,2017-04-11,109,@,DAL,1,240,41,84,0.488,23,42,0.548,18,42,0.429,9,14,0.643,109,35,88,0.398,23,48,0.479,12,40,0.3,9,11,0.818,91
905,MIN,2017-04-09,109,@,LAL,0,240,40,80,0.5,37,65,0.569,3,15,0.2,26,31,0.839,109,42,86,0.488,32,59,0.542,10,27,0.37,16,20,0.8,110
906,HOU,2017-04-07,109,,DET,0,240,36,87,0.414,20,36,0.556,16,51,0.314,21,28,0.75,109,46,108,0.426,37,82,0.451,9,26,0.346,13,16,0.813,114
907,POR,2017-04-03,109,@,MIN,0,240,38,86,0.442,27,54,0.5,11,32,0.344,22,25,0.88,109,41,84,0.488,37,75,0.493,4,9,0.444,24,28,0.857,110
908,DAL,2017-04-02,109,@,MIL,1,240,38,73,0.521,24,37,0.649,14,36,0.389,19,20,0.95,109,39,77,0.506,27,43,0.628,12,34,0.353,15,18,0.833,105
909,SAS,2017-04-02,109,,UTA,1,240,40,77,0.519,30,58,0.517,10,19,0.526,19,22,0.864,109,43,89,0.483,34,65,0.523,9,24,0.375,8,13,0.615,103
910,NYK,2017-03-27,109,,DET,1,240,45,84,0.536,38,63,0.603,7,21,0.333,12,13,0.923,109,36,84,0.429,27,61,0.443,9,23,0.391,14,21,0.667,95
911,CHI,2017-03-26,109,@,MIL,1,240,46,85,0.541,36,64,0.563,10,21,0.476,7,10,0.7,109,37,84,0.44,30,61,0.492,7,23,0.304,13,17,0.765,94
912,CHO,2017-03-22,109,@,ORL,1,240,42,90,0.467,33,63,0.524,9,27,0.333,16,18,0.889,109,40,88,0.455,26,48,0.542,14,40,0.35,8,10,0.8,102
913,BOS,2017-03-22,109,,IND,1,240,43,84,0.512,32,57,0.561,11,27,0.407,12,14,0.857,109,38,87,0.437,27,59,0.458,11,28,0.393,13,19,0.684,100
914,LAL,2017-03-21,109,,LAC,0,240,43,92,0.467,37,72,0.514,6,20,0.3,17,27,0.63,109,45,84,0.536,30,51,0.588,15,33,0.455,28,32,0.875,133
915,PHI,2017-03-20,109,@,ORL,0,265,39,102,0.382,30,68,0.441,9,34,0.265,22,24,0.917,109,35,94,0.372,31,71,0.437,4,23,0.174,38,46,0.826,112
916,MIN,2017-03-19,109,@,NOP,0,240,44,86,0.512,35,61,0.574,9,25,0.36,12,17,0.706,109,49,90,0.544,35,60,0.583,14,30,0.467,11,15,0.733,123
917,HOU,2017-03-18,109,@,DEN,1,240,38,83,0.458,33,59,0.559,5,24,0.208,28,35,0.8,109,38,89,0.427,28,58,0.483,10,31,0.323,19,30,0.633,105
918,ORL,2017-03-17,109,@,PHO,1,240,42,96,0.438,35,73,0.479,7,23,0.304,18,21,0.857,109,38,87,0.437,36,73,0.493,2,14,0.143,25,30,0.833,103
919,CHO,2017-03-13,109,,CHI,0,240,43,93,0.462,36,64,0.563,7,29,0.241,16,19,0.842,109,41,92,0.446,27,52,0.519,14,40,0.35,19,22,0.864,115
920,DET,2017-03-06,109,,CHI,1,240,45,92,0.489,39,71,0.549,6,21,0.286,13,20,0.65,109,34,83,0.41,26,55,0.473,8,28,0.286,19,21,0.905,95
921,MEM,2017-03-06,109,,BRK,0,240,34,77,0.442,24,52,0.462,10,25,0.4,31,39,0.795,109,39,73,0.534,25,43,0.581,14,30,0.467,30,38,0.789,122
922,PHO,2017-03-05,109,,BOS,1,240,42,94,0.447,38,74,0.514,4,20,0.2,21,26,0.808,109,32,85,0.376,19,48,0.396,13,37,0.351,29,40,0.725,106
923,SAC,2017-03-05,109,,UTA,0,265,43,83,0.518,35,66,0.53,8,17,0.471,15,20,0.75,109,41,90,0.456,31,57,0.544,10,33,0.303,18,27,0.667,110
924,OKC,2017-03-02,109,@,POR,0,240,34,86,0.395,23,57,0.404,11,29,0.379,30,32,0.938,109,39,79,0.494,29,54,0.537,10,25,0.4,26,35,0.743,114
925,BRK,2017-03-01,109,@,SAC,1,240,34,74,0.459,23,46,0.5,11,28,0.393,30,36,0.833,109,35,81,0.432,24,59,0.407,11,22,0.5,19,22,0.864,100
926,NOP,2017-03-01,109,,DET,1,240,39,78,0.5,30,53,0.566,9,25,0.36,22,23,0.957,109,40,103,0.388,37,80,0.463,3,23,0.13,3,17,0.176,86
927,CHO,2017-02-28,109,@,LAL,1,240,38,85,0.447,22,46,0.478,16,39,0.41,17,24,0.708,109,41,84,0.488,29,52,0.558,12,32,0.375,10,13,0.769,104
928,OKC,2017-02-28,109,,UTA,1,240,39,76,0.513,24,54,0.444,15,22,0.682,16,23,0.696,109,43,93,0.462,34,71,0.479,9,22,0.409,11,13,0.846,106
929,PHI,2017-02-25,109,@,NYK,0,240,40,95,0.421,33,64,0.516,7,31,0.226,22,27,0.815,109,43,91,0.473,37,70,0.529,6,21,0.286,18,23,0.783,110
930,BRK,2017-02-24,109,@,DEN,0,240,41,83,0.494,31,53,0.585,10,30,0.333,17,31,0.548,109,49,97,0.505,35,66,0.53,14,31,0.452,17,24,0.708,129
931,UTA,2017-02-24,109,@,MIL,1,240,37,74,0.5,29,51,0.569,8,23,0.348,27,30,0.9,109,32,74,0.432,25,56,0.446,7,18,0.389,24,29,0.828,95
932,GSW,2017-02-15,109,,SAC,1,240,41,84,0.488,28,48,0.583,13,36,0.361,14,21,0.667,109,33,89,0.371,26,65,0.4,7,24,0.292,13,17,0.765,86
933,HOU,2017-02-15,109,,MIA,0,240,36,87,0.414,23,47,0.489,13,40,0.325,24,31,0.774,109,44,84,0.524,31,49,0.633,13,35,0.371,16,24,0.667,117
934,ATL,2017-02-13,109,@,POR,1,265,32,83,0.386,24,55,0.436,8,28,0.286,37,48,0.771,109,37,103,0.359,21,61,0.344,16,42,0.381,14,25,0.56,104
935,DEN,2017-02-11,109,@,CLE,0,240,39,97,0.402,27,60,0.45,12,37,0.324,19,22,0.864,109,46,84,0.548,31,54,0.574,15,30,0.5,18,22,0.818,125
936,MIA,2017-02-11,109,@,PHI,0,240,39,85,0.459,32,61,0.525,7,24,0.292,24,28,0.857,109,39,86,0.453,30,61,0.492,9,25,0.36,30,38,0.789,117
937,CLE,2017-02-09,109,@,OKC,0,240,38,79,0.481,28,58,0.483,10,21,0.476,23,30,0.767,109,50,106,0.472,42,79,0.532,8,27,0.296,10,13,0.769,118
938,TOR,2017-02-08,109,@,MIN,0,240,42,79,0.532,31,51,0.608,11,28,0.393,14,20,0.7,109,39,80,0.488,32,61,0.525,7,19,0.368,27,30,0.9,112
939,LAC,2017-02-06,109,@,TOR,0,240,42,90,0.467,29,55,0.527,13,35,0.371,12,18,0.667,109,41,84,0.488,31,60,0.517,10,24,0.417,26,29,0.897,118
940,SAC,2017-02-04,109,,GSW,1,265,43,88,0.489,36,65,0.554,7,23,0.304,16,19,0.842,109,36,87,0.414,21,43,0.488,15,44,0.341,19,24,0.792,106
941,BOS,2017-02-01,109,,TOR,1,240,36,87,0.414,24,51,0.471,12,36,0.333,25,30,0.833,109,41,78,0.526,33,47,0.702,8,31,0.258,14,25,0.56,104
942,DET,2017-01-30,109,@,BOS,0,240,43,97,0.443,40,70,0.571,3,27,0.111,20,29,0.69,109,36,82,0.439,23,50,0.46,13,32,0.406,28,33,0.848,113
943,BRK,2017-01-28,109,@,MIN,0,240,41,85,0.482,34,64,0.531,7,21,0.333,20,25,0.8,109,47,93,0.505,38,73,0.521,9,20,0.45,26,32,0.813,129
944,SAC,2017-01-28,109,@,CHO,1,240,41,79,0.519,30,52,0.577,11,27,0.407,16,26,0.615,109,36,75,0.48,24,38,0.632,12,37,0.324,22,24,0.917,106
945,MEM,2017-01-27,109,@,POR,0,240,37,77,0.481,28,51,0.549,9,26,0.346,26,33,0.788,109,38,81,0.469,22,46,0.478,16,35,0.457,20,21,0.952,112
946,OKC,2017-01-26,109,,DAL,1,240,37,72,0.514,28,50,0.56,9,22,0.409,26,36,0.722,109,38,84,0.452,27,58,0.466,11,26,0.423,11,13,0.846,98
947,IND,2017-01-26,109,@,MIN,1,240,42,81,0.519,32,63,0.508,10,18,0.556,15,17,0.882,109,36,81,0.444,26,54,0.481,10,27,0.37,21,27,0.778,103
948,HOU,2017-01-25,109,@,BOS,0,240,36,77,0.468,26,46,0.565,10,31,0.323,27,38,0.711,109,47,91,0.516,36,59,0.61,11,32,0.344,15,16,0.938,120
949,MIA,2017-01-25,109,@,BRK,1,240,40,83,0.482,29,60,0.483,11,23,0.478,18,25,0.72,109,35,80,0.438,22,45,0.489,13,35,0.371,23,26,0.885,106
950,MIL,2017-01-25,109,,PHI,0,240,42,91,0.462,35,63,0.556,7,28,0.25,18,23,0.783,109,40,75,0.533,28,49,0.571,12,26,0.462,22,25,0.88,114
951,SAC,2017-01-23,109,@,DET,1,240,40,82,0.488,31,61,0.508,9,21,0.429,20,26,0.769,109,41,82,0.5,31,54,0.574,10,28,0.357,12,17,0.706,104
952,WAS,2017-01-23,109,@,CHO,1,240,43,80,0.538,33,55,0.6,10,25,0.4,13,17,0.765,109,35,90,0.389,27,58,0.466,8,32,0.25,21,25,0.84,99
953,NYK,2017-01-23,109,@,IND,1,240,35,76,0.461,27,54,0.5,8,22,0.364,31,35,0.886,109,38,86,0.442,31,60,0.517,7,26,0.269,20,25,0.8,103
954,UTA,2017-01-21,109,,IND,1,240,39,84,0.464,33,60,0.55,6,24,0.25,25,32,0.781,109,39,77,0.506,29,57,0.509,10,20,0.5,12,17,0.706,100
955,MIA,2017-01-21,109,,MIL,1,240,41,77,0.532,28,47,0.596,13,30,0.433,14,22,0.636,109,33,79,0.418,27,61,0.443,6,18,0.333,25,32,0.781,97
956,BRK,2017-01-17,109,,TOR,0,240,40,89,0.449,33,63,0.524,7,26,0.269,22,24,0.917,109,48,92,0.522,38,73,0.521,10,19,0.526,13,16,0.813,119
957,MIA,2017-01-17,109,,HOU,1,240,42,90,0.467,33,61,0.541,9,29,0.31,16,24,0.667,109,36,90,0.4,27,51,0.529,9,39,0.231,22,28,0.786,103
958,WAS,2017-01-14,109,,PHI,1,240,44,91,0.484,36,74,0.486,8,17,0.471,13,18,0.722,109,36,87,0.414,26,56,0.464,10,31,0.323,11,21,0.524,93
959,POR,2017-01-13,109,,ORL,0,240,39,97,0.402,29,63,0.46,10,34,0.294,21,25,0.84,109,41,83,0.494,31,65,0.477,10,18,0.556,23,26,0.885,115
960,MIL,2017-01-10,109,@,SAS,1,240,44,84,0.524,34,65,0.523,10,19,0.526,11,13,0.846,109,42,88,0.477,30,58,0.517,12,30,0.4,11,14,0.786,107
961,OKC,2017-01-09,109,@,CHI,1,240,47,83,0.566,40,59,0.678,7,24,0.292,8,11,0.727,109,34,83,0.41,27,64,0.422,7,19,0.368,19,22,0.864,94
962,NYK,2017-01-07,109,@,IND,0,240,40,87,0.46,28,56,0.5,12,31,0.387,17,24,0.708,109,43,86,0.5,32,62,0.516,11,24,0.458,26,28,0.929,123
963,BRK,2017-01-05,109,@,IND,0,240,41,90,0.456,24,52,0.462,17,38,0.447,10,13,0.769,109,48,93,0.516,38,71,0.535,10,22,0.455,15,19,0.789,121
964,LAL,2017-01-05,109,@,POR,0,240,36,86,0.419,26,55,0.473,10,31,0.323,27,33,0.818,109,43,81,0.531,31,48,0.646,12,33,0.364,20,30,0.667,118
965,LAC,2017-01-02,109,,PHO,1,240,37,80,0.463,30,64,0.469,7,16,0.438,28,38,0.737,109,39,102,0.382,37,87,0.425,2,15,0.133,18,22,0.818,98
966,CHO,2016-12-31,109,,CLE,0,240,40,78,0.513,31,54,0.574,9,24,0.375,20,23,0.87,109,43,85,0.506,29,54,0.537,14,31,0.452,21,25,0.84,121
967,CLE,2016-12-25,109,,GSW,1,240,37,95,0.389,25,60,0.417,12,35,0.343,23,32,0.719,109,37,77,0.481,28,47,0.596,9,30,0.3,25,29,0.862,108
968,ATL,2016-12-23,109,@,DEN,1,240,37,86,0.43,29,61,0.475,8,25,0.32,27,33,0.818,109,37,78,0.474,29,53,0.547,8,25,0.32,26,35,0.743,108
969,SAC,2016-12-23,109,@,MIN,1,240,42,80,0.525,27,51,0.529,15,29,0.517,10,14,0.714,109,36,79,0.456,24,47,0.511,12,32,0.375,21,26,0.808,105
970,HOU,2016-12-23,109,@,MEM,0,240,38,89,0.427,18,37,0.486,20,52,0.385,13,15,0.867,109,41,81,0.506,28,56,0.5,13,25,0.52,20,25,0.8,115
971,ORL,2016-12-23,109,,LAL,1,240,45,89,0.506,34,62,0.548,11,27,0.407,8,14,0.571,109,31,87,0.356,23,64,0.359,8,23,0.348,20,24,0.833,90
972,BOS,2016-12-22,109,@,IND,1,240,38,92,0.413,28,53,0.528,10,39,0.256,23,27,0.852,109,35,82,0.427,28,59,0.475,7,23,0.304,25,29,0.862,102
973,MEM,2016-12-20,109,,BOS,0,265,38,94,0.404,26,64,0.406,12,30,0.4,21,26,0.808,109,33,81,0.407,21,44,0.477,12,37,0.324,34,38,0.895,112
974,TOR,2016-12-18,109,@,ORL,1,240,43,87,0.494,36,60,0.6,7,27,0.259,16,21,0.762,109,34,83,0.41,31,62,0.5,3,21,0.143,8,9,0.889,79
975,MIN,2016-12-17,109,,HOU,0,265,41,92,0.446,34,71,0.479,7,21,0.333,20,27,0.741,109,39,96,0.406,22,45,0.489,17,51,0.333,16,20,0.8,111
976,WAS,2016-12-14,109,,CHO,1,240,45,87,0.517,40,69,0.58,5,18,0.278,14,17,0.824,109,38,74,0.514,24,41,0.585,14,33,0.424,16,21,0.762,106
977,UTA,2016-12-14,109,,OKC,1,240,42,72,0.583,29,49,0.592,13,23,0.565,12,15,0.8,109,30,82,0.366,24,63,0.381,6,19,0.316,23,27,0.852,89
978,NOP,2016-12-13,109,,GSW,0,240,39,82,0.476,25,47,0.532,14,35,0.4,17,21,0.81,109,42,95,0.442,28,61,0.459,14,34,0.412,15,19,0.789,113
979,HOU,2016-12-10,109,,DAL,1,240,37,74,0.5,18,37,0.486,19,37,0.514,16,22,0.727,109,32,79,0.405,21,45,0.467,11,34,0.324,12,14,0.857,87
980,CHO,2016-12-09,109,,ORL,1,240,41,85,0.482,32,63,0.508,9,22,0.409,18,23,0.783,109,34,91,0.374,25,57,0.439,9,34,0.265,11,14,0.786,88
981,IND,2016-12-07,109,@,PHO,1,240,35,78,0.449,28,55,0.509,7,23,0.304,32,41,0.78,109,34,85,0.4,25,52,0.481,9,33,0.273,17,18,0.944,94
982,CHO,2016-12-05,109,@,DAL,1,240,40,79,0.506,37,61,0.607,3,18,0.167,26,28,0.929,109,37,89,0.416,24,53,0.453,13,36,0.361,14,18,0.778,101
983,PHO,2016-12-03,109,@,GSW,0,240,41,91,0.451,30,59,0.508,11,32,0.344,16,21,0.762,109,49,78,0.628,35,57,0.614,14,21,0.667,26,34,0.765,138
984,PHO,2016-11-30,109,,ATL,1,240,40,89,0.449,30,68,0.441,10,21,0.476,19,25,0.76,109,45,89,0.506,36,64,0.563,9,25,0.36,8,10,0.8,107
985,IND,2016-11-30,109,@,POR,0,240,36,72,0.5,30,58,0.517,6,14,0.429,31,35,0.886,109,51,94,0.543,39,62,0.629,12,32,0.375,17,19,0.895,131
986,LAL,2016-11-27,109,,ATL,1,240,42,95,0.442,34,75,0.453,8,20,0.4,17,20,0.85,109,39,88,0.443,27,53,0.509,12,35,0.343,4,10,0.4,94
987,SAS,2016-11-25,109,@,BOS,1,240,38,81,0.469,27,57,0.474,11,24,0.458,22,25,0.88,109,42,91,0.462,30,57,0.526,12,34,0.353,7,9,0.778,103
988,GSW,2016-11-25,109,@,LAL,1,240,43,83,0.518,32,55,0.582,11,28,0.393,12,17,0.706,109,32,90,0.356,27,68,0.397,5,22,0.227,16,23,0.696,85
989,OKC,2016-11-22,109,@,LAL,0,240,45,92,0.489,34,65,0.523,11,27,0.407,8,11,0.727,109,42,83,0.506,28,56,0.5,14,27,0.519,13,16,0.813,111
990,BRK,2016-11-20,109,,POR,0,240,37,93,0.398,27,58,0.466,10,35,0.286,25,31,0.806,109,49,85,0.576,34,49,0.694,15,36,0.417,16,21,0.762,129
991,POR,2016-11-17,109,@,HOU,0,240,41,90,0.456,31,62,0.5,10,28,0.357,17,21,0.81,109,46,95,0.484,32,63,0.508,14,32,0.438,20,25,0.8,126
992,PHI,2016-11-16,109,,WAS,1,240,42,77,0.545,32,49,0.653,10,28,0.357,15,22,0.682,109,38,91,0.418,30,68,0.441,8,23,0.348,18,25,0.72,102
993,PHI,2016-11-11,109,,IND,1,265,36,86,0.419,25,54,0.463,11,32,0.344,26,31,0.839,109,39,88,0.443,34,69,0.493,5,19,0.263,22,23,0.957,105
994,DAL,2016-11-08,109,@,LAL,1,240,43,82,0.524,33,59,0.559,10,23,0.435,13,15,0.867,109,38,78,0.487,28,52,0.538,10,26,0.385,11,14,0.786,97
995,UTA,2016-11-07,109,@,PHI,1,240,43,85,0.506,32,66,0.485,11,19,0.579,12,20,0.6,109,31,77,0.403,24,56,0.429,7,21,0.333,15,22,0.682,84
996,NYK,2016-11-06,109,,UTA,0,240,42,83,0.506,34,63,0.54,8,20,0.4,17,19,0.895,109,38,75,0.507,30,50,0.6,8,25,0.32,30,35,0.857,114
997,CHO,2016-11-02,109,,PHI,1,240,39,79,0.494,26,45,0.578,13,34,0.382,18,26,0.692,109,34,86,0.395,22,48,0.458,12,38,0.316,13,15,0.867,93
998,BRK,2016-11-02,109,,DET,1,240,41,76,0.539,28,49,0.571,13,27,0.481,14,17,0.824,109,37,88,0.42,28,63,0.444,9,25,0.36,18,21,0.857,101
999,TOR,2016-10-26,109,,DET,1,240,41,86,0.477,38,68,0.559,3,18,0.167,24,29,0.828,109,35,84,0.417,31,62,0.5,4,22,0.182,17,22,0.773,91
1000,LAL,2017-04-11,108,,NOP,1,240,42,88,0.477,34,66,0.515,8,22,0.364,16,23,0.696,108,37,79,0.468,30,57,0.526,7,22,0.318,15,20,0.75,96
1001,IND,2017-04-04,108,,TOR,1,240,39,89,0.438,27,64,0.422,12,25,0.48,18,18,1.0,108,34,76,0.447,29,53,0.547,5,23,0.217,17,19,0.895,90
1002,LAL,2017-04-02,108,,MEM,1,240,40,85,0.471,33,66,0.5,7,19,0.368,21,27,0.778,108,40,80,0.5,27,50,0.54,13,30,0.433,10,14,0.714,103
1003,MIL,2017-03-31,108,,DET,1,265,35,84,0.417,21,48,0.438,14,36,0.389,24,34,0.706,108,44,97,0.454,37,67,0.552,7,30,0.233,10,16,0.625,105
1004,CHO,2017-03-28,108,,MIL,0,240,39,80,0.488,32,52,0.615,7,28,0.25,23,29,0.793,108,46,74,0.622,32,44,0.727,14,30,0.467,12,17,0.706,118
1005,LAL,2017-03-28,108,,WAS,0,240,43,85,0.506,35,63,0.556,8,22,0.364,14,16,0.875,108,48,94,0.511,42,71,0.592,6,23,0.261,17,25,0.68,119
1006,UTA,2017-03-27,108,,NOP,1,240,41,85,0.482,26,58,0.448,15,27,0.556,11,18,0.611,108,37,80,0.463,27,55,0.491,10,25,0.4,16,24,0.667,100
1007,MIA,2017-03-26,108,@,BOS,0,240,41,91,0.451,34,62,0.548,7,29,0.241,19,24,0.792,108,41,77,0.532,33,53,0.623,8,24,0.333,22,25,0.88,112
1008,LAC,2017-03-25,108,,UTA,1,240,38,84,0.452,31,57,0.544,7,27,0.259,25,28,0.893,108,37,86,0.43,29,60,0.483,8,26,0.308,13,18,0.722,95
1009,BRK,2017-03-24,108,@,WAS,0,240,43,82,0.524,40,67,0.597,3,15,0.2,19,26,0.731,108,49,97,0.505,39,71,0.549,10,26,0.385,21,22,0.955,129
1010,UTA,2017-03-22,108,,NYK,1,240,41,90,0.456,34,62,0.548,7,28,0.25,19,29,0.655,108,38,80,0.475,29,59,0.492,9,21,0.429,16,18,0.889,101
1011,LAC,2017-03-18,108,,CLE,1,240,40,78,0.513,32,52,0.615,8,26,0.308,20,29,0.69,108,32,83,0.386,27,56,0.482,5,27,0.185,9,13,0.692,78
1012,LAC,2017-03-13,108,@,UTA,0,240,39,78,0.5,27,48,0.563,12,30,0.4,18,23,0.783,108,41,78,0.526,27,57,0.474,14,21,0.667,18,22,0.818,114
1013,PHI,2017-03-09,108,@,POR,0,265,41,94,0.436,30,65,0.462,11,29,0.379,15,20,0.75,108,40,88,0.455,34,67,0.507,6,21,0.286,28,33,0.848,114
1014,MIA,2017-03-08,108,,CHO,1,240,37,85,0.435,20,44,0.455,17,41,0.415,17,24,0.708,108,37,80,0.463,30,59,0.508,7,21,0.333,20,21,0.952,101
1015,HOU,2017-03-08,108,,UTA,0,240,35,79,0.443,27,47,0.574,8,32,0.25,30,40,0.75,108,41,76,0.539,29,45,0.644,12,31,0.387,21,24,0.875,115
1016,DEN,2017-03-06,108,,SAC,1,240,37,74,0.5,24,44,0.545,13,30,0.433,21,28,0.75,108,36,83,0.434,30,67,0.448,6,16,0.375,18,21,0.857,96
1017,MEM,2017-03-04,108,@,HOU,0,240,43,97,0.443,35,69,0.507,8,28,0.286,14,21,0.667,108,39,78,0.5,21,36,0.583,18,42,0.429,27,36,0.75,123
1018,GSW,2017-02-28,108,@,WAS,0,240,39,84,0.464,31,55,0.564,8,29,0.276,22,27,0.815,108,41,91,0.451,29,63,0.46,12,28,0.429,18,20,0.9,112
1019,PHI,2017-02-27,108,,GSW,0,240,37,82,0.451,27,48,0.563,10,34,0.294,24,27,0.889,108,40,89,0.449,34,60,0.567,6,29,0.207,33,39,0.846,119
1020,HOU,2017-02-27,108,,IND,0,240,32,88,0.364,22,43,0.512,10,45,0.222,34,42,0.81,108,41,91,0.451,28,61,0.459,13,30,0.433,22,25,0.88,117
1021,MIA,2017-02-24,108,@,ATL,1,240,40,99,0.404,23,62,0.371,17,37,0.459,11,13,0.846,108,30,79,0.38,24,59,0.407,6,20,0.3,24,36,0.667,90
1022,CHO,2017-02-23,108,@,DET,0,265,38,92,0.413,31,62,0.5,7,30,0.233,25,26,0.962,108,44,107,0.411,29,70,0.414,15,37,0.405,11,12,0.917,114
1023,PHI,2017-02-15,108,@,BOS,0,240,44,93,0.473,36,62,0.581,8,31,0.258,12,18,0.667,108,38,80,0.475,25,52,0.481,13,28,0.464,27,36,0.75,116
1024,MIN,2017-02-14,108,,CLE,0,240,42,86,0.488,33,63,0.524,9,23,0.391,15,19,0.789,108,44,86,0.512,31,47,0.66,13,39,0.333,15,22,0.682,116
1025,PHO,2017-02-13,108,,NOP,0,240,40,93,0.43,32,70,0.457,8,23,0.348,20,24,0.833,108,37,78,0.474,29,50,0.58,8,28,0.286,28,35,0.8,110
1026,MIA,2017-02-10,108,@,BRK,1,240,41,92,0.446,34,69,0.493,7,23,0.304,19,21,0.905,108,35,81,0.432,27,61,0.443,8,20,0.4,21,28,0.75,99
1027,SAC,2017-02-10,108,,ATL,1,240,38,80,0.475,20,44,0.455,18,36,0.5,14,21,0.667,108,36,71,0.507,25,41,0.61,11,30,0.367,24,31,0.774,107
1028,SAC,2017-02-08,108,,BOS,1,240,42,84,0.5,32,59,0.542,10,25,0.4,14,15,0.933,108,29,73,0.397,19,41,0.463,10,32,0.313,24,27,0.889,92
1029,DAL,2017-02-03,108,@,POR,1,240,36,76,0.474,19,45,0.422,17,31,0.548,19,23,0.826,108,40,88,0.455,31,58,0.534,9,30,0.3,15,20,0.75,104
1030,MIN,2017-02-03,108,@,DET,0,240,44,89,0.494,39,72,0.542,5,17,0.294,15,19,0.789,108,44,98,0.449,33,72,0.458,11,26,0.423,17,22,0.773,116
1031,HOU,2017-02-02,108,,ATL,0,240,35,93,0.376,22,42,0.524,13,51,0.255,25,33,0.758,108,44,85,0.518,36,55,0.655,8,30,0.267,17,23,0.739,113
1032,LAL,2017-02-02,108,@,WAS,0,240,40,87,0.46,28,48,0.583,12,39,0.308,16,22,0.727,108,44,96,0.458,32,63,0.508,12,33,0.364,16,21,0.762,116
1033,SAS,2017-01-31,108,,OKC,1,240,37,86,0.43,30,65,0.462,7,21,0.333,27,38,0.711,108,30,85,0.353,23,57,0.404,7,28,0.25,27,32,0.844,94
1034,TOR,2017-01-31,108,,NOP,1,265,43,94,0.457,33,63,0.524,10,31,0.323,12,15,0.8,108,40,94,0.426,28,64,0.438,12,30,0.4,14,19,0.737,106
1035,PHI,2017-01-29,108,@,CHI,0,240,44,99,0.444,34,71,0.479,10,28,0.357,10,14,0.714,108,45,89,0.506,37,75,0.493,8,14,0.571,23,28,0.821,121
1036,MIL,2017-01-28,108,,BOS,0,265,37,87,0.425,28,66,0.424,9,21,0.429,25,32,0.781,108,37,89,0.416,23,48,0.479,14,41,0.341,24,30,0.8,112
1037,SAS,2017-01-24,108,@,TOR,1,240,38,85,0.447,31,61,0.508,7,24,0.292,25,33,0.758,108,38,84,0.452,32,59,0.542,6,25,0.24,24,28,0.857,106
1038,BOS,2017-01-24,108,@,WAS,0,240,38,84,0.452,28,51,0.549,10,33,0.303,22,24,0.917,108,48,84,0.571,39,64,0.609,9,20,0.45,18,21,0.857,123
1039,DEN,2017-01-22,108,@,MIN,0,240,42,82,0.512,35,58,0.603,7,24,0.292,17,21,0.81,108,45,85,0.529,39,70,0.557,6,15,0.4,15,21,0.714,111
1040,HOU,2017-01-20,108,,GSW,0,240,43,96,0.448,36,61,0.59,7,35,0.2,15,18,0.833,108,47,89,0.528,32,51,0.627,15,38,0.395,16,21,0.762,125
1041,LAL,2017-01-20,108,,IND,1,240,41,87,0.471,27,54,0.5,14,33,0.424,12,15,0.8,108,34,80,0.425,25,57,0.439,9,23,0.391,18,25,0.72,95
1042,BOS,2017-01-16,108,,CHO,1,240,42,84,0.5,27,45,0.6,15,39,0.385,9,10,0.9,108,38,86,0.442,30,61,0.492,8,25,0.32,14,17,0.824,98
1043,ATL,2017-01-16,108,@,NYK,1,240,40,87,0.46,28,55,0.509,12,32,0.375,16,23,0.696,108,42,85,0.494,34,59,0.576,8,26,0.308,15,23,0.652,107
1044,CHI,2017-01-15,108,@,MEM,1,240,40,78,0.513,36,61,0.59,4,17,0.235,24,35,0.686,108,40,95,0.421,29,63,0.46,11,32,0.344,13,13,1.0,104
1045,PHO,2017-01-14,108,,SAS,1,240,39,85,0.459,31,64,0.484,8,21,0.381,22,24,0.917,108,36,71,0.507,27,51,0.529,9,20,0.45,24,34,0.706,105
1046,MIA,2017-01-13,108,@,MIL,0,240,41,83,0.494,29,51,0.569,12,32,0.375,14,18,0.778,108,40,80,0.5,31,65,0.477,9,15,0.6,27,31,0.871,116
1047,SAC,2017-01-13,108,,CLE,0,240,42,80,0.525,33,55,0.6,9,25,0.36,15,19,0.789,108,44,87,0.506,29,50,0.58,15,37,0.405,17,22,0.773,120
1048,PHO,2017-01-12,108,,DAL,0,240,38,78,0.487,28,60,0.467,10,18,0.556,22,27,0.815,108,43,89,0.483,28,55,0.509,15,34,0.441,12,17,0.706,113
1049,WAS,2017-01-11,108,@,BOS,0,240,45,105,0.429,35,79,0.443,10,26,0.385,8,12,0.667,108,43,85,0.506,26,44,0.591,17,41,0.415,14,18,0.778,117
1050,POR,2017-01-10,108,@,LAL,1,240,43,85,0.506,36,64,0.563,7,21,0.333,15,20,0.75,108,32,83,0.386,23,59,0.39,9,24,0.375,14,26,0.538,87
1051,NOP,2017-01-07,108,@,BOS,0,240,40,85,0.471,30,54,0.556,10,31,0.323,18,23,0.783,108,40,93,0.43,22,57,0.386,18,36,0.5,19,21,0.905,117
1052,BRK,2017-01-06,108,,CLE,0,240,41,91,0.451,32,61,0.525,9,30,0.3,17,19,0.895,108,38,88,0.432,29,55,0.527,9,33,0.273,31,43,0.721,116
1053,GSW,2016-12-30,108,,DAL,1,240,42,84,0.5,31,51,0.608,11,33,0.333,13,15,0.867,108,39,93,0.419,31,61,0.508,8,32,0.25,13,15,0.867,99
1054,GSW,2016-12-25,108,@,CLE,0,240,37,77,0.481,28,47,0.596,9,30,0.3,25,29,0.862,108,37,95,0.389,25,60,0.417,12,35,0.343,23,32,0.719,109
1055,DEN,2016-12-23,108,,ATL,0,240,37,78,0.474,29,53,0.547,8,25,0.32,26,35,0.743,108,37,86,0.43,29,61,0.475,8,25,0.32,27,33,0.818,109
1056,NOP,2016-12-20,108,@,PHI,1,240,40,93,0.43,30,76,0.395,10,17,0.588,18,26,0.692,108,33,82,0.402,22,49,0.449,11,33,0.333,16,21,0.762,93
1057,MIL,2016-12-20,108,,CLE,0,265,40,87,0.46,33,60,0.55,7,27,0.259,21,29,0.724,108,37,91,0.407,20,51,0.392,17,40,0.425,23,27,0.852,114
1058,OKC,2016-12-19,108,,ATL,0,240,39,87,0.448,29,52,0.558,10,35,0.286,20,26,0.769,108,41,75,0.547,32,52,0.615,9,23,0.391,19,24,0.792,110
1059,PHO,2016-12-19,108,@,MIN,0,240,37,82,0.451,28,61,0.459,9,21,0.429,25,35,0.714,108,42,86,0.488,35,67,0.522,7,19,0.368,24,25,0.96,115
1060,PHI,2016-12-18,108,,BRK,1,240,38,88,0.432,26,60,0.433,12,28,0.429,20,23,0.87,108,36,81,0.444,24,47,0.511,12,34,0.353,23,31,0.742,107
1061,LAL,2016-12-17,108,@,CLE,0,240,41,86,0.477,25,49,0.51,16,37,0.432,10,13,0.769,108,46,89,0.517,31,56,0.554,15,33,0.455,12,18,0.667,119
1062,DET,2016-12-16,108,@,WAS,0,240,42,86,0.488,32,58,0.552,10,28,0.357,14,21,0.667,108,44,77,0.571,32,52,0.615,12,25,0.48,22,27,0.815,122
1063,MIL,2016-12-15,108,,CHI,1,240,45,95,0.474,34,75,0.453,11,20,0.55,7,13,0.538,108,35,74,0.473,30,54,0.556,5,20,0.25,22,29,0.759,97
1064,ORL,2016-12-14,108,,LAC,0,240,42,89,0.472,28,56,0.5,14,33,0.424,10,20,0.5,108,37,74,0.5,24,49,0.49,13,25,0.52,26,37,0.703,113
1065,SAS,2016-12-14,108,,BOS,1,240,44,80,0.55,36,58,0.621,8,22,0.364,12,14,0.857,108,37,84,0.44,27,53,0.509,10,31,0.323,17,20,0.85,101
1066,MIN,2016-12-11,108,,GSW,0,240,36,81,0.444,27,57,0.474,9,24,0.375,27,36,0.75,108,38,83,0.458,25,51,0.49,13,32,0.406,27,30,0.9,116
1067,NOP,2016-12-05,108,,MEM,0,290,39,99,0.394,29,67,0.433,10,32,0.313,20,21,0.952,108,42,104,0.404,29,70,0.414,13,34,0.382,13,21,0.619,110
1068,PHI,2016-11-27,108,,CLE,0,240,43,92,0.467,28,58,0.483,15,34,0.441,7,10,0.7,108,38,92,0.413,26,52,0.5,12,40,0.3,24,28,0.857,112
1069,DET,2016-11-25,108,,LAC,1,240,47,90,0.522,38,71,0.535,9,19,0.474,5,7,0.714,108,35,73,0.479,28,52,0.538,7,21,0.333,20,26,0.769,97
1070,UTA,2016-11-23,108,,DEN,1,240,39,79,0.494,31,53,0.585,8,26,0.308,22,31,0.71,108,28,88,0.318,19,61,0.311,9,27,0.333,18,31,0.581,83
1071,MIN,2016-11-15,108,,CHO,0,240,38,89,0.427,23,54,0.426,15,35,0.429,17,21,0.81,108,43,80,0.538,32,56,0.571,11,24,0.458,18,22,0.818,115
1072,OKC,2016-11-11,108,,LAC,0,240,38,88,0.432,22,60,0.367,16,28,0.571,16,19,0.842,108,39,86,0.453,28,59,0.475,11,27,0.407,21,35,0.6,110
1073,MEM,2016-11-08,108,,DEN,1,240,44,86,0.512,37,62,0.597,7,24,0.292,13,19,0.684,108,35,70,0.5,25,46,0.543,10,24,0.417,27,34,0.794,107
1074,PHO,2016-11-06,108,@,LAL,0,240,40,91,0.44,34,71,0.479,6,20,0.3,22,28,0.786,108,41,90,0.456,31,67,0.463,10,23,0.435,27,35,0.771,119
1075,LAL,2016-11-01,108,@,IND,0,240,40,89,0.449,34,61,0.557,6,28,0.214,22,25,0.88,108,41,87,0.471,31,59,0.525,10,28,0.357,23,29,0.793,115
1076,MIA,2016-11-01,108,,SAC,1,265,37,86,0.43,24,57,0.421,13,29,0.448,21,29,0.724,108,34,89,0.382,29,66,0.439,5,23,0.217,23,27,0.852,96
1077,BRK,2016-10-29,108,@,MIL,0,240,37,84,0.44,26,50,0.52,11,34,0.324,23,28,0.821,108,41,88,0.466,33,66,0.5,8,22,0.364,20,24,0.833,110
1078,DET,2016-10-28,108,,ORL,1,240,48,95,0.505,41,76,0.539,7,19,0.368,5,6,0.833,108,33,95,0.347,25,69,0.362,8,26,0.308,8,12,0.667,82
1079,MIA,2016-10-26,108,@,ORL,1,240,47,97,0.485,43,81,0.531,4,16,0.25,10,16,0.625,108,34,89,0.382,28,71,0.394,6,18,0.333,22,28,0.786,96
1080,BRK,2017-04-08,107,,CHI,1,240,39,92,0.424,29,61,0.475,10,31,0.323,19,24,0.792,107,40,90,0.444,29,66,0.439,11,24,0.458,15,17,0.882,106
1081,BRK,2017-04-06,107,@,ORL,0,240,40,87,0.46,29,57,0.509,11,30,0.367,16,22,0.727,107,42,90,0.467,33,65,0.508,9,25,0.36,22,26,0.846,115
1082,MIN,2017-04-04,107,@,GSW,0,240,41,96,0.427,37,77,0.481,4,19,0.211,21,26,0.808,107,44,84,0.524,30,52,0.577,14,32,0.438,19,24,0.792,121
1083,GSW,2017-03-31,107,,HOU,1,240,43,95,0.453,32,63,0.508,11,32,0.344,10,14,0.714,107,34,91,0.374,22,54,0.407,12,37,0.324,18,23,0.783,98
1084,HOU,2017-03-30,107,@,POR,0,240,40,91,0.44,32,57,0.561,8,34,0.235,19,23,0.826,107,43,90,0.478,30,57,0.526,13,33,0.394,18,22,0.818,117
1085,BRK,2017-03-26,107,@,ATL,1,240,38,86,0.442,32,64,0.5,6,22,0.273,25,30,0.833,107,34,98,0.347,29,71,0.408,5,27,0.185,19,32,0.594,92
1086,IND,2017-03-26,107,,PHI,1,240,38,89,0.427,31,72,0.431,7,17,0.412,24,29,0.828,107,35,88,0.398,21,47,0.447,14,41,0.341,10,14,0.714,94
1087,CHI,2017-03-24,107,,PHI,0,240,37,91,0.407,27,67,0.403,10,24,0.417,23,31,0.742,107,46,83,0.554,38,58,0.655,8,25,0.32,17,23,0.739,117
1088,NOP,2017-03-24,107,@,HOU,0,240,41,91,0.451,27,53,0.509,14,38,0.368,11,14,0.786,107,44,93,0.473,30,54,0.556,14,39,0.359,15,20,0.75,117
1089,IND,2017-03-20,107,,UTA,1,240,38,87,0.437,28,67,0.418,10,20,0.5,21,23,0.913,107,40,88,0.455,34,63,0.54,6,25,0.24,14,20,0.7,100
1090,MIL,2017-03-17,107,@,LAL,1,240,40,82,0.488,36,58,0.621,4,24,0.167,23,30,0.767,107,38,84,0.452,27,55,0.491,11,29,0.379,16,26,0.615,103
1091,CHI,2017-03-17,107,@,WAS,0,240,44,88,0.5,37,61,0.607,7,27,0.259,12,18,0.667,107,46,101,0.455,36,75,0.48,10,26,0.385,10,12,0.833,112
1092,WAS,2017-03-15,107,,DAL,0,240,40,82,0.488,28,52,0.538,12,30,0.4,15,21,0.714,107,40,79,0.506,26,47,0.553,14,32,0.438,18,25,0.72,112
1093,SAC,2017-03-15,107,@,PHO,1,240,38,79,0.481,32,65,0.492,6,14,0.429,25,34,0.735,107,43,107,0.402,37,82,0.451,6,25,0.24,9,14,0.643,101
1094,SAS,2017-03-13,107,,ATL,1,240,39,81,0.481,23,47,0.489,16,34,0.471,13,17,0.765,107,37,81,0.457,31,59,0.525,6,22,0.273,19,30,0.633,99
1095,SAS,2017-03-11,107,,GSW,1,240,40,77,0.519,28,50,0.56,12,27,0.444,15,18,0.833,107,33,92,0.359,28,75,0.373,5,17,0.294,14,23,0.609,85
1096,ATL,2017-03-11,107,@,MEM,1,240,36,72,0.5,21,42,0.5,15,30,0.5,20,26,0.769,107,34,90,0.378,29,61,0.475,5,29,0.172,17,23,0.739,90
1097,MIN,2017-03-08,107,,LAC,1,240,42,86,0.488,37,66,0.561,5,20,0.25,18,20,0.9,107,35,83,0.422,26,59,0.441,9,24,0.375,12,18,0.667,91
1098,MIN,2017-03-01,107,@,UTA,1,240,39,78,0.5,31,62,0.5,8,16,0.5,21,26,0.808,107,35,90,0.389,31,71,0.437,4,19,0.211,6,11,0.545,80
1099,CHI,2017-02-28,107,,DEN,0,240,44,96,0.458,34,70,0.486,10,26,0.385,9,10,0.9,107,45,80,0.563,32,50,0.64,13,30,0.433,22,24,0.917,125
1100,TOR,2017-02-24,107,,BOS,1,240,40,81,0.494,35,66,0.53,5,15,0.333,22,29,0.759,107,33,78,0.423,21,40,0.525,12,38,0.316,19,22,0.864,97
1101,SAS,2017-02-15,107,@,ORL,1,240,42,89,0.472,34,58,0.586,8,31,0.258,15,19,0.789,107,30,76,0.395,26,58,0.448,4,18,0.222,15,19,0.789,79
1102,MIA,2017-02-13,107,,ORL,0,240,39,83,0.47,33,61,0.541,6,22,0.273,23,27,0.852,107,44,90,0.489,36,76,0.474,8,14,0.571,20,29,0.69,116
1103,LAC,2017-02-11,107,@,CHO,1,240,40,85,0.471,26,51,0.51,14,34,0.412,13,20,0.65,107,37,85,0.435,24,48,0.5,13,37,0.351,15,20,0.75,102
1104,MEM,2017-02-10,107,,GSW,0,240,34,87,0.391,25,61,0.41,9,26,0.346,30,37,0.811,107,39,77,0.506,24,44,0.545,15,33,0.455,29,38,0.763,122
1105,ATL,2017-02-10,107,@,SAC,0,240,36,71,0.507,25,41,0.61,11,30,0.367,24,31,0.774,107,38,80,0.475,20,44,0.455,18,36,0.5,14,21,0.667,108
1106,IND,2017-02-10,107,@,WAS,0,240,45,92,0.489,41,71,0.577,4,21,0.19,13,15,0.867,107,41,88,0.466,31,59,0.525,10,29,0.345,20,30,0.667,112
1107,HOU,2017-02-09,107,@,CHO,1,240,39,87,0.448,26,47,0.553,13,40,0.325,16,20,0.8,107,37,85,0.435,29,59,0.492,8,26,0.308,13,14,0.929,95
1108,BRK,2017-02-07,107,@,CHO,0,240,39,86,0.453,27,50,0.54,12,36,0.333,17,21,0.81,107,40,102,0.392,33,76,0.434,7,26,0.269,24,29,0.828,111
1109,NYK,2017-02-06,107,,LAL,0,240,37,82,0.451,30,61,0.492,7,21,0.333,26,33,0.788,107,44,102,0.431,36,74,0.486,8,28,0.286,25,31,0.806,121
1110,SAC,2017-02-06,107,,CHI,0,240,41,79,0.519,30,51,0.588,11,28,0.393,14,16,0.875,107,43,81,0.531,37,62,0.597,6,19,0.316,20,31,0.645,112
1111,BOS,2017-02-05,107,,LAC,1,240,37,88,0.42,21,36,0.583,16,52,0.308,17,20,0.85,107,35,84,0.417,25,55,0.455,10,29,0.345,22,28,0.786,102
1112,MEM,2017-02-04,107,@,MIN,1,240,32,77,0.416,22,49,0.449,10,28,0.357,33,39,0.846,107,35,84,0.417,25,58,0.431,10,26,0.385,19,24,0.792,99
1113,LAL,2017-02-03,107,@,BOS,0,240,37,94,0.394,23,56,0.411,14,38,0.368,19,26,0.731,107,39,82,0.476,26,47,0.553,13,35,0.371,22,28,0.786,113
1114,WAS,2017-01-29,107,@,NOP,1,240,45,89,0.506,35,68,0.515,10,21,0.476,7,10,0.7,107,38,84,0.452,28,52,0.538,10,32,0.313,8,15,0.533,94
1115,CLE,2017-01-29,107,,OKC,1,240,41,92,0.446,33,63,0.524,8,29,0.276,17,22,0.773,107,37,100,0.37,31,74,0.419,6,26,0.231,11,16,0.688,91
1116,CHO,2017-01-27,107,@,NYK,0,240,40,90,0.444,27,53,0.509,13,37,0.351,14,15,0.933,107,46,96,0.479,37,69,0.536,9,27,0.333,9,13,0.692,110
1117,PHO,2017-01-21,107,@,NYK,1,240,37,85,0.435,28,61,0.459,9,24,0.375,24,27,0.889,107,40,89,0.449,29,68,0.426,11,21,0.524,14,16,0.875,105
1118,MEM,2017-01-20,107,,SAC,1,240,38,83,0.458,27,55,0.491,11,28,0.393,20,25,0.8,107,31,76,0.408,25,47,0.532,6,29,0.207,23,32,0.719,91
1119,DAL,2017-01-20,107,,UTA,0,265,39,87,0.448,31,64,0.484,8,23,0.348,21,28,0.75,107,38,83,0.458,30,60,0.5,8,23,0.348,28,39,0.718,112
1120,CHO,2017-01-18,107,,POR,1,240,41,87,0.471,30,61,0.492,11,26,0.423,14,17,0.824,107,33,94,0.351,25,63,0.397,8,31,0.258,11,11,1.0,85
1121,NYK,2017-01-16,107,,ATL,0,240,42,85,0.494,34,59,0.576,8,26,0.308,15,23,0.652,107,40,87,0.46,28,55,0.509,12,32,0.375,16,23,0.696,108
1122,CHI,2017-01-14,107,,NOP,1,240,43,101,0.426,35,81,0.432,8,20,0.4,13,23,0.565,107,39,84,0.464,32,61,0.525,7,23,0.304,14,21,0.667,99
1123,ORL,2017-01-14,107,@,UTA,0,240,38,82,0.463,26,48,0.542,12,34,0.353,19,27,0.704,107,41,83,0.494,34,57,0.596,7,26,0.269,25,36,0.694,114
1124,DET,2017-01-12,107,@,GSW,0,240,43,88,0.489,37,60,0.617,6,28,0.214,15,20,0.75,107,50,89,0.562,35,60,0.583,15,29,0.517,12,18,0.667,127
1125,SAS,2017-01-10,107,,MIL,0,240,42,88,0.477,30,58,0.517,12,30,0.4,11,14,0.786,107,44,84,0.524,34,65,0.523,10,19,0.526,11,13,0.846,109
1126,GSW,2017-01-10,107,,MIA,1,240,39,86,0.453,28,59,0.475,11,27,0.407,18,22,0.818,107,38,90,0.422,32,60,0.533,6,30,0.2,13,17,0.765,95
1127,WAS,2017-01-08,107,@,MIL,1,240,41,84,0.488,31,52,0.596,10,32,0.313,15,18,0.833,107,37,80,0.463,28,57,0.491,9,23,0.391,18,20,0.9,101
1128,MIA,2017-01-04,107,@,SAC,1,240,35,72,0.486,23,44,0.523,12,28,0.429,25,29,0.862,107,40,78,0.513,32,58,0.552,8,20,0.4,14,17,0.824,102
1129,DET,2017-01-01,107,@,MIA,1,240,42,86,0.488,33,64,0.516,9,22,0.409,14,22,0.636,107,35,77,0.455,21,51,0.412,14,26,0.538,14,18,0.778,98
1130,DAL,2016-12-27,107,,HOU,0,240,36,87,0.414,21,49,0.429,15,38,0.395,20,25,0.8,107,41,78,0.526,24,46,0.522,17,32,0.531,24,28,0.857,123
1131,WAS,2016-12-26,107,,MIL,1,240,40,79,0.506,28,50,0.56,12,29,0.414,15,20,0.75,107,40,87,0.46,34,67,0.507,6,20,0.3,16,23,0.696,102
1132,LAL,2016-12-22,107,@,MIA,0,240,40,90,0.444,26,52,0.5,14,38,0.368,13,15,0.867,107,45,84,0.536,34,62,0.548,11,22,0.5,14,21,0.667,115
1133,WAS,2016-12-21,107,@,CHI,1,240,43,82,0.524,40,64,0.625,3,18,0.167,18,25,0.72,107,38,95,0.4,32,74,0.432,6,21,0.286,15,19,0.789,97
1134,IND,2016-12-19,107,,WAS,1,240,41,87,0.471,34,66,0.515,7,21,0.333,18,21,0.857,107,38,88,0.432,30,55,0.545,8,33,0.242,21,26,0.808,105
1135,DAL,2016-12-19,107,@,DEN,0,240,43,80,0.538,29,55,0.527,14,25,0.56,7,9,0.778,107,45,80,0.563,32,55,0.582,13,25,0.52,14,18,0.778,117
1136,BRK,2016-12-18,107,@,PHI,0,240,36,81,0.444,24,47,0.511,12,34,0.353,23,31,0.742,107,38,88,0.432,26,60,0.433,12,28,0.429,20,23,0.87,108
1137,CHO,2016-12-17,107,@,ATL,1,240,43,88,0.489,31,61,0.508,12,27,0.444,9,13,0.692,107,40,86,0.465,30,60,0.5,10,26,0.385,9,16,0.563,99
1138,SAS,2016-12-15,107,@,PHO,1,240,39,74,0.527,34,58,0.586,5,16,0.313,24,26,0.923,107,34,85,0.4,24,58,0.414,10,27,0.37,14,18,0.778,92
1139,BRK,2016-12-14,107,,LAL,1,240,33,86,0.384,22,51,0.431,11,35,0.314,30,40,0.75,107,35,91,0.385,29,64,0.453,6,27,0.222,21,34,0.618,97
1140,POR,2016-12-07,107,@,MIL,0,240,37,85,0.435,20,45,0.444,17,40,0.425,16,19,0.842,107,40,77,0.519,30,53,0.566,10,24,0.417,25,37,0.676,115
1141,UTA,2016-12-05,107,@,LAL,1,240,38,80,0.475,25,48,0.521,13,32,0.406,18,29,0.621,107,39,87,0.448,34,73,0.466,5,14,0.357,18,23,0.783,101
1142,HOU,2016-12-05,107,,BOS,1,240,34,76,0.447,22,38,0.579,12,38,0.316,27,31,0.871,107,42,99,0.424,31,67,0.463,11,32,0.344,11,12,0.917,106
1143,BOS,2016-12-03,107,@,PHI,1,240,38,76,0.5,30,50,0.6,8,26,0.308,23,29,0.793,107,35,76,0.461,20,43,0.465,15,33,0.455,21,26,0.808,106
1144,DAL,2016-12-03,107,,CHI,1,240,40,87,0.46,27,56,0.482,13,31,0.419,14,18,0.778,107,32,71,0.451,29,58,0.5,3,13,0.231,15,21,0.714,82
1145,SAS,2016-12-02,107,,WAS,1,240,39,80,0.488,31,60,0.517,8,20,0.4,21,33,0.636,107,41,81,0.506,34,70,0.486,7,11,0.636,16,18,0.889,105
1146,ATL,2016-11-30,107,@,PHO,0,240,45,89,0.506,36,64,0.563,9,25,0.36,8,10,0.8,107,40,89,0.449,30,68,0.441,10,21,0.476,19,25,0.76,109
1147,CHO,2016-11-26,107,,NYK,1,240,35,80,0.438,27,58,0.466,8,22,0.364,29,42,0.69,107,37,99,0.374,25,67,0.373,12,32,0.375,16,20,0.8,102
1148,MIA,2016-11-26,107,,MEM,0,240,40,81,0.494,29,50,0.58,11,31,0.355,16,24,0.667,107,37,73,0.507,28,48,0.583,9,25,0.36,27,33,0.818,110
1149,DET,2016-11-23,107,,MIA,1,240,40,81,0.494,34,62,0.548,6,19,0.316,21,25,0.84,107,27,75,0.36,20,49,0.408,7,26,0.269,23,30,0.767,84
1150,NYK,2016-11-22,107,,POR,1,240,45,96,0.469,36,67,0.537,9,29,0.31,8,8,1.0,107,38,86,0.442,32,64,0.5,6,22,0.273,21,26,0.808,103
1151,CHI,2016-11-22,107,@,DEN,0,240,43,95,0.453,37,77,0.481,6,18,0.333,15,18,0.833,107,43,100,0.43,33,78,0.423,10,22,0.455,14,17,0.824,110
1152,LAL,2016-11-18,107,,SAS,0,240,39,87,0.448,27,62,0.435,12,25,0.48,17,21,0.81,107,44,78,0.564,34,54,0.63,10,24,0.417,18,19,0.947,116
1153,ATL,2016-11-16,107,,MIL,1,240,35,72,0.486,25,40,0.625,10,32,0.313,27,31,0.871,107,39,98,0.398,31,66,0.47,8,32,0.25,14,18,0.778,100
1154,LAC,2016-11-16,107,,MEM,0,240,37,81,0.457,28,56,0.5,9,25,0.36,24,34,0.706,107,40,82,0.488,25,56,0.446,15,26,0.577,16,19,0.842,111
1155,NYK,2016-11-12,107,@,TOR,0,240,44,97,0.454,37,74,0.5,7,23,0.304,12,16,0.75,107,39,83,0.47,32,61,0.525,7,22,0.318,33,38,0.868,118
1156,CHI,2016-11-09,107,@,ATL,0,240,41,91,0.451,32,64,0.5,9,27,0.333,16,21,0.762,107,42,83,0.506,33,63,0.524,9,20,0.45,22,27,0.815,115
1157,PHO,2016-11-09,107,,DET,1,240,38,84,0.452,30,62,0.484,8,22,0.364,23,30,0.767,107,32,89,0.36,23,67,0.343,9,22,0.409,27,32,0.844,100
1158,ORL,2016-11-09,107,,MIN,0,240,38,85,0.447,30,61,0.492,8,24,0.333,23,30,0.767,107,45,87,0.517,32,64,0.5,13,23,0.565,20,26,0.769,123
1159,DEN,2016-11-08,107,@,MEM,0,240,35,70,0.5,25,46,0.543,10,24,0.417,27,34,0.794,107,44,86,0.512,37,62,0.597,7,24,0.292,13,19,0.684,108
1160,BOS,2016-11-06,107,,DEN,0,240,41,90,0.456,33,65,0.508,8,25,0.32,17,21,0.81,107,44,84,0.524,33,61,0.541,11,23,0.478,24,31,0.774,123
1161,IND,2016-11-03,107,@,MIL,0,240,38,81,0.469,28,58,0.483,10,23,0.435,21,27,0.778,107,47,82,0.573,35,55,0.636,12,27,0.444,19,24,0.792,125
1162,BOS,2016-11-02,107,,CHI,1,240,41,87,0.471,27,55,0.491,14,32,0.438,11,17,0.647,107,35,81,0.432,28,61,0.459,7,20,0.35,23,31,0.742,100
1163,CHO,2016-10-26,107,@,MIL,1,240,40,89,0.449,33,66,0.5,7,23,0.304,20,24,0.833,107,39,92,0.424,36,76,0.474,3,16,0.188,15,20,0.75,96
1164,DEN,2016-10-26,107,@,NOP,1,240,37,83,0.446,29,59,0.492,8,24,0.333,25,33,0.758,107,38,92,0.413,35,73,0.479,3,19,0.158,23,26,0.885,102
1165,OKC,2017-04-09,106,@,DEN,1,240,40,96,0.417,34,71,0.479,6,25,0.24,20,22,0.909,106,40,84,0.476,29,50,0.58,11,34,0.324,14,15,0.933,105
1166,CHI,2017-04-08,106,@,BRK,0,240,40,90,0.444,29,66,0.439,11,24,0.458,15,17,0.882,106,39,92,0.424,29,61,0.475,10,31,0.323,19,24,0.792,107
1167,MIA,2017-04-08,106,@,WAS,1,240,37,80,0.463,30,62,0.484,7,18,0.389,25,36,0.694,106,39,81,0.481,31,59,0.525,8,22,0.364,17,22,0.773,103
1168,NOP,2017-04-07,106,@,DEN,0,240,47,99,0.475,44,76,0.579,3,23,0.13,9,13,0.692,106,43,78,0.551,30,46,0.652,13,32,0.406,23,32,0.719,122
1169,WAS,2017-04-06,106,@,NYK,1,240,36,74,0.486,22,40,0.55,14,34,0.412,20,28,0.714,106,40,95,0.421,33,75,0.44,7,20,0.35,16,21,0.762,103
1170,UTA,2017-04-04,106,,POR,1,240,39,74,0.527,26,51,0.51,13,23,0.565,15,19,0.789,106,33,83,0.398,27,57,0.474,6,26,0.231,15,17,0.882,87
1171,CHI,2017-04-01,106,,ATL,1,240,40,85,0.471,28,55,0.509,12,30,0.4,14,14,1.0,106,40,90,0.444,29,62,0.468,11,28,0.393,13,17,0.765,104
1172,TOR,2017-03-29,106,,CHO,0,240,38,83,0.458,27,52,0.519,11,31,0.355,19,24,0.792,106,39,86,0.453,23,54,0.426,16,32,0.5,16,21,0.762,110
1173,ORL,2017-03-29,106,,OKC,0,265,39,97,0.402,30,67,0.448,9,30,0.3,19,27,0.704,106,43,102,0.422,33,69,0.478,10,33,0.303,18,28,0.643,114
1174,PHI,2017-03-28,106,@,BRK,1,240,39,91,0.429,29,58,0.5,10,33,0.303,18,21,0.857,106,38,94,0.404,29,62,0.468,9,32,0.281,16,24,0.667,101
1175,HOU,2017-03-28,106,,GSW,0,240,33,85,0.388,28,54,0.519,5,31,0.161,35,39,0.897,106,45,88,0.511,34,47,0.723,11,41,0.268,12,16,0.75,113
1176,PHO,2017-03-26,106,@,CHO,0,240,41,81,0.506,35,65,0.538,6,16,0.375,18,22,0.818,106,42,87,0.483,28,57,0.491,14,30,0.467,22,24,0.917,120
1177,GSW,2017-03-26,106,,MEM,1,240,39,71,0.549,22,40,0.55,17,31,0.548,11,15,0.733,106,38,85,0.447,30,56,0.536,8,29,0.276,10,15,0.667,94
1178,SAS,2017-03-25,106,,NYK,1,240,45,99,0.455,35,74,0.473,10,25,0.4,6,8,0.75,106,41,87,0.471,38,77,0.494,3,10,0.3,13,15,0.867,98
1179,SAS,2017-03-15,106,,POR,0,240,42,88,0.477,31,62,0.5,11,26,0.423,11,15,0.733,106,38,80,0.475,29,58,0.5,9,22,0.409,25,28,0.893,110
1180,GSW,2017-03-14,106,,PHI,1,240,32,88,0.364,18,56,0.321,14,32,0.438,28,35,0.8,106,39,89,0.438,31,62,0.5,8,27,0.296,18,27,0.667,104
1181,DET,2017-03-09,106,,CLE,1,240,41,88,0.466,32,62,0.516,9,26,0.346,15,19,0.789,106,39,84,0.464,28,45,0.622,11,39,0.282,12,19,0.632,101
1182,MIA,2017-03-06,106,@,CLE,1,240,39,91,0.429,23,56,0.411,16,35,0.457,12,14,0.857,106,35,78,0.449,26,51,0.51,9,27,0.333,19,29,0.655,98
1183,BOS,2017-03-05,106,@,PHO,0,240,32,85,0.376,19,48,0.396,13,37,0.351,29,40,0.725,106,42,94,0.447,38,74,0.514,4,20,0.2,21,26,0.808,109
1184,PHI,2017-03-04,106,,DET,0,240,43,88,0.489,29,54,0.537,14,34,0.412,6,7,0.857,106,54,95,0.568,44,72,0.611,10,23,0.435,18,21,0.857,136
1185,WAS,2017-03-03,106,,TOR,0,240,34,92,0.37,24,62,0.387,10,30,0.333,28,32,0.875,106,41,81,0.506,30,56,0.536,11,25,0.44,21,27,0.778,114
1186,UTA,2017-02-28,106,@,OKC,0,240,43,93,0.462,34,71,0.479,9,22,0.409,11,13,0.846,106,39,76,0.513,24,54,0.444,15,22,0.682,16,23,0.696,109
1187,POR,2017-02-26,106,@,TOR,0,240,35,79,0.443,26,58,0.448,9,21,0.429,27,35,0.771,106,42,78,0.538,35,58,0.603,7,20,0.35,21,27,0.778,112
1188,IND,2017-02-13,106,,SAS,0,240,38,78,0.487,29,58,0.5,9,20,0.45,21,30,0.7,106,40,87,0.46,33,72,0.458,7,15,0.467,23,27,0.852,110
1189,MIN,2017-02-10,106,,NOP,0,240,38,82,0.463,32,55,0.582,6,27,0.222,24,32,0.75,106,45,75,0.6,33,50,0.66,12,25,0.48,20,27,0.741,122
1190,DEN,2017-02-08,106,@,ATL,0,240,40,100,0.4,27,56,0.482,13,44,0.295,13,21,0.619,106,47,93,0.505,39,66,0.591,8,27,0.296,15,18,0.833,117
1191,MIA,2017-02-08,106,@,MIL,1,240,41,86,0.477,30,53,0.566,11,33,0.333,13,18,0.722,106,33,71,0.465,27,56,0.482,6,15,0.4,16,28,0.571,88
1192,PHO,2017-02-06,106,@,NOP,0,240,40,93,0.43,35,66,0.53,5,27,0.185,21,25,0.84,106,42,92,0.457,33,66,0.5,9,26,0.346,18,22,0.818,111
1193,GSW,2017-02-04,106,@,SAC,0,265,36,87,0.414,21,43,0.488,15,44,0.341,19,24,0.792,106,43,88,0.489,36,65,0.554,7,23,0.304,16,19,0.842,109
1194,IND,2017-02-03,106,@,BRK,1,240,37,86,0.43,29,66,0.439,8,20,0.4,24,31,0.774,106,32,86,0.372,21,58,0.362,11,28,0.393,22,23,0.957,97
1195,NOP,2017-01-31,106,@,TOR,0,265,40,94,0.426,28,64,0.438,12,30,0.4,14,19,0.737,106,43,94,0.457,33,63,0.524,10,31,0.323,12,15,0.8,108
1196,CHO,2017-01-28,106,,SAC,0,240,36,75,0.48,24,38,0.632,12,37,0.324,22,24,0.917,106,41,79,0.519,30,52,0.577,11,27,0.407,16,26,0.615,109
1197,BRK,2017-01-25,106,,MIA,0,240,35,80,0.438,22,45,0.489,13,35,0.371,23,26,0.885,106,40,83,0.482,29,60,0.483,11,23,0.478,18,25,0.72,109
1198,TOR,2017-01-24,106,,SAS,0,240,38,84,0.452,32,59,0.542,6,25,0.24,24,28,0.857,106,38,85,0.447,31,61,0.508,7,24,0.292,25,33,0.758,108
1199,BOS,2017-01-18,106,,NYK,0,240,35,91,0.385,26,58,0.448,9,33,0.273,27,29,0.931,106,46,91,0.505,36,66,0.545,10,25,0.4,15,18,0.833,117
1200,IND,2017-01-18,106,@,SAC,1,240,39,75,0.52,32,54,0.593,7,21,0.333,21,25,0.84,106,35,72,0.486,26,51,0.51,9,21,0.429,21,27,0.778,100
1201,UTA,2017-01-16,106,@,PHO,1,240,41,89,0.461,33,66,0.5,8,23,0.348,16,24,0.667,106,40,81,0.494,35,59,0.593,5,22,0.227,16,17,0.941,101
1202,BOS,2017-01-10,106,@,TOR,0,240,40,85,0.471,31,58,0.534,9,27,0.333,17,20,0.85,106,41,87,0.471,31,65,0.477,10,22,0.455,22,27,0.815,114
1203,SAC,2017-01-08,106,,GSW,0,240,36,74,0.486,25,46,0.543,11,28,0.393,23,29,0.793,106,45,89,0.506,35,60,0.583,10,29,0.345,17,20,0.85,117
1204,DEN,2017-01-07,106,@,OKC,0,240,40,99,0.404,31,75,0.413,9,24,0.375,17,24,0.708,106,43,89,0.483,31,53,0.585,12,36,0.333,23,29,0.793,121
1205,LAC,2017-01-06,106,@,SAC,1,240,39,84,0.464,26,53,0.491,13,31,0.419,15,21,0.714,106,36,87,0.414,27,57,0.474,9,30,0.3,17,22,0.773,98
1206,PHI,2017-01-06,106,@,BOS,0,240,37,79,0.468,28,51,0.549,9,28,0.321,23,26,0.885,106,35,87,0.402,16,47,0.34,19,40,0.475,21,25,0.84,110
1207,CHI,2017-01-04,106,@,CLE,1,240,41,85,0.482,28,55,0.509,13,30,0.433,11,15,0.733,106,34,83,0.41,26,58,0.448,8,25,0.32,18,24,0.75,94
1208,MEM,2017-01-04,106,@,LAC,0,240,38,88,0.432,27,60,0.45,11,28,0.393,19,25,0.76,106,37,73,0.507,28,50,0.56,9,23,0.391,32,45,0.711,115
1209,OKC,2016-12-27,106,@,MIA,1,240,42,82,0.512,37,63,0.587,5,19,0.263,17,25,0.68,106,36,82,0.439,29,60,0.483,7,22,0.318,15,21,0.714,94
1210,DEN,2016-12-26,106,@,LAC,1,240,36,82,0.439,25,51,0.49,11,31,0.355,23,28,0.821,106,39,84,0.464,30,59,0.508,9,25,0.36,15,20,0.75,102
1211,DET,2016-12-26,106,,CLE,1,240,41,92,0.446,25,64,0.391,16,28,0.571,8,15,0.533,106,30,79,0.38,19,51,0.373,11,28,0.393,19,23,0.826,90
1212,LAC,2016-12-22,106,,SAS,1,240,39,83,0.47,28,55,0.509,11,28,0.393,17,22,0.773,106,37,92,0.402,31,73,0.425,6,19,0.316,21,25,0.84,101
1213,NYK,2016-12-22,106,,ORL,1,240,41,96,0.427,32,76,0.421,9,20,0.45,15,17,0.882,106,39,90,0.433,34,63,0.54,5,27,0.185,12,16,0.75,95
1214,CHO,2016-12-14,106,@,WAS,0,240,38,74,0.514,24,41,0.585,14,33,0.424,16,21,0.762,106,45,87,0.517,40,69,0.58,5,18,0.278,14,17,0.824,109
1215,GSW,2016-12-08,106,@,UTA,1,240,39,80,0.488,27,51,0.529,12,29,0.414,16,23,0.696,106,37,89,0.416,27,51,0.529,10,38,0.263,15,21,0.714,99
1216,DEN,2016-12-05,106,@,PHI,1,240,35,76,0.461,25,49,0.51,10,27,0.37,26,34,0.765,106,35,86,0.407,24,55,0.436,11,31,0.355,17,23,0.739,98
1217,BOS,2016-12-05,106,@,HOU,0,240,42,99,0.424,31,67,0.463,11,32,0.344,11,12,0.917,106,34,76,0.447,22,38,0.579,12,38,0.316,27,31,0.871,107
1218,IND,2016-12-05,106,@,GSW,0,240,35,85,0.412,32,70,0.457,3,15,0.2,33,35,0.943,106,54,104,0.519,40,67,0.597,14,37,0.378,20,26,0.769,142
1219,NYK,2016-12-04,106,,SAC,1,240,39,88,0.443,28,59,0.475,11,29,0.379,17,24,0.708,106,31,97,0.32,22,69,0.319,9,28,0.321,27,31,0.871,98
1220,PHI,2016-12-03,106,,BOS,0,240,35,76,0.461,20,43,0.465,15,33,0.455,21,26,0.808,106,38,76,0.5,30,50,0.6,8,26,0.308,23,29,0.793,107
1221,NYK,2016-11-30,106,@,MIN,1,240,41,91,0.451,28,59,0.475,13,32,0.406,11,15,0.733,106,34,77,0.442,30,58,0.517,4,19,0.211,32,39,0.821,104
1222,MIA,2016-11-30,106,@,DEN,1,240,41,93,0.441,32,69,0.464,9,24,0.375,15,26,0.577,106,38,91,0.418,31,69,0.449,7,22,0.318,15,24,0.625,98
1223,OKC,2016-11-26,106,,DET,1,240,42,83,0.506,34,60,0.567,8,23,0.348,14,26,0.538,106,37,82,0.451,36,63,0.571,1,19,0.053,13,17,0.765,88
1224,LAL,2016-11-23,106,@,GSW,0,240,40,93,0.43,32,73,0.438,8,20,0.4,18,22,0.818,106,53,86,0.616,34,50,0.68,19,36,0.528,24,35,0.686,149
1225,WAS,2016-11-21,106,,PHO,1,240,37,91,0.407,27,63,0.429,10,28,0.357,22,34,0.647,106,39,91,0.429,28,64,0.438,11,27,0.407,12,15,0.8,101
1226,NOP,2016-11-14,106,,BOS,1,240,35,79,0.443,29,58,0.5,6,21,0.286,30,36,0.833,106,38,95,0.4,26,54,0.481,12,41,0.293,17,20,0.85,105
1227,MIL,2016-11-12,106,,MEM,1,240,36,68,0.529,29,50,0.58,7,18,0.389,27,36,0.75,106,35,78,0.449,29,48,0.604,6,30,0.2,20,21,0.952,96
1228,SAS,2016-11-12,106,@,HOU,1,240,41,76,0.539,36,58,0.621,5,18,0.278,19,24,0.792,106,34,89,0.382,19,42,0.452,15,47,0.319,17,21,0.81,100
1229,CHI,2016-11-12,106,,WAS,1,240,39,97,0.402,34,82,0.415,5,15,0.333,23,25,0.92,106,38,91,0.418,34,78,0.436,4,13,0.308,15,18,0.833,95
1230,DET,2016-11-12,106,@,DEN,1,240,46,90,0.511,42,72,0.583,4,18,0.222,10,14,0.714,106,36,84,0.429,27,59,0.458,9,25,0.36,14,19,0.737,95
1231,MIL,2016-11-10,106,,NOP,0,240,40,91,0.44,34,73,0.466,6,18,0.333,20,25,0.8,106,39,89,0.438,30,64,0.469,9,25,0.36,25,27,0.926,112
1232,CLE,2016-11-08,106,,ATL,0,240,37,99,0.374,26,57,0.456,11,42,0.262,21,25,0.84,106,41,81,0.506,30,52,0.577,11,29,0.379,17,24,0.708,110
1233,NOP,2016-11-07,106,@,GSW,0,240,39,80,0.488,32,59,0.542,7,21,0.333,21,27,0.778,106,45,90,0.5,29,55,0.527,16,35,0.457,10,12,0.833,116
1234,WAS,2016-11-07,106,,HOU,0,240,39,94,0.415,29,67,0.433,10,27,0.37,18,20,0.9,106,41,79,0.519,24,42,0.571,17,37,0.459,15,18,0.833,114
1235,UTA,2016-11-01,106,@,SAS,1,240,38,76,0.5,23,45,0.511,15,31,0.484,15,18,0.833,106,33,76,0.434,27,56,0.482,6,20,0.3,19,21,0.905,91
1236,ATL,2016-10-31,106,,SAC,1,240,33,79,0.418,22,49,0.449,11,30,0.367,29,47,0.617,106,36,75,0.48,26,52,0.5,10,23,0.435,13,19,0.684,95
1237,SAS,2016-10-30,106,@,MIA,1,240,37,82,0.451,27,64,0.422,10,18,0.556,22,26,0.846,106,37,80,0.463,30,60,0.5,7,20,0.35,18,26,0.692,99
1238,GSW,2016-10-30,106,@,PHO,1,240,35,83,0.422,27,54,0.5,8,29,0.276,28,33,0.848,106,37,90,0.411,29,67,0.433,8,23,0.348,18,25,0.72,100
1239,SAC,2016-10-29,106,,MIN,1,240,39,85,0.459,30,59,0.508,9,26,0.346,19,25,0.76,106,37,70,0.529,30,48,0.625,7,22,0.318,22,31,0.71,103
1240,HOU,2016-10-28,106,@,DAL,1,240,33,70,0.471,18,38,0.474,15,32,0.469,25,31,0.806,106,35,80,0.438,27,51,0.529,8,29,0.276,20,24,0.833,98
1241,POR,2016-10-27,106,,LAC,0,240,39,85,0.459,35,67,0.522,4,18,0.222,24,32,0.75,106,37,91,0.407,29,62,0.468,8,29,0.276,32,46,0.696,114
1242,OKC,2017-04-12,105,,DEN,0,240,43,101,0.426,35,76,0.461,8,25,0.32,11,17,0.647,105,39,85,0.459,32,60,0.533,7,25,0.28,26,32,0.813,111
1243,WAS,2017-04-10,105,@,DET,1,240,42,83,0.506,35,64,0.547,7,19,0.368,14,16,0.875,105,43,94,0.457,33,68,0.485,10,26,0.385,5,5,1.0,101
1244,UTA,2017-04-10,105,@,GSW,1,240,41,92,0.446,28,57,0.491,13,35,0.371,10,15,0.667,105,39,80,0.488,30,55,0.545,9,25,0.36,12,17,0.706,99
1245,BRK,2017-04-10,105,@,BOS,0,240,31,86,0.36,23,55,0.418,8,31,0.258,35,39,0.897,105,41,91,0.451,27,53,0.509,14,38,0.368,18,21,0.857,114
1246,DEN,2017-04-09,105,,OKC,0,240,40,84,0.476,29,50,0.58,11,34,0.324,14,15,0.933,105,40,96,0.417,34,71,0.479,6,25,0.24,20,22,0.909,106
1247,POR,2017-04-06,105,,MIN,1,240,35,81,0.432,21,48,0.438,14,33,0.424,21,26,0.808,105,38,87,0.437,34,69,0.493,4,18,0.222,18,20,0.9,98
1248,TOR,2017-04-05,105,@,DET,1,240,41,87,0.471,31,57,0.544,10,30,0.333,13,15,0.867,105,42,81,0.519,35,60,0.583,7,21,0.333,11,18,0.611,102
1249,MIL,2017-04-02,105,,DAL,0,240,39,77,0.506,27,43,0.628,12,34,0.353,15,18,0.833,105,38,73,0.521,24,37,0.649,14,36,0.389,19,20,0.95,109
1250,PHI,2017-04-02,105,@,TOR,0,240,36,80,0.45,25,44,0.568,11,36,0.306,22,25,0.88,105,46,85,0.541,40,66,0.606,6,19,0.316,15,19,0.789,113
1251,PHI,2017-03-31,105,@,CLE,0,240,40,82,0.488,29,49,0.592,11,33,0.333,14,19,0.737,105,50,95,0.526,37,66,0.561,13,29,0.448,9,16,0.563,122
1252,DET,2017-03-31,105,@,MIL,0,265,44,97,0.454,37,67,0.552,7,30,0.233,10,16,0.625,105,35,84,0.417,21,48,0.438,14,36,0.389,24,34,0.706,108
1253,MIA,2017-03-29,105,@,NYK,1,240,40,84,0.476,28,59,0.475,12,25,0.48,13,17,0.765,105,33,89,0.371,28,64,0.438,5,25,0.2,17,21,0.81,88
1254,CHO,2017-03-24,105,,CLE,0,240,38,90,0.422,28,52,0.538,10,38,0.263,19,24,0.792,105,41,74,0.554,32,49,0.653,9,25,0.36,21,24,0.875,112
1255,CHO,2017-03-20,105,,ATL,1,240,40,80,0.5,28,50,0.56,12,30,0.4,13,20,0.65,105,37,84,0.44,25,47,0.532,12,37,0.324,4,10,0.4,90
1256,NYK,2017-03-20,105,@,LAC,0,240,40,89,0.449,34,65,0.523,6,24,0.25,19,24,0.792,105,43,87,0.494,33,56,0.589,10,31,0.323,18,24,0.75,114
1257,PHI,2017-03-19,105,,BOS,1,240,41,88,0.466,29,55,0.527,12,33,0.364,11,15,0.733,105,34,84,0.405,28,55,0.509,6,29,0.207,25,29,0.862,99
1258,DEN,2017-03-18,105,,HOU,0,240,38,89,0.427,28,58,0.483,10,31,0.323,19,30,0.633,105,38,83,0.458,33,59,0.559,5,24,0.208,28,35,0.8,109
1259,MIN,2017-03-17,105,@,MIA,0,240,41,82,0.5,39,70,0.557,2,12,0.167,21,22,0.955,105,50,85,0.588,42,59,0.712,8,26,0.308,15,19,0.789,123
1260,DEN,2017-03-11,105,@,SAC,1,240,40,85,0.471,31,51,0.608,9,34,0.265,16,18,0.889,105,36,82,0.439,28,59,0.475,8,23,0.348,12,20,0.6,92
1261,ATL,2017-03-10,105,,TOR,1,240,39,75,0.52,31,53,0.585,8,22,0.364,19,29,0.655,105,37,92,0.402,33,67,0.493,4,25,0.16,21,27,0.778,99
1262,DAL,2017-03-10,105,,BRK,1,240,33,78,0.423,19,45,0.422,14,33,0.424,25,28,0.893,105,34,78,0.436,25,47,0.532,9,31,0.29,19,23,0.826,96
1263,BRK,2017-03-08,105,@,ATL,0,240,37,80,0.463,26,47,0.553,11,33,0.333,20,25,0.8,105,41,95,0.432,37,75,0.493,4,20,0.2,24,32,0.75,110
1264,ORL,2017-03-06,105,,NYK,0,240,40,85,0.471,31,53,0.585,9,32,0.281,16,24,0.667,105,40,86,0.465,34,72,0.472,6,14,0.429,27,28,0.964,113
1265,NOP,2017-03-05,105,@,LAL,1,240,36,89,0.404,27,65,0.415,9,24,0.375,24,35,0.686,105,38,83,0.458,28,55,0.509,10,28,0.357,11,15,0.733,97
1266,NYK,2017-03-05,105,,GSW,0,240,39,83,0.47,32,61,0.525,7,22,0.318,20,25,0.8,105,40,88,0.455,27,53,0.509,13,35,0.371,19,23,0.826,112
1267,PHI,2017-03-03,105,,NYK,1,240,36,83,0.434,27,55,0.491,9,28,0.321,24,31,0.774,105,33,84,0.393,26,63,0.413,7,21,0.333,29,33,0.879,102
1268,WAS,2017-03-01,105,@,TOR,1,240,40,84,0.476,31,59,0.525,9,25,0.36,16,19,0.842,105,33,90,0.367,26,70,0.371,7,20,0.35,23,26,0.885,96
1269,MEM,2017-02-26,105,@,DEN,1,240,36,80,0.45,25,47,0.532,11,33,0.333,22,25,0.88,105,37,84,0.44,26,50,0.52,11,34,0.324,13,17,0.765,98
1270,ORL,2017-02-25,105,,ATL,1,240,37,81,0.457,29,54,0.537,8,27,0.296,23,24,0.958,105,32,85,0.376,24,60,0.4,8,25,0.32,14,26,0.538,86
1271,SAS,2017-02-24,105,@,LAC,1,240,35,82,0.427,26,56,0.464,9,26,0.346,26,30,0.867,105,35,79,0.443,28,56,0.5,7,23,0.304,20,24,0.833,97
1272,NYK,2017-02-15,105,@,OKC,0,240,41,86,0.477,30,65,0.462,11,21,0.524,12,14,0.857,105,41,88,0.466,29,65,0.446,12,23,0.522,22,31,0.71,116
1273,CHI,2017-02-14,105,,TOR,1,240,35,73,0.479,28,56,0.5,7,17,0.412,28,35,0.8,105,35,77,0.455,30,57,0.526,5,20,0.25,19,24,0.792,94
1274,PHI,2017-02-13,105,@,CHO,1,240,41,86,0.477,29,53,0.547,12,33,0.364,11,17,0.647,105,34,78,0.436,23,47,0.489,11,31,0.355,20,26,0.769,99
1275,SAC,2017-02-12,105,,NOP,1,240,35,78,0.449,24,47,0.511,11,31,0.355,24,27,0.889,105,34,82,0.415,21,51,0.412,13,31,0.419,18,21,0.857,99
1276,UTA,2017-02-09,105,@,DAL,0,265,39,85,0.459,26,56,0.464,13,29,0.448,14,17,0.824,105,44,87,0.506,39,67,0.582,5,20,0.25,19,25,0.76,112
1277,OKC,2017-02-05,105,,POR,1,240,40,98,0.408,36,80,0.45,4,18,0.222,21,28,0.75,105,35,87,0.402,25,59,0.424,10,28,0.357,19,21,0.905,99
1278,IND,2017-02-04,105,,DET,1,240,44,91,0.484,37,67,0.552,7,24,0.292,10,15,0.667,105,31,75,0.413,25,58,0.431,6,17,0.353,16,20,0.8,84
1279,WAS,2017-02-04,105,,NOP,1,240,38,83,0.458,28,52,0.538,10,31,0.323,19,22,0.864,105,37,84,0.44,32,67,0.478,5,17,0.294,12,22,0.545,91
1280,UTA,2017-02-04,105,,CHO,1,240,38,81,0.469,25,48,0.521,13,33,0.394,16,24,0.667,105,35,82,0.427,22,49,0.449,13,33,0.394,15,18,0.833,98
1281,PHO,2017-02-03,105,@,SAC,1,240,32,77,0.416,20,48,0.417,12,29,0.414,29,35,0.829,105,38,85,0.447,28,58,0.483,10,27,0.37,17,22,0.773,103
1282,HOU,2017-01-31,105,,SAC,1,240,38,85,0.447,24,40,0.6,14,45,0.311,15,22,0.682,105,30,86,0.349,22,57,0.386,8,29,0.276,15,26,0.577,83
1283,ORL,2017-01-30,105,@,MIN,0,265,41,96,0.427,31,61,0.508,10,35,0.286,13,19,0.684,105,40,91,0.44,28,62,0.452,12,29,0.414,19,26,0.731,111
1284,DAL,2017-01-29,105,@,SAS,1,240,39,87,0.448,27,53,0.509,12,34,0.353,15,16,0.938,105,39,83,0.47,31,61,0.508,8,22,0.364,15,23,0.652,101
1285,NOP,2017-01-25,105,,OKC,0,240,41,96,0.427,30,69,0.435,11,27,0.407,12,19,0.632,105,42,91,0.462,32,64,0.5,10,27,0.37,20,28,0.714,114
1286,POR,2017-01-25,105,,LAL,1,240,43,90,0.478,39,75,0.52,4,15,0.267,15,20,0.75,105,37,94,0.394,26,64,0.406,11,30,0.367,13,14,0.929,98
1287,ATL,2017-01-23,105,,LAC,0,240,37,88,0.42,28,59,0.475,9,29,0.31,22,26,0.846,105,42,84,0.5,28,60,0.467,14,24,0.583,17,22,0.773,115
1288,MIA,2017-01-23,105,,GSW,1,240,38,86,0.442,25,56,0.446,13,30,0.433,16,27,0.593,105,41,88,0.466,33,58,0.569,8,30,0.267,12,20,0.6,102
1289,BRK,2017-01-21,105,@,CHO,0,240,38,88,0.432,21,47,0.447,17,41,0.415,12,15,0.8,105,39,82,0.476,25,52,0.481,14,30,0.467,20,22,0.909,112
1290,NYK,2017-01-21,105,,PHO,0,240,40,89,0.449,29,68,0.426,11,21,0.524,14,16,0.875,105,37,85,0.435,28,61,0.459,9,24,0.375,24,27,0.889,107
1291,SAS,2017-01-14,105,@,PHO,0,240,36,71,0.507,27,51,0.529,9,20,0.45,24,34,0.706,105,39,85,0.459,31,64,0.484,8,21,0.381,22,24,0.917,108
1292,HOU,2017-01-13,105,,MEM,0,240,33,82,0.402,23,41,0.561,10,41,0.244,29,36,0.806,105,41,76,0.539,31,49,0.633,10,27,0.37,18,27,0.667,110
1293,LAC,2017-01-11,105,,ORL,1,240,39,76,0.513,30,50,0.6,9,26,0.346,18,26,0.692,105,39,92,0.424,33,65,0.508,6,27,0.222,12,18,0.667,96
1294,HOU,2017-01-11,105,@,MIN,0,240,36,87,0.414,21,45,0.467,15,42,0.357,18,22,0.818,105,44,81,0.543,36,58,0.621,8,23,0.348,23,25,0.92,119
1295,PHI,2017-01-08,105,@,BRK,1,240,37,94,0.394,29,67,0.433,8,27,0.296,23,27,0.852,105,36,78,0.462,26,51,0.51,10,27,0.37,13,17,0.765,95
1296,MIN,2017-01-06,105,@,WAS,0,240,42,88,0.477,35,70,0.5,7,18,0.389,14,17,0.824,105,46,79,0.582,34,57,0.596,12,22,0.545,8,9,0.889,112
1297,MIL,2017-01-04,105,@,NYK,1,240,37,78,0.474,28,50,0.56,9,28,0.321,22,31,0.71,105,42,94,0.447,29,66,0.439,13,28,0.464,7,12,0.583,104
1298,WAS,2017-01-03,105,@,DAL,0,240,41,92,0.446,30,62,0.484,11,30,0.367,12,14,0.857,105,37,78,0.474,20,46,0.435,17,32,0.531,22,24,0.917,113
1299,ATL,2016-12-30,105,,DET,1,240,39,88,0.443,31,62,0.5,8,26,0.308,19,25,0.76,105,35,84,0.417,26,53,0.491,9,31,0.29,19,21,0.905,98
1300,DEN,2016-12-28,105,,MIN,1,240,42,81,0.519,32,53,0.604,10,28,0.357,11,14,0.786,105,42,94,0.447,35,69,0.507,7,25,0.28,12,17,0.706,103
1301,IND,2016-12-28,105,@,WAS,0,240,35,79,0.443,24,51,0.471,11,28,0.393,24,29,0.828,105,38,78,0.487,30,56,0.536,8,22,0.364,27,37,0.73,111
1302,MIN,2016-12-23,105,,SAC,0,240,36,79,0.456,24,47,0.511,12,32,0.375,21,26,0.808,105,42,80,0.525,27,51,0.529,15,29,0.517,10,14,0.714,109
1303,WAS,2016-12-19,105,@,IND,0,240,38,88,0.432,30,55,0.545,8,33,0.242,21,26,0.808,105,41,87,0.471,34,66,0.515,7,21,0.333,18,21,0.857,107
1304,BOS,2016-12-18,105,@,MIA,1,240,41,90,0.456,32,62,0.516,9,28,0.321,14,19,0.737,105,36,69,0.522,27,45,0.6,9,24,0.375,14,25,0.56,95
1305,IND,2016-12-17,105,@,DET,1,240,40,83,0.482,34,64,0.531,6,19,0.316,19,25,0.76,105,32,84,0.381,22,54,0.407,10,30,0.333,16,22,0.727,90
1306,MIL,2016-12-10,105,@,WAS,0,240,40,79,0.506,27,54,0.5,13,25,0.52,12,15,0.8,105,40,88,0.455,32,67,0.478,8,21,0.381,22,28,0.786,110
1307,CHO,2016-12-10,105,@,CLE,0,240,39,86,0.453,29,59,0.492,10,27,0.37,17,24,0.708,105,42,73,0.575,29,42,0.69,13,31,0.419,19,28,0.679,116
1308,NOP,2016-12-10,105,@,LAC,0,240,40,83,0.482,32,64,0.5,8,19,0.421,17,26,0.654,105,54,94,0.574,37,58,0.638,17,36,0.472,8,9,0.889,133
1309,CHI,2016-12-10,105,,MIA,1,240,38,84,0.452,37,76,0.487,1,8,0.125,28,31,0.903,105,42,91,0.462,37,71,0.521,5,20,0.25,11,18,0.611,100
1310,PHO,2016-12-06,105,@,UTA,0,240,39,84,0.464,33,66,0.5,6,18,0.333,21,25,0.84,105,36,73,0.493,24,46,0.522,12,27,0.444,28,32,0.875,112
1311,SAS,2016-12-06,105,@,MIN,1,240,39,74,0.527,28,50,0.56,11,24,0.458,16,19,0.842,105,36,82,0.439,29,62,0.468,7,20,0.35,12,18,0.667,91
1312,UTA,2016-12-03,105,,DEN,1,240,35,78,0.449,26,53,0.491,9,25,0.36,26,28,0.929,105,37,83,0.446,24,59,0.407,13,24,0.542,11,14,0.786,98
1313,WAS,2016-12-02,105,@,SAS,0,240,41,81,0.506,34,70,0.486,7,11,0.636,16,18,0.889,105,39,80,0.488,31,60,0.517,8,20,0.4,21,33,0.636,107
1314,ORL,2016-12-02,105,@,PHI,1,240,37,78,0.474,24,52,0.462,13,26,0.5,18,26,0.692,105,36,95,0.379,27,63,0.429,9,32,0.281,7,10,0.7,88
1315,CLE,2016-12-02,105,@,CHI,0,240,45,83,0.542,35,57,0.614,10,26,0.385,5,10,0.5,105,47,96,0.49,44,78,0.564,3,18,0.167,14,17,0.824,111
1316,MEM,2016-11-30,105,@,TOR,0,240,36,82,0.439,25,55,0.455,11,27,0.407,22,26,0.846,105,38,69,0.551,22,37,0.595,16,32,0.5,28,33,0.848,120
1317,NOP,2016-11-29,105,,LAL,1,240,38,88,0.432,30,57,0.526,8,31,0.258,21,25,0.84,105,37,87,0.425,32,57,0.561,5,30,0.167,9,18,0.5,88
1318,GSW,2016-11-28,105,,ATL,1,240,37,85,0.435,25,50,0.5,12,35,0.343,19,24,0.792,105,36,85,0.424,29,56,0.518,7,29,0.241,21,30,0.7,100
1319,BRK,2016-11-27,105,,SAC,0,240,38,87,0.437,22,47,0.468,16,40,0.4,13,14,0.929,105,46,86,0.535,33,63,0.524,13,23,0.565,17,22,0.773,122
1320,TOR,2016-11-25,105,@,MIL,1,240,38,82,0.463,24,50,0.48,14,32,0.438,15,19,0.789,105,40,79,0.506,28,50,0.56,12,29,0.414,7,12,0.583,99
1321,CHI,2016-11-25,105,@,PHI,1,240,40,90,0.444,34,69,0.493,6,21,0.286,19,26,0.731,105,31,78,0.397,22,56,0.393,9,22,0.409,18,22,0.818,89
1322,MEM,2016-11-21,105,@,CHO,1,240,40,84,0.476,28,58,0.483,12,26,0.462,13,17,0.765,105,30,73,0.411,21,42,0.5,9,31,0.29,21,33,0.636,90
1323,DEN,2016-11-20,105,,UTA,1,240,42,86,0.488,34,64,0.531,8,22,0.364,13,30,0.433,105,33,85,0.388,26,58,0.448,7,27,0.259,18,23,0.783,91
1324,PHO,2016-11-19,105,@,PHI,0,240,39,92,0.424,33,71,0.465,6,21,0.286,21,34,0.618,105,45,86,0.523,28,51,0.549,17,35,0.486,13,20,0.65,120
1325,BRK,2016-11-18,105,@,OKC,0,240,35,83,0.422,24,54,0.444,11,29,0.379,24,30,0.8,105,49,89,0.551,42,63,0.667,7,26,0.269,19,24,0.792,124
1326,NYK,2016-11-16,105,,DET,1,240,42,93,0.452,33,68,0.485,9,25,0.36,12,19,0.632,105,42,85,0.494,34,62,0.548,8,23,0.348,10,12,0.833,102
1327,SAC,2016-11-16,105,,SAS,0,240,36,76,0.474,27,56,0.482,9,20,0.45,24,31,0.774,105,43,88,0.489,32,58,0.552,11,30,0.367,13,17,0.765,110
1328,OKC,2016-11-16,105,,HOU,1,240,40,84,0.476,28,59,0.475,12,25,0.48,13,14,0.929,105,40,92,0.435,26,52,0.5,14,40,0.35,9,14,0.643,103
1329,BOS,2016-11-14,105,@,NOP,0,240,38,95,0.4,26,54,0.481,12,41,0.293,17,20,0.85,105,35,79,0.443,29,58,0.5,6,21,0.286,30,36,0.833,106
1330,DEN,2016-11-13,105,@,POR,0,240,36,91,0.396,25,62,0.403,11,29,0.379,22,29,0.759,105,39,99,0.394,31,70,0.443,8,29,0.276,26,32,0.813,112
1331,BOS,2016-11-12,105,@,IND,1,240,35,80,0.438,27,55,0.491,8,25,0.32,27,33,0.818,105,36,86,0.419,30,59,0.508,6,27,0.222,21,28,0.75,99
1332,MIN,2016-11-12,105,,LAC,0,240,40,89,0.449,32,67,0.478,8,22,0.364,17,21,0.81,105,40,76,0.526,29,52,0.558,11,24,0.458,28,37,0.757,119
1333,IND,2016-11-11,105,@,PHI,0,265,39,88,0.443,34,69,0.493,5,19,0.263,22,23,0.957,105,36,86,0.419,25,54,0.463,11,32,0.344,26,31,0.839,109
1334,CLE,2016-11-11,105,@,WAS,1,240,36,86,0.419,22,53,0.415,14,33,0.424,19,26,0.731,105,38,87,0.437,35,72,0.486,3,15,0.2,15,19,0.789,94
1335,POR,2016-11-04,105,@,DAL,1,240,36,80,0.45,24,49,0.49,12,31,0.387,21,26,0.808,105,34,83,0.41,24,55,0.436,10,28,0.357,17,20,0.85,95
1336,TOR,2016-10-31,105,,DEN,1,240,41,88,0.466,37,72,0.514,4,16,0.25,19,25,0.76,105,33,81,0.407,24,59,0.407,9,22,0.409,27,35,0.771,102
1337,CLE,2016-10-29,105,,ORL,1,240,36,88,0.409,25,51,0.49,11,37,0.297,22,30,0.733,105,38,84,0.452,30,56,0.536,8,28,0.286,15,26,0.577,99
1338,CHI,2016-10-27,105,,BOS,1,240,36,92,0.391,25,67,0.373,11,25,0.44,22,30,0.733,105,38,76,0.5,30,53,0.566,8,23,0.348,15,24,0.625,99
1339,IND,2017-04-12,104,,ATL,1,240,39,82,0.476,29,58,0.5,10,24,0.417,16,19,0.842,104,30,72,0.417,19,43,0.442,11,29,0.379,15,19,0.789,86
1340,PHO,2017-04-11,104,@,SAC,0,240,41,109,0.376,33,79,0.418,8,30,0.267,14,24,0.583,104,43,83,0.518,34,64,0.531,9,19,0.474,34,43,0.791,129
1341,IND,2017-04-06,104,,MIL,1,240,38,80,0.475,30,55,0.545,8,25,0.32,20,26,0.769,104,33,71,0.465,22,47,0.468,11,24,0.458,12,14,0.857,89
1342,DEN,2017-04-05,104,@,HOU,0,240,41,104,0.394,34,66,0.515,7,38,0.184,15,18,0.833,104,37,87,0.425,27,53,0.509,10,34,0.294,26,38,0.684,110
1343,LAL,2017-04-01,104,@,LAC,0,240,39,90,0.433,33,67,0.493,6,23,0.261,20,30,0.667,104,38,69,0.551,27,44,0.614,11,25,0.44,28,34,0.824,115
1344,ATL,2017-04-01,104,@,CHI,0,240,40,90,0.444,29,62,0.468,11,28,0.393,13,17,0.765,104,40,85,0.471,28,55,0.509,12,30,0.4,14,14,1.0,106
1345,LAL,2017-03-30,104,@,MIN,0,240,40,84,0.476,31,57,0.544,9,27,0.333,15,16,0.938,104,43,89,0.483,33,68,0.485,10,21,0.476,23,30,0.767,119
1346,WAS,2017-03-22,104,,ATL,1,240,38,95,0.4,27,61,0.443,11,34,0.324,17,23,0.739,104,34,86,0.395,26,61,0.426,8,25,0.32,24,29,0.828,100
1347,BRK,2017-03-19,104,,DAL,0,240,31,72,0.431,18,41,0.439,13,31,0.419,29,38,0.763,104,41,76,0.539,31,51,0.608,10,25,0.4,19,25,0.76,111
1348,MIA,2017-03-19,104,,POR,0,240,41,88,0.466,32,58,0.552,9,30,0.3,13,20,0.65,104,42,83,0.506,29,57,0.509,13,26,0.5,18,24,0.75,115
1349,MEM,2017-03-18,104,,SAS,1,240,32,76,0.421,19,46,0.413,13,30,0.433,27,31,0.871,104,33,75,0.44,24,47,0.511,9,28,0.321,21,22,0.955,96
1350,MIN,2017-03-15,104,@,BOS,0,240,40,91,0.44,32,64,0.5,8,27,0.296,16,20,0.8,104,43,79,0.544,30,46,0.652,13,33,0.394,18,21,0.857,117
1351,BRK,2017-03-14,104,,OKC,0,240,33,71,0.465,21,47,0.447,12,24,0.5,26,30,0.867,104,44,89,0.494,34,67,0.507,10,22,0.455,24,34,0.706,122
1352,PHI,2017-03-14,104,@,GSW,0,240,39,89,0.438,31,62,0.5,8,27,0.296,18,27,0.667,104,32,88,0.364,18,56,0.321,14,32,0.438,28,35,0.8,106
1353,WAS,2017-03-13,104,@,MIN,0,240,36,84,0.429,29,58,0.5,7,26,0.269,25,31,0.806,104,45,86,0.523,35,65,0.538,10,21,0.476,19,22,0.864,119
1354,UTA,2017-03-11,104,@,OKC,0,240,36,75,0.48,27,55,0.491,9,20,0.45,23,28,0.821,104,43,86,0.5,35,63,0.556,8,23,0.348,18,24,0.75,112
1355,MIA,2017-03-11,104,,TOR,1,240,35,72,0.486,24,44,0.545,11,28,0.393,23,33,0.697,104,33,88,0.375,31,73,0.425,2,15,0.133,21,25,0.84,89
1356,ORL,2017-03-11,104,,CLE,0,240,38,96,0.396,34,75,0.453,4,21,0.19,24,28,0.857,104,43,86,0.5,28,47,0.596,15,39,0.385,15,25,0.6,116
1357,SAC,2017-03-08,104,@,SAS,0,240,42,86,0.488,35,67,0.522,7,19,0.368,13,16,0.813,104,42,84,0.5,28,55,0.509,14,29,0.483,16,21,0.762,114
1358,MIL,2017-03-08,104,,NYK,1,240,37,86,0.43,29,60,0.483,8,26,0.308,22,28,0.786,104,39,84,0.464,32,63,0.508,7,21,0.333,8,12,0.667,93
1359,DAL,2017-03-05,104,,OKC,1,240,42,86,0.488,35,61,0.574,7,25,0.28,13,16,0.813,104,33,82,0.402,31,60,0.517,2,22,0.091,21,30,0.7,89
1360,DAL,2017-03-03,104,,MEM,1,240,39,82,0.476,34,55,0.618,5,27,0.185,21,27,0.778,104,38,82,0.463,29,54,0.537,9,28,0.321,15,22,0.682,100
1361,LAL,2017-02-28,104,,CHO,0,240,41,84,0.488,29,52,0.558,12,32,0.375,10,13,0.769,104,38,85,0.447,22,46,0.478,16,39,0.41,17,24,0.708,109
1362,BOS,2017-02-26,104,@,DET,1,240,34,85,0.4,22,50,0.44,12,35,0.343,24,30,0.8,104,35,81,0.432,23,48,0.479,12,33,0.364,16,35,0.457,98
1363,NYK,2017-02-23,104,@,CLE,0,240,42,101,0.416,34,75,0.453,8,26,0.308,12,17,0.706,104,46,87,0.529,31,49,0.633,15,38,0.395,12,15,0.8,119
1364,CHI,2017-02-16,104,,BOS,1,240,38,90,0.422,32,65,0.492,6,25,0.24,22,22,1.0,104,36,77,0.468,22,40,0.55,14,37,0.378,17,20,0.85,103
1365,IND,2017-02-15,104,@,CLE,0,240,40,86,0.465,28,62,0.452,12,24,0.5,12,14,0.857,104,39,82,0.476,21,43,0.488,18,39,0.462,17,19,0.895,113
1366,POR,2017-02-13,104,,ATL,0,265,37,103,0.359,21,61,0.344,16,42,0.381,14,25,0.56,104,32,83,0.386,24,55,0.436,8,28,0.286,37,48,0.771,109
1367,UTA,2017-02-11,104,,BOS,0,240,35,86,0.407,27,55,0.491,8,31,0.258,26,30,0.867,104,42,71,0.592,29,41,0.707,13,30,0.433,15,23,0.652,112
1368,ORL,2017-02-07,104,@,HOU,0,240,42,88,0.477,36,63,0.571,6,25,0.24,14,20,0.7,104,44,89,0.494,28,51,0.549,16,38,0.421,24,36,0.667,128
1369,NYK,2017-02-04,104,,CLE,0,240,39,86,0.453,27,55,0.491,12,31,0.387,14,28,0.5,104,41,84,0.488,25,44,0.568,16,40,0.4,13,18,0.722,111
1370,POR,2017-02-03,104,,DAL,0,240,40,88,0.455,31,58,0.534,9,30,0.3,15,20,0.75,104,36,76,0.474,19,45,0.422,17,31,0.548,19,23,0.826,108
1371,UTA,2017-02-01,104,,MIL,1,240,36,78,0.462,25,49,0.51,11,29,0.379,21,27,0.778,104,32,73,0.438,23,50,0.46,9,23,0.391,15,25,0.6,88
1372,TOR,2017-02-01,104,@,BOS,0,240,41,78,0.526,33,47,0.702,8,31,0.258,14,25,0.56,104,36,87,0.414,24,51,0.471,12,36,0.333,25,30,0.833,109
1373,DAL,2017-01-30,104,,CLE,1,240,39,86,0.453,30,54,0.556,9,32,0.281,17,18,0.944,104,35,75,0.467,23,43,0.535,12,32,0.375,15,21,0.714,97
1374,MIA,2017-01-30,104,,BRK,1,240,39,82,0.476,28,56,0.5,11,26,0.423,15,23,0.652,104,37,87,0.425,33,61,0.541,4,26,0.154,18,22,0.818,96
1375,DET,2017-01-23,104,,SAC,0,240,41,82,0.5,31,54,0.574,10,28,0.357,12,17,0.706,104,40,82,0.488,31,61,0.508,9,21,0.429,20,26,0.769,109
1376,MIN,2017-01-19,104,@,LAC,1,240,40,84,0.476,35,68,0.515,5,16,0.313,19,25,0.76,104,42,87,0.483,38,65,0.585,4,22,0.182,13,24,0.542,101
1377,DEN,2017-01-19,104,@,SAS,0,240,37,91,0.407,27,60,0.45,10,31,0.323,20,26,0.769,104,44,86,0.512,35,64,0.547,9,22,0.409,21,25,0.84,118
1378,WAS,2017-01-18,104,,MEM,1,240,36,80,0.45,28,51,0.549,8,29,0.276,24,26,0.923,104,33,83,0.398,25,58,0.431,8,25,0.32,27,34,0.794,101
1379,MIL,2017-01-16,104,,PHI,0,240,42,89,0.472,37,75,0.493,5,14,0.357,15,22,0.682,104,35,78,0.449,21,41,0.512,14,37,0.378,29,36,0.806,113
1380,MEM,2017-01-15,104,,CHI,0,240,40,95,0.421,29,63,0.46,11,32,0.344,13,13,1.0,104,40,78,0.513,36,61,0.59,4,17,0.235,24,35,0.686,108
1381,NYK,2017-01-12,104,,CHI,1,240,44,92,0.478,37,69,0.536,7,23,0.304,9,11,0.818,104,35,89,0.393,32,71,0.451,3,18,0.167,16,21,0.762,89
1382,NOP,2017-01-12,104,@,BRK,1,240,38,90,0.422,27,58,0.466,11,32,0.344,17,25,0.68,104,40,97,0.412,31,55,0.564,9,42,0.214,6,11,0.545,95
1383,NYK,2017-01-04,104,,MIL,0,240,42,94,0.447,29,66,0.439,13,28,0.464,7,12,0.583,104,37,78,0.474,28,50,0.56,9,28,0.321,22,31,0.71,105
1384,UTA,2017-01-03,104,@,BOS,0,240,38,82,0.463,27,56,0.482,11,26,0.423,17,21,0.81,104,41,74,0.554,24,43,0.558,17,31,0.548,16,17,0.941,115
1385,ORL,2017-01-01,104,@,IND,0,240,42,97,0.433,32,59,0.542,10,38,0.263,10,11,0.909,104,43,86,0.5,34,64,0.531,9,22,0.409,22,24,0.917,117
1386,NOP,2016-12-30,104,,NYK,1,240,38,85,0.447,26,56,0.464,12,29,0.414,16,17,0.941,104,35,93,0.376,28,70,0.4,7,23,0.304,15,16,0.938,92
1387,MIN,2016-12-26,104,,ATL,1,240,37,82,0.451,22,51,0.431,15,31,0.484,15,18,0.833,104,35,83,0.422,27,51,0.529,8,32,0.25,12,17,0.706,90
1388,DAL,2016-12-26,104,@,NOP,0,240,37,75,0.493,24,43,0.558,13,32,0.406,17,22,0.773,104,37,70,0.529,25,45,0.556,12,25,0.48,25,30,0.833,111
1389,TOR,2016-12-23,104,@,UTA,1,240,43,81,0.531,35,60,0.583,8,21,0.381,10,15,0.667,104,35,79,0.443,25,52,0.481,10,27,0.37,18,21,0.857,98
1390,GSW,2016-12-20,104,,UTA,1,240,40,90,0.444,31,67,0.463,9,23,0.391,15,17,0.882,104,27,76,0.355,18,46,0.391,9,30,0.3,11,20,0.55,74
1391,BRK,2016-12-20,104,@,TOR,0,240,36,91,0.396,26,56,0.464,10,35,0.286,22,28,0.786,104,42,91,0.462,34,73,0.466,8,18,0.444,24,31,0.774,116
1392,UTA,2016-12-10,104,,SAC,1,240,37,77,0.481,24,48,0.5,13,29,0.448,17,18,0.944,104,34,90,0.378,25,64,0.391,9,26,0.346,7,13,0.538,84
1393,MIN,2016-11-30,104,,NYK,0,240,34,77,0.442,30,58,0.517,4,19,0.211,32,39,0.821,104,41,91,0.451,28,59,0.475,13,32,0.406,11,15,0.733,106
1394,CHO,2016-11-28,104,@,MEM,1,240,36,82,0.439,27,56,0.482,9,26,0.346,23,31,0.742,104,36,89,0.404,29,60,0.483,7,29,0.241,6,13,0.462,85
1395,MIA,2016-11-28,104,,BOS,0,240,38,80,0.475,32,50,0.64,6,30,0.2,22,32,0.688,104,40,83,0.482,29,56,0.518,11,27,0.407,21,26,0.808,112
1396,MIL,2016-11-27,104,@,ORL,1,240,41,86,0.477,33,62,0.532,8,24,0.333,14,20,0.7,104,38,92,0.413,31,64,0.484,7,28,0.25,13,17,0.765,96
1397,SAC,2016-11-25,104,,HOU,0,240,39,80,0.488,30,48,0.625,9,32,0.281,17,21,0.81,104,40,85,0.471,19,35,0.543,21,50,0.42,16,20,0.8,117
1398,NOP,2016-11-25,104,@,POR,0,240,36,76,0.474,23,53,0.434,13,23,0.565,19,29,0.655,104,47,100,0.47,35,68,0.515,12,32,0.375,13,17,0.765,119
1399,DAL,2016-11-23,104,,LAC,0,240,38,84,0.452,27,60,0.45,11,24,0.458,17,18,0.944,104,43,85,0.506,28,53,0.528,15,32,0.469,23,31,0.742,124
1400,MEM,2016-11-23,104,@,PHI,1,290,38,99,0.384,28,70,0.4,10,29,0.345,18,24,0.75,104,35,93,0.376,23,57,0.404,12,36,0.333,17,23,0.739,99
1401,NYK,2016-11-20,104,,ATL,1,240,42,88,0.477,32,61,0.525,10,27,0.37,10,14,0.714,104,34,85,0.4,28,64,0.438,6,21,0.286,20,29,0.69,94
1402,CLE,2016-11-18,104,,DET,1,240,40,83,0.482,29,58,0.5,11,25,0.44,13,14,0.929,104,29,93,0.312,23,74,0.311,6,19,0.316,17,20,0.85,81
1403,GSW,2016-11-18,104,@,BOS,1,240,44,90,0.489,35,62,0.565,9,28,0.321,7,12,0.583,104,31,83,0.373,20,51,0.392,11,32,0.344,15,19,0.789,88
1404,PHO,2016-11-16,104,@,DEN,0,240,39,79,0.494,31,59,0.525,8,20,0.4,18,29,0.621,104,45,93,0.484,37,76,0.487,8,17,0.471,22,24,0.917,120
1405,DET,2016-11-14,104,,OKC,1,240,43,92,0.467,38,76,0.5,5,16,0.313,13,16,0.813,104,33,88,0.375,28,61,0.459,5,27,0.185,17,22,0.773,88
1406,PHO,2016-11-12,104,,BRK,0,240,40,107,0.374,32,74,0.432,8,33,0.242,16,21,0.762,104,40,84,0.476,24,47,0.511,16,37,0.432,26,30,0.867,122
1407,CHO,2016-11-09,104,,UTA,1,240,38,82,0.463,30,56,0.536,8,26,0.308,20,29,0.69,104,38,82,0.463,30,48,0.625,8,34,0.235,14,18,0.778,98
1408,CHI,2016-11-04,104,,NYK,0,240,37,84,0.44,29,61,0.475,8,23,0.348,22,27,0.815,104,46,89,0.517,37,68,0.544,9,21,0.429,16,21,0.762,117
1409,POR,2016-11-01,104,,GSW,0,240,37,86,0.43,23,47,0.489,14,39,0.359,16,21,0.762,104,50,89,0.562,40,63,0.635,10,26,0.385,17,23,0.739,127
1410,BOS,2016-10-29,104,@,CHO,1,240,39,81,0.481,24,50,0.48,15,31,0.484,11,17,0.647,104,32,79,0.405,23,47,0.489,9,32,0.281,25,33,0.758,98
1411,ATL,2016-10-29,104,@,PHI,1,240,42,85,0.494,37,65,0.569,5,20,0.25,15,23,0.652,104,28,80,0.35,23,62,0.371,5,18,0.278,11,15,0.733,72
1412,MEM,2016-10-29,104,@,NYK,0,240,37,86,0.43,28,61,0.459,9,25,0.36,21,26,0.808,104,40,76,0.526,34,55,0.618,6,21,0.286,25,39,0.641,111
1413,UTA,2016-10-25,104,@,POR,0,240,40,82,0.488,32,58,0.552,8,24,0.333,16,16,1.0,104,39,75,0.52,26,56,0.464,13,19,0.684,22,22,1.0,113
1414,NOP,2017-04-12,103,@,POR,1,240,40,90,0.444,32,66,0.485,8,24,0.333,15,21,0.714,103,41,85,0.482,28,55,0.509,13,30,0.433,5,13,0.385,100
1415,ATL,2017-04-11,103,,CHO,1,240,41,79,0.519,34,52,0.654,7,27,0.259,14,18,0.778,103,29,88,0.33,26,65,0.4,3,23,0.13,15,19,0.789,76
1416,DET,2017-04-09,103,@,MEM,1,240,39,82,0.476,25,54,0.463,14,28,0.5,11,16,0.688,103,36,75,0.48,27,54,0.5,9,21,0.429,9,13,0.692,90
1417,WAS,2017-04-08,103,,MIA,0,240,39,81,0.481,31,59,0.525,8,22,0.364,17,22,0.773,103,37,80,0.463,30,62,0.484,7,18,0.389,25,36,0.694,106
1418,NYK,2017-04-06,103,,WAS,0,240,40,95,0.421,33,75,0.44,7,20,0.35,16,21,0.762,103,36,74,0.486,22,40,0.55,14,34,0.412,20,28,0.714,106
1419,OKC,2017-04-05,103,@,MEM,1,240,37,85,0.435,23,54,0.426,14,31,0.452,15,24,0.625,103,37,78,0.474,28,52,0.538,9,26,0.346,17,21,0.81,100
1420,MEM,2017-04-02,103,@,LAL,0,240,40,80,0.5,27,50,0.54,13,30,0.433,10,14,0.714,103,40,85,0.471,33,66,0.5,7,19,0.368,21,27,0.778,108
1421,UTA,2017-04-02,103,@,SAS,0,240,43,89,0.483,34,65,0.523,9,24,0.375,8,13,0.615,103,40,77,0.519,30,58,0.517,10,19,0.526,19,22,0.864,109
1422,MIL,2017-03-29,103,@,BOS,1,240,41,78,0.526,33,56,0.589,8,22,0.364,13,17,0.765,103,35,88,0.398,23,51,0.451,12,37,0.324,18,23,0.783,100
1423,SAS,2017-03-27,103,,CLE,1,240,41,86,0.477,34,60,0.567,7,26,0.269,14,17,0.824,103,31,83,0.373,27,57,0.474,4,26,0.154,8,13,0.615,74
1424,PHO,2017-03-17,103,,ORL,0,240,38,87,0.437,36,73,0.493,2,14,0.143,25,30,0.833,103,42,96,0.438,35,73,0.479,7,23,0.304,18,21,0.857,109
1425,LAL,2017-03-17,103,,MIL,0,240,38,84,0.452,27,55,0.491,11,29,0.379,16,26,0.615,103,40,82,0.488,36,58,0.621,4,24,0.167,23,30,0.767,107
1426,MEM,2017-03-16,103,@,ATL,1,240,39,92,0.424,29,64,0.453,10,28,0.357,15,18,0.833,103,29,71,0.408,21,44,0.477,8,27,0.296,25,34,0.735,91
1427,MIN,2017-03-10,103,,GSW,1,240,39,88,0.443,35,74,0.473,4,14,0.286,21,27,0.778,103,41,88,0.466,34,64,0.531,7,24,0.292,13,17,0.765,102
1428,CHO,2017-03-02,103,@,PHO,0,240,35,89,0.393,25,55,0.455,10,34,0.294,23,28,0.821,103,46,77,0.597,39,58,0.672,7,19,0.368,21,25,0.84,120
1429,LAC,2017-03-01,103,,HOU,0,240,42,94,0.447,30,60,0.5,12,34,0.353,7,13,0.538,103,37,87,0.425,17,35,0.486,20,52,0.385,28,33,0.848,122
1430,BOS,2017-03-01,103,,CLE,1,240,36,78,0.462,23,47,0.489,13,31,0.419,18,23,0.783,103,37,91,0.407,27,58,0.466,10,33,0.303,15,22,0.682,99
1431,ORL,2017-02-23,103,,POR,0,240,34,86,0.395,27,64,0.422,7,22,0.318,28,39,0.718,103,41,81,0.506,32,63,0.508,9,18,0.5,21,27,0.778,112
1432,BOS,2017-02-16,103,@,CHI,0,240,36,77,0.468,22,40,0.55,14,37,0.378,17,20,0.85,103,38,90,0.422,32,65,0.492,6,25,0.24,22,22,1.0,104
1433,BRK,2017-02-13,103,,MEM,0,240,38,82,0.463,26,45,0.578,12,37,0.324,15,18,0.833,103,39,77,0.506,30,55,0.545,9,22,0.409,25,27,0.926,112
1434,SAS,2017-02-10,103,@,DET,1,240,41,82,0.5,32,63,0.508,9,19,0.474,12,15,0.8,103,39,92,0.424,34,75,0.453,5,17,0.294,9,13,0.692,92
1435,PHI,2017-02-08,103,,SAS,0,240,34,84,0.405,21,50,0.42,13,34,0.382,22,29,0.759,103,39,74,0.527,28,52,0.538,11,22,0.5,22,25,0.88,111
1436,TOR,2017-02-05,103,@,BRK,1,240,40,87,0.46,35,68,0.515,5,19,0.263,18,20,0.9,103,32,76,0.421,19,42,0.452,13,34,0.382,18,21,0.857,95
1437,SAC,2017-02-03,103,,PHO,0,240,38,85,0.447,28,58,0.483,10,27,0.37,17,22,0.773,103,32,77,0.416,20,48,0.417,12,29,0.414,29,35,0.829,105
1438,DET,2017-01-28,103,@,MIA,0,240,46,89,0.517,42,77,0.545,4,12,0.333,7,12,0.583,103,42,80,0.525,28,52,0.538,14,28,0.5,18,23,0.783,116
1439,SAS,2017-01-27,103,@,NOP,0,240,33,85,0.388,21,57,0.368,12,28,0.429,25,29,0.862,103,48,93,0.516,35,63,0.556,13,30,0.433,10,14,0.714,119
1440,MIN,2017-01-26,103,,IND,0,240,36,81,0.444,26,54,0.481,10,27,0.37,21,27,0.778,103,42,81,0.519,32,63,0.508,10,18,0.556,15,17,0.882,109
1441,CHO,2017-01-25,103,,GSW,0,240,38,92,0.413,31,69,0.449,7,23,0.304,20,21,0.952,103,39,82,0.476,28,54,0.519,11,28,0.393,24,27,0.889,113
1442,DAL,2017-01-25,103,,NYK,1,240,39,83,0.47,33,57,0.579,6,26,0.231,19,24,0.792,103,39,92,0.424,32,69,0.464,7,23,0.304,10,12,0.833,95
1443,DEN,2017-01-24,103,,UTA,1,240,35,76,0.461,25,50,0.5,10,26,0.385,23,31,0.742,103,35,85,0.412,28,63,0.444,7,22,0.318,16,21,0.762,93
1444,IND,2017-01-23,103,,NYK,0,240,38,86,0.442,31,60,0.517,7,26,0.269,20,25,0.8,103,35,76,0.461,27,54,0.5,8,22,0.364,31,35,0.886,109
1445,TOR,2017-01-22,103,,PHO,0,240,33,83,0.398,26,56,0.464,7,27,0.259,30,35,0.857,103,40,79,0.506,31,57,0.544,9,22,0.409,26,28,0.929,115
1446,PHO,2017-01-19,103,@,CLE,0,240,37,85,0.435,33,66,0.5,4,19,0.211,25,31,0.806,103,43,85,0.506,24,43,0.558,19,42,0.452,13,19,0.684,118
1447,HOU,2017-01-17,103,@,MIA,0,240,36,90,0.4,27,51,0.529,9,39,0.231,22,28,0.786,103,42,90,0.467,33,61,0.541,9,29,0.31,16,24,0.667,109
1448,BOS,2017-01-13,103,@,ATL,1,240,36,83,0.434,19,39,0.487,17,44,0.386,14,19,0.737,103,36,84,0.429,25,54,0.463,11,30,0.367,18,21,0.857,101
1449,OKC,2017-01-11,103,,MEM,1,240,36,81,0.444,28,55,0.509,8,26,0.308,23,29,0.793,103,38,92,0.413,31,68,0.456,7,24,0.292,12,21,0.571,95
1450,NYK,2017-01-02,103,,ORL,0,240,39,83,0.47,31,62,0.5,8,21,0.381,17,24,0.708,103,45,91,0.495,30,60,0.5,15,31,0.484,10,14,0.714,115
1451,MIN,2016-12-28,103,@,DEN,0,240,42,94,0.447,35,69,0.507,7,25,0.28,12,17,0.706,103,42,81,0.519,32,53,0.604,10,28,0.357,11,14,0.786,105
1452,MEM,2016-12-27,103,@,BOS,0,240,37,88,0.42,28,58,0.483,9,30,0.3,20,29,0.69,103,41,85,0.482,29,54,0.537,12,31,0.387,19,21,0.905,113
1453,CHO,2016-12-23,103,,CHI,1,240,37,84,0.44,32,66,0.485,5,18,0.278,24,28,0.857,103,38,96,0.396,31,74,0.419,7,22,0.318,8,10,0.8,91
1454,UTA,2016-12-16,103,,DAL,1,240,37,65,0.569,29,43,0.674,8,22,0.364,21,27,0.778,103,35,77,0.455,23,49,0.469,12,28,0.429,18,21,0.857,100
1455,GSW,2016-12-15,103,,NYK,1,240,45,96,0.469,36,64,0.563,9,32,0.281,4,8,0.5,103,38,93,0.409,33,72,0.458,5,21,0.238,9,19,0.474,90
1456,CLE,2016-12-13,103,,MEM,1,240,37,81,0.457,25,50,0.5,12,31,0.387,17,23,0.739,103,35,86,0.407,31,64,0.484,4,22,0.182,12,15,0.8,86
1457,NYK,2016-12-09,103,@,SAC,1,240,36,84,0.429,26,55,0.473,10,29,0.345,21,25,0.84,103,35,87,0.402,28,59,0.475,7,28,0.25,23,27,0.852,100
1458,IND,2016-12-09,103,@,DAL,0,240,32,69,0.464,18,44,0.409,14,25,0.56,25,26,0.962,103,39,80,0.488,24,48,0.5,15,32,0.469,18,24,0.75,111
1459,ATL,2016-12-07,103,,MIA,1,240,43,88,0.489,39,69,0.565,4,19,0.211,13,15,0.867,103,34,80,0.425,23,53,0.434,11,27,0.407,16,20,0.8,95
1460,MIA,2016-12-06,103,,NYK,0,240,38,89,0.427,27,64,0.422,11,25,0.44,16,27,0.593,103,48,98,0.49,41,73,0.562,7,25,0.28,11,16,0.688,114
1461,MEM,2016-12-03,103,,LAL,1,240,41,88,0.466,31,58,0.534,10,30,0.333,11,15,0.733,103,35,81,0.432,28,60,0.467,7,21,0.333,23,29,0.793,100
1462,BRK,2016-12-03,103,@,MIL,0,240,34,91,0.374,23,50,0.46,11,41,0.268,24,33,0.727,103,40,85,0.471,34,61,0.557,6,24,0.25,26,36,0.722,112
1463,NYK,2016-11-28,103,,OKC,0,240,36,91,0.396,30,72,0.417,6,19,0.316,25,28,0.893,103,46,92,0.5,38,70,0.543,8,22,0.364,12,18,0.667,112
1464,MIN,2016-11-28,103,,UTA,0,240,36,81,0.444,29,62,0.468,7,19,0.368,24,25,0.96,103,40,79,0.506,36,61,0.59,4,18,0.222,28,34,0.824,112
1465,BOS,2016-11-25,103,,SAS,0,240,42,91,0.462,30,57,0.526,12,34,0.353,7,9,0.778,103,38,81,0.469,27,57,0.474,11,24,0.458,22,25,0.88,109
1466,POR,2016-11-22,103,@,NYK,0,240,38,86,0.442,32,64,0.5,6,22,0.273,21,26,0.808,103,45,96,0.469,36,67,0.537,9,29,0.31,8,8,1.0,107
1467,IND,2016-11-16,103,,CLE,1,240,43,86,0.5,33,58,0.569,10,28,0.357,7,11,0.636,103,35,86,0.407,24,56,0.429,11,30,0.367,12,20,0.6,93
1468,HOU,2016-11-16,103,@,OKC,0,240,40,92,0.435,26,52,0.5,14,40,0.35,9,14,0.643,103,40,84,0.476,28,59,0.475,12,25,0.48,13,14,0.929,105
1469,DET,2016-11-05,103,,DEN,1,240,40,84,0.476,33,64,0.516,7,20,0.35,16,22,0.727,103,31,94,0.33,24,69,0.348,7,25,0.28,17,20,0.85,86
1470,WAS,2016-11-02,103,,TOR,0,240,42,72,0.583,39,62,0.629,3,10,0.3,16,24,0.667,103,43,77,0.558,33,52,0.635,10,25,0.4,17,25,0.68,113
1471,ORL,2016-11-01,103,@,PHI,1,240,42,93,0.452,36,68,0.529,6,25,0.24,13,17,0.765,103,40,81,0.494,31,61,0.508,9,20,0.45,12,16,0.75,101
1472,WAS,2016-10-30,103,@,MEM,0,265,38,86,0.442,33,61,0.541,5,25,0.2,22,25,0.88,103,39,88,0.443,24,57,0.421,15,31,0.484,19,26,0.731,112
1473,MIN,2016-10-29,103,@,SAC,0,240,37,70,0.529,30,48,0.625,7,22,0.318,22,31,0.71,103,39,85,0.459,30,59,0.508,9,26,0.346,19,25,0.76,106
1474,BRK,2016-10-28,103,,IND,1,240,38,87,0.437,28,54,0.519,10,33,0.303,17,20,0.85,103,37,98,0.378,30,74,0.405,7,24,0.292,13,20,0.65,94
1475,OKC,2016-10-26,103,@,PHI,1,240,39,94,0.415,33,72,0.458,6,22,0.273,19,26,0.731,103,36,84,0.429,29,60,0.483,7,24,0.292,18,25,0.72,97
1476,WAS,2017-04-12,102,@,MIA,0,240,42,87,0.483,35,61,0.574,7,26,0.269,11,14,0.786,102,46,88,0.523,38,64,0.594,8,24,0.333,10,12,0.833,110
1477,SAS,2017-04-07,102,@,DAL,1,240,40,96,0.417,31,68,0.456,9,28,0.321,13,22,0.591,102,38,88,0.432,30,62,0.484,8,26,0.308,5,8,0.625,89
1478,CHI,2017-04-06,102,@,PHI,1,240,39,91,0.429,31,66,0.47,8,25,0.32,16,17,0.941,102,33,91,0.363,26,58,0.448,7,33,0.212,17,22,0.773,90
1479,LAL,2017-04-05,102,@,SAS,1,240,42,86,0.488,35,72,0.486,7,14,0.5,11,14,0.786,102,39,89,0.438,26,54,0.481,13,35,0.371,4,6,0.667,95
1480,DET,2017-04-05,102,,TOR,0,240,42,81,0.519,35,60,0.583,7,21,0.333,11,18,0.611,102,41,87,0.471,31,57,0.544,10,30,0.333,13,15,0.867,105
1481,ORL,2017-04-04,102,@,CLE,0,240,33,86,0.384,22,53,0.415,11,33,0.333,25,26,0.962,102,44,82,0.537,26,46,0.565,18,36,0.5,16,21,0.762,122
1482,ORL,2017-03-22,102,,CHO,0,240,40,88,0.455,26,48,0.542,14,40,0.35,8,10,0.8,102,42,90,0.467,33,63,0.524,9,27,0.333,16,18,0.889,109
1483,WAS,2017-03-20,102,@,BOS,0,240,37,86,0.43,29,51,0.569,8,35,0.229,20,26,0.769,102,40,93,0.43,30,60,0.5,10,33,0.303,20,28,0.714,110
1484,SAC,2017-03-19,102,@,SAS,0,240,41,83,0.494,34,73,0.466,7,10,0.7,13,17,0.765,102,43,87,0.494,32,59,0.542,11,28,0.393,21,27,0.778,118
1485,TOR,2017-03-16,102,,OKC,0,240,37,81,0.457,32,61,0.525,5,20,0.25,23,30,0.767,102,47,88,0.534,33,63,0.524,14,25,0.56,15,19,0.789,123
1486,IND,2017-03-12,102,,MIA,1,240,35,82,0.427,30,67,0.448,5,15,0.333,27,32,0.844,102,39,94,0.415,30,62,0.484,9,32,0.281,11,16,0.688,98
1487,MIL,2017-03-11,102,,MIN,1,240,37,80,0.463,29,60,0.483,8,20,0.4,20,23,0.87,102,37,81,0.457,32,68,0.471,5,13,0.385,16,21,0.762,95
1488,GSW,2017-03-10,102,@,MIN,0,240,41,88,0.466,34,64,0.531,7,24,0.292,13,17,0.765,102,39,88,0.443,35,74,0.473,4,14,0.286,21,27,0.778,103
1489,OKC,2017-03-09,102,,SAS,1,240,41,89,0.461,35,69,0.507,6,20,0.3,14,21,0.667,102,35,84,0.417,29,65,0.446,6,19,0.316,16,20,0.8,92
1490,BOS,2017-03-06,102,@,LAC,0,240,34,83,0.41,24,48,0.5,10,35,0.286,24,29,0.828,102,39,73,0.534,30,53,0.566,9,20,0.45,29,47,0.617,116
1491,DEN,2017-03-04,102,,CHO,0,240,36,80,0.45,27,50,0.54,9,30,0.3,21,25,0.84,102,41,90,0.456,25,63,0.397,16,27,0.593,14,17,0.824,112
1492,NYK,2017-03-03,102,@,PHI,0,240,33,84,0.393,26,63,0.413,7,21,0.333,29,33,0.879,102,36,83,0.434,27,55,0.491,9,28,0.321,24,31,0.774,105
1493,MIN,2017-02-27,102,@,SAC,1,240,40,95,0.421,32,72,0.444,8,23,0.348,14,20,0.7,102,36,82,0.439,30,65,0.462,6,17,0.353,10,15,0.667,88
1494,CLE,2017-02-27,102,,MIL,1,240,35,70,0.5,25,42,0.595,10,28,0.357,22,26,0.846,102,37,83,0.446,26,53,0.491,11,30,0.367,10,16,0.625,95
1495,UTA,2017-02-26,102,@,WAS,1,240,34,72,0.472,23,48,0.479,11,24,0.458,23,32,0.719,102,37,87,0.425,29,65,0.446,8,22,0.364,10,13,0.769,92
1496,IND,2017-02-24,102,,MEM,1,240,40,78,0.513,29,52,0.558,11,26,0.423,11,11,1.0,102,35,84,0.417,26,57,0.456,9,27,0.333,13,23,0.565,92
1497,MIL,2017-02-13,102,,DET,1,240,40,79,0.506,34,58,0.586,6,21,0.286,16,16,1.0,102,34,78,0.436,27,57,0.474,7,21,0.333,14,19,0.737,89
1498,DET,2017-02-12,102,@,TOR,1,240,36,84,0.429,28,53,0.528,8,31,0.258,22,29,0.759,102,38,75,0.507,30,59,0.508,8,16,0.5,17,25,0.68,101
1499,CHO,2017-02-11,102,,LAC,0,240,37,85,0.435,24,48,0.5,13,37,0.351,15,20,0.75,102,40,85,0.471,26,51,0.51,14,34,0.412,13,20,0.65,107
1500,PHO,2017-02-11,102,@,HOU,0,240,37,94,0.394,29,72,0.403,8,22,0.364,20,26,0.769,102,42,85,0.494,24,49,0.49,18,36,0.5,31,39,0.795,133
1501,LAL,2017-02-08,102,@,DET,0,240,37,86,0.43,31,63,0.492,6,23,0.261,22,26,0.846,102,51,97,0.526,47,81,0.58,4,16,0.25,15,24,0.625,121
1502,LAC,2017-02-05,102,@,BOS,0,240,35,84,0.417,25,55,0.455,10,29,0.345,22,28,0.786,102,37,88,0.42,21,36,0.583,16,52,0.308,17,20,0.85,107
1503,PHI,2017-02-04,102,@,MIA,0,240,35,84,0.417,29,61,0.475,6,23,0.261,26,31,0.839,102,48,82,0.585,36,60,0.6,12,22,0.545,17,23,0.739,125
1504,MEM,2017-02-03,102,@,OKC,0,240,40,83,0.482,37,64,0.578,3,19,0.158,19,22,0.864,102,38,80,0.475,25,54,0.463,13,26,0.5,25,33,0.758,114
1505,ORL,2017-02-03,102,,TOR,1,240,37,80,0.463,32,66,0.485,5,14,0.357,23,32,0.719,102,34,87,0.391,24,59,0.407,10,28,0.357,16,21,0.762,94
1506,SAS,2017-02-02,102,,PHI,1,240,38,89,0.427,32,68,0.471,6,21,0.286,20,27,0.741,102,30,88,0.341,21,63,0.333,9,25,0.36,17,23,0.739,86
1507,MEM,2017-01-28,102,@,UTA,1,240,41,80,0.513,30,54,0.556,11,26,0.423,9,10,0.9,102,29,62,0.468,19,37,0.514,10,25,0.4,27,29,0.931,95
1508,TOR,2017-01-27,102,,MIL,1,240,37,84,0.44,27,59,0.458,10,25,0.4,18,23,0.783,102,31,80,0.388,24,57,0.421,7,23,0.304,17,24,0.708,86
1509,GSW,2017-01-23,102,@,MIA,0,240,41,88,0.466,33,58,0.569,8,30,0.267,12,20,0.6,102,38,86,0.442,25,56,0.446,13,30,0.433,16,27,0.593,105
1510,CHI,2017-01-21,102,,SAC,1,240,34,83,0.41,28,66,0.424,6,17,0.353,28,33,0.848,102,37,84,0.44,28,58,0.483,9,26,0.346,16,21,0.762,99
1511,ATL,2017-01-20,102,,CHI,1,240,39,82,0.476,30,60,0.5,9,22,0.409,15,19,0.789,102,34,81,0.42,27,53,0.509,7,28,0.25,18,19,0.947,93
1512,DET,2017-01-15,102,@,LAL,1,240,41,95,0.432,32,70,0.457,9,25,0.36,11,16,0.688,102,36,83,0.434,30,57,0.526,6,26,0.231,19,24,0.792,97
1513,PHI,2017-01-13,102,,CHO,1,240,36,76,0.474,22,38,0.579,14,38,0.368,16,20,0.8,102,28,85,0.329,22,62,0.355,6,23,0.261,31,32,0.969,93
1514,POR,2017-01-11,102,,CLE,1,240,40,93,0.43,30,63,0.476,10,30,0.333,12,16,0.75,102,28,82,0.341,19,52,0.365,9,30,0.3,21,28,0.75,86
1515,SAS,2017-01-07,102,,CHO,1,240,36,89,0.404,23,55,0.418,13,34,0.382,17,20,0.85,102,30,75,0.4,26,54,0.481,4,21,0.19,21,25,0.84,85
1516,PHO,2017-01-05,102,@,DAL,1,240,38,85,0.447,31,68,0.456,7,17,0.412,19,22,0.864,102,36,79,0.456,27,50,0.54,9,29,0.31,14,17,0.824,95
1517,SAC,2017-01-04,102,,MIA,0,240,40,78,0.513,32,58,0.552,8,20,0.4,14,17,0.824,102,35,72,0.486,23,44,0.523,12,28,0.429,25,29,0.862,107
1518,MEM,2017-01-03,102,@,LAL,0,240,30,77,0.39,20,46,0.435,10,31,0.323,32,35,0.914,102,42,82,0.512,25,49,0.51,17,33,0.515,15,28,0.536,116
1519,POR,2016-12-28,102,,SAC,1,240,35,74,0.473,23,49,0.469,12,25,0.48,20,22,0.909,102,31,79,0.392,22,51,0.431,9,28,0.321,18,23,0.783,89
1520,ATL,2016-12-28,102,,NYK,1,265,37,101,0.366,30,74,0.405,7,27,0.259,21,27,0.778,102,35,93,0.376,28,66,0.424,7,27,0.259,21,26,0.808,98
1521,NOP,2016-12-28,102,,LAC,1,240,40,87,0.46,30,58,0.517,10,29,0.345,12,21,0.571,102,37,94,0.394,26,57,0.456,11,37,0.297,13,18,0.722,98
1522,UTA,2016-12-27,102,@,LAL,1,240,38,75,0.507,29,49,0.592,9,26,0.346,17,24,0.708,102,39,83,0.47,35,67,0.522,4,16,0.25,18,22,0.818,100
1523,SAC,2016-12-26,102,,PHI,1,240,39,87,0.448,32,62,0.516,7,25,0.28,17,21,0.81,102,39,79,0.494,30,54,0.556,9,25,0.36,13,18,0.722,100
1524,MEM,2016-12-26,102,@,ORL,0,240,35,76,0.461,25,51,0.49,10,25,0.4,22,28,0.786,102,44,86,0.512,31,60,0.517,13,26,0.5,11,16,0.688,112
1525,MIL,2016-12-26,102,@,WAS,0,240,40,87,0.46,34,67,0.507,6,20,0.3,16,23,0.696,102,40,79,0.506,28,50,0.56,12,29,0.414,15,20,0.75,107
1526,LAC,2016-12-26,102,,DEN,0,240,39,84,0.464,30,59,0.508,9,25,0.36,15,20,0.75,102,36,82,0.439,25,51,0.49,11,31,0.355,23,28,0.821,106
1527,LAC,2016-12-25,102,@,LAL,0,240,37,85,0.435,27,56,0.482,10,29,0.345,18,22,0.818,102,40,84,0.476,32,59,0.542,8,25,0.32,23,30,0.767,111
1528,IND,2016-12-22,102,,BOS,0,240,35,82,0.427,28,59,0.475,7,23,0.304,25,29,0.862,102,38,92,0.413,28,53,0.528,10,39,0.256,23,27,0.852,109
1529,MIL,2016-12-21,102,@,CLE,0,240,36,77,0.468,27,55,0.491,9,22,0.409,21,29,0.724,102,43,87,0.494,28,60,0.467,15,27,0.556,12,19,0.632,113
1530,DEN,2016-12-20,102,@,LAC,0,240,39,90,0.433,28,51,0.549,11,39,0.282,13,20,0.65,102,47,86,0.547,31,50,0.62,16,36,0.444,9,13,0.692,119
1531,SAS,2016-12-20,102,@,HOU,1,240,36,77,0.468,24,54,0.444,12,23,0.522,18,25,0.72,102,35,92,0.38,29,54,0.537,6,38,0.158,24,27,0.889,100
1532,LAC,2016-12-16,102,@,MIA,1,240,36,83,0.434,29,58,0.5,7,25,0.28,23,29,0.793,102,38,93,0.409,32,66,0.485,6,27,0.222,16,25,0.64,98
1533,NOP,2016-12-15,102,,IND,1,240,36,85,0.424,26,58,0.448,10,27,0.37,20,28,0.714,102,36,87,0.414,33,66,0.5,3,21,0.143,20,24,0.833,95
1534,HOU,2016-12-09,102,@,OKC,1,240,36,92,0.391,25,50,0.5,11,42,0.262,19,30,0.633,102,34,81,0.42,27,53,0.509,7,28,0.25,24,31,0.774,99
1535,DET,2016-12-06,102,,CHI,1,240,40,88,0.455,32,67,0.478,8,21,0.381,14,21,0.667,102,33,75,0.44,31,60,0.517,2,15,0.133,23,32,0.719,91
1536,OKC,2016-12-05,102,@,ATL,1,240,37,80,0.463,27,49,0.551,10,31,0.323,18,28,0.643,102,34,77,0.442,27,55,0.491,7,22,0.318,24,32,0.75,99
1537,LAC,2016-12-04,102,,IND,0,240,36,81,0.444,26,51,0.51,10,30,0.333,20,28,0.714,102,39,79,0.494,34,65,0.523,5,14,0.357,28,35,0.8,111
1538,NYK,2016-11-26,102,@,CHO,0,240,37,99,0.374,25,67,0.373,12,32,0.375,16,20,0.8,102,35,80,0.438,27,58,0.466,8,22,0.364,29,42,0.69,107
1539,MIN,2016-11-26,102,@,GSW,0,240,41,89,0.461,31,54,0.574,10,35,0.286,10,12,0.833,102,45,81,0.556,34,59,0.576,11,22,0.5,14,17,0.824,115
1540,HOU,2016-11-23,102,,TOR,0,240,38,78,0.487,24,36,0.667,14,42,0.333,12,12,1.0,102,43,88,0.489,31,65,0.477,12,23,0.522,17,21,0.81,115
1541,SAC,2016-11-20,102,,TOR,1,240,36,81,0.444,25,54,0.463,11,27,0.407,19,25,0.76,102,34,85,0.4,25,61,0.41,9,24,0.375,22,24,0.917,99
1542,UTA,2016-11-19,102,@,HOU,0,240,39,76,0.513,27,49,0.551,12,27,0.444,12,17,0.706,102,42,94,0.447,30,62,0.484,12,32,0.375,15,20,0.75,111
1543,LAC,2016-11-19,102,,CHI,1,240,36,77,0.468,25,50,0.5,11,27,0.407,19,23,0.826,102,33,77,0.429,24,47,0.511,9,30,0.3,20,24,0.833,95
1544,WAS,2016-11-16,102,@,PHI,0,240,38,91,0.418,30,68,0.441,8,23,0.348,18,25,0.72,102,42,77,0.545,32,49,0.653,10,28,0.357,15,22,0.682,109
1545,DET,2016-11-16,102,@,NYK,0,240,42,85,0.494,34,62,0.548,8,23,0.348,10,12,0.833,102,42,93,0.452,33,68,0.485,9,25,0.36,12,19,0.632,105
1546,MEM,2016-11-14,102,@,UTA,1,240,36,76,0.474,28,55,0.509,8,21,0.381,22,26,0.846,102,35,73,0.479,27,45,0.6,8,28,0.286,18,22,0.818,96
1547,UTA,2016-11-12,102,@,MIA,1,240,40,81,0.494,34,61,0.557,6,20,0.3,16,19,0.842,102,38,81,0.469,33,64,0.516,5,17,0.294,10,19,0.526,91
1548,OKC,2016-11-09,102,,TOR,0,240,31,74,0.419,19,40,0.475,12,34,0.353,28,31,0.903,102,43,83,0.518,32,57,0.561,11,26,0.423,15,22,0.682,112
1549,SAC,2016-11-08,102,,NOP,1,240,39,81,0.481,31,56,0.554,8,25,0.32,16,20,0.8,102,38,84,0.452,33,63,0.524,5,21,0.238,13,18,0.722,94
1550,CLE,2016-11-05,102,@,PHI,1,240,37,91,0.407,23,53,0.434,14,38,0.368,14,18,0.778,102,40,87,0.46,26,49,0.531,14,38,0.368,7,12,0.583,101
1551,ORL,2016-11-03,102,,SAC,1,240,38,84,0.452,28,54,0.519,10,30,0.333,16,23,0.696,102,38,80,0.475,31,62,0.5,7,18,0.389,11,17,0.647,94
1552,DEN,2016-11-03,102,@,MIN,1,240,39,81,0.481,33,59,0.559,6,22,0.273,18,25,0.72,102,35,88,0.398,26,66,0.394,9,22,0.409,20,25,0.8,99
1553,DET,2016-11-01,102,,NYK,1,240,41,89,0.461,33,76,0.434,8,13,0.615,12,21,0.571,102,35,86,0.407,28,64,0.438,7,22,0.318,12,15,0.8,89
1554,DEN,2016-10-31,102,@,TOR,0,240,33,81,0.407,24,59,0.407,9,22,0.409,27,35,0.771,102,41,88,0.466,37,72,0.514,4,16,0.25,19,25,0.76,105
1555,SAS,2016-10-27,102,@,SAC,1,240,36,79,0.456,30,61,0.492,6,18,0.333,24,27,0.889,102,28,70,0.4,22,50,0.44,6,20,0.3,32,38,0.842,94
1556,MEM,2016-10-26,102,,MIN,1,240,36,80,0.45,25,56,0.446,11,24,0.458,19,27,0.704,102,36,86,0.419,30,68,0.441,6,18,0.333,20,29,0.69,98
1557,NOP,2016-10-26,102,,DEN,0,240,38,92,0.413,35,73,0.479,3,19,0.158,23,26,0.885,102,37,83,0.446,29,59,0.492,8,24,0.333,25,33,0.758,107
1558,UTA,2017-04-12,101,,SAS,1,240,39,77,0.506,29,51,0.569,10,26,0.385,13,20,0.65,101,39,86,0.453,31,65,0.477,8,21,0.381,11,13,0.846,97
1559,DET,2017-04-10,101,,WAS,0,240,43,94,0.457,33,68,0.485,10,26,0.385,5,5,1.0,101,42,83,0.506,35,64,0.547,7,19,0.368,14,16,0.875,105
1560,POR,2017-04-08,101,,UTA,1,240,37,91,0.407,24,61,0.393,13,30,0.433,14,16,0.875,101,31,78,0.397,25,59,0.424,6,19,0.316,18,24,0.75,86
1561,NOP,2017-04-08,101,@,GSW,0,240,42,86,0.488,37,65,0.569,5,21,0.238,12,19,0.632,101,49,96,0.51,39,63,0.619,10,33,0.303,15,16,0.938,123
1562,MEM,2017-04-07,101,,NYK,1,240,38,75,0.507,23,48,0.479,15,27,0.556,10,12,0.833,101,38,88,0.432,32,60,0.533,6,28,0.214,6,13,0.462,88
1563,DAL,2017-04-05,101,@,LAC,0,240,38,86,0.442,27,55,0.491,11,31,0.355,14,18,0.778,101,38,75,0.507,26,44,0.591,12,31,0.387,24,31,0.774,112
1564,OKC,2017-04-02,101,,CHO,0,240,39,84,0.464,27,53,0.509,12,31,0.387,11,12,0.917,101,37,77,0.481,26,47,0.553,11,30,0.367,28,32,0.875,113
1565,BRK,2017-03-28,101,,PHI,0,240,38,94,0.404,29,62,0.468,9,32,0.281,16,24,0.667,101,39,91,0.429,29,58,0.5,10,33,0.303,18,21,0.857,106
1566,TOR,2017-03-23,101,@,MIA,1,240,35,79,0.443,29,56,0.518,6,23,0.261,25,32,0.781,101,32,82,0.39,26,59,0.441,6,23,0.261,14,23,0.609,84
1567,NYK,2017-03-22,101,@,UTA,0,240,38,80,0.475,29,59,0.492,9,21,0.429,16,18,0.889,101,41,90,0.456,34,62,0.548,7,28,0.25,19,29,0.655,108
1568,PHO,2017-03-15,101,,SAC,0,240,43,107,0.402,37,82,0.451,6,25,0.24,9,14,0.643,101,38,79,0.481,32,65,0.492,6,14,0.429,25,34,0.735,107
1569,LAL,2017-03-13,101,@,DEN,0,240,42,97,0.433,36,77,0.468,6,20,0.3,11,19,0.579,101,45,84,0.536,28,46,0.609,17,38,0.447,22,25,0.88,129
1570,PHO,2017-03-12,101,,POR,0,240,41,93,0.441,36,79,0.456,5,14,0.357,14,20,0.7,101,43,86,0.5,36,64,0.563,7,22,0.318,17,25,0.68,110
1571,CLE,2017-03-09,101,@,DET,0,240,39,84,0.464,28,45,0.622,11,39,0.282,12,19,0.632,101,41,88,0.466,32,62,0.516,9,26,0.346,15,19,0.789,106
1572,CHO,2017-03-08,101,@,MIA,0,240,37,80,0.463,30,59,0.508,7,21,0.333,20,21,0.952,101,37,85,0.435,20,44,0.455,17,41,0.415,17,24,0.708,108
1573,LAC,2017-03-04,101,@,CHI,1,240,41,85,0.482,35,60,0.583,6,25,0.24,13,16,0.813,101,35,83,0.422,29,66,0.439,6,17,0.353,15,20,0.75,91
1574,MIL,2017-03-04,101,,TOR,1,240,38,87,0.437,32,60,0.533,6,27,0.222,19,23,0.826,101,35,75,0.467,28,54,0.519,7,21,0.333,17,20,0.85,94
1575,LAC,2017-03-03,101,@,MIL,0,240,36,64,0.563,28,45,0.622,8,19,0.421,21,36,0.583,101,44,80,0.55,34,55,0.618,10,25,0.4,14,15,0.933,112
1576,SAS,2017-03-03,101,@,NOP,1,265,40,95,0.421,34,68,0.5,6,27,0.222,15,25,0.6,101,35,91,0.385,27,66,0.409,8,25,0.32,20,24,0.833,98
1577,NYK,2017-03-01,101,@,ORL,1,240,34,81,0.42,26,52,0.5,8,29,0.276,25,31,0.806,101,34,83,0.41,29,58,0.5,5,25,0.2,17,22,0.773,90
1578,LAL,2017-02-15,101,@,PHO,0,240,35,93,0.376,26,67,0.388,9,26,0.346,22,28,0.786,101,49,88,0.557,39,64,0.609,10,24,0.417,29,34,0.853,137
1579,TOR,2017-02-12,101,,DET,0,240,38,75,0.507,30,59,0.508,8,16,0.5,17,25,0.68,101,36,84,0.429,28,53,0.528,8,31,0.258,22,29,0.759,102
1580,NYK,2017-01-31,101,@,WAS,0,240,34,93,0.366,29,69,0.42,5,24,0.208,28,35,0.8,101,49,88,0.557,42,66,0.636,7,22,0.318,12,15,0.8,117
1581,HOU,2017-01-29,101,@,IND,0,240,34,83,0.41,23,44,0.523,11,39,0.282,22,25,0.88,101,47,87,0.54,42,66,0.636,5,21,0.238,21,26,0.808,120
1582,SAS,2017-01-29,101,,DAL,0,240,39,83,0.47,31,61,0.508,8,22,0.364,15,23,0.652,101,39,87,0.448,27,53,0.509,12,34,0.353,15,16,0.938,105
1583,MEM,2017-01-25,101,,TOR,1,240,36,78,0.462,26,56,0.464,10,22,0.455,19,25,0.76,101,39,92,0.424,29,58,0.5,10,34,0.294,11,19,0.579,99
1584,LAC,2017-01-19,101,,MIN,0,240,42,87,0.483,38,65,0.585,4,22,0.182,13,24,0.542,101,40,84,0.476,35,68,0.515,5,16,0.313,19,25,0.76,104
1585,MEM,2017-01-18,101,@,WAS,0,240,33,83,0.398,25,58,0.431,8,25,0.32,27,34,0.794,101,36,80,0.45,28,51,0.549,8,29,0.276,24,26,0.923,104
1586,POR,2017-01-16,101,@,WAS,0,240,37,88,0.42,29,62,0.468,8,26,0.308,19,25,0.76,101,42,86,0.488,29,63,0.46,13,23,0.565,23,25,0.92,120
1587,PHO,2017-01-16,101,,UTA,0,240,40,81,0.494,35,59,0.593,5,22,0.227,16,17,0.941,101,41,89,0.461,33,66,0.5,8,23,0.348,16,24,0.667,106
1588,NYK,2017-01-15,101,@,TOR,0,240,35,84,0.417,23,55,0.418,12,29,0.414,19,27,0.704,101,44,89,0.494,36,67,0.537,8,22,0.364,20,23,0.87,116
1589,ATL,2017-01-13,101,,BOS,0,240,36,84,0.429,25,54,0.463,11,30,0.367,18,21,0.857,101,36,83,0.434,19,39,0.487,17,44,0.386,14,19,0.737,103
1590,WAS,2017-01-10,101,,CHI,1,240,42,83,0.506,31,61,0.508,11,22,0.5,6,9,0.667,101,35,88,0.398,25,61,0.41,10,27,0.37,19,21,0.905,99
1591,MIN,2017-01-09,101,,DAL,1,240,40,71,0.563,34,55,0.618,6,16,0.375,15,21,0.714,101,36,78,0.462,23,50,0.46,13,28,0.464,7,9,0.778,92
1592,MIL,2017-01-08,101,,WAS,0,240,37,80,0.463,28,57,0.491,9,23,0.391,18,20,0.9,101,41,84,0.488,31,52,0.596,10,32,0.313,15,18,0.833,107
1593,TOR,2017-01-05,101,,UTA,1,240,36,91,0.396,28,70,0.4,8,21,0.381,21,28,0.75,101,34,73,0.466,27,53,0.509,7,20,0.35,18,21,0.857,93
1594,HOU,2017-01-02,101,,WAS,1,240,37,86,0.43,25,47,0.532,12,39,0.308,15,21,0.714,101,38,87,0.437,32,61,0.525,6,26,0.231,9,12,0.75,91
1595,UTA,2017-01-02,101,@,BRK,1,240,39,93,0.419,32,69,0.464,7,24,0.292,16,20,0.8,101,33,78,0.423,27,51,0.529,6,27,0.222,17,23,0.739,89
1596,CHI,2016-12-30,101,@,IND,0,240,35,84,0.417,29,61,0.475,6,23,0.261,25,31,0.806,101,39,81,0.481,32,62,0.516,7,19,0.368,26,30,0.867,111
1597,DAL,2016-12-29,101,@,LAL,1,240,38,77,0.494,24,46,0.522,14,31,0.452,11,14,0.786,101,32,68,0.471,25,49,0.51,7,19,0.368,18,25,0.72,89
1598,ORL,2016-12-28,101,,CHO,0,240,42,86,0.488,33,52,0.635,9,34,0.265,8,10,0.8,101,46,84,0.548,36,60,0.6,10,24,0.417,18,19,0.947,120
1599,CHI,2016-12-28,101,,BRK,1,240,35,88,0.398,32,75,0.427,3,13,0.231,28,29,0.966,101,37,86,0.43,24,54,0.444,13,32,0.406,12,16,0.75,99
1600,SAS,2016-12-22,101,@,LAC,0,240,37,92,0.402,31,73,0.425,6,19,0.316,21,25,0.84,101,39,83,0.47,28,55,0.509,11,28,0.393,17,22,0.773,106
1601,SAS,2016-12-22,101,@,LAC,0,240,37,92,0.402,31,73,0.425,6,19,0.316,21,25,0.84,101,39,83,0.47,28,55,0.509,11,28,0.393,17,22,0.773,106
1602,PHO,2016-12-17,101,@,OKC,0,240,39,90,0.433,31,68,0.456,8,22,0.364,15,20,0.75,101,41,81,0.506,34,65,0.523,7,16,0.438,25,34,0.735,114
1603,BOS,2016-12-14,101,@,SAS,0,240,37,84,0.44,27,53,0.509,10,31,0.323,17,20,0.85,101,44,80,0.55,36,58,0.621,8,22,0.364,12,14,0.857,108
1604,WAS,2016-12-12,101,@,MIA,0,240,39,84,0.464,34,61,0.557,5,23,0.217,18,22,0.818,101,45,88,0.511,36,62,0.581,9,26,0.346,13,19,0.684,112
1605,BRK,2016-12-10,101,@,SAS,0,240,36,87,0.414,29,60,0.483,7,27,0.259,22,25,0.88,101,50,94,0.532,36,68,0.529,14,26,0.538,16,18,0.889,130
1606,TOR,2016-12-09,101,@,BOS,1,240,34,82,0.415,25,62,0.403,9,20,0.45,24,27,0.889,101,31,83,0.373,14,41,0.341,17,42,0.405,15,22,0.682,94
1607,DAL,2016-12-05,101,,CHO,0,240,37,89,0.416,24,53,0.453,13,36,0.361,14,18,0.778,101,40,79,0.506,37,61,0.607,3,18,0.167,26,28,0.929,109
1608,LAL,2016-12-05,101,,UTA,0,240,39,87,0.448,34,73,0.466,5,14,0.357,18,23,0.783,101,38,80,0.475,25,48,0.521,13,32,0.406,18,29,0.621,107
1609,OKC,2016-12-04,101,,NOP,1,240,41,89,0.461,35,61,0.574,6,28,0.214,13,26,0.5,101,36,98,0.367,30,70,0.429,6,28,0.214,14,19,0.737,92
1610,CLE,2016-11-29,101,@,MIL,0,240,32,75,0.427,18,36,0.5,14,39,0.359,23,31,0.742,101,46,86,0.535,39,67,0.582,7,19,0.368,19,23,0.826,118
1611,HOU,2016-11-29,101,@,UTA,0,240,37,91,0.407,26,61,0.426,11,30,0.367,16,22,0.727,101,41,74,0.554,26,46,0.565,15,28,0.536,23,27,0.852,120
1612,WAS,2016-11-28,101,,SAC,1,265,35,85,0.412,25,60,0.417,10,25,0.4,21,26,0.808,101,38,93,0.409,35,72,0.486,3,21,0.143,16,26,0.615,95
1613,OKC,2016-11-23,101,@,SAC,0,240,32,76,0.421,25,51,0.49,7,25,0.28,30,38,0.789,101,44,94,0.468,32,66,0.485,12,28,0.429,16,17,0.941,116
1614,PHI,2016-11-21,101,,MIA,1,240,37,78,0.474,26,52,0.5,11,26,0.423,16,20,0.8,101,34,88,0.386,27,57,0.474,7,31,0.226,19,28,0.679,94
1615,PHO,2016-11-21,101,@,WAS,0,240,39,91,0.429,28,64,0.438,11,27,0.407,12,15,0.8,101,37,91,0.407,27,63,0.429,10,28,0.357,22,34,0.647,106
1616,POR,2016-11-18,101,@,NOP,0,240,33,88,0.375,21,54,0.389,12,34,0.353,23,26,0.885,101,45,82,0.549,36,58,0.621,9,24,0.375,14,20,0.7,113
1617,LAL,2016-11-10,101,@,SAC,1,240,38,74,0.514,29,47,0.617,9,27,0.333,16,22,0.727,101,34,85,0.4,26,64,0.406,8,21,0.381,15,20,0.75,91
1618,DEN,2016-11-10,101,,GSW,0,240,38,94,0.404,25,58,0.431,13,36,0.361,12,17,0.706,101,46,85,0.541,32,55,0.582,14,30,0.467,19,20,0.95,125
1619,HOU,2016-11-09,101,@,SAS,1,240,37,78,0.474,27,48,0.563,10,30,0.333,17,22,0.773,101,33,84,0.393,26,61,0.426,7,23,0.304,26,30,0.867,99
1620,PHI,2016-11-05,101,,CLE,0,240,40,87,0.46,26,49,0.531,14,38,0.368,7,12,0.583,101,37,91,0.407,23,53,0.434,14,38,0.368,14,18,0.778,102
1621,DET,2016-11-02,101,@,BRK,0,240,37,88,0.42,28,63,0.444,9,25,0.36,18,21,0.857,101,41,76,0.539,28,49,0.571,13,27,0.481,14,17,0.824,109
1622,PHI,2016-11-01,101,,ORL,0,240,40,81,0.494,31,61,0.508,9,20,0.45,12,16,0.75,101,42,93,0.452,36,68,0.529,6,25,0.24,13,17,0.765,103
1623,IND,2016-10-29,101,@,CHI,0,240,43,88,0.489,36,70,0.514,7,18,0.389,8,9,0.889,101,45,86,0.523,36,65,0.554,9,21,0.429,19,21,0.905,118
1624,DAL,2017-04-12,100,@,MEM,1,240,33,75,0.44,24,41,0.585,9,34,0.265,25,31,0.806,100,33,84,0.393,25,59,0.424,8,25,0.32,19,22,0.864,93
1625,POR,2017-04-12,100,,NOP,0,240,41,85,0.482,28,55,0.509,13,30,0.433,5,13,0.385,100,40,90,0.444,32,66,0.485,8,24,0.333,15,21,0.714,103
1626,OKC,2017-04-11,100,@,MIN,1,240,37,86,0.43,30,64,0.469,7,22,0.318,19,25,0.76,100,38,86,0.442,33,66,0.5,5,20,0.25,17,25,0.68,98
1627,CLE,2017-04-07,100,,ATL,0,240,39,81,0.481,30,45,0.667,9,36,0.25,13,17,0.765,100,45,89,0.506,29,52,0.558,16,37,0.432,8,8,1.0,114
1628,MEM,2017-04-05,100,,OKC,0,240,37,78,0.474,28,52,0.538,9,26,0.346,17,21,0.81,100,37,85,0.435,23,54,0.426,14,31,0.452,15,24,0.625,103
1629,NYK,2017-04-04,100,,CHI,1,240,42,89,0.472,36,66,0.545,6,23,0.261,10,16,0.625,100,32,85,0.376,26,58,0.448,6,27,0.222,21,23,0.913,91
1630,SAS,2017-03-31,100,@,OKC,1,240,37,85,0.435,28,58,0.483,9,27,0.333,17,27,0.63,100,33,81,0.407,27,60,0.45,6,21,0.286,23,27,0.852,95
1631,IND,2017-03-31,100,@,TOR,0,240,36,87,0.414,25,61,0.41,11,26,0.423,17,21,0.81,100,37,82,0.451,23,55,0.418,14,27,0.519,23,35,0.657,111
1632,BOS,2017-03-29,100,,MIL,0,240,35,88,0.398,23,51,0.451,12,37,0.324,18,23,0.783,100,41,78,0.526,33,56,0.589,8,22,0.364,13,17,0.765,103
1633,NOP,2017-03-27,100,@,UTA,0,240,37,80,0.463,27,55,0.491,10,25,0.4,16,24,0.667,100,41,85,0.482,26,58,0.448,15,27,0.556,11,18,0.611,108
1634,MIN,2017-03-25,100,@,POR,0,240,37,76,0.487,35,66,0.53,2,10,0.2,24,32,0.75,100,45,71,0.634,34,49,0.694,11,22,0.5,11,17,0.647,112
1635,MIL,2017-03-24,100,,ATL,1,240,39,88,0.443,31,61,0.508,8,27,0.296,14,16,0.875,100,34,83,0.41,26,61,0.426,8,22,0.364,21,24,0.875,97
1636,SAC,2017-03-24,100,@,GSW,0,240,40,83,0.482,30,62,0.484,10,21,0.476,10,13,0.769,100,44,89,0.494,34,58,0.586,10,31,0.323,16,18,0.889,114
1637,ATL,2017-03-22,100,@,WAS,0,240,34,86,0.395,26,61,0.426,8,25,0.32,24,29,0.828,100,38,95,0.4,27,61,0.443,11,34,0.324,17,23,0.739,104
1638,IND,2017-03-22,100,@,BOS,0,240,38,87,0.437,27,59,0.458,11,28,0.393,13,19,0.684,100,43,84,0.512,32,57,0.561,11,27,0.407,12,14,0.857,109
1639,SAS,2017-03-21,100,@,MIN,1,240,37,77,0.481,29,53,0.547,8,24,0.333,18,22,0.818,100,32,72,0.444,25,57,0.439,7,15,0.467,22,25,0.88,93
1640,UTA,2017-03-20,100,@,IND,0,240,40,88,0.455,34,63,0.54,6,25,0.24,14,20,0.7,100,38,87,0.437,28,67,0.418,10,20,0.5,21,23,0.913,107
1641,LAL,2017-03-15,100,@,HOU,0,240,42,91,0.462,39,66,0.591,3,25,0.12,13,18,0.722,100,50,91,0.549,32,48,0.667,18,43,0.419,21,32,0.656,139
1642,NOP,2017-03-14,100,,POR,1,240,38,80,0.475,32,59,0.542,6,21,0.286,18,30,0.6,100,23,76,0.303,12,44,0.273,11,32,0.344,20,26,0.769,77
1643,TOR,2017-03-13,100,,DAL,1,240,37,78,0.474,28,53,0.528,9,25,0.36,17,18,0.944,100,31,85,0.365,24,60,0.4,7,25,0.28,9,13,0.692,78
1644,BOS,2017-03-12,100,,CHI,1,240,40,86,0.465,24,49,0.49,16,37,0.432,4,4,1.0,100,33,87,0.379,26,62,0.419,7,25,0.28,7,9,0.778,80
1645,PHO,2017-03-11,100,@,DAL,1,240,38,83,0.458,32,62,0.516,6,21,0.286,18,20,0.9,100,28,74,0.378,19,48,0.396,9,26,0.346,33,36,0.917,98
1646,PHI,2017-03-11,100,@,LAC,0,240,40,84,0.476,30,54,0.556,10,30,0.333,10,14,0.714,100,40,81,0.494,32,56,0.571,8,25,0.32,24,29,0.828,112
1647,CHO,2017-03-06,100,,IND,1,240,35,86,0.407,24,55,0.436,11,31,0.355,19,21,0.905,100,37,81,0.457,25,51,0.49,12,30,0.4,2,3,0.667,88
1648,MEM,2017-03-03,100,@,DAL,0,240,38,82,0.463,29,54,0.537,9,28,0.321,15,22,0.682,100,39,82,0.476,34,55,0.618,5,27,0.185,21,27,0.778,104
1649,SAC,2017-03-01,100,,BRK,0,240,35,81,0.432,24,59,0.407,11,22,0.5,19,22,0.864,100,34,74,0.459,23,46,0.5,11,28,0.393,30,36,0.833,109
1650,ATL,2017-03-01,100,,DAL,1,240,36,64,0.563,26,43,0.605,10,21,0.476,18,24,0.75,100,35,77,0.455,21,44,0.477,14,33,0.424,11,13,0.846,95
1651,SAS,2017-03-01,100,,IND,1,240,35,74,0.473,26,45,0.578,9,29,0.31,21,24,0.875,100,37,81,0.457,30,58,0.517,7,23,0.304,18,25,0.72,99
1652,MIL,2017-02-26,100,,PHO,1,240,39,76,0.513,33,56,0.589,6,20,0.3,16,18,0.889,100,40,83,0.482,35,69,0.507,5,14,0.357,11,16,0.688,96
1653,DEN,2017-02-23,100,@,SAC,0,240,39,88,0.443,27,53,0.509,12,35,0.343,10,14,0.714,100,46,88,0.523,39,74,0.527,7,14,0.5,17,19,0.895,116
1654,IND,2017-02-11,100,,MIL,0,240,35,73,0.479,25,51,0.49,10,22,0.455,20,24,0.833,100,35,73,0.479,18,42,0.429,17,31,0.548,29,37,0.784,116
1655,OKC,2017-02-01,100,,CHI,0,240,38,100,0.38,28,63,0.444,10,37,0.27,14,17,0.824,100,49,81,0.605,43,66,0.652,6,15,0.4,24,30,0.8,128
1656,MIA,2017-01-27,100,@,CHI,1,240,41,89,0.461,32,65,0.492,9,24,0.375,9,11,0.818,100,33,78,0.423,30,65,0.462,3,13,0.231,19,25,0.76,88
1657,CHI,2017-01-24,100,@,ORL,1,240,35,77,0.455,28,55,0.509,7,22,0.318,23,30,0.767,100,35,85,0.412,28,63,0.444,7,22,0.318,15,20,0.75,92
1658,IND,2017-01-21,100,@,UTA,0,240,39,77,0.506,29,57,0.509,10,20,0.5,12,17,0.706,100,39,84,0.464,33,60,0.55,6,24,0.25,25,32,0.781,109
1659,OKC,2017-01-18,100,@,GSW,0,240,38,90,0.422,30,62,0.484,8,28,0.286,16,19,0.842,100,46,85,0.541,36,64,0.563,10,21,0.476,19,27,0.704,121
1660,SAC,2017-01-18,100,,IND,0,240,35,72,0.486,26,51,0.51,9,21,0.429,21,27,0.778,100,39,75,0.52,32,54,0.593,7,21,0.333,21,25,0.84,106
1661,SAC,2017-01-10,100,,DET,1,240,32,73,0.438,19,50,0.38,13,23,0.565,23,29,0.793,100,36,82,0.439,24,55,0.436,12,27,0.444,10,16,0.625,94
1662,UTA,2017-01-10,100,,CLE,1,240,38,79,0.481,25,45,0.556,13,34,0.382,11,19,0.579,100,31,85,0.365,22,54,0.407,9,31,0.29,21,25,0.84,92
1663,MIA,2017-01-06,100,@,LAL,0,240,38,92,0.413,30,60,0.5,8,32,0.25,16,27,0.593,100,48,96,0.5,38,68,0.559,10,28,0.357,21,29,0.724,127
1664,HOU,2017-01-06,100,@,ORL,1,240,39,86,0.453,24,37,0.649,15,49,0.306,7,12,0.583,100,38,91,0.418,30,68,0.441,8,23,0.348,9,13,0.692,93
1665,UTA,2016-12-29,100,,PHI,1,240,35,73,0.479,20,47,0.426,15,26,0.577,15,28,0.536,100,35,87,0.402,29,63,0.46,6,24,0.25,7,8,0.875,83
1666,LAL,2016-12-27,100,,UTA,0,240,39,83,0.47,35,67,0.522,4,16,0.25,18,22,0.818,100,38,75,0.507,29,49,0.592,9,26,0.346,17,24,0.708,102
1667,PHI,2016-12-26,100,@,SAC,0,240,39,79,0.494,30,54,0.556,9,25,0.36,13,18,0.722,100,39,87,0.448,32,62,0.516,7,25,0.28,17,21,0.81,102
1668,CHI,2016-12-25,100,@,SAS,0,240,39,86,0.453,32,68,0.471,7,18,0.389,15,20,0.75,100,48,85,0.565,39,67,0.582,9,18,0.5,14,19,0.737,119
1669,MIN,2016-12-25,100,@,OKC,0,240,39,83,0.47,35,71,0.493,4,12,0.333,18,23,0.783,100,42,82,0.512,34,58,0.586,8,24,0.333,20,24,0.833,112
1670,HOU,2016-12-20,100,,SAS,0,240,35,92,0.38,29,54,0.537,6,38,0.158,24,27,0.889,100,36,77,0.468,24,54,0.444,12,23,0.522,18,25,0.72,102
1671,NOP,2016-12-18,100,@,SAS,0,240,41,89,0.461,31,63,0.492,10,26,0.385,8,14,0.571,100,42,86,0.488,31,64,0.484,11,22,0.5,18,22,0.818,113
1672,NOP,2016-12-16,100,@,HOU,0,240,40,98,0.408,31,71,0.437,9,27,0.333,11,20,0.55,100,42,94,0.447,18,33,0.545,24,61,0.393,14,19,0.737,122
1673,DAL,2016-12-16,100,@,UTA,0,240,35,77,0.455,23,49,0.469,12,28,0.429,18,21,0.857,100,37,65,0.569,29,43,0.674,8,22,0.364,21,27,0.778,103
1674,LAL,2016-12-16,100,@,PHI,1,240,36,79,0.456,27,49,0.551,9,30,0.3,19,22,0.864,100,32,88,0.364,26,57,0.456,6,31,0.194,19,24,0.792,89
1675,MIL,2016-12-12,100,@,TOR,0,240,42,89,0.472,38,65,0.585,4,24,0.167,12,17,0.706,100,42,81,0.519,28,56,0.5,14,25,0.56,24,28,0.857,122
1676,MIA,2016-12-10,100,@,CHI,0,240,42,91,0.462,37,71,0.521,5,20,0.25,11,18,0.611,100,38,84,0.452,37,76,0.487,1,8,0.125,28,31,0.903,105
1677,SAC,2016-12-09,100,,NYK,0,240,35,87,0.402,28,59,0.475,7,28,0.25,23,27,0.852,100,36,84,0.429,26,55,0.473,10,29,0.345,21,25,0.84,103
1678,LAL,2016-12-03,100,@,MEM,0,240,35,81,0.432,28,60,0.467,7,21,0.333,23,29,0.793,100,41,88,0.466,31,58,0.534,10,30,0.333,11,15,0.733,103
1679,ATL,2016-11-28,100,@,GSW,0,240,36,85,0.424,29,56,0.518,7,29,0.241,21,30,0.7,100,37,85,0.435,25,50,0.5,12,35,0.343,19,24,0.792,105
1680,WAS,2016-11-26,100,,SAS,0,240,42,88,0.477,36,66,0.545,6,22,0.273,10,14,0.714,100,40,75,0.533,31,51,0.608,9,24,0.375,23,29,0.793,112
1681,CHO,2016-11-18,100,,ATL,1,240,37,90,0.411,27,61,0.443,10,29,0.345,16,24,0.667,100,39,84,0.464,32,56,0.571,7,28,0.25,11,17,0.647,96
1682,MIL,2016-11-16,100,@,ATL,0,240,39,98,0.398,31,66,0.47,8,32,0.25,14,18,0.778,100,35,72,0.486,25,40,0.625,10,32,0.313,27,31,0.871,107
1683,CLE,2016-11-13,100,,CHO,1,240,39,92,0.424,25,54,0.463,14,38,0.368,8,15,0.533,100,36,95,0.379,25,66,0.379,11,29,0.379,10,12,0.833,93
1684,HOU,2016-11-12,100,,SAS,0,240,34,89,0.382,19,42,0.452,15,47,0.319,17,21,0.81,100,41,76,0.539,36,58,0.621,5,18,0.278,19,24,0.792,106
1685,DET,2016-11-09,100,@,PHO,0,240,32,89,0.36,23,67,0.343,9,22,0.409,27,32,0.844,100,38,84,0.452,30,62,0.484,8,22,0.364,23,30,0.767,107
1686,IND,2016-11-07,100,@,CHO,0,240,40,94,0.426,31,61,0.508,9,33,0.273,11,15,0.733,100,41,84,0.488,29,52,0.558,12,32,0.375,28,32,0.875,122
1687,POR,2016-11-06,100,@,MEM,1,240,32,71,0.451,18,38,0.474,14,33,0.424,22,27,0.815,100,31,81,0.383,25,55,0.455,6,26,0.231,26,32,0.813,94
1688,SAS,2016-11-04,100,@,UTA,1,240,37,83,0.446,31,63,0.492,6,20,0.3,20,22,0.909,100,30,80,0.375,19,54,0.352,11,26,0.423,15,24,0.625,86
1689,CHI,2016-11-02,100,@,BOS,0,240,35,81,0.432,28,61,0.459,7,20,0.35,23,31,0.742,100,41,87,0.471,27,55,0.491,14,32,0.438,11,17,0.647,107
1690,PHO,2016-10-30,100,,GSW,0,240,37,90,0.411,29,67,0.433,8,23,0.348,18,25,0.72,100,35,83,0.422,27,54,0.5,8,29,0.276,28,33,0.848,106
1691,GSW,2016-10-25,100,,SAS,0,240,40,85,0.471,33,52,0.635,7,33,0.212,13,18,0.722,100,47,98,0.48,35,74,0.473,12,24,0.5,23,26,0.885,129
1692,POR,2017-04-10,99,,SAS,1,240,37,89,0.416,25,62,0.403,12,27,0.444,13,15,0.867,99,38,83,0.458,30,62,0.484,8,21,0.381,14,20,0.7,98
1693,GSW,2017-04-10,99,,UTA,0,240,39,80,0.488,30,55,0.545,9,25,0.36,12,17,0.706,99,41,92,0.446,28,57,0.491,13,35,0.371,10,15,0.667,105
1694,OKC,2017-04-07,99,@,PHO,0,240,34,92,0.37,27,62,0.435,7,30,0.233,24,33,0.727,99,43,83,0.518,35,65,0.538,8,18,0.444,26,31,0.839,120
1695,CHO,2017-04-05,99,,MIA,0,240,35,78,0.449,27,53,0.509,8,25,0.32,21,24,0.875,99,40,84,0.476,19,44,0.432,21,40,0.525,11,12,0.917,112
1696,MEM,2017-03-31,99,,DAL,1,240,35,75,0.467,24,48,0.5,11,27,0.407,18,20,0.9,99,29,76,0.382,17,42,0.405,12,34,0.353,20,25,0.8,90
1697,CHI,2017-03-30,99,,CLE,1,240,38,90,0.422,26,65,0.4,12,25,0.48,11,18,0.611,99,37,83,0.446,27,56,0.482,10,27,0.37,9,16,0.563,93
1698,ATL,2017-03-29,99,@,PHI,1,240,34,80,0.425,25,62,0.403,9,18,0.5,22,26,0.846,99,36,87,0.414,25,48,0.521,11,39,0.282,9,11,0.818,92
1699,BOS,2017-03-19,99,@,PHI,0,240,34,84,0.405,28,55,0.509,6,29,0.207,25,29,0.862,99,41,88,0.466,29,55,0.527,12,33,0.364,11,15,0.733,105
1700,ATL,2017-03-13,99,@,SAS,0,240,37,81,0.457,31,59,0.525,6,22,0.273,19,30,0.633,99,39,81,0.481,23,47,0.489,16,34,0.471,13,17,0.765,107
1701,TOR,2017-03-10,99,@,ATL,0,240,37,92,0.402,33,67,0.493,4,25,0.16,21,27,0.778,99,39,75,0.52,31,53,0.585,8,22,0.364,19,29,0.655,105
1702,BOS,2017-03-10,99,@,DEN,0,240,34,81,0.42,22,48,0.458,12,33,0.364,19,23,0.826,99,45,85,0.529,33,54,0.611,12,31,0.387,17,22,0.773,119
1703,MIL,2017-03-10,99,,IND,1,240,33,64,0.516,26,47,0.553,7,17,0.412,26,30,0.867,99,33,75,0.44,31,57,0.544,2,18,0.111,17,22,0.773,85
1704,BOS,2017-03-08,99,@,GSW,1,240,37,84,0.44,27,55,0.491,10,29,0.345,15,19,0.789,99,37,84,0.44,31,54,0.574,6,30,0.2,6,9,0.667,86
1705,MIA,2017-03-03,99,@,ORL,0,240,35,91,0.385,27,63,0.429,8,28,0.286,21,25,0.84,99,45,90,0.5,40,73,0.548,5,17,0.294,15,19,0.789,110
1706,CLE,2017-03-01,99,@,BOS,0,240,37,91,0.407,27,58,0.466,10,33,0.303,15,22,0.682,99,36,78,0.462,23,47,0.489,13,31,0.419,18,23,0.783,103
1707,IND,2017-03-01,99,@,SAS,0,240,37,81,0.457,30,58,0.517,7,23,0.304,18,25,0.72,99,35,74,0.473,26,45,0.578,9,29,0.31,21,24,0.875,100
1708,CLE,2017-02-25,99,,CHI,0,240,37,80,0.463,23,43,0.535,14,37,0.378,11,15,0.733,99,46,93,0.495,31,63,0.492,15,30,0.5,10,16,0.625,117
1709,CHO,2017-02-25,99,@,SAC,1,240,34,85,0.4,20,47,0.426,14,38,0.368,17,18,0.944,99,31,79,0.392,20,51,0.392,11,28,0.393,12,15,0.8,85
1710,NOP,2017-02-23,99,,HOU,0,240,36,86,0.419,30,55,0.545,6,31,0.194,21,26,0.808,99,45,91,0.495,25,40,0.625,20,51,0.392,19,24,0.792,129
1711,LAC,2017-02-15,99,,ATL,1,240,37,79,0.468,23,42,0.548,14,37,0.378,11,12,0.917,99,32,79,0.405,25,53,0.472,7,26,0.269,13,19,0.684,84
1712,DEN,2017-02-15,99,,MIN,0,240,38,94,0.404,27,60,0.45,11,34,0.324,12,18,0.667,99,41,86,0.477,35,68,0.515,6,18,0.333,24,28,0.857,112
1713,CHO,2017-02-13,99,,PHI,0,240,34,78,0.436,23,47,0.489,11,31,0.355,20,26,0.769,99,41,86,0.477,29,53,0.547,12,33,0.364,11,17,0.647,105
1714,NOP,2017-02-12,99,@,SAC,0,240,34,82,0.415,21,51,0.412,13,31,0.419,18,21,0.857,99,35,78,0.449,24,47,0.511,11,31,0.355,24,27,0.889,105
1715,BRK,2017-02-10,99,,MIA,0,240,35,81,0.432,27,61,0.443,8,20,0.4,21,28,0.75,99,41,92,0.446,34,69,0.493,7,23,0.304,19,21,0.905,108
1716,POR,2017-02-05,99,@,OKC,0,240,35,87,0.402,25,59,0.424,10,28,0.357,19,21,0.905,99,40,98,0.408,36,80,0.45,4,18,0.222,21,28,0.75,105
1717,MIN,2017-02-04,99,,MEM,0,240,35,84,0.417,25,58,0.431,10,26,0.385,19,24,0.792,99,32,77,0.416,22,49,0.449,10,28,0.357,33,39,0.846,107
1718,DEN,2017-02-01,99,,MEM,0,240,32,80,0.4,23,55,0.418,9,25,0.36,26,35,0.743,99,45,92,0.489,31,62,0.5,14,30,0.467,15,20,0.75,119
1719,TOR,2017-01-25,99,@,MEM,0,240,39,92,0.424,29,58,0.5,10,34,0.294,11,19,0.579,99,36,78,0.462,26,56,0.464,10,22,0.455,19,25,0.76,101
1720,CHO,2017-01-23,99,,WAS,0,240,35,90,0.389,27,58,0.466,8,32,0.25,21,25,0.84,99,43,80,0.538,33,55,0.6,10,25,0.4,13,17,0.765,109
1721,SAC,2017-01-21,99,@,CHI,0,240,37,84,0.44,28,58,0.483,9,26,0.346,16,21,0.762,99,34,83,0.41,28,66,0.424,6,17,0.353,28,33,0.848,102
1722,MIA,2017-01-19,99,,DAL,1,240,35,73,0.479,26,53,0.491,9,20,0.45,20,29,0.69,99,37,82,0.451,23,46,0.5,14,36,0.389,7,11,0.636,95
1723,DAL,2017-01-17,99,@,CHI,1,240,37,78,0.474,26,50,0.52,11,28,0.393,14,18,0.778,99,37,82,0.451,31,68,0.456,6,14,0.429,18,22,0.818,98
1724,NOP,2017-01-14,99,@,CHI,0,240,39,84,0.464,32,61,0.525,7,23,0.304,14,21,0.667,99,43,101,0.426,35,81,0.432,8,20,0.4,13,23,0.565,107
1725,CHI,2017-01-10,99,@,WAS,0,240,35,88,0.398,25,61,0.41,10,27,0.37,19,21,0.905,99,42,83,0.506,31,61,0.508,11,22,0.5,6,9,0.667,101
1726,ATL,2017-01-05,99,@,NOP,1,240,38,90,0.422,29,67,0.433,9,23,0.391,14,17,0.824,99,34,93,0.366,19,58,0.328,15,35,0.429,11,14,0.786,94
1727,DEN,2017-01-05,99,,SAS,0,240,39,86,0.453,32,61,0.525,7,25,0.28,14,17,0.824,99,51,90,0.567,39,66,0.591,12,24,0.5,13,17,0.765,127
1728,PHO,2017-01-03,99,,MIA,1,240,36,77,0.468,27,54,0.5,9,23,0.391,18,22,0.818,99,36,91,0.396,30,68,0.441,6,23,0.261,12,16,0.75,90
1729,DAL,2016-12-30,99,@,GSW,0,240,39,93,0.419,31,61,0.508,8,32,0.25,13,15,0.867,99,42,84,0.5,31,51,0.608,11,33,0.333,13,15,0.867,108
1730,MIL,2016-12-30,99,@,MIN,0,240,40,74,0.541,32,56,0.571,8,18,0.444,11,17,0.647,99,43,77,0.558,30,52,0.577,13,25,0.52,17,21,0.81,116
1731,PHO,2016-12-29,99,,TOR,1,240,37,83,0.446,28,62,0.452,9,21,0.429,16,23,0.696,99,30,75,0.4,23,48,0.479,7,27,0.259,24,29,0.828,91
1732,BRK,2016-12-28,99,@,CHI,0,240,37,86,0.43,24,54,0.444,13,32,0.406,12,16,0.75,99,35,88,0.398,32,75,0.427,3,13,0.231,28,29,0.966,101
1733,BRK,2016-12-23,99,@,CLE,0,240,38,85,0.447,30,55,0.545,8,30,0.267,15,18,0.833,99,45,99,0.455,37,64,0.578,8,35,0.229,21,24,0.875,119
1734,DAL,2016-12-18,99,,SAC,1,240,34,77,0.442,21,44,0.477,13,33,0.394,18,22,0.818,99,30,76,0.395,22,45,0.489,8,31,0.258,11,17,0.647,79
1735,ATL,2016-12-17,99,,CHO,0,240,40,86,0.465,30,60,0.5,10,26,0.385,9,16,0.563,99,43,88,0.489,31,61,0.508,12,27,0.444,9,13,0.692,107
1736,MIN,2016-12-13,99,@,CHI,1,240,38,86,0.442,32,65,0.492,6,21,0.286,17,22,0.773,99,38,87,0.437,34,72,0.472,4,15,0.267,14,19,0.737,94
1737,OKC,2016-12-11,99,,BOS,1,240,41,83,0.494,38,62,0.613,3,21,0.143,14,27,0.519,99,40,90,0.444,29,58,0.5,11,32,0.344,5,8,0.625,96
1738,OKC,2016-12-09,99,,HOU,0,240,34,81,0.42,27,53,0.509,7,28,0.25,24,31,0.774,99,36,92,0.391,25,50,0.5,11,42,0.262,19,30,0.633,102
1739,PHI,2016-12-08,99,@,NOP,1,240,39,91,0.429,27,51,0.529,12,40,0.3,9,13,0.692,99,33,84,0.393,26,59,0.441,7,25,0.28,15,22,0.682,88
1740,UTA,2016-12-08,99,,GSW,0,240,37,89,0.416,27,51,0.529,10,38,0.263,15,21,0.714,99,39,80,0.488,27,51,0.529,12,29,0.414,16,23,0.696,106
1741,ATL,2016-12-05,99,,OKC,0,240,34,77,0.442,27,55,0.491,7,22,0.318,24,32,0.75,99,37,80,0.463,27,49,0.551,10,31,0.323,18,28,0.643,102
1742,POR,2016-12-03,99,,MIA,1,240,36,89,0.404,27,65,0.415,9,24,0.375,18,24,0.75,99,38,86,0.442,32,64,0.5,6,22,0.273,10,15,0.667,92
1743,MIL,2016-11-25,99,,TOR,0,240,40,79,0.506,28,50,0.56,12,29,0.414,7,12,0.583,99,38,82,0.463,24,50,0.48,14,32,0.438,15,19,0.789,105
1744,PHI,2016-11-23,99,,MEM,0,290,35,93,0.376,23,57,0.404,12,36,0.333,17,23,0.739,99,38,99,0.384,28,70,0.4,10,29,0.345,18,24,0.75,104
1745,HOU,2016-11-21,99,@,DET,1,240,35,78,0.449,25,47,0.532,10,31,0.323,19,27,0.704,99,36,87,0.414,29,70,0.414,7,17,0.412,17,24,0.708,96
1746,BOS,2016-11-21,99,@,MIN,1,240,38,84,0.452,26,46,0.565,12,38,0.316,11,14,0.786,99,36,86,0.419,32,62,0.516,4,24,0.167,17,25,0.68,93
1747,TOR,2016-11-20,99,@,SAC,0,240,34,85,0.4,25,61,0.41,9,24,0.375,22,24,0.917,99,36,81,0.444,25,54,0.463,11,27,0.407,19,25,0.76,102
1748,LAL,2016-11-13,99,@,MIN,0,240,33,71,0.465,25,47,0.532,8,24,0.333,25,30,0.833,99,42,80,0.525,29,53,0.547,13,27,0.481,28,42,0.667,125
1749,IND,2016-11-12,99,,BOS,0,240,36,86,0.419,30,59,0.508,6,27,0.222,21,28,0.75,99,35,80,0.438,27,55,0.491,8,25,0.32,27,33,0.818,105
1750,NOP,2016-11-12,99,,LAL,0,240,39,90,0.433,33,70,0.471,6,20,0.3,15,19,0.789,99,52,94,0.553,36,64,0.563,16,30,0.533,6,7,0.857,126
1751,SAS,2016-11-09,99,,HOU,0,240,33,84,0.393,26,61,0.426,7,23,0.304,26,30,0.867,99,37,78,0.474,27,48,0.563,10,30,0.333,17,22,0.773,101
1752,LAC,2016-11-04,99,@,MEM,1,240,32,85,0.376,24,58,0.414,8,27,0.296,27,33,0.818,99,31,84,0.369,22,58,0.379,9,26,0.346,17,22,0.773,88
1753,CHO,2016-11-04,99,@,BRK,1,240,36,86,0.419,26,56,0.464,10,30,0.333,17,24,0.708,99,35,87,0.402,26,51,0.51,9,36,0.25,16,21,0.762,95
1754,MIN,2016-11-03,99,,DEN,0,240,35,88,0.398,26,66,0.394,9,22,0.409,20,25,0.8,99,39,81,0.481,33,59,0.559,6,22,0.273,18,25,0.72,102
1755,NYK,2016-11-02,99,,HOU,0,240,37,85,0.435,29,65,0.446,8,20,0.4,17,25,0.68,99,42,89,0.472,27,49,0.551,15,40,0.375,19,27,0.704,118
1756,MIA,2016-10-30,99,,SAS,0,240,37,80,0.463,30,60,0.5,7,20,0.35,18,26,0.692,99,37,82,0.451,27,64,0.422,10,18,0.556,22,26,0.846,106
1757,ORL,2016-10-29,99,@,CLE,0,240,38,84,0.452,30,56,0.536,8,28,0.286,15,26,0.577,99,36,88,0.409,25,51,0.49,11,37,0.297,22,30,0.733,105
1758,WAS,2016-10-27,99,@,ATL,0,240,40,94,0.426,34,74,0.459,6,20,0.3,13,18,0.722,99,44,88,0.5,32,62,0.516,12,26,0.462,14,18,0.778,114
1759,BOS,2016-10-27,99,@,CHI,0,240,38,76,0.5,30,53,0.566,8,23,0.348,15,24,0.625,99,36,92,0.391,25,67,0.373,11,25,0.44,22,30,0.733,105
1760,TOR,2017-04-12,98,@,CLE,1,240,40,86,0.465,32,60,0.533,8,26,0.308,10,16,0.625,98,28,76,0.368,18,39,0.462,10,37,0.27,17,24,0.708,83
1761,MIN,2017-04-11,98,,OKC,0,240,38,86,0.442,33,66,0.5,5,20,0.25,17,25,0.68,98,37,86,0.43,30,64,0.469,7,22,0.318,19,25,0.76,100
1762,SAS,2017-04-10,98,@,POR,0,240,38,83,0.458,30,62,0.484,8,21,0.381,14,20,0.7,98,37,89,0.416,25,62,0.403,12,27,0.444,13,15,0.867,99
1763,LAC,2017-04-08,98,@,SAS,1,240,42,84,0.5,36,62,0.581,6,22,0.273,8,14,0.571,98,34,80,0.425,26,58,0.448,8,22,0.364,11,14,0.786,87
1764,LAL,2017-04-07,98,,SAC,1,240,38,86,0.442,34,62,0.548,4,24,0.167,18,25,0.72,98,38,75,0.507,30,55,0.545,8,20,0.4,10,13,0.769,94
1765,MIN,2017-04-06,98,@,POR,0,240,38,87,0.437,34,69,0.493,4,18,0.222,18,20,0.9,98,35,81,0.432,21,48,0.438,14,33,0.424,21,26,0.808,105
1766,SAC,2017-04-04,98,,DAL,1,240,36,81,0.444,24,59,0.407,12,22,0.545,14,17,0.824,98,32,80,0.4,20,37,0.541,12,43,0.279,11,14,0.786,87
1767,NYK,2017-03-31,98,@,MIA,1,240,38,80,0.475,32,64,0.5,6,16,0.375,16,17,0.941,98,34,83,0.41,26,50,0.52,8,33,0.242,18,25,0.72,94
1768,HOU,2017-03-31,98,@,GSW,0,240,34,91,0.374,22,54,0.407,12,37,0.324,18,23,0.783,98,43,95,0.453,32,63,0.508,11,32,0.344,10,14,0.714,107
1769,SAS,2017-03-29,98,,GSW,0,240,34,83,0.41,25,59,0.424,9,24,0.375,21,26,0.808,98,43,85,0.506,30,59,0.508,13,26,0.5,11,11,1.0,110
1770,SAC,2017-03-26,98,@,LAC,1,240,38,84,0.452,25,56,0.446,13,28,0.464,9,13,0.692,98,32,78,0.41,22,49,0.449,10,29,0.345,23,28,0.821,97
1771,NYK,2017-03-25,98,@,SAS,0,240,41,87,0.471,38,77,0.494,3,10,0.3,13,15,0.867,98,45,99,0.455,35,74,0.473,10,25,0.4,6,8,0.75,106
1772,PHO,2017-03-23,98,@,BRK,0,240,34,93,0.366,27,68,0.397,7,25,0.28,23,34,0.676,98,43,95,0.453,35,66,0.53,8,29,0.276,32,42,0.762,126
1773,SAC,2017-03-22,98,,MIL,0,240,41,84,0.488,31,58,0.534,10,26,0.385,6,10,0.6,98,43,81,0.531,27,46,0.587,16,35,0.457,14,19,0.737,116
1774,BRK,2017-03-21,98,,DET,1,240,38,88,0.432,28,59,0.475,10,29,0.345,12,19,0.632,98,40,92,0.435,35,69,0.507,5,23,0.217,11,16,0.688,96
1775,CHO,2017-03-18,98,,WAS,1,240,35,82,0.427,26,58,0.448,9,24,0.375,19,27,0.704,98,29,79,0.367,18,46,0.391,11,33,0.333,24,31,0.774,93
1776,BOS,2017-03-17,98,@,BRK,1,240,34,85,0.4,27,56,0.482,7,29,0.241,23,29,0.793,98,30,83,0.361,19,48,0.396,11,35,0.314,24,30,0.8,95
1777,IND,2017-03-15,98,,CHO,1,240,39,73,0.534,27,45,0.6,12,28,0.429,8,9,0.889,98,32,80,0.4,29,57,0.509,3,23,0.13,10,13,0.769,77
1778,MEM,2017-03-15,98,@,CHI,1,240,36,85,0.424,25,54,0.463,11,31,0.355,15,18,0.833,98,34,91,0.374,23,63,0.365,11,28,0.393,12,15,0.8,91
1779,MIA,2017-03-12,98,@,IND,0,240,39,94,0.415,30,62,0.484,9,32,0.281,11,16,0.688,98,35,82,0.427,30,67,0.448,5,15,0.333,27,32,0.844,102
1780,DAL,2017-03-11,98,,PHO,0,240,28,74,0.378,19,48,0.396,9,26,0.346,33,36,0.917,98,38,83,0.458,32,62,0.516,6,21,0.286,18,20,0.9,100
1781,MEM,2017-03-09,98,,LAC,0,240,37,83,0.446,30,63,0.476,7,20,0.35,17,22,0.773,98,40,78,0.513,29,48,0.604,11,30,0.367,23,28,0.821,114
1782,ORL,2017-03-08,98,,CHI,1,240,37,89,0.416,30,64,0.469,7,25,0.28,17,21,0.81,98,36,81,0.444,24,53,0.453,12,28,0.429,7,11,0.636,91
1783,DET,2017-03-08,98,@,IND,0,240,39,89,0.438,32,63,0.508,7,26,0.269,13,22,0.591,98,44,88,0.5,33,65,0.508,11,23,0.478,16,19,0.842,115
1784,PHI,2017-03-06,98,,MIL,0,240,39,89,0.438,31,59,0.525,8,30,0.267,12,19,0.632,98,41,83,0.494,27,50,0.54,14,33,0.424,16,20,0.8,112
1785,CLE,2017-03-06,98,,MIA,0,240,35,78,0.449,26,51,0.51,9,27,0.333,19,29,0.655,98,39,91,0.429,23,56,0.411,16,35,0.457,12,14,0.857,106
1786,NOP,2017-03-03,98,,SAS,0,265,35,91,0.385,27,66,0.409,8,25,0.32,20,24,0.833,98,40,95,0.421,34,68,0.5,6,27,0.222,15,25,0.6,101
1787,MIL,2017-03-01,98,,DEN,0,240,38,83,0.458,29,65,0.446,9,18,0.5,13,15,0.867,98,41,84,0.488,31,51,0.608,10,33,0.303,18,20,0.9,110
1788,PHI,2017-03-01,98,@,MIA,0,240,37,85,0.435,31,68,0.456,6,17,0.353,18,22,0.818,98,49,90,0.544,36,60,0.6,13,30,0.433,14,21,0.667,125
1789,BOS,2017-02-27,98,,ATL,0,240,34,87,0.391,24,53,0.453,10,34,0.294,20,25,0.8,98,46,95,0.484,40,70,0.571,6,25,0.24,16,20,0.8,114
1790,DEN,2017-02-26,98,,MEM,0,240,37,84,0.44,26,50,0.52,11,34,0.324,13,17,0.765,98,36,80,0.45,25,47,0.532,11,33,0.333,22,25,0.88,105
1791,DET,2017-02-26,98,,BOS,0,240,35,81,0.432,23,48,0.479,12,33,0.364,16,35,0.457,98,34,85,0.4,22,50,0.44,12,35,0.343,24,30,0.8,104
1792,LAL,2017-02-26,98,,SAS,0,240,40,87,0.46,33,65,0.508,7,22,0.318,11,18,0.611,98,49,94,0.521,39,73,0.534,10,21,0.476,11,13,0.846,119
1793,IND,2017-02-16,98,,WAS,0,240,40,80,0.5,36,62,0.581,4,18,0.222,14,18,0.778,98,43,83,0.518,28,54,0.519,15,29,0.517,10,15,0.667,111
1794,DET,2017-02-15,98,,DAL,1,240,36,82,0.439,30,63,0.476,6,19,0.316,20,22,0.909,98,35,92,0.38,25,55,0.455,10,37,0.27,11,11,1.0,91
1795,DAL,2017-02-13,98,,BOS,0,240,35,77,0.455,26,50,0.52,9,27,0.333,19,25,0.76,98,40,81,0.494,24,47,0.511,16,34,0.471,15,18,0.833,111
1796,OKC,2017-02-13,98,@,WAS,0,240,34,96,0.354,27,62,0.435,7,34,0.206,23,30,0.767,98,42,73,0.575,29,53,0.547,13,20,0.65,23,28,0.821,120
1797,CHO,2017-02-04,98,@,UTA,0,240,35,82,0.427,22,49,0.449,13,33,0.394,15,18,0.833,98,38,81,0.469,25,48,0.521,13,33,0.394,16,24,0.667,105
1798,IND,2017-02-01,98,@,ORL,1,240,33,69,0.478,24,49,0.49,9,20,0.45,23,26,0.885,98,31,77,0.403,25,53,0.472,6,24,0.25,20,28,0.714,88
1799,NOP,2017-02-01,98,@,DET,0,240,41,82,0.5,36,61,0.59,5,21,0.238,11,14,0.786,98,48,88,0.545,38,62,0.613,10,26,0.385,12,17,0.706,118
1800,CHO,2017-01-31,98,@,POR,0,240,33,83,0.398,22,52,0.423,11,31,0.355,21,25,0.84,98,42,93,0.452,31,62,0.5,11,31,0.355,20,23,0.87,115
1801,LAC,2017-01-28,98,@,GSW,0,240,36,82,0.439,24,54,0.444,12,28,0.429,14,22,0.636,98,57,92,0.62,40,58,0.69,17,34,0.5,13,16,0.813,144
1802,ORL,2017-01-27,98,@,BOS,0,240,38,87,0.437,29,62,0.468,9,25,0.36,13,18,0.722,98,50,89,0.562,34,55,0.618,16,34,0.471,12,15,0.8,128
1803,DAL,2017-01-26,98,@,OKC,0,240,38,84,0.452,27,58,0.466,11,26,0.423,11,13,0.846,98,37,72,0.514,28,50,0.56,9,22,0.409,26,36,0.722,109
1804,LAL,2017-01-25,98,@,POR,0,240,37,94,0.394,26,64,0.406,11,30,0.367,13,14,0.929,98,43,90,0.478,39,75,0.52,4,15,0.267,15,20,0.75,105
1805,ORL,2017-01-22,98,,GSW,0,240,42,96,0.438,35,68,0.515,7,28,0.25,7,16,0.438,98,42,89,0.472,23,47,0.489,19,42,0.452,15,19,0.789,118
1806,LAC,2017-01-21,98,@,DEN,0,240,40,96,0.417,30,64,0.469,10,32,0.313,8,8,1.0,98,46,87,0.529,36,63,0.571,10,24,0.417,21,26,0.808,123
1807,ORL,2017-01-18,98,@,NOP,0,240,39,88,0.443,28,56,0.5,11,32,0.344,9,11,0.818,98,46,93,0.495,31,57,0.544,15,36,0.417,11,15,0.733,118
1808,CHI,2017-01-17,98,,DAL,0,240,37,82,0.451,31,68,0.456,6,14,0.429,18,22,0.818,98,37,78,0.474,26,50,0.52,11,28,0.393,14,18,0.778,99
1809,CHO,2017-01-16,98,@,BOS,0,240,38,86,0.442,30,61,0.492,8,25,0.32,14,17,0.824,98,42,84,0.5,27,45,0.6,15,39,0.385,9,10,0.9,108
1810,OKC,2017-01-16,98,@,LAC,0,240,36,85,0.424,26,55,0.473,10,30,0.333,16,19,0.842,98,45,82,0.549,33,54,0.611,12,28,0.429,18,22,0.818,120
1811,IND,2017-01-16,98,,NOP,1,240,41,81,0.506,36,62,0.581,5,19,0.263,11,16,0.688,98,36,83,0.434,26,58,0.448,10,25,0.4,13,18,0.722,95
1812,MIL,2017-01-15,98,@,ATL,0,240,39,79,0.494,33,60,0.55,6,19,0.316,14,18,0.778,98,42,80,0.525,29,54,0.537,13,26,0.5,14,18,0.778,111
1813,DAL,2017-01-15,98,,MIN,1,240,36,77,0.468,24,48,0.5,12,29,0.414,14,19,0.737,98,35,80,0.438,30,59,0.508,5,21,0.238,12,18,0.667,87
1814,PHI,2017-01-11,98,,NYK,1,240,37,95,0.389,30,67,0.448,7,28,0.25,17,21,0.81,98,42,86,0.488,38,64,0.594,4,22,0.182,9,10,0.9,97
1815,LAC,2017-01-08,98,,MIA,1,240,36,86,0.419,27,56,0.482,9,30,0.3,17,25,0.68,98,31,84,0.369,24,57,0.421,7,27,0.259,17,21,0.81,86
1816,SAC,2017-01-06,98,,LAC,0,240,36,87,0.414,27,57,0.474,9,30,0.3,17,22,0.773,98,39,84,0.464,26,53,0.491,13,31,0.419,15,21,0.714,106
1817,PHO,2017-01-02,98,@,LAC,0,240,39,102,0.382,37,87,0.425,2,15,0.133,18,22,0.818,98,37,80,0.463,30,64,0.469,7,16,0.438,28,38,0.737,109
1818,MIL,2017-01-02,98,,OKC,1,240,38,79,0.481,31,60,0.517,7,19,0.368,15,24,0.625,98,36,78,0.462,27,51,0.529,9,27,0.333,13,19,0.684,94
1819,MIA,2017-01-01,98,,DET,0,240,35,77,0.455,21,51,0.412,14,26,0.538,14,18,0.778,98,42,86,0.488,33,64,0.516,9,22,0.409,14,22,0.636,107
1820,SAC,2016-12-31,98,,MEM,0,240,31,72,0.431,20,44,0.455,11,28,0.393,25,28,0.893,98,44,87,0.506,27,52,0.519,17,35,0.486,7,9,0.778,112
1821,DET,2016-12-30,98,@,ATL,0,240,35,84,0.417,26,53,0.491,9,31,0.29,19,21,0.905,98,39,88,0.443,31,62,0.5,8,26,0.308,19,25,0.76,105
1822,LAC,2016-12-28,98,@,NOP,0,240,37,94,0.394,26,57,0.456,11,37,0.297,13,18,0.722,98,40,87,0.46,30,58,0.517,10,29,0.345,12,21,0.571,102
1823,PHO,2016-12-28,98,@,SAS,0,240,36,74,0.486,29,58,0.5,7,16,0.438,19,24,0.792,98,47,87,0.54,42,70,0.6,5,17,0.294,20,25,0.8,119
1824,NYK,2016-12-28,98,@,ATL,0,265,35,93,0.376,28,66,0.424,7,27,0.259,21,26,0.808,98,37,101,0.366,30,74,0.405,7,27,0.259,21,27,0.778,102
1825,UTA,2016-12-23,98,,TOR,0,240,35,79,0.443,25,52,0.481,10,27,0.37,18,21,0.857,98,43,81,0.531,35,60,0.583,8,21,0.381,10,15,0.667,104
1826,MEM,2016-12-21,98,@,DET,1,240,35,82,0.427,23,52,0.442,12,30,0.4,16,19,0.842,98,26,72,0.361,20,49,0.408,6,23,0.261,28,37,0.757,86
1827,MIA,2016-12-16,98,,LAC,0,240,38,93,0.409,32,66,0.485,6,27,0.222,16,25,0.64,98,36,83,0.434,29,58,0.5,7,25,0.28,23,29,0.793,102
1828,SAC,2016-12-14,98,@,HOU,0,240,39,92,0.424,28,60,0.467,11,32,0.344,9,11,0.818,98,50,85,0.588,28,43,0.651,22,42,0.524,10,16,0.625,132
1829,LAC,2016-12-07,98,,GSW,0,240,36,92,0.391,28,66,0.424,8,26,0.308,18,24,0.75,98,42,89,0.472,35,58,0.603,7,31,0.226,24,29,0.828,115
1830,PHI,2016-12-05,98,,DEN,0,240,35,86,0.407,24,55,0.436,11,31,0.355,17,23,0.739,98,35,76,0.461,25,49,0.51,10,27,0.37,26,34,0.765,106
1831,ORL,2016-12-04,98,@,DET,1,240,42,79,0.532,35,56,0.625,7,23,0.304,7,14,0.5,98,38,86,0.442,28,59,0.475,10,27,0.37,6,13,0.462,92
1832,SAC,2016-12-04,98,@,NYK,0,240,31,97,0.32,22,69,0.319,9,28,0.321,27,31,0.871,98,39,88,0.443,28,59,0.475,11,29,0.379,17,24,0.708,106
1833,DEN,2016-12-03,98,@,UTA,0,240,37,83,0.446,24,59,0.407,13,24,0.542,11,14,0.786,98,35,78,0.449,26,53,0.491,9,25,0.36,26,28,0.929,105
1834,DEN,2016-11-30,98,,MIA,0,240,38,91,0.418,31,69,0.449,7,22,0.318,15,24,0.625,98,41,93,0.441,32,69,0.464,9,24,0.375,15,26,0.577,106
1835,MIN,2016-11-25,98,@,PHO,1,240,34,85,0.4,27,63,0.429,7,22,0.318,23,25,0.92,98,32,79,0.405,26,53,0.491,6,26,0.231,15,21,0.714,85
1836,CHI,2016-11-10,98,@,MIA,1,240,37,89,0.416,31,73,0.425,6,16,0.375,18,20,0.9,98,36,88,0.409,23,59,0.39,13,29,0.448,10,15,0.667,95
1837,UTA,2016-11-09,98,@,CHO,0,240,38,82,0.463,30,48,0.625,8,34,0.235,14,18,0.778,98,38,82,0.463,30,56,0.536,8,26,0.308,20,29,0.69,104
1838,PHO,2016-10-31,98,@,LAC,0,240,35,84,0.417,30,69,0.435,5,15,0.333,23,31,0.742,98,40,80,0.5,34,64,0.531,6,16,0.375,30,38,0.789,116
1839,DET,2016-10-30,98,,MIL,1,240,39,88,0.443,34,68,0.5,5,20,0.25,15,20,0.75,98,34,87,0.391,30,70,0.429,4,17,0.235,11,14,0.786,83
1840,CHO,2016-10-29,98,,BOS,0,240,32,79,0.405,23,47,0.489,9,32,0.281,25,33,0.758,98,39,81,0.481,24,50,0.48,15,31,0.484,11,17,0.647,104
1841,SAS,2016-10-29,98,,NOP,1,240,35,83,0.422,25,59,0.424,10,24,0.417,18,23,0.783,98,32,86,0.372,28,64,0.438,4,22,0.182,11,15,0.733,79
1842,DAL,2016-10-28,98,,HOU,0,240,35,80,0.438,27,51,0.529,8,29,0.276,20,24,0.833,98,33,70,0.471,18,38,0.474,15,32,0.469,25,31,0.806,106
1843,MIN,2016-10-26,98,@,MEM,0,240,36,86,0.419,30,68,0.441,6,18,0.333,20,29,0.69,98,36,80,0.45,25,56,0.446,11,24,0.458,19,27,0.704,102
1844,SAS,2017-04-12,97,@,UTA,0,240,39,86,0.453,31,65,0.477,8,21,0.381,11,13,0.846,97,39,77,0.506,29,51,0.569,10,26,0.385,13,20,0.65,101
1845,NYK,2017-04-09,97,,TOR,0,240,37,82,0.451,28,54,0.519,9,28,0.321,14,15,0.933,97,40,77,0.519,30,46,0.652,10,31,0.323,20,23,0.87,110
1846,IND,2017-03-29,97,@,MEM,0,240,37,85,0.435,27,60,0.45,10,25,0.4,13,15,0.867,97,41,88,0.466,29,56,0.518,12,32,0.375,16,18,0.889,110
1847,MIA,2017-03-28,97,@,DET,1,240,36,79,0.456,31,58,0.534,5,21,0.238,20,28,0.714,97,36,85,0.424,28,58,0.483,8,27,0.296,16,21,0.762,96
1848,LAC,2017-03-26,97,,SAC,0,240,32,78,0.41,22,49,0.449,10,29,0.345,23,28,0.821,97,38,84,0.452,25,56,0.446,13,28,0.464,9,13,0.692,98
1849,POR,2017-03-26,97,@,LAL,1,240,36,89,0.404,24,61,0.393,12,28,0.429,13,18,0.722,97,33,84,0.393,28,63,0.444,5,21,0.238,10,17,0.588,81
1850,ATL,2017-03-24,97,@,MIL,0,240,34,83,0.41,26,61,0.426,8,22,0.364,21,24,0.875,97,39,88,0.443,31,61,0.508,8,27,0.296,14,16,0.875,100
1851,DAL,2017-03-23,97,,LAC,1,240,38,82,0.463,29,56,0.518,9,26,0.346,12,18,0.667,97,36,80,0.45,27,53,0.509,9,27,0.333,14,21,0.667,95
1852,SAS,2017-03-23,97,,MEM,1,240,37,77,0.481,29,51,0.569,8,26,0.308,15,23,0.652,97,34,78,0.436,24,49,0.49,10,29,0.345,12,15,0.8,90
1853,PHI,2017-03-22,97,@,OKC,0,240,37,87,0.425,29,62,0.468,8,25,0.32,15,17,0.882,97,48,88,0.545,44,72,0.611,4,16,0.25,22,30,0.733,122
1854,PHO,2017-03-21,97,@,MIA,0,240,36,82,0.439,32,66,0.485,4,16,0.25,21,29,0.724,97,42,96,0.438,31,69,0.449,11,27,0.407,17,23,0.739,112
1855,ATL,2017-03-18,97,,POR,0,240,32,88,0.364,25,62,0.403,7,26,0.269,26,32,0.813,97,44,87,0.506,36,69,0.522,8,18,0.444,17,19,0.895,113
1856,MIL,2017-03-15,97,@,LAC,1,240,34,76,0.447,24,47,0.511,10,29,0.345,19,25,0.76,97,35,75,0.467,30,51,0.588,5,24,0.208,21,29,0.724,96
1857,UTA,2017-03-15,97,@,DET,1,240,36,77,0.468,23,49,0.469,13,28,0.464,12,16,0.75,97,36,86,0.419,33,73,0.452,3,13,0.231,8,12,0.667,83
1858,LAL,2017-03-05,97,,NOP,0,240,38,83,0.458,28,55,0.509,10,28,0.357,11,15,0.733,97,36,89,0.404,27,65,0.415,9,24,0.375,24,35,0.686,105
1859,IND,2017-03-05,97,@,ATL,1,240,35,78,0.449,20,45,0.444,15,33,0.455,12,21,0.571,97,34,77,0.442,25,50,0.5,9,27,0.333,19,31,0.613,96
1860,SAS,2017-03-04,97,,MIN,1,265,38,94,0.404,32,70,0.457,6,24,0.25,15,24,0.625,97,35,89,0.393,31,73,0.425,4,16,0.25,16,22,0.727,90
1861,BRK,2017-03-03,97,@,UTA,0,240,36,89,0.404,29,59,0.492,7,30,0.233,18,24,0.75,97,38,74,0.514,26,48,0.542,12,26,0.462,24,34,0.706,112
1862,LAC,2017-02-24,97,,SAS,0,240,35,79,0.443,28,56,0.5,7,23,0.304,20,24,0.833,97,35,82,0.427,26,56,0.464,9,26,0.346,26,30,0.867,105
1863,BOS,2017-02-24,97,@,TOR,0,240,33,78,0.423,21,40,0.525,12,38,0.316,19,22,0.864,97,40,81,0.494,35,66,0.53,5,15,0.333,22,29,0.759,107
1864,MIN,2017-02-24,97,,DAL,1,240,41,78,0.526,36,65,0.554,5,13,0.385,10,14,0.714,97,35,83,0.422,27,50,0.54,8,33,0.242,6,9,0.667,84
1865,SAC,2017-02-14,97,@,LAL,1,240,36,73,0.493,29,49,0.592,7,24,0.292,18,25,0.72,97,38,83,0.458,26,54,0.481,12,29,0.414,8,15,0.533,96
1866,CHI,2017-02-10,97,@,PHO,0,240,37,86,0.43,32,67,0.478,5,19,0.263,18,22,0.818,97,48,95,0.505,40,76,0.526,8,19,0.421,11,13,0.846,115
1867,DEN,2017-02-04,97,@,SAS,0,240,41,92,0.446,31,66,0.47,10,26,0.385,5,10,0.5,97,45,79,0.57,35,58,0.603,10,21,0.476,21,26,0.808,121
1868,BRK,2017-02-03,97,,IND,0,240,32,86,0.372,21,58,0.362,11,28,0.393,22,23,0.957,97,37,86,0.43,29,66,0.439,8,20,0.4,24,31,0.774,106
1869,MIN,2017-02-01,97,@,CLE,0,240,41,94,0.436,34,73,0.466,7,21,0.333,8,10,0.8,97,48,89,0.539,33,52,0.635,15,37,0.405,14,22,0.636,125
1870,CLE,2017-01-30,97,@,DAL,0,240,35,75,0.467,23,43,0.535,12,32,0.375,15,21,0.714,97,39,86,0.453,30,54,0.556,9,32,0.281,17,18,0.944,104
1871,OKC,2017-01-23,97,@,UTA,1,240,36,83,0.434,30,63,0.476,6,20,0.3,19,25,0.76,97,36,84,0.429,31,63,0.492,5,21,0.238,18,26,0.692,95
1872,MIL,2017-01-21,97,@,MIA,0,240,33,79,0.418,27,61,0.443,6,18,0.333,25,32,0.781,97,41,77,0.532,28,47,0.596,13,30,0.433,14,22,0.636,109
1873,LAL,2017-01-15,97,,DET,0,240,36,83,0.434,30,57,0.526,6,26,0.231,19,24,0.792,97,41,95,0.432,32,70,0.457,9,25,0.36,11,16,0.688,102
1874,LAL,2017-01-14,97,@,LAC,0,240,36,80,0.45,26,59,0.441,10,21,0.476,15,27,0.556,97,48,92,0.522,38,64,0.594,10,28,0.357,7,8,0.875,113
1875,NYK,2017-01-11,97,@,PHI,0,240,42,86,0.488,38,64,0.594,4,22,0.182,9,10,0.9,97,37,95,0.389,30,67,0.448,7,28,0.25,17,21,0.81,98
1876,BRK,2017-01-10,97,,ATL,0,240,35,87,0.402,25,58,0.431,10,29,0.345,17,23,0.739,97,44,92,0.478,37,69,0.536,7,23,0.304,22,38,0.579,117
1877,ATL,2017-01-07,97,@,DAL,1,240,30,74,0.405,19,52,0.365,11,22,0.5,26,32,0.813,97,32,82,0.39,23,46,0.5,9,36,0.25,9,10,0.9,82
1878,CHI,2016-12-21,97,,WAS,0,240,38,95,0.4,32,74,0.432,6,21,0.286,15,19,0.789,97,43,82,0.524,40,64,0.625,3,18,0.167,18,25,0.72,107
1879,CHI,2016-12-15,97,@,MIL,0,240,35,74,0.473,30,54,0.556,5,20,0.25,22,29,0.759,97,45,95,0.474,34,75,0.453,11,20,0.55,7,13,0.538,108
1880,LAL,2016-12-14,97,@,BRK,0,240,35,91,0.385,29,64,0.453,6,27,0.222,21,34,0.618,97,33,86,0.384,22,51,0.431,11,35,0.314,30,40,0.75,107
1881,PHI,2016-12-11,97,@,DET,1,240,38,68,0.559,31,51,0.608,7,17,0.412,14,17,0.824,97,32,82,0.39,27,63,0.429,5,19,0.263,10,14,0.714,79
1882,SAS,2016-12-05,97,@,MIL,1,240,40,93,0.43,32,65,0.492,8,28,0.286,9,14,0.643,97,30,73,0.411,24,49,0.49,6,24,0.25,30,34,0.882,96
1883,BOS,2016-12-02,97,,SAC,1,240,36,88,0.409,25,60,0.417,11,28,0.393,14,15,0.933,97,33,88,0.375,27,62,0.435,6,26,0.231,20,25,0.8,92
1884,CHO,2016-12-01,97,,DAL,1,240,35,74,0.473,30,56,0.536,5,18,0.278,22,31,0.71,97,32,86,0.372,23,55,0.418,9,31,0.29,14,18,0.778,87
1885,BRK,2016-11-25,97,@,IND,0,240,36,79,0.456,25,45,0.556,11,34,0.324,14,23,0.609,97,48,87,0.552,37,61,0.607,11,26,0.423,11,16,0.688,118
1886,LAC,2016-11-25,97,@,DET,0,240,35,73,0.479,28,52,0.538,7,21,0.333,20,26,0.769,97,47,90,0.522,38,71,0.535,9,19,0.474,5,7,0.714,108
1887,LAL,2016-11-08,97,,DAL,0,240,38,78,0.487,28,52,0.538,10,26,0.385,11,14,0.786,97,43,82,0.524,33,59,0.559,10,23,0.435,13,15,0.867,109
1888,OKC,2016-11-07,97,,MIA,1,240,37,85,0.435,28,57,0.491,9,28,0.321,14,17,0.824,97,31,84,0.369,27,67,0.403,4,17,0.235,19,22,0.864,85
1889,HOU,2016-11-05,97,@,ATL,0,240,37,85,0.435,25,49,0.51,12,36,0.333,11,13,0.846,97,45,85,0.529,37,65,0.569,8,20,0.4,14,24,0.583,112
1890,GSW,2016-11-04,97,@,LAL,0,240,39,86,0.453,34,54,0.63,5,32,0.156,14,20,0.7,97,45,95,0.474,37,65,0.569,8,30,0.267,19,21,0.905,117
1891,UTA,2016-11-02,97,,DAL,1,240,35,77,0.455,23,52,0.442,12,25,0.48,15,26,0.577,97,33,77,0.429,26,51,0.51,7,26,0.269,8,10,0.8,81
1892,CHO,2016-10-28,97,@,MIA,1,240,35,92,0.38,28,70,0.4,7,22,0.318,20,24,0.833,97,32,86,0.372,18,52,0.346,14,34,0.412,13,20,0.65,91
1893,PHI,2016-10-26,97,,OKC,0,240,36,84,0.429,29,60,0.483,7,24,0.292,18,25,0.72,97,39,94,0.415,33,72,0.458,6,22,0.273,19,26,0.731,103
1894,NOP,2017-04-11,96,@,LAL,0,240,37,79,0.468,30,57,0.526,7,22,0.318,15,20,0.75,96,42,88,0.477,34,66,0.515,8,22,0.364,16,23,0.696,108
1895,HOU,2017-04-10,96,@,LAC,0,240,33,84,0.393,24,44,0.545,9,40,0.225,21,27,0.778,96,46,91,0.505,36,65,0.554,10,26,0.385,23,28,0.821,125
1896,TOR,2017-04-07,96,,MIA,1,240,35,85,0.412,26,65,0.4,9,20,0.45,17,24,0.708,96,33,83,0.398,25,60,0.417,8,23,0.348,20,29,0.69,94
1897,DET,2017-03-28,96,,MIA,0,240,36,85,0.424,28,58,0.483,8,27,0.296,16,21,0.762,96,36,79,0.456,31,58,0.534,5,21,0.238,20,28,0.714,97
1898,DET,2017-03-21,96,@,BRK,0,240,40,92,0.435,35,69,0.507,5,23,0.217,11,16,0.688,96,38,88,0.432,28,59,0.475,10,29,0.345,12,19,0.632,98
1899,SAS,2017-03-18,96,@,MEM,0,240,33,75,0.44,24,47,0.511,9,28,0.321,21,22,0.955,96,32,76,0.421,19,46,0.413,13,30,0.433,27,31,0.871,104
1900,LAC,2017-03-15,96,,MIL,0,240,35,75,0.467,30,51,0.588,5,24,0.208,21,29,0.724,96,34,76,0.447,24,47,0.511,10,29,0.345,19,25,0.76,97
1901,DET,2017-03-14,96,@,CLE,0,240,37,99,0.374,33,80,0.413,4,19,0.211,18,19,0.947,96,46,77,0.597,27,47,0.574,19,30,0.633,17,23,0.739,128
1902,BRK,2017-03-10,96,@,DAL,0,240,34,78,0.436,25,47,0.532,9,31,0.29,19,23,0.826,96,33,78,0.423,19,45,0.422,14,33,0.424,25,28,0.893,105
1903,SAC,2017-03-06,96,@,DEN,0,240,36,83,0.434,30,67,0.448,6,16,0.375,18,21,0.857,96,37,74,0.5,24,44,0.545,13,30,0.433,21,28,0.75,108
1904,ATL,2017-03-05,96,,IND,0,240,34,77,0.442,25,50,0.5,9,27,0.333,19,31,0.613,96,35,78,0.449,20,45,0.444,15,33,0.455,12,21,0.571,97
1905,TOR,2017-03-01,96,,WAS,0,240,33,90,0.367,26,70,0.371,7,20,0.35,23,26,0.885,96,40,84,0.476,31,59,0.525,9,25,0.36,16,19,0.842,105
1906,DAL,2017-02-27,96,,MIA,1,240,33,76,0.434,24,58,0.414,9,18,0.5,21,23,0.913,96,37,83,0.446,28,57,0.491,9,26,0.346,6,13,0.462,89
1907,PHO,2017-02-26,96,@,MIL,0,240,40,83,0.482,35,69,0.507,5,14,0.357,11,16,0.688,96,39,76,0.513,33,56,0.589,6,20,0.3,16,18,0.889,100
1908,DAL,2017-02-25,96,,NOP,1,240,36,78,0.462,24,52,0.462,12,26,0.462,12,16,0.75,96,31,78,0.397,26,54,0.481,5,24,0.208,16,25,0.64,83
1909,LAL,2017-02-14,96,,SAC,0,240,38,83,0.458,26,54,0.481,12,29,0.414,8,15,0.533,96,36,73,0.493,29,49,0.592,7,24,0.292,18,25,0.72,97
1910,PHI,2017-02-06,96,@,DET,0,240,36,85,0.424,31,57,0.544,5,28,0.179,19,28,0.679,96,46,99,0.465,41,77,0.532,5,22,0.227,16,17,0.941,113
1911,BRK,2017-01-30,96,@,MIA,0,240,37,87,0.425,33,61,0.541,4,26,0.154,18,22,0.818,96,39,82,0.476,28,56,0.5,11,26,0.423,15,23,0.652,104
1912,PHO,2017-01-30,96,,MEM,0,240,31,74,0.419,26,55,0.473,5,19,0.263,29,39,0.744,96,39,80,0.488,23,52,0.442,16,28,0.571,21,24,0.875,115
1913,UTA,2017-01-26,96,,LAL,1,240,33,81,0.407,27,55,0.491,6,26,0.231,24,28,0.857,96,36,84,0.429,32,70,0.457,4,14,0.286,12,13,0.923,88
1914,MIL,2017-01-20,96,@,ORL,0,240,34,83,0.41,24,58,0.414,10,25,0.4,18,26,0.692,96,40,87,0.46,32,59,0.542,8,28,0.286,24,31,0.774,112
1915,MIN,2017-01-13,96,,OKC,1,240,39,86,0.453,34,68,0.5,5,18,0.278,13,14,0.929,96,33,85,0.388,30,65,0.462,3,20,0.15,17,21,0.81,86
1916,ORL,2017-01-11,96,@,LAC,0,240,39,92,0.424,33,65,0.508,6,27,0.222,12,18,0.667,96,39,76,0.513,30,50,0.6,9,26,0.346,18,26,0.692,105
1917,NYK,2017-01-09,96,,NOP,0,240,36,85,0.424,25,56,0.446,11,29,0.379,13,16,0.813,96,41,84,0.488,29,57,0.509,12,27,0.444,16,19,0.842,110
1918,CHI,2016-12-31,96,,MIL,0,240,33,83,0.398,23,56,0.411,10,27,0.37,20,28,0.714,96,43,76,0.566,34,61,0.557,9,15,0.6,21,27,0.778,116
1919,WAS,2016-12-23,96,@,MIL,0,240,37,79,0.468,30,55,0.545,7,24,0.292,15,18,0.833,96,45,80,0.563,36,55,0.655,9,25,0.36,24,27,0.889,123
1920,DAL,2016-12-21,96,@,POR,1,240,35,83,0.422,28,52,0.538,7,31,0.226,19,23,0.826,96,32,72,0.444,22,45,0.489,10,27,0.37,21,28,0.75,95
1921,BOS,2016-12-16,96,,CHO,1,240,34,78,0.436,25,50,0.5,9,28,0.321,19,26,0.731,96,32,97,0.33,24,67,0.358,8,30,0.267,16,19,0.842,88
1922,SAC,2016-12-16,96,@,MEM,1,240,31,80,0.388,24,56,0.429,7,24,0.292,27,37,0.73,96,29,77,0.377,24,52,0.462,5,25,0.2,29,36,0.806,92
1923,BOS,2016-12-11,96,@,OKC,0,240,40,90,0.444,29,58,0.5,11,32,0.344,5,8,0.625,96,41,83,0.494,38,62,0.613,3,21,0.143,14,27,0.519,99
1924,MEM,2016-12-06,96,,PHI,1,240,33,86,0.384,31,69,0.449,2,17,0.118,28,35,0.8,96,32,82,0.39,18,41,0.439,14,41,0.341,13,26,0.5,91
1925,MIL,2016-12-05,96,,SAS,0,240,30,73,0.411,24,49,0.49,6,24,0.25,30,34,0.882,96,40,93,0.43,32,65,0.492,8,28,0.286,9,14,0.643,97
1926,NOP,2016-12-02,96,,LAC,0,240,39,85,0.459,34,65,0.523,5,20,0.25,13,21,0.619,96,45,88,0.511,35,64,0.547,10,24,0.417,14,16,0.875,114
1927,LAL,2016-11-30,96,@,CHI,1,240,33,81,0.407,31,73,0.425,2,8,0.25,28,41,0.683,96,32,91,0.352,28,70,0.4,4,21,0.19,22,29,0.759,90
1928,ORL,2016-11-27,96,,MIL,0,240,38,92,0.413,31,64,0.484,7,28,0.25,13,17,0.765,96,41,86,0.477,33,62,0.532,8,24,0.333,14,20,0.7,104
1929,ATL,2016-11-23,96,@,IND,1,240,36,85,0.424,31,65,0.477,5,20,0.25,19,22,0.864,96,34,84,0.405,27,57,0.474,7,27,0.259,10,14,0.714,85
1930,MIN,2016-11-23,96,@,NOP,0,240,33,86,0.384,30,69,0.435,3,17,0.176,27,33,0.818,96,45,83,0.542,36,59,0.61,9,24,0.375,18,23,0.783,117
1931,DET,2016-11-21,96,,HOU,0,240,36,87,0.414,29,70,0.414,7,17,0.412,17,24,0.708,96,35,78,0.449,25,47,0.532,10,31,0.323,19,27,0.704,99
1932,SAS,2016-11-21,96,,DAL,1,240,35,75,0.467,27,55,0.491,8,20,0.4,18,25,0.72,96,35,74,0.473,27,47,0.574,8,27,0.296,13,20,0.65,91
1933,ATL,2016-11-18,96,@,CHO,0,240,39,84,0.464,32,56,0.571,7,28,0.25,11,17,0.647,96,37,90,0.411,27,61,0.443,10,29,0.345,16,24,0.667,100
1934,IND,2016-11-18,96,,PHO,0,240,36,76,0.474,35,69,0.507,1,7,0.143,23,29,0.793,96,46,97,0.474,37,71,0.521,9,26,0.346,15,18,0.833,116
1935,MIA,2016-11-17,96,,MIL,1,240,39,97,0.402,32,67,0.478,7,30,0.233,11,21,0.524,96,28,85,0.329,21,62,0.339,7,23,0.304,10,13,0.769,73
1936,UTA,2016-11-14,96,,MEM,0,240,35,73,0.479,27,45,0.6,8,28,0.286,18,22,0.818,96,36,76,0.474,28,55,0.509,8,21,0.381,22,26,0.846,102
1937,MEM,2016-11-12,96,@,MIL,0,240,35,78,0.449,29,48,0.604,6,30,0.2,20,21,0.952,96,36,68,0.529,29,50,0.58,7,18,0.389,27,36,0.75,106
1938,PHI,2016-11-12,96,@,ATL,0,240,36,83,0.434,25,54,0.463,11,29,0.379,13,20,0.65,96,48,95,0.505,35,63,0.556,13,32,0.406,8,14,0.571,117
1939,SAS,2016-11-11,96,,DET,1,240,36,81,0.444,27,61,0.443,9,20,0.45,15,19,0.789,96,32,76,0.421,27,51,0.529,5,25,0.2,17,21,0.81,86
1940,BRK,2016-11-09,96,@,NYK,0,240,33,79,0.418,22,46,0.478,11,33,0.333,19,27,0.704,96,44,92,0.478,34,62,0.548,10,30,0.333,12,17,0.706,110
1941,SAC,2016-11-06,96,@,TOR,1,240,34,78,0.436,29,62,0.468,5,16,0.313,23,31,0.742,96,30,84,0.357,23,54,0.426,7,30,0.233,24,31,0.774,91
1942,TOR,2016-11-04,96,,MIA,1,240,37,84,0.44,31,59,0.525,6,25,0.24,16,18,0.889,96,34,88,0.386,25,60,0.417,9,28,0.321,10,15,0.667,87
1943,OKC,2016-11-03,96,@,GSW,0,240,35,87,0.402,25,60,0.417,10,27,0.37,16,28,0.571,96,46,89,0.517,32,59,0.542,14,30,0.467,16,20,0.8,122
1944,SAC,2016-11-01,96,@,MIA,0,265,34,89,0.382,29,66,0.439,5,23,0.217,23,27,0.852,96,37,86,0.43,24,57,0.421,13,29,0.448,21,29,0.724,108
1945,LAL,2016-10-30,96,@,OKC,0,240,35,87,0.402,28,55,0.509,7,32,0.219,19,24,0.792,96,45,95,0.474,36,69,0.522,9,26,0.346,14,17,0.824,113
1946,UTA,2016-10-28,96,,LAL,1,240,31,75,0.413,25,50,0.5,6,25,0.24,28,40,0.7,96,32,84,0.381,23,61,0.377,9,23,0.391,16,21,0.762,89
1947,MIL,2016-10-26,96,,CHO,0,240,39,92,0.424,36,76,0.474,3,16,0.188,15,20,0.75,96,40,89,0.449,33,66,0.5,7,23,0.304,20,24,0.833,107
1948,ORL,2016-10-26,96,,MIA,0,240,34,89,0.382,28,71,0.394,6,18,0.333,22,28,0.786,96,47,97,0.485,43,81,0.531,4,16,0.25,10,16,0.625,108
1949,SAC,2017-04-12,95,@,LAC,0,240,40,81,0.494,35,70,0.5,5,11,0.455,10,14,0.714,95,43,83,0.518,33,55,0.6,10,28,0.357,19,25,0.76,115
1950,SAS,2017-04-05,95,,LAL,0,240,39,89,0.438,26,54,0.481,13,35,0.371,4,6,0.667,95,42,86,0.488,35,72,0.486,7,14,0.5,11,14,0.786,102
1951,SAS,2017-04-04,95,,MEM,1,265,35,80,0.438,24,59,0.407,11,21,0.524,14,18,0.778,95,35,89,0.393,27,64,0.422,8,25,0.32,11,18,0.611,89
1952,UTA,2017-03-31,95,,WAS,1,240,33,72,0.458,23,47,0.489,10,25,0.4,19,31,0.613,95,35,87,0.402,30,70,0.429,5,17,0.294,13,16,0.813,88
1953,OKC,2017-03-31,95,,SAS,0,240,33,81,0.407,27,60,0.45,6,21,0.286,23,27,0.852,95,37,85,0.435,28,58,0.483,9,27,0.333,17,27,0.63,100
1954,ATL,2017-03-28,95,,PHO,1,240,34,85,0.4,28,58,0.483,6,27,0.222,21,29,0.724,95,35,96,0.365,28,65,0.431,7,31,0.226,14,24,0.583,91
1955,DET,2017-03-27,95,@,NYK,0,240,36,84,0.429,27,61,0.443,9,23,0.391,14,21,0.667,95,45,84,0.536,38,63,0.603,7,21,0.333,12,13,0.923,109
1956,UTA,2017-03-25,95,@,LAC,0,240,37,86,0.43,29,60,0.483,8,26,0.308,13,18,0.722,95,38,84,0.452,31,57,0.544,7,27,0.259,25,28,0.893,108
1957,NYK,2017-03-23,95,@,POR,0,240,36,88,0.409,31,66,0.47,5,22,0.227,18,20,0.9,95,39,80,0.488,28,59,0.475,11,21,0.524,21,29,0.724,110
1958,LAC,2017-03-23,95,@,DAL,0,240,36,80,0.45,27,53,0.509,9,27,0.333,14,21,0.667,95,38,82,0.463,29,56,0.518,9,26,0.346,12,18,0.667,97
1959,DET,2017-03-22,95,@,CHI,0,240,39,88,0.443,32,68,0.471,7,20,0.35,10,17,0.588,95,47,80,0.588,36,57,0.632,11,23,0.478,12,19,0.632,117
1960,NOP,2017-03-21,95,,MEM,1,240,35,88,0.398,26,59,0.441,9,29,0.31,16,19,0.842,95,32,79,0.405,23,44,0.523,9,35,0.257,9,13,0.692,82
1961,OKC,2017-03-20,95,,GSW,0,240,37,87,0.425,33,66,0.5,4,21,0.19,17,31,0.548,95,40,83,0.482,25,50,0.5,15,33,0.455,16,21,0.762,111
1962,PHO,2017-03-19,95,@,DET,0,240,35,99,0.354,29,77,0.377,6,22,0.273,19,30,0.633,95,40,92,0.435,28,67,0.418,12,25,0.48,20,30,0.667,112
1963,CHI,2017-03-18,95,,UTA,1,240,38,80,0.475,31,61,0.508,7,19,0.368,12,14,0.857,95,31,81,0.383,24,56,0.429,7,25,0.28,17,25,0.68,86
1964,BRK,2017-03-17,95,,BOS,0,240,30,83,0.361,19,48,0.396,11,35,0.314,24,30,0.8,95,34,85,0.4,27,56,0.482,7,29,0.241,23,29,0.793,98
1965,MIN,2017-03-11,95,@,MIL,0,240,37,81,0.457,32,68,0.471,5,13,0.385,16,21,0.762,95,37,80,0.463,29,60,0.483,8,20,0.4,20,23,0.87,102
1966,CHI,2017-03-06,95,@,DET,0,240,34,83,0.41,26,55,0.473,8,28,0.286,19,21,0.905,95,45,92,0.489,39,71,0.549,6,21,0.286,13,20,0.65,109
1967,LAL,2017-03-03,95,,BOS,0,240,37,87,0.425,31,63,0.492,6,24,0.25,15,20,0.75,95,43,84,0.512,33,51,0.647,10,33,0.303,19,25,0.76,115
1968,DAL,2017-03-01,95,@,ATL,0,240,35,77,0.455,21,44,0.477,14,33,0.424,11,13,0.846,95,36,64,0.563,26,43,0.605,10,21,0.476,18,24,0.75,100
1969,MIL,2017-02-27,95,@,CLE,0,240,37,83,0.446,26,53,0.491,11,30,0.367,10,16,0.625,95,35,70,0.5,25,42,0.595,10,28,0.357,22,26,0.846,102
1970,IND,2017-02-25,95,@,MIA,0,240,34,85,0.4,30,73,0.411,4,12,0.333,23,26,0.885,95,38,78,0.487,25,47,0.532,13,31,0.419,24,31,0.774,113
1971,BRK,2017-02-25,95,@,GSW,0,240,38,94,0.404,30,66,0.455,8,28,0.286,11,17,0.647,95,42,100,0.42,31,69,0.449,11,31,0.355,17,22,0.773,112
1972,MIL,2017-02-24,95,,UTA,0,240,32,74,0.432,25,56,0.446,7,18,0.389,24,29,0.828,95,37,74,0.5,29,51,0.569,8,23,0.348,27,30,0.9,109
1973,NOP,2017-02-15,95,@,MEM,1,240,37,75,0.493,29,57,0.509,8,18,0.444,13,22,0.591,95,33,89,0.371,27,56,0.482,6,33,0.182,19,25,0.76,91
1974,CHO,2017-02-09,95,,HOU,0,240,37,85,0.435,29,59,0.492,8,26,0.308,13,14,0.929,95,39,87,0.448,26,47,0.553,13,40,0.325,16,20,0.8,107
1975,ATL,2017-02-06,95,,UTA,0,240,33,74,0.446,27,57,0.474,6,17,0.353,23,32,0.719,95,49,80,0.613,39,54,0.722,10,26,0.385,12,18,0.667,120
1976,BRK,2017-02-05,95,,TOR,0,240,32,76,0.421,19,42,0.452,13,34,0.382,18,21,0.857,95,40,87,0.46,35,68,0.515,5,19,0.263,18,20,0.9,103
1977,NYK,2017-02-01,95,@,BRK,1,240,35,99,0.354,29,72,0.403,6,27,0.222,19,31,0.613,95,37,88,0.42,32,63,0.508,5,25,0.2,11,16,0.688,90
1978,PHI,2017-02-01,95,@,DAL,0,240,35,77,0.455,29,55,0.527,6,22,0.273,19,26,0.731,95,40,86,0.465,30,60,0.5,10,26,0.385,23,28,0.821,113
1979,UTA,2017-01-28,95,,MEM,0,240,29,62,0.468,19,37,0.514,10,25,0.4,27,29,0.931,95,41,80,0.513,30,54,0.556,11,26,0.423,9,10,0.9,102
1980,NYK,2017-01-25,95,@,DAL,0,240,39,92,0.424,32,69,0.464,7,23,0.304,10,12,0.833,95,39,83,0.47,33,57,0.579,6,26,0.231,19,24,0.792,103
1981,UTA,2017-01-23,95,,OKC,0,240,36,84,0.429,31,63,0.492,5,21,0.238,18,26,0.692,95,36,83,0.434,30,63,0.476,6,20,0.3,19,25,0.76,97
1982,MEM,2017-01-21,95,,HOU,0,240,33,89,0.371,24,55,0.436,9,34,0.265,20,28,0.714,95,41,80,0.513,25,38,0.658,16,42,0.381,21,25,0.84,119
1983,IND,2017-01-20,95,@,LAL,0,240,34,80,0.425,25,57,0.439,9,23,0.391,18,25,0.72,95,41,87,0.471,27,54,0.5,14,33,0.424,12,15,0.8,108
1984,DAL,2017-01-19,95,@,MIA,0,240,37,82,0.451,23,46,0.5,14,36,0.389,7,11,0.636,95,35,73,0.479,26,53,0.491,9,20,0.45,20,29,0.69,99
1985,ATL,2017-01-18,95,@,DET,0,240,30,78,0.385,24,53,0.453,6,25,0.24,29,37,0.784,95,45,91,0.495,35,66,0.53,10,25,0.4,18,28,0.643,118
1986,NOP,2017-01-16,95,@,IND,0,240,36,83,0.434,26,58,0.448,10,25,0.4,13,18,0.722,95,41,81,0.506,36,62,0.581,5,19,0.263,11,16,0.688,98
1987,BRK,2017-01-12,95,,NOP,0,240,40,97,0.412,31,55,0.564,9,42,0.214,6,11,0.545,95,38,90,0.422,27,58,0.466,11,32,0.344,17,25,0.68,104
1988,MEM,2017-01-11,95,@,OKC,0,240,38,92,0.413,31,68,0.456,7,24,0.292,12,21,0.571,95,36,81,0.444,28,55,0.509,8,26,0.308,23,29,0.793,103
1989,MIA,2017-01-10,95,@,GSW,0,240,38,90,0.422,32,60,0.533,6,30,0.2,13,17,0.765,95,39,86,0.453,28,59,0.475,11,27,0.407,18,22,0.818,107
1990,BRK,2017-01-08,95,,PHI,0,240,36,78,0.462,26,51,0.51,10,27,0.37,13,17,0.765,95,37,94,0.394,29,67,0.433,8,27,0.296,23,27,0.852,105
1991,ORL,2017-01-08,95,@,LAL,0,240,34,90,0.378,27,64,0.422,7,26,0.269,20,29,0.69,95,42,87,0.483,34,55,0.618,8,32,0.25,19,24,0.792,111
1992,DAL,2017-01-05,95,,PHO,0,240,36,79,0.456,27,50,0.54,9,29,0.31,14,17,0.824,95,38,85,0.447,31,68,0.456,7,17,0.412,19,22,0.864,102
1993,POR,2017-01-01,95,@,MIN,1,240,36,73,0.493,30,51,0.588,6,22,0.273,17,28,0.607,95,35,87,0.402,28,64,0.438,7,23,0.304,12,18,0.667,89
1994,BRK,2016-12-30,95,@,WAS,0,240,32,74,0.432,22,49,0.449,10,25,0.4,21,25,0.84,95,47,83,0.566,36,61,0.59,11,22,0.5,13,14,0.929,118
1995,TOR,2016-12-26,95,@,POR,1,240,32,95,0.337,20,61,0.328,12,34,0.353,19,24,0.792,95,35,83,0.422,27,60,0.45,8,23,0.348,13,18,0.722,91
1996,ORL,2016-12-22,95,@,NYK,0,240,39,90,0.433,34,63,0.54,5,27,0.185,12,16,0.75,95,41,96,0.427,32,76,0.421,9,20,0.45,15,17,0.882,106
1997,POR,2016-12-21,95,,DAL,0,240,32,72,0.444,22,45,0.489,10,27,0.37,21,28,0.75,95,35,83,0.422,28,52,0.538,7,31,0.226,19,23,0.826,96
1998,MIA,2016-12-18,95,,BOS,0,240,36,69,0.522,27,45,0.6,9,24,0.375,14,25,0.56,95,41,90,0.456,32,62,0.516,9,28,0.321,14,19,0.737,105
1999,MIL,2016-12-16,95,@,CHI,1,240,38,82,0.463,28,57,0.491,10,25,0.4,9,13,0.692,95,28,92,0.304,23,71,0.324,5,21,0.238,8,15,0.533,69
2000,IND,2016-12-15,95,@,NOP,0,240,36,87,0.414,33,66,0.5,3,21,0.143,20,24,0.833,95,36,85,0.424,26,58,0.448,10,27,0.37,20,28,0.714,102
2001,DET,2016-12-14,95,@,DAL,1,240,36,71,0.507,31,54,0.574,5,17,0.294,18,22,0.818,95,32,78,0.41,24,53,0.453,8,25,0.32,13,16,0.813,85
2002,MIA,2016-12-14,95,,IND,1,240,37,82,0.451,30,57,0.526,7,25,0.28,14,25,0.56,95,33,89,0.371,24,62,0.387,9,27,0.333,14,17,0.824,89
2003,OKC,2016-12-13,95,@,POR,0,240,33,87,0.379,25,60,0.417,8,27,0.296,21,28,0.75,95,43,80,0.538,35,57,0.614,8,23,0.348,20,27,0.741,114
2004,CHI,2016-12-08,95,,SAS,1,240,35,80,0.438,31,63,0.492,4,17,0.235,21,27,0.778,95,39,97,0.402,30,69,0.435,9,28,0.321,4,5,0.8,91
2005,MIA,2016-12-07,95,@,ATL,0,240,34,80,0.425,23,53,0.434,11,27,0.407,16,20,0.8,95,43,88,0.489,39,69,0.565,4,19,0.211,13,15,0.867,103
2006,LAL,2016-12-07,95,@,HOU,0,240,34,87,0.391,29,67,0.433,5,20,0.25,22,27,0.815,95,51,94,0.543,36,58,0.621,15,36,0.417,17,21,0.81,134
2007,MEM,2016-12-01,95,,ORL,1,240,33,79,0.418,26,61,0.426,7,18,0.389,22,28,0.786,95,33,74,0.446,27,50,0.54,6,24,0.25,22,31,0.71,94
2008,ORL,2016-11-29,95,@,SAS,1,240,39,86,0.453,33,71,0.465,6,15,0.4,11,12,0.917,95,28,76,0.368,23,56,0.411,5,20,0.25,22,26,0.846,83
2009,PHI,2016-11-28,95,@,TOR,0,240,36,86,0.419,22,52,0.423,14,34,0.412,9,13,0.692,95,42,77,0.545,29,58,0.5,13,19,0.684,25,31,0.806,122
2010,SAC,2016-11-28,95,@,WAS,0,265,38,93,0.409,35,72,0.486,3,21,0.143,16,26,0.615,95,35,85,0.412,25,60,0.417,10,25,0.4,21,26,0.808,101
2011,UTA,2016-11-25,95,,ATL,1,240,35,80,0.438,25,46,0.543,10,34,0.294,15,18,0.833,95,26,83,0.313,18,58,0.31,8,25,0.32,8,12,0.667,68
2012,ORL,2016-11-19,95,,DAL,1,240,34,78,0.436,26,57,0.456,8,21,0.381,19,22,0.864,95,26,77,0.338,13,49,0.265,13,28,0.464,22,27,0.815,87
2013,CHI,2016-11-19,95,@,LAC,0,240,33,77,0.429,24,47,0.511,9,30,0.3,20,24,0.833,95,36,77,0.468,25,50,0.5,11,27,0.407,19,23,0.826,102
2014,BRK,2016-11-14,95,@,LAC,0,240,34,77,0.442,24,44,0.545,10,33,0.303,17,22,0.773,95,48,90,0.533,34,65,0.523,14,25,0.56,17,21,0.81,127
2015,WAS,2016-11-12,95,@,CHI,0,240,38,91,0.418,34,78,0.436,4,13,0.308,15,18,0.833,95,39,97,0.402,34,82,0.415,5,15,0.333,23,25,0.92,106
2016,DEN,2016-11-12,95,,DET,0,240,36,84,0.429,27,59,0.458,9,25,0.36,14,19,0.737,95,46,90,0.511,42,72,0.583,4,18,0.222,10,14,0.714,106
2017,MIA,2016-11-10,95,,CHI,0,240,36,88,0.409,23,59,0.39,13,29,0.448,10,15,0.667,95,37,89,0.416,31,73,0.425,6,16,0.375,18,20,0.9,98
2018,DAL,2016-11-09,95,@,GSW,0,240,34,86,0.395,28,58,0.483,6,28,0.214,21,28,0.75,95,43,74,0.581,26,41,0.634,17,33,0.515,13,22,0.591,116
2019,WAS,2016-11-04,95,,ATL,1,240,31,80,0.388,26,60,0.433,5,20,0.25,28,35,0.8,95,32,83,0.386,27,58,0.466,5,25,0.2,23,36,0.639,92
2020,BRK,2016-11-04,95,,CHO,0,240,35,87,0.402,26,51,0.51,9,36,0.25,16,21,0.762,95,36,86,0.419,26,56,0.464,10,30,0.333,17,24,0.708,99
2021,DAL,2016-11-04,95,,POR,0,240,34,83,0.41,24,55,0.436,10,28,0.357,17,20,0.85,95,36,80,0.45,24,49,0.49,12,31,0.387,21,26,0.808,105
2022,SAC,2016-10-31,95,@,ATL,0,240,36,75,0.48,26,52,0.5,10,23,0.435,13,19,0.684,95,33,79,0.418,22,49,0.449,11,30,0.367,29,47,0.617,106
2023,LAL,2017-04-12,94,@,GSW,0,240,41,93,0.441,37,76,0.487,4,17,0.235,8,14,0.571,94,41,90,0.456,29,54,0.537,12,36,0.333,15,22,0.682,109
2024,MIL,2017-04-12,94,@,BOS,0,240,37,84,0.44,31,61,0.508,6,23,0.261,14,17,0.824,94,41,91,0.451,29,54,0.537,12,37,0.324,18,26,0.692,112
2025,SAC,2017-04-07,94,@,LAL,0,240,38,75,0.507,30,55,0.545,8,20,0.4,10,13,0.769,94,38,86,0.442,34,62,0.548,4,24,0.167,18,25,0.72,98
2026,MIA,2017-04-07,94,@,TOR,0,240,33,83,0.398,25,60,0.417,8,23,0.348,20,29,0.69,94,35,85,0.412,26,65,0.4,9,20,0.45,17,24,0.708,96
2027,NYK,2017-04-02,94,,BOS,0,240,33,85,0.388,26,60,0.433,7,25,0.28,21,25,0.84,94,40,72,0.556,28,35,0.8,12,37,0.324,18,26,0.692,110
2028,MIA,2017-03-31,94,,NYK,0,240,34,83,0.41,26,50,0.52,8,33,0.242,18,25,0.72,94,38,80,0.475,32,64,0.5,6,16,0.375,16,17,0.941,98
2029,MEM,2017-03-26,94,@,GSW,0,240,38,85,0.447,30,56,0.536,8,29,0.276,10,15,0.667,94,39,71,0.549,22,40,0.55,17,31,0.548,11,15,0.733,106
2030,PHI,2017-03-26,94,@,IND,0,240,35,88,0.398,21,47,0.447,14,41,0.341,10,14,0.714,94,38,89,0.427,31,72,0.431,7,17,0.412,24,29,0.828,107
2031,MIL,2017-03-26,94,,CHI,0,240,37,84,0.44,30,61,0.492,7,23,0.304,13,17,0.765,94,46,85,0.541,36,64,0.563,10,21,0.476,7,10,0.7,109
2032,TOR,2017-03-25,94,@,DAL,1,240,39,81,0.481,30,60,0.5,9,21,0.429,7,9,0.778,94,31,82,0.378,24,54,0.444,7,28,0.25,17,20,0.85,86
2033,SAC,2017-03-18,94,@,OKC,0,240,35,85,0.412,30,64,0.469,5,21,0.238,19,23,0.826,94,41,82,0.5,31,56,0.554,10,26,0.385,18,25,0.72,110
2034,CHI,2017-03-10,94,,HOU,0,240,38,98,0.388,29,59,0.492,9,39,0.231,9,12,0.75,94,37,89,0.416,22,42,0.524,15,47,0.319,26,32,0.813,115
2035,TOR,2017-03-08,94,@,NOP,1,240,36,76,0.474,28,55,0.509,8,21,0.381,14,23,0.609,94,34,80,0.425,25,51,0.49,9,29,0.31,10,13,0.769,87
2036,TOR,2017-03-04,94,@,MIL,0,240,35,75,0.467,28,54,0.519,7,21,0.333,17,20,0.85,94,38,87,0.437,32,60,0.533,6,27,0.222,19,23,0.826,101
2037,CHI,2017-03-02,94,,GSW,1,240,36,82,0.439,31,63,0.492,5,19,0.263,17,21,0.81,94,34,88,0.386,28,58,0.483,6,30,0.2,13,14,0.929,87
2038,TOR,2017-02-14,94,@,CHI,0,240,35,77,0.455,30,57,0.526,5,20,0.25,19,24,0.792,94,35,73,0.479,28,56,0.5,7,17,0.412,28,35,0.8,105
2039,NYK,2017-02-12,94,,SAS,1,240,34,68,0.5,25,54,0.463,9,14,0.643,17,21,0.81,94,33,91,0.363,27,62,0.435,6,29,0.207,18,22,0.818,90
2040,NOP,2017-02-08,94,,UTA,0,240,35,77,0.455,30,53,0.566,5,24,0.208,19,25,0.76,94,48,88,0.545,34,56,0.607,14,32,0.438,17,21,0.81,127
2041,TOR,2017-02-03,94,@,ORL,0,240,34,87,0.391,24,59,0.407,10,28,0.357,16,21,0.762,94,37,80,0.463,32,66,0.485,5,14,0.357,23,32,0.719,102
2042,OKC,2017-01-31,94,@,SAS,0,240,30,85,0.353,23,57,0.404,7,28,0.25,27,32,0.844,94,37,86,0.43,30,65,0.462,7,21,0.333,27,38,0.711,108
2043,NOP,2017-01-29,94,,WAS,0,240,38,84,0.452,28,52,0.538,10,32,0.313,8,15,0.533,94,45,89,0.506,35,68,0.515,10,21,0.476,7,10,0.7,107
2044,PHI,2017-01-18,94,,TOR,1,240,31,69,0.449,23,45,0.511,8,24,0.333,24,32,0.75,94,34,86,0.395,28,62,0.452,6,24,0.25,15,23,0.652,89
2045,LAL,2017-01-12,94,@,SAS,0,240,35,85,0.412,29,65,0.446,6,20,0.3,18,25,0.72,94,49,81,0.605,39,60,0.65,10,21,0.476,26,29,0.897,134
2046,DET,2017-01-10,94,@,SAC,0,240,36,82,0.439,24,55,0.436,12,27,0.444,10,16,0.625,94,32,73,0.438,19,50,0.38,13,23,0.565,23,29,0.793,100
2047,CHI,2017-01-09,94,,OKC,0,240,34,83,0.41,27,64,0.422,7,19,0.368,19,22,0.864,94,47,83,0.566,40,59,0.678,7,24,0.292,8,11,0.727,109
2048,UTA,2017-01-07,94,@,MIN,1,240,32,77,0.416,24,54,0.444,8,23,0.348,22,28,0.786,94,35,80,0.438,28,60,0.467,7,20,0.35,15,21,0.714,92
2049,NOP,2017-01-05,94,,ATL,0,240,34,93,0.366,19,58,0.328,15,35,0.429,11,14,0.786,94,38,90,0.422,29,67,0.433,9,23,0.391,14,17,0.824,99
2050,CLE,2017-01-04,94,,CHI,0,240,34,83,0.41,26,58,0.448,8,25,0.32,18,24,0.75,94,41,85,0.482,28,55,0.509,13,30,0.433,11,15,0.733,106
2051,OKC,2017-01-02,94,@,MIL,0,240,36,78,0.462,27,51,0.529,9,27,0.333,13,19,0.684,94,38,79,0.481,31,60,0.517,7,19,0.368,15,24,0.625,98
2052,POR,2016-12-30,94,@,SAS,0,240,35,77,0.455,29,57,0.509,6,20,0.3,18,21,0.857,94,39,78,0.5,28,56,0.5,11,22,0.5,21,25,0.84,110
2053,DET,2016-12-28,94,,MIL,0,240,39,88,0.443,33,64,0.516,6,24,0.25,10,16,0.625,94,48,84,0.571,37,62,0.597,11,22,0.5,12,16,0.75,119
2054,MIA,2016-12-27,94,,OKC,0,240,36,82,0.439,29,60,0.483,7,22,0.318,15,21,0.714,94,42,82,0.512,37,63,0.587,5,19,0.263,17,25,0.68,106
2055,SAC,2016-12-21,94,@,UTA,1,240,34,74,0.459,24,53,0.453,10,21,0.476,16,24,0.667,94,33,74,0.446,24,47,0.511,9,27,0.333,18,22,0.818,93
2056,CHI,2016-12-13,94,,MIN,0,240,38,87,0.437,34,72,0.472,4,15,0.267,14,19,0.737,94,38,86,0.442,32,65,0.492,6,21,0.286,17,22,0.773,99
2057,CHO,2016-12-12,94,@,IND,0,240,28,84,0.333,18,58,0.31,10,26,0.385,28,32,0.875,94,43,88,0.489,26,52,0.5,17,36,0.472,7,10,0.7,110
2058,BOS,2016-12-09,94,,TOR,0,240,31,83,0.373,14,41,0.341,17,42,0.405,15,22,0.682,94,34,82,0.415,25,62,0.403,9,20,0.45,24,27,0.889,101
2059,PHO,2016-12-07,94,,IND,0,240,34,85,0.4,25,52,0.481,9,33,0.273,17,18,0.944,94,35,78,0.449,28,55,0.509,7,23,0.304,32,41,0.78,109
2060,NYK,2016-12-07,94,,CLE,0,240,35,87,0.402,24,56,0.429,11,31,0.355,13,15,0.867,94,39,80,0.488,17,40,0.425,22,40,0.55,26,31,0.839,126
2061,ORL,2016-12-01,94,@,MEM,0,240,33,74,0.446,27,50,0.54,6,24,0.25,22,31,0.71,94,33,79,0.418,26,61,0.426,7,18,0.389,22,28,0.786,95
2062,CLE,2016-12-01,94,,LAC,0,240,28,69,0.406,19,45,0.422,9,24,0.375,29,39,0.744,94,42,89,0.472,29,58,0.5,13,31,0.419,16,24,0.667,113
2063,SAS,2016-11-30,94,@,DAL,1,240,33,71,0.465,22,52,0.423,11,19,0.579,17,24,0.708,94,33,77,0.429,23,47,0.489,10,30,0.333,11,14,0.786,87
2064,ATL,2016-11-27,94,@,LAL,0,240,39,88,0.443,27,53,0.509,12,35,0.343,4,10,0.4,94,42,95,0.442,34,75,0.453,8,20,0.4,17,20,0.85,109
2065,WAS,2016-11-25,94,@,ORL,1,240,40,88,0.455,34,59,0.576,6,29,0.207,8,10,0.8,94,35,80,0.438,28,57,0.491,7,23,0.304,14,20,0.7,91
2066,ATL,2016-11-22,94,,NOP,0,240,39,85,0.459,29,56,0.518,10,29,0.345,6,10,0.6,94,45,86,0.523,34,61,0.557,11,25,0.44,11,12,0.917,112
2067,MIA,2016-11-21,94,@,PHI,0,240,34,88,0.386,27,57,0.474,7,31,0.226,19,28,0.679,94,37,78,0.474,26,52,0.5,11,26,0.423,16,20,0.8,101
2068,ATL,2016-11-20,94,@,NYK,0,240,34,85,0.4,28,64,0.438,6,21,0.286,20,29,0.69,94,42,88,0.477,32,61,0.525,10,27,0.37,10,14,0.714,104
2069,BOS,2016-11-19,94,@,DET,1,240,33,82,0.402,21,51,0.412,12,31,0.387,16,17,0.941,94,37,86,0.43,30,66,0.455,7,20,0.35,11,16,0.688,92
2070,SAS,2016-11-14,94,,MIA,1,240,33,82,0.402,25,67,0.373,8,15,0.533,20,27,0.741,94,37,84,0.44,33,69,0.478,4,15,0.267,12,21,0.571,90
2071,WAS,2016-11-11,94,,CLE,0,240,38,87,0.437,35,72,0.486,3,15,0.2,15,19,0.789,94,36,86,0.419,22,53,0.415,14,33,0.424,19,26,0.731,105
2072,NOP,2016-11-08,94,@,SAC,0,240,38,84,0.452,33,63,0.524,5,21,0.238,13,18,0.722,94,39,81,0.481,31,56,0.554,8,25,0.32,16,20,0.8,102
2073,MEM,2016-11-06,94,,POR,0,240,31,81,0.383,25,55,0.455,6,26,0.231,26,32,0.813,94,32,71,0.451,18,38,0.474,14,33,0.424,22,27,0.815,100
2074,CHI,2016-11-05,94,@,IND,0,240,34,79,0.43,28,61,0.459,6,18,0.333,20,25,0.8,94,46,86,0.535,34,60,0.567,12,26,0.462,7,12,0.583,111
2075,SAC,2016-11-03,94,@,ORL,0,240,38,80,0.475,31,62,0.5,7,18,0.389,11,17,0.647,94,38,84,0.452,28,54,0.519,10,30,0.333,16,23,0.696,102
2076,IND,2016-10-28,94,@,BRK,0,240,37,98,0.378,30,74,0.405,7,24,0.292,13,20,0.65,94,38,87,0.437,28,54,0.519,10,33,0.303,17,20,0.85,103
2077,CLE,2016-10-28,94,@,TOR,1,240,33,79,0.418,21,47,0.447,12,32,0.375,16,22,0.727,94,35,90,0.389,31,74,0.419,4,16,0.25,17,18,0.944,91
2078,SAC,2016-10-27,94,,SAS,0,240,28,70,0.4,22,50,0.44,6,20,0.3,32,38,0.842,94,36,79,0.456,30,61,0.492,6,18,0.333,24,27,0.889,102
2079,PHO,2016-10-26,94,,SAC,0,240,36,77,0.468,32,61,0.525,4,16,0.25,18,27,0.667,94,44,86,0.512,38,65,0.585,6,21,0.286,19,26,0.731,113
2080,MEM,2017-04-12,93,,DAL,0,240,33,84,0.393,25,59,0.424,8,25,0.32,19,22,0.864,93,33,75,0.44,24,41,0.585,9,34,0.265,25,31,0.806,100
2081,CLE,2017-03-30,93,@,CHI,0,240,37,83,0.446,27,56,0.482,10,27,0.37,9,16,0.563,93,38,90,0.422,26,65,0.4,12,25,0.48,11,18,0.611,99
2082,MIN,2017-03-21,93,,SAS,0,240,32,72,0.444,25,57,0.439,7,15,0.467,22,25,0.88,93,37,77,0.481,29,53,0.547,8,24,0.333,18,22,0.818,100
2083,MIL,2017-03-21,93,@,POR,1,240,38,90,0.422,31,74,0.419,7,16,0.438,10,12,0.833,93,35,83,0.422,31,62,0.5,4,21,0.19,16,26,0.615,90
2084,WAS,2017-03-18,93,@,CHO,0,240,29,79,0.367,18,46,0.391,11,33,0.333,24,31,0.774,93,35,82,0.427,26,58,0.448,9,24,0.375,19,27,0.704,98
2085,MIL,2017-03-13,93,@,MEM,0,240,31,67,0.463,17,41,0.415,14,26,0.538,17,20,0.85,93,41,79,0.519,27,52,0.519,14,27,0.519,17,23,0.739,113
2086,NYK,2017-03-08,93,@,MIL,0,240,39,84,0.464,32,63,0.508,7,21,0.333,8,12,0.667,93,37,86,0.43,29,60,0.483,8,26,0.308,22,28,0.786,104
2087,LAL,2017-02-24,93,@,OKC,0,240,40,101,0.396,33,66,0.5,7,35,0.2,6,14,0.429,93,44,97,0.454,34,73,0.466,10,24,0.417,12,17,0.706,110
2088,IND,2017-02-06,93,,OKC,1,240,33,87,0.379,25,61,0.41,8,26,0.308,19,29,0.655,93,34,88,0.386,27,60,0.45,7,28,0.25,15,21,0.714,90
2089,ATL,2017-02-01,93,@,MIA,0,240,34,86,0.395,27,60,0.45,7,26,0.269,18,21,0.857,93,45,93,0.484,33,61,0.541,12,32,0.375,14,19,0.737,116
2090,UTA,2017-01-24,93,@,DEN,0,240,35,85,0.412,28,63,0.444,7,22,0.318,16,21,0.762,93,35,76,0.461,25,50,0.5,10,26,0.385,23,31,0.742,103
2091,PHI,2017-01-21,93,@,ATL,0,240,33,78,0.423,21,49,0.429,12,29,0.414,15,18,0.833,93,45,91,0.495,38,71,0.535,7,20,0.35,13,23,0.565,110
2092,CHI,2017-01-20,93,@,ATL,0,240,34,81,0.42,27,53,0.509,7,28,0.25,18,19,0.947,93,39,82,0.476,30,60,0.5,9,22,0.409,15,19,0.789,102
2093,PHI,2017-01-20,93,,POR,1,240,36,92,0.391,24,63,0.381,12,29,0.414,9,16,0.563,93,33,89,0.371,27,70,0.386,6,19,0.316,20,28,0.714,92
2094,PHI,2017-01-14,93,@,WAS,0,240,36,87,0.414,26,56,0.464,10,31,0.323,11,21,0.524,93,44,91,0.484,36,74,0.486,8,17,0.471,13,18,0.722,109
2095,CHO,2017-01-13,93,@,PHI,0,240,28,85,0.329,22,62,0.355,6,23,0.261,31,32,0.969,93,36,76,0.474,22,38,0.579,14,38,0.368,16,20,0.8,102
2096,ORL,2017-01-06,93,,HOU,0,240,38,91,0.418,30,68,0.441,8,23,0.348,9,13,0.692,93,39,86,0.453,24,37,0.649,15,49,0.306,7,12,0.583,100
2097,UTA,2017-01-05,93,@,TOR,0,240,34,73,0.466,27,53,0.509,7,20,0.35,18,21,0.857,93,36,91,0.396,28,70,0.4,8,21,0.381,21,28,0.75,101
2098,PHI,2017-01-03,93,,MIN,1,240,33,85,0.388,26,53,0.491,7,32,0.219,20,25,0.8,93,33,82,0.402,26,58,0.448,7,24,0.292,18,20,0.9,91
2099,UTA,2016-12-21,93,,SAC,0,240,33,74,0.446,24,47,0.511,9,27,0.333,18,22,0.818,93,34,74,0.459,24,53,0.453,10,21,0.476,16,24,0.667,94
2100,PHI,2016-12-20,93,,NOP,0,240,33,82,0.402,22,49,0.449,11,33,0.333,16,21,0.762,93,40,93,0.43,30,76,0.395,10,17,0.588,18,26,0.692,108
2101,MEM,2016-12-14,93,,CLE,1,240,35,81,0.432,23,58,0.397,12,23,0.522,11,16,0.688,93,28,75,0.373,19,50,0.38,9,25,0.36,20,31,0.645,85
2102,BRK,2016-12-01,93,,MIL,0,240,34,89,0.382,22,49,0.449,12,40,0.3,13,16,0.813,93,36,80,0.45,21,46,0.457,15,34,0.441,24,29,0.828,111
2103,MIN,2016-11-21,93,,BOS,0,240,36,86,0.419,32,62,0.516,4,24,0.167,17,25,0.68,93,38,84,0.452,26,46,0.565,12,38,0.316,11,14,0.786,99
2104,MIL,2016-11-21,93,,ORL,1,240,35,86,0.407,27,57,0.474,8,29,0.276,15,21,0.714,93,32,77,0.416,25,52,0.481,7,25,0.28,18,24,0.75,89
2105,MEM,2016-11-19,93,,MIN,1,240,29,76,0.382,27,58,0.466,2,18,0.111,33,38,0.868,93,25,64,0.391,18,42,0.429,7,22,0.318,14,22,0.636,71
2106,CLE,2016-11-16,93,@,IND,0,240,35,86,0.407,24,56,0.429,11,30,0.367,12,20,0.6,93,43,86,0.5,33,58,0.569,10,28,0.357,7,11,0.636,103
2107,ATL,2016-11-15,93,@,MIA,1,240,37,80,0.463,31,63,0.492,6,17,0.353,13,19,0.684,93,36,89,0.404,29,66,0.439,7,23,0.304,11,14,0.786,90
2108,NYK,2016-11-14,93,,DAL,1,240,34,78,0.436,25,53,0.472,9,25,0.36,16,18,0.889,93,32,84,0.381,27,57,0.474,5,27,0.185,8,11,0.727,77
2109,CHO,2016-11-13,93,@,CLE,0,240,36,95,0.379,25,66,0.379,11,29,0.379,10,12,0.833,93,39,92,0.424,25,54,0.463,14,38,0.368,8,15,0.533,100
2110,BOS,2016-11-09,93,@,WAS,0,240,35,81,0.432,25,50,0.5,10,31,0.323,13,22,0.591,93,46,92,0.5,36,71,0.507,10,21,0.476,16,20,0.8,118
2111,PHI,2016-11-02,93,@,CHO,0,240,34,86,0.395,22,48,0.458,12,38,0.316,13,15,0.867,93,39,79,0.494,26,45,0.578,13,34,0.382,18,26,0.692,109
2112,HOU,2016-10-30,93,,DAL,1,240,34,81,0.42,23,50,0.46,11,31,0.355,14,21,0.667,93,32,86,0.372,21,55,0.382,11,31,0.355,17,20,0.85,92
2113,PHI,2017-03-29,92,,ATL,0,240,36,87,0.414,25,48,0.521,11,39,0.282,9,11,0.818,92,34,80,0.425,25,62,0.403,9,18,0.5,22,26,0.846,99
2114,OKC,2017-03-27,92,@,DAL,1,240,37,85,0.435,31,62,0.5,6,23,0.261,12,14,0.857,92,33,80,0.413,23,51,0.451,10,29,0.345,15,19,0.789,91
2115,ATL,2017-03-26,92,,BRK,0,240,34,98,0.347,29,71,0.408,5,27,0.185,19,32,0.594,92,38,86,0.442,32,64,0.5,6,22,0.273,25,30,0.833,107
2116,MIL,2017-03-18,92,@,GSW,0,240,36,89,0.404,27,62,0.435,9,27,0.333,11,14,0.786,92,45,75,0.6,33,52,0.635,12,23,0.522,15,19,0.789,117
2117,ORL,2017-03-16,92,@,GSW,0,240,35,94,0.372,28,67,0.418,7,27,0.259,15,21,0.714,92,50,87,0.575,40,61,0.656,10,26,0.385,12,23,0.522,122
2118,NYK,2017-03-11,92,@,DET,0,240,36,82,0.439,23,52,0.442,13,30,0.433,7,11,0.636,92,46,96,0.479,37,69,0.536,9,27,0.333,11,19,0.579,112
2119,SAC,2017-03-11,92,,DEN,0,240,36,82,0.439,28,59,0.475,8,23,0.348,12,20,0.6,92,40,85,0.471,31,51,0.608,9,34,0.265,16,18,0.889,105
2120,SAS,2017-03-09,92,@,OKC,0,240,35,84,0.417,29,65,0.446,6,19,0.316,16,20,0.8,92,41,89,0.461,35,69,0.507,6,20,0.3,14,21,0.667,102
2121,CLE,2017-03-04,92,@,MIA,0,240,35,73,0.479,24,46,0.522,11,27,0.407,11,18,0.611,92,46,88,0.523,28,54,0.519,18,34,0.529,10,12,0.833,120
2122,TOR,2017-02-27,92,@,NYK,1,240,33,78,0.423,26,52,0.5,7,26,0.269,19,23,0.826,92,33,73,0.452,24,49,0.49,9,24,0.375,16,19,0.842,91
2123,WAS,2017-02-26,92,,UTA,0,240,37,87,0.425,29,65,0.446,8,22,0.364,10,13,0.769,92,34,72,0.472,23,48,0.479,11,24,0.458,23,32,0.719,102
2124,MEM,2017-02-24,92,@,IND,0,240,35,84,0.417,26,57,0.456,9,27,0.333,13,23,0.565,92,40,78,0.513,29,52,0.558,11,26,0.423,11,11,1.0,102
2125,DET,2017-02-10,92,,SAS,0,240,39,92,0.424,34,75,0.453,5,17,0.294,9,13,0.692,92,41,82,0.5,32,63,0.508,9,19,0.474,12,15,0.8,103
2126,CHI,2017-02-08,92,@,GSW,0,240,37,92,0.402,33,68,0.485,4,24,0.167,14,19,0.737,92,48,85,0.565,33,57,0.579,15,28,0.536,12,13,0.923,123
2127,BOS,2017-02-08,92,@,SAC,0,240,29,73,0.397,19,41,0.463,10,32,0.313,24,27,0.889,92,42,84,0.5,32,59,0.542,10,25,0.4,14,15,0.933,108
2128,ORL,2017-01-24,92,,CHI,0,240,35,85,0.412,28,63,0.444,7,22,0.318,15,20,0.75,92,35,77,0.455,28,55,0.509,7,22,0.318,23,30,0.767,100
2129,POR,2017-01-20,92,@,PHI,0,240,33,89,0.371,27,70,0.386,6,19,0.316,20,28,0.714,92,36,92,0.391,24,63,0.381,12,29,0.414,9,16,0.563,93
2130,MIL,2017-01-18,92,@,HOU,0,240,37,93,0.398,30,65,0.462,7,28,0.25,11,14,0.786,92,43,95,0.453,29,51,0.569,14,44,0.318,11,15,0.733,111
2131,CLE,2017-01-10,92,@,UTA,0,240,31,85,0.365,22,54,0.407,9,31,0.29,21,25,0.84,92,38,79,0.481,25,45,0.556,13,34,0.382,11,19,0.579,100
2132,DAL,2017-01-09,92,@,MIN,0,240,36,78,0.462,23,50,0.46,13,28,0.464,7,9,0.778,92,40,71,0.563,34,55,0.618,6,16,0.375,15,21,0.714,101
2133,MIN,2017-01-07,92,,UTA,0,240,35,80,0.438,28,60,0.467,7,20,0.35,15,21,0.714,92,32,77,0.416,24,54,0.444,8,23,0.348,22,28,0.786,94
2134,ORL,2017-01-04,92,,ATL,0,240,37,86,0.43,28,58,0.483,9,28,0.321,9,10,0.9,92,44,81,0.543,34,62,0.548,10,19,0.526,13,18,0.722,111
2135,NYK,2016-12-30,92,@,NOP,0,240,35,93,0.376,28,70,0.4,7,23,0.304,15,16,0.938,92,38,85,0.447,26,56,0.464,12,29,0.414,16,17,0.941,104
2136,MIN,2016-12-21,92,@,ATL,1,240,35,83,0.422,26,54,0.481,9,29,0.31,13,14,0.929,92,34,82,0.415,27,56,0.482,7,26,0.269,9,13,0.692,84
2137,MEM,2016-12-16,92,,SAC,0,240,29,77,0.377,24,52,0.462,5,25,0.2,29,36,0.806,92,31,80,0.388,24,56,0.429,7,24,0.292,27,37,0.73,96
2138,PHO,2016-12-15,92,,SAS,0,240,34,85,0.4,24,58,0.414,10,27,0.37,14,18,0.778,92,39,74,0.527,34,58,0.586,5,16,0.313,24,26,0.923,107
2139,DEN,2016-12-12,92,@,DAL,0,240,35,83,0.422,28,58,0.483,7,25,0.28,15,18,0.833,92,45,77,0.584,33,51,0.647,12,26,0.462,10,12,0.833,112
2140,LAL,2016-12-12,92,@,SAC,0,240,33,84,0.393,23,61,0.377,10,23,0.435,16,21,0.762,92,47,84,0.56,37,61,0.607,10,23,0.435,12,21,0.571,116
2141,WAS,2016-12-08,92,,DEN,1,240,35,78,0.449,29,59,0.492,6,19,0.316,16,17,0.941,92,31,76,0.408,24,44,0.545,7,32,0.219,16,24,0.667,85
2142,NOP,2016-12-04,92,@,OKC,0,240,36,98,0.367,30,70,0.429,6,28,0.214,14,19,0.737,92,41,89,0.461,35,61,0.574,6,28,0.214,13,26,0.5,101
2143,DET,2016-12-04,92,,ORL,0,240,38,86,0.442,28,59,0.475,10,27,0.37,6,13,0.462,92,42,79,0.532,35,56,0.625,7,23,0.304,7,14,0.5,98
2144,MIA,2016-12-03,92,@,POR,0,240,38,86,0.442,32,64,0.5,6,22,0.273,10,15,0.667,92,36,89,0.404,27,65,0.415,9,24,0.375,18,24,0.75,99
2145,SAC,2016-12-02,92,@,BOS,0,240,33,88,0.375,27,62,0.435,6,26,0.231,20,25,0.8,92,36,88,0.409,25,60,0.417,11,28,0.393,14,15,0.933,97
2146,BRK,2016-11-23,92,,BOS,0,240,34,86,0.395,24,55,0.436,10,31,0.323,14,22,0.636,92,45,98,0.459,30,60,0.5,15,38,0.395,6,8,0.75,111
2147,PHO,2016-11-23,92,@,ORL,1,240,33,73,0.452,24,51,0.471,9,22,0.409,17,22,0.773,92,33,91,0.363,26,66,0.394,7,25,0.28,14,23,0.609,87
2148,DET,2016-11-19,92,,BOS,0,240,37,86,0.43,30,66,0.455,7,20,0.35,11,16,0.688,92,33,82,0.402,21,51,0.412,12,31,0.387,16,17,0.941,94
2149,SAS,2016-11-05,92,,LAC,0,240,30,74,0.405,20,49,0.408,10,25,0.4,22,25,0.88,92,47,91,0.516,38,68,0.559,9,23,0.391,13,14,0.929,116
2150,MIN,2016-11-05,92,@,OKC,0,240,33,84,0.393,29,65,0.446,4,19,0.211,22,29,0.759,92,45,86,0.523,38,70,0.543,7,16,0.438,15,24,0.625,112
2151,ATL,2016-11-04,92,@,WAS,0,240,32,83,0.386,27,58,0.466,5,25,0.2,23,36,0.639,92,31,80,0.388,26,60,0.433,5,20,0.25,28,35,0.8,95
2152,DAL,2016-10-30,92,@,HOU,0,240,32,86,0.372,21,55,0.382,11,31,0.355,17,20,0.85,92,34,81,0.42,23,50,0.46,11,31,0.355,14,21,0.667,93
2153,DAL,2017-04-11,91,,DEN,0,240,35,88,0.398,23,48,0.479,12,40,0.3,9,11,0.818,91,41,84,0.488,23,42,0.548,18,42,0.429,9,14,0.643,109
2154,BOS,2017-04-05,91,,CLE,0,240,33,81,0.407,26,48,0.542,7,33,0.212,18,29,0.621,91,43,92,0.467,32,56,0.571,11,36,0.306,17,18,0.944,114
2155,CHI,2017-04-04,91,@,NYK,0,240,32,85,0.376,26,58,0.448,6,27,0.222,21,23,0.913,91,42,89,0.472,36,66,0.545,6,23,0.261,10,16,0.625,100
2156,BRK,2017-04-02,91,,ATL,1,240,32,82,0.39,22,49,0.449,10,33,0.303,17,20,0.85,91,30,80,0.375,23,56,0.411,7,24,0.292,15,23,0.652,82
2157,PHO,2017-03-28,91,@,ATL,0,240,35,96,0.365,28,65,0.431,7,31,0.226,14,24,0.583,91,34,85,0.4,28,58,0.483,6,27,0.222,21,29,0.724,95
2158,DAL,2017-03-27,91,,OKC,0,240,33,80,0.413,23,51,0.451,10,29,0.345,15,19,0.789,91,37,85,0.435,31,62,0.5,6,23,0.261,12,14,0.857,92
2159,SAC,2017-03-27,91,,MEM,1,240,31,67,0.463,25,42,0.595,6,25,0.24,23,30,0.767,91,31,90,0.344,26,64,0.406,5,26,0.192,23,29,0.793,90
2160,IND,2017-03-19,91,@,TOR,0,240,33,80,0.413,27,57,0.474,6,23,0.261,19,26,0.731,91,45,91,0.495,33,64,0.516,12,27,0.444,14,16,0.875,116
2161,CLE,2017-03-16,91,,UTA,1,240,36,86,0.419,27,53,0.509,9,33,0.273,10,19,0.526,91,34,82,0.415,29,61,0.475,5,21,0.238,10,14,0.714,83
2162,ATL,2017-03-16,91,,MEM,0,240,29,71,0.408,21,44,0.477,8,27,0.296,25,34,0.735,91,39,92,0.424,29,64,0.453,10,28,0.357,15,18,0.833,103
2163,CHI,2017-03-15,91,,MEM,0,240,34,91,0.374,23,63,0.365,11,28,0.393,12,15,0.8,91,36,85,0.424,25,54,0.463,11,31,0.355,15,18,0.833,98
2164,LAC,2017-03-08,91,@,MIN,0,240,35,83,0.422,26,59,0.441,9,24,0.375,12,18,0.667,91,42,86,0.488,37,66,0.561,5,20,0.25,18,20,0.9,107
2165,CHI,2017-03-08,91,@,ORL,0,240,36,81,0.444,24,53,0.453,12,28,0.429,7,11,0.636,91,37,89,0.416,30,64,0.469,7,25,0.28,17,21,0.81,98
2166,CHI,2017-03-04,91,,LAC,0,240,35,83,0.422,29,66,0.439,6,17,0.353,15,20,0.75,91,41,85,0.482,35,60,0.583,6,25,0.24,13,16,0.813,101
2167,NYK,2017-02-27,91,,TOR,0,240,33,73,0.452,24,49,0.49,9,24,0.375,16,19,0.842,91,33,78,0.423,26,52,0.5,7,26,0.269,19,23,0.826,92
2168,MEM,2017-02-15,91,,NOP,0,240,33,89,0.371,27,56,0.482,6,33,0.182,19,25,0.76,91,37,75,0.493,29,57,0.509,8,18,0.444,13,22,0.591,95
2169,DAL,2017-02-15,91,@,DET,0,240,35,92,0.38,25,55,0.455,10,37,0.27,11,11,1.0,91,36,82,0.439,30,63,0.476,6,19,0.316,20,22,0.909,98
2170,PHO,2017-02-08,91,@,MEM,0,240,29,87,0.333,24,64,0.375,5,23,0.217,28,34,0.824,91,35,72,0.486,21,48,0.438,14,24,0.583,26,34,0.765,110
2171,NOP,2017-02-04,91,@,WAS,0,240,37,84,0.44,32,67,0.478,5,17,0.294,12,22,0.545,91,38,83,0.458,28,52,0.538,10,31,0.323,19,22,0.864,105
2172,OKC,2017-01-29,91,@,CLE,0,240,37,100,0.37,31,74,0.419,6,26,0.231,11,16,0.688,91,41,92,0.446,33,63,0.524,8,29,0.276,17,22,0.773,107
2173,SAC,2017-01-20,91,@,MEM,0,240,31,76,0.408,25,47,0.532,6,29,0.207,23,32,0.719,91,38,83,0.458,27,55,0.491,11,28,0.393,20,25,0.8,107
2174,CLE,2017-01-16,91,@,GSW,0,240,31,88,0.352,22,54,0.407,9,34,0.265,20,27,0.741,91,46,91,0.505,31,57,0.544,15,34,0.441,19,24,0.792,126
2175,MIN,2017-01-03,91,@,PHI,0,240,33,82,0.402,26,58,0.448,7,24,0.292,18,20,0.9,91,33,85,0.388,26,53,0.491,7,32,0.219,20,25,0.8,93
2176,WAS,2017-01-02,91,@,HOU,0,240,38,87,0.437,32,61,0.525,6,26,0.231,9,12,0.75,91,37,86,0.43,25,47,0.532,12,39,0.308,15,21,0.714,101
2177,UTA,2016-12-31,91,,PHO,1,240,35,73,0.479,27,53,0.509,8,20,0.4,13,20,0.65,91,36,87,0.414,29,70,0.414,7,17,0.412,7,10,0.7,86
2178,TOR,2016-12-29,91,@,PHO,0,240,30,75,0.4,23,48,0.479,7,27,0.259,24,29,0.828,91,37,83,0.446,28,62,0.452,9,21,0.429,16,23,0.696,99
2179,CHO,2016-12-29,91,,MIA,1,240,36,93,0.387,31,67,0.463,5,26,0.192,14,18,0.778,91,33,82,0.402,23,54,0.426,10,28,0.357,6,13,0.462,82
2180,POR,2016-12-26,91,,TOR,0,240,35,83,0.422,27,60,0.45,8,23,0.348,13,18,0.722,91,32,95,0.337,20,61,0.328,12,34,0.353,19,24,0.792,95
2181,CHI,2016-12-23,91,@,CHO,0,240,38,96,0.396,31,74,0.419,7,22,0.318,8,10,0.8,91,37,84,0.44,32,66,0.485,5,18,0.278,24,28,0.857,103
2182,NOP,2016-12-23,91,,MIA,1,240,33,89,0.371,22,61,0.361,11,28,0.393,14,21,0.667,91,36,87,0.414,28,67,0.418,8,20,0.4,7,13,0.538,87
2183,SAS,2016-12-08,91,@,CHI,0,240,39,97,0.402,30,69,0.435,9,28,0.321,4,5,0.8,91,35,80,0.438,31,63,0.492,4,17,0.235,21,27,0.778,95
2184,MIN,2016-12-06,91,,SAS,0,240,36,82,0.439,29,62,0.468,7,20,0.35,12,18,0.667,91,39,74,0.527,28,50,0.56,11,24,0.458,16,19,0.842,105
2185,CHI,2016-12-06,91,@,DET,0,240,33,75,0.44,31,60,0.517,2,15,0.133,23,32,0.719,91,40,88,0.455,32,67,0.478,8,21,0.381,14,21,0.667,102
2186,PHI,2016-12-06,91,@,MEM,0,240,32,82,0.39,18,41,0.439,14,41,0.341,13,26,0.5,91,33,86,0.384,31,69,0.449,2,17,0.118,28,35,0.8,96
2187,DAL,2016-11-27,91,,NOP,1,240,32,77,0.416,22,50,0.44,10,27,0.37,17,20,0.85,91,30,77,0.39,25,57,0.439,5,20,0.25,16,18,0.889,81
2188,IND,2016-11-27,91,,LAC,1,240,40,92,0.435,35,73,0.479,5,19,0.263,6,7,0.857,91,22,70,0.314,18,46,0.391,4,24,0.167,22,27,0.815,70
2189,ORL,2016-11-25,91,,WAS,0,240,35,80,0.438,28,57,0.491,7,23,0.304,14,20,0.7,91,40,88,0.455,34,59,0.576,6,29,0.207,8,10,0.8,94
2190,DAL,2016-11-21,91,@,SAS,0,240,35,74,0.473,27,47,0.574,8,27,0.296,13,20,0.65,91,35,75,0.467,27,55,0.491,8,20,0.4,18,25,0.72,96
2191,UTA,2016-11-20,91,@,DEN,0,240,33,85,0.388,26,58,0.448,7,27,0.259,18,23,0.783,91,42,86,0.488,34,64,0.531,8,22,0.364,13,30,0.433,105
2192,MIA,2016-11-12,91,,UTA,0,240,38,81,0.469,33,64,0.516,5,17,0.294,10,19,0.526,91,40,81,0.494,34,61,0.557,6,20,0.3,16,19,0.842,102
2193,SAC,2016-11-10,91,,LAL,0,240,34,85,0.4,26,64,0.406,8,21,0.381,15,20,0.75,91,38,74,0.514,29,47,0.617,9,27,0.333,16,22,0.727,101
2194,TOR,2016-11-06,91,,SAC,0,240,30,84,0.357,23,54,0.426,7,30,0.233,24,31,0.774,91,34,78,0.436,29,62,0.468,5,16,0.313,23,31,0.742,96
2195,SAC,2016-11-05,91,@,MIL,0,240,33,84,0.393,23,56,0.411,10,28,0.357,15,19,0.789,91,41,82,0.5,27,49,0.551,14,33,0.424,21,25,0.84,117
2196,SAS,2016-11-01,91,,UTA,0,240,33,76,0.434,27,56,0.482,6,20,0.3,19,21,0.905,91,38,76,0.5,23,45,0.511,15,31,0.484,15,18,0.833,106
2197,MIA,2016-10-28,91,,CHO,0,240,32,86,0.372,18,52,0.346,14,34,0.412,13,20,0.65,91,35,92,0.38,28,70,0.4,7,22,0.318,20,24,0.833,97
2198,TOR,2016-10-28,91,,CLE,0,240,35,90,0.389,31,74,0.419,4,16,0.25,17,18,0.944,91,33,79,0.418,21,47,0.447,12,32,0.375,16,22,0.727,94
2199,DET,2016-10-26,91,@,TOR,0,240,35,84,0.417,31,62,0.5,4,22,0.182,17,22,0.773,91,41,86,0.477,38,68,0.559,3,18,0.167,24,29,0.828,109
2200,MEM,2017-04-09,90,,DET,0,240,36,75,0.48,27,54,0.5,9,21,0.429,9,13,0.692,90,39,82,0.476,25,54,0.463,14,28,0.5,11,16,0.688,103
2201,MIL,2017-04-08,90,@,PHI,1,240,35,79,0.443,29,52,0.558,6,27,0.222,14,20,0.7,90,27,77,0.351,19,46,0.413,8,31,0.258,20,23,0.87,82
2202,PHI,2017-04-06,90,,CHI,0,240,33,91,0.363,26,58,0.448,7,33,0.212,17,22,0.773,90,39,91,0.429,31,66,0.47,8,25,0.32,16,17,0.941,102
2203,TOR,2017-04-04,90,@,IND,0,240,34,76,0.447,29,53,0.547,5,23,0.217,17,19,0.895,90,39,89,0.438,27,64,0.422,12,25,0.48,18,18,1.0,108
2204,DAL,2017-03-31,90,@,MEM,0,240,29,76,0.382,17,42,0.405,12,34,0.353,20,25,0.8,90,35,75,0.467,24,48,0.5,11,27,0.407,18,20,0.9,99
2205,DET,2017-03-30,90,,BRK,1,240,36,86,0.419,29,68,0.426,7,18,0.389,11,17,0.647,90,35,92,0.38,25,61,0.41,10,31,0.323,9,12,0.75,89
2206,MEM,2017-03-27,90,@,SAC,0,240,31,90,0.344,26,64,0.406,5,26,0.192,23,29,0.793,90,31,67,0.463,25,42,0.595,6,25,0.24,23,30,0.767,91
2207,DEN,2017-03-26,90,,NOP,0,240,36,95,0.379,30,70,0.429,6,25,0.24,12,14,0.857,90,48,97,0.495,39,70,0.557,9,27,0.333,10,12,0.833,115
2208,MEM,2017-03-23,90,@,SAS,0,240,34,78,0.436,24,49,0.49,10,29,0.345,12,15,0.8,90,37,77,0.481,29,51,0.569,8,26,0.308,15,23,0.652,97
2209,POR,2017-03-21,90,,MIL,0,240,35,83,0.422,31,62,0.5,4,21,0.19,16,26,0.615,90,38,90,0.422,31,74,0.419,7,16,0.438,10,12,0.833,93
2210,ATL,2017-03-20,90,@,CHO,0,240,37,84,0.44,25,47,0.532,12,37,0.324,4,10,0.4,90,40,80,0.5,28,50,0.56,12,30,0.4,13,20,0.65,105
2211,MEM,2017-03-11,90,,ATL,0,240,34,90,0.378,29,61,0.475,5,29,0.172,17,23,0.739,90,36,72,0.5,21,42,0.5,15,30,0.5,20,26,0.769,107
2212,MIN,2017-03-04,90,@,SAS,0,265,35,89,0.393,31,73,0.425,4,16,0.25,16,22,0.727,90,38,94,0.404,32,70,0.457,6,24,0.25,15,24,0.625,97
2213,ORL,2017-03-01,90,,NYK,0,240,34,83,0.41,29,58,0.5,5,25,0.2,17,22,0.773,90,34,81,0.42,26,52,0.5,8,29,0.276,25,31,0.806,101
2214,ATL,2017-02-24,90,,MIA,0,240,30,79,0.38,24,59,0.407,6,20,0.3,24,36,0.667,90,40,99,0.404,23,62,0.371,17,37,0.459,11,13,0.846,108
2215,TOR,2017-02-15,90,,CHO,1,240,32,84,0.381,20,52,0.385,12,32,0.375,14,19,0.737,90,32,76,0.421,19,38,0.5,13,38,0.342,8,9,0.889,85
2216,SAS,2017-02-12,90,@,NYK,0,240,33,91,0.363,27,62,0.435,6,29,0.207,18,22,0.818,90,34,68,0.5,25,54,0.463,9,14,0.643,17,21,0.81,94
2217,OKC,2017-02-06,90,@,IND,0,240,34,88,0.386,27,60,0.45,7,28,0.25,15,21,0.714,90,33,87,0.379,25,61,0.41,8,26,0.308,19,29,0.655,93
2218,BRK,2017-02-01,90,,NYK,0,240,37,88,0.42,32,63,0.508,5,25,0.2,11,16,0.688,90,35,99,0.354,29,72,0.403,6,27,0.222,19,31,0.613,95
2219,MIA,2017-01-03,90,@,PHO,0,240,36,91,0.396,30,68,0.441,6,23,0.261,12,16,0.75,90,36,77,0.468,27,54,0.5,9,23,0.391,18,22,0.818,99
2220,CLE,2017-01-02,90,,NOP,1,240,34,90,0.378,28,59,0.475,6,31,0.194,16,22,0.727,90,32,88,0.364,21,62,0.339,11,26,0.423,7,10,0.7,82
2221,CLE,2016-12-26,90,@,DET,0,240,30,79,0.38,19,51,0.373,11,28,0.393,19,23,0.826,90,41,92,0.446,25,64,0.391,16,28,0.571,8,15,0.533,106
2222,ATL,2016-12-26,90,@,MIN,0,240,35,83,0.422,27,51,0.529,8,32,0.25,12,17,0.706,90,37,82,0.451,22,51,0.431,15,31,0.484,15,18,0.833,104
2223,CHI,2016-12-26,90,,IND,1,240,32,83,0.386,26,58,0.448,6,25,0.24,20,28,0.714,90,34,81,0.42,25,56,0.446,9,25,0.36,8,10,0.8,85
2224,LAL,2016-12-23,90,@,ORL,0,240,31,87,0.356,23,64,0.359,8,23,0.348,20,24,0.833,90,45,89,0.506,34,62,0.548,11,27,0.407,8,14,0.571,109
2225,POR,2016-12-23,90,,SAS,0,240,35,79,0.443,23,49,0.469,12,30,0.4,8,16,0.5,90,39,78,0.5,27,58,0.466,12,20,0.6,20,21,0.952,110
2226,DAL,2016-12-23,90,@,LAC,1,240,37,87,0.425,30,58,0.517,7,29,0.241,9,15,0.6,90,34,74,0.459,21,45,0.467,13,29,0.448,7,11,0.636,88
2227,POR,2016-12-17,90,@,GSW,0,240,34,86,0.395,26,58,0.448,8,28,0.286,14,20,0.7,90,51,87,0.586,37,59,0.627,14,28,0.5,19,26,0.731,135
2228,DET,2016-12-17,90,,IND,0,240,32,84,0.381,22,54,0.407,10,30,0.333,16,22,0.727,90,40,83,0.482,34,64,0.531,6,19,0.316,19,25,0.76,105
2229,NYK,2016-12-15,90,@,GSW,0,240,38,93,0.409,33,72,0.458,5,21,0.238,9,19,0.474,90,45,96,0.469,36,64,0.563,9,32,0.281,4,8,0.5,103
2230,MIN,2016-12-09,90,,DET,0,240,37,78,0.474,34,62,0.548,3,16,0.188,13,20,0.65,90,42,84,0.5,28,55,0.509,14,29,0.483,19,23,0.826,117
2231,CHI,2016-11-30,90,,LAL,0,240,32,91,0.352,28,70,0.4,4,21,0.19,22,29,0.759,90,33,81,0.407,31,73,0.425,2,8,0.25,28,41,0.683,96
2232,DAL,2016-11-25,90,@,CLE,0,240,37,91,0.407,29,56,0.518,8,35,0.229,8,12,0.667,90,43,85,0.506,23,42,0.548,20,43,0.465,22,24,0.917,128
2233,MIA,2016-11-25,90,@,MEM,1,240,33,85,0.388,21,54,0.389,12,31,0.387,12,18,0.667,90,29,82,0.354,25,63,0.397,4,19,0.211,19,23,0.826,81
2234,CHO,2016-11-21,90,,MEM,0,240,30,73,0.411,21,42,0.5,9,31,0.29,21,33,0.636,90,40,84,0.476,28,58,0.483,12,26,0.462,13,17,0.765,105
2235,BOS,2016-11-16,90,,DAL,1,240,33,76,0.434,26,55,0.473,7,21,0.333,17,23,0.739,90,34,83,0.41,26,60,0.433,8,23,0.348,7,10,0.7,83
2236,MIA,2016-11-15,90,,ATL,0,240,36,89,0.404,29,66,0.439,7,23,0.304,11,14,0.786,90,37,80,0.463,31,63,0.492,6,17,0.353,13,19,0.684,93
2237,MIA,2016-11-14,90,@,SAS,0,240,37,84,0.44,33,69,0.478,4,15,0.267,12,21,0.571,90,33,82,0.402,25,67,0.373,8,15,0.533,20,27,0.741,94
2238,MIL,2017-04-10,89,,CHO,1,240,35,78,0.449,19,51,0.373,16,27,0.593,3,5,0.6,89,33,81,0.407,28,63,0.444,5,18,0.278,8,13,0.615,79
2239,DAL,2017-04-07,89,,SAS,0,240,38,88,0.432,30,62,0.484,8,26,0.308,5,8,0.625,89,40,96,0.417,31,68,0.456,9,28,0.321,13,22,0.591,102
2240,MIL,2017-04-06,89,@,IND,0,240,33,71,0.465,22,47,0.468,11,24,0.458,12,14,0.857,89,38,80,0.475,30,55,0.545,8,25,0.32,20,26,0.769,104
2241,MEM,2017-04-04,89,@,SAS,0,265,35,89,0.393,27,64,0.422,8,25,0.32,11,18,0.611,89,35,80,0.438,24,59,0.407,11,21,0.524,14,18,0.778,95
2242,SAC,2017-03-31,89,@,NOP,0,240,35,90,0.389,29,70,0.414,6,20,0.3,13,17,0.765,89,46,95,0.484,36,62,0.581,10,33,0.303,15,19,0.789,117
2243,BRK,2017-03-30,89,@,DET,0,240,35,92,0.38,25,61,0.41,10,31,0.323,9,12,0.75,89,36,86,0.419,29,68,0.426,7,18,0.389,11,17,0.647,90
2244,TOR,2017-03-11,89,@,MIA,0,240,33,88,0.375,31,73,0.425,2,15,0.133,21,25,0.84,89,35,72,0.486,24,44,0.545,11,28,0.393,23,33,0.697,104
2245,OKC,2017-03-05,89,@,DAL,0,240,33,82,0.402,31,60,0.517,2,22,0.091,21,30,0.7,89,42,86,0.488,35,61,0.574,7,25,0.28,13,16,0.813,104
2246,MIA,2017-02-27,89,@,DAL,0,240,37,83,0.446,28,57,0.491,9,26,0.346,6,13,0.462,89,33,76,0.434,24,58,0.414,9,18,0.5,21,23,0.913,96
2247,DET,2017-02-13,89,@,MIL,0,240,34,78,0.436,27,57,0.474,7,21,0.333,14,19,0.737,89,40,79,0.506,34,58,0.586,6,21,0.286,16,16,1.0,102
2248,CHI,2017-02-12,89,@,MIN,0,240,35,84,0.417,25,59,0.424,10,25,0.4,9,13,0.692,89,44,81,0.543,38,57,0.667,6,24,0.25,23,26,0.885,117
2249,MEM,2017-02-06,89,,SAS,1,240,32,81,0.395,28,62,0.452,4,19,0.211,21,25,0.84,89,30,82,0.366,26,63,0.413,4,19,0.211,10,18,0.556,74
2250,TOR,2017-01-18,89,@,PHI,0,240,34,86,0.395,28,62,0.452,6,24,0.25,15,23,0.652,89,31,69,0.449,23,45,0.511,8,24,0.333,24,32,0.75,94
2251,CHI,2017-01-12,89,@,NYK,0,240,35,89,0.393,32,71,0.451,3,18,0.167,16,21,0.762,89,44,92,0.478,37,69,0.536,7,23,0.304,9,11,0.818,104
2252,BRK,2017-01-02,89,,UTA,0,240,33,78,0.423,27,51,0.529,6,27,0.222,17,23,0.739,89,39,93,0.419,32,69,0.464,7,24,0.292,16,20,0.8,101
2253,MIN,2017-01-01,89,,POR,0,240,35,87,0.402,28,64,0.438,7,23,0.304,12,18,0.667,89,36,73,0.493,30,51,0.588,6,22,0.273,17,28,0.607,95
2254,LAL,2016-12-29,89,,DAL,0,240,32,68,0.471,25,49,0.51,7,19,0.368,18,25,0.72,89,38,77,0.494,24,46,0.522,14,31,0.452,11,14,0.786,101
2255,SAC,2016-12-28,89,@,POR,0,240,31,79,0.392,22,51,0.431,9,28,0.321,18,23,0.783,89,35,74,0.473,23,49,0.469,12,25,0.48,20,22,0.909,102
2256,PHI,2016-12-16,89,,LAL,0,240,32,88,0.364,26,57,0.456,6,31,0.194,19,24,0.792,89,36,79,0.456,27,49,0.551,9,30,0.3,19,22,0.864,100
2257,OKC,2016-12-14,89,@,UTA,0,240,30,82,0.366,24,63,0.381,6,19,0.316,23,27,0.852,89,42,72,0.583,29,49,0.592,13,23,0.565,12,15,0.8,109
2258,IND,2016-12-14,89,@,MIA,0,240,33,89,0.371,24,62,0.387,9,27,0.333,14,17,0.824,89,37,82,0.451,30,57,0.526,7,25,0.28,14,25,0.56,95
2259,GSW,2016-12-10,89,@,MEM,0,240,34,77,0.442,25,50,0.5,9,27,0.333,12,20,0.6,89,38,87,0.437,30,61,0.492,8,26,0.308,26,29,0.897,110
2260,DAL,2016-12-07,89,,SAC,0,240,32,78,0.41,22,48,0.458,10,30,0.333,15,20,0.75,89,47,84,0.56,37,62,0.597,10,22,0.455,16,21,0.762,120
2261,CHO,2016-11-29,89,,DET,0,240,31,78,0.397,22,51,0.431,9,27,0.333,18,21,0.857,89,45,92,0.489,33,64,0.516,12,28,0.429,10,11,0.909,112
2262,PHI,2016-11-25,89,,CHI,0,240,31,78,0.397,22,56,0.393,9,22,0.409,18,22,0.818,89,40,90,0.444,34,69,0.493,6,21,0.286,19,26,0.731,105
2263,ORL,2016-11-21,89,@,MIL,0,240,32,77,0.416,25,52,0.481,7,25,0.28,18,24,0.75,89,35,86,0.407,27,57,0.474,8,29,0.276,15,21,0.714,93
2264,ORL,2016-11-16,89,,NOP,1,240,34,88,0.386,24,61,0.393,10,27,0.37,11,19,0.579,89,30,82,0.366,23,61,0.377,7,21,0.333,15,19,0.789,82
2265,MEM,2016-11-02,89,,NOP,1,265,33,94,0.351,25,67,0.373,8,27,0.296,15,20,0.75,89,30,81,0.37,19,47,0.404,11,34,0.324,12,16,0.75,83
2266,NYK,2016-11-01,89,@,DET,0,240,35,86,0.407,28,64,0.438,7,22,0.318,12,15,0.8,89,41,89,0.461,33,76,0.434,8,13,0.615,12,21,0.571,102
2267,LAL,2016-10-28,89,@,UTA,0,240,32,84,0.381,23,61,0.377,9,23,0.391,16,21,0.762,89,31,75,0.413,25,50,0.5,6,25,0.24,28,40,0.7,96
2268,NYK,2017-04-07,88,@,MEM,0,240,38,88,0.432,32,60,0.533,6,28,0.214,6,13,0.462,88,38,75,0.507,23,48,0.479,15,27,0.556,10,12,0.833,101
2269,WAS,2017-03-31,88,@,UTA,0,240,35,87,0.402,30,70,0.429,5,17,0.294,13,16,0.813,88,33,72,0.458,23,47,0.489,10,25,0.4,19,31,0.613,95
2270,NYK,2017-03-29,88,,MIA,0,240,33,89,0.371,28,64,0.438,5,25,0.2,17,21,0.81,88,40,84,0.476,28,59,0.475,12,25,0.48,13,17,0.765,105
2271,IND,2017-03-06,88,@,CHO,0,240,37,81,0.457,25,51,0.49,12,30,0.4,2,3,0.667,88,35,86,0.407,24,55,0.436,11,31,0.355,19,21,0.905,100
2272,UTA,2017-03-06,88,,NOP,1,240,33,81,0.407,23,54,0.426,10,27,0.37,12,15,0.8,88,30,84,0.357,20,51,0.392,10,33,0.303,13,18,0.722,83
2273,SAC,2017-02-27,88,,MIN,0,240,36,82,0.439,30,65,0.462,6,17,0.353,10,15,0.667,88,40,95,0.421,32,72,0.444,8,23,0.348,14,20,0.7,102
2274,POR,2017-02-15,88,@,UTA,0,240,32,79,0.405,23,57,0.404,9,22,0.409,15,20,0.75,88,42,81,0.519,31,59,0.525,11,22,0.5,16,23,0.696,111
2275,LAC,2017-02-13,88,@,UTA,1,240,36,81,0.444,27,56,0.482,9,25,0.36,7,11,0.636,88,28,87,0.322,24,64,0.375,4,23,0.174,12,18,0.667,72
2276,MIL,2017-02-08,88,,MIA,0,240,33,71,0.465,27,56,0.482,6,15,0.4,16,28,0.571,88,41,86,0.477,30,53,0.566,11,33,0.333,13,18,0.722,106
2277,MIL,2017-02-01,88,@,UTA,0,240,32,73,0.438,23,50,0.46,9,23,0.391,15,25,0.6,88,36,78,0.462,25,49,0.51,11,29,0.379,21,27,0.778,104
2278,ORL,2017-02-01,88,,IND,0,240,31,77,0.403,25,53,0.472,6,24,0.25,20,28,0.714,88,33,69,0.478,24,49,0.49,9,20,0.45,23,26,0.885,98
2279,CHI,2017-01-27,88,,MIA,0,240,33,78,0.423,30,65,0.462,3,13,0.231,19,25,0.76,88,41,89,0.461,32,65,0.492,9,24,0.375,9,11,0.818,100
2280,LAL,2017-01-26,88,@,UTA,0,240,36,84,0.429,32,70,0.457,4,14,0.286,12,13,0.923,88,33,81,0.407,27,55,0.491,6,26,0.231,24,28,0.857,96
2281,MEM,2017-01-08,88,,UTA,1,240,34,78,0.436,25,54,0.463,9,24,0.375,11,14,0.786,88,28,72,0.389,19,49,0.388,9,23,0.391,14,23,0.609,79
2282,LAC,2016-12-31,88,@,OKC,0,240,31,75,0.413,23,45,0.511,8,30,0.267,18,21,0.857,88,37,78,0.474,27,49,0.551,10,29,0.345,30,35,0.857,114
2283,LAC,2016-12-23,88,,DAL,0,240,34,74,0.459,21,45,0.467,13,29,0.448,7,11,0.636,88,37,87,0.425,30,58,0.517,7,29,0.241,9,15,0.6,90
2284,CHO,2016-12-16,88,@,BOS,0,240,32,97,0.33,24,67,0.358,8,30,0.267,16,19,0.842,88,34,78,0.436,25,50,0.5,9,28,0.321,19,26,0.731,96
2285,ORL,2016-12-09,88,@,CHO,0,240,34,91,0.374,25,57,0.439,9,34,0.265,11,14,0.786,88,41,85,0.482,32,63,0.508,9,22,0.409,18,23,0.783,109
2286,NOP,2016-12-08,88,,PHI,0,240,33,84,0.393,26,59,0.441,7,25,0.28,15,22,0.682,88,39,91,0.429,27,51,0.529,12,40,0.3,9,13,0.692,99
2287,MEM,2016-12-08,88,,POR,1,240,31,87,0.356,25,67,0.373,6,20,0.3,20,30,0.667,88,25,82,0.305,18,54,0.333,7,28,0.25,29,40,0.725,86
2288,PHI,2016-12-02,88,,ORL,0,240,36,95,0.379,27,63,0.429,9,32,0.281,7,10,0.7,88,37,78,0.474,24,52,0.462,13,26,0.5,18,26,0.692,105
2289,LAL,2016-11-29,88,@,NOP,0,240,37,87,0.425,32,57,0.561,5,30,0.167,9,18,0.5,88,38,88,0.432,30,57,0.526,8,31,0.258,21,25,0.84,105
2290,DET,2016-11-26,88,@,OKC,0,240,37,82,0.451,36,63,0.571,1,19,0.053,13,17,0.765,88,42,83,0.506,34,60,0.567,8,23,0.348,14,26,0.538,106
2291,BOS,2016-11-18,88,,GSW,0,240,31,83,0.373,20,51,0.392,11,32,0.344,15,19,0.789,88,44,90,0.489,35,62,0.565,9,28,0.321,7,12,0.583,104
2292,POR,2016-11-15,88,,CHI,0,240,34,95,0.358,25,61,0.41,9,34,0.265,11,18,0.611,88,41,98,0.418,34,78,0.436,7,20,0.35,24,28,0.857,113
2293,PHI,2016-11-14,88,@,HOU,0,240,34,90,0.378,29,68,0.426,5,22,0.227,15,17,0.882,88,44,91,0.484,27,51,0.529,17,40,0.425,10,17,0.588,115
2294,IND,2016-11-14,88,,ORL,1,240,35,90,0.389,27,65,0.415,8,25,0.32,10,10,1.0,88,27,84,0.321,22,59,0.373,5,25,0.2,10,13,0.769,69
2295,OKC,2016-11-14,88,@,DET,0,240,33,88,0.375,28,61,0.459,5,27,0.185,17,22,0.773,88,43,92,0.467,38,76,0.5,5,16,0.313,13,16,0.813,104
2296,ORL,2016-11-05,88,,WAS,1,240,31,78,0.397,22,50,0.44,9,28,0.321,17,27,0.63,88,34,86,0.395,28,69,0.406,6,17,0.353,12,17,0.706,86
2297,MEM,2016-11-04,88,,LAC,0,240,31,84,0.369,22,58,0.379,9,26,0.346,17,22,0.773,88,32,85,0.376,24,58,0.414,8,27,0.296,27,33,0.818,99
2298,BRK,2016-10-31,88,,CHI,0,240,33,96,0.344,28,65,0.431,5,31,0.161,17,21,0.81,88,45,89,0.506,34,62,0.548,11,27,0.407,17,18,0.944,118
2299,LAC,2016-10-30,88,,UTA,1,240,34,83,0.41,28,56,0.5,6,27,0.222,14,20,0.7,88,29,73,0.397,22,54,0.407,7,19,0.368,10,13,0.769,75
2300,NYK,2016-10-25,88,@,CLE,0,240,32,87,0.368,23,60,0.383,9,27,0.333,15,20,0.75,88,45,94,0.479,32,59,0.542,13,35,0.371,14,19,0.737,117
2301,SAS,2017-04-08,87,,LAC,0,240,34,80,0.425,26,58,0.448,8,22,0.364,11,14,0.786,87,42,84,0.5,36,62,0.581,6,22,0.273,8,14,0.571,98
2302,DAL,2017-04-04,87,@,SAC,0,240,32,80,0.4,20,37,0.541,12,43,0.279,11,14,0.786,87,36,81,0.444,24,59,0.407,12,22,0.545,14,17,0.824,98
2303,POR,2017-04-04,87,@,UTA,0,240,33,83,0.398,27,57,0.474,6,26,0.231,15,17,0.882,87,39,74,0.527,26,51,0.51,13,23,0.565,15,19,0.789,106
2304,DET,2017-03-24,87,@,ORL,0,240,34,96,0.354,32,74,0.432,2,22,0.091,17,20,0.85,87,47,91,0.516,35,65,0.538,12,26,0.462,9,13,0.692,115
2305,DAL,2017-03-21,87,,GSW,0,240,33,92,0.359,22,58,0.379,11,34,0.324,10,12,0.833,87,43,78,0.551,30,48,0.625,13,30,0.433,13,16,0.813,112
2306,TOR,2017-03-17,87,@,DET,1,240,30,78,0.385,21,51,0.412,9,27,0.333,18,20,0.9,87,29,83,0.349,26,63,0.413,3,20,0.15,14,21,0.667,75
2307,NYK,2017-03-14,87,,IND,1,240,35,83,0.422,26,55,0.473,9,28,0.321,8,13,0.615,87,32,87,0.368,24,58,0.414,8,29,0.276,9,15,0.6,81
2308,NOP,2017-03-08,87,,TOR,0,240,34,80,0.425,25,51,0.49,9,29,0.31,10,13,0.769,87,36,76,0.474,28,55,0.509,8,21,0.381,14,23,0.609,94
2309,GSW,2017-03-02,87,@,CHI,0,240,34,88,0.386,28,58,0.483,6,30,0.2,13,14,0.929,87,36,82,0.439,31,63,0.492,5,19,0.263,17,21,0.81,94
2310,DAL,2017-02-06,87,@,DEN,0,240,34,79,0.43,26,53,0.491,8,26,0.308,11,17,0.647,87,42,84,0.5,31,56,0.554,11,28,0.393,15,16,0.938,110
2311,MIN,2017-01-15,87,@,DAL,0,240,35,80,0.438,30,59,0.508,5,21,0.238,12,18,0.667,87,36,77,0.468,24,48,0.5,12,29,0.414,14,19,0.737,98
2312,LAL,2017-01-10,87,,POR,0,240,32,83,0.386,23,59,0.39,9,24,0.375,14,26,0.538,87,43,85,0.506,36,64,0.563,7,21,0.333,15,20,0.75,108
2313,MIA,2016-12-23,87,@,NOP,0,240,36,87,0.414,28,67,0.418,8,20,0.4,7,13,0.538,87,33,89,0.371,22,61,0.361,11,28,0.393,14,21,0.667,91
2314,DAL,2016-12-10,87,@,HOU,0,240,32,79,0.405,21,45,0.467,11,34,0.324,12,14,0.857,87,37,74,0.5,18,37,0.486,19,37,0.514,16,22,0.727,109
2315,CHO,2016-12-07,87,,DET,1,240,30,88,0.341,24,67,0.358,6,21,0.286,21,29,0.724,87,34,89,0.382,30,62,0.484,4,27,0.148,5,8,0.625,77
2316,ORL,2016-12-07,87,,BOS,0,240,30,81,0.37,19,55,0.345,11,26,0.423,16,24,0.667,87,43,84,0.512,36,58,0.621,7,26,0.269,24,29,0.828,117
2317,DAL,2016-12-01,87,@,CHO,0,240,32,86,0.372,23,55,0.418,9,31,0.29,14,18,0.778,87,35,74,0.473,30,56,0.536,5,18,0.278,22,31,0.71,97
2318,DAL,2016-11-30,87,,SAS,0,240,33,77,0.429,23,47,0.489,10,30,0.333,11,14,0.786,87,33,71,0.465,22,52,0.423,11,19,0.579,17,24,0.708,94
2319,ORL,2016-11-23,87,,PHO,0,240,33,91,0.363,26,66,0.394,7,25,0.28,14,23,0.609,87,33,73,0.452,24,51,0.471,9,22,0.409,17,22,0.773,92
2320,DAL,2016-11-19,87,@,ORL,0,240,26,77,0.338,13,49,0.265,13,28,0.464,22,27,0.815,87,34,78,0.436,26,57,0.456,8,21,0.381,19,22,0.864,95
2321,UTA,2016-11-11,87,@,ORL,1,240,33,81,0.407,26,53,0.491,7,28,0.25,14,16,0.875,87,26,78,0.333,18,58,0.31,8,20,0.4,14,19,0.737,74
2322,NYK,2016-11-11,87,@,BOS,0,240,33,94,0.351,27,71,0.38,6,23,0.261,15,17,0.882,87,35,90,0.389,24,63,0.381,11,27,0.407,34,43,0.791,115
2323,MIA,2016-11-04,87,@,TOR,0,240,34,88,0.386,25,60,0.417,9,28,0.321,10,15,0.667,87,37,84,0.44,31,59,0.525,6,25,0.24,16,18,0.889,96
2324,ATL,2017-04-12,86,@,IND,0,240,30,72,0.417,19,43,0.442,11,29,0.379,15,19,0.789,86,39,82,0.476,29,58,0.5,10,24,0.417,16,19,0.842,104
2325,UTA,2017-04-08,86,@,POR,0,240,31,78,0.397,25,59,0.424,6,19,0.316,18,24,0.75,86,37,91,0.407,24,61,0.393,13,30,0.433,14,16,0.875,101
2326,DAL,2017-03-25,86,,TOR,0,240,31,82,0.378,24,54,0.444,7,28,0.25,17,20,0.85,86,39,81,0.481,30,60,0.5,9,21,0.429,7,9,0.778,94
2327,UTA,2017-03-18,86,@,CHI,0,240,31,81,0.383,24,56,0.429,7,25,0.28,17,25,0.68,86,38,80,0.475,31,61,0.508,7,19,0.368,12,14,0.857,95
2328,GSW,2017-03-08,86,,BOS,0,240,37,84,0.44,31,54,0.574,6,30,0.2,6,9,0.667,86,37,84,0.44,27,55,0.491,10,29,0.345,15,19,0.789,99
2329,DET,2017-03-01,86,@,NOP,0,240,40,103,0.388,37,80,0.463,3,23,0.13,3,17,0.176,86,39,78,0.5,30,53,0.566,9,25,0.36,22,23,0.957,109
2330,ATL,2017-02-25,86,@,ORL,0,240,32,85,0.376,24,60,0.4,8,25,0.32,14,26,0.538,86,37,81,0.457,29,54,0.537,8,27,0.296,23,24,0.958,105
2331,SAC,2017-02-15,86,@,GSW,0,240,33,89,0.371,26,65,0.4,7,24,0.292,13,17,0.765,86,41,84,0.488,28,48,0.583,13,36,0.361,14,21,0.667,109
2332,ORL,2017-02-04,86,@,ATL,0,240,27,78,0.346,20,51,0.392,7,27,0.259,25,28,0.893,86,41,78,0.526,31,50,0.62,10,28,0.357,21,27,0.778,113
2333,PHI,2017-02-02,86,@,SAS,0,240,30,88,0.341,21,63,0.333,9,25,0.36,17,23,0.739,86,38,89,0.427,32,68,0.471,6,21,0.286,20,27,0.741,102
2334,MIL,2017-01-27,86,@,TOR,0,240,31,80,0.388,24,57,0.421,7,23,0.304,17,24,0.708,86,37,84,0.44,27,59,0.458,10,25,0.4,18,23,0.783,102
2335,ATL,2017-01-27,86,,WAS,0,240,30,83,0.361,21,52,0.404,9,31,0.29,17,25,0.68,86,43,89,0.483,30,58,0.517,13,31,0.419,13,19,0.684,112
2336,BRK,2017-01-23,86,,SAS,0,240,32,81,0.395,27,56,0.482,5,25,0.2,17,18,0.944,86,45,95,0.474,36,73,0.493,9,22,0.409,13,16,0.813,112
2337,OKC,2017-01-13,86,@,MIN,0,240,33,85,0.388,30,65,0.462,3,20,0.15,17,21,0.81,86,39,86,0.453,34,68,0.5,5,18,0.278,13,14,0.929,96
2338,CLE,2017-01-11,86,@,POR,0,240,28,82,0.341,19,52,0.365,9,30,0.3,21,28,0.75,86,40,93,0.43,30,63,0.476,10,30,0.333,12,16,0.75,102
2339,MIA,2017-01-08,86,@,LAC,0,240,31,84,0.369,24,57,0.421,7,27,0.259,17,21,0.81,86,36,86,0.419,27,56,0.482,9,30,0.3,17,25,0.68,98
2340,PHO,2016-12-31,86,@,UTA,0,240,36,87,0.414,29,70,0.414,7,17,0.412,7,10,0.7,86,35,73,0.479,27,53,0.509,8,20,0.4,13,20,0.65,91
2341,DET,2016-12-21,86,,MEM,0,240,26,72,0.361,20,49,0.408,6,23,0.261,28,37,0.757,86,35,82,0.427,23,52,0.442,12,30,0.4,16,19,0.842,98
2342,MEM,2016-12-13,86,@,CLE,0,240,35,86,0.407,31,64,0.484,4,22,0.182,12,15,0.8,86,37,81,0.457,25,50,0.5,12,31,0.387,17,23,0.739,103
2343,POR,2016-12-08,86,@,MEM,0,240,25,82,0.305,18,54,0.333,7,28,0.25,29,40,0.725,86,31,87,0.356,25,67,0.373,6,20,0.3,20,30,0.667,88
2344,PHI,2016-11-17,86,@,MIN,0,240,31,83,0.373,22,51,0.431,9,32,0.281,15,19,0.789,86,43,84,0.512,37,59,0.627,6,25,0.24,18,20,0.9,110
2345,DET,2016-11-11,86,@,SAS,0,240,32,76,0.421,27,51,0.529,5,25,0.2,17,21,0.81,86,36,81,0.444,27,61,0.443,9,20,0.45,15,19,0.789,96
2346,DAL,2016-11-06,86,,MIL,1,265,33,88,0.375,24,50,0.48,9,38,0.237,11,12,0.917,86,30,82,0.366,24,53,0.453,6,29,0.207,9,12,0.75,75
2347,DEN,2016-11-05,86,@,DET,0,240,31,94,0.33,24,69,0.348,7,25,0.28,17,20,0.85,86,40,84,0.476,33,64,0.516,7,20,0.35,16,22,0.727,103
2348,WAS,2016-11-05,86,@,ORL,0,240,34,86,0.395,28,69,0.406,6,17,0.353,12,17,0.706,86,31,78,0.397,22,50,0.44,9,28,0.321,17,27,0.63,88
2349,UTA,2016-11-04,86,,SAS,0,240,30,80,0.375,19,54,0.352,11,26,0.423,15,24,0.625,86,37,83,0.446,31,63,0.492,6,20,0.3,20,22,0.909,100
2350,GSW,2017-03-11,85,@,SAS,0,240,33,92,0.359,28,75,0.373,5,17,0.294,14,23,0.609,85,40,77,0.519,28,50,0.56,12,27,0.444,15,18,0.833,107
2351,IND,2017-03-10,85,@,MIL,0,240,33,75,0.44,31,57,0.544,2,18,0.111,17,22,0.773,85,33,64,0.516,26,47,0.553,7,17,0.412,26,30,0.867,99
2352,SAC,2017-02-25,85,,CHO,0,240,31,79,0.392,20,51,0.392,11,28,0.393,12,15,0.8,85,34,85,0.4,20,47,0.426,14,38,0.368,17,18,0.944,99
2353,CHO,2017-02-15,85,@,TOR,0,240,32,76,0.421,19,38,0.5,13,38,0.342,8,9,0.889,85,32,84,0.381,20,52,0.385,12,32,0.375,14,19,0.737,90
2354,POR,2017-01-18,85,@,CHO,0,240,33,94,0.351,25,63,0.397,8,31,0.258,11,11,1.0,85,41,87,0.471,30,61,0.492,11,26,0.423,14,17,0.824,107
2355,CHO,2017-01-07,85,@,SAS,0,240,30,75,0.4,26,54,0.481,4,21,0.19,21,25,0.84,85,36,89,0.404,23,55,0.418,13,34,0.382,17,20,0.85,102
2356,IND,2016-12-26,85,@,CHI,0,240,34,81,0.42,25,56,0.446,9,25,0.36,8,10,0.8,85,32,83,0.386,26,58,0.448,6,25,0.24,20,28,0.714,90
2357,DAL,2016-12-14,85,,DET,0,240,32,78,0.41,24,53,0.453,8,25,0.32,13,16,0.813,85,36,71,0.507,31,54,0.574,5,17,0.294,18,22,0.818,95
2358,CLE,2016-12-14,85,@,MEM,0,240,28,75,0.373,19,50,0.38,9,25,0.36,20,31,0.645,85,35,81,0.432,23,58,0.397,12,23,0.522,11,16,0.688,93
2359,DEN,2016-12-08,85,@,WAS,0,240,31,76,0.408,24,44,0.545,7,32,0.219,16,24,0.667,85,35,78,0.449,29,59,0.492,6,19,0.316,16,17,0.941,92
2360,ATL,2016-12-02,85,,DET,0,240,32,88,0.364,26,64,0.406,6,24,0.25,15,20,0.75,85,48,89,0.539,31,60,0.517,17,29,0.586,8,12,0.667,121
2361,MEM,2016-11-28,85,,CHO,0,240,36,89,0.404,29,60,0.483,7,29,0.241,6,13,0.462,85,36,82,0.439,27,56,0.482,9,26,0.346,23,31,0.742,104
2362,LAL,2016-11-25,85,,GSW,0,240,32,90,0.356,27,68,0.397,5,22,0.227,16,23,0.696,85,43,83,0.518,32,55,0.582,11,28,0.393,12,17,0.706,109
2363,PHO,2016-11-25,85,,MIN,0,240,32,79,0.405,26,53,0.491,6,26,0.231,15,21,0.714,85,34,85,0.4,27,63,0.429,7,22,0.318,23,25,0.92,98
2364,IND,2016-11-23,85,,ATL,0,240,34,84,0.405,27,57,0.474,7,27,0.259,10,14,0.714,85,36,85,0.424,31,65,0.477,5,20,0.25,19,22,0.864,96
2365,CHI,2016-11-17,85,@,UTA,1,240,33,90,0.367,28,73,0.384,5,17,0.294,14,16,0.875,85,30,78,0.385,25,53,0.472,5,25,0.2,12,14,0.857,77
2366,MIA,2016-11-07,85,@,OKC,0,240,31,84,0.369,27,67,0.403,4,17,0.235,19,22,0.864,85,37,85,0.435,28,57,0.491,9,28,0.321,14,17,0.824,97
2367,OKC,2016-11-02,85,@,LAC,1,240,34,84,0.405,29,64,0.453,5,20,0.25,12,20,0.6,85,34,87,0.391,27,65,0.415,7,22,0.318,8,18,0.444,83
2368,MIA,2017-03-23,84,,TOR,0,240,32,82,0.39,26,59,0.441,6,23,0.261,14,23,0.609,84,35,79,0.443,29,56,0.518,6,23,0.261,25,32,0.781,101
2369,DAL,2017-02-24,84,@,MIN,0,240,35,83,0.422,27,50,0.54,8,33,0.242,6,9,0.667,84,41,78,0.526,36,65,0.554,5,13,0.385,10,14,0.714,97
2370,ATL,2017-02-15,84,@,LAC,0,240,32,79,0.405,25,53,0.472,7,26,0.269,13,19,0.684,84,37,79,0.468,23,42,0.548,14,37,0.378,11,12,0.917,99
2371,DET,2017-02-04,84,@,IND,0,240,31,75,0.413,25,58,0.431,6,17,0.353,16,20,0.8,84,44,91,0.484,37,67,0.552,7,24,0.292,10,15,0.667,105
2372,ATL,2016-12-21,84,,MIN,0,240,34,82,0.415,27,56,0.482,7,26,0.269,9,13,0.692,84,35,83,0.422,26,54,0.481,9,29,0.31,13,14,0.929,92
2373,SAC,2016-12-10,84,@,UTA,0,240,34,90,0.378,25,64,0.391,9,26,0.346,7,13,0.538,84,37,77,0.481,24,48,0.5,13,29,0.448,17,18,0.944,104
2374,MIA,2016-12-09,84,@,CLE,0,240,31,90,0.344,25,63,0.397,6,27,0.222,16,21,0.762,84,46,83,0.554,37,59,0.627,9,24,0.375,13,19,0.684,114
2375,ATL,2016-12-03,84,@,TOR,0,240,35,88,0.398,28,60,0.467,7,28,0.25,7,14,0.5,84,53,92,0.576,40,68,0.588,13,24,0.542,9,11,0.818,128
2376,MIA,2016-11-23,84,@,DET,0,240,27,75,0.36,20,49,0.408,7,26,0.269,23,30,0.767,84,40,81,0.494,34,62,0.548,6,19,0.316,21,25,0.84,107
2377,PHI,2016-11-07,84,,UTA,0,240,31,77,0.403,24,56,0.429,7,21,0.333,15,22,0.682,84,43,85,0.506,32,66,0.485,11,19,0.579,12,20,0.6,109
2378,CLE,2017-04-12,83,,TOR,0,240,28,76,0.368,18,39,0.462,10,37,0.27,17,24,0.708,83,40,86,0.465,32,60,0.533,8,26,0.308,10,16,0.625,98
2379,UTA,2017-03-16,83,@,CLE,0,240,34,82,0.415,29,61,0.475,5,21,0.238,10,14,0.714,83,36,86,0.419,27,53,0.509,9,33,0.273,10,19,0.526,91
2380,DET,2017-03-15,83,,UTA,0,240,36,86,0.419,33,73,0.452,3,13,0.231,8,12,0.667,83,36,77,0.468,23,49,0.469,13,28,0.464,12,16,0.75,97
2381,NOP,2017-03-06,83,@,UTA,0,240,30,84,0.357,20,51,0.392,10,33,0.303,13,18,0.722,83,33,81,0.407,23,54,0.426,10,27,0.37,12,15,0.8,88
2382,NOP,2017-02-25,83,@,DAL,0,240,31,78,0.397,26,54,0.481,5,24,0.208,16,25,0.64,83,36,78,0.462,24,52,0.462,12,26,0.462,12,16,0.75,96
2383,SAC,2017-01-31,83,@,HOU,0,240,30,86,0.349,22,57,0.386,8,29,0.276,15,26,0.577,83,38,85,0.447,24,40,0.6,14,45,0.311,15,22,0.682,105
2384,PHI,2016-12-29,83,@,UTA,0,240,35,87,0.402,29,63,0.46,6,24,0.25,7,8,0.875,83,35,73,0.479,20,47,0.426,15,26,0.577,15,28,0.536,100
2385,SAS,2016-11-29,83,,ORL,0,240,28,76,0.368,23,56,0.411,5,20,0.25,22,26,0.846,83,39,86,0.453,33,71,0.465,6,15,0.4,11,12,0.917,95
2386,DEN,2016-11-23,83,@,UTA,0,240,28,88,0.318,19,61,0.311,9,27,0.333,18,31,0.581,83,39,79,0.494,31,53,0.585,8,26,0.308,22,31,0.71,108
2387,IND,2016-11-21,83,,GSW,0,240,33,103,0.32,27,80,0.338,6,23,0.261,11,12,0.917,83,40,90,0.444,27,54,0.5,13,36,0.361,27,32,0.844,120
2388,DAL,2016-11-16,83,@,BOS,0,240,34,83,0.41,26,60,0.433,8,23,0.348,7,10,0.7,83,33,76,0.434,26,55,0.473,7,21,0.333,17,23,0.739,90
2389,LAC,2016-11-02,83,,OKC,0,240,34,87,0.391,27,65,0.415,7,22,0.318,8,18,0.444,83,34,84,0.405,29,64,0.453,5,20,0.25,12,20,0.6,85
2390,NOP,2016-11-02,83,@,MEM,0,265,30,81,0.37,19,47,0.404,11,34,0.324,12,16,0.75,83,33,94,0.351,25,67,0.373,8,27,0.296,15,20,0.75,89
2391,MIL,2016-10-30,83,@,DET,0,240,34,87,0.391,30,70,0.429,4,17,0.235,11,14,0.786,83,39,88,0.443,34,68,0.5,5,20,0.25,15,20,0.75,98
2392,PHI,2017-04-08,82,,MIL,0,240,27,77,0.351,19,46,0.413,8,31,0.258,20,23,0.87,82,35,79,0.443,29,52,0.558,6,27,0.222,14,20,0.7,90
2393,ATL,2017-04-02,82,@,BRK,0,240,30,80,0.375,23,56,0.411,7,24,0.292,15,23,0.652,82,32,82,0.39,22,49,0.449,10,33,0.303,17,20,0.85,91
2394,SAC,2017-03-29,82,,UTA,0,240,34,75,0.453,32,60,0.533,2,15,0.133,12,18,0.667,82,42,79,0.532,29,48,0.604,13,31,0.419,15,19,0.789,112
2395,MEM,2017-03-21,82,@,NOP,0,240,32,79,0.405,23,44,0.523,9,35,0.257,9,13,0.692,82,35,88,0.398,26,59,0.441,9,29,0.31,16,19,0.842,95
2396,DAL,2017-01-07,82,,ATL,0,240,32,82,0.39,23,46,0.5,9,36,0.25,9,10,0.9,82,30,74,0.405,19,52,0.365,11,22,0.5,26,32,0.813,97
2397,TOR,2017-01-03,82,@,SAS,0,240,31,83,0.373,27,65,0.415,4,18,0.222,16,22,0.727,82,43,78,0.551,30,54,0.556,13,24,0.542,11,15,0.733,110
2398,NOP,2017-01-02,82,@,CLE,0,240,32,88,0.364,21,62,0.339,11,26,0.423,7,10,0.7,82,34,90,0.378,28,59,0.475,6,31,0.194,16,22,0.727,90
2399,MIA,2016-12-29,82,@,CHO,0,240,33,82,0.402,23,54,0.426,10,28,0.357,6,13,0.462,82,36,93,0.387,31,67,0.463,5,26,0.192,14,18,0.778,91
2400,DET,2016-12-19,82,@,CHI,0,240,34,83,0.41,31,60,0.517,3,23,0.13,11,13,0.846,82,49,82,0.598,41,66,0.621,8,16,0.5,7,7,1.0,113
2401,UTA,2016-12-18,82,@,MEM,1,240,30,66,0.455,22,39,0.564,8,27,0.296,14,25,0.56,82,28,93,0.301,26,70,0.371,2,23,0.087,15,18,0.833,73
2402,CHI,2016-12-03,82,@,DAL,0,240,32,71,0.451,29,58,0.5,3,13,0.231,15,21,0.714,82,40,87,0.46,27,56,0.482,13,31,0.419,14,18,0.778,107
2403,NOP,2016-11-16,82,@,ORL,0,240,30,82,0.366,23,61,0.377,7,21,0.333,15,19,0.789,82,34,88,0.386,24,61,0.393,10,27,0.37,11,19,0.579,89
2404,DET,2016-11-07,82,@,LAC,0,240,30,82,0.366,26,70,0.371,4,12,0.333,18,26,0.692,82,41,76,0.539,28,51,0.549,13,25,0.52,19,22,0.864,114
2405,ORL,2016-10-28,82,@,DET,0,240,33,95,0.347,25,69,0.362,8,26,0.308,8,12,0.667,82,48,95,0.505,41,76,0.539,7,19,0.368,5,6,0.833,108
2406,LAL,2017-03-26,81,,POR,0,240,33,84,0.393,28,63,0.444,5,21,0.238,10,17,0.588,81,36,89,0.404,24,61,0.393,12,28,0.429,13,18,0.722,97
2407,IND,2017-03-14,81,@,NYK,0,240,32,87,0.368,24,58,0.414,8,29,0.276,9,15,0.6,81,35,83,0.422,26,55,0.473,9,28,0.321,8,13,0.615,87
2408,ORL,2017-03-10,81,@,CHO,0,240,31,76,0.408,26,49,0.531,5,27,0.185,14,22,0.636,81,47,79,0.595,37,58,0.638,10,21,0.476,17,20,0.85,121
2409,NOP,2016-11-27,81,@,DAL,0,240,30,77,0.39,25,57,0.439,5,20,0.25,16,18,0.889,81,32,77,0.416,22,50,0.44,10,27,0.37,17,20,0.85,91
2410,MEM,2016-11-25,81,,MIA,0,240,29,82,0.354,25,63,0.397,4,19,0.211,19,23,0.826,81,33,85,0.388,21,54,0.389,12,31,0.387,12,18,0.667,90
2411,DET,2016-11-18,81,@,CLE,0,240,29,93,0.312,23,74,0.311,6,19,0.316,17,20,0.85,81,40,83,0.482,29,58,0.5,11,25,0.44,13,14,0.929,104
2412,DAL,2016-11-02,81,@,UTA,0,240,33,77,0.429,26,51,0.51,7,26,0.269,8,10,0.8,81,35,77,0.455,23,52,0.442,12,25,0.48,15,26,0.577,97
2413,CHI,2017-03-12,80,@,BOS,0,240,33,87,0.379,26,62,0.419,7,25,0.28,7,9,0.778,80,40,86,0.465,24,49,0.49,16,37,0.432,4,4,1.0,100
2414,UTA,2017-03-01,80,,MIN,0,240,35,90,0.389,31,71,0.437,4,19,0.211,6,11,0.545,80,39,78,0.5,31,62,0.5,8,16,0.5,21,26,0.808,107
2415,ORL,2017-02-11,80,@,DAL,0,240,32,82,0.39,29,59,0.492,3,23,0.13,13,18,0.722,80,45,91,0.495,28,56,0.5,17,35,0.486,5,6,0.833,112
2416,OKC,2016-12-29,80,@,MEM,0,240,25,74,0.338,21,52,0.404,4,22,0.182,26,38,0.684,80,43,82,0.524,30,60,0.5,13,22,0.591,15,20,0.75,114
2417,LAL,2016-12-02,80,@,TOR,0,240,32,93,0.344,26,67,0.388,6,26,0.231,10,17,0.588,80,45,83,0.542,33,54,0.611,12,29,0.414,11,13,0.846,113
2418,MEM,2016-11-18,80,@,DAL,1,240,31,77,0.403,22,52,0.423,9,25,0.36,9,12,0.75,80,21,73,0.288,16,48,0.333,5,25,0.2,17,22,0.773,64
2419,POR,2016-11-09,80,@,LAC,0,240,31,88,0.352,25,58,0.431,6,30,0.2,12,14,0.857,80,38,87,0.437,27,55,0.491,11,32,0.344,24,33,0.727,111
2420,ORL,2016-11-07,80,@,CHI,0,240,33,85,0.388,24,55,0.436,9,30,0.3,5,6,0.833,80,42,89,0.472,39,70,0.557,3,19,0.158,25,31,0.806,112
2421,MEM,2016-11-01,80,@,MIN,0,240,27,75,0.36,23,51,0.451,4,24,0.167,22,29,0.759,80,43,78,0.551,31,58,0.534,12,20,0.6,18,23,0.783,116
2422,CHO,2017-04-10,79,@,MIL,0,240,33,81,0.407,28,63,0.444,5,18,0.278,8,13,0.615,79,35,78,0.449,19,51,0.373,16,27,0.593,3,5,0.6,89
2423,MIL,2017-04-04,79,@,OKC,0,240,29,81,0.358,26,63,0.413,3,18,0.167,18,26,0.692,79,40,84,0.476,31,56,0.554,9,28,0.321,21,25,0.84,110
2424,ORL,2017-02-15,79,,SAS,0,240,30,76,0.395,26,58,0.448,4,18,0.222,15,19,0.789,79,42,89,0.472,34,58,0.586,8,31,0.258,15,19,0.789,107
2425,UTA,2017-01-08,79,@,MEM,0,240,28,72,0.389,19,49,0.388,9,23,0.391,14,23,0.609,79,34,78,0.436,25,54,0.463,9,24,0.375,11,14,0.786,88
2426,SAC,2016-12-18,79,@,DAL,0,240,30,76,0.395,22,45,0.489,8,31,0.258,11,17,0.647,79,34,77,0.442,21,44,0.477,13,33,0.394,18,22,0.818,99
2427,ORL,2016-12-18,79,,TOR,0,240,34,83,0.41,31,62,0.5,3,21,0.143,8,9,0.889,79,43,87,0.494,36,60,0.6,7,27,0.259,16,21,0.762,109
2428,DET,2016-12-11,79,,PHI,0,240,32,82,0.39,27,63,0.429,5,19,0.263,10,14,0.714,79,38,68,0.559,31,51,0.608,7,17,0.412,14,17,0.824,97
2429,NOP,2016-10-29,79,@,SAS,0,240,32,86,0.372,28,64,0.438,4,22,0.182,11,15,0.733,79,35,83,0.422,25,59,0.424,10,24,0.417,18,23,0.783,98
2430,CLE,2017-03-18,78,@,LAC,0,240,32,83,0.386,27,56,0.482,5,27,0.185,9,13,0.692,78,40,78,0.513,32,52,0.615,8,26,0.308,20,29,0.69,108
2431,DAL,2017-03-13,78,@,TOR,0,240,31,85,0.365,24,60,0.4,7,25,0.28,9,13,0.692,78,37,78,0.474,28,53,0.528,9,25,0.36,17,18,0.944,100
2432,TOR,2017-01-20,78,@,CHO,0,240,29,86,0.337,22,56,0.393,7,30,0.233,13,14,0.929,78,40,80,0.5,28,55,0.509,12,25,0.48,21,25,0.84,113
2433,CHO,2017-03-15,77,@,IND,0,240,32,80,0.4,29,57,0.509,3,23,0.13,10,13,0.769,77,39,73,0.534,27,45,0.6,12,28,0.429,8,9,0.889,98
2434,POR,2017-03-14,77,@,NOP,0,240,23,76,0.303,12,44,0.273,11,32,0.344,20,26,0.769,77,38,80,0.475,32,59,0.542,6,21,0.286,18,30,0.6,100
2435,DET,2017-01-13,77,@,UTA,0,240,30,76,0.395,24,59,0.407,6,17,0.353,11,16,0.688,77,43,80,0.538,27,49,0.551,16,31,0.516,8,13,0.615,110
2436,DET,2016-12-07,77,@,CHO,0,240,34,89,0.382,30,62,0.484,4,27,0.148,5,8,0.625,77,30,88,0.341,24,67,0.358,6,21,0.286,21,29,0.724,87
2437,UTA,2016-11-17,77,,CHI,0,240,30,78,0.385,25,53,0.472,5,25,0.2,12,14,0.857,77,33,90,0.367,28,73,0.384,5,17,0.294,14,16,0.875,85
2438,DAL,2016-11-14,77,@,NYK,0,240,32,84,0.381,27,57,0.474,5,27,0.185,8,11,0.727,77,34,78,0.436,25,53,0.472,9,25,0.36,16,18,0.889,93
2439,CHO,2017-04-11,76,@,ATL,0,240,29,88,0.33,26,65,0.4,3,23,0.13,15,19,0.789,76,41,79,0.519,34,52,0.654,7,27,0.259,14,18,0.778,103
2440,ORL,2017-04-10,75,@,CHI,0,240,29,84,0.345,24,57,0.421,5,27,0.185,12,16,0.75,75,48,89,0.539,36,63,0.571,12,26,0.462,14,16,0.875,122
2441,DET,2017-03-17,75,,TOR,0,240,29,83,0.349,26,63,0.413,3,20,0.15,14,21,0.667,75,30,78,0.385,21,51,0.412,9,27,0.333,18,20,0.9,87
2442,MIL,2016-11-06,75,@,DAL,0,265,30,82,0.366,24,53,0.453,6,29,0.207,9,12,0.75,75,33,88,0.375,24,50,0.48,9,38,0.237,11,12,0.917,86
2443,UTA,2016-10-30,75,@,LAC,0,240,29,73,0.397,22,54,0.407,7,19,0.368,10,13,0.769,75,34,83,0.41,28,56,0.5,6,27,0.222,14,20,0.7,88
2444,CLE,2017-03-27,74,@,SAS,0,240,31,83,0.373,27,57,0.474,4,26,0.154,8,13,0.615,74,41,86,0.477,34,60,0.567,7,26,0.269,14,17,0.824,103
2445,DAL,2017-03-17,74,@,PHI,0,240,30,87,0.345,25,64,0.391,5,23,0.217,9,17,0.529,74,42,80,0.525,30,51,0.588,12,29,0.414,20,23,0.87,116
2446,SAS,2017-02-06,74,@,MEM,0,240,30,82,0.366,26,63,0.413,4,19,0.211,10,18,0.556,74,32,81,0.395,28,62,0.452,4,19,0.211,21,25,0.84,89
2447,UTA,2016-12-20,74,@,GSW,0,240,27,76,0.355,18,46,0.391,9,30,0.3,11,20,0.55,74,40,90,0.444,31,67,0.463,9,23,0.391,15,17,0.882,104
2448,ORL,2016-11-11,74,,UTA,0,240,26,78,0.333,18,58,0.31,8,20,0.4,14,19,0.737,74,33,81,0.407,26,53,0.491,7,28,0.25,14,16,0.875,87
2449,BRK,2017-04-12,73,@,CHI,0,240,28,86,0.326,25,53,0.472,3,33,0.091,14,18,0.778,73,41,95,0.432,27,65,0.415,14,30,0.467,16,21,0.762,112
2450,LAL,2017-01-22,73,@,DAL,0,240,28,73,0.384,25,52,0.481,3,21,0.143,14,17,0.824,73,43,87,0.494,26,48,0.542,17,39,0.436,19,19,1.0,122
2451,MEM,2016-12-18,73,,UTA,0,240,28,93,0.301,26,70,0.371,2,23,0.087,15,18,0.833,73,30,66,0.455,22,39,0.564,8,27,0.296,14,25,0.56,82
2452,MIL,2016-11-17,73,@,MIA,0,240,28,85,0.329,21,62,0.339,7,23,0.304,10,13,0.769,73,39,97,0.402,32,67,0.478,7,30,0.233,11,21,0.524,96
2453,UTA,2017-02-13,72,,LAC,0,240,28,87,0.322,24,64,0.375,4,23,0.174,12,18,0.667,72,36,81,0.444,27,56,0.482,9,25,0.36,7,11,0.636,88
2454,PHI,2016-10-29,72,,ATL,0,240,28,80,0.35,23,62,0.371,5,18,0.278,11,15,0.733,72,42,85,0.494,37,65,0.569,5,20,0.25,15,23,0.652,104
2455,MIN,2016-11-19,71,@,MEM,0,240,25,64,0.391,18,42,0.429,7,22,0.318,14,22,0.636,71,29,76,0.382,27,58,0.466,2,18,0.111,33,38,0.868,93
2456,LAC,2016-11-27,70,@,IND,0,240,22,70,0.314,18,46,0.391,4,24,0.167,22,27,0.815,70,40,92,0.435,35,73,0.479,5,19,0.263,6,7,0.857,91
2457,CHI,2016-12-16,69,,MIL,0,240,28,92,0.304,23,71,0.324,5,21,0.238,8,15,0.533,69,38,82,0.463,28,57,0.491,10,25,0.4,9,13,0.692,95
2458,ORL,2016-11-14,69,@,IND,0,240,27,84,0.321,22,59,0.373,5,25,0.2,10,13,0.769,69,35,90,0.389,27,65,0.415,8,25,0.32,10,10,1.0,88
2459,ATL,2016-11-25,68,@,UTA,0,240,26,83,0.313,18,58,0.31,8,25,0.32,8,12,0.667,68,35,80,0.438,25,46,0.543,10,34,0.294,15,18,0.833,95
2460,DAL,2016-11-18,64,,MEM,0,240,21,73,0.288,16,48,0.333,5,25,0.2,17,22,0.773,64,31,77,0.403,22,52,0.423,9,25,0.36,9,12,0.75,80
