Rk,Team,Date,PTS,Unnamed: 4,Opp,Result,MP,FG,FGA,FG%,2P,2PA,2P%,3P,3PA,3P%,FT,FTA,FT%,PTS.1,FG.1,FGA.1,FG%.1,2P.1,2PA.1,2P%.1,3P.1,3PA.1,3P%.1,FT.1,FTA.1,FT%.1,PTS.2
1,DET,2015-12-18,147,@,CHI,1,340,56,124,0.452,48,95,0.505,8,29,0.276,27,46,0.587,147,50,120,0.417,45,98,0.459,5,22,0.227,39,44,0.886,144
2,MIN,2016-04-13,144,,NOP,1,240,56,86,0.651,43,58,0.741,13,28,0.464,19,23,0.826,144,40,92,0.435,29,62,0.468,11,30,0.367,18,22,0.818,109
3,CHI,2015-12-18,144,,DET,0,340,50,120,0.417,45,98,0.459,5,22,0.227,39,44,0.886,144,56,124,0.452,48,95,0.505,8,29,0.276,27,46,0.587,147
4,SAC,2016-01-02,142,,PHO,1,240,53,87,0.609,44,64,0.688,9,23,0.391,27,34,0.794,142,43,83,0.518,33,54,0.611,10,29,0.345,23,28,0.821,119
5,LAC,2016-01-18,140,,HOU,1,265,47,91,0.516,25,54,0.463,22,37,0.595,24,33,0.727,140,44,88,0.5,33,56,0.589,11,32,0.344,33,52,0.635,132
6,ORL,2016-03-29,139,,BRK,1,240,56,91,0.615,42,64,0.656,14,27,0.519,13,19,0.684,139,37,79,0.468,32,65,0.492,5,14,0.357,26,39,0.667,105
7,BOS,2016-02-10,139,,LAC,1,265,47,95,0.495,34,62,0.548,13,33,0.394,32,37,0.865,139,44,85,0.518,32,55,0.582,12,30,0.4,34,50,0.68,134
8,OKC,2015-10-30,139,@,ORL,1,290,50,110,0.455,42,83,0.506,8,27,0.296,31,38,0.816,139,47,106,0.443,35,73,0.479,12,33,0.364,30,38,0.789,136
9,POR,2016-02-19,137,,GSW,1,240,52,97,0.536,35,67,0.522,17,30,0.567,16,23,0.696,137,36,92,0.391,24,58,0.414,12,34,0.353,21,28,0.75,105
10,GSW,2016-04-03,136,,POR,1,240,50,88,0.568,32,58,0.552,18,30,0.6,18,22,0.818,136,38,85,0.447,29,61,0.475,9,24,0.375,26,33,0.788,111
11,ORL,2015-10-30,136,,OKC,0,290,47,106,0.443,35,73,0.479,12,33,0.364,30,38,0.789,136,50,110,0.455,42,83,0.506,8,27,0.296,31,38,0.816,139
12,GSW,2015-11-27,135,@,PHO,1,240,46,81,0.568,24,43,0.558,22,38,0.579,21,31,0.677,135,45,92,0.489,35,66,0.53,10,26,0.385,16,23,0.696,116
13,LAC,2016-02-10,134,@,BOS,0,265,44,85,0.518,32,55,0.582,12,30,0.4,34,50,0.68,134,47,95,0.495,34,62,0.548,13,33,0.394,32,37,0.865,139
14,GSW,2016-02-03,134,@,WAS,1,240,49,93,0.527,29,52,0.558,20,41,0.488,16,29,0.552,134,46,91,0.505,38,68,0.559,8,23,0.348,21,30,0.7,121
15,GSW,2015-10-31,134,@,NOP,1,240,46,84,0.548,29,54,0.537,17,30,0.567,25,35,0.714,134,46,100,0.46,38,78,0.487,8,22,0.364,20,23,0.87,120
16,SAC,2016-03-27,133,,DAL,1,240,51,82,0.622,42,62,0.677,9,20,0.45,22,30,0.733,133,42,88,0.477,34,64,0.531,8,24,0.333,19,24,0.792,111
17,MIN,2016-03-25,132,@,WAS,1,290,51,96,0.531,43,70,0.614,8,26,0.308,22,22,1.0,132,50,100,0.5,37,71,0.521,13,29,0.448,16,23,0.696,129
18,DAL,2016-03-20,132,,POR,1,265,49,89,0.551,34,64,0.531,15,25,0.6,19,23,0.826,132,42,104,0.404,24,58,0.414,18,46,0.391,18,28,0.643,120
19,MIN,2016-03-05,132,,BRK,1,240,52,76,0.684,42,58,0.724,10,18,0.556,18,22,0.818,132,45,92,0.489,36,66,0.545,9,26,0.346,19,26,0.731,118
20,GSW,2016-01-18,132,@,CLE,1,240,46,85,0.541,27,45,0.6,19,40,0.475,21,27,0.778,132,37,77,0.481,30,58,0.517,7,19,0.368,17,25,0.68,98
21,HOU,2016-01-18,132,@,LAC,0,265,44,88,0.5,33,56,0.589,11,32,0.344,33,52,0.635,132,47,91,0.516,25,54,0.463,22,37,0.595,24,33,0.727,140
22,SAC,2015-10-30,132,,LAL,1,240,52,101,0.515,46,79,0.582,6,22,0.273,22,30,0.733,132,41,89,0.461,30,55,0.545,11,34,0.324,21,27,0.778,114
23,BRK,2016-03-15,131,,PHI,1,240,47,90,0.522,37,66,0.561,10,24,0.417,27,31,0.871,131,41,88,0.466,30,58,0.517,11,30,0.367,21,26,0.808,114
24,OKC,2016-02-29,131,@,SAC,1,240,47,82,0.573,33,48,0.688,14,34,0.412,23,26,0.885,131,48,107,0.449,41,82,0.5,7,25,0.28,13,19,0.684,116
25,OKC,2015-12-29,131,,MIL,1,240,43,86,0.5,35,64,0.547,8,22,0.364,37,40,0.925,131,49,100,0.49,39,84,0.464,10,16,0.625,15,22,0.682,123
26,GSW,2015-12-08,131,@,IND,1,240,52,95,0.547,36,60,0.6,16,35,0.457,11,15,0.733,131,44,100,0.44,30,67,0.448,14,33,0.424,21,26,0.808,123
27,HOU,2016-04-10,130,,LAL,1,240,50,98,0.51,33,57,0.579,17,41,0.415,13,18,0.722,130,41,83,0.494,29,55,0.527,12,28,0.429,16,19,0.842,110
28,GSW,2016-03-18,130,@,DAL,1,240,48,95,0.505,26,57,0.456,22,38,0.579,12,14,0.857,130,41,93,0.441,32,64,0.5,9,29,0.31,21,22,0.955,112
29,OKC,2016-03-16,130,@,BOS,1,240,47,96,0.49,35,67,0.522,12,29,0.414,24,30,0.8,130,40,93,0.43,35,74,0.473,5,19,0.263,24,27,0.889,109
30,HOU,2016-03-14,130,,MEM,1,240,46,85,0.541,30,52,0.577,16,33,0.485,22,34,0.647,130,30,101,0.297,26,84,0.31,4,17,0.235,17,28,0.607,81
31,ORL,2016-02-28,130,,PHI,1,240,49,86,0.57,39,70,0.557,10,16,0.625,22,25,0.88,130,41,77,0.532,36,55,0.655,5,22,0.227,29,37,0.784,116
32,GSW,2016-02-25,130,@,ORL,1,240,53,88,0.602,40,63,0.635,13,25,0.52,11,16,0.688,130,41,90,0.456,31,64,0.484,10,26,0.385,22,28,0.786,114
33,SAS,2016-01-27,130,,HOU,1,240,50,90,0.556,38,67,0.567,12,23,0.522,18,21,0.857,130,28,73,0.384,20,43,0.465,8,30,0.267,35,52,0.673,99
34,LAC,2016-01-02,130,,PHI,1,240,49,81,0.605,37,58,0.638,12,23,0.522,20,25,0.8,130,41,89,0.461,32,66,0.485,9,23,0.391,8,17,0.471,99
35,NOP,2015-12-20,130,@,DEN,1,240,44,78,0.564,33,54,0.611,11,24,0.458,31,39,0.795,130,45,96,0.469,28,61,0.459,17,35,0.486,18,22,0.818,125
36,CHO,2015-11-03,130,,CHI,1,240,47,91,0.516,33,68,0.485,14,23,0.609,22,23,0.957,130,44,90,0.489,30,60,0.5,14,30,0.467,3,8,0.375,105
37,HOU,2016-04-11,129,@,MIN,1,240,48,86,0.558,33,56,0.589,15,30,0.5,18,26,0.692,129,38,83,0.458,33,62,0.532,5,21,0.238,24,33,0.727,105
38,IND,2016-04-10,129,,BRK,1,240,48,86,0.558,37,59,0.627,11,27,0.407,22,27,0.815,129,35,91,0.385,21,54,0.389,14,37,0.378,21,26,0.808,105
39,WAS,2016-03-25,129,,MIN,0,290,50,100,0.5,37,71,0.521,13,29,0.448,16,23,0.696,129,51,96,0.531,43,70,0.614,8,26,0.308,22,22,1.0,132
40,MIA,2016-03-01,129,,CHI,1,240,52,77,0.675,46,65,0.708,6,12,0.5,19,25,0.76,129,41,90,0.456,30,67,0.448,11,23,0.478,18,26,0.692,111
41,DAL,2016-02-21,129,,PHI,1,240,41,85,0.482,28,51,0.549,13,34,0.382,34,36,0.944,129,37,77,0.481,25,49,0.51,12,28,0.429,17,27,0.63,103
42,CHO,2016-01-25,129,@,SAC,1,290,44,110,0.4,24,66,0.364,20,44,0.455,21,26,0.808,129,48,91,0.527,41,68,0.603,7,23,0.304,25,32,0.781,128
43,DEN,2016-01-17,129,,IND,1,240,46,91,0.505,36,65,0.554,10,26,0.385,27,38,0.711,129,48,82,0.585,39,62,0.629,9,20,0.45,21,30,0.7,126
44,SAC,2015-11-25,129,@,MIL,1,240,44,77,0.571,34,54,0.63,10,23,0.435,31,37,0.838,129,42,88,0.477,29,57,0.509,13,31,0.419,21,27,0.778,118
45,GSW,2015-11-12,129,@,MIN,1,240,48,89,0.539,30,51,0.588,18,38,0.474,15,16,0.938,129,43,87,0.494,40,78,0.513,3,9,0.333,27,36,0.75,116
46,GSW,2016-03-25,128,,DAL,1,240,43,88,0.489,22,43,0.512,21,45,0.467,21,23,0.913,128,43,96,0.448,25,61,0.41,18,35,0.514,16,21,0.762,120
47,OKC,2016-03-14,128,,POR,1,240,49,83,0.59,40,66,0.606,9,17,0.529,21,26,0.808,128,31,91,0.341,24,64,0.375,7,27,0.259,25,27,0.926,94
48,GSW,2016-03-11,128,,POR,1,240,40,89,0.449,22,49,0.449,18,40,0.45,30,39,0.769,128,37,86,0.43,18,50,0.36,19,36,0.528,19,23,0.826,112
49,NYK,2016-03-09,128,@,PHO,1,240,46,82,0.561,30,58,0.517,16,24,0.667,20,24,0.833,128,39,89,0.438,30,60,0.5,9,29,0.31,10,15,0.667,97
50,MIL,2016-02-29,128,,HOU,1,240,48,81,0.593,40,66,0.606,8,15,0.533,24,33,0.727,128,41,87,0.471,26,51,0.51,15,36,0.417,24,35,0.686,121
51,DAL,2016-02-28,128,,MIN,1,240,47,89,0.528,34,53,0.642,13,36,0.361,21,21,1.0,128,34,90,0.378,27,67,0.403,7,23,0.304,26,37,0.703,101
52,MEM,2016-02-24,128,,LAL,1,240,48,85,0.565,35,58,0.603,13,27,0.481,19,29,0.655,128,39,88,0.443,22,49,0.449,17,39,0.436,24,33,0.727,119
53,BOS,2016-02-07,128,,SAC,1,240,51,91,0.56,38,67,0.567,13,24,0.542,13,15,0.867,128,47,95,0.495,37,69,0.536,10,26,0.385,15,19,0.789,119
54,BRK,2016-02-05,128,,SAC,1,240,48,86,0.558,30,58,0.517,18,28,0.643,14,15,0.933,128,45,89,0.506,37,63,0.587,8,26,0.308,21,22,0.955,119
55,OKC,2016-01-26,128,@,NYK,1,265,46,99,0.465,35,79,0.443,11,20,0.55,25,29,0.862,128,44,95,0.463,33,72,0.458,11,23,0.478,23,30,0.767,122
56,SAC,2016-01-25,128,,CHO,0,290,48,91,0.527,41,68,0.603,7,23,0.304,25,32,0.781,128,44,110,0.4,24,66,0.364,20,44,0.455,21,26,0.808,129
57,GSW,2016-01-09,128,@,SAC,1,240,49,87,0.563,30,50,0.6,19,37,0.514,11,15,0.733,128,43,92,0.467,35,69,0.507,8,23,0.348,22,29,0.759,116
58,GSW,2016-01-08,128,@,POR,1,240,46,87,0.529,28,55,0.509,18,32,0.563,18,21,0.857,128,38,96,0.396,26,63,0.413,12,33,0.364,20,28,0.714,108
59,GSW,2015-12-16,128,,PHO,1,240,46,88,0.523,31,56,0.554,15,32,0.469,21,27,0.778,128,41,91,0.451,36,69,0.522,5,22,0.227,16,18,0.889,103
60,GSW,2016-01-27,127,,DAL,1,240,47,81,0.58,33,52,0.635,14,29,0.483,19,21,0.905,127,44,87,0.506,33,56,0.589,11,31,0.355,8,12,0.667,107
61,ATL,2015-12-16,127,,PHI,1,240,48,78,0.615,38,57,0.667,10,21,0.476,21,24,0.875,127,39,75,0.52,27,49,0.551,12,26,0.462,16,24,0.667,106
62,DET,2015-12-02,127,,PHO,1,265,44,87,0.506,32,60,0.533,12,27,0.444,27,44,0.614,127,47,97,0.485,33,64,0.516,14,33,0.424,14,15,0.933,122
63,CHO,2015-11-23,127,,SAC,1,265,49,98,0.5,40,69,0.58,9,29,0.31,20,26,0.769,127,52,104,0.5,44,73,0.603,8,31,0.258,10,16,0.625,122
64,CHO,2016-03-01,126,,PHO,1,240,45,93,0.484,32,66,0.485,13,27,0.481,23,27,0.852,126,33,91,0.363,27,64,0.422,6,27,0.222,20,27,0.741,92
65,CHI,2016-02-21,126,,LAL,1,240,44,79,0.557,31,60,0.517,13,19,0.684,25,26,0.962,126,43,93,0.462,36,72,0.5,7,21,0.333,22,33,0.667,115
66,OKC,2016-01-27,126,@,MIN,1,240,48,91,0.527,38,71,0.535,10,20,0.5,20,21,0.952,126,50,90,0.556,45,76,0.592,5,14,0.357,18,28,0.643,123
67,IND,2016-01-17,126,@,DEN,0,240,48,82,0.585,39,62,0.629,9,20,0.45,21,30,0.7,126,46,91,0.505,36,65,0.554,10,26,0.385,27,38,0.711,129
68,ATL,2016-01-07,126,@,PHI,1,240,49,92,0.533,36,60,0.6,13,32,0.406,15,19,0.789,126,39,86,0.453,34,68,0.5,5,18,0.278,15,25,0.6,98
69,HOU,2015-12-12,126,,LAL,1,240,47,90,0.522,32,57,0.561,15,33,0.455,17,28,0.607,126,35,88,0.398,25,56,0.446,10,32,0.313,17,20,0.85,97
70,GSW,2016-04-13,125,,MEM,1,240,46,87,0.529,26,40,0.65,20,47,0.426,13,16,0.813,125,42,98,0.429,34,74,0.459,8,24,0.333,12,16,0.75,104
71,GSW,2016-03-14,125,,NOP,1,240,47,81,0.58,35,56,0.625,12,25,0.48,19,23,0.826,125,35,93,0.376,28,68,0.412,7,25,0.28,30,34,0.882,107
72,CHO,2016-03-12,125,,HOU,1,240,48,88,0.545,33,57,0.579,15,31,0.484,14,16,0.875,125,43,93,0.462,38,67,0.567,5,26,0.192,18,28,0.643,109
73,DET,2016-03-12,125,@,PHI,1,240,49,91,0.538,40,73,0.548,9,18,0.5,18,22,0.818,125,39,84,0.464,29,59,0.492,10,25,0.4,23,27,0.852,111
74,GSW,2016-01-20,125,@,CHI,1,240,50,95,0.526,38,63,0.603,12,32,0.375,13,20,0.65,125,37,100,0.37,36,80,0.45,1,20,0.05,19,24,0.792,94
75,CLE,2016-01-08,125,@,MIN,1,240,43,81,0.531,30,54,0.556,13,27,0.481,26,29,0.897,125,36,79,0.456,29,63,0.46,7,16,0.438,20,26,0.769,99
76,DEN,2015-12-20,125,,NOP,0,240,45,96,0.469,28,61,0.459,17,35,0.486,18,22,0.818,125,44,78,0.564,33,54,0.611,11,24,0.458,31,39,0.795,130
77,OKC,2015-12-08,125,@,MEM,1,240,47,84,0.56,34,58,0.586,13,26,0.5,18,23,0.783,125,33,81,0.407,30,67,0.448,3,14,0.214,19,22,0.864,88
78,OKC,2015-11-10,125,@,WAS,1,240,44,86,0.512,29,63,0.46,15,23,0.652,22,29,0.759,125,38,97,0.392,33,73,0.452,5,24,0.208,20,26,0.769,101
79,BOS,2016-04-08,124,,MIL,1,240,44,78,0.564,38,64,0.594,6,14,0.429,30,38,0.789,124,41,84,0.488,34,67,0.507,7,17,0.412,20,29,0.69,109
80,PHO,2016-04-07,124,@,HOU,1,240,44,94,0.468,32,63,0.508,12,31,0.387,24,29,0.828,124,42,74,0.568,28,41,0.683,14,33,0.424,17,28,0.607,115
81,OKC,2016-04-05,124,@,DEN,1,240,46,87,0.529,31,54,0.574,15,33,0.455,17,24,0.708,124,37,88,0.42,27,58,0.466,10,30,0.333,18,27,0.667,102
82,MIN,2016-04-05,124,@,GSW,1,265,44,86,0.512,36,69,0.522,8,17,0.471,28,36,0.778,124,49,98,0.5,37,63,0.587,12,35,0.343,7,8,0.875,117
83,CLE,2016-03-21,124,,DEN,1,240,48,86,0.558,33,55,0.6,15,31,0.484,13,17,0.765,124,32,81,0.395,24,59,0.407,8,22,0.364,19,25,0.76,91
84,WAS,2016-03-14,124,,DET,1,240,51,90,0.567,43,72,0.597,8,18,0.444,14,18,0.778,124,32,79,0.405,29,56,0.518,3,23,0.13,14,22,0.636,81
85,MIA,2016-03-14,124,,DEN,1,240,47,79,0.595,39,62,0.629,8,17,0.471,22,28,0.786,124,49,93,0.527,42,73,0.575,7,20,0.35,14,20,0.7,119
86,ORL,2016-02-23,124,@,PHI,1,240,41,85,0.482,34,71,0.479,7,14,0.5,35,41,0.854,124,43,79,0.544,33,58,0.569,10,21,0.476,19,26,0.731,115
87,MIN,2016-02-22,124,,BOS,1,240,43,83,0.518,35,68,0.515,8,15,0.533,30,40,0.75,124,49,101,0.485,39,73,0.534,10,28,0.357,14,17,0.824,122
88,LAC,2016-02-22,124,,PHO,1,240,44,80,0.55,31,56,0.554,13,24,0.542,23,35,0.657,124,31,88,0.352,24,64,0.375,7,24,0.292,15,20,0.75,84
89,ATL,2016-02-03,124,@,PHI,1,240,48,92,0.522,38,72,0.528,10,20,0.5,18,25,0.72,124,35,84,0.417,29,57,0.509,6,27,0.222,10,14,0.714,86
90,CHO,2016-01-18,124,,UTA,1,290,41,88,0.466,27,61,0.443,14,27,0.519,28,32,0.875,124,44,104,0.423,29,59,0.492,15,45,0.333,16,20,0.8,119
91,GSW,2015-12-11,124,@,BOS,1,290,42,107,0.393,33,76,0.434,9,31,0.29,31,39,0.795,124,49,114,0.43,37,81,0.457,12,33,0.364,9,16,0.563,119
92,GSW,2015-11-19,124,@,LAC,1,240,38,73,0.521,21,43,0.488,17,30,0.567,31,36,0.861,124,44,88,0.5,31,59,0.525,13,29,0.448,16,24,0.667,117
93,OKC,2015-11-08,124,,PHO,1,240,49,94,0.521,45,74,0.608,4,20,0.2,22,30,0.733,124,38,84,0.452,31,68,0.456,7,16,0.438,20,26,0.769,103
94,IND,2016-04-06,123,,CLE,1,240,45,80,0.563,29,49,0.592,16,31,0.516,17,22,0.773,123,35,74,0.473,27,45,0.6,8,29,0.276,31,34,0.912,109
95,UTA,2016-03-28,123,,LAL,1,240,46,89,0.517,29,57,0.509,17,32,0.531,14,19,0.737,123,26,85,0.306,19,65,0.292,7,20,0.35,16,22,0.727,75
96,NOP,2016-03-16,123,@,SAC,1,240,49,90,0.544,37,69,0.536,12,21,0.571,13,16,0.813,123,42,90,0.467,33,72,0.458,9,18,0.5,15,17,0.882,108
97,GSW,2016-03-12,123,,PHO,1,240,42,84,0.5,31,51,0.608,11,33,0.333,28,33,0.848,123,45,92,0.489,34,63,0.54,11,29,0.379,15,20,0.75,116
98,DET,2016-03-06,123,,POR,1,240,44,84,0.524,32,62,0.516,12,22,0.545,23,28,0.821,123,35,78,0.449,24,47,0.511,11,31,0.355,22,23,0.957,103
99,NOP,2016-02-25,123,,OKC,1,240,47,90,0.522,35,70,0.5,12,20,0.6,17,18,0.944,123,47,86,0.547,39,67,0.582,8,19,0.421,17,22,0.773,119
100,GSW,2016-02-09,123,,HOU,1,240,44,94,0.468,32,60,0.533,12,34,0.353,23,26,0.885,123,37,87,0.425,24,54,0.444,13,33,0.394,23,35,0.657,110
101,WAS,2016-01-30,123,@,HOU,1,240,45,86,0.523,34,54,0.63,11,32,0.344,22,30,0.733,123,41,86,0.477,24,51,0.471,17,35,0.486,23,33,0.697,122
102,MIN,2016-01-27,123,,OKC,0,240,50,90,0.556,45,76,0.592,5,14,0.357,18,28,0.643,123,48,91,0.527,38,71,0.535,10,20,0.5,20,21,0.952,126
103,DET,2016-01-20,123,@,HOU,1,240,38,80,0.475,26,50,0.52,12,30,0.4,35,59,0.593,123,43,95,0.453,31,71,0.437,12,24,0.5,16,18,0.889,114
104,SAS,2016-01-06,123,,UTA,1,240,52,86,0.605,43,65,0.662,9,21,0.429,10,13,0.769,123,37,79,0.468,30,61,0.492,7,18,0.389,17,18,0.944,98
105,SAS,2016-01-04,123,@,MIL,1,240,49,90,0.544,40,70,0.571,9,20,0.45,16,20,0.8,123,37,77,0.481,34,65,0.523,3,12,0.25,21,30,0.7,98
106,MIL,2015-12-29,123,@,OKC,0,240,49,100,0.49,39,84,0.464,10,16,0.625,15,22,0.682,123,43,86,0.5,35,64,0.547,8,22,0.364,37,40,0.925,131
107,CHO,2015-12-11,123,@,MEM,1,240,39,78,0.5,21,41,0.512,18,37,0.486,27,30,0.9,123,32,80,0.4,25,60,0.417,7,20,0.35,28,37,0.757,99
108,MIN,2015-12-09,123,,LAL,1,265,46,93,0.495,39,74,0.527,7,19,0.368,24,31,0.774,123,48,93,0.516,39,70,0.557,9,23,0.391,17,27,0.63,122
109,IND,2015-12-08,123,,GSW,0,240,44,100,0.44,30,67,0.448,14,33,0.424,21,26,0.808,123,52,95,0.547,36,60,0.6,16,35,0.457,11,15,0.733,131
110,POR,2015-12-03,123,,IND,1,240,44,85,0.518,26,49,0.531,18,36,0.5,17,20,0.85,123,38,88,0.432,25,58,0.431,13,30,0.433,22,24,0.917,111
111,IND,2015-11-24,123,@,WAS,1,240,44,80,0.55,25,54,0.463,19,26,0.731,16,23,0.696,123,38,83,0.458,25,50,0.5,13,33,0.394,17,24,0.708,106
112,IND,2015-11-21,123,,MIL,1,240,47,91,0.516,32,61,0.525,15,30,0.5,14,23,0.609,123,34,79,0.43,29,62,0.468,5,17,0.294,13,19,0.684,86
113,TOR,2016-04-12,122,,PHI,1,240,48,95,0.505,38,70,0.543,10,25,0.4,16,19,0.842,122,35,77,0.455,20,42,0.476,15,35,0.429,13,25,0.52,98
114,ATL,2016-03-23,122,@,WAS,1,240,45,84,0.536,28,42,0.667,17,42,0.405,15,22,0.682,122,39,92,0.424,27,62,0.435,12,30,0.4,11,12,0.917,101
115,MIA,2016-03-19,122,,CLE,1,240,46,84,0.548,35,65,0.538,11,19,0.579,19,23,0.826,122,40,76,0.526,30,52,0.577,10,24,0.417,11,13,0.846,101
116,LAC,2016-03-16,122,@,HOU,1,240,43,76,0.566,31,46,0.674,12,30,0.4,24,32,0.75,122,40,82,0.488,31,57,0.544,9,25,0.36,17,24,0.708,106
117,CHO,2016-03-09,122,,NOP,1,240,38,82,0.463,23,47,0.489,15,35,0.429,31,38,0.816,122,40,85,0.471,30,52,0.577,10,33,0.303,23,28,0.821,113
118,DAL,2016-02-26,122,,DEN,1,265,45,88,0.511,34,59,0.576,11,29,0.379,21,27,0.778,122,43,93,0.462,34,64,0.531,9,29,0.31,21,31,0.677,116
119,TOR,2016-02-22,122,@,NYK,1,240,46,87,0.529,35,62,0.565,11,25,0.44,19,25,0.76,122,37,84,0.44,31,64,0.484,6,20,0.3,15,23,0.652,95
120,BOS,2016-02-22,122,@,MIN,0,240,49,101,0.485,39,73,0.534,10,28,0.357,14,17,0.824,122,43,83,0.518,35,68,0.515,8,15,0.533,30,40,0.75,124
121,OKC,2016-02-08,122,@,PHO,1,240,42,85,0.494,27,52,0.519,15,33,0.455,23,30,0.767,122,37,73,0.507,36,62,0.581,1,11,0.091,31,39,0.795,106
122,HOU,2016-01-30,122,,WAS,0,240,41,86,0.477,24,51,0.471,17,35,0.486,23,33,0.697,122,45,86,0.523,34,54,0.63,11,32,0.344,22,30,0.733,123
123,NYK,2016-01-26,122,,OKC,0,265,44,95,0.463,33,72,0.458,11,23,0.478,23,30,0.767,122,46,99,0.465,35,79,0.443,11,20,0.55,25,29,0.862,128
124,GSW,2016-01-22,122,,IND,1,240,43,90,0.478,29,57,0.509,14,33,0.424,22,25,0.88,122,44,95,0.463,41,78,0.526,3,17,0.176,19,27,0.704,110
125,CLE,2016-01-04,122,,TOR,1,240,41,74,0.554,24,41,0.585,17,33,0.515,23,26,0.885,122,36,73,0.493,28,54,0.519,8,19,0.421,20,29,0.69,100
126,LAC,2015-12-30,122,@,CHO,1,240,37,71,0.521,22,41,0.537,15,30,0.5,33,41,0.805,122,38,88,0.432,29,58,0.5,9,30,0.3,32,36,0.889,117
127,GSW,2015-12-28,122,,SAC,1,240,43,89,0.483,23,47,0.489,20,42,0.476,16,24,0.667,122,37,95,0.389,24,64,0.375,13,31,0.419,16,28,0.571,103
128,OKC,2015-12-27,122,,DEN,1,240,48,83,0.578,40,68,0.588,8,15,0.533,18,21,0.857,122,46,94,0.489,37,69,0.536,9,25,0.36,11,15,0.733,112
129,LAL,2015-12-09,122,@,MIN,0,265,48,93,0.516,39,70,0.557,9,23,0.391,17,27,0.63,122,46,93,0.495,39,74,0.527,7,19,0.368,24,31,0.774,123
130,UTA,2015-12-05,122,,IND,1,265,43,92,0.467,35,69,0.507,8,23,0.348,28,37,0.757,122,40,93,0.43,28,64,0.438,12,29,0.414,27,34,0.794,119
131,PHO,2015-12-02,122,@,DET,0,265,47,97,0.485,33,64,0.516,14,33,0.424,14,15,0.933,122,44,87,0.506,32,60,0.533,12,27,0.444,27,44,0.614,127
132,SAC,2015-11-23,122,@,CHO,0,265,52,104,0.5,44,73,0.603,8,31,0.258,10,16,0.625,122,49,98,0.5,40,69,0.58,9,29,0.31,20,26,0.769,127
133,NOP,2015-11-22,122,,PHO,1,240,39,85,0.459,28,55,0.509,11,30,0.367,33,40,0.825,122,35,90,0.389,18,54,0.333,17,36,0.472,29,33,0.879,116
134,MEM,2015-11-16,122,,OKC,1,240,37,84,0.44,25,67,0.373,12,17,0.706,36,39,0.923,122,41,81,0.506,31,57,0.544,10,24,0.417,22,31,0.71,114
135,NYK,2015-10-28,122,@,MIL,1,240,42,93,0.452,33,70,0.471,9,23,0.391,29,35,0.829,122,30,86,0.349,21,68,0.309,9,18,0.5,28,31,0.903,97
136,CHI,2016-04-11,121,@,NOP,1,240,44,77,0.571,34,54,0.63,10,23,0.435,23,26,0.885,121,41,80,0.513,29,54,0.537,12,26,0.462,22,28,0.786,116
137,PHO,2016-04-09,121,@,NOP,1,240,43,83,0.518,33,58,0.569,10,25,0.4,25,31,0.806,121,39,95,0.411,32,74,0.432,7,21,0.333,15,20,0.75,100
138,WAS,2016-04-06,121,,BRK,1,240,48,95,0.505,40,67,0.597,8,28,0.286,17,20,0.85,121,39,92,0.424,32,75,0.427,7,17,0.412,18,24,0.75,103
139,MIN,2016-03-28,121,,PHO,1,240,41,81,0.506,34,55,0.618,7,26,0.269,32,40,0.8,121,41,84,0.488,26,51,0.51,15,33,0.455,19,23,0.826,116
140,GSW,2016-03-16,121,,NYK,1,240,46,91,0.505,28,54,0.519,18,37,0.486,11,12,0.917,121,36,91,0.396,29,72,0.403,7,19,0.368,6,10,0.6,85
141,POR,2016-03-12,121,,ORL,1,240,47,84,0.56,30,49,0.612,17,35,0.486,10,11,0.909,121,34,91,0.374,27,65,0.415,7,26,0.269,9,18,0.5,84
142,MEM,2016-03-11,121,,NOP,1,265,47,96,0.49,41,82,0.5,6,14,0.429,21,32,0.656,121,42,96,0.438,35,72,0.486,7,24,0.292,23,34,0.676,114
143,BRK,2016-03-04,121,@,DEN,1,265,46,91,0.505,33,69,0.478,13,22,0.591,16,21,0.762,121,46,96,0.479,40,70,0.571,6,26,0.231,22,25,0.88,120
144,GSW,2016-03-03,121,,OKC,1,240,47,87,0.54,36,53,0.679,11,34,0.324,16,21,0.762,121,40,86,0.465,36,66,0.545,4,20,0.2,22,27,0.815,106
145,DAL,2016-03-01,121,,ORL,1,240,43,77,0.558,34,58,0.586,9,19,0.474,26,31,0.839,121,41,91,0.451,32,61,0.525,9,30,0.3,17,20,0.85,108
146,HOU,2016-02-29,121,@,MIL,0,240,41,87,0.471,26,51,0.51,15,36,0.417,24,35,0.686,121,48,81,0.593,40,66,0.606,8,15,0.533,24,33,0.727,128
147,GSW,2016-02-27,121,@,OKC,1,265,45,95,0.474,31,63,0.492,14,32,0.438,17,25,0.68,121,46,96,0.479,37,70,0.529,9,26,0.346,17,26,0.654,118
148,BOS,2016-02-21,121,@,DEN,1,240,47,97,0.485,37,65,0.569,10,32,0.313,17,20,0.85,121,34,73,0.466,28,52,0.538,6,21,0.286,27,34,0.794,101
149,NOP,2016-02-19,121,,PHI,1,240,41,81,0.506,34,64,0.531,7,17,0.412,32,40,0.8,121,40,76,0.526,28,49,0.571,12,27,0.444,22,26,0.846,114
150,OKC,2016-02-11,121,,NOP,1,240,45,86,0.523,33,54,0.611,12,32,0.375,19,23,0.826,121,38,88,0.432,35,72,0.486,3,16,0.188,16,24,0.667,95
151,UTA,2016-02-09,121,@,DAL,1,265,48,92,0.522,42,66,0.636,6,26,0.231,19,27,0.704,121,36,75,0.48,25,46,0.543,11,29,0.379,36,41,0.878,119
152,WAS,2016-02-03,121,,GSW,0,240,46,91,0.505,38,68,0.559,8,23,0.348,21,30,0.7,121,49,93,0.527,29,52,0.558,20,41,0.488,16,29,0.552,134
153,MEM,2016-01-30,121,,SAC,1,240,41,79,0.519,33,61,0.541,8,18,0.444,31,37,0.838,121,38,92,0.413,29,68,0.426,9,24,0.375,32,38,0.842,117
154,POR,2016-01-23,121,,LAL,1,240,47,93,0.505,37,62,0.597,10,31,0.323,17,22,0.773,121,34,69,0.493,27,52,0.519,7,17,0.412,28,32,0.875,103
155,CLE,2016-01-06,121,@,WAS,1,240,48,89,0.539,36,60,0.6,12,29,0.414,13,19,0.684,121,42,76,0.553,28,52,0.538,14,24,0.583,17,27,0.63,115
156,SAS,2016-01-02,121,,HOU,1,240,45,86,0.523,32,62,0.516,13,24,0.542,18,19,0.947,121,37,74,0.5,28,52,0.538,9,22,0.409,20,33,0.606,103
157,ATL,2015-12-29,121,@,HOU,1,240,43,99,0.434,29,58,0.5,14,41,0.341,21,25,0.84,121,39,72,0.542,28,52,0.538,11,20,0.55,26,39,0.667,115
158,GSW,2015-12-18,121,,MIL,1,240,42,87,0.483,33,61,0.541,9,26,0.346,28,37,0.757,121,42,91,0.462,38,73,0.521,4,18,0.222,24,28,0.857,112
159,ATL,2015-11-24,121,,BOS,1,240,45,80,0.563,33,56,0.589,12,24,0.5,19,22,0.864,121,34,82,0.415,25,61,0.41,9,21,0.429,20,26,0.769,97
160,ATL,2015-11-06,121,@,NOP,1,240,41,77,0.532,32,56,0.571,9,21,0.429,30,35,0.857,121,42,84,0.5,32,54,0.593,10,30,0.333,21,24,0.875,115
161,WAS,2016-04-11,120,@,BRK,1,240,46,89,0.517,37,64,0.578,9,25,0.36,19,24,0.792,120,44,98,0.449,34,67,0.507,10,31,0.323,13,21,0.619,111
162,POR,2016-04-06,120,,OKC,1,240,43,84,0.512,28,51,0.549,15,33,0.455,19,24,0.792,120,43,91,0.473,34,69,0.493,9,22,0.409,20,31,0.645,115
163,SAC,2016-03-30,120,,WAS,1,240,47,84,0.56,39,66,0.591,8,18,0.444,18,25,0.72,120,43,89,0.483,34,63,0.54,9,26,0.346,16,20,0.8,111
164,BRK,2016-03-26,120,,IND,1,240,42,77,0.545,37,66,0.561,5,11,0.455,31,36,0.861,120,37,77,0.481,26,53,0.491,11,24,0.458,25,30,0.833,110
165,DAL,2016-03-25,120,@,GSW,0,240,43,96,0.448,25,61,0.41,18,35,0.514,16,21,0.762,120,43,88,0.489,22,43,0.512,21,45,0.467,21,23,0.913,128
166,BOS,2016-03-20,120,@,PHI,1,240,46,94,0.489,36,69,0.522,10,25,0.4,18,21,0.857,120,39,92,0.424,31,71,0.437,8,21,0.381,19,27,0.704,105
167,POR,2016-03-20,120,@,DAL,0,265,42,104,0.404,24,58,0.414,18,46,0.391,18,28,0.643,120,49,89,0.551,34,64,0.531,15,25,0.6,19,23,0.826,132
168,CLE,2016-03-10,120,@,LAL,1,240,45,85,0.529,29,50,0.58,16,35,0.457,14,20,0.7,120,42,80,0.525,35,58,0.603,7,22,0.318,17,21,0.81,108
169,CLE,2016-03-09,120,@,SAC,1,240,39,90,0.433,26,46,0.565,13,44,0.295,29,35,0.829,120,40,84,0.476,32,62,0.516,8,22,0.364,23,32,0.719,111
170,OKC,2016-03-09,120,,LAC,1,240,48,91,0.527,39,67,0.582,9,24,0.375,15,18,0.833,120,41,81,0.506,29,47,0.617,12,34,0.353,14,23,0.609,108
171,CLE,2016-03-05,120,,BOS,1,240,42,82,0.512,32,52,0.615,10,30,0.333,26,34,0.765,120,37,80,0.463,27,57,0.474,10,23,0.435,19,27,0.704,103
172,DEN,2016-03-04,120,,BRK,0,265,46,96,0.479,40,70,0.571,6,26,0.231,22,25,0.88,120,46,91,0.505,33,69,0.478,13,22,0.591,16,21,0.762,121
173,CLE,2016-02-10,120,,LAL,1,240,48,94,0.511,35,63,0.556,13,31,0.419,11,18,0.611,120,38,86,0.442,25,58,0.431,13,28,0.464,22,27,0.815,111
174,CLE,2016-02-08,120,,SAC,1,240,45,94,0.479,29,59,0.492,16,35,0.457,14,19,0.737,120,36,82,0.439,27,59,0.458,9,23,0.391,19,29,0.655,100
175,LAC,2016-01-31,120,,CHI,1,240,45,84,0.536,28,52,0.538,17,32,0.531,13,19,0.684,120,40,93,0.43,35,78,0.449,5,15,0.333,8,11,0.727,93
176,GSW,2016-01-25,120,,SAS,1,240,44,85,0.518,33,59,0.559,11,26,0.423,21,25,0.84,120,31,74,0.419,26,60,0.433,5,14,0.357,23,31,0.742,90
177,CHO,2016-01-22,120,@,ORL,1,265,45,101,0.446,35,74,0.473,10,27,0.37,20,22,0.909,120,45,91,0.495,34,68,0.5,11,23,0.478,15,19,0.789,116
178,NYK,2016-01-12,120,,BOS,1,240,43,81,0.531,36,61,0.59,7,20,0.35,27,30,0.9,120,42,86,0.488,33,57,0.579,9,29,0.31,21,26,0.808,114
179,ATL,2016-01-09,120,,CHI,1,240,49,94,0.521,39,70,0.557,10,24,0.417,12,15,0.8,120,36,83,0.434,29,65,0.446,7,18,0.389,26,31,0.839,105
180,MIL,2015-12-31,120,@,IND,1,240,45,77,0.584,39,63,0.619,6,14,0.429,24,35,0.686,120,41,82,0.5,28,52,0.538,13,30,0.433,21,26,0.808,116
181,OKC,2015-12-23,120,@,LAL,1,240,51,95,0.537,46,76,0.605,5,19,0.263,13,17,0.765,120,32,89,0.36,25,64,0.391,7,25,0.28,14,22,0.636,85
182,HOU,2015-12-05,120,,SAC,1,240,36,78,0.462,20,44,0.455,16,34,0.471,32,43,0.744,120,46,98,0.469,36,72,0.5,10,26,0.385,11,13,0.846,113
183,GSW,2015-11-28,120,,SAC,1,240,39,80,0.488,23,50,0.46,16,30,0.533,26,31,0.839,120,39,100,0.39,29,75,0.387,10,25,0.4,13,15,0.867,101
184,NOP,2015-11-25,120,@,PHO,1,240,42,81,0.519,32,59,0.542,10,22,0.455,26,34,0.765,120,44,96,0.458,34,70,0.486,10,26,0.385,16,20,0.8,114
185,BOS,2015-11-20,120,,BRK,1,240,51,87,0.586,41,58,0.707,10,29,0.345,8,10,0.8,120,35,89,0.393,27,70,0.386,8,19,0.421,17,24,0.708,95
186,PHO,2015-11-16,120,,LAL,1,240,45,93,0.484,34,63,0.54,11,30,0.367,19,25,0.76,120,37,77,0.481,28,57,0.491,9,20,0.45,18,20,0.9,101
187,NOP,2015-11-10,120,,DAL,1,240,46,92,0.5,32,59,0.542,14,33,0.424,14,18,0.778,120,39,88,0.443,34,68,0.5,5,20,0.25,22,26,0.846,105
188,DET,2015-11-08,120,@,POR,1,240,47,96,0.49,36,66,0.545,11,30,0.367,15,22,0.682,120,41,76,0.539,32,51,0.627,9,25,0.36,12,18,0.667,103
189,DEN,2015-11-03,120,@,LAL,1,240,43,85,0.506,36,65,0.554,7,20,0.35,27,31,0.871,120,36,86,0.419,30,60,0.5,6,26,0.231,31,38,0.816,109
190,NOP,2015-10-31,120,,GSW,0,240,46,100,0.46,38,78,0.487,8,22,0.364,20,23,0.87,120,46,84,0.548,29,54,0.537,17,30,0.567,25,35,0.714,134
191,ORL,2016-04-03,119,,MEM,1,240,43,90,0.478,33,64,0.516,10,26,0.385,23,29,0.793,119,41,89,0.461,33,68,0.485,8,21,0.381,17,26,0.654,107
192,OKC,2016-03-31,119,,LAC,1,240,45,87,0.517,35,55,0.636,10,32,0.313,19,24,0.792,119,42,76,0.553,26,47,0.553,16,29,0.552,17,22,0.773,117
193,OKC,2016-03-28,119,@,TOR,1,240,41,86,0.477,30,60,0.5,11,26,0.423,26,32,0.813,119,38,93,0.409,30,69,0.435,8,24,0.333,16,23,0.696,100
194,PHO,2016-03-23,119,,LAL,1,240,47,93,0.505,34,65,0.523,13,28,0.464,12,20,0.6,119,39,93,0.419,32,66,0.485,7,27,0.259,22,26,0.846,107
195,DEN,2016-03-14,119,@,MIA,0,240,49,93,0.527,42,73,0.575,7,20,0.35,14,20,0.7,119,47,79,0.595,39,62,0.629,8,17,0.471,22,28,0.786,124
196,GSW,2016-03-07,119,,ORL,1,240,42,84,0.5,26,49,0.531,16,35,0.457,19,27,0.704,119,40,90,0.444,35,69,0.507,5,21,0.238,28,34,0.824,113
197,CHO,2016-03-02,119,@,PHI,1,240,40,81,0.494,30,56,0.536,10,25,0.4,29,35,0.829,119,34,85,0.4,21,52,0.404,13,33,0.394,18,26,0.692,99
198,HOU,2016-02-25,119,@,POR,1,240,44,82,0.537,34,53,0.642,10,29,0.345,21,35,0.6,119,37,80,0.463,24,45,0.533,13,35,0.371,18,22,0.818,105
199,OKC,2016-02-25,119,@,NOP,0,240,47,86,0.547,39,67,0.582,8,19,0.421,17,22,0.773,119,47,90,0.522,35,70,0.5,12,20,0.6,17,18,0.944,123
200,LAL,2016-02-24,119,@,MEM,0,240,39,88,0.443,22,49,0.449,17,39,0.436,24,33,0.727,119,48,85,0.565,35,58,0.603,13,27,0.481,19,29,0.655,128
201,SAS,2016-02-19,119,@,LAL,1,240,48,88,0.545,42,76,0.553,6,12,0.5,17,18,0.944,119,40,81,0.494,30,59,0.508,10,22,0.455,23,26,0.885,113
202,SAS,2016-02-09,119,@,MIA,1,240,47,89,0.528,41,75,0.547,6,14,0.429,19,26,0.731,119,40,70,0.571,36,58,0.621,4,12,0.333,17,24,0.708,101
203,DAL,2016-02-09,119,,UTA,0,265,36,75,0.48,25,46,0.543,11,29,0.379,36,41,0.878,119,48,92,0.522,42,66,0.636,6,26,0.231,19,27,0.704,121
204,SAC,2016-02-07,119,@,BOS,0,240,47,95,0.495,37,69,0.536,10,26,0.385,15,19,0.789,119,51,91,0.56,38,67,0.567,13,24,0.542,13,15,0.867,128
205,SAC,2016-02-05,119,@,BRK,0,240,45,89,0.506,37,63,0.587,8,26,0.308,21,22,0.955,119,48,86,0.558,30,58,0.517,18,28,0.643,14,15,0.933,128
206,LAL,2016-02-02,119,,MIN,1,240,40,80,0.5,28,54,0.519,12,26,0.462,27,35,0.771,119,46,80,0.575,42,63,0.667,4,17,0.235,19,25,0.76,115
207,ORL,2016-01-31,119,,BOS,1,240,44,82,0.537,34,58,0.586,10,24,0.417,21,35,0.6,119,39,93,0.419,23,47,0.489,16,46,0.348,20,25,0.8,114
208,ATL,2016-01-25,119,@,DEN,1,240,43,86,0.5,34,59,0.576,9,27,0.333,24,26,0.923,119,33,84,0.393,27,64,0.422,6,20,0.3,33,37,0.892,105
209,NYK,2016-01-18,119,,PHI,1,290,43,97,0.443,35,77,0.455,8,20,0.4,25,30,0.833,119,45,102,0.441,35,74,0.473,10,28,0.357,13,25,0.52,113
210,UTA,2016-01-18,119,@,CHO,0,290,44,104,0.423,29,59,0.492,15,45,0.333,16,20,0.8,119,41,88,0.466,27,61,0.443,14,27,0.519,28,32,0.875,124
211,BOS,2016-01-16,119,@,WAS,1,240,39,88,0.443,30,59,0.508,9,29,0.31,32,36,0.889,119,40,89,0.449,34,67,0.507,6,22,0.273,31,36,0.861,117
212,PHO,2016-01-02,119,@,SAC,0,240,43,83,0.518,33,54,0.611,10,29,0.345,23,28,0.821,119,53,87,0.609,44,64,0.688,9,23,0.391,27,34,0.794,142
213,DAL,2015-12-23,119,@,BRK,1,265,45,82,0.549,29,48,0.604,16,34,0.471,13,15,0.867,119,51,101,0.505,41,82,0.5,10,19,0.526,6,14,0.429,118
214,DET,2015-12-16,119,,BOS,1,240,38,78,0.487,27,57,0.474,11,21,0.524,32,43,0.744,119,43,89,0.483,33,64,0.516,10,25,0.4,20,24,0.833,116
215,BOS,2015-12-11,119,,GSW,0,290,49,114,0.43,37,81,0.457,12,33,0.364,9,16,0.563,119,42,107,0.393,33,76,0.434,9,31,0.29,31,39,0.795,124
216,SAS,2015-12-07,119,@,PHI,1,240,47,76,0.618,43,65,0.662,4,11,0.364,21,25,0.84,119,26,75,0.347,22,51,0.431,4,24,0.167,12,21,0.571,68
217,IND,2015-12-05,119,@,UTA,0,265,40,93,0.43,28,64,0.438,12,29,0.414,27,34,0.794,119,43,92,0.467,35,69,0.507,8,23,0.348,28,37,0.757,122
218,TOR,2015-11-11,119,@,PHI,1,240,43,89,0.483,38,71,0.535,5,18,0.278,28,31,0.903,119,40,87,0.46,28,58,0.483,12,29,0.414,11,17,0.647,103
219,GSW,2015-11-06,119,,DEN,1,240,46,93,0.495,29,56,0.518,17,37,0.459,10,18,0.556,119,39,92,0.424,31,68,0.456,8,24,0.333,18,22,0.818,104
220,HOU,2015-11-04,119,,ORL,1,265,42,88,0.477,31,54,0.574,11,34,0.324,24,34,0.706,119,46,91,0.505,39,71,0.549,7,20,0.35,15,19,0.789,114
221,GSW,2015-11-02,119,,MEM,1,240,43,84,0.512,32,59,0.542,11,25,0.44,22,30,0.733,119,26,96,0.271,23,73,0.315,3,23,0.13,14,20,0.7,69
222,MIA,2016-04-10,118,,ORL,1,240,43,77,0.558,37,57,0.649,6,20,0.3,26,30,0.867,118,37,83,0.446,30,65,0.462,7,18,0.389,15,19,0.789,96
223,ATL,2016-04-09,118,,BOS,1,240,46,88,0.523,29,55,0.527,17,33,0.515,9,11,0.818,118,40,90,0.444,29,62,0.468,11,28,0.393,16,24,0.667,107
224,HOU,2016-04-03,118,,OKC,1,240,41,102,0.402,28,60,0.467,13,42,0.31,23,26,0.885,118,38,82,0.463,31,55,0.564,7,27,0.259,27,32,0.844,110
225,DET,2016-03-23,118,,ORL,1,240,43,80,0.538,32,56,0.571,11,24,0.458,21,25,0.84,118,39,98,0.398,31,73,0.425,8,25,0.32,16,19,0.842,102
226,CHI,2016-03-17,118,,BRK,1,240,46,94,0.489,35,70,0.5,11,24,0.458,15,15,1.0,118,40,86,0.465,34,65,0.523,6,21,0.286,16,20,0.8,102
227,SAS,2016-03-17,118,,POR,1,240,45,86,0.523,37,70,0.529,8,16,0.5,20,22,0.909,118,39,89,0.438,29,67,0.433,10,22,0.455,22,30,0.733,110
228,ATL,2016-03-16,118,@,DET,1,240,39,89,0.438,27,55,0.491,12,34,0.353,28,34,0.824,118,39,84,0.464,31,59,0.525,8,25,0.32,28,39,0.718,114
229,CHO,2016-03-11,118,,DET,1,240,42,83,0.506,32,58,0.552,10,25,0.4,24,29,0.828,118,36,76,0.474,27,46,0.587,9,30,0.3,22,27,0.815,103
230,MIA,2016-03-11,118,@,CHI,1,240,47,91,0.516,37,73,0.507,10,18,0.556,14,20,0.7,118,38,81,0.469,30,60,0.5,8,21,0.381,12,15,0.8,96
231,HOU,2016-03-09,118,@,PHI,1,240,38,86,0.442,27,53,0.509,11,33,0.333,31,41,0.756,118,35,86,0.407,23,53,0.434,12,33,0.364,22,32,0.688,104
232,BRK,2016-03-05,118,@,MIN,0,240,45,92,0.489,36,66,0.545,9,26,0.346,19,26,0.731,118,52,76,0.684,42,58,0.724,10,18,0.556,18,22,0.818,132
233,OKC,2016-02-27,118,,GSW,0,265,46,96,0.479,37,70,0.529,9,26,0.346,17,26,0.654,118,45,95,0.474,31,63,0.492,14,32,0.438,17,25,0.68,121
234,GSW,2016-02-24,118,@,MIA,1,240,42,90,0.467,29,62,0.468,13,28,0.464,21,25,0.84,118,40,86,0.465,34,72,0.472,6,14,0.429,26,31,0.839,112
235,SAS,2016-02-21,118,@,PHO,1,240,43,82,0.524,33,66,0.5,10,16,0.625,22,34,0.647,118,43,93,0.462,34,69,0.493,9,24,0.375,16,22,0.727,111
236,NYK,2016-01-20,118,,UTA,1,265,47,90,0.522,40,73,0.548,7,17,0.412,17,18,0.944,118,37,86,0.43,25,59,0.424,12,27,0.444,25,31,0.806,111
237,DAL,2016-01-18,118,,BOS,1,265,40,93,0.43,24,59,0.407,16,34,0.471,22,24,0.917,118,40,94,0.426,28,64,0.438,12,30,0.4,21,26,0.808,113
238,WAS,2016-01-15,118,@,IND,1,240,51,98,0.52,40,73,0.548,11,25,0.44,5,10,0.5,118,38,80,0.475,35,63,0.556,3,17,0.176,25,32,0.781,104
239,SAC,2016-01-07,118,,LAL,1,240,47,85,0.553,41,64,0.641,6,21,0.286,18,27,0.667,118,41,76,0.539,33,52,0.635,8,24,0.333,25,29,0.862,115
240,DAL,2015-12-26,118,,CHI,1,240,40,87,0.46,24,54,0.444,16,33,0.485,22,28,0.786,118,42,78,0.538,34,57,0.596,8,21,0.381,19,26,0.731,111
241,BRK,2015-12-23,118,,DAL,0,265,51,101,0.505,41,82,0.5,10,19,0.526,6,14,0.429,118,45,82,0.549,29,48,0.604,16,34,0.471,13,15,0.867,119
242,OKC,2015-12-19,118,,LAL,1,240,46,84,0.548,37,65,0.569,9,19,0.474,17,25,0.68,118,30,86,0.349,22,58,0.379,8,28,0.286,10,17,0.588,78
243,SAS,2015-12-14,118,,UTA,1,240,42,75,0.56,33,54,0.611,9,21,0.429,25,27,0.926,118,32,79,0.405,29,68,0.426,3,11,0.273,14,17,0.824,81
244,DET,2015-12-12,118,,IND,1,240,45,90,0.5,32,61,0.525,13,29,0.448,15,19,0.789,118,41,82,0.5,38,66,0.576,3,16,0.188,11,18,0.611,96
245,MIL,2015-11-25,118,,SAC,0,240,42,88,0.477,29,57,0.509,13,31,0.419,21,27,0.778,118,44,77,0.571,34,54,0.63,10,23,0.435,31,37,0.838,129
246,GSW,2015-11-22,118,@,DEN,1,240,47,89,0.528,32,60,0.533,15,29,0.517,9,13,0.692,118,37,86,0.43,33,71,0.465,4,15,0.267,27,35,0.771,105
247,PHO,2015-11-12,118,,LAC,1,240,44,83,0.53,30,53,0.566,14,30,0.467,16,21,0.762,118,40,90,0.444,31,64,0.484,9,26,0.346,15,28,0.536,104
248,DAL,2015-11-11,118,,LAC,1,240,42,76,0.553,31,52,0.596,11,24,0.458,23,30,0.767,118,37,86,0.43,25,59,0.424,12,27,0.444,22,33,0.667,108
249,CLE,2015-11-10,118,,UTA,1,240,37,74,0.5,26,50,0.52,11,24,0.458,33,43,0.767,118,40,82,0.488,30,60,0.5,10,22,0.455,24,28,0.857,114
250,BOS,2015-11-06,118,,WAS,1,240,44,97,0.454,32,67,0.478,12,30,0.4,18,23,0.783,118,36,88,0.409,28,63,0.444,8,25,0.32,18,23,0.783,98
251,PHO,2015-11-04,118,,SAC,1,240,45,83,0.542,31,60,0.517,14,23,0.609,14,22,0.636,118,40,84,0.476,29,60,0.483,11,24,0.458,6,12,0.5,97
252,WAS,2015-10-30,118,@,MIL,1,240,35,68,0.515,23,47,0.489,12,21,0.571,36,44,0.818,118,42,82,0.512,35,58,0.603,7,24,0.292,22,28,0.786,113
253,CHO,2016-04-13,117,,ORL,1,240,47,86,0.547,36,57,0.632,11,29,0.379,12,19,0.632,117,42,91,0.462,34,64,0.531,8,27,0.296,11,18,0.611,103
254,GSW,2016-04-05,117,,MIN,0,265,49,98,0.5,37,63,0.587,12,35,0.343,7,8,0.875,117,44,86,0.512,36,69,0.522,8,17,0.471,28,36,0.778,124
255,LAC,2016-03-31,117,@,OKC,0,240,42,76,0.553,26,47,0.553,16,29,0.552,17,22,0.773,117,45,87,0.517,35,55,0.636,10,32,0.313,19,24,0.792,119
256,GSW,2016-03-27,117,,PHI,1,240,44,83,0.53,30,50,0.6,14,33,0.424,15,20,0.75,117,42,90,0.467,32,60,0.533,10,30,0.333,11,12,0.917,105
257,WAS,2016-03-21,117,@,ATL,1,240,46,91,0.505,33,66,0.5,13,25,0.52,12,20,0.6,117,38,78,0.487,25,45,0.556,13,33,0.394,13,17,0.765,102
258,POR,2016-03-18,117,@,NOP,1,240,36,78,0.462,27,51,0.529,9,27,0.333,36,40,0.9,117,40,83,0.482,30,62,0.484,10,21,0.476,22,28,0.786,112
259,WAS,2016-03-16,117,,CHI,1,240,43,88,0.489,30,67,0.448,13,21,0.619,18,24,0.75,117,35,87,0.402,29,67,0.433,6,20,0.3,20,23,0.87,96
260,TOR,2016-03-04,117,,POR,1,240,34,67,0.507,28,55,0.509,6,12,0.5,43,54,0.796,117,39,83,0.47,28,56,0.5,11,27,0.407,26,35,0.743,115
261,DEN,2016-03-02,117,,LAL,1,240,38,78,0.487,26,55,0.473,12,23,0.522,29,38,0.763,117,35,79,0.443,24,48,0.5,11,31,0.355,26,32,0.813,107
262,LAC,2016-02-26,117,@,SAC,1,240,43,89,0.483,34,60,0.567,9,29,0.31,22,26,0.846,117,34,78,0.436,22,54,0.407,12,24,0.5,27,37,0.73,107
263,UTA,2016-02-23,117,,HOU,1,265,38,74,0.514,28,50,0.56,10,24,0.417,31,38,0.816,117,36,87,0.414,25,53,0.472,11,34,0.324,31,41,0.756,114
264,MIL,2016-02-20,117,@,ATL,1,290,46,104,0.442,43,87,0.494,3,17,0.176,22,32,0.688,117,44,106,0.415,35,65,0.538,9,41,0.22,12,18,0.667,109
265,MIN,2016-02-10,117,,TOR,1,240,35,76,0.461,31,62,0.5,4,14,0.286,43,53,0.811,117,39,86,0.453,29,55,0.527,10,31,0.323,24,32,0.75,112
266,CHO,2016-02-10,117,@,IND,1,240,45,87,0.517,33,59,0.559,12,28,0.429,15,19,0.789,117,40,92,0.435,36,74,0.486,4,18,0.222,11,15,0.733,95
267,ORL,2016-02-08,117,@,ATL,1,265,46,93,0.495,37,64,0.578,9,29,0.31,16,22,0.727,117,43,92,0.467,31,63,0.492,12,29,0.414,12,20,0.6,110
268,OKC,2016-02-03,117,,ORL,1,240,44,93,0.473,35,66,0.53,9,27,0.333,20,25,0.8,117,47,95,0.495,37,72,0.514,10,23,0.435,10,12,0.833,114
269,SAC,2016-01-30,117,@,MEM,0,240,38,92,0.413,29,68,0.426,9,24,0.375,32,38,0.842,117,41,79,0.519,33,61,0.541,8,18,0.444,31,37,0.838,121
270,CLE,2016-01-30,117,,SAS,1,240,45,82,0.549,36,59,0.61,9,23,0.391,18,21,0.857,117,40,81,0.494,34,63,0.54,6,18,0.333,17,21,0.81,103
271,DEN,2016-01-28,117,@,WAS,1,240,41,81,0.506,32,63,0.508,9,18,0.5,26,33,0.788,117,39,88,0.443,28,60,0.467,11,28,0.393,24,30,0.8,113
272,SAS,2016-01-21,117,@,PHO,1,240,42,86,0.488,33,72,0.458,9,14,0.643,24,28,0.857,117,32,81,0.395,26,63,0.413,6,18,0.333,19,23,0.826,89
273,MIN,2016-01-17,117,,PHO,1,240,39,69,0.565,32,51,0.627,7,18,0.389,32,40,0.8,117,35,81,0.432,32,66,0.485,3,15,0.2,14,25,0.56,87
274,WAS,2016-01-16,117,,BOS,0,240,40,89,0.449,34,67,0.507,6,22,0.273,31,36,0.861,117,39,88,0.443,30,59,0.508,9,29,0.31,32,36,0.889,119
275,BOS,2016-01-15,117,,PHO,1,240,42,96,0.438,28,66,0.424,14,30,0.467,19,29,0.655,117,35,89,0.393,25,62,0.403,10,27,0.37,23,28,0.821,103
276,OKC,2016-01-08,117,@,LAL,1,240,45,89,0.506,40,72,0.556,5,17,0.294,22,26,0.846,117,40,84,0.476,31,58,0.534,9,26,0.346,24,25,0.96,113
277,CHI,2016-01-05,117,,MIL,1,240,46,83,0.554,41,64,0.641,5,19,0.263,20,20,1.0,117,46,102,0.451,40,86,0.465,6,16,0.375,8,14,0.571,106
278,DAL,2016-01-05,117,,SAC,1,290,45,98,0.459,33,69,0.478,12,29,0.414,15,23,0.652,117,47,99,0.475,35,67,0.522,12,32,0.375,10,14,0.714,116
279,CHO,2015-12-30,117,,LAC,0,240,38,88,0.432,29,58,0.5,9,30,0.3,32,36,0.889,117,37,71,0.521,22,41,0.537,15,30,0.5,33,41,0.805,122
280,ATL,2015-12-26,117,,NYK,1,240,47,88,0.534,39,63,0.619,8,25,0.32,15,18,0.833,117,39,81,0.481,32,57,0.561,7,24,0.292,13,17,0.765,98
281,CLE,2015-11-23,117,,ORL,1,240,43,81,0.531,25,46,0.543,18,35,0.514,13,22,0.591,117,40,81,0.494,30,59,0.508,10,22,0.455,13,21,0.619,103
282,OKC,2015-11-22,117,,DAL,1,240,47,90,0.522,38,68,0.559,9,22,0.409,14,18,0.778,117,44,83,0.53,34,64,0.531,10,19,0.526,16,28,0.571,114
283,LAC,2015-11-19,117,,GSW,0,240,44,88,0.5,31,59,0.525,13,29,0.448,16,24,0.667,117,38,73,0.521,21,43,0.488,17,30,0.567,31,36,0.861,124
284,MIN,2015-11-09,117,@,ATL,1,240,46,80,0.575,39,65,0.6,7,15,0.467,18,22,0.818,117,44,86,0.512,31,55,0.564,13,31,0.419,6,7,0.857,107
285,OKC,2015-11-01,117,,DEN,1,240,45,86,0.523,32,61,0.525,13,25,0.52,14,18,0.778,117,35,92,0.38,26,66,0.394,9,26,0.346,14,19,0.737,93
286,NYK,2015-10-31,117,@,WAS,1,240,41,86,0.477,32,67,0.478,9,19,0.474,26,32,0.813,117,38,90,0.422,32,68,0.471,6,22,0.273,28,33,0.848,110
287,HOU,2016-04-13,116,,SAC,1,240,47,97,0.485,37,62,0.597,10,35,0.286,12,19,0.632,116,32,96,0.333,21,59,0.356,11,37,0.297,6,13,0.462,81
288,NOP,2016-04-11,116,,CHI,0,240,41,80,0.513,29,54,0.537,12,26,0.462,22,28,0.786,116,44,77,0.571,34,54,0.63,10,23,0.435,23,26,0.885,121
289,POR,2016-03-31,116,,BOS,1,240,41,90,0.456,27,56,0.482,14,34,0.412,20,27,0.741,116,37,88,0.42,28,64,0.438,9,24,0.375,26,34,0.765,109
290,PHO,2016-03-28,116,@,MIN,0,240,41,84,0.488,26,51,0.51,15,33,0.455,19,23,0.826,116,41,81,0.506,34,55,0.618,7,26,0.269,32,40,0.8,121
291,DEN,2016-03-25,116,@,LAL,1,240,45,94,0.479,35,68,0.515,10,26,0.385,16,24,0.667,116,37,85,0.435,27,62,0.435,10,23,0.435,21,26,0.808,105
292,SAC,2016-03-25,116,,PHO,1,240,40,90,0.444,33,68,0.485,7,22,0.318,29,39,0.744,116,35,94,0.372,26,62,0.419,9,32,0.281,15,23,0.652,94
293,HOU,2016-03-18,116,,MIN,1,240,48,85,0.565,37,56,0.661,11,29,0.379,9,14,0.643,116,43,85,0.506,37,69,0.536,6,16,0.375,19,24,0.792,111
294,ATL,2016-03-17,116,,DEN,1,240,40,80,0.5,28,54,0.519,12,26,0.462,24,28,0.857,116,39,87,0.448,33,65,0.508,6,22,0.273,14,17,0.824,98
295,ORL,2016-03-15,116,,DEN,1,240,44,81,0.543,36,56,0.643,8,25,0.32,20,25,0.8,116,40,80,0.5,31,56,0.554,9,24,0.375,21,24,0.875,110
296,DEN,2016-03-12,116,,WAS,1,240,42,80,0.525,34,56,0.607,8,24,0.333,24,29,0.828,116,36,86,0.419,29,65,0.446,7,21,0.333,21,29,0.724,100
297,PHO,2016-03-12,116,@,GSW,0,240,45,92,0.489,34,63,0.54,11,29,0.379,15,20,0.75,116,42,84,0.5,31,51,0.608,11,33,0.333,28,33,0.848,123
298,DEN,2016-03-10,116,,PHO,1,240,44,91,0.484,31,63,0.492,13,28,0.464,15,19,0.789,116,33,89,0.371,27,61,0.443,6,28,0.214,26,33,0.788,98
299,BOS,2016-03-09,116,,MEM,1,240,41,87,0.471,26,55,0.473,15,32,0.469,19,24,0.792,116,32,84,0.381,25,58,0.431,7,26,0.269,25,31,0.806,96
300,SAS,2016-03-08,116,@,MIN,1,240,47,85,0.553,43,66,0.652,4,19,0.211,18,19,0.947,116,36,79,0.456,32,64,0.5,4,15,0.267,15,19,0.789,91
301,POR,2016-03-08,116,,WAS,1,265,41,89,0.461,31,65,0.477,10,24,0.417,24,31,0.774,116,45,99,0.455,37,79,0.468,8,20,0.4,11,23,0.478,109
302,DEN,2016-03-06,116,,DAL,1,265,44,107,0.411,35,81,0.432,9,26,0.346,19,25,0.76,116,41,93,0.441,25,52,0.481,16,41,0.39,16,20,0.8,114
303,MIL,2016-03-04,116,,MIN,1,240,43,83,0.518,29,59,0.492,14,24,0.583,16,20,0.8,116,42,87,0.483,35,65,0.538,7,22,0.318,10,14,0.714,101
304,BOS,2016-03-02,116,,POR,1,240,43,107,0.402,36,81,0.444,7,26,0.269,23,24,0.958,116,34,84,0.405,23,55,0.418,11,29,0.379,14,20,0.7,93
305,SAC,2016-02-29,116,,OKC,0,240,48,107,0.449,41,82,0.5,7,25,0.28,13,19,0.684,116,47,82,0.573,33,48,0.688,14,34,0.412,23,26,0.885,131
306,WAS,2016-02-29,116,,PHI,1,240,43,89,0.483,37,69,0.536,6,20,0.3,24,31,0.774,116,43,89,0.483,33,57,0.579,10,32,0.313,12,21,0.571,108
307,PHI,2016-02-28,116,@,ORL,0,240,41,77,0.532,36,55,0.655,5,22,0.227,29,37,0.784,116,49,86,0.57,39,70,0.557,10,16,0.625,22,25,0.88,130
308,DEN,2016-02-26,116,@,DAL,0,265,43,93,0.462,34,64,0.531,9,29,0.31,21,31,0.677,116,45,88,0.511,34,59,0.576,11,29,0.379,21,27,0.778,122
309,BRK,2016-02-25,116,@,PHO,1,240,37,75,0.493,29,57,0.509,8,18,0.444,34,42,0.81,116,42,98,0.429,33,71,0.465,9,27,0.333,13,23,0.565,106
310,OKC,2016-02-24,116,@,DAL,1,240,43,89,0.483,31,56,0.554,12,33,0.364,18,22,0.818,116,35,86,0.407,26,58,0.448,9,28,0.321,24,30,0.8,103
311,CHI,2016-02-19,116,,TOR,1,240,48,93,0.516,41,77,0.532,7,16,0.438,13,20,0.65,116,38,88,0.432,33,70,0.471,5,18,0.278,25,34,0.735,106
312,HOU,2016-02-19,116,@,PHO,1,240,37,78,0.474,30,54,0.556,7,24,0.292,35,56,0.625,116,30,82,0.366,19,47,0.404,11,35,0.314,29,35,0.829,100
313,SAC,2016-02-19,116,,DEN,1,240,41,83,0.494,31,62,0.5,10,21,0.476,24,31,0.774,116,42,90,0.467,34,66,0.515,8,24,0.333,18,26,0.692,110
314,POR,2016-02-10,116,,HOU,1,240,41,89,0.461,33,61,0.541,8,28,0.286,26,34,0.765,116,37,77,0.481,26,43,0.605,11,34,0.324,18,34,0.529,103
315,NOP,2016-02-08,116,@,MIN,1,240,47,97,0.485,37,73,0.507,10,24,0.417,12,20,0.6,116,36,81,0.444,34,69,0.493,2,12,0.167,28,35,0.8,102
316,GSW,2016-02-06,116,,OKC,1,240,48,97,0.495,41,71,0.577,7,26,0.269,13,20,0.65,116,36,85,0.424,29,63,0.46,7,22,0.318,29,37,0.784,108
317,SAS,2016-02-05,116,@,DAL,1,240,41,80,0.513,29,58,0.5,12,22,0.545,22,25,0.88,116,33,73,0.452,30,58,0.517,3,15,0.2,21,27,0.778,90
318,GSW,2016-01-31,116,@,NYK,1,240,42,73,0.575,26,44,0.591,16,29,0.552,16,23,0.696,116,33,90,0.367,27,72,0.375,6,18,0.333,23,26,0.885,95
319,OKC,2016-01-29,116,,HOU,1,240,41,86,0.477,33,67,0.493,8,19,0.421,26,30,0.867,116,36,95,0.379,27,56,0.482,9,39,0.231,27,43,0.628,108
320,BOS,2016-01-25,116,@,WAS,1,240,44,90,0.489,35,68,0.515,9,22,0.409,19,23,0.826,116,32,75,0.427,25,51,0.49,7,24,0.292,20,30,0.667,91
321,BRK,2016-01-24,116,,OKC,1,240,45,94,0.479,37,77,0.481,8,17,0.471,18,25,0.72,116,43,93,0.462,35,67,0.522,8,26,0.308,12,19,0.632,106
322,NOP,2016-01-23,116,,MIL,1,240,43,94,0.457,26,63,0.413,17,31,0.548,13,17,0.765,116,39,74,0.527,33,59,0.559,6,15,0.4,15,18,0.833,99
323,LAC,2016-01-22,116,@,NYK,1,240,43,76,0.566,30,53,0.566,13,23,0.565,17,24,0.708,116,33,85,0.388,29,67,0.433,4,18,0.222,18,20,0.9,88
324,ORL,2016-01-22,116,,CHO,0,265,45,91,0.495,34,68,0.5,11,23,0.478,15,19,0.789,116,45,101,0.446,35,74,0.473,10,27,0.37,20,22,0.909,120
325,POR,2016-01-15,116,@,BRK,1,240,47,93,0.505,32,58,0.552,15,35,0.429,7,11,0.636,116,38,85,0.447,30,66,0.455,8,19,0.421,20,28,0.714,104
326,GSW,2016-01-14,116,,LAL,1,240,43,86,0.5,30,53,0.566,13,33,0.394,17,20,0.85,116,40,90,0.444,36,67,0.537,4,23,0.174,14,24,0.583,98
327,IND,2016-01-12,116,,PHO,1,240,41,79,0.519,31,55,0.564,10,24,0.417,24,31,0.774,116,36,89,0.404,28,64,0.438,8,25,0.32,17,27,0.63,97
328,SAC,2016-01-09,116,,GSW,0,240,43,92,0.467,35,69,0.507,8,23,0.348,22,29,0.759,116,49,87,0.563,30,50,0.6,19,37,0.514,11,15,0.733,128
329,SAC,2016-01-05,116,@,DAL,0,290,47,99,0.475,35,67,0.522,12,32,0.375,10,14,0.714,116,45,98,0.459,33,69,0.478,12,29,0.414,15,23,0.652,117
330,SAC,2016-01-04,116,@,OKC,1,240,40,89,0.449,33,72,0.458,7,17,0.412,29,39,0.744,116,39,89,0.438,29,60,0.483,10,29,0.345,16,23,0.696,104
331,IND,2015-12-31,116,,MIL,0,240,41,82,0.5,28,52,0.538,13,30,0.433,21,26,0.808,116,45,77,0.584,39,63,0.619,6,14,0.429,24,35,0.686,120
332,MIA,2015-12-20,116,,POR,1,240,43,75,0.573,31,52,0.596,12,23,0.522,18,26,0.692,116,39,80,0.488,26,46,0.565,13,34,0.382,18,22,0.818,109
333,BOS,2015-12-16,116,@,DET,0,240,43,89,0.483,33,64,0.516,10,25,0.4,20,24,0.833,116,38,78,0.487,27,57,0.474,11,21,0.524,32,43,0.744,119
334,DAL,2015-12-06,116,@,WAS,1,240,38,76,0.5,22,45,0.489,16,31,0.516,24,27,0.889,116,42,89,0.472,34,62,0.548,8,27,0.296,12,21,0.571,104
335,GSW,2015-12-02,116,@,CHO,1,240,46,88,0.523,30,54,0.556,16,34,0.471,8,11,0.727,116,35,94,0.372,26,63,0.413,9,31,0.29,20,30,0.667,99
336,DET,2015-11-30,116,,HOU,1,240,45,85,0.529,37,62,0.597,8,23,0.348,18,37,0.486,116,35,88,0.398,24,61,0.393,11,27,0.407,24,28,0.857,105
337,HOU,2015-11-29,116,@,NYK,1,265,43,95,0.453,36,70,0.514,7,25,0.28,23,36,0.639,116,45,78,0.577,39,60,0.65,6,18,0.333,15,17,0.882,111
338,PHO,2015-11-27,116,,GSW,0,240,45,92,0.489,35,66,0.53,10,26,0.385,16,23,0.696,116,46,81,0.568,24,43,0.558,22,38,0.579,21,31,0.677,135
339,HOU,2015-11-27,116,,PHI,1,240,38,73,0.521,27,53,0.509,11,20,0.55,29,37,0.784,116,40,83,0.482,24,48,0.5,16,35,0.457,18,26,0.692,114
340,ATL,2015-11-27,116,@,MEM,1,240,35,75,0.467,21,36,0.583,14,39,0.359,32,36,0.889,116,35,80,0.438,23,50,0.46,12,30,0.4,19,21,0.905,101
341,PHO,2015-11-22,116,@,NOP,0,240,35,90,0.389,18,54,0.333,17,36,0.472,29,33,0.879,116,39,85,0.459,28,55,0.509,11,30,0.367,33,40,0.825,122
342,MIA,2015-11-19,116,,SAC,1,240,42,89,0.472,35,65,0.538,7,24,0.292,25,33,0.758,116,43,84,0.512,31,61,0.508,12,23,0.522,11,20,0.55,109
343,CHO,2015-11-18,116,,BRK,1,240,39,80,0.488,28,55,0.509,11,25,0.44,27,36,0.75,116,44,91,0.484,39,76,0.513,5,15,0.333,18,22,0.818,111
344,MIN,2015-11-12,116,,GSW,0,240,43,87,0.494,40,78,0.513,3,9,0.333,27,36,0.75,116,48,89,0.539,30,51,0.588,18,38,0.474,15,16,0.938,129
345,HOU,2015-11-06,116,@,SAC,1,240,40,82,0.488,25,46,0.543,15,36,0.417,21,27,0.778,116,40,93,0.43,31,65,0.477,9,28,0.321,21,29,0.724,110
346,CHI,2016-04-13,115,,PHI,1,240,39,83,0.47,24,59,0.407,15,24,0.625,22,27,0.815,115,37,81,0.457,20,46,0.435,17,35,0.486,14,18,0.778,105
347,HOU,2016-04-07,115,,PHO,0,240,42,74,0.568,28,41,0.683,14,33,0.424,17,28,0.607,115,44,94,0.468,32,63,0.508,12,31,0.387,24,29,0.828,124
348,OKC,2016-04-06,115,@,POR,0,240,43,91,0.473,34,69,0.493,9,22,0.409,20,31,0.645,115,43,84,0.512,28,51,0.549,15,33,0.455,19,24,0.792,120
349,POR,2016-04-05,115,@,SAC,1,240,40,93,0.43,28,62,0.452,12,31,0.387,23,27,0.852,115,41,78,0.526,30,56,0.536,11,22,0.5,14,21,0.667,107
350,IND,2016-04-02,115,@,PHI,1,240,44,84,0.524,36,61,0.59,8,23,0.348,19,23,0.826,115,34,83,0.41,18,46,0.391,16,37,0.432,18,26,0.692,102
351,SAC,2016-04-02,115,@,DEN,1,240,41,88,0.466,33,67,0.493,8,21,0.381,25,31,0.806,115,40,92,0.435,31,63,0.492,9,29,0.31,17,24,0.708,106
352,CHO,2016-03-26,115,@,MIL,1,240,41,74,0.554,25,45,0.556,16,29,0.552,17,21,0.81,115,37,84,0.44,33,69,0.478,4,15,0.267,13,15,0.867,91
353,TOR,2016-03-26,115,@,NOP,1,240,39,73,0.534,27,44,0.614,12,29,0.414,25,28,0.893,115,37,85,0.435,33,70,0.471,4,15,0.267,13,20,0.65,91
354,NYK,2016-03-23,115,@,CHI,1,240,45,87,0.517,31,62,0.5,14,25,0.56,11,15,0.733,115,38,82,0.463,23,50,0.46,15,32,0.469,16,21,0.762,107
355,OKC,2016-03-19,115,@,IND,1,240,42,80,0.525,32,52,0.615,10,28,0.357,21,26,0.808,115,40,83,0.482,31,61,0.508,9,22,0.409,22,30,0.733,111
356,DET,2016-03-19,115,,BRK,1,240,46,94,0.489,36,70,0.514,10,24,0.417,13,21,0.619,115,42,80,0.525,37,66,0.561,5,14,0.357,14,21,0.667,103
357,DET,2016-03-18,115,,SAC,1,240,44,92,0.478,32,66,0.485,12,26,0.462,15,18,0.833,115,40,79,0.506,36,64,0.563,4,15,0.267,24,29,0.828,108
358,GSW,2016-03-09,115,,UTA,1,240,48,84,0.571,35,54,0.648,13,30,0.433,6,10,0.6,115,32,79,0.405,24,59,0.407,8,20,0.4,22,31,0.71,94
359,NOP,2016-03-07,115,,SAC,1,240,45,94,0.479,38,69,0.551,7,25,0.28,18,26,0.692,115,41,83,0.494,34,58,0.586,7,25,0.28,23,27,0.852,112
360,POR,2016-03-04,115,@,TOR,0,240,39,83,0.47,28,56,0.5,11,27,0.407,26,35,0.743,115,34,67,0.507,28,55,0.509,6,12,0.5,43,54,0.796,117
361,PHI,2016-02-23,115,,ORL,0,240,43,79,0.544,33,58,0.569,10,21,0.476,19,26,0.731,115,41,85,0.482,34,71,0.479,7,14,0.5,35,41,0.854,124
362,LAL,2016-02-21,115,@,CHI,0,240,43,93,0.462,36,72,0.5,7,21,0.333,22,33,0.667,115,44,79,0.557,31,60,0.517,13,19,0.684,25,26,0.962,126
363,CLE,2016-02-21,115,@,OKC,1,240,41,80,0.513,31,57,0.544,10,23,0.435,23,27,0.852,115,37,90,0.411,32,69,0.464,5,21,0.238,13,19,0.684,92
364,POR,2016-02-21,115,,UTA,1,240,39,90,0.433,27,58,0.466,12,32,0.375,25,38,0.658,115,43,86,0.5,35,70,0.5,8,16,0.5,17,23,0.739,111
365,GSW,2016-02-20,115,@,LAC,1,240,42,82,0.512,31,51,0.608,11,31,0.355,20,26,0.769,115,42,94,0.447,29,58,0.5,13,36,0.361,15,18,0.833,112
366,MIA,2016-02-19,115,@,ATL,1,240,44,88,0.5,36,68,0.529,8,20,0.4,19,28,0.679,115,41,87,0.471,25,51,0.49,16,36,0.444,13,13,1.0,111
367,DEN,2016-02-05,115,,CHI,1,240,39,87,0.448,33,69,0.478,6,18,0.333,31,44,0.705,115,43,93,0.462,38,81,0.469,5,12,0.417,19,27,0.704,110
368,HOU,2016-02-02,115,,MIA,1,240,44,84,0.524,28,49,0.571,16,35,0.457,11,16,0.688,115,38,85,0.447,32,68,0.471,6,17,0.353,20,27,0.741,102
369,MIN,2016-02-02,115,@,LAL,0,240,46,80,0.575,42,63,0.667,4,17,0.235,19,25,0.76,115,40,80,0.5,28,54,0.519,12,26,0.462,27,35,0.771,119
370,CLE,2016-01-27,115,,PHO,1,240,45,81,0.556,34,53,0.642,11,28,0.393,14,16,0.875,115,33,70,0.471,25,50,0.5,8,20,0.4,19,25,0.76,93
371,HOU,2016-01-24,115,,DAL,1,240,43,89,0.483,28,45,0.622,15,44,0.341,14,21,0.667,115,36,79,0.456,21,49,0.429,15,30,0.5,17,22,0.773,104
372,CLE,2016-01-21,115,,LAC,1,240,42,83,0.506,29,55,0.527,13,28,0.464,18,24,0.75,115,36,80,0.45,30,55,0.545,6,25,0.24,24,36,0.667,102
373,NOP,2016-01-21,115,,DET,1,240,46,86,0.535,41,74,0.554,5,12,0.417,18,18,1.0,115,38,91,0.418,31,61,0.508,7,30,0.233,16,20,0.8,99
374,TOR,2016-01-20,115,,BOS,1,240,46,83,0.554,35,54,0.648,11,29,0.379,12,17,0.706,115,43,85,0.506,31,59,0.525,12,26,0.462,11,15,0.733,109
375,CHI,2016-01-14,115,@,PHI,1,265,41,88,0.466,34,71,0.479,7,17,0.412,26,31,0.839,115,42,93,0.452,30,66,0.455,12,27,0.444,15,20,0.75,111
376,POR,2016-01-10,115,,OKC,1,240,42,100,0.42,23,56,0.411,19,44,0.432,12,14,0.857,115,37,76,0.487,27,55,0.491,10,21,0.476,26,36,0.722,110
377,LAL,2016-01-07,115,@,SAC,0,240,41,76,0.539,33,52,0.635,8,24,0.333,25,29,0.862,115,47,85,0.553,41,64,0.641,6,21,0.286,18,27,0.667,118
378,WAS,2016-01-06,115,,CLE,0,240,42,76,0.553,28,52,0.538,14,24,0.583,17,27,0.63,115,48,89,0.539,36,60,0.6,12,29,0.414,13,19,0.684,121
379,DET,2016-01-04,115,,ORL,1,240,43,88,0.489,29,58,0.5,14,30,0.467,15,21,0.714,115,36,81,0.444,30,61,0.492,6,20,0.3,11,11,1.0,89
380,CHI,2016-01-03,115,@,TOR,1,240,42,82,0.512,33,61,0.541,9,21,0.429,22,25,0.88,115,42,92,0.457,29,61,0.475,13,31,0.419,16,19,0.842,113
381,DET,2015-12-31,115,,MIN,1,240,41,86,0.477,27,51,0.529,14,35,0.4,19,28,0.679,115,35,86,0.407,30,72,0.417,5,14,0.357,15,19,0.789,90
382,HOU,2015-12-29,115,,ATL,0,240,39,72,0.542,28,52,0.538,11,20,0.55,26,39,0.667,115,43,99,0.434,29,58,0.5,14,41,0.341,21,25,0.84,121
383,NOP,2015-12-23,115,,POR,1,240,41,85,0.482,28,54,0.519,13,31,0.419,20,23,0.87,115,33,95,0.347,26,67,0.388,7,28,0.25,16,24,0.667,89
384,SAS,2015-12-18,115,,LAC,1,240,43,87,0.494,33,68,0.485,10,19,0.526,19,24,0.792,115,36,72,0.5,26,48,0.542,10,24,0.417,25,40,0.625,107
385,CHI,2015-12-14,115,,PHI,1,240,43,85,0.506,35,63,0.556,8,22,0.364,21,26,0.808,115,38,92,0.413,27,61,0.443,11,31,0.355,9,13,0.692,96
386,DAL,2015-12-01,115,@,POR,1,265,43,94,0.457,34,65,0.523,9,29,0.31,20,24,0.833,115,41,100,0.41,26,60,0.433,15,40,0.375,15,17,0.882,112
387,CLE,2015-11-19,115,,MIL,1,240,40,71,0.563,29,47,0.617,11,24,0.458,24,30,0.8,115,38,73,0.521,35,65,0.538,3,8,0.375,21,26,0.808,100
388,WAS,2015-11-17,115,,MIL,1,240,37,70,0.529,25,48,0.521,12,22,0.545,29,41,0.707,115,31,72,0.431,21,51,0.412,10,21,0.476,14,24,0.583,86
389,GSW,2015-11-17,115,,TOR,1,240,43,80,0.538,32,51,0.627,11,29,0.379,18,27,0.667,115,37,79,0.468,31,61,0.508,6,18,0.333,30,39,0.769,110
390,DEN,2015-11-17,115,@,NOP,1,240,45,85,0.529,30,55,0.545,15,30,0.5,10,13,0.769,115,41,83,0.494,34,60,0.567,7,23,0.304,9,11,0.818,98
391,NOP,2015-11-06,115,,ATL,0,240,42,84,0.5,32,54,0.593,10,30,0.333,21,24,0.875,115,41,77,0.532,32,56,0.571,9,21,0.429,30,35,0.857,121
392,POR,2015-11-05,115,,MEM,1,240,44,87,0.506,29,57,0.509,15,30,0.5,12,20,0.6,115,37,77,0.481,30,57,0.526,7,20,0.35,15,21,0.714,96
393,CHI,2015-10-28,115,@,BRK,1,240,42,78,0.538,28,50,0.56,14,28,0.5,17,20,0.85,115,39,93,0.419,39,84,0.464,0,9,0.0,22,28,0.786,100
394,PHO,2016-04-13,114,,LAC,1,240,45,99,0.455,38,73,0.521,7,26,0.269,17,22,0.773,114,43,96,0.448,34,65,0.523,9,31,0.29,10,12,0.833,105
395,CHO,2016-04-11,114,@,BOS,1,240,41,81,0.506,27,49,0.551,14,32,0.438,18,22,0.818,114,34,89,0.382,26,65,0.4,8,24,0.333,24,29,0.828,100
396,SAC,2016-04-09,114,,OKC,1,240,45,94,0.479,32,62,0.516,13,32,0.406,11,20,0.55,114,39,81,0.481,26,49,0.531,13,32,0.406,21,28,0.75,112
397,LAC,2016-04-03,114,,WAS,1,240,43,85,0.506,35,66,0.53,8,19,0.421,20,33,0.606,114,43,94,0.457,32,64,0.5,11,30,0.367,12,21,0.571,109
398,ORL,2016-03-31,114,@,IND,1,240,48,90,0.533,43,74,0.581,5,16,0.313,13,18,0.722,114,36,86,0.419,29,67,0.433,7,19,0.368,15,21,0.714,94
399,LAC,2016-03-28,114,,BOS,1,240,44,84,0.524,33,59,0.559,11,25,0.44,15,18,0.833,114,31,89,0.348,24,70,0.343,7,19,0.368,21,27,0.778,90
400,GSW,2016-03-23,114,,LAC,1,240,39,87,0.448,24,53,0.453,15,34,0.441,21,28,0.75,114,36,85,0.424,28,57,0.491,8,28,0.286,18,27,0.667,98
401,DET,2016-03-16,114,,ATL,0,240,39,84,0.464,31,59,0.525,8,25,0.32,28,39,0.718,114,39,89,0.438,27,55,0.491,12,34,0.353,28,34,0.824,118
402,MIN,2016-03-16,114,@,MEM,1,240,40,71,0.563,30,50,0.6,10,21,0.476,24,31,0.774,114,44,100,0.44,40,80,0.5,4,20,0.2,16,21,0.762,108
403,PHI,2016-03-15,114,@,BRK,0,240,41,88,0.466,30,58,0.517,11,30,0.367,21,26,0.808,114,47,90,0.522,37,66,0.561,10,24,0.417,27,31,0.871,131
404,CLE,2016-03-13,114,@,LAC,1,240,41,84,0.488,23,47,0.489,18,37,0.486,14,20,0.7,114,32,79,0.405,22,47,0.468,10,32,0.313,16,19,0.842,90
405,NOP,2016-03-11,114,@,MEM,0,265,42,96,0.438,35,72,0.486,7,24,0.292,23,34,0.676,114,47,96,0.49,41,82,0.5,6,14,0.429,21,32,0.656,121
406,UTA,2016-03-11,114,,WAS,1,240,38,67,0.567,29,51,0.569,9,16,0.563,29,38,0.763,114,35,80,0.438,28,56,0.5,7,24,0.292,16,22,0.727,93
407,MIL,2016-03-09,114,,MIA,1,240,42,80,0.525,38,72,0.528,4,8,0.5,26,37,0.703,114,42,80,0.525,36,65,0.554,6,15,0.4,18,19,0.947,108
408,DAL,2016-03-06,114,@,DEN,0,265,41,93,0.441,25,52,0.481,16,41,0.39,16,20,0.8,114,44,107,0.411,35,81,0.432,9,26,0.346,19,25,0.76,116
409,DET,2016-02-28,114,,TOR,1,240,41,71,0.577,29,48,0.604,12,23,0.522,20,27,0.741,114,39,80,0.488,29,59,0.492,10,21,0.476,13,18,0.722,101
410,ORL,2016-02-25,114,,GSW,0,240,41,90,0.456,31,64,0.484,10,26,0.385,22,28,0.786,114,53,88,0.602,40,63,0.635,13,25,0.52,11,16,0.688,130
411,TOR,2016-02-24,114,,MIN,1,240,41,85,0.482,31,59,0.525,10,26,0.385,22,26,0.846,114,37,74,0.5,31,64,0.484,6,10,0.6,25,33,0.758,105
412,CLE,2016-02-24,114,,CHO,1,240,45,91,0.495,32,59,0.542,13,32,0.406,11,17,0.647,114,37,76,0.487,27,47,0.574,10,29,0.345,19,27,0.704,103
413,SAC,2016-02-23,114,@,DEN,1,240,43,83,0.518,36,66,0.545,7,17,0.412,21,28,0.75,114,41,100,0.41,31,73,0.425,10,27,0.37,18,22,0.818,110
414,HOU,2016-02-23,114,@,UTA,0,265,36,87,0.414,25,53,0.472,11,34,0.324,31,41,0.756,114,38,74,0.514,28,50,0.56,10,24,0.417,31,38,0.816,117
415,MIA,2016-02-20,114,,WAS,1,240,47,96,0.49,45,83,0.542,2,13,0.154,18,28,0.643,114,40,99,0.404,37,77,0.481,3,22,0.136,11,21,0.524,94
416,PHI,2016-02-19,114,@,NOP,0,240,40,76,0.526,28,49,0.571,12,27,0.444,22,26,0.846,114,41,81,0.506,34,64,0.531,7,17,0.412,32,40,0.8,121
417,SAC,2016-02-10,114,@,PHI,1,240,44,87,0.506,40,71,0.563,4,16,0.25,22,29,0.759,114,42,91,0.462,27,56,0.482,15,35,0.429,11,17,0.647,110
418,DAL,2016-02-06,114,@,MEM,1,265,38,88,0.432,23,50,0.46,15,38,0.395,23,33,0.697,114,44,88,0.5,35,65,0.538,9,23,0.391,13,23,0.565,110
419,IND,2016-02-03,114,@,BRK,1,240,44,88,0.5,32,64,0.5,12,24,0.5,14,17,0.824,114,36,81,0.444,29,58,0.5,7,23,0.304,21,31,0.677,100
420,ORL,2016-02-03,114,@,OKC,0,240,47,95,0.495,37,72,0.514,10,23,0.435,10,12,0.833,114,44,93,0.473,35,66,0.53,9,27,0.333,20,25,0.8,117
421,OKC,2016-02-01,114,,WAS,1,240,43,83,0.518,36,61,0.59,7,22,0.318,21,27,0.778,114,40,86,0.465,33,60,0.55,7,26,0.269,11,15,0.733,98
422,BOS,2016-01-31,114,@,ORL,0,240,39,93,0.419,23,47,0.489,16,46,0.348,20,25,0.8,114,44,82,0.537,34,58,0.586,10,24,0.417,21,35,0.6,119
423,CLE,2016-01-29,114,@,DET,1,240,39,83,0.47,30,60,0.5,9,23,0.391,27,29,0.931,114,40,84,0.476,33,61,0.541,7,23,0.304,19,26,0.731,106
424,CHI,2016-01-28,114,@,LAL,1,240,47,95,0.495,41,78,0.526,6,17,0.353,14,16,0.875,114,32,85,0.376,23,60,0.383,9,25,0.36,18,23,0.783,91
425,NOP,2016-01-28,114,,SAC,1,240,43,98,0.439,33,72,0.458,10,26,0.385,18,24,0.75,114,40,89,0.449,30,61,0.492,10,28,0.357,15,20,0.75,105
426,CLE,2016-01-25,114,,MIN,1,240,45,89,0.506,34,58,0.586,11,31,0.355,13,20,0.65,114,41,84,0.488,37,68,0.544,4,16,0.25,21,23,0.913,107
427,HOU,2016-01-20,114,,DET,0,240,43,95,0.453,31,71,0.437,12,24,0.5,16,18,0.889,114,38,80,0.475,26,50,0.52,12,30,0.4,35,59,0.593,123
428,NOP,2016-01-19,114,,MIN,1,240,42,83,0.506,32,60,0.533,10,23,0.435,20,23,0.87,114,36,76,0.474,33,62,0.532,3,14,0.214,24,31,0.774,99
429,ATL,2016-01-16,114,,BRK,1,240,44,79,0.557,36,50,0.72,8,29,0.276,18,24,0.75,114,34,78,0.436,28,58,0.483,6,20,0.3,12,19,0.632,86
430,PHI,2016-01-16,114,,POR,1,240,42,76,0.553,32,53,0.604,10,23,0.435,20,30,0.667,114,34,87,0.391,29,58,0.5,5,29,0.172,16,24,0.667,89
431,BOS,2016-01-12,114,@,NYK,0,240,42,86,0.488,33,57,0.579,9,29,0.31,21,26,0.808,114,43,81,0.531,36,61,0.59,7,20,0.35,27,30,0.9,120
432,WAS,2016-01-11,114,@,CHI,1,240,48,99,0.485,39,75,0.52,9,24,0.375,9,10,0.9,114,34,81,0.42,25,59,0.424,9,22,0.409,23,27,0.852,100
433,LAC,2016-01-10,114,,NOP,1,265,42,89,0.472,30,53,0.566,12,36,0.333,18,34,0.529,114,40,100,0.4,32,70,0.457,8,30,0.267,23,29,0.793,111
434,GSW,2015-12-31,114,@,HOU,1,240,43,84,0.512,32,61,0.525,11,23,0.478,17,27,0.63,114,36,78,0.462,24,48,0.5,12,30,0.4,26,29,0.897,110
435,DAL,2015-12-30,114,,GSW,1,240,42,82,0.512,28,55,0.509,14,27,0.519,16,20,0.8,114,33,81,0.407,26,62,0.419,7,19,0.368,18,24,0.75,91
436,SAS,2015-12-16,114,,WAS,1,240,44,83,0.53,36,61,0.59,8,22,0.364,18,23,0.783,114,35,84,0.417,32,69,0.464,3,15,0.2,22,25,0.88,95
437,DEN,2015-12-14,114,,HOU,1,240,42,82,0.512,34,57,0.596,8,25,0.32,22,25,0.88,114,41,87,0.471,23,47,0.489,18,40,0.45,8,11,0.727,108
438,WAS,2015-12-12,114,@,DAL,1,240,44,85,0.518,30,56,0.536,14,29,0.483,12,15,0.8,114,38,89,0.427,24,56,0.429,14,33,0.424,21,24,0.875,111
439,SAC,2015-12-08,114,,UTA,1,240,43,77,0.558,33,49,0.673,10,28,0.357,18,24,0.75,114,38,92,0.413,23,56,0.411,15,36,0.417,15,22,0.682,106
440,WAS,2015-12-07,114,@,MIA,1,240,46,92,0.5,37,74,0.5,9,18,0.5,13,17,0.765,114,41,69,0.594,36,53,0.679,5,16,0.313,16,22,0.727,103
441,GSW,2015-12-06,114,@,BRK,1,240,44,86,0.512,30,53,0.566,14,33,0.424,12,23,0.522,114,39,89,0.438,34,72,0.472,5,17,0.294,15,23,0.652,98
442,NOP,2015-12-04,114,,CLE,1,265,42,85,0.494,33,60,0.55,9,25,0.36,21,31,0.677,114,39,89,0.438,29,56,0.518,10,33,0.303,20,24,0.833,108
443,BOS,2015-12-03,114,@,SAC,1,240,40,84,0.476,26,51,0.51,14,33,0.424,20,24,0.833,114,29,77,0.377,22,56,0.393,7,21,0.333,32,41,0.78,97
444,ORL,2015-11-27,114,,MIL,1,240,43,82,0.524,31,55,0.564,12,27,0.444,16,22,0.727,114,31,74,0.419,23,48,0.479,8,26,0.308,20,22,0.909,90
445,PHI,2015-11-27,114,@,HOU,0,240,40,83,0.482,24,48,0.5,16,35,0.457,18,26,0.692,114,38,73,0.521,27,53,0.509,11,20,0.55,29,37,0.784,116
446,PHO,2015-11-25,114,,NOP,0,240,44,96,0.458,34,70,0.486,10,26,0.385,16,20,0.8,114,42,81,0.519,32,59,0.542,10,22,0.455,26,34,0.765,120
447,DAL,2015-11-22,114,@,OKC,0,240,44,83,0.53,34,64,0.531,10,19,0.526,16,28,0.571,114,47,90,0.522,38,68,0.559,9,22,0.409,14,18,0.778,117
448,PHO,2015-11-20,114,@,DEN,1,240,40,79,0.506,25,52,0.481,15,27,0.556,19,25,0.76,114,41,90,0.456,36,66,0.545,5,24,0.208,20,26,0.769,107
449,OKC,2015-11-16,114,@,MEM,0,240,41,81,0.506,31,57,0.544,10,24,0.417,22,31,0.71,114,37,84,0.44,25,67,0.373,12,17,0.706,36,39,0.923,122
450,MEM,2015-11-15,114,@,MIN,1,240,40,71,0.563,31,54,0.574,9,17,0.529,25,27,0.926,114,41,82,0.5,36,66,0.545,5,16,0.313,19,21,0.905,106
451,UTA,2015-11-10,114,@,CLE,0,240,40,82,0.488,30,60,0.5,10,22,0.455,24,28,0.857,114,37,74,0.5,26,50,0.52,11,24,0.458,33,43,0.767,118
452,ATL,2015-11-07,114,,WAS,1,240,43,92,0.467,30,59,0.508,13,33,0.394,15,15,1.0,114,38,78,0.487,30,54,0.556,8,24,0.333,15,17,0.882,99
453,SAS,2015-11-07,114,,CHO,1,240,45,81,0.556,36,60,0.6,9,21,0.429,15,23,0.652,114,34,73,0.466,28,54,0.519,6,19,0.316,20,31,0.645,94
454,ORL,2015-11-04,114,@,HOU,0,265,46,91,0.505,39,71,0.549,7,20,0.35,15,19,0.789,114,42,88,0.477,31,54,0.574,11,34,0.324,24,34,0.706,119
455,LAC,2015-10-31,114,,SAC,1,240,39,76,0.513,35,59,0.593,4,17,0.235,32,46,0.696,114,43,101,0.426,37,83,0.446,6,18,0.333,17,25,0.68,109
456,LAL,2015-10-30,114,@,SAC,0,240,41,89,0.461,30,55,0.545,11,34,0.324,21,27,0.778,114,52,101,0.515,46,79,0.582,6,22,0.273,22,30,0.733,132
457,WAS,2016-04-10,113,,CHO,1,240,42,80,0.525,33,59,0.559,9,21,0.429,20,28,0.714,113,28,81,0.346,16,48,0.333,12,33,0.364,30,35,0.857,98
458,CHO,2016-04-08,113,,BRK,1,240,41,83,0.494,27,46,0.587,14,37,0.378,17,20,0.85,113,39,92,0.424,29,67,0.433,10,25,0.4,11,20,0.55,99
459,MIL,2016-04-01,113,,ORL,1,240,47,86,0.547,43,69,0.623,4,17,0.235,15,25,0.6,113,46,86,0.535,38,62,0.613,8,24,0.333,10,12,0.833,110
460,OKC,2016-03-24,113,,UTA,1,240,45,83,0.542,36,61,0.59,9,22,0.409,14,22,0.636,113,35,73,0.479,30,51,0.588,5,22,0.227,16,23,0.696,91
461,MIN,2016-03-23,113,,SAC,1,240,45,80,0.563,40,67,0.597,5,13,0.385,18,32,0.563,113,42,91,0.462,34,71,0.479,8,20,0.4,12,23,0.522,104
462,CLE,2016-03-23,113,,MIL,1,240,40,83,0.482,30,49,0.612,10,34,0.294,23,27,0.852,113,43,80,0.538,36,64,0.563,7,16,0.438,11,15,0.733,104
463,MIA,2016-03-22,113,@,NOP,1,240,44,88,0.5,41,69,0.594,3,19,0.158,22,27,0.815,113,34,87,0.391,27,71,0.38,7,16,0.438,24,30,0.8,99
464,MEM,2016-03-19,113,,LAC,1,240,40,82,0.488,36,67,0.537,4,15,0.267,29,36,0.806,113,31,66,0.47,19,36,0.528,12,30,0.4,28,39,0.718,102
465,NOP,2016-03-09,113,@,CHO,0,240,40,85,0.471,30,52,0.577,10,33,0.303,23,28,0.821,113,38,82,0.463,23,47,0.489,15,35,0.429,31,38,0.816,122
466,ORL,2016-03-07,113,@,GSW,0,240,40,90,0.444,35,69,0.507,5,21,0.238,28,34,0.824,113,42,84,0.5,26,49,0.531,16,35,0.457,19,27,0.704,119
467,HOU,2016-03-06,113,@,TOR,1,240,38,78,0.487,25,49,0.51,13,29,0.448,24,37,0.649,113,37,77,0.481,25,44,0.568,12,33,0.364,21,27,0.778,107
468,WAS,2016-02-28,113,,CLE,1,240,39,79,0.494,28,48,0.583,11,31,0.355,24,34,0.706,113,32,80,0.4,23,51,0.451,9,29,0.31,26,30,0.867,99
469,LAL,2016-02-19,113,,SAS,0,240,40,81,0.494,30,59,0.508,10,22,0.455,23,26,0.885,113,48,88,0.545,42,76,0.553,6,12,0.5,17,18,0.944,119
470,ATL,2016-02-10,113,@,CHI,1,240,43,90,0.478,30,57,0.526,13,33,0.394,14,15,0.933,113,38,86,0.442,33,72,0.458,5,14,0.357,9,12,0.75,90
471,BOS,2016-01-29,113,,ORL,1,240,43,86,0.5,33,62,0.532,10,24,0.417,17,21,0.81,113,32,79,0.405,25,59,0.424,7,20,0.35,23,29,0.793,94
472,WAS,2016-01-28,113,,DEN,0,240,39,88,0.443,28,60,0.467,11,28,0.393,24,30,0.8,113,41,81,0.506,32,63,0.508,9,18,0.5,26,33,0.788,117
473,PHI,2016-01-26,113,,PHO,1,240,39,81,0.481,28,53,0.528,11,28,0.393,24,36,0.667,113,39,83,0.47,33,64,0.516,6,19,0.316,19,28,0.679,103
474,BOS,2016-01-18,113,@,DAL,0,265,40,94,0.426,28,64,0.438,12,30,0.4,21,26,0.808,113,40,93,0.43,24,59,0.407,16,34,0.471,22,24,0.917,118
475,PHI,2016-01-18,113,@,NYK,0,290,45,102,0.441,35,74,0.473,10,28,0.357,13,25,0.52,113,43,97,0.443,35,77,0.455,8,20,0.4,25,30,0.833,119
476,DET,2016-01-16,113,,GSW,1,240,47,101,0.465,39,78,0.5,8,23,0.348,11,20,0.55,113,34,94,0.362,24,69,0.348,10,25,0.4,17,23,0.739,95
477,OKC,2016-01-15,113,,MIN,1,240,47,89,0.528,42,66,0.636,5,23,0.217,14,22,0.636,113,34,85,0.4,29,73,0.397,5,12,0.417,20,23,0.87,93
478,LAL,2016-01-08,113,,OKC,0,240,40,84,0.476,31,58,0.534,9,26,0.346,24,25,0.96,113,45,89,0.506,40,72,0.556,5,17,0.294,22,26,0.846,117
479,TOR,2016-01-03,113,,CHI,0,240,42,92,0.457,29,61,0.475,13,31,0.419,16,19,0.842,113,42,82,0.512,33,61,0.541,9,21,0.429,22,25,0.88,115
480,MIL,2015-12-23,113,,PHI,1,240,51,85,0.6,46,73,0.63,5,12,0.417,6,8,0.75,113,37,81,0.457,30,61,0.492,7,20,0.35,19,29,0.655,100
481,WAS,2015-12-21,113,,SAC,1,240,42,83,0.506,28,59,0.475,14,24,0.583,15,17,0.882,113,37,91,0.407,30,69,0.435,7,22,0.318,18,22,0.818,99
482,BOS,2015-12-21,113,,MIN,1,240,46,89,0.517,34,64,0.531,12,25,0.48,9,16,0.563,113,36,79,0.456,34,66,0.515,2,13,0.154,25,32,0.781,99
483,ORL,2015-12-16,113,,CHO,1,240,43,77,0.558,29,53,0.547,14,24,0.583,13,15,0.867,113,36,79,0.456,22,45,0.489,14,34,0.412,12,15,0.8,98
484,LAL,2015-12-15,113,,MIL,1,240,41,89,0.461,31,62,0.5,10,27,0.37,21,25,0.84,113,40,85,0.471,36,72,0.5,4,13,0.308,11,20,0.55,95
485,SAC,2015-12-05,113,@,HOU,0,240,46,98,0.469,36,72,0.5,10,26,0.385,11,13,0.846,113,36,78,0.462,20,44,0.455,16,34,0.471,32,43,0.744,120
486,MEM,2015-12-01,113,@,NOP,1,240,43,90,0.478,41,80,0.513,2,10,0.2,25,26,0.962,113,35,81,0.432,26,54,0.481,9,27,0.333,25,33,0.758,104
487,CHO,2015-11-20,113,,PHI,1,240,40,81,0.494,28,56,0.5,12,25,0.48,21,22,0.955,113,32,79,0.405,24,53,0.453,8,26,0.308,16,22,0.727,88
488,SAS,2015-11-11,113,@,POR,1,240,46,82,0.561,39,67,0.582,7,15,0.467,14,18,0.778,113,39,88,0.443,30,66,0.455,9,22,0.409,14,23,0.609,101
489,TOR,2015-10-30,113,@,BOS,1,240,36,82,0.439,25,56,0.446,11,26,0.423,30,35,0.857,113,32,85,0.376,25,59,0.424,7,26,0.269,32,41,0.78,103
490,MIL,2015-10-30,113,,WAS,0,240,42,82,0.512,35,58,0.603,7,24,0.292,22,28,0.786,113,35,68,0.515,23,47,0.489,12,21,0.571,36,44,0.818,118
491,DET,2016-04-13,112,@,CLE,1,265,37,85,0.435,21,52,0.404,16,33,0.485,22,28,0.786,112,46,97,0.474,39,79,0.494,7,18,0.389,11,15,0.733,110
492,OKC,2016-04-11,112,,LAL,1,240,42,96,0.438,30,59,0.508,12,37,0.324,16,27,0.593,112,23,81,0.284,16,50,0.32,7,31,0.226,26,30,0.867,79
493,OKC,2016-04-09,112,@,SAC,0,240,39,81,0.481,26,49,0.531,13,32,0.406,21,28,0.75,112,45,94,0.479,32,62,0.516,13,32,0.406,11,20,0.55,114
494,ORL,2016-04-08,112,,MIA,1,240,43,82,0.524,38,71,0.535,5,11,0.455,21,28,0.75,112,45,100,0.45,37,78,0.474,8,22,0.364,11,21,0.524,109
495,DET,2016-04-08,112,,WAS,1,240,36,77,0.468,22,45,0.489,14,32,0.438,26,29,0.897,112,38,86,0.442,32,67,0.478,6,19,0.316,17,23,0.739,99
496,GSW,2016-04-07,112,,SAS,1,240,45,83,0.542,33,58,0.569,12,25,0.48,10,11,0.909,112,39,80,0.488,32,64,0.5,7,16,0.438,16,23,0.696,101
497,CLE,2016-04-03,112,,CHO,1,240,45,83,0.542,29,54,0.537,16,29,0.552,6,13,0.462,112,34,76,0.447,25,50,0.5,9,26,0.346,26,27,0.963,103
498,MIA,2016-04-01,112,@,SAC,1,240,42,82,0.512,30,60,0.5,12,22,0.545,16,17,0.941,112,38,87,0.437,31,66,0.47,7,21,0.333,23,29,0.793,106
499,ATL,2016-03-26,112,@,DET,1,240,43,95,0.453,30,61,0.492,13,34,0.382,13,14,0.929,112,34,88,0.386,27,59,0.458,7,29,0.241,20,28,0.714,95
500,HOU,2016-03-25,112,,TOR,1,240,42,81,0.519,30,59,0.508,12,22,0.545,16,35,0.457,112,39,94,0.415,26,63,0.413,13,31,0.419,18,26,0.692,109
501,DET,2016-03-25,112,,CHO,1,240,42,91,0.462,34,61,0.557,8,30,0.267,20,26,0.769,112,37,93,0.398,23,63,0.365,14,30,0.467,17,22,0.773,105
502,SAS,2016-03-23,112,,MIA,1,240,42,81,0.519,34,67,0.507,8,14,0.571,20,24,0.833,112,37,77,0.481,30,63,0.476,7,14,0.5,7,12,0.583,88
503,DAL,2016-03-18,112,,GSW,0,240,41,93,0.441,32,64,0.5,9,29,0.31,21,22,0.955,112,48,95,0.505,26,57,0.456,22,38,0.579,12,14,0.857,130
504,NOP,2016-03-18,112,,POR,0,240,40,83,0.482,30,62,0.484,10,21,0.476,22,28,0.786,112,36,78,0.462,27,51,0.529,9,27,0.333,36,40,0.9,117
505,TOR,2016-03-12,112,,MIA,1,265,37,84,0.44,31,66,0.47,6,18,0.333,32,38,0.842,112,37,98,0.378,28,73,0.384,9,25,0.36,21,26,0.808,104
506,IND,2016-03-12,112,@,DAL,1,240,38,81,0.469,29,53,0.547,9,28,0.321,27,29,0.931,112,41,85,0.482,33,63,0.524,8,22,0.364,15,18,0.833,105
507,POR,2016-03-11,112,@,GSW,0,240,37,86,0.43,18,50,0.36,19,36,0.528,19,23,0.826,112,40,89,0.449,22,49,0.449,18,40,0.45,30,39,0.769,128
508,SAC,2016-03-07,112,@,NOP,0,240,41,83,0.494,34,58,0.586,7,25,0.28,23,27,0.852,112,45,94,0.479,38,69,0.551,7,25,0.28,18,26,0.692,115
509,LAL,2016-03-06,112,,GSW,1,240,41,87,0.471,32,62,0.516,9,25,0.36,21,22,0.955,112,37,92,0.402,33,62,0.532,4,30,0.133,17,21,0.81,95
510,MIA,2016-03-04,112,@,PHI,1,240,39,88,0.443,34,72,0.472,5,16,0.313,29,36,0.806,112,36,95,0.379,27,64,0.422,9,31,0.29,21,27,0.778,102
511,MIN,2016-02-27,112,@,NOP,1,240,42,84,0.5,37,69,0.536,5,15,0.333,23,30,0.767,112,39,84,0.464,29,57,0.509,10,27,0.37,22,26,0.846,110
512,MEM,2016-02-26,112,@,LAL,1,240,43,85,0.506,30,53,0.566,13,32,0.406,13,15,0.867,112,32,78,0.41,27,55,0.491,5,23,0.217,26,39,0.667,95
513,BOS,2016-02-25,112,,MIL,1,240,41,84,0.488,36,61,0.59,5,23,0.217,25,33,0.758,112,42,87,0.483,38,72,0.528,4,15,0.267,19,25,0.76,107
514,MIA,2016-02-24,112,,GSW,0,240,40,86,0.465,34,72,0.472,6,14,0.429,26,31,0.839,112,42,90,0.467,29,62,0.468,13,28,0.464,21,25,0.84,118
515,POR,2016-02-23,112,,BRK,1,240,40,80,0.5,30,57,0.526,10,23,0.435,22,25,0.88,112,43,90,0.478,40,78,0.513,3,12,0.25,15,19,0.789,104
516,LAC,2016-02-20,112,,GSW,0,240,42,94,0.447,29,58,0.5,13,36,0.361,15,18,0.833,112,42,82,0.512,31,51,0.608,11,31,0.355,20,26,0.769,115
517,TOR,2016-02-10,112,@,MIN,0,240,39,86,0.453,29,55,0.527,10,31,0.323,24,32,0.75,112,35,76,0.461,31,62,0.5,4,14,0.286,43,53,0.811,117
518,GSW,2016-02-10,112,@,PHO,1,240,37,89,0.416,23,49,0.469,14,40,0.35,24,29,0.828,112,41,93,0.441,35,72,0.486,6,21,0.286,16,22,0.727,104
519,MIL,2016-02-09,112,,BOS,1,240,45,88,0.511,38,69,0.551,7,19,0.368,15,23,0.652,112,39,84,0.464,29,55,0.527,10,29,0.345,23,24,0.958,111
520,POR,2016-02-08,112,@,MEM,1,265,44,89,0.494,34,60,0.567,10,29,0.345,14,20,0.7,112,43,86,0.5,36,67,0.537,7,19,0.368,13,19,0.684,106
521,MIN,2016-02-06,112,,CHI,1,240,45,87,0.517,44,75,0.587,1,12,0.083,21,22,0.955,112,40,85,0.471,32,65,0.492,8,20,0.4,17,19,0.895,105
522,IND,2016-02-06,112,,DET,1,240,41,76,0.539,35,65,0.538,6,11,0.545,24,29,0.828,112,38,79,0.481,26,46,0.565,12,33,0.364,16,31,0.516,104
523,DEN,2016-02-01,112,,TOR,1,240,45,83,0.542,35,61,0.574,10,22,0.455,12,15,0.8,112,29,78,0.372,21,53,0.396,8,25,0.32,27,39,0.692,93
524,ATL,2016-02-01,112,,DAL,1,240,42,80,0.525,28,45,0.622,14,35,0.4,14,19,0.737,112,31,85,0.365,24,59,0.407,7,26,0.269,28,38,0.737,97
525,POR,2016-01-26,112,,SAC,1,240,44,90,0.489,35,60,0.583,9,30,0.3,15,19,0.789,112,36,86,0.419,29,67,0.433,7,19,0.368,18,32,0.563,97
526,HOU,2016-01-25,112,@,NOP,1,240,38,80,0.475,19,40,0.475,19,40,0.475,17,21,0.81,112,42,91,0.462,29,62,0.468,13,29,0.448,14,25,0.56,111
527,TOR,2016-01-24,112,,LAC,1,240,41,83,0.494,29,61,0.475,12,22,0.545,18,26,0.692,112,34,76,0.447,26,50,0.52,8,26,0.308,18,30,0.6,94
528,BOS,2016-01-24,112,@,PHI,1,240,43,97,0.443,32,72,0.444,11,25,0.44,15,19,0.789,112,35,89,0.393,27,63,0.429,8,26,0.308,14,20,0.7,92
529,SAC,2016-01-20,112,@,LAL,1,240,43,89,0.483,37,69,0.536,6,20,0.3,20,28,0.714,112,32,90,0.356,28,65,0.431,4,25,0.16,25,31,0.806,93
530,TOR,2016-01-18,112,,BRK,1,240,43,85,0.506,30,61,0.492,13,24,0.542,13,18,0.722,112,39,76,0.513,34,62,0.548,5,14,0.357,17,19,0.895,100
531,HOU,2016-01-17,112,@,LAL,1,240,44,91,0.484,38,70,0.543,6,21,0.286,18,24,0.75,112,37,82,0.451,31,63,0.492,6,19,0.316,15,19,0.789,95
532,SAS,2016-01-17,112,,DAL,1,240,42,90,0.467,37,70,0.529,5,20,0.25,23,28,0.821,112,29,81,0.358,23,58,0.397,6,23,0.261,19,25,0.76,83
533,DEN,2016-01-13,112,,GSW,1,240,37,87,0.425,32,65,0.492,5,22,0.227,33,37,0.892,112,42,88,0.477,32,62,0.516,10,26,0.385,16,20,0.8,110
534,OKC,2016-01-06,112,,MEM,1,240,38,83,0.458,30,66,0.455,8,17,0.471,28,33,0.848,112,35,90,0.389,28,69,0.406,7,21,0.333,17,24,0.708,94
535,POR,2016-01-03,112,@,DEN,1,240,40,78,0.513,30,55,0.545,10,23,0.435,22,32,0.688,112,34,80,0.425,27,58,0.466,7,22,0.318,31,48,0.646,106
536,LAL,2015-12-30,112,@,BOS,1,240,43,94,0.457,34,75,0.453,9,19,0.474,17,23,0.739,112,38,88,0.432,31,61,0.508,7,27,0.259,21,25,0.84,104
537,SAS,2015-12-30,112,,PHO,1,240,43,76,0.566,37,62,0.597,6,14,0.429,20,33,0.606,112,32,81,0.395,27,63,0.429,5,18,0.278,10,18,0.556,79
538,MEM,2015-12-27,112,,LAL,1,240,45,80,0.563,39,64,0.609,6,16,0.375,16,22,0.727,112,32,84,0.381,24,55,0.436,8,29,0.276,24,32,0.75,96
539,DEN,2015-12-27,112,@,OKC,0,240,46,94,0.489,37,69,0.536,9,25,0.36,11,15,0.733,112,48,83,0.578,40,68,0.588,8,15,0.533,18,21,0.857,122
540,MIL,2015-12-18,112,@,GSW,0,240,42,91,0.462,38,73,0.521,4,18,0.222,24,28,0.857,112,42,87,0.483,33,61,0.541,9,26,0.346,28,37,0.757,121
541,DEN,2015-12-15,112,@,MIN,1,240,41,73,0.562,31,55,0.564,10,18,0.556,20,27,0.741,112,36,77,0.468,32,67,0.478,4,10,0.4,24,31,0.774,100
542,MEM,2015-12-14,112,,WAS,1,240,44,78,0.564,34,63,0.54,10,15,0.667,14,15,0.933,112,37,86,0.43,28,62,0.452,9,24,0.375,12,20,0.6,95
543,NYK,2015-12-12,112,@,POR,1,240,39,75,0.52,30,54,0.556,9,21,0.429,25,28,0.893,112,41,89,0.461,35,68,0.515,6,21,0.286,22,29,0.759,110
544,GSW,2015-12-05,112,@,TOR,1,240,35,73,0.479,19,43,0.442,16,30,0.533,26,36,0.722,112,40,91,0.44,32,71,0.451,8,20,0.4,21,26,0.808,109
545,POR,2015-12-01,112,,DAL,0,265,41,100,0.41,26,60,0.433,15,40,0.375,15,17,0.882,112,43,94,0.457,34,65,0.523,9,29,0.31,20,24,0.833,115
546,SAC,2015-11-30,112,,DAL,1,240,36,79,0.456,27,48,0.563,9,31,0.29,31,44,0.705,112,36,84,0.429,27,47,0.574,9,37,0.243,17,22,0.773,98
547,IND,2015-11-18,112,@,PHI,1,240,42,92,0.457,30,65,0.462,12,27,0.444,16,20,0.8,112,35,76,0.461,30,51,0.588,5,25,0.2,10,16,0.625,85
548,GSW,2015-11-04,112,,LAC,1,240,39,85,0.459,29,59,0.492,10,26,0.385,24,31,0.774,112,43,88,0.489,35,66,0.53,8,22,0.364,14,22,0.636,108
549,GSW,2015-10-30,112,@,HOU,1,240,43,93,0.462,34,67,0.507,9,26,0.346,17,25,0.68,112,30,82,0.366,25,59,0.424,5,23,0.217,27,36,0.75,92
550,ATL,2015-10-29,112,@,NYK,1,240,42,83,0.506,32,59,0.542,10,24,0.417,18,26,0.692,112,38,93,0.409,32,64,0.5,6,29,0.207,19,21,0.905,101
551,MEM,2015-10-29,112,@,IND,1,240,41,82,0.5,34,66,0.515,7,16,0.438,23,29,0.793,112,37,78,0.474,25,48,0.521,12,30,0.4,17,24,0.708,103
552,OKC,2015-10-28,112,,SAS,1,240,42,86,0.488,35,67,0.522,7,19,0.368,21,22,0.955,112,45,93,0.484,40,78,0.513,5,15,0.333,11,13,0.846,106
553,MIN,2015-10-28,112,@,LAL,1,240,38,83,0.458,33,63,0.524,5,20,0.25,31,37,0.838,112,35,90,0.389,26,56,0.464,9,34,0.265,32,35,0.914,111
554,BOS,2015-10-28,112,,PHI,1,240,39,85,0.459,31,61,0.508,8,24,0.333,26,27,0.963,112,34,83,0.41,27,61,0.443,7,22,0.318,20,23,0.87,95
555,POR,2015-10-28,112,,NOP,1,240,44,88,0.5,32,56,0.571,12,32,0.375,12,14,0.857,112,36,91,0.396,25,58,0.431,11,33,0.333,11,18,0.611,94
556,BRK,2016-04-11,111,,WAS,0,240,44,98,0.449,34,67,0.507,10,31,0.323,13,21,0.619,111,46,89,0.517,37,64,0.578,9,25,0.36,19,24,0.792,120
557,TOR,2016-04-08,111,,IND,1,240,37,68,0.544,27,46,0.587,10,22,0.455,27,38,0.711,111,37,83,0.446,29,56,0.518,8,27,0.296,16,20,0.8,98
558,CHO,2016-04-06,111,@,NYK,1,240,42,90,0.467,30,64,0.469,12,26,0.462,15,17,0.882,111,37,78,0.474,27,52,0.519,10,26,0.385,13,15,0.867,97
559,POR,2016-04-03,111,@,GSW,0,240,38,85,0.447,29,61,0.475,9,24,0.375,26,33,0.788,111,50,88,0.568,32,58,0.552,18,30,0.6,18,22,0.818,136
560,WAS,2016-03-30,111,@,SAC,0,240,43,89,0.483,34,63,0.54,9,26,0.346,16,20,0.8,111,47,84,0.56,39,66,0.591,8,18,0.444,18,25,0.72,120
561,DAL,2016-03-27,111,@,SAC,0,240,42,88,0.477,34,64,0.531,8,24,0.333,19,24,0.792,111,51,82,0.622,42,62,0.677,9,20,0.45,22,30,0.733,133
562,OKC,2016-03-26,111,,SAS,1,240,44,85,0.518,37,65,0.569,7,20,0.35,16,18,0.889,111,37,86,0.43,33,71,0.465,4,15,0.267,14,17,0.824,92
563,ORL,2016-03-26,111,,CHI,1,240,48,89,0.539,41,70,0.586,7,19,0.368,8,12,0.667,111,36,88,0.409,30,64,0.469,6,24,0.25,11,17,0.647,89
564,OKC,2016-03-22,111,,HOU,1,240,41,91,0.451,33,56,0.589,8,35,0.229,21,29,0.724,111,40,92,0.435,27,55,0.491,13,37,0.351,14,17,0.824,107
565,IND,2016-03-19,111,,OKC,0,240,40,83,0.482,31,61,0.508,9,22,0.409,22,30,0.733,111,42,80,0.525,32,52,0.615,10,28,0.357,21,26,0.808,115
566,MIN,2016-03-18,111,@,HOU,0,240,43,85,0.506,37,69,0.536,6,16,0.375,19,24,0.792,111,48,85,0.565,37,56,0.661,11,29,0.379,9,14,0.643,116
567,OKC,2016-03-18,111,@,PHI,1,240,45,89,0.506,38,67,0.567,7,22,0.318,14,18,0.778,111,35,89,0.393,25,60,0.417,10,29,0.345,17,27,0.63,97
568,PHI,2016-03-12,111,,DET,0,240,39,84,0.464,29,59,0.492,10,25,0.4,23,27,0.852,111,49,91,0.538,40,73,0.548,9,18,0.5,18,22,0.818,125
569,SAC,2016-03-09,111,,CLE,0,240,40,84,0.476,32,62,0.516,8,22,0.364,23,32,0.719,111,39,90,0.433,26,46,0.565,13,44,0.295,29,35,0.829,120
570,CHI,2016-03-01,111,@,MIA,0,240,41,90,0.456,30,67,0.448,11,23,0.478,18,26,0.692,111,52,77,0.675,46,65,0.708,6,12,0.5,19,25,0.76,129
571,POR,2016-02-28,111,@,IND,1,240,41,81,0.506,27,57,0.474,14,24,0.583,15,21,0.714,111,40,93,0.43,37,79,0.468,3,14,0.214,19,25,0.76,102
572,PHO,2016-02-27,111,,MEM,1,240,37,80,0.463,25,48,0.521,12,32,0.375,25,35,0.714,111,32,80,0.4,26,60,0.433,6,20,0.3,36,42,0.857,106
573,DET,2016-02-24,111,,PHI,1,240,39,83,0.47,28,55,0.509,11,28,0.393,22,34,0.647,111,33,83,0.398,26,60,0.433,7,23,0.304,18,26,0.692,91
574,PHO,2016-02-21,111,,SAS,0,240,43,93,0.462,34,69,0.493,9,24,0.375,16,22,0.727,111,43,82,0.524,33,66,0.5,10,16,0.625,22,34,0.647,118
575,UTA,2016-02-21,111,@,POR,0,240,43,86,0.5,35,70,0.5,8,16,0.5,17,23,0.739,111,39,90,0.433,27,58,0.466,12,32,0.375,25,38,0.658,115
576,NOP,2016-02-21,111,@,DET,1,240,41,86,0.477,37,66,0.561,4,20,0.2,25,29,0.862,111,37,89,0.416,25,56,0.446,12,33,0.364,20,32,0.625,106
577,ATL,2016-02-19,111,,MIA,0,240,41,87,0.471,25,51,0.49,16,36,0.444,13,13,1.0,111,44,88,0.5,36,68,0.529,8,20,0.4,19,28,0.679,115
578,UTA,2016-02-19,111,,BOS,1,240,37,68,0.544,27,45,0.6,10,23,0.435,27,44,0.614,111,30,81,0.37,23,56,0.411,7,25,0.28,26,36,0.722,93
579,LAL,2016-02-10,111,@,CLE,0,240,38,86,0.442,25,58,0.431,13,28,0.464,22,27,0.815,111,48,94,0.511,35,63,0.556,13,31,0.419,11,18,0.611,120
580,BOS,2016-02-09,111,@,MIL,0,240,39,84,0.464,29,55,0.527,10,29,0.345,23,24,0.958,111,45,88,0.511,38,69,0.551,7,19,0.368,15,23,0.652,112
581,WAS,2016-02-09,111,@,NYK,1,240,39,78,0.5,23,52,0.442,16,26,0.615,17,25,0.68,111,44,83,0.53,36,57,0.632,8,26,0.308,12,14,0.857,108
582,DET,2016-02-04,111,,NYK,1,240,40,79,0.506,31,62,0.5,9,17,0.529,22,33,0.667,111,36,84,0.429,30,62,0.484,6,22,0.273,27,34,0.794,105
583,HOU,2016-02-04,111,@,PHO,1,240,37,86,0.43,22,44,0.5,15,42,0.357,22,32,0.688,111,32,83,0.386,21,54,0.389,11,29,0.379,30,32,0.938,105
584,SAC,2016-02-01,111,,MIL,1,240,39,86,0.453,30,60,0.5,9,26,0.346,24,30,0.8,111,42,84,0.5,34,64,0.531,8,20,0.4,12,17,0.706,104
585,CLE,2016-02-01,111,@,IND,1,265,44,88,0.5,37,66,0.561,7,22,0.318,16,23,0.696,111,43,101,0.426,35,74,0.473,8,27,0.296,12,14,0.857,106
586,TOR,2016-01-30,111,,DET,1,240,36,78,0.462,32,64,0.5,4,14,0.286,35,47,0.745,111,39,87,0.448,30,58,0.517,9,29,0.31,20,34,0.588,107
587,IND,2016-01-28,111,,ATL,1,240,38,78,0.487,29,63,0.46,9,15,0.6,26,30,0.867,111,33,83,0.398,26,55,0.473,7,28,0.25,19,21,0.905,92
588,BOS,2016-01-27,111,,DEN,1,240,41,96,0.427,32,68,0.471,9,28,0.321,20,24,0.833,111,36,84,0.429,29,63,0.46,7,21,0.333,24,32,0.75,103
589,NOP,2016-01-25,111,,HOU,0,240,42,91,0.462,29,62,0.468,13,29,0.448,14,25,0.56,111,38,80,0.475,19,40,0.475,19,40,0.475,17,21,0.81,112
590,UTA,2016-01-20,111,@,NYK,0,265,37,86,0.43,25,59,0.424,12,27,0.444,25,31,0.806,111,47,90,0.522,40,73,0.548,7,17,0.412,17,18,0.944,118
591,CHI,2016-01-18,111,@,DET,1,240,44,84,0.524,35,63,0.556,9,21,0.429,14,20,0.7,111,42,95,0.442,37,69,0.536,5,26,0.192,12,20,0.6,101
592,PHI,2016-01-14,111,,CHI,0,265,42,93,0.452,30,66,0.455,12,27,0.444,15,20,0.75,111,41,88,0.466,34,71,0.479,7,17,0.412,26,31,0.839,115
593,GSW,2016-01-11,111,,MIA,1,240,41,86,0.477,34,63,0.54,7,23,0.304,22,30,0.733,111,41,91,0.451,34,72,0.472,7,19,0.368,14,16,0.875,103
594,NOP,2016-01-10,111,@,LAC,0,265,40,100,0.4,32,70,0.457,8,30,0.267,23,29,0.793,111,42,89,0.472,30,53,0.566,12,36,0.333,18,34,0.529,114
595,PHO,2016-01-06,111,,CHO,1,240,41,84,0.488,22,51,0.431,19,33,0.576,10,13,0.769,111,38,87,0.437,27,59,0.458,11,28,0.393,15,22,0.682,102
596,GSW,2016-01-04,111,,CHO,1,240,45,87,0.517,30,53,0.566,15,34,0.441,6,6,1.0,111,38,86,0.442,31,65,0.477,7,21,0.333,18,19,0.947,101
597,NYK,2016-01-03,111,,ATL,1,240,44,88,0.5,33,62,0.532,11,26,0.423,12,14,0.857,111,37,84,0.44,29,58,0.5,8,26,0.308,15,20,0.75,97
598,GSW,2016-01-02,111,,DEN,1,265,43,86,0.5,33,58,0.569,10,28,0.357,15,23,0.652,111,44,105,0.419,39,75,0.52,5,30,0.167,15,23,0.652,108
599,BRK,2015-12-28,111,@,MIA,1,240,36,82,0.439,24,59,0.407,12,23,0.522,27,36,0.75,111,36,78,0.462,26,54,0.481,10,24,0.417,23,30,0.767,105
600,PHI,2015-12-26,111,@,PHO,1,240,38,79,0.481,26,52,0.5,12,27,0.444,23,27,0.852,111,34,88,0.386,24,61,0.393,10,27,0.37,26,34,0.765,104
601,WAS,2015-12-26,111,@,BRK,1,240,42,84,0.5,30,57,0.526,12,27,0.444,15,22,0.682,111,43,89,0.483,38,72,0.528,5,17,0.294,5,16,0.313,96
602,CHI,2015-12-26,111,@,DAL,0,240,42,78,0.538,34,57,0.596,8,21,0.381,19,26,0.731,111,40,87,0.46,24,54,0.444,16,33,0.485,22,28,0.786,118
603,TOR,2015-12-26,111,@,MIL,1,240,42,81,0.519,29,52,0.558,13,29,0.448,14,19,0.737,111,34,81,0.42,28,67,0.418,6,14,0.429,16,18,0.889,90
604,LAL,2015-12-22,111,@,DEN,1,240,40,84,0.476,33,58,0.569,7,26,0.269,24,32,0.75,111,41,90,0.456,32,65,0.492,9,25,0.36,16,19,0.842,107
605,DAL,2015-12-12,111,,WAS,0,240,38,89,0.427,24,56,0.429,14,33,0.424,21,24,0.875,111,44,85,0.518,30,56,0.536,14,29,0.483,12,15,0.8,114
606,DEN,2015-12-11,111,,MIN,1,265,38,86,0.442,27,58,0.466,11,28,0.393,24,33,0.727,111,38,87,0.437,31,68,0.456,7,19,0.368,25,29,0.862,108
607,CLE,2015-12-11,111,@,ORL,1,240,41,72,0.569,30,51,0.588,11,21,0.524,18,27,0.667,111,28,72,0.389,22,50,0.44,6,22,0.273,14,20,0.7,76
608,BOS,2015-12-07,111,@,NOP,1,240,40,81,0.494,28,53,0.528,12,28,0.429,19,24,0.792,111,37,90,0.411,33,77,0.429,4,13,0.308,15,18,0.833,93
609,DET,2015-12-06,111,,LAL,1,240,41,93,0.441,32,69,0.464,9,24,0.375,20,26,0.769,111,32,80,0.4,27,62,0.435,5,18,0.278,22,29,0.759,91
610,IND,2015-12-03,111,@,POR,0,240,38,88,0.432,25,58,0.431,13,30,0.433,22,24,0.917,111,44,85,0.518,26,49,0.531,18,36,0.5,17,20,0.85,123
611,NYK,2015-11-29,111,,HOU,0,265,45,78,0.577,39,60,0.65,6,18,0.333,15,17,0.882,111,43,95,0.453,36,70,0.514,7,25,0.28,23,36,0.639,116
612,LAC,2015-11-27,111,,NOP,1,240,40,83,0.482,33,64,0.516,7,19,0.368,24,30,0.8,111,34,94,0.362,29,74,0.392,5,20,0.25,17,23,0.739,90
613,BOS,2015-11-27,111,,WAS,1,240,42,97,0.433,30,64,0.469,12,33,0.364,15,19,0.789,111,27,84,0.321,22,66,0.333,5,18,0.278,19,22,0.864,78
614,GSW,2015-11-24,111,,LAL,1,240,45,92,0.489,33,57,0.579,12,35,0.343,9,15,0.6,111,31,83,0.373,28,62,0.452,3,21,0.143,12,16,0.75,77
615,LAC,2015-11-24,111,@,DEN,1,240,37,79,0.468,29,59,0.492,8,20,0.4,29,47,0.617,111,31,78,0.397,23,53,0.434,8,25,0.32,24,29,0.828,94
616,OKC,2015-11-23,111,@,UTA,1,240,42,77,0.545,31,50,0.62,11,27,0.407,16,18,0.889,111,28,73,0.384,23,54,0.426,5,19,0.263,28,40,0.7,89
617,BRK,2015-11-22,111,,BOS,1,240,40,79,0.506,35,64,0.547,5,15,0.333,26,33,0.788,111,35,82,0.427,21,45,0.467,14,37,0.378,17,21,0.81,101
618,BRK,2015-11-18,111,@,CHO,0,240,44,91,0.484,39,76,0.513,5,15,0.333,18,22,0.818,111,39,80,0.488,28,55,0.509,11,25,0.44,27,36,0.75,116
619,BOS,2015-11-16,111,@,HOU,1,240,44,93,0.473,33,57,0.579,11,36,0.306,12,17,0.706,111,36,85,0.424,25,53,0.472,11,32,0.344,12,23,0.522,95
620,SAC,2015-11-13,111,,BRK,1,240,40,94,0.426,29,67,0.433,11,27,0.407,20,26,0.769,111,42,89,0.472,34,68,0.5,8,21,0.381,17,21,0.81,109
621,NYK,2015-11-10,111,@,TOR,1,240,42,95,0.442,31,72,0.431,11,23,0.478,16,18,0.889,111,37,84,0.44,33,67,0.493,4,17,0.235,31,39,0.795,109
622,CHI,2015-11-09,111,@,PHI,1,240,41,96,0.427,31,71,0.437,10,25,0.4,19,23,0.826,111,35,100,0.35,30,75,0.4,5,25,0.2,13,23,0.565,88
623,DAL,2015-10-28,111,@,PHO,1,240,40,85,0.471,30,64,0.469,10,21,0.476,21,31,0.677,111,34,87,0.391,28,63,0.444,6,24,0.25,21,33,0.636,95
624,LAC,2015-10-28,111,@,SAC,1,240,42,80,0.525,36,61,0.59,6,19,0.316,21,31,0.677,111,41,94,0.436,30,70,0.429,11,24,0.458,11,18,0.611,104
625,LAL,2015-10-28,111,,MIN,0,240,35,90,0.389,26,56,0.464,9,34,0.265,32,35,0.914,111,38,83,0.458,33,63,0.524,5,20,0.25,31,37,0.838,112
626,GSW,2015-10-27,111,,NOP,1,240,41,96,0.427,32,66,0.485,9,30,0.3,20,22,0.909,111,35,83,0.422,29,65,0.446,6,18,0.333,19,27,0.704,95
627,CLE,2016-04-13,110,,DET,0,265,46,97,0.474,39,79,0.494,7,18,0.389,11,15,0.733,110,37,85,0.435,21,52,0.404,16,33,0.485,22,28,0.786,112
628,LAC,2016-04-12,110,,MEM,1,240,41,75,0.547,29,50,0.58,12,25,0.48,16,21,0.762,110,35,86,0.407,30,66,0.455,5,20,0.25,9,14,0.643,84
629,LAL,2016-04-10,110,@,HOU,0,240,41,83,0.494,29,55,0.527,12,28,0.429,16,19,0.842,110,50,98,0.51,33,57,0.579,17,41,0.415,13,18,0.722,130
630,NOP,2016-04-08,110,,LAL,1,240,42,79,0.532,32,57,0.561,10,22,0.455,16,21,0.762,110,34,81,0.42,23,57,0.404,11,24,0.458,23,27,0.852,102
631,OKC,2016-04-03,110,@,HOU,0,240,38,82,0.463,31,55,0.564,7,27,0.259,27,32,0.844,110,41,102,0.402,28,60,0.467,13,42,0.31,23,26,0.885,118
632,POR,2016-04-02,110,,MIA,1,240,41,79,0.519,31,64,0.484,10,15,0.667,18,23,0.783,110,34,88,0.386,28,69,0.406,6,19,0.316,19,27,0.704,93
633,CLE,2016-04-01,110,@,ATL,1,265,39,98,0.398,27,60,0.45,12,38,0.316,20,31,0.645,110,38,95,0.4,29,65,0.446,9,30,0.3,23,26,0.885,108
634,ORL,2016-04-01,110,@,MIL,0,240,46,86,0.535,38,62,0.613,8,24,0.333,10,12,0.833,110,47,86,0.547,43,69,0.623,4,17,0.235,15,25,0.6,113
635,MIA,2016-03-28,110,,BRK,1,240,48,84,0.571,43,68,0.632,5,16,0.313,9,12,0.75,110,41,77,0.532,38,66,0.576,3,11,0.273,14,18,0.778,99
636,IND,2016-03-26,110,@,BRK,0,240,37,77,0.481,26,53,0.491,11,24,0.458,25,30,0.833,110,42,77,0.545,37,66,0.561,5,11,0.455,31,36,0.861,120
637,SAS,2016-03-25,110,,MEM,1,240,44,77,0.571,37,59,0.627,7,18,0.389,15,18,0.833,110,44,83,0.53,37,65,0.569,7,18,0.389,9,13,0.692,104
638,POR,2016-03-17,110,@,SAS,0,240,39,89,0.438,29,67,0.433,10,22,0.455,22,30,0.733,110,45,86,0.523,37,70,0.529,8,16,0.5,20,22,0.909,118
639,DEN,2016-03-15,110,@,ORL,0,240,40,80,0.5,31,56,0.554,9,24,0.375,21,24,0.875,110,44,81,0.543,36,56,0.643,8,25,0.32,20,25,0.8,116
640,DEN,2016-03-08,110,,NYK,1,240,45,99,0.455,39,78,0.5,6,21,0.286,14,19,0.737,110,33,75,0.44,27,57,0.474,6,18,0.333,22,26,0.846,94
641,NOP,2016-02-27,110,,MIN,0,240,39,84,0.464,29,57,0.509,10,27,0.37,22,26,0.846,110,42,84,0.5,37,69,0.536,5,15,0.333,23,30,0.767,112
642,DEN,2016-02-23,110,,SAC,0,240,41,100,0.41,31,73,0.425,10,27,0.37,18,22,0.818,110,43,83,0.518,36,66,0.545,7,17,0.412,21,28,0.75,114
643,DEN,2016-02-19,110,@,SAC,0,240,42,90,0.467,34,66,0.515,8,24,0.333,18,26,0.692,110,41,83,0.494,31,62,0.5,10,21,0.476,24,31,0.774,116
644,ORL,2016-02-19,110,,DAL,1,265,41,102,0.402,28,67,0.418,13,35,0.371,15,17,0.882,110,37,89,0.416,18,48,0.375,19,41,0.463,11,18,0.611,104
645,PHI,2016-02-10,110,,SAC,0,240,42,91,0.462,27,56,0.482,15,35,0.429,11,17,0.647,110,44,87,0.506,40,71,0.563,4,16,0.25,22,29,0.759,114
646,HOU,2016-02-09,110,@,GSW,0,240,37,87,0.425,24,54,0.444,13,33,0.394,23,35,0.657,110,44,94,0.468,32,60,0.533,12,34,0.353,23,26,0.885,123
647,ATL,2016-02-08,110,,ORL,0,265,43,92,0.467,31,63,0.492,12,29,0.414,12,20,0.6,110,46,93,0.495,37,64,0.578,9,29,0.31,16,22,0.727,117
648,MEM,2016-02-06,110,,DAL,0,265,44,88,0.5,35,65,0.538,9,23,0.391,13,23,0.565,110,38,88,0.432,23,50,0.46,15,38,0.395,23,33,0.697,114
649,CHI,2016-02-05,110,@,DEN,0,240,43,93,0.462,38,81,0.469,5,12,0.417,19,27,0.704,110,39,87,0.448,33,69,0.478,6,18,0.333,31,44,0.705,115
650,TOR,2016-02-04,110,@,POR,1,240,40,85,0.471,28,66,0.424,12,19,0.632,18,25,0.72,110,38,81,0.469,28,56,0.5,10,25,0.4,17,23,0.739,103
651,SAS,2016-02-03,110,,NOP,1,240,42,81,0.519,33,66,0.5,9,15,0.6,17,18,0.944,110,41,90,0.456,38,71,0.535,3,19,0.158,12,14,0.857,97
652,MEM,2016-02-01,110,@,NOP,1,240,43,71,0.606,34,55,0.618,9,16,0.563,15,18,0.833,110,36,88,0.409,26,62,0.419,10,26,0.385,13,21,0.619,95
653,DET,2016-01-27,110,,PHI,1,240,39,91,0.429,34,70,0.486,5,21,0.238,27,38,0.711,110,39,82,0.476,32,63,0.508,7,19,0.368,12,17,0.706,97
654,IND,2016-01-22,110,@,GSW,0,240,44,95,0.463,41,78,0.526,3,17,0.176,19,27,0.704,110,43,90,0.478,29,57,0.509,14,33,0.424,22,25,0.88,122
655,BOS,2016-01-22,110,,CHI,1,240,43,96,0.448,35,73,0.479,8,23,0.348,16,21,0.762,110,38,89,0.427,35,76,0.461,3,13,0.231,22,26,0.846,101
656,OKC,2016-01-19,110,@,DEN,1,240,41,97,0.423,35,69,0.507,6,28,0.214,22,30,0.733,110,35,83,0.422,28,63,0.444,7,20,0.35,27,36,0.75,104
657,SAC,2016-01-16,110,@,LAC,1,240,36,76,0.474,23,51,0.451,13,25,0.52,25,33,0.758,110,38,96,0.396,25,57,0.439,13,39,0.333,14,19,0.737,103
658,GSW,2016-01-13,110,@,DEN,0,240,42,88,0.477,32,62,0.516,10,26,0.385,16,20,0.8,110,37,87,0.425,32,65,0.492,5,22,0.227,33,37,0.892,112
659,BRK,2016-01-13,110,,NYK,1,240,45,86,0.523,36,69,0.522,9,17,0.529,11,14,0.786,110,41,91,0.451,34,69,0.493,7,22,0.318,15,23,0.652,104
660,CLE,2016-01-12,110,@,DAL,1,265,40,97,0.412,23,53,0.434,17,44,0.386,13,16,0.813,110,39,79,0.494,28,51,0.549,11,28,0.393,18,22,0.818,107
661,OKC,2016-01-10,110,@,POR,0,240,37,76,0.487,27,55,0.491,10,21,0.476,26,36,0.722,110,42,100,0.42,23,56,0.411,19,44,0.432,12,14,0.857,115
662,OKC,2015-12-31,110,,PHO,1,240,42,80,0.525,35,59,0.593,7,21,0.333,19,24,0.792,110,43,82,0.524,35,62,0.565,8,20,0.4,12,13,0.923,106
663,HOU,2015-12-31,110,,GSW,0,240,36,78,0.462,24,48,0.5,12,30,0.4,26,29,0.897,110,43,84,0.512,32,61,0.525,11,23,0.478,17,27,0.63,114
664,PHI,2015-12-30,110,@,SAC,1,240,40,94,0.426,31,63,0.492,9,31,0.29,21,34,0.618,110,36,74,0.486,28,49,0.571,8,25,0.32,25,41,0.61,105
665,POR,2015-12-30,110,,DEN,1,240,41,87,0.471,29,55,0.527,12,32,0.375,16,20,0.8,110,37,87,0.425,25,60,0.417,12,27,0.444,17,19,0.895,103
666,NOP,2015-12-26,110,,HOU,1,240,38,75,0.507,25,51,0.49,13,24,0.542,21,26,0.808,110,38,84,0.452,23,51,0.451,15,33,0.455,17,20,0.85,108
667,UTA,2015-12-21,110,,PHO,1,240,36,79,0.456,27,54,0.5,9,25,0.36,29,37,0.784,110,31,79,0.392,24,55,0.436,7,24,0.292,20,22,0.909,89
668,POR,2015-12-12,110,,NYK,0,240,41,89,0.461,35,68,0.515,6,21,0.286,22,29,0.759,110,39,75,0.52,30,54,0.556,9,21,0.429,25,28,0.893,112
669,BRK,2015-12-08,110,,HOU,1,240,45,81,0.556,38,63,0.603,7,18,0.389,13,16,0.813,110,39,82,0.476,24,47,0.511,15,35,0.429,12,17,0.706,105
670,LAC,2015-12-07,110,@,MIN,1,240,38,86,0.442,30,61,0.492,8,25,0.32,26,29,0.897,110,36,82,0.439,29,64,0.453,7,18,0.389,27,35,0.771,106
671,ORL,2015-11-29,110,,BOS,1,240,45,93,0.484,36,68,0.529,9,25,0.36,11,16,0.688,110,36,88,0.409,31,61,0.508,5,27,0.185,14,20,0.7,91
672,OKC,2015-11-25,110,,BRK,1,240,41,78,0.526,31,54,0.574,10,24,0.417,18,21,0.857,110,43,94,0.457,40,81,0.494,3,13,0.231,10,12,0.833,99
673,MEM,2015-11-24,110,,DAL,1,240,37,86,0.43,30,65,0.462,7,21,0.333,29,37,0.784,110,30,77,0.39,19,43,0.442,11,34,0.324,25,28,0.893,96
674,OKC,2015-11-18,110,,NOP,1,240,38,85,0.447,31,68,0.456,7,17,0.412,27,40,0.675,110,43,95,0.453,35,63,0.556,8,32,0.25,9,9,1.0,103
675,TOR,2015-11-17,110,@,GSW,0,240,37,79,0.468,31,61,0.508,6,18,0.333,30,39,0.769,110,43,80,0.538,32,51,0.627,11,29,0.379,18,27,0.667,115
676,DAL,2015-11-14,110,@,HOU,1,240,43,89,0.483,35,61,0.574,8,28,0.286,16,21,0.762,110,32,84,0.381,23,50,0.46,9,34,0.265,25,32,0.781,98
677,SAC,2015-11-06,110,,HOU,0,240,40,93,0.43,31,65,0.477,9,28,0.321,21,29,0.724,110,40,82,0.488,25,46,0.543,15,36,0.417,21,27,0.778,116
678,HOU,2015-11-02,110,,OKC,1,240,41,89,0.461,32,60,0.533,9,29,0.31,19,29,0.655,110,40,84,0.476,30,61,0.492,10,23,0.435,15,22,0.682,105
679,WAS,2015-10-31,110,,NYK,0,240,38,90,0.422,32,68,0.471,6,22,0.273,28,33,0.848,110,41,86,0.477,32,67,0.478,9,19,0.474,26,32,0.813,117
680,PHO,2015-10-30,110,,POR,1,240,37,83,0.446,33,65,0.508,4,18,0.222,32,42,0.762,110,34,86,0.395,25,62,0.403,9,24,0.375,15,19,0.789,92
681,WAS,2016-04-13,109,,ATL,1,240,42,88,0.477,33,60,0.55,9,28,0.321,16,30,0.533,109,32,81,0.395,21,52,0.404,11,29,0.379,23,31,0.742,98
682,NOP,2016-04-13,109,@,MIN,0,240,40,92,0.435,29,62,0.468,11,30,0.367,18,22,0.818,109,56,86,0.651,43,58,0.741,13,28,0.464,19,23,0.826,144
683,CLE,2016-04-11,109,,ATL,1,240,40,83,0.482,29,54,0.537,11,29,0.379,18,20,0.9,109,39,87,0.448,31,57,0.544,8,30,0.267,8,15,0.533,94
684,MIL,2016-04-10,109,@,PHI,1,265,40,87,0.46,33,64,0.516,7,23,0.304,22,24,0.917,109,39,96,0.406,26,50,0.52,13,46,0.283,17,25,0.68,108
685,NYK,2016-04-08,109,@,PHI,1,240,43,91,0.473,39,75,0.52,4,16,0.25,19,30,0.633,109,32,91,0.352,18,54,0.333,14,37,0.378,24,36,0.667,102
686,MIA,2016-04-08,109,@,ORL,0,240,45,100,0.45,37,78,0.474,8,22,0.364,11,21,0.524,109,43,82,0.524,38,71,0.535,5,11,0.455,21,28,0.75,112
687,MIL,2016-04-08,109,@,BOS,0,240,41,84,0.488,34,67,0.507,7,17,0.412,20,29,0.69,109,44,78,0.564,38,64,0.594,6,14,0.429,30,38,0.789,124
688,CLE,2016-04-06,109,@,IND,0,240,35,74,0.473,27,45,0.6,8,29,0.276,31,34,0.912,109,45,80,0.563,29,49,0.592,16,31,0.516,17,22,0.773,123
689,CLE,2016-04-05,109,@,MIL,1,240,41,75,0.547,23,39,0.59,18,36,0.5,9,10,0.9,109,35,88,0.398,31,72,0.431,4,16,0.25,6,12,0.5,80
690,WAS,2016-04-03,109,@,LAC,0,240,43,94,0.457,32,64,0.5,11,30,0.367,12,21,0.571,109,43,85,0.506,35,66,0.53,8,19,0.421,20,33,0.606,114
691,BOS,2016-04-01,109,@,GSW,1,240,41,87,0.471,33,64,0.516,8,23,0.348,19,30,0.633,109,38,83,0.458,18,40,0.45,20,43,0.465,10,13,0.769,106
692,BOS,2016-03-31,109,@,POR,0,240,37,88,0.42,28,64,0.438,9,24,0.375,26,34,0.765,109,41,90,0.456,27,56,0.482,14,34,0.412,20,27,0.741,116
693,DEN,2016-03-30,109,@,MEM,1,240,38,78,0.487,25,49,0.51,13,29,0.448,20,24,0.833,109,41,95,0.432,35,76,0.461,6,19,0.316,17,27,0.63,105
694,TOR,2016-03-25,109,@,HOU,0,240,39,94,0.415,26,63,0.413,13,31,0.419,18,26,0.692,109,42,81,0.519,30,59,0.508,12,22,0.545,16,35,0.457,112
695,POR,2016-03-23,109,,DAL,1,240,40,89,0.449,33,62,0.532,7,27,0.259,22,25,0.88,109,42,96,0.438,33,66,0.5,9,30,0.3,10,11,0.909,103
696,GSW,2016-03-21,109,@,MIN,1,240,43,87,0.494,35,63,0.556,8,24,0.333,15,24,0.625,109,36,82,0.439,29,63,0.46,7,19,0.368,25,30,0.833,104
697,CHI,2016-03-21,109,,SAC,1,240,41,91,0.451,29,67,0.433,12,24,0.5,15,23,0.652,109,40,88,0.455,31,59,0.525,9,29,0.31,13,16,0.813,102
698,NOP,2016-03-20,109,,LAC,1,240,35,71,0.493,28,50,0.56,7,21,0.333,32,40,0.8,109,33,82,0.402,23,43,0.535,10,39,0.256,29,42,0.69,105
699,ATL,2016-03-19,109,,HOU,1,240,44,88,0.5,30,50,0.6,14,38,0.368,7,12,0.583,109,33,84,0.393,28,61,0.459,5,23,0.217,26,31,0.839,97
700,CLE,2016-03-18,109,@,ORL,1,240,38,76,0.5,25,48,0.521,13,28,0.464,20,27,0.741,109,37,82,0.451,26,60,0.433,11,22,0.5,18,22,0.818,103
701,CHO,2016-03-17,109,@,MIA,1,240,40,86,0.465,27,60,0.45,13,26,0.5,16,21,0.762,109,40,75,0.533,33,58,0.569,7,17,0.412,19,24,0.792,106
702,BOS,2016-03-16,109,,OKC,0,240,40,93,0.43,35,74,0.473,5,19,0.263,24,27,0.889,109,47,96,0.49,35,67,0.522,12,29,0.414,24,30,0.8,130
703,CHI,2016-03-14,109,@,TOR,1,240,41,83,0.494,32,58,0.552,9,25,0.36,18,20,0.9,109,37,83,0.446,31,63,0.492,6,20,0.3,27,31,0.871,107
704,MIL,2016-03-13,109,@,BRK,1,240,45,89,0.506,39,75,0.52,6,14,0.429,13,21,0.619,109,39,70,0.557,27,43,0.628,12,27,0.444,10,13,0.769,100
705,HOU,2016-03-12,109,@,CHO,0,240,43,93,0.462,38,67,0.567,5,26,0.192,18,28,0.643,109,48,88,0.545,33,57,0.579,15,31,0.484,14,16,0.875,125
706,SAS,2016-03-10,109,,CHI,1,240,44,93,0.473,38,76,0.5,6,17,0.353,15,19,0.789,109,39,86,0.453,28,64,0.438,11,22,0.5,12,13,0.923,101
707,WAS,2016-03-08,109,@,POR,0,265,45,99,0.455,37,79,0.468,8,20,0.4,11,23,0.478,109,41,89,0.461,31,65,0.477,10,24,0.417,24,31,0.774,116
708,LAC,2016-03-07,109,@,DAL,1,240,39,83,0.47,27,51,0.529,12,32,0.375,19,29,0.655,109,30,81,0.37,26,56,0.464,4,25,0.16,26,32,0.813,90
709,PHO,2016-03-06,109,@,MEM,1,240,37,71,0.521,25,43,0.581,12,28,0.429,23,30,0.767,109,32,80,0.4,22,58,0.379,10,22,0.455,26,33,0.788,100
710,GSW,2016-03-01,109,,ATL,1,265,41,103,0.398,29,67,0.433,12,36,0.333,15,17,0.882,109,37,80,0.463,25,47,0.532,12,33,0.364,19,24,0.792,105
711,CHI,2016-02-24,109,,WAS,1,240,44,88,0.5,36,65,0.554,8,23,0.348,13,16,0.813,109,38,90,0.422,29,62,0.468,9,28,0.321,19,26,0.731,104
712,WAS,2016-02-23,109,,NOP,1,240,43,94,0.457,31,68,0.456,12,26,0.462,11,17,0.647,109,29,83,0.349,23,60,0.383,6,23,0.261,25,33,0.758,89
713,ATL,2016-02-20,109,,MIL,0,290,44,106,0.415,35,65,0.538,9,41,0.22,12,18,0.667,109,46,104,0.442,43,87,0.494,3,17,0.176,22,32,0.688,117
714,BRK,2016-02-19,109,,NYK,1,240,42,86,0.488,34,69,0.493,8,17,0.471,17,20,0.85,109,36,82,0.439,26,56,0.464,10,26,0.385,16,18,0.889,98
715,MEM,2016-02-19,109,,MIN,1,240,40,82,0.488,33,61,0.541,7,21,0.333,22,28,0.786,109,31,75,0.413,20,49,0.408,11,26,0.423,31,31,1.0,104
716,MEM,2016-02-10,109,@,BRK,1,240,45,86,0.523,36,66,0.545,9,20,0.45,10,12,0.833,109,33,71,0.465,22,49,0.449,11,22,0.5,13,19,0.684,90
717,IND,2016-01-30,109,,DEN,1,265,44,100,0.44,35,73,0.479,9,27,0.333,12,16,0.75,109,40,87,0.46,36,69,0.522,4,18,0.222,21,25,0.84,105
718,POR,2016-01-29,109,,CHO,1,240,45,92,0.489,38,72,0.528,7,20,0.35,12,16,0.75,109,31,80,0.388,21,51,0.412,10,29,0.345,19,28,0.679,91
719,OKC,2016-01-22,109,@,DAL,1,240,45,91,0.495,37,61,0.607,8,30,0.267,11,15,0.733,109,40,87,0.46,30,54,0.556,10,33,0.303,16,18,0.889,106
720,OKC,2016-01-20,109,,CHO,1,240,39,83,0.47,30,59,0.508,9,24,0.375,22,30,0.733,109,34,81,0.42,25,54,0.463,9,27,0.333,18,21,0.857,95
721,BOS,2016-01-20,109,@,TOR,0,240,43,85,0.506,31,59,0.525,12,26,0.462,11,15,0.733,109,46,83,0.554,35,54,0.648,11,29,0.379,12,17,0.706,115
722,UTA,2016-01-16,109,,LAL,1,240,41,83,0.494,29,59,0.492,12,24,0.5,15,18,0.833,109,31,90,0.344,22,67,0.328,9,23,0.391,11,18,0.611,82
723,NOP,2016-01-15,109,,CHO,1,240,43,87,0.494,31,60,0.517,12,27,0.444,11,13,0.846,109,42,86,0.488,28,51,0.549,14,35,0.4,9,12,0.75,107
724,NOP,2016-01-13,109,@,SAC,1,240,42,100,0.42,26,67,0.388,16,33,0.485,9,11,0.818,109,41,84,0.488,35,61,0.574,6,23,0.261,9,14,0.643,97
725,SAS,2016-01-12,109,@,DET,1,240,41,85,0.482,36,71,0.507,5,14,0.357,22,27,0.815,109,38,91,0.418,32,68,0.471,6,23,0.261,17,26,0.654,99
726,LAC,2016-01-06,109,@,POR,1,240,42,83,0.506,31,60,0.517,11,23,0.478,14,17,0.824,109,38,86,0.442,29,60,0.483,9,26,0.346,13,23,0.565,98
727,GSW,2016-01-05,109,@,LAL,1,240,40,86,0.465,27,55,0.491,13,31,0.419,16,21,0.762,109,29,91,0.319,24,70,0.343,5,21,0.238,25,30,0.833,88
728,PHI,2016-01-04,109,,MIN,1,240,48,87,0.552,44,67,0.657,4,20,0.2,9,14,0.643,109,39,73,0.534,37,68,0.544,2,5,0.4,19,24,0.792,99
729,OKC,2016-01-02,109,@,CHO,1,240,35,79,0.443,26,56,0.464,9,23,0.391,30,37,0.811,109,29,84,0.345,23,62,0.371,6,22,0.273,26,34,0.765,90
730,UTA,2015-12-31,109,,POR,1,240,43,86,0.5,28,53,0.528,15,33,0.455,8,11,0.727,109,35,78,0.449,19,42,0.452,16,36,0.444,10,14,0.714,96
731,LAC,2015-12-26,109,@,UTA,1,240,38,79,0.481,25,53,0.472,13,26,0.5,20,24,0.833,109,36,74,0.486,26,47,0.553,10,27,0.37,22,27,0.815,104
732,POR,2015-12-20,109,@,MIA,0,240,39,80,0.488,26,46,0.565,13,34,0.382,18,22,0.818,109,43,75,0.573,31,52,0.596,12,23,0.522,18,26,0.692,116
733,WAS,2015-12-19,109,,CHO,1,240,40,79,0.506,31,59,0.525,9,20,0.45,20,23,0.87,109,39,93,0.419,29,60,0.483,10,33,0.303,13,16,0.813,101
734,ATL,2015-12-18,109,@,BOS,1,240,41,88,0.466,37,68,0.544,4,20,0.2,23,29,0.793,109,34,77,0.442,24,54,0.444,10,23,0.435,23,31,0.742,101
735,CHO,2015-12-17,109,,TOR,1,265,37,85,0.435,27,56,0.482,10,29,0.345,25,31,0.806,109,35,97,0.361,26,58,0.448,9,39,0.231,20,28,0.714,99
736,SAS,2015-12-11,109,,LAL,1,240,44,82,0.537,38,68,0.559,6,14,0.429,15,25,0.6,109,36,88,0.409,27,63,0.429,9,25,0.36,6,10,0.6,87
737,HOU,2015-12-09,109,@,WAS,1,240,40,83,0.482,28,50,0.56,12,33,0.364,17,25,0.68,109,39,89,0.438,34,64,0.531,5,25,0.2,20,24,0.833,103
738,LAC,2015-12-09,109,@,MIL,1,240,38,81,0.469,26,53,0.491,12,28,0.429,21,36,0.583,109,42,90,0.467,40,80,0.5,2,10,0.2,9,12,0.75,95
739,POR,2015-12-05,109,@,MIN,1,240,39,77,0.506,29,57,0.509,10,20,0.5,21,30,0.7,109,38,83,0.458,33,68,0.485,5,15,0.333,22,26,0.846,103
740,TOR,2015-12-05,109,,GSW,0,240,40,91,0.44,32,71,0.451,8,20,0.4,21,26,0.808,109,35,73,0.479,19,43,0.442,16,30,0.533,26,36,0.722,112
741,WAS,2015-12-04,109,,PHO,1,240,40,82,0.488,30,56,0.536,10,26,0.385,19,25,0.76,109,43,84,0.512,33,61,0.541,10,23,0.435,10,16,0.625,106
742,MIL,2015-11-23,109,,DET,1,240,43,83,0.518,34,70,0.486,9,13,0.692,14,17,0.824,109,31,91,0.341,25,63,0.397,6,28,0.214,20,24,0.833,88
743,CLE,2015-11-21,109,,ATL,1,240,41,85,0.482,30,56,0.536,11,29,0.379,16,19,0.842,109,32,86,0.372,21,58,0.362,11,28,0.393,22,25,0.88,97
744,SAC,2015-11-19,109,@,MIA,0,240,43,84,0.512,31,61,0.508,12,23,0.522,11,20,0.55,109,42,89,0.472,35,65,0.538,7,24,0.292,25,33,0.758,116
745,SAS,2015-11-18,109,,DEN,1,240,42,86,0.488,33,68,0.485,9,18,0.5,16,20,0.8,109,38,98,0.388,33,83,0.398,5,15,0.333,17,18,0.944,98
746,BRK,2015-11-13,109,@,SAC,0,240,42,89,0.472,34,68,0.5,8,21,0.381,17,21,0.81,109,40,94,0.426,29,67,0.433,11,27,0.407,20,26,0.769,111
747,TOR,2015-11-10,109,,NYK,0,240,37,84,0.44,33,67,0.493,4,17,0.235,31,39,0.795,109,42,95,0.442,31,72,0.431,11,23,0.478,16,18,0.889,111
748,GSW,2015-11-09,109,,DET,1,240,43,91,0.473,31,70,0.443,12,21,0.571,11,13,0.846,109,40,85,0.471,34,66,0.515,6,19,0.316,9,15,0.6,95
749,HOU,2015-11-07,109,@,LAC,1,240,38,86,0.442,31,56,0.554,7,30,0.233,26,29,0.897,109,42,88,0.477,38,66,0.576,4,22,0.182,17,25,0.68,105
750,LAL,2015-11-03,109,,DEN,0,240,36,86,0.419,30,60,0.5,6,26,0.231,31,38,0.816,109,43,85,0.506,36,65,0.554,7,20,0.35,27,31,0.871,120
751,MIA,2015-11-01,109,,HOU,1,240,42,86,0.488,33,64,0.516,9,22,0.409,16,21,0.762,109,32,79,0.405,22,43,0.512,10,36,0.278,15,18,0.833,89
752,SAC,2015-10-31,109,@,LAC,0,240,43,101,0.426,37,83,0.446,6,18,0.333,17,25,0.68,109,39,76,0.513,35,59,0.593,4,17,0.235,32,46,0.696,114
753,PHI,2016-04-10,108,,MIL,0,265,39,96,0.406,26,50,0.52,13,46,0.283,17,25,0.68,108,40,87,0.46,33,64,0.516,7,23,0.304,22,24,0.917,109
754,DET,2016-04-06,108,@,ORL,1,240,39,86,0.453,28,59,0.475,11,27,0.407,19,31,0.613,108,43,90,0.478,39,75,0.52,4,15,0.267,14,19,0.737,104
755,MEM,2016-04-05,108,,CHI,1,240,39,87,0.448,32,68,0.471,7,19,0.368,23,26,0.885,108,34,77,0.442,23,48,0.479,11,29,0.379,13,19,0.684,92
756,ATL,2016-04-01,108,,CLE,0,265,38,95,0.4,29,65,0.446,9,30,0.3,23,26,0.885,108,39,98,0.398,27,60,0.45,12,38,0.316,20,31,0.645,110
757,POR,2016-03-26,108,,PHI,1,240,38,91,0.418,30,66,0.455,8,25,0.32,24,30,0.8,108,39,93,0.419,29,55,0.527,10,38,0.263,17,24,0.708,105
758,MIA,2016-03-25,108,,ORL,1,240,40,80,0.5,35,65,0.538,5,15,0.333,23,33,0.697,108,36,84,0.429,30,66,0.455,6,18,0.333,19,28,0.679,97
759,SAC,2016-03-18,108,@,DET,0,240,40,79,0.506,36,64,0.563,4,15,0.267,24,29,0.828,108,44,92,0.478,32,66,0.485,12,26,0.462,15,18,0.833,115
760,SAC,2016-03-16,108,,NOP,0,240,42,90,0.467,33,72,0.458,9,18,0.5,15,17,0.882,108,49,90,0.544,37,69,0.536,12,21,0.571,13,16,0.813,123
761,MEM,2016-03-16,108,,MIN,0,240,44,100,0.44,40,80,0.5,4,20,0.2,16,21,0.762,108,40,71,0.563,30,50,0.6,10,21,0.476,24,31,0.774,114
762,SAS,2016-03-15,108,,LAC,1,240,44,82,0.537,36,62,0.581,8,20,0.4,12,16,0.75,108,32,69,0.464,24,50,0.48,8,19,0.421,15,22,0.682,87
763,UTA,2016-03-13,108,@,SAC,1,240,39,82,0.476,27,54,0.5,12,28,0.429,18,22,0.818,108,38,81,0.469,29,60,0.483,9,21,0.429,14,21,0.667,99
764,LAL,2016-03-10,108,,CLE,0,240,42,80,0.525,35,58,0.603,7,22,0.318,17,21,0.81,108,45,85,0.529,29,50,0.58,16,35,0.457,14,20,0.7,120
765,LAC,2016-03-09,108,@,OKC,0,240,41,81,0.506,29,47,0.617,12,34,0.353,14,23,0.609,108,48,91,0.527,39,67,0.582,9,24,0.375,15,18,0.833,120
766,MIA,2016-03-09,108,@,MIL,0,240,42,80,0.525,36,65,0.554,6,15,0.4,18,19,0.947,108,42,80,0.525,38,72,0.528,4,8,0.5,26,37,0.703,114
767,CHO,2016-03-07,108,,MIN,1,240,41,90,0.456,29,60,0.483,12,30,0.4,14,17,0.824,108,39,80,0.488,35,65,0.538,4,15,0.267,21,24,0.875,103
768,CHI,2016-03-05,108,,HOU,1,240,36,79,0.456,27,58,0.466,9,21,0.429,27,34,0.794,108,35,87,0.402,26,52,0.5,9,35,0.257,21,30,0.7,100
769,CHO,2016-03-04,108,,IND,1,240,38,79,0.481,25,48,0.521,13,31,0.419,19,23,0.826,108,37,90,0.411,28,62,0.452,9,28,0.321,18,21,0.857,101
770,CLE,2016-03-04,108,,WAS,1,240,42,90,0.467,30,63,0.476,12,27,0.444,12,16,0.75,108,32,81,0.395,29,61,0.475,3,20,0.15,16,24,0.667,83
771,MIA,2016-03-03,108,,PHO,1,240,40,83,0.482,31,66,0.47,9,17,0.529,19,25,0.76,108,33,82,0.402,28,60,0.467,5,22,0.227,21,27,0.778,92
772,ORL,2016-03-01,108,@,DAL,0,240,41,91,0.451,32,61,0.525,9,30,0.3,17,20,0.85,108,43,77,0.558,34,58,0.586,9,19,0.474,26,31,0.839,121
773,PHI,2016-02-29,108,@,WAS,0,240,43,89,0.483,33,57,0.579,10,32,0.313,12,21,0.571,108,43,89,0.483,37,69,0.536,6,20,0.3,24,31,0.774,116
774,NYK,2016-02-26,108,,ORL,1,240,37,80,0.463,33,64,0.516,4,16,0.25,30,36,0.833,108,39,93,0.419,33,66,0.5,6,27,0.222,11,16,0.688,95
775,SAS,2016-02-24,108,@,SAC,1,240,44,85,0.518,36,66,0.545,8,19,0.421,12,15,0.8,108,39,96,0.406,33,78,0.423,6,18,0.333,8,15,0.533,92
776,IND,2016-02-24,108,,NYK,1,240,46,91,0.505,43,76,0.566,3,15,0.2,13,16,0.813,108,35,77,0.455,22,51,0.431,13,26,0.5,22,25,0.88,105
777,MIL,2016-02-22,108,,LAL,1,240,44,86,0.512,39,70,0.557,5,16,0.313,15,25,0.6,108,28,76,0.368,16,47,0.34,12,29,0.414,33,43,0.767,101
778,NYK,2016-02-09,108,,WAS,0,240,44,83,0.53,36,57,0.632,8,26,0.308,12,14,0.857,108,39,78,0.5,23,52,0.442,16,26,0.615,17,25,0.68,111
779,CHO,2016-02-08,108,,CHI,1,240,35,80,0.438,21,44,0.477,14,36,0.389,24,31,0.774,108,35,90,0.389,25,65,0.385,10,25,0.4,11,14,0.786,91
780,CHO,2016-02-06,108,,WAS,1,240,38,81,0.469,26,54,0.481,12,27,0.444,20,25,0.8,108,38,86,0.442,29,61,0.475,9,25,0.36,19,24,0.792,104
781,OKC,2016-02-06,108,@,GSW,0,240,36,85,0.424,29,63,0.46,7,22,0.318,29,37,0.784,108,48,97,0.495,41,71,0.577,7,26,0.269,13,20,0.65,116
782,MIN,2016-02-03,108,@,LAC,1,240,39,77,0.506,31,60,0.517,8,17,0.471,22,26,0.846,108,33,75,0.44,22,43,0.512,11,32,0.344,25,34,0.735,102
783,GSW,2016-01-30,108,@,PHI,1,240,47,95,0.495,34,65,0.523,13,30,0.433,1,2,0.5,108,42,92,0.457,32,63,0.508,10,29,0.345,11,21,0.524,105
784,HOU,2016-01-29,108,@,OKC,0,240,36,95,0.379,27,56,0.482,9,39,0.231,27,43,0.628,108,41,86,0.477,33,67,0.493,8,19,0.421,26,30,0.867,116
785,MEM,2016-01-25,108,,ORL,1,265,43,100,0.43,37,82,0.451,6,18,0.333,16,25,0.64,108,40,86,0.465,30,58,0.517,10,28,0.357,12,14,0.857,102
786,SAC,2016-01-23,108,,IND,1,240,38,85,0.447,33,69,0.478,5,16,0.313,27,36,0.75,108,36,86,0.419,29,67,0.433,7,19,0.368,18,25,0.72,97
787,SAS,2016-01-22,108,@,LAL,1,240,43,85,0.506,32,64,0.5,11,21,0.524,11,13,0.846,108,38,84,0.452,32,68,0.471,6,16,0.375,13,18,0.722,95
788,UTA,2016-01-22,108,@,BRK,1,240,43,75,0.573,34,59,0.576,9,16,0.563,13,15,0.867,108,33,75,0.44,27,59,0.458,6,16,0.375,14,18,0.778,86
789,POR,2016-01-18,108,@,WAS,1,240,43,84,0.512,26,53,0.491,17,31,0.548,5,11,0.455,108,37,77,0.481,28,56,0.5,9,21,0.429,15,20,0.75,98
790,MIL,2016-01-15,108,,ATL,1,265,40,96,0.417,37,86,0.43,3,10,0.3,25,37,0.676,108,43,100,0.43,34,70,0.486,9,30,0.3,6,6,1.0,101
791,OKC,2016-01-13,108,,DAL,1,240,38,82,0.463,23,49,0.469,15,33,0.455,17,29,0.586,108,32,82,0.39,26,51,0.51,6,31,0.194,19,25,0.76,89
792,TOR,2016-01-09,108,@,PHI,1,240,41,75,0.547,36,58,0.621,5,17,0.294,21,27,0.778,108,39,80,0.488,28,63,0.444,11,17,0.647,6,14,0.429,95
793,POR,2016-01-08,108,,GSW,0,240,38,96,0.396,26,63,0.413,12,33,0.364,20,28,0.714,108,46,87,0.529,28,55,0.509,18,32,0.563,18,21,0.857,128
794,DEN,2016-01-02,108,@,GSW,0,265,44,105,0.419,39,75,0.52,5,30,0.167,15,23,0.652,108,43,86,0.5,33,58,0.569,10,28,0.357,15,23,0.652,111
795,CHI,2016-01-01,108,,NYK,1,240,39,85,0.459,29,69,0.42,10,16,0.625,20,25,0.8,108,31,84,0.369,25,65,0.385,6,19,0.316,13,17,0.765,81
796,NYK,2015-12-29,108,,DET,1,240,43,79,0.544,35,63,0.556,8,16,0.5,14,17,0.824,108,37,89,0.416,27,62,0.435,10,27,0.37,12,17,0.706,96
797,CHO,2015-12-28,108,,LAL,1,240,43,89,0.483,37,64,0.578,6,25,0.24,16,22,0.727,108,35,85,0.412,26,56,0.464,9,29,0.31,19,23,0.826,98
798,LAC,2015-12-28,108,@,WAS,1,240,41,78,0.526,34,55,0.618,7,23,0.304,19,25,0.76,108,34,87,0.391,27,63,0.429,7,24,0.292,16,24,0.667,91
799,HOU,2015-12-26,108,@,NOP,0,240,38,84,0.452,23,51,0.451,15,33,0.455,17,20,0.85,108,38,75,0.507,25,51,0.49,13,24,0.542,21,26,0.808,110
800,MIA,2015-12-26,108,@,ORL,1,240,38,77,0.494,28,57,0.491,10,20,0.5,22,23,0.957,108,43,79,0.544,34,60,0.567,9,19,0.474,6,13,0.462,101
801,SAS,2015-12-23,108,@,MIN,1,240,44,82,0.537,34,58,0.586,10,24,0.417,10,14,0.714,108,30,72,0.417,27,62,0.435,3,10,0.3,20,25,0.8,83
802,SAC,2015-12-23,108,@,IND,1,240,46,89,0.517,42,66,0.636,4,23,0.174,12,16,0.75,108,41,89,0.461,29,57,0.509,12,32,0.375,12,20,0.6,106
803,CLE,2015-12-20,108,,PHI,1,240,40,85,0.471,29,60,0.483,11,25,0.44,17,21,0.81,108,30,86,0.349,25,62,0.403,5,24,0.208,21,30,0.7,86
804,TOR,2015-12-18,108,@,MIA,1,240,41,80,0.513,33,59,0.559,8,21,0.381,18,22,0.818,108,35,74,0.473,26,49,0.531,9,25,0.36,15,17,0.882,94
805,HOU,2015-12-14,108,@,DEN,0,240,41,87,0.471,23,47,0.489,18,40,0.45,8,11,0.727,108,42,82,0.512,34,57,0.596,8,25,0.32,22,25,0.88,114
806,PHO,2015-12-13,108,,MIN,1,240,39,87,0.448,29,57,0.509,10,30,0.333,20,24,0.833,108,33,73,0.452,25,54,0.463,8,19,0.421,27,34,0.794,101
807,MIL,2015-12-12,108,,GSW,1,240,44,90,0.489,38,76,0.5,6,14,0.429,14,18,0.778,108,36,89,0.404,30,62,0.484,6,27,0.222,17,25,0.68,95
808,MIN,2015-12-11,108,@,DEN,0,265,38,87,0.437,31,68,0.456,7,19,0.368,25,29,0.862,108,38,86,0.442,27,58,0.466,11,28,0.393,24,33,0.727,111
809,DEN,2015-12-05,108,@,PHI,1,240,37,81,0.457,26,50,0.52,11,31,0.355,23,38,0.605,108,37,74,0.5,22,43,0.512,15,31,0.484,16,26,0.615,105
810,SAS,2015-12-05,108,,BOS,1,240,44,83,0.53,39,66,0.591,5,17,0.294,15,22,0.682,108,39,86,0.453,27,57,0.474,12,29,0.414,15,22,0.682,105
811,CLE,2015-12-04,108,@,NOP,0,265,39,89,0.438,29,56,0.518,10,33,0.303,20,24,0.833,108,42,85,0.494,33,60,0.55,9,25,0.36,21,31,0.677,114
812,NYK,2015-12-04,108,,BRK,1,240,39,87,0.448,27,60,0.45,12,27,0.444,18,21,0.857,108,39,91,0.429,36,80,0.45,3,11,0.273,10,15,0.667,91
813,HOU,2015-12-02,108,,NOP,1,240,36,87,0.414,28,60,0.467,8,27,0.296,28,39,0.718,108,36,88,0.409,29,63,0.46,7,25,0.28,22,25,0.88,101
814,LAL,2015-12-02,108,@,WAS,1,240,41,96,0.427,33,71,0.465,8,25,0.32,18,20,0.9,108,37,79,0.468,30,58,0.517,7,21,0.333,23,31,0.742,104
815,POR,2015-11-28,108,,LAL,1,240,38,78,0.487,26,48,0.542,12,30,0.4,20,26,0.769,108,36,82,0.439,29,59,0.492,7,23,0.304,17,23,0.739,96
816,SAS,2015-11-28,108,,ATL,1,240,40,85,0.471,31,68,0.456,9,17,0.529,19,20,0.95,108,37,87,0.425,31,61,0.508,6,26,0.231,8,13,0.615,88
817,HOU,2015-11-18,108,,POR,1,265,32,92,0.348,18,48,0.375,14,44,0.318,30,35,0.857,108,35,88,0.398,26,58,0.448,9,30,0.3,24,29,0.828,103
818,MIL,2015-11-14,108,,CLE,1,290,43,102,0.422,37,86,0.43,6,16,0.375,16,22,0.727,108,37,91,0.407,23,53,0.434,14,38,0.368,17,27,0.63,105
819,WAS,2015-11-14,108,,ORL,1,240,39,83,0.47,27,54,0.5,12,29,0.414,18,26,0.692,108,38,87,0.437,34,69,0.493,4,18,0.222,19,24,0.792,99
820,LAC,2015-11-11,108,@,DAL,0,240,37,86,0.43,25,59,0.424,12,27,0.444,22,33,0.667,108,42,76,0.553,31,52,0.596,11,24,0.458,23,30,0.767,118
821,DEN,2015-11-09,108,,POR,1,240,40,77,0.519,33,58,0.569,7,19,0.368,21,32,0.656,108,36,91,0.396,26,62,0.419,10,29,0.345,22,27,0.815,104
822,CLE,2015-11-06,108,,PHI,1,240,45,88,0.511,35,62,0.565,10,26,0.385,8,12,0.667,108,41,79,0.519,31,56,0.554,10,23,0.435,10,15,0.667,102
823,CHO,2015-11-05,108,@,DAL,1,240,44,89,0.494,38,62,0.613,6,27,0.222,14,17,0.824,108,32,82,0.39,26,53,0.491,6,29,0.207,24,27,0.889,94
824,LAC,2015-11-04,108,@,GSW,0,240,43,88,0.489,35,66,0.53,8,22,0.364,14,22,0.636,108,39,85,0.459,29,59,0.492,10,26,0.385,24,31,0.774,112
825,POR,2015-11-04,108,@,UTA,1,240,41,77,0.532,30,52,0.577,11,25,0.44,15,32,0.469,108,33,88,0.375,28,64,0.438,5,24,0.208,21,33,0.636,92
826,POR,2016-04-13,107,,DEN,1,240,39,89,0.438,28,53,0.528,11,36,0.306,18,22,0.818,107,40,94,0.426,33,69,0.478,7,25,0.28,12,18,0.667,99
827,ORL,2016-04-11,107,,MIL,1,240,41,84,0.488,34,61,0.557,7,23,0.304,18,28,0.643,107,41,78,0.526,38,63,0.603,3,15,0.2,13,19,0.684,98
828,BOS,2016-04-09,107,@,ATL,0,240,40,90,0.444,29,62,0.468,11,28,0.393,16,24,0.667,107,46,88,0.523,29,55,0.527,17,33,0.515,9,11,0.818,118
829,MIA,2016-04-05,107,,DET,1,240,44,84,0.524,35,70,0.5,9,14,0.643,10,14,0.714,107,32,80,0.4,27,58,0.466,5,22,0.227,20,25,0.8,89
830,PHI,2016-04-05,107,,NOP,1,240,40,88,0.455,27,54,0.5,13,34,0.382,14,17,0.824,107,37,82,0.451,30,64,0.469,7,18,0.389,12,16,0.75,93
831,SAC,2016-04-05,107,,POR,0,240,41,78,0.526,30,56,0.536,11,22,0.5,14,21,0.667,107,40,93,0.43,28,62,0.452,12,31,0.387,23,27,0.852,115
832,BOS,2016-04-03,107,@,LAL,1,240,41,91,0.451,33,61,0.541,8,30,0.267,17,22,0.773,107,37,90,0.411,31,69,0.449,6,21,0.286,20,29,0.69,100
833,MEM,2016-04-03,107,@,ORL,0,240,41,89,0.461,33,68,0.485,8,21,0.381,17,26,0.654,107,43,90,0.478,33,64,0.516,10,26,0.385,23,29,0.793,119
834,CLE,2016-03-31,107,,BRK,1,240,38,87,0.437,26,49,0.531,12,38,0.316,19,24,0.792,107,35,94,0.372,31,73,0.425,4,21,0.19,13,21,0.619,87
835,CLE,2016-03-26,107,@,NYK,1,240,37,83,0.446,23,49,0.469,14,34,0.412,19,25,0.76,107,33,79,0.418,25,56,0.446,8,23,0.348,19,28,0.679,93
836,CHI,2016-03-23,107,,NYK,0,240,38,82,0.463,23,50,0.46,15,32,0.469,16,21,0.762,107,45,87,0.517,31,62,0.5,14,25,0.56,11,15,0.733,115
837,LAL,2016-03-23,107,@,PHO,0,240,39,93,0.419,32,66,0.485,7,27,0.259,22,26,0.846,107,47,93,0.505,34,65,0.523,13,28,0.464,12,20,0.6,119
838,LAL,2016-03-22,107,,MEM,1,240,39,77,0.506,33,58,0.569,6,19,0.316,23,24,0.958,107,40,80,0.5,36,65,0.554,4,15,0.267,16,23,0.696,100
839,HOU,2016-03-22,107,@,OKC,0,240,40,92,0.435,27,55,0.491,13,37,0.351,14,17,0.824,107,41,91,0.451,33,56,0.589,8,35,0.229,21,29,0.724,111
840,BOS,2016-03-21,107,,ORL,1,240,40,85,0.471,33,63,0.524,7,22,0.318,20,24,0.833,107,39,93,0.419,34,74,0.459,5,19,0.263,13,19,0.684,96
841,CHO,2016-03-16,107,,ORL,1,240,40,100,0.4,29,63,0.46,11,37,0.297,16,21,0.762,107,35,83,0.422,24,58,0.414,11,25,0.44,18,21,0.857,99
842,TOR,2016-03-15,107,@,MIL,1,240,39,83,0.47,25,53,0.472,14,30,0.467,15,17,0.882,107,34,77,0.442,32,64,0.5,2,13,0.154,19,26,0.731,89
843,TOR,2016-03-14,107,,CHI,0,240,37,83,0.446,31,63,0.492,6,20,0.3,27,31,0.871,107,41,83,0.494,32,58,0.552,9,25,0.36,18,20,0.9,109
844,NOP,2016-03-14,107,@,GSW,0,240,35,93,0.376,28,68,0.412,7,25,0.28,30,34,0.882,107,47,81,0.58,35,56,0.625,12,25,0.48,19,23,0.826,125
845,DAL,2016-03-14,107,@,CHO,1,240,42,87,0.483,33,57,0.579,9,30,0.3,14,18,0.778,107,32,76,0.421,22,46,0.478,10,30,0.333,22,34,0.647,96
846,PHO,2016-03-14,107,,MIN,1,240,40,95,0.421,29,60,0.483,11,35,0.314,16,20,0.8,107,37,84,0.44,33,68,0.485,4,16,0.25,26,30,0.867,104
847,ORL,2016-03-11,107,@,SAC,1,240,41,79,0.519,37,64,0.578,4,15,0.267,21,34,0.618,107,35,88,0.398,27,63,0.429,8,25,0.32,22,25,0.88,100
848,LAL,2016-03-08,107,,ORL,1,240,40,81,0.494,31,54,0.574,9,27,0.333,18,23,0.783,107,37,76,0.487,32,57,0.561,5,19,0.263,19,27,0.704,98
849,TOR,2016-03-06,107,,HOU,0,240,37,77,0.481,25,44,0.568,12,33,0.364,21,27,0.778,107,38,78,0.487,25,49,0.51,13,29,0.448,24,37,0.649,113
850,ATL,2016-03-05,107,@,LAC,1,240,40,89,0.449,30,62,0.484,10,27,0.37,17,20,0.85,107,34,79,0.43,22,47,0.468,12,32,0.375,17,28,0.607,97
851,LAL,2016-03-02,107,@,DEN,0,240,35,79,0.443,24,48,0.5,11,31,0.355,26,32,0.813,107,38,78,0.487,26,55,0.473,12,23,0.522,29,38,0.763,117
852,LAL,2016-03-01,107,,BRK,1,240,41,83,0.494,30,57,0.526,11,26,0.423,14,21,0.667,107,39,89,0.438,34,71,0.479,5,18,0.278,18,27,0.667,101
853,SAC,2016-02-26,107,,LAC,0,240,34,78,0.436,22,54,0.407,12,24,0.5,27,37,0.73,107,43,89,0.483,34,60,0.567,9,29,0.31,22,26,0.846,117
854,MIL,2016-02-25,107,@,BOS,0,240,42,87,0.483,38,72,0.528,4,15,0.267,19,25,0.76,107,41,84,0.488,36,61,0.59,5,23,0.217,25,33,0.758,112
855,LAC,2016-02-05,107,@,ORL,1,240,40,74,0.541,32,47,0.681,8,27,0.296,19,23,0.826,107,34,81,0.42,30,61,0.492,4,20,0.2,21,28,0.75,93
856,CHI,2016-02-03,107,@,SAC,1,240,40,88,0.455,29,67,0.433,11,21,0.524,16,21,0.762,107,42,88,0.477,36,68,0.529,6,20,0.3,12,19,0.632,102
857,POR,2016-02-02,107,,MIL,1,240,39,85,0.459,28,54,0.519,11,31,0.355,18,25,0.72,107,38,86,0.442,33,72,0.458,5,14,0.357,14,24,0.583,95
858,SAS,2016-02-01,107,,ORL,1,240,40,78,0.513,31,54,0.574,9,24,0.375,18,21,0.857,107,39,96,0.406,34,79,0.43,5,17,0.294,9,11,0.818,92
859,DET,2016-01-30,107,@,TOR,0,240,39,87,0.448,30,58,0.517,9,29,0.31,20,34,0.588,107,36,78,0.462,32,64,0.5,4,14,0.286,35,47,0.745,111
860,MIA,2016-01-29,107,@,MIL,1,240,37,74,0.5,30,56,0.536,7,18,0.389,26,32,0.813,107,38,80,0.475,36,68,0.529,2,12,0.167,25,28,0.893,103
861,DAL,2016-01-27,107,@,GSW,0,240,44,87,0.506,33,56,0.589,11,31,0.355,8,12,0.667,107,47,81,0.58,33,52,0.635,14,29,0.483,19,21,0.905,127
862,MIL,2016-01-26,107,,ORL,1,240,38,77,0.494,33,64,0.516,5,13,0.385,26,31,0.839,107,33,80,0.413,20,56,0.357,13,24,0.542,21,29,0.724,100
863,MIN,2016-01-25,107,@,CLE,0,240,41,84,0.488,37,68,0.544,4,16,0.25,21,23,0.913,107,45,89,0.506,34,58,0.586,11,31,0.355,13,20,0.65,114
864,CHO,2016-01-15,107,@,NOP,0,240,42,86,0.488,28,51,0.549,14,35,0.4,9,12,0.75,107,43,87,0.494,31,60,0.517,12,27,0.444,11,13,0.846,109
865,CHO,2016-01-13,107,,ATL,1,240,36,82,0.439,23,43,0.535,13,39,0.333,22,26,0.846,107,30,81,0.37,23,56,0.411,7,25,0.28,17,21,0.81,84
866,HOU,2016-01-13,107,,MIN,1,240,37,75,0.493,30,45,0.667,7,30,0.233,26,38,0.684,107,36,78,0.462,28,61,0.459,8,17,0.471,24,30,0.8,104
867,DAL,2016-01-12,107,,CLE,0,265,39,79,0.494,28,51,0.549,11,28,0.393,18,22,0.818,107,40,97,0.412,23,53,0.434,17,44,0.386,13,16,0.813,110
868,HOU,2016-01-12,107,@,MEM,1,240,33,77,0.429,15,42,0.357,18,35,0.514,23,27,0.852,107,33,72,0.458,26,54,0.481,7,18,0.389,18,24,0.75,91
869,HOU,2016-01-10,107,,IND,1,265,39,89,0.438,25,51,0.49,14,38,0.368,15,23,0.652,107,43,90,0.478,34,59,0.576,9,31,0.29,8,10,0.8,103
870,NYK,2016-01-05,107,@,ATL,1,240,40,84,0.476,35,66,0.53,5,18,0.278,22,24,0.917,107,37,87,0.425,22,48,0.458,15,39,0.385,12,19,0.632,101
871,ATL,2015-12-23,107,,DET,1,240,43,89,0.483,37,69,0.536,6,20,0.3,15,20,0.75,107,38,89,0.427,31,68,0.456,7,21,0.333,17,33,0.515,100
872,DEN,2015-12-22,107,,LAL,0,240,41,90,0.456,32,65,0.492,9,25,0.36,16,19,0.842,107,40,84,0.476,33,58,0.569,7,26,0.269,24,32,0.75,111
873,ORL,2015-12-21,107,@,NYK,1,240,44,86,0.512,34,64,0.531,10,22,0.455,9,11,0.818,107,39,76,0.513,32,52,0.615,7,24,0.292,14,16,0.875,99
874,HOU,2015-12-19,107,,LAC,1,240,34,76,0.447,26,51,0.51,8,25,0.32,31,49,0.633,107,34,86,0.395,23,48,0.479,11,38,0.289,18,29,0.621,97
875,NYK,2015-12-19,107,,CHI,1,240,41,82,0.5,36,62,0.581,5,20,0.25,20,24,0.833,107,37,94,0.394,32,73,0.438,5,21,0.238,12,17,0.706,91
876,LAC,2015-12-18,107,@,SAS,0,240,36,72,0.5,26,48,0.542,10,24,0.417,25,40,0.625,107,43,87,0.494,33,68,0.485,10,19,0.526,19,24,0.792,115
877,NYK,2015-12-18,107,@,PHI,1,240,40,85,0.471,34,66,0.515,6,19,0.316,21,28,0.75,107,37,77,0.481,31,53,0.585,6,24,0.25,17,30,0.567,97
878,HOU,2015-12-17,107,@,LAL,1,240,34,88,0.386,22,57,0.386,12,31,0.387,27,42,0.643,107,36,84,0.429,31,60,0.517,5,24,0.208,10,18,0.556,87
879,NYK,2015-12-16,107,,MIN,1,240,37,85,0.435,29,64,0.453,8,21,0.381,25,30,0.833,107,42,101,0.416,38,80,0.475,4,21,0.19,14,14,1.0,102
880,IND,2015-12-16,107,,DAL,1,240,43,89,0.483,32,60,0.533,11,29,0.379,10,17,0.588,107,33,90,0.367,25,57,0.439,8,33,0.242,7,10,0.7,81
881,SAC,2015-12-15,107,,HOU,1,240,38,75,0.507,27,51,0.529,11,24,0.458,20,29,0.69,107,34,82,0.415,22,43,0.512,12,39,0.308,17,23,0.739,97
882,NOP,2015-12-11,107,,WAS,1,240,39,79,0.494,23,52,0.442,16,27,0.593,13,18,0.722,107,40,80,0.5,28,53,0.528,12,27,0.444,13,21,0.619,105
883,DET,2015-12-11,107,@,PHI,1,240,43,93,0.462,33,66,0.5,10,27,0.37,11,16,0.688,107,36,80,0.45,30,62,0.484,6,18,0.333,17,24,0.708,95
884,OKC,2015-12-10,107,,ATL,1,240,39,80,0.488,30,63,0.476,9,17,0.529,20,26,0.769,107,35,78,0.449,25,50,0.5,10,28,0.357,14,23,0.609,94
885,PHO,2015-12-09,107,,ORL,1,240,41,80,0.513,35,56,0.625,6,24,0.25,19,27,0.704,107,40,85,0.471,28,60,0.467,12,25,0.48,12,16,0.75,104
886,PHO,2015-11-29,107,@,TOR,1,240,40,94,0.426,29,67,0.433,11,27,0.407,16,20,0.8,107,38,86,0.442,26,57,0.456,12,29,0.414,14,17,0.824,102
887,LAC,2015-11-29,107,,MIN,1,240,39,75,0.52,31,53,0.585,8,22,0.364,21,33,0.636,107,37,82,0.451,29,66,0.439,8,16,0.5,17,21,0.81,99
888,IND,2015-11-29,107,@,LAL,1,240,34,83,0.41,25,56,0.446,9,27,0.333,30,37,0.811,107,38,99,0.384,27,66,0.409,11,33,0.333,16,22,0.727,103
889,POR,2015-11-22,107,@,LAL,1,240,43,87,0.494,35,62,0.565,8,25,0.32,13,17,0.765,107,32,88,0.364,26,70,0.371,6,18,0.333,23,27,0.852,93
890,NYK,2015-11-21,107,@,HOU,1,240,34,80,0.425,22,55,0.4,12,25,0.48,27,34,0.794,107,35,81,0.432,23,53,0.434,12,28,0.429,20,28,0.714,102
891,DEN,2015-11-20,107,,PHO,0,240,41,90,0.456,36,66,0.545,5,24,0.208,20,26,0.769,107,40,79,0.506,25,52,0.481,15,27,0.556,19,25,0.76,114
892,SAC,2015-11-15,107,,TOR,1,240,39,76,0.513,29,51,0.569,10,25,0.4,19,24,0.792,107,38,87,0.437,23,56,0.411,15,31,0.484,10,14,0.714,101
893,GSW,2015-11-14,107,,BRK,1,265,43,97,0.443,31,63,0.492,12,34,0.353,9,10,0.9,107,41,98,0.418,39,80,0.488,2,18,0.111,15,16,0.938,99
894,DEN,2015-11-13,107,,HOU,1,240,37,81,0.457,28,61,0.459,9,20,0.45,24,32,0.75,107,33,77,0.429,24,48,0.5,9,29,0.31,23,31,0.742,98
895,IND,2015-11-13,107,,MIN,1,240,41,86,0.477,31,61,0.508,10,25,0.4,15,23,0.652,107,42,83,0.506,35,63,0.556,7,20,0.35,12,13,0.923,103
896,ATL,2015-11-09,107,,MIN,0,240,44,86,0.512,31,55,0.564,13,31,0.419,6,7,0.857,107,46,80,0.575,39,65,0.6,7,15,0.467,18,22,0.818,117
897,DAL,2015-11-07,107,,NOP,1,240,40,84,0.476,31,60,0.517,9,24,0.375,18,22,0.818,107,39,86,0.453,30,58,0.517,9,28,0.321,11,13,0.846,98
898,CLE,2015-11-02,107,@,PHI,1,240,42,81,0.519,34,59,0.576,8,22,0.364,15,20,0.75,107,38,85,0.447,31,61,0.508,7,24,0.292,17,23,0.739,100
899,MIN,2016-04-09,106,@,POR,1,240,41,84,0.488,36,71,0.507,5,13,0.385,19,25,0.76,106,40,80,0.5,31,56,0.554,9,24,0.375,16,18,0.889,105
900,MIA,2016-04-07,106,,CHI,1,240,44,92,0.478,40,78,0.513,4,14,0.286,14,17,0.824,106,35,78,0.449,32,64,0.5,3,14,0.214,25,28,0.893,98
901,NOP,2016-04-03,106,@,BRK,1,240,42,76,0.553,34,54,0.63,8,22,0.364,14,23,0.609,106,33,85,0.388,25,62,0.403,8,23,0.348,13,21,0.619,87
902,DEN,2016-04-02,106,,SAC,0,240,40,92,0.435,31,63,0.492,9,29,0.31,17,24,0.708,106,41,88,0.466,33,67,0.493,8,21,0.381,25,31,0.806,115
903,SAC,2016-04-01,106,,MIA,0,240,38,87,0.437,31,66,0.47,7,21,0.333,23,29,0.793,106,42,82,0.512,30,60,0.5,12,22,0.545,16,17,0.941,112
904,WAS,2016-04-01,106,@,PHO,1,240,38,86,0.442,28,60,0.467,10,26,0.385,20,25,0.8,106,36,93,0.387,29,70,0.414,7,23,0.304,20,26,0.769,99
905,GSW,2016-04-01,106,,BOS,0,240,38,83,0.458,18,40,0.45,20,43,0.465,10,13,0.769,106,41,87,0.471,33,64,0.516,8,23,0.348,19,30,0.633,109
906,HOU,2016-03-29,106,@,CLE,1,240,38,79,0.481,29,54,0.537,9,25,0.36,21,42,0.5,106,31,86,0.36,17,46,0.37,14,40,0.35,24,28,0.857,100
907,NYK,2016-03-24,106,,CHI,1,240,39,76,0.513,26,46,0.565,13,30,0.433,15,16,0.938,106,37,89,0.416,31,64,0.484,6,25,0.24,14,18,0.778,94
908,MIA,2016-03-17,106,,CHO,0,240,40,75,0.533,33,58,0.569,7,17,0.412,19,24,0.792,106,40,86,0.465,27,60,0.45,13,26,0.5,16,21,0.762,109
909,HOU,2016-03-16,106,,LAC,0,240,40,82,0.488,31,57,0.544,9,25,0.36,17,24,0.708,106,43,76,0.566,31,46,0.674,12,30,0.4,24,32,0.75,122
910,SAC,2016-03-15,106,@,LAL,1,240,38,79,0.481,34,61,0.557,4,18,0.222,26,33,0.788,106,37,84,0.44,32,58,0.552,5,26,0.192,19,26,0.731,98
911,MEM,2016-03-07,106,@,CLE,1,240,41,86,0.477,35,66,0.53,6,20,0.3,18,22,0.818,106,36,80,0.45,29,51,0.569,7,29,0.241,24,29,0.828,103
912,UTA,2016-03-05,106,@,NOP,1,240,37,78,0.474,31,58,0.534,6,20,0.3,26,27,0.963,106,38,92,0.413,29,73,0.397,9,19,0.474,9,11,0.818,94
913,ATL,2016-03-04,106,@,LAL,1,240,37,68,0.544,24,40,0.6,13,28,0.464,19,26,0.731,106,29,85,0.341,24,58,0.414,5,27,0.185,14,20,0.7,77
914,OKC,2016-03-03,106,@,GSW,0,240,40,86,0.465,36,66,0.545,4,20,0.2,22,27,0.815,106,47,87,0.54,36,53,0.679,11,34,0.324,16,21,0.762,121
915,MEM,2016-02-27,106,@,PHO,0,240,32,80,0.4,26,60,0.433,6,20,0.3,36,42,0.857,106,37,80,0.463,25,48,0.521,12,32,0.375,25,35,0.714,111
916,PHO,2016-02-25,106,,BRK,0,240,42,98,0.429,33,71,0.465,9,27,0.333,13,23,0.565,106,37,75,0.493,29,57,0.509,8,18,0.444,34,42,0.81,116
917,DET,2016-02-21,106,,NOP,0,240,37,89,0.416,25,56,0.446,12,33,0.364,20,32,0.625,106,41,86,0.477,37,66,0.561,4,20,0.2,25,29,0.862,111
918,TOR,2016-02-19,106,@,CHI,0,240,38,88,0.432,33,70,0.471,5,18,0.278,25,34,0.735,106,48,93,0.516,41,77,0.532,7,16,0.438,13,20,0.65,116
919,CLE,2016-02-18,106,,CHI,1,240,42,91,0.462,35,67,0.522,7,24,0.292,15,17,0.882,106,37,93,0.398,29,72,0.403,8,21,0.381,13,22,0.591,95
920,MEM,2016-02-08,106,,POR,0,265,43,86,0.5,36,67,0.537,7,19,0.368,13,19,0.684,106,44,89,0.494,34,60,0.567,10,29,0.345,14,20,0.7,112
921,PHO,2016-02-08,106,,OKC,0,240,37,73,0.507,36,62,0.581,1,11,0.091,31,39,0.795,106,42,85,0.494,27,52,0.519,15,33,0.455,23,30,0.767,122
922,SAS,2016-02-06,106,,LAL,1,240,39,88,0.443,31,64,0.484,8,24,0.333,20,25,0.8,106,34,86,0.395,24,56,0.429,10,30,0.333,24,27,0.889,102
923,WAS,2016-02-05,106,,PHI,1,240,44,84,0.524,38,62,0.613,6,22,0.273,12,20,0.6,106,37,87,0.425,28,61,0.459,9,26,0.346,11,14,0.786,94
924,CHO,2016-02-03,106,,CLE,1,240,39,79,0.494,30,52,0.577,9,27,0.333,19,23,0.826,106,38,83,0.458,28,55,0.509,10,28,0.357,11,14,0.786,97
925,IND,2016-02-01,106,,CLE,0,265,43,101,0.426,35,74,0.473,8,27,0.296,12,14,0.857,106,44,88,0.5,37,66,0.561,7,22,0.318,16,23,0.696,111
926,DET,2016-01-29,106,,CLE,0,240,40,84,0.476,33,61,0.541,7,23,0.304,19,26,0.731,106,39,83,0.47,30,60,0.5,9,23,0.391,27,29,0.931,114
927,TOR,2016-01-26,106,,WAS,1,240,35,79,0.443,24,50,0.48,11,29,0.379,25,32,0.781,106,32,78,0.41,28,63,0.444,4,15,0.267,21,28,0.75,89
928,OKC,2016-01-24,106,@,BRK,0,240,43,93,0.462,35,67,0.522,8,26,0.308,12,19,0.632,106,45,94,0.479,37,77,0.481,8,17,0.471,18,25,0.72,116
929,MIN,2016-01-23,106,,MEM,1,240,34,68,0.5,29,51,0.569,5,17,0.294,33,36,0.917,106,37,79,0.468,28,60,0.467,9,19,0.474,18,22,0.818,101
930,DAL,2016-01-22,106,,OKC,0,240,40,87,0.46,30,54,0.556,10,33,0.303,16,18,0.889,106,45,91,0.495,37,61,0.607,8,30,0.267,11,15,0.733,109
931,DAL,2016-01-20,106,,MIN,1,265,42,97,0.433,37,72,0.514,5,25,0.2,17,22,0.773,106,40,91,0.44,35,68,0.515,5,23,0.217,9,11,0.818,94
932,WAS,2016-01-20,106,,MIA,1,240,45,86,0.523,40,70,0.571,5,16,0.313,11,13,0.846,106,33,68,0.485,26,53,0.491,7,15,0.467,14,18,0.778,87
933,TOR,2016-01-14,106,@,ORL,1,265,37,90,0.411,29,66,0.439,8,24,0.333,24,31,0.774,106,44,97,0.454,35,74,0.473,9,23,0.391,6,8,0.75,103
934,WAS,2016-01-13,106,,MIL,1,240,38,84,0.452,26,57,0.456,12,27,0.444,18,24,0.75,106,38,72,0.528,37,64,0.578,1,8,0.125,24,34,0.706,101
935,MIL,2016-01-12,106,,CHI,1,240,43,93,0.462,40,80,0.5,3,13,0.231,17,28,0.607,106,35,85,0.412,23,56,0.411,12,29,0.414,19,24,0.792,101
936,SAS,2016-01-11,106,@,BRK,1,240,44,82,0.537,40,69,0.58,4,13,0.308,14,19,0.737,106,33,73,0.452,31,61,0.508,2,12,0.167,11,13,0.846,79
937,MIL,2016-01-05,106,@,CHI,0,240,46,102,0.451,40,86,0.465,6,16,0.375,8,14,0.571,106,46,83,0.554,41,64,0.641,5,19,0.263,20,20,1.0,117
938,DEN,2016-01-03,106,,POR,0,240,34,80,0.425,27,58,0.466,7,22,0.318,31,48,0.646,106,40,78,0.513,30,55,0.545,10,23,0.435,22,32,0.688,112
939,MIA,2016-01-01,106,,DAL,1,240,46,82,0.561,38,64,0.594,8,18,0.444,6,9,0.667,106,32,88,0.364,25,57,0.439,7,31,0.226,11,14,0.786,82
940,PHO,2015-12-31,106,@,OKC,0,240,43,82,0.524,35,62,0.565,8,20,0.4,12,13,0.923,106,42,80,0.525,35,59,0.593,7,21,0.333,19,24,0.792,110
941,IND,2015-12-23,106,,SAC,0,240,41,89,0.461,29,57,0.509,12,32,0.375,12,20,0.6,106,46,89,0.517,42,66,0.636,4,23,0.174,12,16,0.75,108
942,SAS,2015-12-21,106,,IND,1,240,46,89,0.517,40,69,0.58,6,20,0.3,8,9,0.889,106,38,90,0.422,31,71,0.437,7,19,0.368,9,15,0.6,92
943,ATL,2015-12-21,106,,POR,1,240,37,77,0.481,28,48,0.583,9,29,0.31,23,28,0.821,106,38,81,0.469,33,57,0.579,5,24,0.208,16,22,0.727,97
944,OKC,2015-12-16,106,,POR,1,240,38,79,0.481,36,65,0.554,2,14,0.143,28,37,0.757,106,32,92,0.348,21,66,0.318,11,26,0.423,15,18,0.833,90
945,PHI,2015-12-16,106,@,ATL,0,240,39,75,0.52,27,49,0.551,12,26,0.462,16,24,0.667,106,48,78,0.615,38,57,0.667,10,21,0.476,21,24,0.875,127
946,IND,2015-12-14,106,,TOR,1,240,41,86,0.477,31,64,0.484,10,22,0.455,14,16,0.875,106,29,79,0.367,19,51,0.373,10,28,0.357,22,26,0.846,90
947,POR,2015-12-11,106,@,PHO,1,240,45,96,0.469,33,62,0.532,12,34,0.353,4,7,0.571,106,36,83,0.434,23,48,0.479,13,35,0.371,11,18,0.611,96
948,UTA,2015-12-09,106,,NYK,1,240,39,80,0.488,30,59,0.508,9,21,0.429,19,23,0.826,106,31,78,0.397,23,57,0.404,8,21,0.381,15,27,0.556,85
949,UTA,2015-12-08,106,@,SAC,0,240,38,92,0.413,23,56,0.411,15,36,0.417,15,22,0.682,106,43,77,0.558,33,49,0.673,10,28,0.357,18,24,0.75,114
950,MIN,2015-12-07,106,,LAC,0,240,36,82,0.439,29,64,0.453,7,18,0.389,27,35,0.771,106,38,86,0.442,30,61,0.492,8,25,0.32,26,29,0.897,110
951,MIL,2015-12-05,106,,NYK,1,240,44,89,0.494,42,85,0.494,2,4,0.5,16,24,0.667,106,32,76,0.421,26,51,0.51,6,25,0.24,21,28,0.75,91
952,PHO,2015-12-04,106,@,WAS,0,240,43,84,0.512,33,61,0.541,10,23,0.435,10,16,0.625,106,40,82,0.488,30,56,0.536,10,26,0.385,19,25,0.76,109
953,DEN,2015-12-03,106,@,TOR,1,240,38,81,0.469,26,54,0.481,12,27,0.444,18,18,1.0,106,39,92,0.424,31,65,0.477,8,27,0.296,19,22,0.864,105
954,GSW,2015-11-30,106,@,UTA,1,240,40,82,0.488,26,53,0.491,14,29,0.483,12,15,0.8,106,40,89,0.449,34,70,0.486,6,19,0.316,17,22,0.773,103
955,ATL,2015-11-30,106,,OKC,1,240,39,90,0.433,29,62,0.468,10,28,0.357,18,20,0.9,106,37,93,0.398,30,74,0.405,7,19,0.368,19,22,0.864,100
956,WAS,2015-11-24,106,,IND,0,240,38,83,0.458,25,50,0.5,13,33,0.394,17,24,0.708,106,44,80,0.55,25,54,0.463,19,26,0.731,16,23,0.696,123
957,GSW,2015-11-20,106,,CHI,1,240,39,79,0.494,29,50,0.58,10,29,0.345,18,24,0.75,106,35,88,0.398,28,66,0.424,7,22,0.318,17,23,0.739,94
958,DAL,2015-11-18,106,@,BOS,1,240,37,72,0.514,30,52,0.577,7,20,0.35,25,35,0.714,106,38,92,0.413,30,66,0.455,8,26,0.308,18,24,0.75,102
959,MIN,2015-11-15,106,,MEM,0,240,41,82,0.5,36,66,0.545,5,16,0.313,19,21,0.905,106,40,71,0.563,31,54,0.574,9,17,0.529,25,27,0.926,114
960,CHO,2015-11-15,106,,POR,1,240,41,83,0.494,32,52,0.615,9,31,0.29,15,19,0.789,106,35,89,0.393,30,68,0.441,5,21,0.238,19,21,0.905,94
961,BOS,2015-11-13,106,,ATL,1,240,42,103,0.408,31,70,0.443,11,33,0.333,11,12,0.917,106,36,76,0.474,30,56,0.536,6,20,0.3,15,20,0.75,93
962,ATL,2015-11-11,106,,NOP,1,240,42,86,0.488,32,60,0.533,10,26,0.385,12,16,0.75,106,37,83,0.446,23,54,0.426,14,29,0.483,10,15,0.667,98
963,BRK,2015-11-11,106,@,HOU,1,240,42,98,0.429,34,81,0.42,8,17,0.471,14,17,0.824,106,42,98,0.429,34,64,0.531,8,34,0.235,6,12,0.5,98
964,SAS,2015-11-09,106,@,SAC,1,240,46,87,0.529,40,64,0.625,6,23,0.261,8,11,0.727,106,34,84,0.405,27,65,0.415,7,19,0.368,13,19,0.684,88
965,POR,2015-11-02,106,@,MIN,1,240,41,89,0.461,32,59,0.542,9,30,0.3,15,20,0.75,106,34,79,0.43,31,66,0.47,3,13,0.231,30,39,0.769,101
966,TOR,2015-11-01,106,,MIL,1,240,41,90,0.456,30,65,0.462,11,25,0.44,13,20,0.65,106,29,69,0.42,24,50,0.48,5,19,0.263,24,24,1.0,87
967,CLE,2015-10-28,106,@,MEM,1,240,41,84,0.488,28,55,0.509,13,29,0.448,11,17,0.647,106,29,82,0.354,27,66,0.409,2,16,0.125,16,22,0.727,76
968,TOR,2015-10-28,106,,IND,1,240,36,80,0.45,29,62,0.468,7,18,0.389,27,39,0.692,106,32,86,0.372,23,63,0.365,9,23,0.391,26,31,0.839,99
969,SAS,2015-10-28,106,@,OKC,0,240,45,93,0.484,40,78,0.513,5,15,0.333,11,13,0.846,106,42,86,0.488,35,67,0.522,7,19,0.368,21,22,0.955,112
970,DET,2015-10-27,106,@,ATL,1,240,37,96,0.385,25,67,0.373,12,29,0.414,20,26,0.769,106,37,82,0.451,29,55,0.527,8,27,0.296,12,15,0.8,94
971,PHI,2016-04-13,105,@,CHI,0,240,37,81,0.457,20,46,0.435,17,35,0.486,14,18,0.778,105,39,83,0.47,24,59,0.407,15,24,0.625,22,27,0.815,115
972,LAC,2016-04-13,105,@,PHO,0,240,43,96,0.448,34,65,0.523,9,31,0.29,10,12,0.833,105,45,99,0.455,38,73,0.521,7,26,0.269,17,22,0.773,114
973,MIN,2016-04-11,105,,HOU,0,240,38,83,0.458,33,62,0.532,5,21,0.238,24,33,0.727,105,48,86,0.558,33,56,0.589,15,30,0.5,18,26,0.692,129
974,SAC,2016-04-11,105,@,PHO,1,240,41,83,0.494,35,66,0.53,6,17,0.353,17,28,0.607,105,41,100,0.41,36,78,0.462,5,22,0.227,14,17,0.824,101
975,BRK,2016-04-10,105,@,IND,0,240,35,91,0.385,21,54,0.389,14,37,0.378,21,26,0.808,105,48,86,0.558,37,59,0.627,11,27,0.407,22,27,0.815,129
976,CHI,2016-04-09,105,,CLE,1,240,40,89,0.449,32,65,0.492,8,24,0.333,17,21,0.81,105,36,83,0.434,17,43,0.395,19,40,0.475,11,18,0.611,102
977,POR,2016-04-09,105,,MIN,0,240,40,80,0.5,31,56,0.554,9,24,0.375,16,18,0.889,105,41,84,0.488,36,71,0.507,5,13,0.385,19,25,0.76,106
978,MIN,2016-04-07,105,@,SAC,1,240,36,80,0.45,25,59,0.424,11,21,0.524,22,31,0.71,105,36,85,0.424,30,68,0.441,6,17,0.353,19,21,0.905,97
979,NYK,2016-04-01,105,,BRK,1,240,42,84,0.5,28,61,0.459,14,23,0.609,7,7,1.0,105,36,101,0.356,32,77,0.416,4,24,0.167,15,20,0.75,91
980,MIL,2016-03-30,105,,PHO,1,240,37,77,0.481,31,62,0.5,6,15,0.4,25,34,0.735,105,38,84,0.452,33,60,0.55,5,24,0.208,13,17,0.765,94
981,TOR,2016-03-30,105,,ATL,1,240,36,80,0.45,25,57,0.439,11,23,0.478,22,28,0.786,105,37,83,0.446,23,50,0.46,14,33,0.424,9,13,0.692,97
982,MEM,2016-03-30,105,,DEN,0,240,41,95,0.432,35,76,0.461,6,19,0.316,17,27,0.63,105,38,78,0.487,25,49,0.51,13,29,0.448,20,24,0.833,109
983,BRK,2016-03-29,105,@,ORL,0,240,37,79,0.468,32,65,0.492,5,14,0.357,26,39,0.667,105,56,91,0.615,42,64,0.656,14,27,0.519,13,19,0.684,139
984,POR,2016-03-28,105,,SAC,1,240,38,80,0.475,24,51,0.471,14,29,0.483,15,18,0.833,105,37,89,0.416,30,74,0.405,7,15,0.467,12,19,0.632,93
985,PHI,2016-03-27,105,@,GSW,0,240,42,90,0.467,32,60,0.533,10,30,0.333,11,12,0.917,105,44,83,0.53,30,50,0.6,14,33,0.424,15,20,0.75,117
986,LAC,2016-03-27,105,,DEN,1,240,38,80,0.475,28,52,0.538,10,28,0.357,19,26,0.731,105,37,94,0.394,30,65,0.462,7,29,0.241,9,13,0.692,90
987,PHI,2016-03-26,105,@,POR,0,240,39,93,0.419,29,55,0.527,10,38,0.263,17,24,0.708,105,38,91,0.418,30,66,0.455,8,25,0.32,24,30,0.8,108
988,CHO,2016-03-25,105,@,DET,0,240,37,93,0.398,23,63,0.365,14,30,0.467,17,22,0.773,105,42,91,0.462,34,61,0.557,8,30,0.267,20,26,0.769,112
989,LAL,2016-03-25,105,,DEN,0,240,37,85,0.435,27,62,0.435,10,23,0.435,21,26,0.808,105,45,94,0.479,35,68,0.515,10,26,0.385,16,24,0.667,116
990,CHO,2016-03-22,105,@,BRK,1,240,39,82,0.476,29,54,0.537,10,28,0.357,17,21,0.81,105,34,74,0.459,26,56,0.464,8,18,0.444,24,27,0.889,100
991,LAC,2016-03-20,105,@,NOP,0,240,33,82,0.402,23,43,0.535,10,39,0.256,29,42,0.69,105,35,71,0.493,28,50,0.56,7,21,0.333,32,40,0.8,109
992,PHI,2016-03-20,105,,BOS,0,240,39,92,0.424,31,71,0.437,8,21,0.381,19,27,0.704,105,46,94,0.489,36,69,0.522,10,25,0.4,18,21,0.857,120
993,TOR,2016-03-20,105,,ORL,1,240,35,81,0.432,29,61,0.475,6,20,0.3,29,45,0.644,105,40,83,0.482,32,61,0.525,8,22,0.364,12,18,0.667,100
994,TOR,2016-03-18,105,,BOS,1,240,37,77,0.481,24,49,0.49,13,28,0.464,18,25,0.72,105,36,82,0.439,27,61,0.443,9,21,0.429,10,12,0.833,91
995,DAL,2016-03-12,105,,IND,0,240,41,85,0.482,33,63,0.524,8,22,0.364,15,18,0.833,105,38,81,0.469,29,53,0.547,9,28,0.321,27,29,0.931,112
996,BOS,2016-03-04,105,,NYK,1,240,41,90,0.456,37,70,0.529,4,20,0.2,19,25,0.76,105,42,92,0.457,33,69,0.478,9,23,0.391,11,14,0.786,104
997,ATL,2016-03-01,105,@,GSW,0,265,37,80,0.463,25,47,0.532,12,33,0.364,19,24,0.792,105,41,103,0.398,29,67,0.433,12,36,0.333,15,17,0.882,109
998,LAC,2016-02-29,105,,BRK,1,240,41,83,0.494,32,60,0.533,9,23,0.391,14,16,0.875,105,32,77,0.416,24,58,0.414,8,19,0.421,23,33,0.697,95
999,POR,2016-02-25,105,,HOU,0,240,37,80,0.463,24,45,0.533,13,35,0.371,18,22,0.818,105,44,82,0.537,34,53,0.642,10,29,0.345,21,35,0.6,119
1000,MIN,2016-02-24,105,@,TOR,0,240,37,74,0.5,31,64,0.484,6,10,0.6,25,33,0.758,105,41,85,0.482,31,59,0.525,10,26,0.385,22,26,0.846,114
1001,NYK,2016-02-24,105,@,IND,0,240,35,77,0.455,22,51,0.431,13,26,0.5,22,25,0.88,105,46,91,0.505,43,76,0.566,3,15,0.2,13,16,0.813,108
1002,IND,2016-02-21,105,@,ORL,1,240,41,82,0.5,32,58,0.552,9,24,0.375,14,21,0.667,105,38,91,0.418,31,66,0.47,7,25,0.28,19,29,0.655,102
1003,GSW,2016-02-19,105,@,POR,0,240,36,92,0.391,24,58,0.414,12,34,0.353,21,28,0.75,105,52,97,0.536,35,67,0.522,17,30,0.567,16,23,0.696,137
1004,LAC,2016-02-18,105,,SAS,1,240,39,78,0.5,27,53,0.509,12,25,0.48,15,20,0.75,105,35,83,0.422,31,66,0.47,4,17,0.235,12,15,0.8,86
1005,BRK,2016-02-08,105,,DEN,1,240,42,81,0.519,33,62,0.532,9,19,0.474,12,15,0.8,105,42,90,0.467,33,65,0.508,9,25,0.36,11,13,0.846,104
1006,CHI,2016-02-06,105,@,MIN,0,240,40,85,0.471,32,65,0.492,8,20,0.4,17,19,0.895,105,45,87,0.517,44,75,0.587,1,12,0.083,21,22,0.955,112
1007,PHO,2016-02-04,105,,HOU,0,240,32,83,0.386,21,54,0.389,11,29,0.379,30,32,0.938,105,37,86,0.43,22,44,0.5,15,42,0.357,22,32,0.688,111
1008,NYK,2016-02-04,105,@,DET,0,240,36,84,0.429,30,62,0.484,6,22,0.273,27,34,0.794,105,40,79,0.506,31,62,0.5,9,17,0.529,22,33,0.667,111
1009,DET,2016-02-01,105,@,BRK,1,240,42,98,0.429,32,68,0.471,10,30,0.333,11,16,0.688,105,40,82,0.488,33,66,0.5,7,16,0.438,13,15,0.867,100
1010,UTA,2016-02-01,105,,CHI,1,265,38,85,0.447,31,67,0.463,7,18,0.389,22,33,0.667,105,39,90,0.433,34,69,0.493,5,21,0.238,13,20,0.65,96
1011,MIA,2016-01-31,105,,ATL,1,240,39,81,0.481,34,61,0.557,5,20,0.25,22,26,0.846,105,27,70,0.386,22,48,0.458,5,22,0.227,28,32,0.875,87
1012,NOP,2016-01-30,105,,BRK,1,240,43,93,0.462,32,66,0.485,11,27,0.407,8,10,0.8,105,40,84,0.476,31,64,0.484,9,20,0.45,14,23,0.609,103
1013,PHI,2016-01-30,105,,GSW,0,240,42,92,0.457,32,63,0.508,10,29,0.345,11,21,0.524,105,47,95,0.495,34,65,0.523,13,30,0.433,1,2,0.5,108
1014,DEN,2016-01-30,105,@,IND,0,265,40,87,0.46,36,69,0.522,4,18,0.222,21,25,0.84,105,44,100,0.44,35,73,0.479,9,27,0.333,12,16,0.75,109
1015,LAC,2016-01-29,105,,LAL,1,240,40,81,0.494,32,55,0.582,8,26,0.308,17,24,0.708,105,34,78,0.436,29,65,0.446,5,13,0.385,20,25,0.8,93
1016,SAC,2016-01-28,105,@,NOP,0,240,40,89,0.449,30,61,0.492,10,28,0.357,15,20,0.75,105,43,98,0.439,33,72,0.458,10,26,0.385,18,24,0.75,114
1017,DEN,2016-01-25,105,,ATL,0,240,33,84,0.393,27,64,0.422,6,20,0.3,33,37,0.892,105,43,86,0.5,34,59,0.576,9,27,0.333,24,26,0.923,119
1018,MIL,2016-01-16,105,@,CHO,1,240,39,72,0.542,34,60,0.567,5,12,0.417,22,26,0.846,105,33,87,0.379,24,51,0.471,9,36,0.25,17,22,0.773,92
1019,WAS,2016-01-09,105,@,ORL,1,240,42,76,0.553,29,53,0.547,13,23,0.565,8,10,0.8,105,38,74,0.514,33,60,0.55,5,14,0.357,18,24,0.75,99
1020,CHI,2016-01-09,105,@,ATL,0,240,36,83,0.434,29,65,0.446,7,18,0.389,26,31,0.839,105,49,94,0.521,39,70,0.557,10,24,0.417,12,15,0.8,120
1021,NOP,2016-01-02,105,@,DAL,1,240,40,83,0.482,34,63,0.54,6,20,0.3,19,24,0.792,105,36,83,0.434,26,57,0.456,10,26,0.385,16,19,0.842,98
1022,SAC,2015-12-30,105,,PHI,0,240,36,74,0.486,28,49,0.571,8,25,0.32,25,41,0.61,105,40,94,0.426,31,63,0.492,9,31,0.29,21,34,0.618,110
1023,MIA,2015-12-28,105,,BRK,0,240,36,78,0.462,26,54,0.481,10,24,0.417,23,30,0.767,105,36,82,0.439,24,59,0.407,12,23,0.522,27,36,0.75,111
1024,POR,2015-12-26,105,,CLE,1,240,41,89,0.461,32,67,0.478,9,22,0.409,14,19,0.737,105,28,77,0.364,17,46,0.37,11,31,0.355,9,15,0.6,76
1025,CHI,2015-12-25,105,@,OKC,1,240,40,92,0.435,33,74,0.446,7,18,0.389,18,20,0.9,105,37,96,0.385,31,72,0.431,6,24,0.25,16,23,0.696,96
1026,BRK,2015-12-21,105,@,CHI,1,240,43,94,0.457,36,74,0.486,7,20,0.35,12,14,0.857,105,43,95,0.453,34,69,0.493,9,26,0.346,7,13,0.538,102
1027,POR,2015-12-14,105,,NOP,1,240,35,81,0.432,22,49,0.449,13,32,0.406,22,29,0.759,105,36,82,0.439,28,57,0.491,8,25,0.32,21,27,0.778,101
1028,ORL,2015-12-14,105,@,BRK,1,240,41,76,0.539,32,55,0.582,9,21,0.429,14,20,0.7,105,31,80,0.388,24,61,0.393,7,19,0.368,13,16,0.813,82
1029,LAC,2015-12-14,105,@,DET,1,265,44,97,0.454,38,78,0.487,6,19,0.316,11,15,0.733,105,37,89,0.416,31,70,0.443,6,19,0.316,23,31,0.742,103
1030,LAC,2015-12-12,105,@,BRK,1,240,43,86,0.5,35,62,0.565,8,24,0.333,11,18,0.611,105,35,79,0.443,30,60,0.5,5,19,0.263,25,30,0.833,100
1031,WAS,2015-12-11,105,@,NOP,0,240,40,80,0.5,28,53,0.528,12,27,0.444,13,21,0.619,105,39,79,0.494,23,52,0.442,16,27,0.593,13,18,0.722,107
1032,BOS,2015-12-09,105,,CHI,1,240,38,92,0.413,33,69,0.478,5,23,0.217,24,28,0.857,105,39,91,0.429,33,70,0.471,6,21,0.286,16,23,0.696,100
1033,HOU,2015-12-08,105,@,BRK,0,240,39,82,0.476,24,47,0.511,15,35,0.429,12,17,0.706,105,45,81,0.556,38,63,0.603,7,18,0.389,13,16,0.813,110
1034,CLE,2015-12-08,105,,POR,1,240,40,79,0.506,31,58,0.534,9,21,0.429,16,20,0.8,105,40,79,0.506,29,53,0.547,11,26,0.423,9,16,0.563,100
1035,BOS,2015-12-05,105,@,SAS,0,240,39,86,0.453,27,57,0.474,12,29,0.414,15,22,0.682,105,44,83,0.53,39,66,0.591,5,17,0.294,15,22,0.682,108
1036,PHI,2015-12-05,105,,DEN,0,240,37,74,0.5,22,43,0.512,15,31,0.484,16,26,0.615,105,37,81,0.457,26,50,0.52,11,31,0.355,23,38,0.605,108
1037,TOR,2015-12-03,105,,DEN,0,240,39,92,0.424,31,65,0.477,8,27,0.296,19,22,0.864,105,38,81,0.469,26,54,0.481,12,27,0.444,18,18,1.0,106
1038,HOU,2015-11-30,105,@,DET,0,240,35,88,0.398,24,61,0.393,11,27,0.407,24,28,0.857,105,45,85,0.529,37,62,0.597,8,23,0.348,18,37,0.486,116
1039,BOS,2015-11-30,105,@,MIA,1,240,38,80,0.475,30,60,0.5,8,20,0.4,21,25,0.84,105,36,75,0.48,31,58,0.534,5,17,0.294,18,24,0.75,95
1040,DEN,2015-11-22,105,,GSW,0,240,37,86,0.43,33,71,0.465,4,15,0.267,27,35,0.771,105,47,89,0.528,32,60,0.533,15,29,0.517,9,13,0.692,118
1041,PHO,2015-11-14,105,,DEN,1,240,37,84,0.44,26,60,0.433,11,24,0.458,20,26,0.769,105,34,98,0.347,28,63,0.444,6,35,0.171,7,8,0.875,81
1042,CLE,2015-11-14,105,@,MIL,0,290,37,91,0.407,23,53,0.434,14,38,0.368,17,27,0.63,105,43,102,0.422,37,86,0.43,6,16,0.375,16,22,0.727,108
1043,DAL,2015-11-10,105,@,NOP,0,240,39,88,0.443,34,68,0.5,5,20,0.25,22,26,0.846,105,46,92,0.5,32,59,0.542,14,33,0.424,14,18,0.778,120
1044,LAC,2015-11-07,105,,HOU,0,240,42,88,0.477,38,66,0.576,4,22,0.182,17,25,0.68,105,38,86,0.442,31,56,0.554,7,30,0.233,26,29,0.897,109
1045,ORL,2015-11-07,105,@,PHI,1,240,39,83,0.47,33,70,0.471,6,13,0.462,21,24,0.875,105,36,80,0.45,25,47,0.532,11,33,0.333,14,26,0.538,97
1046,CHI,2015-11-03,105,@,CHO,0,240,44,90,0.489,30,60,0.5,14,30,0.467,3,8,0.375,105,47,91,0.516,33,68,0.485,14,23,0.609,22,23,0.957,130
1047,OKC,2015-11-02,105,@,HOU,0,240,40,84,0.476,30,61,0.492,10,23,0.435,15,22,0.682,105,41,89,0.461,32,60,0.533,9,29,0.31,19,29,0.655,110
1048,DEN,2015-10-28,105,@,HOU,1,240,40,79,0.506,27,52,0.519,13,27,0.481,12,18,0.667,105,30,87,0.345,22,52,0.423,8,35,0.229,17,26,0.654,85
1049,MEM,2016-04-13,104,@,GSW,0,240,42,98,0.429,34,74,0.459,8,24,0.333,12,16,0.75,104,46,87,0.529,26,40,0.65,20,47,0.426,13,16,0.813,125
1050,BOS,2016-04-06,104,,NOP,1,240,36,87,0.414,26,53,0.491,10,34,0.294,22,27,0.815,104,34,78,0.436,25,54,0.463,9,24,0.375,20,23,0.87,97
1051,ORL,2016-04-06,104,,DET,0,240,43,90,0.478,39,75,0.52,4,15,0.267,14,19,0.737,104,39,86,0.453,28,59,0.475,11,27,0.407,19,31,0.613,108
1052,IND,2016-03-27,104,,HOU,1,240,41,87,0.471,32,61,0.525,9,26,0.346,13,20,0.65,104,38,85,0.447,31,52,0.596,7,33,0.212,18,27,0.667,101
1053,MEM,2016-03-25,104,@,SAS,0,240,44,83,0.53,37,65,0.569,7,18,0.389,9,13,0.692,104,44,77,0.571,37,59,0.627,7,18,0.389,15,18,0.833,110
1054,BRK,2016-03-24,104,,CLE,1,240,41,89,0.461,33,67,0.493,8,22,0.364,14,19,0.737,104,39,89,0.438,29,51,0.569,10,38,0.263,7,9,0.778,95
1055,DEN,2016-03-23,104,,PHI,1,240,33,76,0.434,27,59,0.458,6,17,0.353,32,40,0.8,104,37,94,0.394,22,57,0.386,15,37,0.405,14,15,0.933,103
1056,MIL,2016-03-23,104,@,CLE,0,240,43,80,0.538,36,64,0.563,7,16,0.438,11,15,0.733,104,40,83,0.482,30,49,0.612,10,34,0.294,23,27,0.852,113
1057,SAC,2016-03-23,104,@,MIN,0,240,42,91,0.462,34,71,0.479,8,20,0.4,12,23,0.522,104,45,80,0.563,40,67,0.597,5,13,0.385,18,32,0.563,113
1058,MIN,2016-03-21,104,,GSW,0,240,36,82,0.439,29,63,0.46,7,19,0.368,25,30,0.833,104,43,87,0.494,35,63,0.556,8,24,0.333,15,24,0.625,109
1059,MIN,2016-03-14,104,@,PHO,0,240,37,84,0.44,33,68,0.485,4,16,0.25,26,30,0.867,104,40,95,0.421,29,60,0.483,11,35,0.314,16,20,0.8,107
1060,ATL,2016-03-13,104,,IND,1,240,40,85,0.471,25,55,0.455,15,30,0.5,9,10,0.9,104,33,87,0.379,28,63,0.444,5,24,0.208,4,7,0.571,75
1061,MIA,2016-03-12,104,@,TOR,0,265,37,98,0.378,28,73,0.384,9,25,0.36,21,26,0.808,104,37,84,0.44,31,66,0.47,6,18,0.333,32,38,0.842,112
1062,TOR,2016-03-10,104,,ATL,1,240,38,82,0.463,31,58,0.534,7,24,0.292,21,29,0.724,104,35,82,0.427,28,59,0.475,7,23,0.304,19,27,0.704,96
1063,PHI,2016-03-09,104,,HOU,0,240,35,86,0.407,23,53,0.434,12,33,0.364,22,32,0.688,104,38,86,0.442,27,53,0.509,11,33,0.333,31,41,0.756,118
1064,TOR,2016-03-08,104,,BRK,1,240,37,78,0.474,27,55,0.491,10,23,0.435,20,25,0.8,104,42,82,0.512,36,70,0.514,6,12,0.5,9,9,1.0,99
1065,OKC,2016-03-06,104,@,MIL,1,240,32,76,0.421,25,51,0.49,7,25,0.28,33,43,0.767,104,34,90,0.378,31,71,0.437,3,19,0.158,25,30,0.833,96
1066,SAS,2016-03-05,104,,SAC,1,240,40,81,0.494,32,58,0.552,8,23,0.348,16,19,0.842,104,37,81,0.457,31,65,0.477,6,16,0.375,14,21,0.667,94
1067,NYK,2016-03-04,104,@,BOS,0,240,42,92,0.457,33,69,0.478,9,23,0.391,11,14,0.786,104,41,90,0.456,37,70,0.529,4,20,0.2,19,25,0.76,105
1068,SAC,2016-03-03,104,@,DAL,1,240,42,80,0.525,35,55,0.636,7,25,0.28,13,24,0.542,104,45,94,0.479,38,65,0.585,7,29,0.241,4,6,0.667,101
1069,IND,2016-03-02,104,@,MIL,1,240,38,80,0.475,28,60,0.467,10,20,0.5,18,26,0.692,104,34,76,0.447,31,62,0.5,3,14,0.214,28,32,0.875,99
1070,WAS,2016-03-02,104,@,MIN,1,240,42,84,0.5,31,55,0.564,11,29,0.379,9,13,0.692,104,32,75,0.427,27,61,0.443,5,14,0.357,29,34,0.853,98
1071,MEM,2016-03-02,104,,SAC,1,240,35,79,0.443,30,61,0.492,5,18,0.278,29,33,0.879,104,39,82,0.476,30,56,0.536,9,26,0.346,11,20,0.55,98
1072,TOR,2016-03-02,104,,UTA,1,240,40,80,0.5,34,58,0.586,6,22,0.273,18,21,0.857,104,37,83,0.446,27,57,0.474,10,26,0.385,10,16,0.625,94
1073,POR,2016-03-01,104,@,NYK,1,240,37,88,0.42,25,58,0.431,12,30,0.4,18,20,0.9,104,33,88,0.375,27,67,0.403,6,21,0.286,13,18,0.722,85
1074,SAS,2016-02-27,104,@,HOU,1,240,37,76,0.487,29,57,0.509,8,19,0.421,22,28,0.786,104,35,84,0.417,27,59,0.458,8,25,0.32,16,22,0.727,94
1075,WAS,2016-02-24,104,@,CHI,0,240,38,90,0.422,29,62,0.468,9,28,0.321,19,26,0.731,104,44,88,0.5,36,65,0.554,8,23,0.348,13,16,0.813,109
1076,BRK,2016-02-23,104,@,POR,0,240,43,90,0.478,40,78,0.513,3,12,0.25,15,19,0.789,104,40,80,0.5,30,57,0.526,10,23,0.435,22,25,0.88,112
1077,CHO,2016-02-21,104,@,BRK,1,240,40,79,0.506,30,52,0.577,10,27,0.37,14,15,0.933,104,35,81,0.432,30,59,0.508,5,22,0.227,21,24,0.875,96
1078,MIN,2016-02-19,104,@,MEM,0,240,31,75,0.413,20,49,0.408,11,26,0.423,31,31,1.0,104,40,82,0.488,33,61,0.541,7,21,0.333,22,28,0.786,109
1079,DAL,2016-02-19,104,@,ORL,0,265,37,89,0.416,18,48,0.375,19,41,0.463,11,18,0.611,104,41,102,0.402,28,67,0.418,13,35,0.371,15,17,0.882,110
1080,PHO,2016-02-10,104,,GSW,0,240,41,93,0.441,35,72,0.486,6,21,0.286,16,22,0.727,104,37,89,0.416,23,49,0.469,14,40,0.35,24,29,0.828,112
1081,DEN,2016-02-08,104,@,BRK,0,240,42,90,0.467,33,65,0.508,9,25,0.36,11,13,0.846,104,42,81,0.519,33,62,0.532,9,19,0.474,12,15,0.8,105
1082,WAS,2016-02-06,104,@,CHO,0,240,38,86,0.442,29,61,0.475,9,25,0.36,19,24,0.792,104,38,81,0.469,26,54,0.481,12,27,0.444,20,25,0.8,108
1083,DET,2016-02-06,104,@,IND,0,240,38,79,0.481,26,46,0.565,12,33,0.364,16,31,0.516,104,41,76,0.539,35,65,0.538,6,11,0.545,24,29,0.828,112
1084,BOS,2016-02-05,104,@,CLE,1,240,38,88,0.432,31,68,0.456,7,20,0.35,21,25,0.84,104,37,87,0.425,29,57,0.509,8,30,0.267,21,35,0.6,103
1085,TOR,2016-02-02,104,@,PHO,1,240,35,74,0.473,26,47,0.553,9,27,0.333,25,32,0.781,104,37,79,0.468,25,48,0.521,12,31,0.387,11,15,0.733,97
1086,MIL,2016-02-01,104,@,SAC,0,240,42,84,0.5,34,64,0.531,8,20,0.4,12,17,0.706,104,39,86,0.453,30,60,0.5,9,26,0.346,24,30,0.8,111
1087,DAL,2016-01-24,104,@,HOU,0,240,36,79,0.456,21,49,0.429,15,30,0.5,17,22,0.773,104,43,89,0.483,28,45,0.622,15,44,0.341,14,21,0.667,115
1088,DEN,2016-01-23,104,,DET,1,240,36,78,0.462,28,56,0.5,8,22,0.364,24,29,0.828,104,40,84,0.476,29,55,0.527,11,29,0.379,10,19,0.526,101
1089,ATL,2016-01-20,104,@,POR,1,240,39,87,0.448,29,63,0.46,10,24,0.417,16,23,0.696,104,41,94,0.436,32,63,0.508,9,31,0.29,7,11,0.636,98
1090,DEN,2016-01-19,104,,OKC,0,240,35,83,0.422,28,63,0.444,7,20,0.35,27,36,0.75,104,41,97,0.423,35,69,0.507,6,28,0.214,22,30,0.733,110
1091,IND,2016-01-15,104,,WAS,0,240,38,80,0.475,35,63,0.556,3,17,0.176,25,32,0.781,104,51,98,0.52,40,73,0.548,11,25,0.44,5,10,0.5,118
1092,BRK,2016-01-15,104,,POR,0,240,38,85,0.447,30,66,0.455,8,19,0.421,20,28,0.714,104,47,93,0.505,32,58,0.552,15,35,0.429,7,11,0.636,116
1093,NYK,2016-01-13,104,@,BRK,0,240,41,91,0.451,34,69,0.493,7,22,0.318,15,23,0.652,104,45,86,0.523,36,69,0.522,9,17,0.529,11,14,0.786,110
1094,MIN,2016-01-13,104,@,HOU,0,240,36,78,0.462,28,61,0.459,8,17,0.471,24,30,0.8,104,37,75,0.493,30,45,0.667,7,30,0.233,26,38,0.684,107
1095,LAC,2016-01-13,104,,MIA,1,240,40,94,0.426,29,69,0.42,11,25,0.44,13,16,0.813,104,31,70,0.443,22,46,0.478,9,24,0.375,19,29,0.655,90
1096,OKC,2016-01-04,104,,SAC,0,240,39,89,0.438,29,60,0.483,10,29,0.345,16,23,0.696,104,40,89,0.449,33,72,0.458,7,17,0.412,29,39,0.744,116
1097,CLE,2016-01-02,104,,ORL,1,240,34,82,0.415,22,45,0.489,12,37,0.324,24,39,0.615,104,29,76,0.382,23,51,0.451,6,25,0.24,15,17,0.882,79
1098,TOR,2016-01-01,104,,CHO,1,240,36,91,0.396,21,58,0.362,15,33,0.455,17,18,0.944,104,34,85,0.4,24,53,0.453,10,32,0.313,16,18,0.889,94
1099,BOS,2015-12-30,104,,LAL,0,240,38,88,0.432,31,61,0.508,7,27,0.259,21,25,0.84,104,43,94,0.457,34,75,0.453,9,19,0.474,17,23,0.739,112
1100,CHI,2015-12-28,104,,TOR,1,240,40,87,0.46,32,66,0.485,8,21,0.381,16,24,0.667,104,38,88,0.432,32,68,0.471,6,20,0.3,15,24,0.625,97
1101,ORL,2015-12-28,104,,NOP,1,240,45,82,0.549,38,65,0.585,7,17,0.412,7,11,0.636,104,37,83,0.446,32,63,0.508,5,20,0.25,10,15,0.667,89
1102,UTA,2015-12-26,104,,LAC,0,240,36,74,0.486,26,47,0.553,10,27,0.37,22,27,0.815,104,38,79,0.481,25,53,0.472,13,26,0.5,20,24,0.833,109
1103,PHO,2015-12-26,104,,PHI,0,240,34,88,0.386,24,61,0.393,10,27,0.37,26,34,0.765,104,38,79,0.481,26,52,0.5,12,27,0.444,23,27,0.852,111
1104,DEN,2015-12-23,104,@,PHO,1,240,42,91,0.462,28,56,0.5,14,35,0.4,6,13,0.462,104,36,87,0.414,23,62,0.371,13,25,0.52,11,17,0.647,96
1105,ORL,2015-12-23,104,,HOU,1,240,44,84,0.524,37,68,0.544,7,16,0.438,9,13,0.692,104,41,83,0.494,34,54,0.63,7,29,0.241,12,17,0.706,101
1106,MEM,2015-12-22,104,@,PHI,1,240,40,85,0.471,35,70,0.5,5,15,0.333,19,24,0.792,104,31,66,0.47,24,43,0.558,7,23,0.304,21,32,0.656,90
1107,SAC,2015-12-20,104,@,TOR,1,240,40,76,0.526,31,55,0.564,9,21,0.429,15,24,0.625,104,35,94,0.372,27,65,0.415,8,29,0.276,16,17,0.941,94
1108,PHO,2015-12-18,104,,NOP,1,240,44,84,0.524,38,68,0.559,6,16,0.375,10,17,0.588,104,26,71,0.366,22,49,0.449,4,22,0.182,32,38,0.842,88
1109,IND,2015-12-18,104,,BRK,1,240,37,89,0.416,30,61,0.492,7,28,0.25,23,26,0.885,104,36,86,0.419,28,70,0.4,8,16,0.5,17,17,1.0,97
1110,CLE,2015-12-17,104,,OKC,1,240,41,88,0.466,29,59,0.492,12,29,0.414,10,13,0.769,104,35,74,0.473,29,54,0.537,6,20,0.3,24,28,0.857,100
1111,NOP,2015-12-16,104,@,UTA,1,240,34,73,0.466,24,52,0.462,10,21,0.476,26,28,0.929,104,32,67,0.478,25,47,0.532,7,20,0.35,23,29,0.793,94
1112,MIA,2015-12-16,104,@,BRK,1,240,40,75,0.533,33,54,0.611,7,21,0.333,17,24,0.708,104,42,89,0.472,38,73,0.521,4,16,0.25,10,14,0.714,98
1113,DAL,2015-12-14,104,,PHO,1,240,38,77,0.494,26,45,0.578,12,32,0.375,16,21,0.762,104,33,80,0.413,24,55,0.436,9,25,0.36,19,27,0.704,94
1114,OKC,2015-12-13,104,,UTA,1,265,35,79,0.443,28,58,0.483,7,21,0.333,27,30,0.9,104,39,94,0.415,31,72,0.431,8,22,0.364,12,20,0.6,98
1115,ORL,2015-12-09,104,@,PHO,0,240,40,85,0.471,28,60,0.467,12,25,0.48,12,16,0.75,104,41,80,0.513,35,56,0.625,6,24,0.25,19,27,0.704,107
1116,DAL,2015-12-07,104,@,NYK,1,240,37,82,0.451,24,51,0.471,13,31,0.419,17,20,0.85,104,40,84,0.476,31,59,0.525,9,25,0.36,8,9,0.889,97
1117,CHO,2015-12-07,104,,DET,1,240,36,84,0.429,28,58,0.483,8,26,0.308,24,35,0.686,104,32,87,0.368,22,53,0.415,10,34,0.294,10,22,0.455,84
1118,WAS,2015-12-06,104,,DAL,0,240,42,89,0.472,34,62,0.548,8,27,0.296,12,21,0.571,104,38,76,0.5,22,45,0.489,16,31,0.516,24,27,0.889,116
1119,WAS,2015-12-02,104,,LAL,0,240,37,79,0.468,30,58,0.517,7,21,0.333,23,31,0.742,104,41,96,0.427,33,71,0.465,8,25,0.32,18,20,0.9,108
1120,NOP,2015-12-01,104,,MEM,0,240,35,81,0.432,26,54,0.481,9,27,0.333,25,33,0.758,104,43,90,0.478,41,80,0.513,2,10,0.2,25,26,0.962,113
1121,IND,2015-11-27,104,,CHI,1,240,37,87,0.425,29,59,0.492,8,28,0.286,22,29,0.759,104,32,92,0.348,21,66,0.318,11,26,0.423,17,20,0.85,92
1122,DET,2015-11-25,104,,MIA,1,240,41,98,0.418,25,67,0.373,16,31,0.516,6,7,0.857,104,32,79,0.405,26,59,0.441,6,20,0.3,11,16,0.688,81
1123,NOP,2015-11-20,104,,SAS,1,240,40,88,0.455,32,66,0.485,8,22,0.364,16,17,0.941,104,34,84,0.405,25,67,0.373,9,17,0.529,13,16,0.813,90
1124,ORL,2015-11-18,104,,MIN,1,265,41,110,0.373,32,89,0.36,9,21,0.429,13,21,0.619,104,36,85,0.424,32,67,0.478,4,18,0.222,25,30,0.833,101
1125,DET,2015-11-17,104,,CLE,1,240,36,84,0.429,29,63,0.46,7,21,0.333,25,31,0.806,104,38,80,0.475,27,47,0.574,11,33,0.333,12,20,0.6,99
1126,LAC,2015-11-12,104,@,PHO,0,240,40,90,0.444,31,64,0.484,9,26,0.346,15,28,0.536,104,44,83,0.53,30,53,0.566,14,30,0.467,16,21,0.762,118
1127,CHO,2015-11-10,104,@,MIN,1,240,38,78,0.487,30,52,0.577,8,26,0.308,20,27,0.741,104,36,80,0.45,27,61,0.443,9,19,0.474,14,19,0.737,95
1128,POR,2015-11-09,104,@,DEN,0,240,36,91,0.396,26,62,0.419,10,29,0.345,22,27,0.815,104,40,77,0.519,33,58,0.569,7,19,0.368,21,32,0.656,108
1129,LAL,2015-11-06,104,@,BRK,1,240,33,78,0.423,26,55,0.473,7,23,0.304,31,40,0.775,104,40,93,0.43,37,74,0.5,3,19,0.158,15,20,0.75,98
1130,DEN,2015-11-06,104,@,GSW,0,240,39,92,0.424,31,68,0.456,8,24,0.333,18,22,0.818,104,46,93,0.495,29,56,0.518,17,37,0.459,10,18,0.556,119
1131,CHI,2015-11-05,104,,OKC,1,240,40,90,0.444,33,72,0.458,7,18,0.389,17,21,0.81,104,38,84,0.452,33,71,0.465,5,13,0.385,17,20,0.85,98
1132,LAC,2015-10-29,104,,DAL,1,240,38,87,0.437,30,56,0.536,8,31,0.258,20,33,0.606,104,35,97,0.361,29,67,0.433,6,30,0.2,12,15,0.8,88
1133,SAC,2015-10-28,104,,LAC,0,240,41,94,0.436,30,70,0.429,11,24,0.458,11,18,0.611,104,42,80,0.525,36,61,0.59,6,19,0.316,21,31,0.677,111
1134,MIA,2015-10-28,104,,CHO,1,240,36,73,0.493,24,53,0.453,12,20,0.6,20,21,0.952,104,33,84,0.393,27,60,0.45,6,24,0.25,22,29,0.759,94
1135,ORL,2016-04-13,103,@,CHO,0,240,42,91,0.462,34,64,0.531,8,27,0.296,11,18,0.611,103,47,86,0.547,36,57,0.632,11,29,0.379,12,19,0.632,117
1136,TOR,2016-04-13,103,@,BRK,1,240,41,93,0.441,28,56,0.5,13,37,0.351,8,15,0.533,103,39,89,0.438,29,63,0.46,10,26,0.385,8,12,0.667,96
1137,DAL,2016-04-08,103,,MEM,1,240,30,60,0.5,18,29,0.621,12,31,0.387,31,39,0.795,103,35,87,0.402,28,65,0.431,7,22,0.318,16,22,0.727,93
1138,BRK,2016-04-06,103,@,WAS,0,240,39,92,0.424,32,75,0.427,7,17,0.412,18,24,0.75,103,48,95,0.505,40,67,0.597,8,28,0.286,17,20,0.85,121
1139,LAC,2016-04-05,103,,LAL,1,240,40,78,0.513,33,58,0.569,7,20,0.35,16,26,0.615,103,26,83,0.313,20,63,0.317,6,20,0.3,23,25,0.92,81
1140,ATL,2016-04-05,103,,PHO,1,240,39,95,0.411,28,61,0.459,11,34,0.324,14,19,0.737,103,30,81,0.37,18,50,0.36,12,31,0.387,18,30,0.6,90
1141,CHO,2016-04-03,103,@,CLE,0,240,34,76,0.447,25,50,0.5,9,26,0.346,26,27,0.963,103,45,83,0.542,29,54,0.537,16,29,0.552,6,13,0.462,112
1142,CHI,2016-03-31,103,@,HOU,1,240,37,77,0.481,26,53,0.491,11,24,0.458,18,22,0.818,103,36,90,0.4,27,65,0.415,9,25,0.36,19,22,0.864,100
1143,GSW,2016-03-30,103,@,UTA,1,265,39,89,0.438,27,54,0.5,12,35,0.343,13,18,0.722,103,37,92,0.402,28,60,0.467,9,32,0.281,13,29,0.448,96
1144,PHI,2016-03-23,103,@,DEN,0,240,37,94,0.394,22,57,0.386,15,37,0.405,14,15,0.933,103,33,76,0.434,27,59,0.458,6,17,0.353,32,40,0.8,104
1145,DAL,2016-03-23,103,@,POR,0,240,42,96,0.438,33,66,0.5,9,30,0.3,10,11,0.909,103,40,89,0.449,33,62,0.532,7,27,0.259,22,25,0.88,109
1146,MEM,2016-03-21,103,@,PHO,1,240,39,90,0.433,31,70,0.443,8,20,0.4,17,19,0.895,103,30,76,0.395,19,48,0.396,11,28,0.393,26,34,0.765,97
1147,BRK,2016-03-19,103,@,DET,0,240,42,80,0.525,37,66,0.561,5,14,0.357,14,21,0.667,103,46,94,0.489,36,70,0.514,10,24,0.417,13,21,0.619,115
1148,ORL,2016-03-18,103,,CLE,0,240,37,82,0.451,26,60,0.433,11,22,0.5,18,22,0.818,103,38,76,0.5,25,48,0.521,13,28,0.464,20,27,0.741,109
1149,UTA,2016-03-17,103,,PHO,1,240,43,88,0.489,32,63,0.508,11,25,0.44,6,9,0.667,103,28,82,0.341,22,56,0.393,6,26,0.231,7,14,0.5,69
1150,IND,2016-03-15,103,,BOS,1,240,39,84,0.464,34,72,0.472,5,12,0.417,20,28,0.714,103,36,94,0.383,28,63,0.444,8,31,0.258,18,22,0.818,98
1151,MIL,2016-03-12,103,,NOP,1,240,40,81,0.494,36,68,0.529,4,13,0.308,19,24,0.792,103,35,89,0.393,29,60,0.483,6,29,0.207,16,21,0.762,92
1152,DET,2016-03-11,103,@,CHO,0,240,36,76,0.474,27,46,0.587,9,30,0.3,22,27,0.815,103,42,83,0.506,32,58,0.552,10,25,0.4,24,29,0.828,118
1153,MIN,2016-03-07,103,@,CHO,0,240,39,80,0.488,35,65,0.538,4,15,0.267,21,24,0.875,103,41,90,0.456,29,60,0.483,12,30,0.4,14,17,0.824,108
1154,CLE,2016-03-07,103,,MEM,0,240,36,80,0.45,29,51,0.569,7,29,0.241,24,29,0.828,103,41,86,0.477,35,66,0.53,6,20,0.3,18,22,0.818,106
1155,MIA,2016-03-06,103,,PHI,1,240,36,81,0.444,28,67,0.418,8,14,0.571,23,30,0.767,103,37,85,0.435,26,54,0.481,11,31,0.355,13,22,0.591,98
1156,POR,2016-03-06,103,@,DET,0,240,35,78,0.449,24,47,0.511,11,31,0.355,22,23,0.957,103,44,84,0.524,32,62,0.516,12,22,0.545,23,28,0.821,123
1157,BOS,2016-03-05,103,@,CLE,0,240,37,80,0.463,27,57,0.474,10,23,0.435,19,27,0.704,103,42,82,0.512,32,52,0.615,10,30,0.333,26,34,0.765,120
1158,LAC,2016-03-02,103,,OKC,1,240,40,98,0.408,31,66,0.47,9,32,0.281,14,21,0.667,103,39,98,0.398,29,63,0.46,10,35,0.286,10,11,0.909,98
1159,MEM,2016-02-29,103,@,DEN,1,240,36,75,0.48,33,55,0.6,3,20,0.15,28,36,0.778,103,40,75,0.533,32,50,0.64,8,25,0.32,8,10,0.8,96
1160,POR,2016-02-27,103,@,CHI,1,240,38,87,0.437,33,66,0.5,5,21,0.238,22,27,0.815,103,39,94,0.415,32,72,0.444,7,22,0.318,10,12,0.833,95
1161,ATL,2016-02-26,103,,CHI,1,240,37,89,0.416,30,55,0.545,7,34,0.206,22,24,0.917,103,32,88,0.364,27,68,0.397,5,20,0.25,19,22,0.864,88
1162,WAS,2016-02-26,103,@,PHI,1,240,40,94,0.426,33,71,0.465,7,23,0.304,16,17,0.941,103,35,82,0.427,27,57,0.474,8,25,0.32,16,21,0.762,94
1163,CHO,2016-02-24,103,@,CLE,0,240,37,76,0.487,27,47,0.574,10,29,0.345,19,27,0.704,103,45,91,0.495,32,59,0.542,13,32,0.406,11,17,0.647,114
1164,DAL,2016-02-24,103,,OKC,0,240,35,86,0.407,26,58,0.448,9,28,0.321,24,30,0.8,103,43,89,0.483,31,56,0.554,12,33,0.364,18,22,0.818,116
1165,PHI,2016-02-21,103,@,DAL,0,240,37,77,0.481,25,49,0.51,12,28,0.429,17,27,0.63,103,41,85,0.482,28,51,0.549,13,34,0.382,34,36,0.944,129
1166,NYK,2016-02-20,103,@,MIN,1,240,42,83,0.506,37,66,0.561,5,17,0.294,14,16,0.875,103,36,84,0.429,31,72,0.431,5,12,0.417,18,25,0.72,95
1167,WAS,2016-02-18,103,,UTA,1,240,42,86,0.488,35,68,0.515,7,18,0.389,12,21,0.571,103,31,77,0.403,27,62,0.435,4,15,0.267,23,29,0.793,89
1168,HOU,2016-02-10,103,@,POR,0,240,37,77,0.481,26,43,0.605,11,34,0.324,18,34,0.529,103,41,89,0.461,33,61,0.541,8,28,0.286,26,34,0.765,116
1169,DEN,2016-02-10,103,@,DET,1,240,39,83,0.47,33,64,0.516,6,19,0.316,19,24,0.792,103,38,88,0.432,28,61,0.459,10,27,0.37,6,7,0.857,92
1170,TOR,2016-02-08,103,@,DET,1,240,39,70,0.557,28,50,0.56,11,20,0.55,14,17,0.824,103,36,80,0.45,28,52,0.538,8,28,0.286,9,17,0.529,89
1171,PHI,2016-02-06,103,,BRK,1,240,38,81,0.469,28,52,0.538,10,29,0.345,17,22,0.773,103,35,76,0.461,30,61,0.492,5,15,0.333,23,26,0.885,98
1172,CLE,2016-02-05,103,,BOS,0,240,37,87,0.425,29,57,0.509,8,30,0.267,21,35,0.6,103,38,88,0.432,31,68,0.456,7,20,0.35,21,25,0.84,104
1173,POR,2016-02-04,103,,TOR,0,240,38,81,0.469,28,56,0.5,10,25,0.4,17,23,0.739,103,40,85,0.471,28,66,0.424,12,19,0.632,18,25,0.72,110
1174,SAS,2016-01-30,103,@,CLE,0,240,40,81,0.494,34,63,0.54,6,18,0.333,17,21,0.81,103,45,82,0.549,36,59,0.61,9,23,0.391,18,21,0.857,117
1175,BRK,2016-01-30,103,@,NOP,0,240,40,84,0.476,31,64,0.484,9,20,0.45,14,23,0.609,103,43,93,0.462,32,66,0.485,11,27,0.407,8,10,0.8,105
1176,UTA,2016-01-29,103,,MIN,1,240,40,76,0.526,30,51,0.588,10,25,0.4,13,16,0.813,103,35,75,0.467,33,65,0.508,2,10,0.2,18,26,0.692,90
1177,MIL,2016-01-29,103,,MIA,0,240,38,80,0.475,36,68,0.529,2,12,0.167,25,28,0.893,103,37,74,0.5,30,56,0.536,7,18,0.389,26,32,0.813,107
1178,TOR,2016-01-28,103,,NYK,1,240,37,85,0.435,29,65,0.446,8,20,0.4,21,29,0.724,103,38,87,0.437,31,69,0.449,7,18,0.389,10,20,0.5,93
1179,MEM,2016-01-28,103,,MIL,1,240,38,80,0.475,28,52,0.538,10,28,0.357,17,20,0.85,103,29,79,0.367,28,63,0.444,1,16,0.063,24,27,0.889,83
1180,DEN,2016-01-27,103,@,BOS,0,240,36,84,0.429,29,63,0.46,7,21,0.333,24,32,0.75,103,41,96,0.427,32,68,0.471,9,28,0.321,20,24,0.833,111
1181,PHO,2016-01-26,103,@,PHI,0,240,39,83,0.47,33,64,0.516,6,19,0.316,19,28,0.679,103,39,81,0.481,28,53,0.528,11,28,0.393,24,36,0.667,113
1182,LAL,2016-01-23,103,@,POR,0,240,34,69,0.493,27,52,0.519,7,17,0.412,28,32,0.875,103,47,93,0.505,37,62,0.597,10,31,0.323,17,22,0.773,121
1183,MEM,2016-01-16,103,,NYK,1,240,39,82,0.476,34,72,0.472,5,10,0.5,20,26,0.769,103,35,77,0.455,30,57,0.526,5,20,0.25,20,24,0.833,95
1184,LAC,2016-01-16,103,,SAC,0,240,38,96,0.396,25,57,0.439,13,39,0.333,14,19,0.737,103,36,76,0.474,23,51,0.451,13,25,0.52,25,33,0.758,110
1185,PHO,2016-01-15,103,@,BOS,0,240,35,89,0.393,25,62,0.403,10,27,0.37,23,28,0.821,103,42,96,0.438,28,66,0.424,14,30,0.467,19,29,0.655,117
1186,ORL,2016-01-14,103,,TOR,0,265,44,97,0.454,35,74,0.473,9,23,0.391,6,8,0.75,103,37,90,0.411,29,66,0.439,8,24,0.333,24,31,0.774,106
1187,SAC,2016-01-14,103,@,UTA,1,240,34,74,0.459,29,63,0.46,5,11,0.455,30,42,0.714,103,35,83,0.422,29,49,0.592,6,34,0.176,25,34,0.735,101
1188,MEM,2016-01-14,103,,DET,1,240,37,76,0.487,28,60,0.467,9,16,0.563,20,25,0.8,103,37,72,0.514,22,40,0.55,15,32,0.469,12,17,0.706,101
1189,BOS,2016-01-13,103,,IND,1,240,40,90,0.444,31,64,0.484,9,26,0.346,14,20,0.7,103,37,91,0.407,32,61,0.525,5,30,0.167,15,20,0.75,94
1190,MIA,2016-01-11,103,@,GSW,0,240,41,91,0.451,34,72,0.472,7,19,0.368,14,16,0.875,103,41,86,0.477,34,63,0.54,7,23,0.304,22,30,0.733,111
1191,IND,2016-01-10,103,@,HOU,0,265,43,90,0.478,34,59,0.576,9,31,0.29,8,10,0.8,103,39,89,0.438,25,51,0.49,14,38,0.368,15,23,0.652,107
1192,DET,2016-01-09,103,,BRK,1,240,43,92,0.467,35,65,0.538,8,27,0.296,9,14,0.643,103,38,82,0.463,33,73,0.452,5,9,0.556,8,10,0.8,89
1193,MIA,2016-01-08,103,@,PHO,1,240,36,73,0.493,29,55,0.527,7,18,0.389,24,30,0.8,103,40,92,0.435,34,68,0.5,6,24,0.25,9,13,0.692,95
1194,HOU,2016-01-07,103,,UTA,1,240,39,75,0.52,32,52,0.615,7,23,0.304,18,26,0.692,103,38,78,0.487,31,50,0.62,7,28,0.25,11,17,0.647,94
1195,MIA,2016-01-04,103,,IND,1,265,34,90,0.378,29,68,0.426,5,22,0.227,30,39,0.769,103,37,94,0.394,29,66,0.439,8,28,0.286,18,25,0.72,100
1196,BOS,2016-01-04,103,@,BRK,1,240,41,92,0.446,35,71,0.493,6,21,0.286,15,19,0.789,103,32,85,0.376,26,57,0.456,6,28,0.214,24,27,0.889,94
1197,HOU,2016-01-02,103,@,SAS,0,240,37,74,0.5,28,52,0.538,9,22,0.409,20,33,0.606,103,45,86,0.523,32,62,0.516,13,24,0.542,18,19,0.947,121
1198,WAS,2016-01-01,103,,ORL,1,240,43,92,0.467,35,66,0.53,8,26,0.308,9,10,0.9,103,40,85,0.471,35,65,0.538,5,20,0.25,6,8,0.75,91
1199,DEN,2015-12-30,103,@,POR,0,240,37,87,0.425,25,60,0.417,12,27,0.444,17,19,0.895,103,41,87,0.471,29,55,0.527,12,32,0.375,16,20,0.8,110
1200,SAC,2015-12-28,103,@,GSW,0,240,37,95,0.389,24,64,0.375,13,31,0.419,16,28,0.571,103,43,89,0.483,23,47,0.489,20,42,0.476,16,24,0.667,122
1201,DAL,2015-12-28,103,,MIL,1,240,38,84,0.452,28,62,0.452,10,22,0.455,17,26,0.654,103,38,79,0.481,34,65,0.523,4,14,0.286,13,15,0.867,93
1202,GSW,2015-12-23,103,,UTA,1,240,39,83,0.47,30,60,0.5,9,23,0.391,16,16,1.0,103,33,80,0.413,26,60,0.433,7,20,0.35,12,14,0.857,85
1203,TOR,2015-12-22,103,,DAL,1,240,35,74,0.473,23,48,0.479,12,26,0.462,21,27,0.778,103,40,92,0.435,29,63,0.46,11,29,0.379,8,11,0.727,99
1204,ATL,2015-12-20,103,@,ORL,1,240,39,78,0.5,28,56,0.5,11,22,0.5,14,20,0.7,103,38,81,0.469,34,69,0.493,4,12,0.333,20,24,0.833,100
1205,LAC,2015-12-16,103,,MIL,1,240,36,75,0.48,25,54,0.463,11,21,0.524,20,24,0.833,103,38,88,0.432,33,72,0.458,5,16,0.313,9,11,0.818,90
1206,PHO,2015-12-16,103,@,GSW,0,240,41,91,0.451,36,69,0.522,5,22,0.227,16,18,0.889,103,46,88,0.523,31,56,0.554,15,32,0.469,21,27,0.778,128
1207,DET,2015-12-14,103,,LAC,0,265,37,89,0.416,31,70,0.443,6,19,0.316,23,31,0.742,103,44,97,0.454,38,78,0.487,6,19,0.316,11,15,0.733,105
1208,SAS,2015-12-12,103,@,ATL,1,240,36,74,0.486,26,54,0.481,10,20,0.5,21,22,0.955,103,30,80,0.375,25,56,0.446,5,24,0.208,13,16,0.813,78
1209,WAS,2015-12-09,103,,HOU,0,240,39,89,0.438,34,64,0.531,5,25,0.2,20,24,0.833,103,40,83,0.482,28,50,0.56,12,33,0.364,17,25,0.68,109
1210,PHO,2015-12-07,103,@,CHI,1,240,41,92,0.446,34,75,0.453,7,17,0.412,14,17,0.824,103,41,90,0.456,35,69,0.507,6,21,0.286,13,18,0.722,101
1211,MIA,2015-12-07,103,,WAS,0,240,41,69,0.594,36,53,0.679,5,16,0.313,16,22,0.727,103,46,92,0.5,37,74,0.5,9,18,0.5,13,17,0.765,114
1212,LAC,2015-12-05,103,,ORL,1,240,37,82,0.451,25,51,0.49,12,31,0.387,17,25,0.68,103,40,90,0.444,34,70,0.486,6,20,0.3,15,18,0.833,101
1213,MIN,2015-12-05,103,,POR,0,240,38,83,0.458,33,68,0.485,5,15,0.333,22,26,0.846,103,39,77,0.506,29,57,0.509,10,20,0.5,21,30,0.7,109
1214,SAS,2015-12-03,103,@,MEM,1,240,40,80,0.5,30,62,0.484,10,18,0.556,13,18,0.722,103,30,80,0.375,28,64,0.438,2,16,0.125,21,25,0.84,83
1215,ORL,2015-12-03,103,@,UTA,1,240,40,89,0.449,32,66,0.485,8,23,0.348,15,15,1.0,103,31,72,0.431,17,39,0.436,14,33,0.424,18,24,0.75,94
1216,IND,2015-12-02,103,@,LAC,1,240,32,76,0.421,25,56,0.446,7,20,0.35,32,39,0.821,103,30,79,0.38,24,52,0.462,6,27,0.222,25,39,0.641,91
1217,PHI,2015-12-01,103,,LAL,1,240,37,79,0.468,23,47,0.489,14,32,0.438,15,23,0.652,103,33,89,0.371,25,55,0.455,8,34,0.235,17,24,0.708,91
1218,UTA,2015-11-30,103,,GSW,0,240,40,89,0.449,34,70,0.486,6,19,0.316,17,22,0.773,103,40,82,0.488,26,53,0.491,14,29,0.483,12,15,0.8,106
1219,LAL,2015-11-29,103,,IND,0,240,38,99,0.384,27,66,0.409,11,33,0.333,16,22,0.727,103,34,83,0.41,25,56,0.446,9,27,0.333,30,37,0.811,107
1220,OKC,2015-11-27,103,,DET,1,240,37,79,0.468,30,55,0.545,7,24,0.292,22,26,0.846,103,31,90,0.344,22,61,0.361,9,29,0.31,16,20,0.8,87
1221,TOR,2015-11-25,103,,CLE,1,240,40,79,0.506,29,54,0.537,11,25,0.44,12,22,0.545,103,36,82,0.439,22,53,0.415,14,29,0.483,13,16,0.813,99
1222,ORL,2015-11-23,103,@,CLE,0,240,40,81,0.494,30,59,0.508,10,22,0.455,13,21,0.619,103,43,81,0.531,25,46,0.543,18,35,0.514,13,22,0.591,117
1223,CHI,2015-11-18,103,@,PHO,1,240,41,83,0.494,32,64,0.5,9,19,0.474,12,14,0.857,103,37,91,0.407,29,64,0.453,8,27,0.296,15,21,0.714,97
1224,ATL,2015-11-18,103,,SAC,1,240,38,89,0.427,29,59,0.492,9,30,0.3,18,24,0.75,103,38,86,0.442,33,70,0.471,5,16,0.313,16,18,0.889,97
1225,POR,2015-11-18,103,@,HOU,0,265,35,88,0.398,26,58,0.448,9,30,0.3,24,29,0.828,103,32,92,0.348,18,48,0.375,14,44,0.318,30,35,0.857,108
1226,NOP,2015-11-18,103,@,OKC,0,240,43,95,0.453,35,63,0.556,8,32,0.25,9,9,1.0,103,38,85,0.447,31,68,0.456,7,17,0.412,27,40,0.675,110
1227,MIN,2015-11-17,103,@,MIA,1,240,36,97,0.371,32,76,0.421,4,21,0.19,27,35,0.771,103,36,79,0.456,31,55,0.564,5,24,0.208,14,30,0.467,91
1228,MIN,2015-11-13,103,@,IND,0,240,42,83,0.506,35,63,0.556,7,20,0.35,12,13,0.923,103,41,86,0.477,31,61,0.508,10,25,0.4,15,23,0.652,107
1229,PHI,2015-11-11,103,,TOR,0,240,40,87,0.46,28,58,0.483,12,29,0.414,11,17,0.647,103,43,89,0.483,38,71,0.535,5,18,0.278,28,31,0.903,119
1230,DEN,2015-11-11,103,,MIL,1,240,39,79,0.494,31,55,0.564,8,24,0.333,17,24,0.708,103,42,79,0.532,32,57,0.561,10,22,0.455,8,9,0.889,102
1231,PHO,2015-11-08,103,@,OKC,0,240,38,84,0.452,31,68,0.456,7,16,0.438,20,26,0.769,103,49,94,0.521,45,74,0.608,4,20,0.2,22,30,0.733,124
1232,POR,2015-11-08,103,,DET,0,240,41,76,0.539,32,51,0.627,9,25,0.36,12,18,0.667,103,47,96,0.49,36,66,0.545,11,30,0.367,15,22,0.682,120
1233,GSW,2015-11-07,103,@,SAC,1,240,38,92,0.413,30,53,0.566,8,39,0.205,19,22,0.864,103,38,87,0.437,32,68,0.471,6,19,0.316,12,16,0.75,94
1234,TOR,2015-11-04,103,@,OKC,1,240,33,79,0.418,28,65,0.431,5,14,0.357,32,39,0.821,103,39,82,0.476,31,59,0.525,8,23,0.348,12,14,0.857,98
1235,MEM,2015-11-03,103,@,SAC,1,240,40,83,0.482,37,63,0.587,3,20,0.15,20,25,0.8,103,29,74,0.392,22,54,0.407,7,20,0.35,24,40,0.6,89
1236,ORL,2015-11-03,103,@,NOP,1,240,42,90,0.467,35,72,0.486,7,18,0.389,12,12,1.0,103,32,90,0.356,20,54,0.37,12,36,0.333,18,25,0.72,94
1237,MIL,2015-11-02,103,@,BRK,1,240,38,73,0.521,29,50,0.58,9,23,0.391,18,26,0.692,103,36,79,0.456,30,60,0.5,6,19,0.316,18,22,0.818,96
1238,DAL,2015-11-01,103,@,LAL,1,240,40,87,0.46,29,57,0.509,11,30,0.367,12,16,0.75,103,31,85,0.365,21,51,0.412,10,34,0.294,21,28,0.75,93
1239,BOS,2015-10-30,103,,TOR,0,240,32,85,0.376,25,59,0.424,7,26,0.269,32,41,0.78,103,36,82,0.439,25,56,0.446,11,26,0.423,30,35,0.857,113
1240,IND,2015-10-29,103,,MEM,0,240,37,78,0.474,25,48,0.521,12,30,0.4,17,24,0.708,103,41,82,0.5,34,66,0.515,7,16,0.438,23,29,0.793,112
1241,IND,2016-04-12,102,,NYK,1,240,41,80,0.513,35,61,0.574,6,19,0.316,14,20,0.7,102,36,80,0.45,26,53,0.491,10,27,0.37,8,9,0.889,90
1242,SAS,2016-04-12,102,,OKC,1,265,37,87,0.425,33,73,0.452,4,14,0.286,24,32,0.75,102,35,87,0.402,29,62,0.468,6,25,0.24,22,25,0.88,98
1243,CLE,2016-04-09,102,@,CHI,0,240,36,83,0.434,17,43,0.395,19,40,0.475,11,18,0.611,102,40,89,0.449,32,65,0.492,8,24,0.333,17,21,0.81,105
1244,PHI,2016-04-08,102,,NYK,0,240,32,91,0.352,18,54,0.333,14,37,0.378,24,36,0.667,102,43,91,0.473,39,75,0.52,4,16,0.25,19,30,0.633,109
1245,LAL,2016-04-08,102,@,NOP,0,240,34,81,0.42,23,57,0.404,11,24,0.458,23,27,0.852,102,42,79,0.532,32,57,0.561,10,22,0.455,16,21,0.762,110
1246,DEN,2016-04-08,102,,SAS,1,240,40,86,0.465,34,64,0.531,6,22,0.273,16,19,0.842,102,36,85,0.424,33,71,0.465,3,14,0.214,23,28,0.821,98
1247,LAC,2016-04-08,102,@,UTA,1,265,37,83,0.446,24,54,0.444,13,29,0.448,15,19,0.789,102,36,82,0.439,25,51,0.49,11,31,0.355,16,23,0.696,99
1248,DEN,2016-04-05,102,,OKC,0,240,37,88,0.42,27,58,0.466,10,30,0.333,18,27,0.667,102,46,87,0.529,31,54,0.574,15,33,0.455,17,24,0.708,124
1249,CHI,2016-04-03,102,@,MIL,1,240,39,74,0.527,32,48,0.667,7,26,0.269,17,22,0.773,102,40,85,0.471,38,78,0.487,2,7,0.286,16,20,0.8,98
1250,SAS,2016-04-02,102,,TOR,1,240,35,77,0.455,30,57,0.526,5,20,0.25,27,30,0.9,102,40,80,0.5,34,62,0.548,6,18,0.333,9,10,0.9,95
1251,PHI,2016-04-02,102,,IND,0,240,34,83,0.41,18,46,0.391,16,37,0.432,18,26,0.692,102,44,84,0.524,36,61,0.59,8,23,0.348,19,23,0.826,115
1252,LAL,2016-03-30,102,,MIA,1,265,37,102,0.363,31,82,0.378,6,20,0.3,22,29,0.759,102,41,86,0.477,38,69,0.551,3,17,0.176,15,26,0.577,100
1253,GSW,2016-03-29,102,,WAS,1,240,38,87,0.437,27,62,0.435,11,25,0.44,15,23,0.652,102,36,86,0.419,31,63,0.492,5,23,0.217,17,27,0.63,94
1254,ATL,2016-03-28,102,@,CHI,1,240,36,85,0.424,31,63,0.492,5,22,0.227,25,28,0.893,102,40,106,0.377,31,84,0.369,9,22,0.409,11,15,0.733,100
1255,BOS,2016-03-26,102,@,PHO,1,240,35,84,0.417,27,55,0.491,8,29,0.276,24,27,0.889,102,37,85,0.435,30,54,0.556,7,31,0.226,18,21,0.857,99
1256,ORL,2016-03-23,102,@,DET,0,240,39,98,0.398,31,73,0.425,8,25,0.32,16,19,0.842,102,43,80,0.538,32,56,0.571,11,24,0.458,21,25,0.84,118
1257,ATL,2016-03-21,102,,WAS,0,240,38,78,0.487,25,45,0.556,13,33,0.394,13,17,0.765,102,46,91,0.505,33,66,0.5,13,25,0.52,12,20,0.6,117
1258,SAC,2016-03-21,102,@,CHI,0,240,40,88,0.455,31,59,0.525,9,29,0.31,13,16,0.813,102,41,91,0.451,29,67,0.433,12,24,0.5,15,23,0.652,109
1259,LAC,2016-03-19,102,@,MEM,0,240,31,66,0.47,19,36,0.528,12,30,0.4,28,39,0.718,102,40,82,0.488,36,67,0.537,4,15,0.267,29,36,0.806,113
1260,BRK,2016-03-17,102,@,CHI,0,240,40,86,0.465,34,65,0.523,6,21,0.286,16,20,0.8,102,46,94,0.489,35,70,0.5,11,24,0.458,15,15,1.0,118
1261,HOU,2016-03-11,102,@,BOS,1,240,40,88,0.455,35,62,0.565,5,26,0.192,17,25,0.68,102,34,91,0.374,26,60,0.433,8,31,0.258,22,28,0.786,98
1262,DET,2016-03-09,102,@,DAL,1,240,38,85,0.447,29,58,0.5,9,27,0.333,17,30,0.567,102,39,86,0.453,30,56,0.536,9,30,0.3,9,11,0.818,96
1263,NYK,2016-03-05,102,,DET,1,240,42,79,0.532,38,63,0.603,4,16,0.25,14,18,0.778,102,36,92,0.391,30,66,0.455,6,26,0.231,11,15,0.733,89
1264,PHO,2016-03-04,102,@,ORL,1,240,35,78,0.449,30,64,0.469,5,14,0.357,27,39,0.692,102,35,101,0.347,28,74,0.378,7,27,0.259,7,14,0.5,84
1265,PHI,2016-03-04,102,,MIA,0,240,36,95,0.379,27,64,0.422,9,31,0.29,21,27,0.778,102,39,88,0.443,34,72,0.472,5,16,0.313,29,36,0.806,112
1266,ORL,2016-03-02,102,,CHI,1,240,39,97,0.402,32,76,0.421,7,21,0.333,17,22,0.773,102,38,99,0.384,32,80,0.4,6,19,0.316,7,11,0.636,89
1267,IND,2016-02-28,102,,POR,0,240,40,93,0.43,37,79,0.468,3,14,0.214,19,25,0.76,102,41,81,0.506,27,57,0.474,14,24,0.583,15,21,0.714,111
1268,DET,2016-02-27,102,@,MIL,1,240,37,88,0.42,25,58,0.431,12,30,0.4,16,24,0.667,102,38,78,0.487,31,66,0.47,7,12,0.583,8,12,0.667,91
1269,GSW,2016-02-22,102,@,ATL,1,240,39,89,0.438,25,44,0.568,14,45,0.311,10,12,0.833,102,36,86,0.419,26,52,0.5,10,34,0.294,10,16,0.625,92
1270,ORL,2016-02-21,102,,IND,0,240,38,91,0.418,31,66,0.47,7,25,0.28,19,29,0.655,102,41,82,0.5,32,58,0.552,9,24,0.375,14,21,0.667,105
1271,MIN,2016-02-08,102,,NOP,0,240,36,81,0.444,34,69,0.493,2,12,0.167,28,35,0.8,102,47,97,0.485,37,73,0.507,10,24,0.417,12,20,0.6,116
1272,LAL,2016-02-06,102,@,SAS,0,240,34,86,0.395,24,56,0.429,10,30,0.333,24,27,0.889,102,39,88,0.443,31,64,0.484,8,24,0.333,20,25,0.8,106
1273,ATL,2016-02-05,102,,IND,1,240,39,76,0.513,29,49,0.592,10,27,0.37,14,20,0.7,102,38,91,0.418,25,60,0.417,13,31,0.419,7,9,0.778,96
1274,BOS,2016-02-03,102,,DET,1,240,42,96,0.438,35,75,0.467,7,21,0.333,11,13,0.846,102,32,85,0.376,21,51,0.412,11,34,0.324,20,28,0.714,95
1275,SAC,2016-02-03,102,,CHI,0,240,42,88,0.477,36,68,0.529,6,20,0.3,12,19,0.632,102,40,88,0.455,29,67,0.433,11,21,0.524,16,21,0.762,107
1276,LAC,2016-02-03,102,,MIN,0,240,33,75,0.44,22,43,0.512,11,32,0.344,25,34,0.735,102,39,77,0.506,31,60,0.517,8,17,0.471,22,26,0.846,108
1277,MIA,2016-02-02,102,@,HOU,0,240,38,85,0.447,32,68,0.471,6,17,0.353,20,27,0.741,102,44,84,0.524,28,49,0.571,16,35,0.457,11,16,0.688,115
1278,NYK,2016-01-29,102,,PHO,1,240,36,84,0.429,29,64,0.453,7,20,0.35,23,26,0.885,102,35,85,0.412,28,59,0.475,7,26,0.269,7,12,0.583,84
1279,UTA,2016-01-27,102,,CHO,1,240,40,81,0.494,28,50,0.56,12,31,0.387,10,15,0.667,102,25,68,0.368,19,43,0.442,6,25,0.24,17,21,0.81,73
1280,MIA,2016-01-26,102,@,BRK,1,240,45,83,0.542,42,74,0.568,3,9,0.333,9,10,0.9,102,36,71,0.507,27,53,0.509,9,18,0.5,17,23,0.739,98
1281,ORL,2016-01-25,102,@,MEM,0,265,40,86,0.465,30,58,0.517,10,28,0.357,12,14,0.857,102,43,100,0.43,37,82,0.451,6,18,0.333,16,25,0.64,108
1282,HOU,2016-01-22,102,,MIL,1,240,38,94,0.404,23,50,0.46,15,44,0.341,11,16,0.688,102,39,85,0.459,36,71,0.507,3,14,0.214,17,22,0.773,98
1283,LAC,2016-01-21,102,@,CLE,0,240,36,80,0.45,30,55,0.545,6,25,0.24,24,36,0.667,102,42,83,0.506,29,55,0.527,13,28,0.464,18,24,0.75,115
1284,MEM,2016-01-21,102,@,DEN,1,240,36,72,0.5,30,51,0.588,6,21,0.286,24,29,0.828,102,36,80,0.45,27,50,0.54,9,30,0.3,20,26,0.769,101
1285,CHO,2016-01-06,102,@,PHO,0,240,38,87,0.437,27,59,0.458,11,28,0.393,15,22,0.682,102,41,84,0.488,22,51,0.431,19,33,0.576,10,13,0.769,111
1286,CHI,2015-12-30,102,,IND,1,265,37,86,0.43,31,68,0.456,6,18,0.333,22,27,0.815,102,37,97,0.381,30,75,0.4,7,22,0.318,19,24,0.792,100
1287,IND,2015-12-26,102,@,MIN,1,240,40,80,0.5,31,54,0.574,9,26,0.346,13,14,0.929,102,35,75,0.467,31,63,0.492,4,12,0.333,14,18,0.778,88
1288,BOS,2015-12-23,102,@,CHO,1,240,36,85,0.424,29,56,0.518,7,29,0.241,23,26,0.885,102,29,81,0.358,21,53,0.396,8,28,0.286,23,32,0.719,89
1289,CHI,2015-12-21,102,,BRK,0,240,43,95,0.453,34,69,0.493,9,26,0.346,7,13,0.538,102,43,94,0.457,36,74,0.486,7,20,0.35,12,14,0.857,105
1290,HOU,2015-12-21,102,,CHO,1,240,33,71,0.465,26,43,0.605,7,28,0.25,29,41,0.707,102,29,83,0.349,17,42,0.405,12,41,0.293,25,31,0.806,95
1291,ORL,2015-12-18,102,,POR,1,240,39,84,0.464,37,69,0.536,2,15,0.133,22,31,0.71,102,32,73,0.438,21,41,0.512,11,32,0.344,19,26,0.731,94
1292,MIN,2015-12-16,102,@,NYK,0,240,42,101,0.416,38,80,0.475,4,21,0.19,14,14,1.0,102,37,85,0.435,29,64,0.453,8,21,0.381,25,30,0.833,107
1293,TOR,2015-12-07,102,,LAL,1,240,34,74,0.459,25,49,0.51,9,25,0.36,25,32,0.781,102,34,83,0.41,27,64,0.422,7,19,0.368,18,20,0.9,93
1294,CHO,2015-12-05,102,@,CHI,1,240,37,89,0.416,27,55,0.491,10,34,0.294,18,25,0.72,102,37,89,0.416,28,64,0.438,9,25,0.36,13,19,0.684,96
1295,DET,2015-12-04,102,,MIL,1,240,34,82,0.415,27,59,0.458,7,23,0.304,27,39,0.692,102,39,87,0.448,35,69,0.507,4,18,0.222,13,14,0.929,95
1296,LAC,2015-11-30,102,,POR,1,240,33,85,0.388,25,66,0.379,8,19,0.421,28,56,0.5,102,33,87,0.379,28,64,0.438,5,23,0.217,16,27,0.593,87
1297,TOR,2015-11-29,102,,PHO,0,240,38,86,0.442,26,57,0.456,12,29,0.414,14,17,0.824,102,40,94,0.426,29,67,0.433,11,27,0.407,16,20,0.8,107
1298,UTA,2015-11-25,102,@,LAC,1,240,39,77,0.506,33,64,0.516,6,13,0.462,18,25,0.72,102,38,75,0.507,34,63,0.54,4,12,0.333,11,17,0.647,91
1299,MEM,2015-11-25,102,@,HOU,1,240,39,80,0.488,36,64,0.563,3,16,0.188,21,23,0.913,102,30,71,0.423,20,37,0.541,10,34,0.294,23,27,0.852,93
1300,HOU,2015-11-21,102,,NYK,0,240,35,81,0.432,23,53,0.434,12,28,0.429,20,28,0.714,102,34,80,0.425,22,55,0.4,12,25,0.48,27,34,0.794,107
1301,POR,2015-11-20,102,,LAC,1,240,38,90,0.422,30,65,0.462,8,25,0.32,18,24,0.75,102,38,86,0.442,31,62,0.5,7,24,0.292,8,16,0.5,91
1302,TOR,2015-11-20,102,@,LAL,1,240,34,78,0.436,19,45,0.422,15,33,0.455,19,24,0.792,102,35,77,0.455,27,52,0.519,8,25,0.32,13,17,0.765,91
1303,DAL,2015-11-20,102,,UTA,1,240,39,83,0.47,31,55,0.564,8,28,0.286,16,17,0.941,102,35,80,0.438,29,60,0.483,6,20,0.3,17,21,0.81,93
1304,BOS,2015-11-18,102,,DAL,0,240,38,92,0.413,30,66,0.455,8,26,0.308,18,24,0.75,102,37,72,0.514,30,52,0.577,7,20,0.35,25,35,0.714,106
1305,NYK,2015-11-17,102,,CHO,1,240,36,89,0.404,26,69,0.377,10,20,0.5,20,21,0.952,102,36,82,0.439,31,62,0.5,5,20,0.25,17,25,0.68,94
1306,CHI,2015-11-13,102,,CHO,1,240,37,84,0.44,33,68,0.485,4,16,0.25,24,31,0.774,102,36,95,0.379,21,62,0.339,15,33,0.455,10,12,0.833,97
1307,OKC,2015-11-13,102,,PHI,1,240,39,97,0.402,31,72,0.431,8,25,0.32,16,21,0.762,102,30,86,0.349,25,69,0.362,5,17,0.294,20,28,0.714,85
1308,ORL,2015-11-13,102,,UTA,1,240,32,76,0.421,22,49,0.449,10,27,0.37,28,31,0.903,102,34,87,0.391,26,62,0.419,8,25,0.32,17,23,0.739,93
1309,IND,2015-11-11,102,@,BOS,1,240,38,79,0.481,32,62,0.516,6,17,0.353,20,31,0.645,102,32,77,0.416,28,53,0.528,4,24,0.167,23,32,0.719,91
1310,MIL,2015-11-11,102,@,DEN,0,240,42,79,0.532,32,57,0.561,10,22,0.455,8,9,0.889,102,39,79,0.494,31,55,0.564,8,24,0.333,17,24,0.708,103
1311,MIN,2015-11-07,102,@,CHI,1,265,39,96,0.406,32,80,0.4,7,16,0.438,17,27,0.63,102,33,93,0.355,22,61,0.361,11,32,0.344,16,23,0.696,93
1312,PHI,2015-11-06,102,@,CLE,0,240,41,79,0.519,31,56,0.554,10,23,0.435,10,15,0.667,102,45,88,0.511,35,62,0.565,10,26,0.385,8,12,0.667,108
1313,WAS,2015-11-04,102,,SAS,1,240,42,87,0.483,34,64,0.531,8,23,0.348,10,14,0.714,102,37,81,0.457,30,59,0.508,7,22,0.318,18,20,0.9,99
1314,TOR,2015-11-03,102,@,DAL,1,240,37,82,0.451,32,65,0.492,5,17,0.294,23,26,0.885,102,33,86,0.384,26,63,0.413,7,23,0.304,18,25,0.72,91
1315,LAC,2015-11-02,102,,PHO,1,240,37,81,0.457,29,55,0.527,8,26,0.308,20,23,0.87,102,36,98,0.367,27,68,0.397,9,30,0.3,15,21,0.714,96
1316,CLE,2015-10-30,102,,MIA,1,240,39,86,0.453,33,61,0.541,6,25,0.24,18,21,0.857,102,33,77,0.429,27,56,0.482,6,21,0.286,20,22,0.909,92
1317,SAS,2015-10-30,102,,BRK,1,240,40,86,0.465,31,64,0.484,9,22,0.409,13,13,1.0,102,31,77,0.403,26,61,0.426,5,16,0.313,8,15,0.533,75
1318,LAL,2016-04-13,101,,UTA,1,240,41,85,0.482,35,60,0.583,6,25,0.24,13,15,0.867,101,39,83,0.47,30,53,0.566,9,30,0.3,9,15,0.6,96
1319,PHO,2016-04-11,101,,SAC,0,240,41,100,0.41,36,78,0.462,5,22,0.227,14,17,0.824,101,41,83,0.494,35,66,0.53,6,17,0.353,17,28,0.607,105
1320,DAL,2016-04-11,101,@,UTA,1,240,36,81,0.444,25,49,0.51,11,32,0.344,18,22,0.818,101,35,77,0.455,26,44,0.591,9,33,0.273,13,18,0.722,92
1321,SAS,2016-04-07,101,@,GSW,0,240,39,80,0.488,32,64,0.5,7,16,0.438,16,23,0.696,101,45,83,0.542,33,58,0.569,12,25,0.48,10,11,0.909,112
1322,UTA,2016-04-03,101,@,PHO,1,240,39,81,0.481,29,54,0.537,10,27,0.37,13,17,0.765,101,33,78,0.423,25,51,0.49,8,27,0.296,12,19,0.632,86
1323,NOP,2016-03-31,101,,DEN,1,240,40,90,0.444,27,61,0.443,13,29,0.448,8,9,0.889,101,36,83,0.434,26,56,0.464,10,27,0.37,13,17,0.765,95
1324,SAS,2016-03-28,101,@,MEM,1,240,37,72,0.514,32,57,0.561,5,15,0.333,22,30,0.733,101,33,83,0.398,27,64,0.422,6,19,0.316,15,24,0.625,87
1325,HOU,2016-03-27,101,@,IND,0,240,38,85,0.447,31,52,0.596,7,33,0.212,18,27,0.667,101,41,87,0.471,32,61,0.525,9,26,0.346,13,20,0.65,104
1326,WAS,2016-03-27,101,@,LAL,1,240,39,72,0.542,32,54,0.593,7,18,0.389,16,29,0.552,101,33,87,0.379,26,59,0.441,7,28,0.25,15,17,0.882,88
1327,ATL,2016-03-25,101,,MIL,1,240,41,97,0.423,36,65,0.554,5,32,0.156,14,17,0.824,101,35,84,0.417,32,71,0.451,3,13,0.231,17,26,0.654,90
1328,WAS,2016-03-23,101,,ATL,0,240,39,92,0.424,27,62,0.435,12,30,0.4,11,12,0.917,101,45,84,0.536,28,42,0.667,17,42,0.405,15,22,0.682,122
1329,CLE,2016-03-19,101,@,MIA,0,240,40,76,0.526,30,52,0.577,10,24,0.417,11,13,0.846,101,46,84,0.548,35,65,0.538,11,19,0.579,19,23,0.826,122
1330,DEN,2016-03-19,101,@,CHO,1,240,38,87,0.437,29,69,0.42,9,18,0.5,16,23,0.696,101,35,83,0.422,26,51,0.51,9,32,0.281,14,20,0.7,93
1331,TOR,2016-03-17,101,@,IND,1,265,32,88,0.364,25,66,0.379,7,22,0.318,30,38,0.789,101,35,91,0.385,27,63,0.429,8,28,0.286,16,23,0.696,94
1332,LAC,2016-03-11,101,,NYK,1,240,38,85,0.447,25,56,0.446,13,29,0.448,12,16,0.75,101,34,83,0.41,30,63,0.476,4,20,0.2,22,25,0.88,94
1333,CHI,2016-03-10,101,@,SAS,0,240,39,86,0.453,28,64,0.438,11,22,0.5,12,13,0.923,101,44,93,0.473,38,76,0.5,6,17,0.353,15,19,0.789,109
1334,IND,2016-03-04,101,@,CHO,0,240,37,90,0.411,28,62,0.452,9,28,0.321,18,21,0.857,101,38,79,0.481,25,48,0.521,13,31,0.419,19,23,0.826,108
1335,MIN,2016-03-04,101,@,MIL,0,240,42,87,0.483,35,65,0.538,7,22,0.318,10,14,0.714,101,43,83,0.518,29,59,0.492,14,24,0.583,16,20,0.8,116
1336,DAL,2016-03-03,101,,SAC,0,240,45,94,0.479,38,65,0.585,7,29,0.241,4,6,0.667,101,42,80,0.525,35,55,0.636,7,25,0.28,13,24,0.542,104
1337,BRK,2016-03-01,101,@,LAL,0,240,39,89,0.438,34,71,0.479,5,18,0.278,18,27,0.667,101,41,83,0.494,30,57,0.526,11,26,0.423,14,21,0.667,107
1338,MIN,2016-02-28,101,@,DAL,0,240,34,90,0.378,27,67,0.403,7,23,0.304,26,37,0.703,101,47,89,0.528,34,53,0.642,13,36,0.361,21,21,1.0,128
1339,TOR,2016-02-28,101,@,DET,0,240,39,80,0.488,29,59,0.492,10,21,0.476,13,18,0.722,101,41,71,0.577,29,48,0.604,12,23,0.522,20,27,0.741,114
1340,BOS,2016-02-27,101,,MIA,1,240,39,96,0.406,34,80,0.425,5,16,0.313,18,22,0.818,101,36,87,0.414,35,74,0.473,1,13,0.077,16,23,0.696,89
1341,LAL,2016-02-22,101,@,MIL,0,240,28,76,0.368,16,47,0.34,12,29,0.414,33,43,0.767,101,44,86,0.512,39,70,0.557,5,16,0.313,15,25,0.6,108
1342,MIA,2016-02-22,101,,IND,1,265,38,100,0.38,36,87,0.414,2,13,0.154,23,34,0.676,101,36,92,0.391,31,77,0.403,5,15,0.333,16,25,0.64,93
1343,DEN,2016-02-21,101,,BOS,0,240,34,73,0.466,28,52,0.538,6,21,0.286,27,34,0.794,101,47,97,0.485,37,65,0.569,10,32,0.313,17,20,0.85,121
1344,IND,2016-02-19,101,@,OKC,1,240,39,88,0.443,30,66,0.455,9,22,0.409,14,22,0.636,101,42,96,0.438,37,70,0.529,5,26,0.192,9,10,0.9,98
1345,MIA,2016-02-09,101,,SAS,0,240,40,70,0.571,36,58,0.621,4,12,0.333,17,24,0.708,101,47,89,0.528,41,75,0.547,6,14,0.429,19,26,0.731,119
1346,DEN,2016-02-07,101,@,NYK,1,240,37,86,0.43,32,65,0.492,5,21,0.238,22,28,0.786,101,37,84,0.44,29,62,0.468,8,22,0.364,14,20,0.7,96
1347,CHO,2016-01-31,101,@,LAL,1,240,36,96,0.375,23,60,0.383,13,36,0.361,16,26,0.615,101,27,80,0.338,19,51,0.373,8,29,0.276,20,23,0.87,82
1348,DET,2016-01-23,101,@,DEN,0,240,40,84,0.476,29,55,0.527,11,29,0.379,10,19,0.526,101,36,78,0.462,28,56,0.5,8,22,0.364,24,29,0.828,104
1349,MEM,2016-01-23,101,@,MIN,0,240,37,79,0.468,28,60,0.467,9,19,0.474,18,22,0.818,101,34,68,0.5,29,51,0.569,5,17,0.294,33,36,0.917,106
1350,TOR,2016-01-22,101,,MIA,1,240,35,75,0.467,22,50,0.44,13,25,0.52,18,21,0.857,101,33,81,0.407,29,64,0.453,4,17,0.235,11,17,0.647,81
1351,CHI,2016-01-22,101,@,BOS,0,240,38,89,0.427,35,76,0.461,3,13,0.231,22,26,0.846,101,43,96,0.448,35,73,0.479,8,23,0.348,16,21,0.762,110
1352,DEN,2016-01-21,101,,MEM,0,240,36,80,0.45,27,50,0.54,9,30,0.3,20,26,0.769,101,36,72,0.5,30,51,0.588,6,21,0.286,24,29,0.828,102
1353,MEM,2016-01-18,101,,NOP,1,240,35,75,0.467,27,56,0.482,8,19,0.421,23,30,0.767,101,36,74,0.486,30,55,0.545,6,19,0.316,21,23,0.913,99
1354,DET,2016-01-18,101,,CHI,0,240,42,95,0.442,37,69,0.536,5,26,0.192,12,20,0.6,101,44,84,0.524,35,63,0.556,9,21,0.429,14,20,0.7,111
1355,ATL,2016-01-15,101,@,MIL,0,265,43,100,0.43,34,70,0.486,9,30,0.3,6,6,1.0,101,40,96,0.417,37,86,0.43,3,10,0.3,25,37,0.676,108
1356,DET,2016-01-14,101,@,MEM,0,240,37,72,0.514,22,40,0.55,15,32,0.469,12,17,0.706,101,37,76,0.487,28,60,0.467,9,16,0.563,20,25,0.8,103
1357,UTA,2016-01-14,101,,SAC,0,240,35,83,0.422,29,49,0.592,6,34,0.176,25,34,0.735,101,34,74,0.459,29,63,0.46,5,11,0.455,30,42,0.714,103
1358,MIL,2016-01-13,101,@,WAS,0,240,38,72,0.528,37,64,0.578,1,8,0.125,24,34,0.706,101,38,84,0.452,26,57,0.456,12,27,0.444,18,24,0.75,106
1359,CHI,2016-01-12,101,@,MIL,0,240,35,85,0.412,23,56,0.411,12,29,0.414,19,24,0.792,101,43,93,0.462,40,80,0.5,3,13,0.231,17,28,0.607,106
1360,OKC,2016-01-12,101,@,MIN,1,240,39,84,0.464,30,62,0.484,9,22,0.409,14,18,0.778,101,36,81,0.444,29,63,0.46,7,18,0.389,17,23,0.739,96
1361,MEM,2016-01-10,101,,BOS,1,240,31,84,0.369,27,68,0.397,4,16,0.25,35,40,0.875,101,37,88,0.42,30,66,0.455,7,22,0.318,17,23,0.739,98
1362,CHI,2016-01-07,101,,BOS,1,240,39,94,0.415,30,72,0.417,9,22,0.409,14,17,0.824,101,35,98,0.357,30,73,0.411,5,25,0.2,17,22,0.773,92
1363,ATL,2016-01-05,101,,NYK,0,240,37,87,0.425,22,48,0.458,15,39,0.385,12,19,0.632,101,40,84,0.476,35,66,0.53,5,18,0.278,22,24,0.917,107
1364,CHO,2016-01-04,101,@,GSW,0,240,38,86,0.442,31,65,0.477,7,21,0.333,18,19,0.947,101,45,87,0.517,30,53,0.566,15,34,0.441,6,6,1.0,111
1365,SAS,2015-12-28,101,,MIN,1,240,37,72,0.514,32,55,0.582,5,17,0.294,22,28,0.786,101,39,82,0.476,36,71,0.507,3,11,0.273,14,24,0.583,95
1366,CLE,2015-12-28,101,@,PHO,1,240,33,71,0.465,16,30,0.533,17,41,0.415,18,25,0.72,101,36,79,0.456,25,54,0.463,11,25,0.44,14,20,0.7,97
1367,SAS,2015-12-26,101,,DEN,1,240,39,81,0.481,32,71,0.451,7,10,0.7,16,17,0.941,101,38,86,0.442,33,68,0.485,5,18,0.278,5,6,0.833,86
1368,ORL,2015-12-26,101,,MIA,0,240,43,79,0.544,34,60,0.567,9,19,0.474,6,13,0.462,101,38,77,0.494,28,57,0.491,10,20,0.5,22,23,0.957,108
1369,HOU,2015-12-23,101,@,ORL,0,240,41,83,0.494,34,54,0.63,7,29,0.241,12,17,0.706,101,44,84,0.524,37,68,0.544,7,16,0.438,9,13,0.692,104
1370,MIL,2015-12-20,101,@,PHO,1,240,41,79,0.519,36,63,0.571,5,16,0.313,14,24,0.583,101,33,74,0.446,25,56,0.446,8,18,0.444,21,24,0.875,95
1371,CHO,2015-12-19,101,@,WAS,0,240,39,93,0.419,29,60,0.483,10,33,0.303,13,16,0.813,101,40,79,0.506,31,59,0.525,9,20,0.45,20,23,0.87,109
1372,BOS,2015-12-18,101,,ATL,0,240,34,77,0.442,24,54,0.444,10,23,0.435,23,31,0.742,101,41,88,0.466,37,68,0.544,4,20,0.2,23,29,0.793,109
1373,NOP,2015-12-14,101,@,POR,0,240,36,82,0.439,28,57,0.491,8,25,0.32,21,27,0.778,101,35,81,0.432,22,49,0.449,13,32,0.406,22,29,0.759,105
1374,MIN,2015-12-13,101,@,PHO,0,240,33,73,0.452,25,54,0.463,8,19,0.421,27,34,0.794,101,39,87,0.448,29,57,0.509,10,30,0.333,20,24,0.833,108
1375,CHI,2015-12-07,101,,PHO,0,240,41,90,0.456,35,69,0.507,6,21,0.286,13,18,0.722,101,41,92,0.446,34,75,0.453,7,17,0.412,14,17,0.824,103
1376,ORL,2015-12-05,101,@,LAC,0,240,40,90,0.444,34,70,0.486,6,20,0.3,15,18,0.833,101,37,82,0.451,25,51,0.49,12,31,0.387,17,25,0.68,103
1377,NOP,2015-12-02,101,@,HOU,0,240,36,88,0.409,29,63,0.46,7,25,0.28,22,25,0.88,101,36,87,0.414,28,60,0.467,8,27,0.296,28,39,0.718,108
1378,SAC,2015-11-28,101,@,GSW,0,240,39,100,0.39,29,75,0.387,10,25,0.4,13,15,0.867,101,39,80,0.488,23,50,0.46,16,30,0.533,26,31,0.839,120
1379,UTA,2015-11-28,101,,NOP,1,240,38,82,0.463,29,64,0.453,9,18,0.5,16,21,0.762,101,29,69,0.42,24,52,0.462,5,17,0.294,24,30,0.8,87
1380,MEM,2015-11-27,101,,ATL,0,240,35,80,0.438,23,50,0.46,12,30,0.4,19,21,0.905,101,35,75,0.467,21,36,0.583,14,39,0.359,32,36,0.889,116
1381,MIN,2015-11-27,101,@,SAC,1,240,37,77,0.481,28,52,0.538,9,25,0.36,18,19,0.947,101,37,86,0.43,29,64,0.453,8,22,0.364,9,15,0.6,91
1382,CHO,2015-11-25,101,,WAS,1,240,39,83,0.47,31,57,0.544,8,26,0.308,15,15,1.0,101,31,87,0.356,21,55,0.382,10,32,0.313,15,18,0.833,87
1383,BOS,2015-11-22,101,@,BRK,0,240,35,82,0.427,21,45,0.467,14,37,0.378,17,21,0.81,101,40,79,0.506,35,64,0.547,5,15,0.333,26,33,0.788,111
1384,MIN,2015-11-18,101,@,ORL,0,265,36,85,0.424,32,67,0.478,4,18,0.222,25,30,0.833,101,41,110,0.373,32,89,0.36,9,21,0.429,13,21,0.619,104
1385,LAL,2015-11-16,101,@,PHO,0,240,37,77,0.481,28,57,0.491,9,20,0.45,18,20,0.9,101,45,93,0.484,34,63,0.54,11,30,0.367,19,25,0.76,120
1386,TOR,2015-11-15,101,@,SAC,0,240,38,87,0.437,23,56,0.411,15,31,0.484,10,14,0.714,101,39,76,0.513,29,51,0.569,10,25,0.4,19,24,0.792,107
1387,LAC,2015-11-14,101,,DET,1,240,37,79,0.468,30,60,0.5,7,19,0.368,20,26,0.769,101,33,74,0.446,26,47,0.553,7,27,0.259,23,35,0.657,96
1388,MEM,2015-11-13,101,,POR,1,240,36,86,0.419,30,70,0.429,6,16,0.375,23,27,0.852,101,33,69,0.478,25,47,0.532,8,22,0.364,26,29,0.897,100
1389,SAC,2015-11-11,101,,DET,1,240,37,74,0.5,28,58,0.483,9,16,0.563,18,24,0.75,101,34,89,0.382,25,57,0.439,9,32,0.281,15,20,0.75,92
1390,POR,2015-11-11,101,,SAS,0,240,39,88,0.443,30,66,0.455,9,22,0.409,14,23,0.609,101,46,82,0.561,39,67,0.582,7,15,0.467,14,18,0.778,113
1391,ORL,2015-11-11,101,,LAL,1,240,40,100,0.4,27,72,0.375,13,28,0.464,8,12,0.667,101,39,79,0.494,32,57,0.561,7,22,0.318,14,18,0.778,99
1392,MIA,2015-11-10,101,,LAL,1,240,38,84,0.452,33,64,0.516,5,20,0.25,20,27,0.741,101,34,77,0.442,23,55,0.418,11,22,0.5,9,12,0.75,88
1393,WAS,2015-11-10,101,,OKC,0,240,38,97,0.392,33,73,0.452,5,24,0.208,20,26,0.769,101,44,86,0.512,29,63,0.46,15,23,0.652,22,29,0.759,125
1394,CLE,2015-11-08,101,,IND,1,240,38,83,0.458,30,59,0.508,8,24,0.333,17,25,0.68,101,39,90,0.433,33,72,0.458,6,18,0.333,13,19,0.684,97
1395,ATL,2015-11-04,101,,BRK,1,240,37,76,0.487,29,54,0.537,8,22,0.364,19,24,0.792,101,36,83,0.434,31,62,0.5,5,21,0.238,10,13,0.769,87
1396,MIN,2015-11-02,101,,POR,0,240,34,79,0.43,31,66,0.47,3,13,0.231,30,39,0.769,101,41,89,0.461,32,59,0.542,9,30,0.3,15,20,0.75,106
1397,MEM,2015-10-31,101,,BRK,1,240,34,80,0.425,25,57,0.439,9,23,0.391,24,28,0.857,101,38,79,0.481,35,66,0.53,3,13,0.231,12,18,0.667,91
1398,PHO,2015-10-31,101,@,POR,1,240,39,94,0.415,28,62,0.452,11,32,0.344,12,16,0.75,101,33,79,0.418,25,49,0.51,8,30,0.267,16,28,0.571,90
1399,NYK,2015-10-29,101,,ATL,0,240,38,93,0.409,32,64,0.5,6,29,0.207,19,21,0.905,101,42,83,0.506,32,59,0.542,10,24,0.417,18,26,0.692,112
1400,BOS,2016-04-11,100,,CHO,0,240,34,89,0.382,26,65,0.4,8,24,0.333,24,29,0.828,100,41,81,0.506,27,49,0.551,14,32,0.438,18,22,0.818,114
1401,UTA,2016-04-10,100,@,DEN,1,240,36,79,0.456,24,48,0.5,12,31,0.387,16,21,0.762,100,32,80,0.4,26,53,0.491,6,27,0.222,14,19,0.737,84
1402,GSW,2016-04-09,100,@,MEM,1,240,39,87,0.448,29,51,0.569,10,36,0.278,12,13,0.923,100,37,96,0.385,30,75,0.4,7,21,0.333,18,20,0.9,99
1403,NOP,2016-04-09,100,,PHO,0,240,39,95,0.411,32,74,0.432,7,21,0.333,15,20,0.75,100,43,83,0.518,33,58,0.569,10,25,0.4,25,31,0.806,121
1404,LAL,2016-04-03,100,,BOS,0,240,37,90,0.411,31,69,0.449,6,21,0.286,20,29,0.69,100,41,91,0.451,33,61,0.541,8,30,0.267,17,22,0.773,107
1405,CHO,2016-04-01,100,,PHI,1,240,36,84,0.429,29,57,0.509,7,27,0.259,21,27,0.778,100,33,90,0.367,23,51,0.451,10,39,0.256,15,21,0.714,91
1406,HOU,2016-03-31,100,,CHI,0,240,36,90,0.4,27,65,0.415,9,25,0.36,19,22,0.864,100,37,77,0.481,26,53,0.491,11,24,0.458,18,22,0.818,103
1407,SAS,2016-03-30,100,,NOP,1,240,36,75,0.48,24,51,0.471,12,24,0.5,16,22,0.727,100,36,80,0.45,28,63,0.444,8,17,0.471,12,18,0.667,92
1408,MIA,2016-03-30,100,@,LAL,0,265,41,86,0.477,38,69,0.551,3,17,0.176,15,26,0.577,100,37,102,0.363,31,82,0.378,6,20,0.3,22,29,0.759,102
1409,CHO,2016-03-29,100,@,PHI,1,240,38,87,0.437,31,62,0.5,7,25,0.28,17,18,0.944,100,30,96,0.313,14,52,0.269,16,44,0.364,9,10,0.9,85
1410,CLE,2016-03-29,100,,HOU,0,240,31,86,0.36,17,46,0.37,14,40,0.35,24,28,0.857,100,38,79,0.481,29,54,0.537,9,25,0.36,21,42,0.5,106
1411,CHI,2016-03-28,100,,ATL,0,240,40,106,0.377,31,84,0.369,9,22,0.409,11,15,0.733,100,36,85,0.424,31,63,0.492,5,22,0.227,25,28,0.893,102
1412,TOR,2016-03-28,100,,OKC,0,240,38,93,0.409,30,69,0.435,8,24,0.333,16,23,0.696,100,41,86,0.477,30,60,0.5,11,26,0.423,26,32,0.813,119
1413,BRK,2016-03-22,100,,CHO,0,240,34,74,0.459,26,56,0.464,8,18,0.444,24,27,0.889,100,39,82,0.476,29,54,0.537,10,28,0.357,17,21,0.81,105
1414,MEM,2016-03-22,100,@,LAL,0,240,40,80,0.5,36,65,0.554,4,15,0.267,16,23,0.696,100,39,77,0.506,33,58,0.569,6,19,0.316,23,24,0.958,107
1415,ORL,2016-03-20,100,@,TOR,0,240,40,83,0.482,32,61,0.525,8,22,0.364,12,18,0.667,100,35,81,0.432,29,61,0.475,6,20,0.3,29,45,0.644,105
1416,BRK,2016-03-13,100,,MIL,0,240,39,70,0.557,27,43,0.628,12,27,0.444,10,13,0.769,100,45,89,0.506,39,75,0.52,6,14,0.429,13,21,0.619,109
1417,WAS,2016-03-12,100,@,DEN,0,240,36,86,0.419,29,65,0.446,7,21,0.333,21,29,0.724,100,42,80,0.525,34,56,0.607,8,24,0.333,24,29,0.828,116
1418,SAC,2016-03-11,100,,ORL,0,240,35,88,0.398,27,63,0.429,8,25,0.32,22,25,0.88,100,41,79,0.519,37,64,0.578,4,15,0.267,21,34,0.618,107
1419,CHI,2016-03-07,100,,MIL,1,240,39,78,0.5,29,53,0.547,10,25,0.4,12,15,0.8,100,36,91,0.396,29,73,0.397,7,18,0.389,11,17,0.647,90
1420,MEM,2016-03-06,100,,PHO,0,240,32,80,0.4,22,58,0.379,10,22,0.455,26,33,0.788,100,37,71,0.521,25,43,0.581,12,28,0.429,23,30,0.767,109
1421,IND,2016-03-05,100,@,WAS,1,240,37,83,0.446,30,62,0.484,7,21,0.333,19,20,0.95,100,39,89,0.438,33,74,0.446,6,15,0.4,15,24,0.625,99
1422,HOU,2016-03-05,100,@,CHI,0,240,35,87,0.402,26,52,0.5,9,35,0.257,21,30,0.7,100,36,79,0.456,27,58,0.466,9,21,0.429,27,34,0.794,108
1423,HOU,2016-03-02,100,,NOP,1,240,36,81,0.444,33,46,0.717,3,35,0.086,25,38,0.658,100,36,90,0.4,22,53,0.415,14,37,0.378,9,13,0.692,95
1424,CLE,2016-02-29,100,,IND,1,240,35,83,0.422,26,54,0.481,9,29,0.31,21,25,0.84,100,37,80,0.463,29,62,0.468,8,18,0.444,14,15,0.933,96
1425,BOS,2016-02-29,100,,UTA,1,240,37,84,0.44,31,66,0.47,6,18,0.333,20,29,0.69,100,38,101,0.376,31,77,0.403,7,24,0.292,12,17,0.706,95
1426,PHO,2016-02-19,100,,HOU,0,240,30,82,0.366,19,47,0.404,11,35,0.314,29,35,0.829,100,37,78,0.474,30,54,0.556,7,24,0.292,35,56,0.625,116
1427,NOP,2016-02-10,100,,UTA,1,240,39,82,0.476,31,63,0.492,8,19,0.421,14,21,0.667,100,33,70,0.471,26,49,0.531,7,21,0.333,23,30,0.767,96
1428,SAC,2016-02-08,100,@,CLE,0,240,36,82,0.439,27,59,0.458,9,23,0.391,19,29,0.655,100,45,94,0.479,29,59,0.492,16,35,0.457,14,19,0.737,120
1429,LAC,2016-02-07,100,@,MIA,1,240,37,81,0.457,28,56,0.5,9,25,0.36,17,33,0.515,100,33,83,0.398,26,66,0.394,7,17,0.412,20,29,0.69,93
1430,BRK,2016-02-03,100,,IND,0,240,36,81,0.444,29,58,0.5,7,23,0.304,21,31,0.677,100,44,88,0.5,32,64,0.5,12,24,0.5,14,17,0.824,114
1431,BRK,2016-02-01,100,,DET,0,240,40,82,0.488,33,66,0.5,7,16,0.438,13,15,0.867,100,42,98,0.429,32,68,0.471,10,30,0.333,11,16,0.688,105
1432,ORL,2016-01-26,100,@,MIL,0,240,33,80,0.413,20,56,0.357,13,24,0.542,21,29,0.724,100,38,77,0.494,33,64,0.516,5,13,0.385,26,31,0.839,107
1433,BRK,2016-01-18,100,@,TOR,0,240,39,76,0.513,34,62,0.548,5,14,0.357,17,19,0.895,100,43,85,0.506,30,61,0.492,13,24,0.542,13,18,0.722,112
1434,CHI,2016-01-11,100,,WAS,0,240,34,81,0.42,25,59,0.424,9,22,0.409,23,27,0.852,100,48,99,0.485,39,75,0.52,9,24,0.375,9,10,0.9,114
1435,NYK,2016-01-10,100,,MIL,1,240,39,84,0.464,32,60,0.533,7,24,0.292,15,18,0.833,100,32,80,0.4,29,67,0.433,3,13,0.231,21,30,0.7,88
1436,SAS,2016-01-08,100,,NYK,1,240,41,93,0.441,37,80,0.463,4,13,0.308,14,17,0.824,100,38,91,0.418,29,70,0.414,9,21,0.429,14,17,0.824,99
1437,DAL,2016-01-06,100,@,NOP,1,240,37,87,0.425,30,59,0.508,7,28,0.25,19,22,0.864,100,34,92,0.37,27,62,0.435,7,30,0.233,16,20,0.8,91
1438,IND,2016-01-04,100,@,MIA,0,265,37,94,0.394,29,66,0.439,8,28,0.286,18,25,0.72,100,34,90,0.378,29,68,0.426,5,22,0.227,30,39,0.769,103
1439,TOR,2016-01-04,100,@,CLE,0,240,36,73,0.493,28,54,0.519,8,19,0.421,20,29,0.69,100,41,74,0.554,24,41,0.585,17,33,0.515,23,26,0.885,122
1440,BRK,2016-01-02,100,@,BOS,1,240,38,93,0.409,35,75,0.467,3,18,0.167,21,22,0.955,100,34,88,0.386,27,56,0.482,7,32,0.219,22,28,0.786,97
1441,IND,2015-12-30,100,@,CHI,0,265,37,97,0.381,30,75,0.4,7,22,0.318,19,24,0.792,100,37,86,0.43,31,68,0.456,6,18,0.333,22,27,0.815,102
1442,ORL,2015-12-30,100,,BRK,1,240,36,82,0.439,27,56,0.482,9,26,0.346,19,21,0.905,100,35,83,0.422,32,63,0.508,3,20,0.15,20,22,0.909,93
1443,BOS,2015-12-27,100,,NYK,1,240,36,85,0.424,28,65,0.431,8,20,0.4,20,29,0.69,100,33,89,0.371,29,70,0.414,4,19,0.211,21,24,0.875,91
1444,PHI,2015-12-23,100,@,MIL,0,240,37,81,0.457,30,61,0.492,7,20,0.35,19,29,0.655,100,51,85,0.6,46,73,0.63,5,12,0.417,6,8,0.75,113
1445,WAS,2015-12-23,100,,MEM,1,240,37,82,0.451,26,57,0.456,11,25,0.44,15,19,0.789,100,33,72,0.458,30,55,0.545,3,17,0.176,22,32,0.688,91
1446,DET,2015-12-23,100,@,ATL,0,240,38,89,0.427,31,68,0.456,7,21,0.333,17,33,0.515,100,43,89,0.483,37,69,0.536,6,20,0.3,15,20,0.75,107
1447,OKC,2015-12-21,100,@,LAC,1,240,40,85,0.471,36,68,0.529,4,17,0.235,16,20,0.8,100,41,87,0.471,34,65,0.523,7,22,0.318,10,14,0.714,99
1448,ORL,2015-12-20,100,,ATL,0,240,38,81,0.469,34,69,0.493,4,12,0.333,20,24,0.833,100,39,78,0.5,28,56,0.5,11,22,0.5,14,20,0.7,103
1449,MIN,2015-12-20,100,@,BRK,1,240,38,80,0.475,35,68,0.515,3,12,0.25,21,24,0.875,100,32,78,0.41,27,57,0.474,5,21,0.238,16,20,0.8,85
1450,OKC,2015-12-17,100,@,CLE,0,240,35,74,0.473,29,54,0.537,6,20,0.3,24,28,0.857,100,41,88,0.466,29,59,0.492,12,29,0.414,10,13,0.769,104
1451,MIN,2015-12-15,100,,DEN,0,240,36,77,0.468,32,67,0.478,4,10,0.4,24,31,0.774,100,41,73,0.562,31,55,0.564,10,18,0.556,20,27,0.741,112
1452,MIA,2015-12-14,100,@,ATL,1,240,40,89,0.449,33,73,0.452,7,16,0.438,13,15,0.867,100,33,84,0.393,25,51,0.49,8,33,0.242,14,15,0.933,88
1453,MIA,2015-12-13,100,,MEM,1,240,37,77,0.481,30,55,0.545,7,22,0.318,19,23,0.826,100,40,77,0.519,33,58,0.569,7,19,0.368,10,14,0.714,97
1454,BRK,2015-12-12,100,,LAC,0,240,35,79,0.443,30,60,0.5,5,19,0.263,25,30,0.833,100,43,86,0.5,35,62,0.565,8,24,0.333,11,18,0.611,105
1455,BRK,2015-12-10,100,,PHI,1,240,37,74,0.5,31,60,0.517,6,14,0.429,20,27,0.741,100,34,87,0.391,30,56,0.536,4,31,0.129,19,22,0.864,91
1456,CHI,2015-12-09,100,@,BOS,0,240,39,91,0.429,33,70,0.471,6,21,0.286,16,23,0.696,100,38,92,0.413,33,69,0.478,5,23,0.217,24,28,0.857,105
1457,POR,2015-12-08,100,@,CLE,0,240,40,79,0.506,29,53,0.547,11,26,0.423,9,16,0.563,100,40,79,0.506,31,58,0.534,9,21,0.429,16,20,0.8,105
1458,ATL,2015-12-04,100,,LAL,1,240,37,74,0.5,27,48,0.563,10,26,0.385,16,20,0.8,100,32,86,0.372,19,59,0.322,13,27,0.481,10,13,0.769,87
1459,HOU,2015-12-04,100,@,DAL,1,240,39,84,0.464,27,58,0.466,12,26,0.462,10,18,0.556,100,37,81,0.457,29,52,0.558,8,29,0.276,14,20,0.7,96
1460,OKC,2015-11-30,100,@,ATL,0,240,37,93,0.398,30,74,0.405,7,19,0.368,19,22,0.864,100,39,90,0.433,29,62,0.468,10,28,0.357,18,20,0.9,106
1461,ORL,2015-11-25,100,,NYK,1,240,34,86,0.395,29,70,0.414,5,16,0.313,27,32,0.844,100,31,83,0.373,22,56,0.393,9,27,0.333,20,25,0.8,91
1462,MIN,2015-11-23,100,,PHI,1,240,36,78,0.462,33,66,0.5,3,12,0.25,25,27,0.926,100,32,78,0.41,22,47,0.468,10,31,0.323,21,27,0.778,95
1463,MIL,2015-11-19,100,@,CLE,0,240,38,73,0.521,35,65,0.538,3,8,0.375,21,26,0.808,100,40,71,0.563,29,47,0.617,11,24,0.458,24,30,0.8,115
1464,BOS,2015-11-15,100,@,OKC,1,240,39,82,0.476,30,59,0.508,9,23,0.391,13,20,0.65,100,28,77,0.364,22,52,0.423,6,25,0.24,23,29,0.793,85
1465,TOR,2015-11-13,100,,NOP,1,240,34,77,0.442,25,56,0.446,9,21,0.429,23,27,0.852,100,30,82,0.366,23,59,0.39,7,23,0.304,14,20,0.7,81
1466,POR,2015-11-13,100,@,MEM,0,240,33,69,0.478,25,47,0.532,8,22,0.364,26,29,0.897,100,36,86,0.419,30,70,0.429,6,16,0.375,23,27,0.852,101
1467,GSW,2015-11-11,100,@,MEM,1,240,36,75,0.48,25,48,0.521,11,27,0.407,17,23,0.739,100,24,70,0.343,21,55,0.382,3,15,0.2,33,36,0.917,84
1468,DET,2015-11-06,100,@,PHO,1,240,37,74,0.5,29,52,0.558,8,22,0.364,18,36,0.5,100,37,92,0.402,27,62,0.435,10,30,0.333,8,13,0.615,92
1469,IND,2015-11-04,100,,BOS,1,240,35,91,0.385,27,68,0.397,8,23,0.348,22,29,0.759,100,35,83,0.422,25,56,0.446,10,27,0.37,18,22,0.818,98
1470,PHI,2015-11-02,100,,CLE,0,240,38,85,0.447,31,61,0.508,7,24,0.292,17,23,0.739,100,42,81,0.519,34,59,0.576,8,22,0.364,15,20,0.75,107
1471,BRK,2015-10-28,100,,CHI,0,240,39,93,0.419,39,84,0.464,0,9,0.0,22,28,0.786,100,42,78,0.538,28,50,0.56,14,28,0.5,17,20,0.85,115
1472,DEN,2016-04-13,99,@,POR,0,240,40,94,0.426,33,69,0.478,7,25,0.28,12,18,0.667,99,39,89,0.438,28,53,0.528,11,36,0.306,18,22,0.818,107
1473,MIA,2016-04-12,99,@,DET,1,240,38,78,0.487,31,58,0.534,7,20,0.35,16,22,0.727,99,34,84,0.405,29,66,0.439,5,18,0.278,20,30,0.667,93
1474,MEM,2016-04-09,99,,GSW,0,240,37,96,0.385,30,75,0.4,7,21,0.333,18,20,0.9,99,39,87,0.448,29,51,0.569,10,36,0.278,12,13,0.923,100
1475,WAS,2016-04-08,99,@,DET,0,240,38,86,0.442,32,67,0.478,6,19,0.316,17,23,0.739,99,36,77,0.468,22,45,0.489,14,32,0.438,26,29,0.897,112
1476,BRK,2016-04-08,99,@,CHO,0,240,39,92,0.424,29,67,0.433,10,25,0.4,11,20,0.55,99,41,83,0.494,27,46,0.587,14,37,0.378,17,20,0.85,113
1477,UTA,2016-04-08,99,,LAC,0,265,36,82,0.439,25,51,0.49,11,31,0.355,16,23,0.696,99,37,83,0.446,24,54,0.444,13,29,0.448,15,19,0.789,102
1478,PHO,2016-04-01,99,,WAS,0,240,36,93,0.387,29,70,0.414,7,23,0.304,20,26,0.769,99,38,86,0.442,28,60,0.467,10,26,0.385,20,25,0.8,106
1479,TOR,2016-04-01,99,@,MEM,1,240,30,71,0.423,18,43,0.419,12,28,0.429,27,29,0.931,99,37,91,0.407,30,72,0.417,7,19,0.368,14,17,0.824,95
1480,LAC,2016-03-30,99,@,MIN,1,240,37,84,0.44,28,53,0.528,9,31,0.29,16,18,0.889,99,30,87,0.345,22,64,0.344,8,23,0.348,11,17,0.647,79
1481,BRK,2016-03-28,99,@,MIA,0,240,41,77,0.532,38,66,0.576,3,11,0.273,14,18,0.778,99,48,84,0.571,43,68,0.632,5,16,0.313,9,12,0.75,110
1482,NOP,2016-03-28,99,,NYK,1,240,32,75,0.427,24,56,0.429,8,19,0.421,27,37,0.73,99,36,89,0.404,26,58,0.448,10,31,0.323,9,13,0.692,91
1483,PHO,2016-03-26,99,,BOS,0,240,37,85,0.435,30,54,0.556,7,31,0.226,18,21,0.857,99,35,84,0.417,27,55,0.491,8,29,0.276,24,27,0.889,102
1484,NOP,2016-03-22,99,,MIA,0,240,34,87,0.391,27,71,0.38,7,16,0.438,24,30,0.8,99,44,88,0.5,41,69,0.594,3,19,0.158,22,27,0.815,113
1485,WAS,2016-03-19,99,,NYK,1,240,39,87,0.448,31,58,0.534,8,29,0.276,13,17,0.765,99,32,81,0.395,22,60,0.367,10,21,0.476,15,17,0.882,89
1486,WAS,2016-03-17,99,@,PHI,1,240,40,90,0.444,34,63,0.54,6,27,0.222,13,19,0.684,99,35,91,0.385,29,58,0.5,6,33,0.182,18,26,0.692,94
1487,ORL,2016-03-16,99,@,CHO,0,240,35,83,0.422,24,58,0.414,11,25,0.44,18,21,0.857,99,40,100,0.4,29,63,0.46,11,37,0.297,16,21,0.762,107
1488,CLE,2016-03-16,99,,DAL,1,240,39,88,0.443,29,51,0.569,10,37,0.27,11,13,0.846,99,37,79,0.468,30,57,0.526,7,22,0.318,17,19,0.895,98
1489,SAC,2016-03-13,99,,UTA,0,240,38,81,0.469,29,60,0.483,9,21,0.429,14,21,0.667,99,39,82,0.476,27,54,0.5,12,28,0.429,18,22,0.818,108
1490,MIN,2016-03-11,99,@,OKC,1,240,37,86,0.43,30,65,0.462,7,21,0.333,18,21,0.857,99,36,84,0.429,30,57,0.526,6,27,0.222,18,25,0.72,96
1491,BRK,2016-03-08,99,@,TOR,0,240,42,82,0.512,36,70,0.514,6,12,0.5,9,9,1.0,99,37,78,0.474,27,55,0.491,10,23,0.435,20,25,0.8,104
1492,IND,2016-03-07,99,,SAS,1,240,32,78,0.41,25,62,0.403,7,16,0.438,28,30,0.933,99,34,96,0.354,30,68,0.441,4,28,0.143,19,22,0.864,91
1493,WAS,2016-03-05,99,,IND,0,240,39,89,0.438,33,74,0.446,6,15,0.4,15,24,0.625,99,37,83,0.446,30,62,0.484,7,21,0.333,19,20,0.95,100
1494,PHI,2016-03-02,99,,CHO,0,240,34,85,0.4,21,52,0.404,13,33,0.394,18,26,0.692,99,40,81,0.494,30,56,0.536,10,25,0.4,29,35,0.829,119
1495,MIL,2016-03-02,99,,IND,0,240,34,76,0.447,31,62,0.5,3,14,0.214,28,32,0.875,99,38,80,0.475,28,60,0.467,10,20,0.5,18,26,0.692,104
1496,CLE,2016-02-28,99,@,WAS,0,240,32,80,0.4,23,51,0.451,9,29,0.31,26,30,0.867,99,39,79,0.494,28,48,0.583,11,31,0.355,24,34,0.706,113
1497,TOR,2016-02-26,99,,CLE,1,240,37,73,0.507,31,56,0.554,6,17,0.353,19,26,0.731,99,35,74,0.473,23,50,0.46,12,24,0.5,15,21,0.714,97
1498,MIL,2016-02-11,99,,WAS,1,240,36,82,0.439,32,68,0.471,4,14,0.286,23,32,0.719,99,34,88,0.386,28,56,0.5,6,32,0.188,18,24,0.75,92
1499,CLE,2016-02-06,99,,NOP,1,240,39,90,0.433,25,49,0.51,14,41,0.341,7,7,1.0,99,34,87,0.391,29,64,0.453,5,23,0.217,11,16,0.688,84
1500,LAL,2016-02-04,99,@,NOP,1,240,39,81,0.481,32,61,0.525,7,20,0.35,14,20,0.7,99,39,85,0.459,35,65,0.538,4,20,0.2,14,26,0.538,96
1501,HOU,2016-01-27,99,@,SAS,0,240,28,73,0.384,20,43,0.465,8,30,0.267,35,52,0.673,99,50,90,0.556,38,67,0.567,12,23,0.522,18,21,0.857,130
1502,MIL,2016-01-23,99,@,NOP,0,240,39,74,0.527,33,59,0.559,6,15,0.4,15,18,0.833,99,43,94,0.457,26,63,0.413,17,31,0.548,13,17,0.765,116
1503,DET,2016-01-21,99,@,NOP,0,240,38,91,0.418,31,61,0.508,7,30,0.233,16,20,0.8,99,46,86,0.535,41,74,0.554,5,12,0.417,18,18,1.0,115
1504,MIN,2016-01-19,99,@,NOP,0,240,36,76,0.474,33,62,0.532,3,14,0.214,24,31,0.774,99,42,83,0.506,32,60,0.533,10,23,0.435,20,23,0.87,114
1505,NOP,2016-01-18,99,@,MEM,0,240,36,74,0.486,30,55,0.545,6,19,0.316,21,23,0.913,99,35,75,0.467,27,56,0.482,8,19,0.421,23,30,0.767,101
1506,OKC,2016-01-17,99,,MIA,1,240,40,88,0.455,33,66,0.5,7,22,0.318,12,12,1.0,99,30,72,0.417,26,58,0.448,4,14,0.286,10,11,0.909,74
1507,SAS,2016-01-14,99,,CLE,1,240,38,83,0.458,33,66,0.5,5,17,0.294,18,22,0.818,99,38,82,0.463,28,56,0.5,10,26,0.385,9,11,0.818,95
1508,POR,2016-01-13,99,,UTA,1,240,39,88,0.443,28,62,0.452,11,26,0.423,10,15,0.667,99,31,76,0.408,23,57,0.404,8,19,0.421,15,22,0.682,85
1509,DET,2016-01-12,99,,SAS,0,240,38,91,0.418,32,68,0.471,6,23,0.261,17,26,0.654,99,41,85,0.482,36,71,0.507,5,14,0.357,22,27,0.815,109
1510,ORL,2016-01-09,99,,WAS,0,240,38,74,0.514,33,60,0.55,5,14,0.357,18,24,0.75,99,42,76,0.553,29,53,0.547,13,23,0.565,8,10,0.8,105
1511,NYK,2016-01-08,99,@,SAS,0,240,38,91,0.418,29,70,0.414,9,21,0.429,14,17,0.824,99,41,93,0.441,37,80,0.463,4,13,0.308,14,17,0.824,100
1512,MIN,2016-01-08,99,,CLE,0,240,36,79,0.456,29,63,0.46,7,16,0.438,20,26,0.769,99,43,81,0.531,30,54,0.556,13,27,0.481,26,29,0.897,125
1513,DET,2016-01-06,99,@,BOS,1,240,33,74,0.446,23,47,0.489,10,27,0.37,23,36,0.639,99,34,91,0.374,28,63,0.444,6,28,0.214,20,27,0.741,94
1514,MIN,2016-01-04,99,@,PHI,0,240,39,73,0.534,37,68,0.544,2,5,0.4,19,24,0.792,99,48,87,0.552,44,67,0.657,4,20,0.2,9,14,0.643,109
1515,PHI,2016-01-02,99,@,LAC,0,240,41,89,0.461,32,66,0.485,9,23,0.391,8,17,0.471,99,49,81,0.605,37,58,0.638,12,23,0.522,20,25,0.8,130
1516,MEM,2015-12-29,99,,MIA,1,265,38,87,0.437,34,72,0.472,4,15,0.267,19,20,0.95,99,35,79,0.443,24,50,0.48,11,29,0.379,9,18,0.5,90
1517,BOS,2015-12-26,99,@,DET,1,240,39,84,0.464,35,61,0.574,4,23,0.174,17,23,0.739,99,35,91,0.385,29,66,0.439,6,25,0.24,17,25,0.68,93
1518,DAL,2015-12-22,99,@,TOR,0,240,40,92,0.435,29,63,0.46,11,29,0.379,8,11,0.727,99,35,74,0.473,23,48,0.479,12,26,0.462,21,27,0.778,103
1519,MIN,2015-12-21,99,@,BOS,0,240,36,79,0.456,34,66,0.515,2,13,0.154,25,32,0.781,99,46,89,0.517,34,64,0.531,12,25,0.48,9,16,0.563,113
1520,LAC,2015-12-21,99,,OKC,0,240,41,87,0.471,34,65,0.523,7,22,0.318,10,14,0.714,99,40,85,0.471,36,68,0.529,4,17,0.235,16,20,0.8,100
1521,SAC,2015-12-21,99,@,WAS,0,240,37,91,0.407,30,69,0.435,7,22,0.318,18,22,0.818,99,42,83,0.506,28,59,0.475,14,24,0.583,15,17,0.882,113
1522,NYK,2015-12-21,99,,ORL,0,240,39,76,0.513,32,52,0.615,7,24,0.292,14,16,0.875,99,44,86,0.512,34,64,0.531,10,22,0.455,9,11,0.818,107
1523,MIN,2015-12-18,99,,SAC,1,240,39,82,0.476,33,64,0.516,6,18,0.333,15,16,0.938,99,38,81,0.469,31,58,0.534,7,23,0.304,12,17,0.706,95
1524,TOR,2015-12-17,99,@,CHO,0,265,35,97,0.361,26,58,0.448,9,39,0.231,20,28,0.714,99,37,85,0.435,27,56,0.482,10,29,0.345,25,31,0.806,109
1525,MEM,2015-12-11,99,,CHO,0,240,32,80,0.4,25,60,0.417,7,20,0.35,28,37,0.757,99,39,78,0.5,21,41,0.512,18,37,0.486,27,30,0.9,123
1526,SAC,2015-12-10,99,,NYK,1,240,42,93,0.452,39,77,0.506,3,16,0.188,12,16,0.75,99,33,83,0.398,24,54,0.444,9,29,0.31,22,28,0.786,97
1527,CHO,2015-12-09,99,,MIA,1,240,40,81,0.494,29,54,0.537,11,27,0.407,8,17,0.471,99,29,75,0.387,23,54,0.426,6,21,0.286,17,24,0.708,81
1528,MIA,2015-12-05,99,,CLE,1,240,37,68,0.544,30,52,0.577,7,16,0.438,18,29,0.621,99,31,85,0.365,25,57,0.439,6,28,0.214,16,24,0.667,84
1529,NYK,2015-12-02,99,,PHI,1,240,38,88,0.432,34,69,0.493,4,19,0.211,19,22,0.864,99,32,86,0.372,23,56,0.411,9,30,0.3,14,24,0.583,87
1530,CHO,2015-12-02,99,,GSW,0,240,35,94,0.372,26,63,0.413,9,31,0.29,20,30,0.667,99,46,88,0.523,30,54,0.556,16,34,0.471,8,11,0.727,116
1531,CHI,2015-12-02,99,,DEN,1,240,36,89,0.404,30,72,0.417,6,17,0.353,21,27,0.778,99,36,93,0.387,31,78,0.397,5,15,0.333,13,22,0.591,90
1532,MIN,2015-11-29,99,@,LAC,0,240,37,82,0.451,29,66,0.439,8,16,0.5,17,21,0.81,99,39,75,0.52,31,53,0.585,8,22,0.364,21,33,0.636,107
1533,CLE,2015-11-25,99,@,TOR,0,240,36,82,0.439,22,53,0.415,14,29,0.483,13,16,0.813,99,40,79,0.506,29,54,0.537,11,25,0.44,12,22,0.545,103
1534,MIN,2015-11-25,99,,ATL,1,240,34,82,0.415,25,61,0.41,9,21,0.429,22,29,0.759,99,31,82,0.378,23,51,0.451,8,31,0.258,25,35,0.714,95
1535,BRK,2015-11-25,99,@,OKC,0,240,43,94,0.457,40,81,0.494,3,13,0.231,10,12,0.833,99,41,78,0.526,31,54,0.574,10,24,0.417,18,21,0.857,110
1536,CLE,2015-11-17,99,@,DET,0,240,38,80,0.475,27,47,0.574,11,33,0.333,12,20,0.6,99,36,84,0.429,29,63,0.46,7,21,0.333,25,31,0.806,104
1537,ORL,2015-11-14,99,@,WAS,0,240,38,87,0.437,34,69,0.493,4,18,0.222,19,24,0.792,99,39,83,0.47,27,54,0.5,12,29,0.414,18,26,0.692,108
1538,BRK,2015-11-14,99,@,GSW,0,265,41,98,0.418,39,80,0.488,2,18,0.111,15,16,0.938,99,43,97,0.443,31,63,0.492,12,34,0.353,9,10,0.9,107
1539,LAL,2015-11-11,99,@,ORL,0,240,39,79,0.494,32,57,0.561,7,22,0.318,14,18,0.778,99,40,100,0.4,27,72,0.375,13,28,0.464,8,12,0.667,101
1540,BOS,2015-11-10,99,@,MIL,1,240,38,86,0.442,31,56,0.554,7,30,0.233,16,19,0.842,99,30,73,0.411,24,56,0.429,6,17,0.353,17,23,0.739,83
1541,NYK,2015-11-08,99,,LAL,1,240,33,84,0.393,24,57,0.421,9,27,0.333,24,29,0.828,99,36,94,0.383,27,67,0.403,9,27,0.333,14,23,0.609,95
1542,WAS,2015-11-07,99,@,ATL,0,240,38,78,0.487,30,54,0.556,8,24,0.333,15,17,0.882,99,43,92,0.467,30,59,0.508,13,33,0.394,15,15,1.0,114
1543,MIL,2015-11-06,99,@,NYK,1,240,35,81,0.432,32,67,0.478,3,14,0.214,26,29,0.897,99,33,81,0.407,29,57,0.509,4,24,0.167,22,28,0.786,92
1544,SAS,2015-11-04,99,@,WAS,0,240,37,81,0.457,30,59,0.508,7,22,0.318,18,20,0.9,99,42,87,0.483,34,64,0.531,8,23,0.348,10,14,0.714,102
1545,UTA,2015-10-30,99,@,PHI,1,240,36,88,0.409,29,75,0.387,7,13,0.538,20,25,0.8,99,19,63,0.302,13,48,0.271,6,15,0.4,27,37,0.73,71
1546,IND,2015-10-28,99,@,TOR,0,240,32,86,0.372,23,63,0.365,9,23,0.391,26,31,0.839,99,36,80,0.45,29,62,0.468,7,18,0.389,27,39,0.692,106
1547,BOS,2016-04-13,98,,MIA,1,240,37,86,0.43,32,72,0.444,5,14,0.357,19,22,0.864,98,38,88,0.432,36,69,0.522,2,19,0.105,10,12,0.833,88
1548,ATL,2016-04-13,98,@,WAS,0,240,32,81,0.395,21,52,0.404,11,29,0.379,23,31,0.742,98,42,88,0.477,33,60,0.55,9,28,0.321,16,30,0.533,109
1549,OKC,2016-04-12,98,@,SAS,0,265,35,87,0.402,29,62,0.468,6,25,0.24,22,25,0.88,98,37,87,0.425,33,73,0.452,4,14,0.286,24,32,0.75,102
1550,PHI,2016-04-12,98,@,TOR,0,240,35,77,0.455,20,42,0.476,15,35,0.429,13,25,0.52,98,48,95,0.505,38,70,0.543,10,25,0.4,16,19,0.842,122
1551,MIL,2016-04-11,98,@,ORL,0,240,41,78,0.526,38,63,0.603,3,15,0.2,13,19,0.684,98,41,84,0.488,34,61,0.557,7,23,0.304,18,28,0.643,107
1552,LAC,2016-04-10,98,,DAL,1,240,37,76,0.487,28,58,0.483,9,18,0.5,15,37,0.405,98,30,74,0.405,22,44,0.5,8,30,0.267,23,33,0.697,91
1553,CHO,2016-04-10,98,@,WAS,0,240,28,81,0.346,16,48,0.333,12,33,0.364,30,35,0.857,98,42,80,0.525,33,59,0.559,9,21,0.429,20,28,0.714,113
1554,SAS,2016-04-08,98,@,DEN,0,240,36,85,0.424,33,71,0.465,3,14,0.214,23,28,0.821,98,40,86,0.465,34,64,0.531,6,22,0.273,16,19,0.842,102
1555,IND,2016-04-08,98,@,TOR,0,240,37,83,0.446,29,56,0.518,8,27,0.296,16,20,0.8,98,37,68,0.544,27,46,0.587,10,22,0.455,27,38,0.711,111
1556,CHI,2016-04-07,98,@,MIA,0,240,35,78,0.449,32,64,0.5,3,14,0.214,25,28,0.893,98,44,92,0.478,40,78,0.513,4,14,0.286,14,17,0.824,106
1557,MIL,2016-04-03,98,,CHI,0,240,40,85,0.471,38,78,0.487,2,7,0.286,16,20,0.8,98,39,74,0.527,32,48,0.667,7,26,0.269,17,22,0.773,102
1558,UTA,2016-04-01,98,,MIN,1,240,38,72,0.528,30,50,0.6,8,22,0.364,14,23,0.609,98,35,79,0.443,26,56,0.464,9,23,0.391,6,10,0.6,85
1559,DAL,2016-04-01,98,@,DET,1,240,39,85,0.459,31,61,0.508,8,24,0.333,12,14,0.857,98,31,81,0.383,18,48,0.375,13,33,0.394,14,24,0.583,89
1560,CHI,2016-03-29,98,@,IND,1,240,37,87,0.425,27,61,0.443,10,26,0.385,14,16,0.875,98,39,90,0.433,36,71,0.507,3,19,0.158,15,17,0.882,96
1561,LAC,2016-03-23,98,@,GSW,0,240,36,85,0.424,28,57,0.491,8,28,0.286,18,27,0.667,98,39,87,0.448,24,53,0.453,15,34,0.441,21,28,0.75,114
1562,DEN,2016-03-17,98,@,ATL,0,240,39,87,0.448,33,65,0.508,6,22,0.273,14,17,0.824,98,40,80,0.5,28,54,0.519,12,26,0.462,24,28,0.857,116
1563,DAL,2016-03-16,98,@,CLE,0,240,37,79,0.468,30,57,0.526,7,22,0.318,17,19,0.895,98,39,88,0.443,29,51,0.569,10,37,0.27,11,13,0.846,99
1564,BOS,2016-03-15,98,@,IND,0,240,36,94,0.383,28,63,0.444,8,31,0.258,18,22,0.818,98,39,84,0.464,34,72,0.472,5,12,0.417,20,28,0.714,103
1565,LAL,2016-03-15,98,,SAC,0,240,37,84,0.44,32,58,0.552,5,26,0.192,19,26,0.731,98,38,79,0.481,34,61,0.557,4,18,0.222,26,33,0.788,106
1566,BOS,2016-03-11,98,,HOU,0,240,34,91,0.374,26,60,0.433,8,31,0.258,22,28,0.786,98,40,88,0.455,35,62,0.565,5,26,0.192,17,25,0.68,102
1567,PHO,2016-03-10,98,@,DEN,0,240,33,89,0.371,27,61,0.443,6,28,0.214,26,33,0.788,98,44,91,0.484,31,63,0.492,13,28,0.464,15,19,0.789,116
1568,ORL,2016-03-08,98,@,LAL,0,240,37,76,0.487,32,57,0.561,5,19,0.263,19,27,0.704,98,40,81,0.494,31,54,0.574,9,27,0.333,18,23,0.783,107
1569,PHI,2016-03-06,98,@,MIA,0,240,37,85,0.435,26,54,0.481,11,31,0.355,13,22,0.591,98,36,81,0.444,28,67,0.418,8,14,0.571,23,30,0.767,103
1570,MIN,2016-03-02,98,,WAS,0,240,32,75,0.427,27,61,0.443,5,14,0.357,29,34,0.853,98,42,84,0.5,31,55,0.564,11,29,0.379,9,13,0.692,104
1571,SAC,2016-03-02,98,@,MEM,0,240,39,82,0.476,30,56,0.536,9,26,0.346,11,20,0.55,98,35,79,0.443,30,61,0.492,5,18,0.278,29,33,0.879,104
1572,OKC,2016-03-02,98,@,LAC,0,240,39,98,0.398,29,63,0.46,10,35,0.286,10,11,0.909,98,40,98,0.408,31,66,0.47,9,32,0.281,14,21,0.667,103
1573,MIA,2016-02-28,98,@,NYK,1,240,40,84,0.476,39,76,0.513,1,8,0.125,17,21,0.81,98,32,87,0.368,26,72,0.361,6,15,0.4,11,12,0.917,81
1574,BRK,2016-02-27,98,@,UTA,1,240,40,84,0.476,33,69,0.478,7,15,0.467,11,17,0.647,98,37,89,0.416,32,69,0.464,5,20,0.25,17,25,0.68,96
1575,TOR,2016-02-21,98,,MEM,1,240,33,81,0.407,26,53,0.491,7,28,0.25,25,31,0.806,98,28,76,0.368,25,56,0.446,3,20,0.15,26,32,0.813,85
1576,OKC,2016-02-19,98,,IND,0,240,42,96,0.438,37,70,0.529,5,26,0.192,9,10,0.9,98,39,88,0.443,30,66,0.455,9,22,0.409,14,22,0.636,101
1577,WAS,2016-02-19,98,,DET,1,240,36,78,0.462,29,56,0.518,7,22,0.318,19,26,0.731,98,35,82,0.427,28,59,0.475,7,23,0.304,9,17,0.529,86
1578,NYK,2016-02-19,98,@,BRK,0,240,36,82,0.439,26,56,0.464,10,26,0.385,16,18,0.889,98,42,86,0.488,34,69,0.493,8,17,0.471,17,20,0.85,109
1579,CHO,2016-02-19,98,@,MIL,1,240,37,86,0.43,28,55,0.509,9,31,0.29,15,18,0.833,98,36,81,0.444,29,62,0.468,7,19,0.368,16,21,0.762,95
1580,SAS,2016-02-10,98,@,ORL,1,240,38,89,0.427,30,69,0.435,8,20,0.4,14,15,0.933,98,37,91,0.407,29,71,0.408,8,20,0.4,14,16,0.875,96
1581,LAC,2016-02-08,98,@,PHI,1,265,35,95,0.368,30,73,0.411,5,22,0.227,23,31,0.742,98,34,90,0.378,28,65,0.431,6,25,0.24,18,21,0.857,92
1582,BRK,2016-02-06,98,@,PHI,0,240,35,76,0.461,30,61,0.492,5,15,0.333,23,26,0.885,98,38,81,0.469,28,52,0.538,10,29,0.345,17,22,0.773,103
1583,UTA,2016-02-06,98,@,PHO,1,240,34,78,0.436,29,62,0.468,5,16,0.313,25,31,0.806,98,30,80,0.375,21,56,0.375,9,24,0.375,20,26,0.769,89
1584,MIA,2016-02-05,98,@,CHO,1,240,43,94,0.457,43,85,0.506,0,9,0.0,12,18,0.667,98,36,81,0.444,26,55,0.473,10,26,0.385,13,15,0.867,95
1585,WAS,2016-02-01,98,@,OKC,0,240,40,86,0.465,33,60,0.55,7,26,0.269,11,15,0.733,98,43,83,0.518,36,61,0.59,7,22,0.318,21,27,0.778,114
1586,BRK,2016-01-26,98,,MIA,0,240,36,71,0.507,27,53,0.509,9,18,0.5,17,23,0.739,98,45,83,0.542,42,74,0.568,3,9,0.333,9,10,0.9,102
1587,PHO,2016-01-23,98,,ATL,1,240,34,85,0.4,24,61,0.393,10,24,0.417,20,26,0.769,98,34,84,0.405,22,50,0.44,12,34,0.353,15,18,0.833,95
1588,MIL,2016-01-22,98,@,HOU,0,240,39,85,0.459,36,71,0.507,3,14,0.214,17,22,0.773,98,38,94,0.404,23,50,0.46,15,44,0.341,11,16,0.688,102
1589,POR,2016-01-20,98,,ATL,0,240,41,94,0.436,32,63,0.508,9,31,0.29,7,11,0.636,98,39,87,0.448,29,63,0.46,10,24,0.417,16,23,0.696,104
1590,CLE,2016-01-18,98,,GSW,0,240,37,77,0.481,30,58,0.517,7,19,0.368,17,25,0.68,98,46,85,0.541,27,45,0.6,19,40,0.475,21,27,0.778,132
1591,ATL,2016-01-18,98,,ORL,1,240,41,80,0.513,32,61,0.525,9,19,0.474,7,10,0.7,98,30,87,0.345,24,65,0.369,6,22,0.273,15,20,0.75,81
1592,WAS,2016-01-18,98,,POR,0,240,37,77,0.481,28,56,0.5,9,21,0.429,15,20,0.75,98,43,84,0.512,26,53,0.491,17,31,0.548,5,11,0.455,108
1593,MIA,2016-01-15,98,@,DEN,1,240,40,81,0.494,36,69,0.522,4,12,0.333,14,19,0.737,98,32,78,0.41,26,60,0.433,6,18,0.333,25,26,0.962,95
1594,LAL,2016-01-14,98,@,GSW,0,240,40,90,0.444,36,67,0.537,4,23,0.174,14,24,0.583,98,43,86,0.5,30,53,0.566,13,33,0.394,17,20,0.85,116
1595,BOS,2016-01-10,98,@,MEM,0,240,37,88,0.42,30,66,0.455,7,22,0.318,17,23,0.739,98,31,84,0.369,27,68,0.397,4,16,0.25,35,40,0.875,101
1596,UTA,2016-01-09,98,,MIA,1,240,39,71,0.549,30,51,0.588,9,20,0.45,11,18,0.611,98,34,82,0.415,28,63,0.444,6,19,0.316,9,17,0.529,83
1597,PHI,2016-01-07,98,,ATL,0,240,39,86,0.453,34,68,0.5,5,18,0.278,15,25,0.6,98,49,92,0.533,36,60,0.6,13,32,0.406,15,19,0.789,126
1598,NYK,2016-01-06,98,@,MIA,1,240,39,70,0.557,36,62,0.581,3,8,0.375,17,18,0.944,98,37,82,0.451,35,65,0.538,2,17,0.118,14,15,0.933,90
1599,UTA,2016-01-06,98,@,SAS,0,240,37,79,0.468,30,61,0.492,7,18,0.389,17,18,0.944,98,52,86,0.605,43,65,0.662,9,21,0.429,10,13,0.769,123
1600,POR,2016-01-06,98,,LAC,0,240,38,86,0.442,29,60,0.483,9,26,0.346,13,23,0.565,98,42,83,0.506,31,60,0.517,11,23,0.478,14,17,0.824,109
1601,MIL,2016-01-04,98,,SAS,0,240,37,77,0.481,34,65,0.523,3,12,0.25,21,30,0.7,98,49,90,0.544,40,70,0.571,9,20,0.45,16,20,0.8,123
1602,DAL,2016-01-02,98,,NOP,0,240,36,83,0.434,26,57,0.456,10,26,0.385,16,19,0.842,98,40,83,0.482,34,63,0.54,6,20,0.3,19,24,0.792,105
1603,LAL,2015-12-28,98,@,CHO,0,240,35,85,0.412,26,56,0.464,9,29,0.31,19,23,0.826,98,43,89,0.483,37,64,0.578,6,25,0.24,16,22,0.727,108
1604,POR,2015-12-27,98,@,SAC,1,240,38,92,0.413,28,59,0.475,10,33,0.303,12,16,0.75,98,30,76,0.395,21,52,0.404,9,24,0.375,25,31,0.806,94
1605,CHO,2015-12-26,98,,MEM,1,240,28,69,0.406,14,37,0.378,14,32,0.438,28,32,0.875,98,37,90,0.411,30,71,0.423,7,19,0.368,11,21,0.524,92
1606,NYK,2015-12-26,98,@,ATL,0,240,39,81,0.481,32,57,0.561,7,24,0.292,13,17,0.765,98,47,88,0.534,39,63,0.619,8,25,0.32,15,18,0.833,117
1607,BRK,2015-12-16,98,,MIA,0,240,42,89,0.472,38,73,0.521,4,16,0.25,10,14,0.714,98,40,75,0.533,33,54,0.611,7,21,0.333,17,24,0.708,104
1608,CHO,2015-12-16,98,@,ORL,0,240,36,79,0.456,22,45,0.489,14,34,0.412,12,15,0.8,98,43,77,0.558,29,53,0.547,14,24,0.583,13,15,0.867,113
1609,CHI,2015-12-16,98,,MEM,1,240,38,86,0.442,29,62,0.468,9,24,0.375,13,19,0.684,98,32,76,0.421,27,57,0.474,5,19,0.263,16,28,0.571,85
1610,UTA,2015-12-13,98,@,OKC,0,265,39,94,0.415,31,72,0.431,8,22,0.364,12,20,0.6,98,35,79,0.443,28,58,0.483,7,21,0.333,27,30,0.9,104
1611,BOS,2015-12-12,98,@,CHO,1,240,40,96,0.417,31,71,0.437,9,25,0.36,9,10,0.9,98,36,88,0.409,25,53,0.472,11,35,0.314,10,10,1.0,93
1612,CHI,2015-12-12,98,,NOP,1,240,33,78,0.423,25,58,0.431,8,20,0.4,24,29,0.828,98,40,89,0.449,34,73,0.466,6,16,0.375,8,11,0.727,94
1613,ATL,2015-12-09,98,@,DAL,1,240,39,81,0.481,33,61,0.541,6,20,0.3,14,18,0.778,98,36,100,0.36,29,69,0.42,7,31,0.226,16,19,0.842,95
1614,BRK,2015-12-06,98,,GSW,0,240,39,89,0.438,34,72,0.472,5,17,0.294,15,23,0.652,98,44,86,0.512,30,53,0.566,14,33,0.424,12,23,0.522,114
1615,OKC,2015-12-06,98,,SAC,1,240,35,86,0.407,29,64,0.453,6,22,0.273,22,31,0.71,98,35,88,0.398,28,64,0.438,7,24,0.292,18,30,0.6,95
1616,DAL,2015-11-30,98,@,SAC,0,240,36,84,0.429,27,47,0.574,9,37,0.243,17,22,0.773,98,36,79,0.456,27,48,0.563,9,31,0.29,31,44,0.705,112
1617,SAS,2015-11-23,98,,PHO,1,240,42,82,0.512,33,62,0.532,9,20,0.45,5,10,0.5,98,34,73,0.466,27,54,0.5,7,19,0.368,9,10,0.9,84
1618,DEN,2015-11-18,98,@,SAS,0,240,38,98,0.388,33,83,0.398,5,15,0.333,17,18,0.944,98,42,86,0.488,33,68,0.485,9,18,0.5,16,20,0.8,109
1619,NOP,2015-11-17,98,,DEN,0,240,41,83,0.494,34,60,0.567,7,23,0.304,9,11,0.818,98,45,85,0.529,30,55,0.545,15,30,0.5,10,13,0.769,115
1620,HOU,2015-11-14,98,,DAL,0,240,32,84,0.381,23,50,0.46,9,34,0.265,25,32,0.781,98,43,89,0.483,35,61,0.574,8,28,0.286,16,21,0.762,110
1621,HOU,2015-11-13,98,@,DEN,0,240,33,77,0.429,24,48,0.5,9,29,0.31,23,31,0.742,98,37,81,0.457,28,61,0.459,9,20,0.45,24,32,0.75,107
1622,HOU,2015-11-11,98,,BRK,0,240,42,98,0.429,34,64,0.531,8,34,0.235,6,12,0.5,98,42,98,0.429,34,81,0.42,8,17,0.471,14,17,0.824,106
1623,NOP,2015-11-11,98,@,ATL,0,240,37,83,0.446,23,54,0.426,14,29,0.483,10,15,0.667,98,42,86,0.488,32,60,0.533,10,26,0.385,12,16,0.75,106
1624,NOP,2015-11-07,98,@,DAL,0,240,39,86,0.453,30,58,0.517,9,28,0.321,11,13,0.846,98,40,84,0.476,31,60,0.517,9,24,0.375,18,22,0.818,107
1625,WAS,2015-11-06,98,@,BOS,0,240,36,88,0.409,28,63,0.444,8,25,0.32,18,23,0.783,98,44,97,0.454,32,67,0.478,12,30,0.4,18,23,0.783,118
1626,BRK,2015-11-06,98,,LAL,0,240,40,93,0.43,37,74,0.5,3,19,0.158,15,20,0.75,98,33,78,0.423,26,55,0.473,7,23,0.304,31,40,0.775,104
1627,OKC,2015-11-05,98,@,CHI,0,240,38,84,0.452,33,71,0.465,5,13,0.385,17,20,0.85,98,40,90,0.444,33,72,0.458,7,18,0.389,17,21,0.81,104
1628,OKC,2015-11-04,98,,TOR,0,240,39,82,0.476,31,59,0.525,8,23,0.348,12,14,0.857,98,33,79,0.418,28,65,0.431,5,14,0.357,32,39,0.821,103
1629,BOS,2015-11-04,98,@,IND,0,240,35,83,0.422,25,56,0.446,10,27,0.37,18,22,0.818,98,35,91,0.385,27,68,0.397,8,23,0.348,22,29,0.759,100
1630,ATL,2015-11-03,98,@,MIA,1,240,37,90,0.411,30,69,0.435,7,21,0.333,17,22,0.773,98,38,86,0.442,33,58,0.569,5,28,0.179,11,16,0.688,92
1631,DET,2015-10-30,98,,CHI,1,265,39,104,0.375,33,76,0.434,6,28,0.214,14,28,0.5,98,34,84,0.405,27,62,0.435,7,22,0.318,19,26,0.731,94
1632,IND,2016-04-13,97,@,MIL,1,240,39,90,0.433,28,66,0.424,11,24,0.458,8,10,0.8,97,37,87,0.425,30,64,0.469,7,23,0.304,11,13,0.846,92
1633,SAC,2016-04-07,97,,MIN,0,240,36,85,0.424,30,68,0.441,6,17,0.353,19,21,0.905,97,36,80,0.45,25,59,0.424,11,21,0.524,22,31,0.71,105
1634,NOP,2016-04-06,97,@,BOS,0,240,34,78,0.436,25,54,0.463,9,24,0.375,20,23,0.87,97,36,87,0.414,26,53,0.491,10,34,0.294,22,27,0.815,104
1635,NYK,2016-04-06,97,,CHO,0,240,37,78,0.474,27,52,0.519,10,26,0.385,13,15,0.867,97,42,90,0.467,30,64,0.469,12,26,0.462,15,17,0.882,111
1636,ATL,2016-03-30,97,@,TOR,0,240,37,83,0.446,23,50,0.46,14,33,0.424,9,13,0.692,97,36,80,0.45,25,57,0.439,11,23,0.478,22,28,0.786,105
1637,DAL,2016-03-28,97,@,DEN,1,240,36,88,0.409,25,56,0.446,11,32,0.344,14,15,0.933,97,31,70,0.443,22,46,0.478,9,24,0.375,17,19,0.895,88
1638,ORL,2016-03-25,97,@,MIA,0,240,36,84,0.429,30,66,0.455,6,18,0.333,19,28,0.679,97,40,80,0.5,35,65,0.538,5,15,0.333,23,33,0.697,108
1639,PHO,2016-03-21,97,,MEM,0,240,30,76,0.395,19,48,0.396,11,28,0.393,26,34,0.765,97,39,90,0.433,31,70,0.443,8,20,0.4,17,19,0.895,103
1640,HOU,2016-03-19,97,@,ATL,0,240,33,84,0.393,28,61,0.459,5,23,0.217,26,31,0.839,97,44,88,0.5,30,50,0.6,14,38,0.368,7,12,0.583,109
1641,PHI,2016-03-18,97,,OKC,0,240,35,89,0.393,25,60,0.417,10,29,0.345,17,27,0.63,97,45,89,0.506,38,67,0.567,7,22,0.318,14,18,0.778,111
1642,PHO,2016-03-09,97,,NYK,0,240,39,89,0.438,30,60,0.5,9,29,0.31,10,15,0.667,97,46,82,0.561,30,58,0.517,16,24,0.667,20,24,0.833,128
1643,LAC,2016-03-05,97,,ATL,0,240,34,79,0.43,22,47,0.468,12,32,0.375,17,28,0.607,97,40,89,0.449,30,62,0.484,10,27,0.37,17,20,0.85,107
1644,SAS,2016-03-02,97,,DET,1,240,43,84,0.512,40,70,0.571,3,14,0.214,8,9,0.889,97,31,78,0.397,25,59,0.424,6,19,0.316,13,23,0.565,81
1645,CLE,2016-02-26,97,@,TOR,0,240,35,74,0.473,23,50,0.46,12,24,0.5,15,21,0.714,97,37,73,0.507,31,56,0.554,6,17,0.353,19,26,0.731,99
1646,NOP,2016-02-03,97,@,SAS,0,240,41,90,0.456,38,71,0.535,3,19,0.158,12,14,0.857,97,42,81,0.519,33,66,0.5,9,15,0.6,17,18,0.944,110
1647,CLE,2016-02-03,97,@,CHO,0,240,38,83,0.458,28,55,0.509,10,28,0.357,11,14,0.786,97,39,79,0.494,30,52,0.577,9,27,0.333,19,23,0.826,106
1648,BOS,2016-02-02,97,@,NYK,1,240,40,90,0.444,37,71,0.521,3,19,0.158,14,17,0.824,97,31,82,0.378,25,62,0.403,6,20,0.3,21,28,0.75,89
1649,PHO,2016-02-02,97,,TOR,0,240,37,79,0.468,25,48,0.521,12,31,0.387,11,15,0.733,97,35,74,0.473,26,47,0.553,9,27,0.333,25,32,0.781,104
1650,DAL,2016-02-01,97,@,ATL,0,240,31,85,0.365,24,59,0.407,7,26,0.269,28,38,0.737,97,42,80,0.525,28,45,0.622,14,35,0.4,14,19,0.737,112
1651,PHI,2016-01-27,97,@,DET,0,240,39,82,0.476,32,63,0.508,7,19,0.368,12,17,0.706,97,39,91,0.429,34,70,0.486,5,21,0.238,27,38,0.711,110
1652,SAC,2016-01-26,97,@,POR,0,240,36,86,0.419,29,67,0.433,7,19,0.368,18,32,0.563,97,44,90,0.489,35,60,0.583,9,30,0.3,15,19,0.789,112
1653,IND,2016-01-23,97,@,SAC,0,240,36,86,0.419,29,67,0.433,7,19,0.368,18,25,0.72,97,38,85,0.447,33,69,0.478,5,16,0.313,27,36,0.75,108
1654,CHO,2016-01-23,97,,NYK,1,240,28,82,0.341,19,51,0.373,9,31,0.29,32,37,0.865,97,29,77,0.377,22,53,0.415,7,24,0.292,19,32,0.594,84
1655,IND,2016-01-19,97,@,PHO,1,240,34,83,0.41,30,63,0.476,4,20,0.2,25,34,0.735,97,28,81,0.346,17,46,0.37,11,35,0.314,27,29,0.931,94
1656,SAC,2016-01-13,97,,NOP,0,240,41,84,0.488,35,61,0.574,6,23,0.261,9,14,0.643,97,42,100,0.42,26,67,0.388,16,33,0.485,9,11,0.818,109
1657,PHO,2016-01-12,97,@,IND,0,240,36,89,0.404,28,64,0.438,8,25,0.32,17,27,0.63,97,41,79,0.519,31,55,0.564,10,24,0.417,24,31,0.774,116
1658,LAC,2016-01-09,97,,CHO,1,240,40,91,0.44,32,60,0.533,8,31,0.258,9,10,0.9,97,31,84,0.369,24,61,0.393,7,23,0.304,14,19,0.737,83
1659,TOR,2016-01-08,97,@,WAS,1,240,34,75,0.453,29,61,0.475,5,14,0.357,24,26,0.923,97,33,84,0.393,25,59,0.424,8,25,0.32,14,15,0.933,88
1660,MIA,2016-01-03,97,@,WAS,1,240,39,86,0.453,30,63,0.476,9,23,0.391,10,12,0.833,97,31,91,0.341,27,61,0.443,4,30,0.133,9,13,0.692,75
1661,ATL,2016-01-03,97,@,NYK,0,240,37,84,0.44,29,58,0.5,8,26,0.308,15,20,0.75,97,44,88,0.5,33,62,0.532,11,26,0.423,12,14,0.857,111
1662,LAL,2016-01-03,97,,PHO,1,240,38,84,0.452,30,62,0.484,8,22,0.364,13,17,0.765,97,32,89,0.36,26,62,0.419,6,27,0.222,7,9,0.778,77
1663,BOS,2016-01-02,97,,BRK,0,240,34,88,0.386,27,56,0.482,7,32,0.219,22,28,0.786,97,38,93,0.409,35,75,0.467,3,18,0.167,21,22,0.955,100
1664,TOR,2015-12-28,97,@,CHI,0,240,38,88,0.432,32,68,0.471,6,20,0.3,15,24,0.625,97,40,87,0.46,32,66,0.485,8,21,0.381,16,24,0.667,104
1665,PHO,2015-12-28,97,,CLE,0,240,36,79,0.456,25,54,0.463,11,25,0.44,14,20,0.7,97,33,71,0.465,16,30,0.533,17,41,0.415,18,25,0.72,101
1666,POR,2015-12-21,97,@,ATL,0,240,38,81,0.469,33,57,0.579,5,24,0.208,16,22,0.727,97,37,77,0.481,28,48,0.583,9,29,0.31,23,28,0.821,106
1667,LAC,2015-12-19,97,@,HOU,0,240,34,86,0.395,23,48,0.479,11,38,0.289,18,29,0.621,97,34,76,0.447,26,51,0.51,8,25,0.32,31,49,0.633,107
1668,UTA,2015-12-18,97,,DEN,1,240,34,73,0.466,24,48,0.5,10,25,0.4,19,25,0.76,97,31,79,0.392,25,51,0.49,6,28,0.214,20,25,0.8,88
1669,DAL,2015-12-18,97,,MEM,1,240,34,78,0.436,24,49,0.49,10,29,0.345,19,21,0.905,97,30,80,0.375,24,63,0.381,6,17,0.353,22,24,0.917,88
1670,BRK,2015-12-18,97,@,IND,0,240,36,86,0.419,28,70,0.4,8,16,0.5,17,17,1.0,97,37,89,0.416,30,61,0.492,7,28,0.25,23,26,0.885,104
1671,PHI,2015-12-18,97,,NYK,0,240,37,77,0.481,31,53,0.585,6,24,0.25,17,30,0.567,97,40,85,0.471,34,66,0.515,6,19,0.316,21,28,0.75,107
1672,HOU,2015-12-15,97,@,SAC,0,240,34,82,0.415,22,43,0.512,12,39,0.308,17,23,0.739,97,38,75,0.507,27,51,0.529,11,24,0.458,20,29,0.69,107
1673,MEM,2015-12-13,97,@,MIA,0,240,40,77,0.519,33,58,0.569,7,19,0.368,10,14,0.714,97,37,77,0.481,30,55,0.545,7,22,0.318,19,23,0.826,100
1674,LAL,2015-12-12,97,@,HOU,0,240,35,88,0.398,25,56,0.446,10,32,0.313,17,20,0.85,97,47,90,0.522,32,57,0.561,15,33,0.455,17,28,0.607,126
1675,NYK,2015-12-10,97,@,SAC,0,240,33,83,0.398,24,54,0.444,9,29,0.31,22,28,0.786,97,42,93,0.452,39,77,0.506,3,16,0.188,12,16,0.75,99
1676,TOR,2015-12-09,97,,SAS,1,240,37,64,0.578,34,54,0.63,3,10,0.3,20,22,0.909,97,34,76,0.447,27,51,0.529,7,25,0.28,19,24,0.792,94
1677,NYK,2015-12-07,97,,DAL,0,240,40,84,0.476,31,59,0.525,9,25,0.36,8,9,0.889,97,37,82,0.451,24,51,0.471,13,31,0.419,17,20,0.85,104
1678,SAC,2015-12-03,97,,BOS,0,240,29,77,0.377,22,56,0.393,7,21,0.333,32,41,0.78,97,40,84,0.476,26,51,0.51,14,33,0.424,20,24,0.833,114
1679,MIA,2015-12-03,97,,OKC,1,240,40,81,0.494,37,68,0.544,3,13,0.231,14,24,0.583,97,35,79,0.443,31,63,0.492,4,16,0.25,21,24,0.875,95
1680,WAS,2015-12-01,97,@,CLE,1,240,39,83,0.47,32,55,0.582,7,28,0.25,12,16,0.75,97,28,83,0.337,19,53,0.358,9,30,0.3,20,23,0.87,85
1681,MIA,2015-11-27,97,@,NYK,1,240,33,76,0.434,26,59,0.441,7,17,0.412,24,28,0.857,97,32,85,0.376,29,71,0.408,3,14,0.214,11,15,0.733,78
1682,BOS,2015-11-24,97,@,ATL,0,240,34,82,0.415,25,61,0.41,9,21,0.429,20,26,0.769,97,45,80,0.563,33,56,0.589,12,24,0.5,19,22,0.864,121
1683,WAS,2015-11-21,97,@,DET,1,240,38,78,0.487,31,59,0.525,7,19,0.368,14,20,0.7,97,36,79,0.456,28,53,0.528,8,26,0.308,15,21,0.714,95
1684,SAC,2015-11-21,97,@,ORL,1,240,31,81,0.383,24,61,0.393,7,20,0.35,28,31,0.903,97,38,92,0.413,29,61,0.475,9,31,0.29,6,8,0.75,91
1685,ATL,2015-11-21,97,@,CLE,0,240,32,86,0.372,21,58,0.362,11,28,0.393,22,25,0.88,97,41,85,0.482,30,56,0.536,11,29,0.379,16,19,0.842,109
1686,PHO,2015-11-18,97,,CHI,0,240,37,91,0.407,29,64,0.453,8,27,0.296,15,21,0.714,97,41,83,0.494,32,64,0.5,9,19,0.474,12,14,0.857,103
1687,SAC,2015-11-18,97,@,ATL,0,240,38,86,0.442,33,70,0.471,5,16,0.313,16,18,0.889,97,38,89,0.427,29,59,0.492,9,30,0.3,18,24,0.75,103
1688,UTA,2015-11-15,97,@,ATL,1,240,39,76,0.513,32,55,0.582,7,21,0.333,12,17,0.706,97,37,76,0.487,29,54,0.537,8,22,0.364,14,17,0.824,96
1689,LAL,2015-11-15,97,,DET,1,240,31,75,0.413,25,56,0.446,6,19,0.316,29,39,0.744,97,35,96,0.365,28,69,0.406,7,27,0.259,8,15,0.533,85
1690,CHO,2015-11-13,97,@,CHI,0,240,36,95,0.379,21,62,0.339,15,33,0.455,10,12,0.833,97,37,84,0.44,33,68,0.485,4,16,0.25,24,31,0.774,102
1691,IND,2015-11-09,97,,ORL,1,240,34,77,0.442,23,52,0.442,11,25,0.44,18,22,0.818,97,31,78,0.397,21,45,0.467,10,33,0.303,12,17,0.706,84
1692,IND,2015-11-08,97,@,CLE,0,240,39,90,0.433,33,72,0.458,6,18,0.333,13,19,0.684,97,38,83,0.458,30,59,0.508,8,24,0.333,17,25,0.68,101
1693,PHI,2015-11-07,97,,ORL,0,240,36,80,0.45,25,47,0.532,11,33,0.333,14,26,0.538,97,39,83,0.47,33,70,0.471,6,13,0.462,21,24,0.875,105
1694,SAC,2015-11-04,97,@,PHO,0,240,40,84,0.476,29,60,0.483,11,24,0.458,6,12,0.5,97,45,83,0.542,31,60,0.517,14,23,0.609,14,22,0.636,118
1695,UTA,2015-10-31,97,@,IND,1,240,39,88,0.443,33,73,0.452,6,15,0.4,13,18,0.722,97,28,70,0.4,24,53,0.453,4,17,0.235,16,21,0.762,76
1696,ATL,2015-10-30,97,,CHO,1,240,36,83,0.434,28,60,0.467,8,23,0.348,17,22,0.773,97,36,88,0.409,24,58,0.414,12,30,0.4,10,13,0.769,94
1697,MIL,2015-10-28,97,,NYK,0,240,30,86,0.349,21,68,0.309,9,18,0.5,28,31,0.903,97,42,93,0.452,33,70,0.471,9,23,0.391,29,35,0.829,122
1698,CHI,2015-10-27,97,,CLE,1,240,37,87,0.425,30,68,0.441,7,19,0.368,16,23,0.696,97,38,94,0.404,29,65,0.446,9,29,0.31,10,17,0.588,95
1699,UTA,2016-04-13,96,@,LAL,0,240,39,83,0.47,30,53,0.566,9,30,0.3,9,15,0.6,96,41,85,0.482,35,60,0.583,6,25,0.24,13,15,0.867,101
1700,SAS,2016-04-13,96,@,DAL,1,240,35,74,0.473,29,51,0.569,6,23,0.261,20,26,0.769,96,31,77,0.403,19,38,0.5,12,39,0.308,17,21,0.81,91
1701,BRK,2016-04-13,96,,TOR,0,240,39,89,0.438,29,63,0.46,10,26,0.385,8,12,0.667,96,41,93,0.441,28,56,0.5,13,37,0.351,8,15,0.533,103
1702,ORL,2016-04-10,96,@,MIA,0,240,37,83,0.446,30,65,0.462,7,18,0.389,15,19,0.789,96,43,77,0.558,37,57,0.649,6,20,0.3,26,30,0.867,118
1703,TOR,2016-04-05,96,,CHO,1,240,34,78,0.436,28,55,0.509,6,23,0.261,22,31,0.71,96,32,88,0.364,21,53,0.396,11,35,0.314,15,21,0.714,90
1704,UTA,2016-03-30,96,,GSW,0,265,37,92,0.402,28,60,0.467,9,32,0.281,13,29,0.448,96,39,89,0.438,27,54,0.5,12,35,0.343,13,18,0.722,103
1705,IND,2016-03-29,96,,CHI,0,240,39,90,0.433,36,71,0.507,3,19,0.158,15,17,0.882,96,37,87,0.425,27,61,0.443,10,26,0.385,14,16,0.875,98
1706,LAC,2016-03-24,96,,POR,1,240,37,82,0.451,33,63,0.524,4,19,0.211,18,28,0.643,96,32,80,0.4,26,56,0.464,6,24,0.25,24,32,0.75,94
1707,ORL,2016-03-21,96,@,BOS,0,240,39,93,0.419,34,74,0.459,5,19,0.263,13,19,0.684,96,40,85,0.471,33,63,0.524,7,22,0.318,20,24,0.833,107
1708,MIL,2016-03-17,96,,MEM,1,240,37,75,0.493,32,56,0.571,5,19,0.263,17,25,0.68,96,34,92,0.37,31,79,0.392,3,13,0.231,15,17,0.882,86
1709,CHI,2016-03-16,96,@,WAS,0,240,35,87,0.402,29,67,0.433,6,20,0.3,20,23,0.87,96,43,88,0.489,30,67,0.448,13,21,0.619,18,24,0.75,117
1710,CHO,2016-03-14,96,,DAL,0,240,32,76,0.421,22,46,0.478,10,30,0.333,22,34,0.647,96,42,87,0.483,33,57,0.579,9,30,0.3,14,18,0.778,107
1711,OKC,2016-03-11,96,,MIN,0,240,36,84,0.429,30,57,0.526,6,27,0.222,18,25,0.72,96,37,86,0.43,30,65,0.462,7,21,0.333,18,21,0.857,99
1712,CHI,2016-03-11,96,,MIA,0,240,38,81,0.469,30,60,0.5,8,21,0.381,12,15,0.8,96,47,91,0.516,37,73,0.507,10,18,0.556,14,20,0.7,118
1713,ATL,2016-03-10,96,@,TOR,0,240,35,82,0.427,28,59,0.475,7,23,0.304,19,27,0.704,96,38,82,0.463,31,58,0.534,7,24,0.292,21,29,0.724,104
1714,DAL,2016-03-09,96,,DET,0,240,39,86,0.453,30,56,0.536,9,30,0.3,9,11,0.818,96,38,85,0.447,29,58,0.5,9,27,0.333,17,30,0.567,102
1715,MEM,2016-03-09,96,@,BOS,0,240,32,84,0.381,25,58,0.431,7,26,0.269,25,31,0.806,96,41,87,0.471,26,55,0.473,15,32,0.469,19,24,0.792,116
1716,MIL,2016-03-06,96,,OKC,0,240,34,90,0.378,31,71,0.437,3,19,0.158,25,30,0.833,96,32,76,0.421,25,51,0.49,7,25,0.28,33,43,0.767,104
1717,IND,2016-02-29,96,@,CLE,0,240,37,80,0.463,29,62,0.468,8,18,0.444,14,15,0.933,96,35,83,0.422,26,54,0.481,9,29,0.31,21,25,0.84,100
1718,DEN,2016-02-29,96,,MEM,0,240,40,75,0.533,32,50,0.64,8,25,0.32,8,10,0.8,96,36,75,0.48,33,55,0.6,3,20,0.15,28,36,0.778,103
1719,UTA,2016-02-27,96,,BRK,0,240,37,89,0.416,32,69,0.464,5,20,0.25,17,25,0.68,96,40,84,0.476,33,69,0.478,7,15,0.467,11,17,0.647,98
1720,CHO,2016-02-26,96,@,IND,1,240,36,83,0.434,25,55,0.455,11,28,0.393,13,19,0.684,96,35,85,0.412,31,66,0.47,4,19,0.211,21,24,0.875,95
1721,SAS,2016-02-25,96,@,UTA,1,240,38,79,0.481,29,61,0.475,9,18,0.5,11,12,0.917,96,33,77,0.429,30,60,0.5,3,17,0.176,9,12,0.75,78
1722,DET,2016-02-22,96,@,CLE,1,240,37,80,0.463,29,55,0.527,8,25,0.32,14,21,0.667,96,34,79,0.43,26,53,0.491,8,26,0.308,12,13,0.923,88
1723,BRK,2016-02-21,96,,CHO,0,240,35,81,0.432,30,59,0.508,5,22,0.227,21,24,0.875,96,40,79,0.506,30,52,0.577,10,27,0.37,14,15,0.933,104
1724,UTA,2016-02-10,96,@,NOP,0,240,33,70,0.471,26,49,0.531,7,21,0.333,23,30,0.767,96,39,82,0.476,31,63,0.492,8,19,0.421,14,21,0.667,100
1725,ORL,2016-02-10,96,,SAS,0,240,37,91,0.407,29,71,0.408,8,20,0.4,14,16,0.875,96,38,89,0.427,30,69,0.435,8,20,0.4,14,15,0.933,98
1726,ORL,2016-02-07,96,,ATL,1,240,39,85,0.459,32,60,0.533,7,25,0.28,11,12,0.917,96,35,91,0.385,22,63,0.349,13,28,0.464,11,15,0.733,94
1727,NYK,2016-02-07,96,,DEN,0,240,37,84,0.44,29,62,0.468,8,22,0.364,14,20,0.7,96,37,86,0.43,32,65,0.492,5,21,0.238,22,28,0.786,101
1728,POR,2016-02-06,96,@,HOU,1,240,35,87,0.402,24,52,0.462,11,35,0.314,15,23,0.652,96,25,77,0.325,18,41,0.439,7,36,0.194,22,30,0.733,79
1729,IND,2016-02-05,96,@,ATL,0,240,38,91,0.418,25,60,0.417,13,31,0.419,7,9,0.778,96,39,76,0.513,29,49,0.592,10,27,0.37,14,20,0.7,102
1730,NOP,2016-02-04,96,,LAL,0,240,39,85,0.459,35,65,0.538,4,20,0.2,14,26,0.538,96,39,81,0.481,32,61,0.525,7,20,0.35,14,20,0.7,99
1731,CHI,2016-02-01,96,@,UTA,0,265,39,90,0.433,34,69,0.493,5,21,0.238,13,20,0.65,96,38,85,0.447,31,67,0.463,7,18,0.389,22,33,0.667,105
1732,POR,2016-01-31,96,,MIN,1,240,32,76,0.421,26,49,0.531,6,27,0.222,26,30,0.867,96,35,80,0.438,31,64,0.484,4,16,0.25,19,28,0.679,93
1733,CHI,2016-01-23,96,@,CLE,1,240,38,87,0.437,31,70,0.443,7,17,0.412,13,15,0.867,96,35,94,0.372,31,70,0.443,4,24,0.167,9,22,0.409,83
1734,PHI,2016-01-20,96,@,ORL,1,240,36,74,0.486,27,55,0.491,9,19,0.474,15,21,0.714,96,33,84,0.393,29,67,0.433,4,17,0.235,17,26,0.654,87
1735,MIN,2016-01-12,96,,OKC,0,240,36,81,0.444,29,63,0.46,7,18,0.389,17,23,0.739,96,39,84,0.464,30,62,0.484,9,22,0.409,14,18,0.778,101
1736,MIL,2016-01-08,96,,DAL,1,240,37,80,0.463,33,71,0.465,4,9,0.444,18,29,0.621,96,35,84,0.417,21,40,0.525,14,44,0.318,11,16,0.688,95
1737,POR,2015-12-31,96,@,UTA,0,240,35,78,0.449,19,42,0.452,16,36,0.444,10,14,0.714,96,43,86,0.5,28,53,0.528,15,33,0.455,8,11,0.727,109
1738,DET,2015-12-29,96,@,NYK,0,240,37,89,0.416,27,62,0.435,10,27,0.37,12,17,0.706,96,43,79,0.544,35,63,0.556,8,16,0.5,14,17,0.824,108
1739,LAL,2015-12-27,96,@,MEM,0,240,32,84,0.381,24,55,0.436,8,29,0.276,24,32,0.75,96,45,80,0.563,39,64,0.609,6,16,0.375,16,22,0.727,112
1740,BRK,2015-12-26,96,,WAS,0,240,43,89,0.483,38,72,0.528,5,17,0.294,5,16,0.313,96,42,84,0.5,30,57,0.526,12,27,0.444,15,22,0.682,111
1741,OKC,2015-12-25,96,,CHI,0,240,37,96,0.385,31,72,0.431,6,24,0.25,16,23,0.696,96,40,92,0.435,33,74,0.446,7,18,0.389,18,20,0.9,105
1742,PHO,2015-12-23,96,,DEN,0,240,36,87,0.414,23,62,0.371,13,25,0.52,11,17,0.647,96,42,91,0.462,28,56,0.5,14,35,0.4,6,13,0.462,104
1743,MEM,2015-12-19,96,,IND,1,240,37,83,0.446,32,64,0.5,5,19,0.263,17,21,0.81,96,30,77,0.39,25,49,0.51,5,28,0.179,19,25,0.76,84
1744,PHI,2015-12-14,96,@,CHI,0,240,38,92,0.413,27,61,0.443,11,31,0.355,9,13,0.692,96,43,85,0.506,35,63,0.556,8,22,0.364,21,26,0.808,115
1745,TOR,2015-12-13,96,,PHI,1,240,32,78,0.41,25,56,0.446,7,22,0.318,25,34,0.735,96,28,84,0.333,18,56,0.321,10,28,0.357,10,14,0.714,76
1746,IND,2015-12-12,96,@,DET,0,240,41,82,0.5,38,66,0.576,3,16,0.188,11,18,0.611,96,45,90,0.5,32,61,0.525,13,29,0.448,15,19,0.789,118
1747,PHO,2015-12-11,96,,POR,0,240,36,83,0.434,23,48,0.479,13,35,0.371,11,18,0.611,96,45,96,0.469,33,62,0.532,12,34,0.353,4,7,0.571,106
1748,IND,2015-12-11,96,,MIA,1,240,36,86,0.419,30,58,0.517,6,28,0.214,18,20,0.9,96,35,81,0.432,30,61,0.492,5,20,0.25,8,13,0.615,83
1749,CHI,2015-12-05,96,,CHO,0,240,37,89,0.416,28,64,0.438,9,25,0.36,13,19,0.684,96,37,89,0.416,27,55,0.491,10,34,0.294,18,25,0.72,102
1750,DAL,2015-12-04,96,,HOU,0,240,37,81,0.457,29,52,0.558,8,29,0.276,14,20,0.7,96,39,84,0.464,27,58,0.466,12,26,0.462,10,18,0.556,100
1751,TOR,2015-12-02,96,@,ATL,1,240,36,79,0.456,30,54,0.556,6,25,0.24,18,24,0.75,96,33,90,0.367,25,63,0.397,8,27,0.296,12,16,0.75,86
1752,ORL,2015-12-01,96,@,MIN,1,240,38,86,0.442,33,69,0.478,5,17,0.294,15,20,0.75,96,29,77,0.377,25,58,0.431,4,19,0.211,31,38,0.816,93
1753,LAL,2015-11-28,96,@,POR,0,240,36,82,0.439,29,59,0.492,7,23,0.304,17,23,0.739,96,38,78,0.487,26,48,0.542,12,30,0.4,20,26,0.769,108
1754,DAL,2015-11-24,96,@,MEM,0,240,30,77,0.39,19,43,0.442,11,34,0.324,25,28,0.893,96,37,86,0.43,30,65,0.462,7,21,0.333,29,37,0.784,110
1755,MIA,2015-11-21,96,,PHI,1,240,30,69,0.435,25,51,0.49,5,18,0.278,31,45,0.689,96,31,82,0.378,21,51,0.412,10,31,0.323,19,24,0.792,91
1756,DET,2015-11-20,96,@,MIN,1,240,40,87,0.46,34,59,0.576,6,28,0.214,10,13,0.769,96,33,77,0.429,30,64,0.469,3,13,0.231,17,25,0.68,86
1757,MEM,2015-11-20,96,,HOU,1,240,36,85,0.424,28,61,0.459,8,24,0.333,16,19,0.842,96,28,74,0.378,22,45,0.489,6,29,0.207,22,37,0.595,84
1758,CHI,2015-11-16,96,,IND,1,240,35,86,0.407,29,71,0.408,6,15,0.4,20,32,0.625,96,35,87,0.402,26,66,0.394,9,21,0.429,16,24,0.667,95
1759,ATL,2015-11-15,96,,UTA,0,240,37,76,0.487,29,54,0.537,8,22,0.364,14,17,0.824,96,39,76,0.513,32,55,0.582,7,21,0.333,12,17,0.706,97
1760,DET,2015-11-14,96,@,LAC,0,240,33,74,0.446,26,47,0.553,7,27,0.259,23,35,0.657,96,37,79,0.468,30,60,0.5,7,19,0.368,20,26,0.769,101
1761,MIA,2015-11-08,96,,TOR,1,240,35,83,0.422,27,63,0.429,8,20,0.4,18,25,0.72,96,28,71,0.394,25,52,0.481,3,19,0.158,17,22,0.773,76
1762,MEM,2015-11-05,96,@,POR,0,240,37,77,0.481,30,57,0.526,7,20,0.35,15,21,0.714,96,44,87,0.506,29,57,0.509,15,30,0.5,12,20,0.6,115
1763,UTA,2015-11-05,96,@,DEN,1,240,37,85,0.435,26,61,0.426,11,24,0.458,11,17,0.647,96,28,72,0.389,23,52,0.442,5,20,0.25,23,34,0.676,84
1764,MIA,2015-11-05,96,@,MIN,1,240,37,76,0.487,33,62,0.532,4,14,0.286,18,25,0.72,96,30,85,0.353,26,73,0.356,4,12,0.333,20,22,0.909,84
1765,CLE,2015-11-04,96,,NYK,1,240,33,83,0.398,26,56,0.464,7,27,0.259,23,32,0.719,96,33,84,0.393,25,60,0.417,8,24,0.333,12,15,0.8,86
1766,PHO,2015-11-02,96,@,LAC,0,240,36,98,0.367,27,68,0.397,9,30,0.3,15,21,0.714,96,37,81,0.457,29,55,0.527,8,26,0.308,20,23,0.87,102
1767,BRK,2015-11-02,96,,MIL,0,240,36,79,0.456,30,60,0.5,6,19,0.316,18,22,0.818,96,38,73,0.521,29,50,0.58,9,23,0.391,18,26,0.692,103
1768,ATL,2016-04-07,95,,TOR,1,240,33,76,0.434,21,44,0.477,12,32,0.375,17,21,0.81,95,32,84,0.381,24,63,0.381,8,21,0.381,15,20,0.75,87
1769,TOR,2016-04-02,95,@,SAS,0,240,40,80,0.5,34,62,0.548,6,18,0.333,9,10,0.9,95,35,77,0.455,30,57,0.526,5,20,0.25,27,30,0.9,102
1770,MEM,2016-04-01,95,,TOR,0,240,37,91,0.407,30,72,0.417,7,19,0.368,14,17,0.824,95,30,71,0.423,18,43,0.419,12,28,0.429,27,29,0.931,99
1771,DEN,2016-03-31,95,@,NOP,0,240,36,83,0.434,26,56,0.464,10,27,0.37,13,17,0.765,95,40,90,0.444,27,61,0.443,13,29,0.448,8,9,0.889,101
1772,DET,2016-03-26,95,,ATL,0,240,34,88,0.386,27,59,0.458,7,29,0.241,20,28,0.714,95,43,95,0.453,30,61,0.492,13,34,0.382,13,14,0.929,112
1773,CLE,2016-03-24,95,@,BRK,0,240,39,89,0.438,29,51,0.569,10,38,0.263,7,9,0.778,95,41,89,0.461,33,67,0.493,8,22,0.364,14,19,0.737,104
1774,PHO,2016-03-18,95,@,LAL,1,240,32,89,0.36,24,59,0.407,8,30,0.267,23,26,0.885,95,31,86,0.36,25,63,0.397,6,23,0.261,22,26,0.846,90
1775,ATL,2016-03-12,95,,MEM,1,240,36,84,0.429,25,50,0.5,11,34,0.324,12,17,0.706,95,33,95,0.347,27,72,0.375,6,23,0.261,11,14,0.786,83
1776,PHI,2016-03-11,95,,BRK,1,240,38,84,0.452,29,56,0.518,9,28,0.321,10,15,0.667,95,33,87,0.379,28,70,0.4,5,17,0.294,18,22,0.818,89
1777,GSW,2016-03-06,95,@,LAL,0,240,37,92,0.402,33,62,0.532,4,30,0.133,17,21,0.81,95,41,87,0.471,32,62,0.516,9,25,0.36,21,22,0.955,112
1778,NOP,2016-03-02,95,@,HOU,0,240,36,90,0.4,22,53,0.415,14,37,0.378,9,13,0.692,95,36,81,0.444,33,46,0.717,3,35,0.086,25,38,0.658,100
1779,BRK,2016-02-29,95,@,LAC,0,240,32,77,0.416,24,58,0.414,8,19,0.421,23,33,0.697,95,41,83,0.494,32,60,0.533,9,23,0.391,14,16,0.875,105
1780,UTA,2016-02-29,95,@,BOS,0,240,38,101,0.376,31,77,0.403,7,24,0.292,12,17,0.706,95,37,84,0.44,31,66,0.47,6,18,0.333,20,29,0.69,100
1781,CHI,2016-02-27,95,,POR,0,240,39,94,0.415,32,72,0.444,7,22,0.318,10,12,0.833,95,38,87,0.437,33,66,0.5,5,21,0.238,22,27,0.815,103
1782,IND,2016-02-26,95,,CHO,0,240,35,85,0.412,31,66,0.47,4,19,0.211,21,24,0.875,95,36,83,0.434,25,55,0.455,11,28,0.393,13,19,0.684,96
1783,LAL,2016-02-26,95,,MEM,0,240,32,78,0.41,27,55,0.491,5,23,0.217,26,39,0.667,95,43,85,0.506,30,53,0.566,13,32,0.406,13,15,0.867,112
1784,ORL,2016-02-26,95,@,NYK,0,240,39,93,0.419,33,66,0.5,6,27,0.222,11,16,0.688,95,37,80,0.463,33,64,0.516,4,16,0.25,30,36,0.833,108
1785,NYK,2016-02-22,95,,TOR,0,240,37,84,0.44,31,64,0.484,6,20,0.3,15,23,0.652,95,46,87,0.529,35,62,0.565,11,25,0.44,19,25,0.76,122
1786,MIN,2016-02-20,95,,NYK,0,240,36,84,0.429,31,72,0.431,5,12,0.417,18,25,0.72,95,42,83,0.506,37,66,0.561,5,17,0.294,14,16,0.875,103
1787,MIL,2016-02-19,95,,CHO,0,240,36,81,0.444,29,62,0.468,7,19,0.368,16,21,0.762,95,37,86,0.43,28,55,0.509,9,31,0.29,15,18,0.833,98
1788,CHI,2016-02-18,95,@,CLE,0,240,37,93,0.398,29,72,0.403,8,21,0.381,13,22,0.591,95,42,91,0.462,35,67,0.522,7,24,0.292,15,17,0.882,106
1789,NOP,2016-02-11,95,@,OKC,0,240,38,88,0.432,35,72,0.486,3,16,0.188,16,24,0.667,95,45,86,0.523,33,54,0.611,12,32,0.375,19,23,0.826,121
1790,IND,2016-02-10,95,,CHO,0,240,40,92,0.435,36,74,0.486,4,18,0.222,11,15,0.733,95,45,87,0.517,33,59,0.559,12,28,0.429,15,19,0.789,117
1791,CHO,2016-02-05,95,,MIA,0,240,36,81,0.444,26,55,0.473,10,26,0.385,13,15,0.867,95,43,94,0.457,43,85,0.506,0,9,0.0,12,18,0.667,98
1792,DET,2016-02-03,95,@,BOS,0,240,32,85,0.376,21,51,0.412,11,34,0.324,20,28,0.714,95,42,96,0.438,35,75,0.467,7,21,0.333,11,13,0.846,102
1793,MIL,2016-02-02,95,@,POR,0,240,38,86,0.442,33,72,0.458,5,14,0.357,14,24,0.583,95,39,85,0.459,28,54,0.519,11,31,0.355,18,25,0.72,107
1794,NOP,2016-02-01,95,,MEM,0,240,36,88,0.409,26,62,0.419,10,26,0.385,13,21,0.619,95,43,71,0.606,34,55,0.618,9,16,0.563,15,18,0.833,110
1795,NYK,2016-01-31,95,,GSW,0,240,33,90,0.367,27,72,0.375,6,18,0.333,23,26,0.885,95,42,73,0.575,26,44,0.591,16,29,0.552,16,23,0.696,116
1796,DET,2016-01-25,95,@,UTA,1,240,34,75,0.453,23,53,0.434,11,22,0.5,16,33,0.485,95,34,85,0.4,25,56,0.446,9,29,0.31,15,18,0.833,92
1797,ATL,2016-01-23,95,@,PHO,0,240,34,84,0.405,22,50,0.44,12,34,0.353,15,18,0.833,95,34,85,0.4,24,61,0.393,10,24,0.417,20,26,0.769,98
1798,LAL,2016-01-22,95,,SAS,0,240,38,84,0.452,32,68,0.471,6,16,0.375,13,18,0.722,95,43,85,0.506,32,64,0.5,11,21,0.524,11,13,0.846,108
1799,CHO,2016-01-20,95,@,OKC,0,240,34,81,0.42,25,54,0.463,9,27,0.333,18,21,0.857,95,39,83,0.47,30,59,0.508,9,24,0.375,22,30,0.733,109
1800,LAL,2016-01-17,95,,HOU,0,240,37,82,0.451,31,63,0.492,6,19,0.316,15,19,0.789,95,44,91,0.484,38,70,0.543,6,21,0.286,18,24,0.75,112
1801,GSW,2016-01-16,95,@,DET,0,240,34,94,0.362,24,69,0.348,10,25,0.4,17,23,0.739,95,47,101,0.465,39,78,0.5,8,23,0.348,11,20,0.55,113
1802,NYK,2016-01-16,95,@,MEM,0,240,35,77,0.455,30,57,0.526,5,20,0.25,20,24,0.833,95,39,82,0.476,34,72,0.472,5,10,0.5,20,26,0.769,103
1803,DEN,2016-01-15,95,,MIA,0,240,32,78,0.41,26,60,0.433,6,18,0.333,25,26,0.962,95,40,81,0.494,36,69,0.522,4,12,0.333,14,19,0.737,98
1804,CLE,2016-01-14,95,@,SAS,0,240,38,82,0.463,28,56,0.5,10,26,0.385,9,11,0.818,95,38,83,0.458,33,66,0.5,5,17,0.294,18,22,0.818,99
1805,LAL,2016-01-12,95,,NOP,1,240,32,87,0.368,26,58,0.448,6,29,0.207,25,32,0.781,95,38,91,0.418,32,68,0.471,6,23,0.261,9,14,0.643,91
1806,CLE,2016-01-10,95,@,PHI,1,240,35,90,0.389,26,58,0.448,9,32,0.281,16,23,0.696,95,35,77,0.455,29,59,0.492,6,18,0.333,9,19,0.474,85
1807,DEN,2016-01-10,95,,CHO,1,240,32,77,0.416,20,50,0.4,12,27,0.444,19,23,0.826,95,30,83,0.361,18,47,0.383,12,36,0.333,20,24,0.833,92
1808,PHI,2016-01-09,95,,TOR,0,240,39,80,0.488,28,63,0.444,11,17,0.647,6,14,0.429,95,41,75,0.547,36,58,0.621,5,17,0.294,21,27,0.778,108
1809,DAL,2016-01-08,95,@,MIL,0,240,35,84,0.417,21,40,0.525,14,44,0.318,11,16,0.688,95,37,80,0.463,33,71,0.465,4,9,0.444,18,29,0.621,96
1810,PHO,2016-01-08,95,,MIA,0,240,40,92,0.435,34,68,0.5,6,24,0.25,9,13,0.692,95,36,73,0.493,29,55,0.527,7,18,0.389,24,30,0.8,103
1811,IND,2016-01-06,95,@,ORL,1,240,32,76,0.421,26,54,0.481,6,22,0.273,25,29,0.862,95,32,79,0.405,26,48,0.542,6,31,0.194,16,17,0.941,86
1812,MIL,2016-01-02,95,@,MIN,1,240,32,75,0.427,24,59,0.407,8,16,0.5,23,28,0.821,95,33,84,0.393,30,70,0.429,3,14,0.214,16,24,0.667,85
1813,LAC,2015-12-31,95,@,NOP,1,240,35,90,0.389,25,56,0.446,10,34,0.294,15,19,0.789,95,36,82,0.439,29,57,0.509,7,25,0.28,10,15,0.667,89
1814,UTA,2015-12-28,95,,PHI,1,240,28,84,0.333,21,58,0.362,7,26,0.269,32,36,0.889,95,36,86,0.419,31,65,0.477,5,21,0.238,14,19,0.737,91
1815,MIN,2015-12-28,95,@,SAS,0,240,39,82,0.476,36,71,0.507,3,11,0.273,14,24,0.583,95,37,72,0.514,32,55,0.582,5,17,0.294,22,28,0.786,101
1816,CHO,2015-12-21,95,@,HOU,0,240,29,83,0.349,17,42,0.405,12,41,0.293,25,31,0.806,95,33,71,0.465,26,43,0.605,7,28,0.25,29,41,0.707,102
1817,PHO,2015-12-20,95,,MIL,0,240,33,74,0.446,25,56,0.446,8,18,0.444,21,24,0.875,95,41,79,0.519,36,63,0.571,5,16,0.313,14,24,0.583,101
1818,SAC,2015-12-18,95,@,MIN,0,240,38,81,0.469,31,58,0.534,7,23,0.304,12,17,0.706,95,39,82,0.476,33,64,0.516,6,18,0.333,15,16,0.938,99
1819,WAS,2015-12-16,95,@,SAS,0,240,35,84,0.417,32,69,0.464,3,15,0.2,22,25,0.88,95,44,83,0.53,36,61,0.59,8,22,0.364,18,23,0.783,114
1820,MIL,2015-12-15,95,@,LAL,0,240,40,85,0.471,36,72,0.5,4,13,0.308,11,20,0.55,95,41,89,0.461,31,62,0.5,10,27,0.37,21,25,0.84,113
1821,WAS,2015-12-14,95,@,MEM,0,240,37,86,0.43,28,62,0.452,9,24,0.375,12,20,0.6,95,44,78,0.564,34,63,0.54,10,15,0.667,14,15,0.933,112
1822,GSW,2015-12-12,95,@,MIL,0,240,36,89,0.404,30,62,0.484,6,27,0.222,17,25,0.68,95,44,90,0.489,38,76,0.5,6,14,0.429,14,18,0.778,108
1823,PHI,2015-12-11,95,,DET,0,240,36,80,0.45,30,62,0.484,6,18,0.333,17,24,0.708,95,43,93,0.462,33,66,0.5,10,27,0.37,11,16,0.688,107
1824,DAL,2015-12-09,95,,ATL,0,240,36,100,0.36,29,69,0.42,7,31,0.226,16,19,0.842,95,39,81,0.481,33,61,0.541,6,20,0.3,14,18,0.778,98
1825,MIL,2015-12-09,95,,LAC,0,240,42,90,0.467,40,80,0.5,2,10,0.2,9,12,0.75,95,38,81,0.469,26,53,0.491,12,28,0.429,21,36,0.583,109
1826,MEM,2015-12-06,95,,PHO,1,240,36,90,0.4,31,75,0.413,5,15,0.333,18,24,0.75,95,36,82,0.439,27,51,0.529,9,31,0.29,12,17,0.706,93
1827,SAC,2015-12-06,95,@,OKC,0,240,35,88,0.398,28,64,0.438,7,24,0.292,18,30,0.6,95,35,86,0.407,29,64,0.453,6,22,0.273,22,31,0.71,98
1828,MIL,2015-12-04,95,@,DET,0,240,39,87,0.448,35,69,0.507,4,18,0.222,13,14,0.929,95,34,82,0.415,27,59,0.458,7,23,0.304,27,39,0.692,102
1829,OKC,2015-12-03,95,@,MIA,0,240,35,79,0.443,31,63,0.492,4,16,0.25,21,24,0.875,95,40,81,0.494,37,68,0.544,3,13,0.231,14,24,0.583,97
1830,SAS,2015-12-02,95,,MIL,1,240,37,90,0.411,30,69,0.435,7,21,0.333,14,20,0.7,95,26,78,0.333,23,64,0.359,3,14,0.214,15,18,0.833,70
1831,MIA,2015-11-30,95,,BOS,0,240,36,75,0.48,31,58,0.534,5,17,0.294,18,24,0.75,95,38,80,0.475,30,60,0.5,8,20,0.4,21,25,0.84,105
1832,CLE,2015-11-27,95,@,CHO,1,240,34,81,0.42,26,56,0.464,8,25,0.32,19,25,0.76,95,33,80,0.413,28,55,0.509,5,25,0.2,19,25,0.76,90
1833,ATL,2015-11-25,95,@,MIN,0,240,31,82,0.378,23,51,0.451,8,31,0.258,25,35,0.714,95,34,82,0.415,25,61,0.41,9,21,0.429,22,29,0.759,99
1834,MIA,2015-11-23,95,,NYK,1,240,31,81,0.383,26,62,0.419,5,19,0.263,28,36,0.778,95,28,87,0.322,24,63,0.381,4,24,0.167,18,21,0.857,78
1835,PHI,2015-11-23,95,@,MIN,0,240,32,78,0.41,22,47,0.468,10,31,0.323,21,27,0.778,95,36,78,0.462,33,66,0.5,3,12,0.25,25,27,0.926,100
1836,DET,2015-11-21,95,,WAS,0,240,36,79,0.456,28,53,0.528,8,26,0.308,15,21,0.714,95,38,78,0.487,31,59,0.525,7,19,0.368,14,20,0.7,97
1837,BRK,2015-11-20,95,@,BOS,0,240,35,89,0.393,27,70,0.386,8,19,0.421,17,24,0.708,95,51,87,0.586,41,58,0.707,10,29,0.345,8,10,0.8,120
1838,HOU,2015-11-16,95,,BOS,0,240,36,85,0.424,25,53,0.472,11,32,0.344,12,23,0.522,95,44,93,0.473,33,57,0.579,11,36,0.306,12,17,0.706,111
1839,IND,2015-11-16,95,@,CHI,0,240,35,87,0.402,26,66,0.394,9,21,0.429,16,24,0.667,95,35,86,0.407,29,71,0.408,6,15,0.4,20,32,0.625,96
1840,NYK,2015-11-15,95,,NOP,1,240,38,88,0.432,34,70,0.486,4,18,0.222,15,19,0.789,95,32,71,0.451,26,50,0.52,6,21,0.286,17,19,0.895,87
1841,CHO,2015-11-11,95,,NYK,1,240,35,84,0.417,27,61,0.443,8,23,0.348,17,28,0.607,95,42,86,0.488,38,65,0.585,4,21,0.19,5,7,0.714,93
1842,MIN,2015-11-10,95,,CHO,0,240,36,80,0.45,27,61,0.443,9,19,0.474,14,19,0.737,95,38,78,0.487,30,52,0.577,8,26,0.308,20,27,0.741,104
1843,DET,2015-11-09,95,@,GSW,0,240,40,85,0.471,34,66,0.515,6,19,0.316,9,15,0.6,95,43,91,0.473,31,70,0.443,12,21,0.571,11,13,0.846,109
1844,LAL,2015-11-08,95,@,NYK,0,240,36,94,0.383,27,67,0.403,9,27,0.333,14,23,0.609,95,33,84,0.393,24,57,0.421,9,27,0.333,24,29,0.828,99
1845,SAS,2015-11-01,95,@,BOS,1,240,36,83,0.434,31,64,0.484,5,19,0.263,18,25,0.72,95,35,98,0.357,29,69,0.42,6,29,0.207,11,14,0.786,87
1846,MIN,2015-10-30,95,@,DEN,1,240,30,71,0.423,28,60,0.467,2,11,0.182,33,41,0.805,95,29,95,0.305,24,70,0.343,5,25,0.2,15,20,0.75,78
1847,PHI,2015-10-28,95,@,BOS,0,240,34,83,0.41,27,61,0.443,7,22,0.318,20,23,0.87,95,39,85,0.459,31,61,0.508,8,24,0.333,26,27,0.963,112
1848,PHO,2015-10-28,95,,DAL,0,240,34,87,0.391,28,63,0.444,6,24,0.25,21,33,0.636,95,40,85,0.471,30,64,0.469,10,21,0.476,21,31,0.677,111
1849,CLE,2015-10-27,95,@,CHI,0,240,38,94,0.404,29,65,0.446,9,29,0.31,10,17,0.588,95,37,87,0.425,30,68,0.441,7,19,0.368,16,23,0.696,97
1850,NOP,2015-10-27,95,@,GSW,0,240,35,83,0.422,29,65,0.446,6,18,0.333,19,27,0.704,95,41,96,0.427,32,66,0.485,9,30,0.3,20,22,0.909,111
1851,ATL,2016-04-11,94,@,CLE,0,240,39,87,0.448,31,57,0.544,8,30,0.267,8,15,0.533,94,40,83,0.482,29,54,0.537,11,29,0.379,18,20,0.9,109
1852,DET,2016-04-02,94,@,CHI,1,240,32,76,0.421,22,56,0.393,10,20,0.5,20,34,0.588,94,34,88,0.386,25,63,0.397,9,25,0.36,13,15,0.867,90
1853,IND,2016-03-31,94,,ORL,0,240,36,86,0.419,29,67,0.433,7,19,0.368,15,21,0.714,94,48,90,0.533,43,74,0.581,5,16,0.313,13,18,0.722,114
1854,PHO,2016-03-30,94,@,MIL,0,240,38,84,0.452,33,60,0.55,5,24,0.208,13,17,0.765,94,37,77,0.481,31,62,0.5,6,15,0.4,25,34,0.735,105
1855,WAS,2016-03-29,94,@,GSW,0,240,36,86,0.419,31,63,0.492,5,23,0.217,17,27,0.63,94,38,87,0.437,27,62,0.435,11,25,0.44,15,23,0.652,102
1856,PHO,2016-03-25,94,@,SAC,0,240,35,94,0.372,26,62,0.419,9,32,0.281,15,23,0.652,94,40,90,0.444,33,68,0.485,7,22,0.318,29,39,0.744,116
1857,POR,2016-03-24,94,@,LAC,0,240,32,80,0.4,26,56,0.464,6,24,0.25,24,32,0.75,94,37,82,0.451,33,63,0.524,4,19,0.211,18,28,0.643,96
1858,CHI,2016-03-24,94,@,NYK,0,240,37,89,0.416,31,64,0.484,6,25,0.24,14,18,0.778,94,39,76,0.513,26,46,0.565,13,30,0.433,15,16,0.938,106
1859,UTA,2016-03-20,94,@,MIL,1,240,34,83,0.41,21,45,0.467,13,38,0.342,13,14,0.929,94,34,65,0.523,31,57,0.544,3,8,0.375,14,17,0.824,85
1860,IND,2016-03-17,94,,TOR,0,265,35,91,0.385,27,63,0.429,8,28,0.286,16,23,0.696,94,32,88,0.364,25,66,0.379,7,22,0.318,30,38,0.789,101
1861,PHI,2016-03-17,94,,WAS,0,240,35,91,0.385,29,58,0.5,6,33,0.182,18,26,0.692,94,40,90,0.444,34,63,0.54,6,27,0.222,13,19,0.684,99
1862,POR,2016-03-14,94,@,OKC,0,240,31,91,0.341,24,64,0.375,7,27,0.259,25,27,0.926,94,49,83,0.59,40,66,0.606,9,17,0.529,21,26,0.808,128
1863,UTA,2016-03-14,94,,CLE,1,240,35,71,0.493,23,44,0.523,12,27,0.444,12,14,0.857,94,35,88,0.398,25,45,0.556,10,43,0.233,5,8,0.625,85
1864,NYK,2016-03-11,94,@,LAC,0,240,34,83,0.41,30,63,0.476,4,20,0.2,22,25,0.88,94,38,85,0.447,25,56,0.446,13,29,0.448,12,16,0.75,101
1865,UTA,2016-03-09,94,@,GSW,0,240,32,79,0.405,24,59,0.407,8,20,0.4,22,31,0.71,94,48,84,0.571,35,54,0.648,13,30,0.433,6,10,0.6,115
1866,NYK,2016-03-08,94,@,DEN,0,240,33,75,0.44,27,57,0.474,6,18,0.333,22,26,0.846,94,45,99,0.455,39,78,0.5,6,21,0.286,14,19,0.737,110
1867,SAC,2016-03-05,94,@,SAS,0,240,37,81,0.457,31,65,0.477,6,16,0.375,14,21,0.667,94,40,81,0.494,32,58,0.552,8,23,0.348,16,19,0.842,104
1868,NOP,2016-03-05,94,,UTA,0,240,38,92,0.413,29,73,0.397,9,19,0.474,9,11,0.818,94,37,78,0.474,31,58,0.534,6,20,0.3,26,27,0.963,106
1869,MEM,2016-03-04,94,,UTA,1,240,37,81,0.457,33,63,0.524,4,18,0.222,16,19,0.842,94,32,75,0.427,27,56,0.482,5,19,0.263,19,29,0.655,88
1870,SAS,2016-03-03,94,@,NOP,1,240,36,81,0.444,28,60,0.467,8,21,0.381,14,15,0.933,94,35,89,0.393,27,65,0.415,8,24,0.333,8,8,1.0,86
1871,UTA,2016-03-02,94,@,TOR,0,240,37,83,0.446,27,57,0.474,10,26,0.385,10,16,0.625,94,40,80,0.5,34,58,0.586,6,22,0.273,18,21,0.857,104
1872,HOU,2016-02-27,94,,SAS,0,240,35,84,0.417,27,59,0.458,8,25,0.32,16,22,0.727,94,37,76,0.487,29,57,0.509,8,19,0.421,22,28,0.786,104
1873,PHI,2016-02-26,94,,WAS,0,240,35,82,0.427,27,57,0.474,8,25,0.32,16,21,0.762,94,40,94,0.426,33,71,0.465,7,23,0.304,16,17,0.941,103
1874,WAS,2016-02-20,94,@,MIA,0,240,40,99,0.404,37,77,0.481,3,22,0.136,11,21,0.524,94,47,96,0.49,45,83,0.542,2,13,0.154,18,28,0.643,114
1875,ATL,2016-02-07,94,@,ORL,0,240,35,91,0.385,22,63,0.349,13,28,0.464,11,15,0.733,94,39,85,0.459,32,60,0.533,7,25,0.28,11,12,0.917,96
1876,PHI,2016-02-05,94,@,WAS,0,240,37,87,0.425,28,61,0.459,9,26,0.346,11,14,0.786,94,44,84,0.524,38,62,0.613,6,22,0.273,12,20,0.6,106
1877,ORL,2016-01-29,94,@,BOS,0,240,32,79,0.405,25,59,0.424,7,20,0.35,23,29,0.793,94,43,86,0.5,33,62,0.532,10,24,0.417,17,21,0.81,113
1878,LAC,2016-01-24,94,@,TOR,0,240,34,76,0.447,26,50,0.52,8,26,0.308,18,30,0.6,94,41,83,0.494,29,61,0.475,12,22,0.545,18,26,0.692,112
1879,MIN,2016-01-20,94,@,DAL,0,265,40,91,0.44,35,68,0.515,5,23,0.217,9,11,0.818,94,42,97,0.433,37,72,0.514,5,25,0.2,17,22,0.773,106
1880,CHI,2016-01-20,94,,GSW,0,240,37,100,0.37,36,80,0.45,1,20,0.05,19,24,0.792,94,50,95,0.526,38,63,0.603,12,32,0.375,13,20,0.65,125
1881,PHO,2016-01-19,94,,IND,0,240,28,81,0.346,17,46,0.37,11,35,0.314,27,29,0.931,94,34,83,0.41,30,63,0.476,4,20,0.2,25,34,0.735,97
1882,IND,2016-01-13,94,@,BOS,0,240,37,91,0.407,32,61,0.525,5,30,0.167,15,20,0.75,94,40,90,0.444,31,64,0.484,9,26,0.346,14,20,0.7,103
1883,UTA,2016-01-07,94,@,HOU,0,240,38,78,0.487,31,50,0.62,7,28,0.25,11,17,0.647,94,39,75,0.52,32,52,0.615,7,23,0.304,18,26,0.692,103
1884,MEM,2016-01-06,94,@,OKC,0,240,35,90,0.389,28,69,0.406,7,21,0.333,17,24,0.708,94,38,83,0.458,30,66,0.455,8,17,0.471,28,33,0.848,112
1885,BOS,2016-01-06,94,,DET,0,240,34,91,0.374,28,63,0.444,6,28,0.214,20,27,0.741,94,33,74,0.446,23,47,0.489,10,27,0.37,23,36,0.639,99
1886,BRK,2016-01-04,94,,BOS,0,240,32,85,0.376,26,57,0.456,6,28,0.214,24,27,0.889,94,41,92,0.446,35,71,0.493,6,21,0.286,15,19,0.789,103
1887,IND,2016-01-02,94,,DET,1,240,33,73,0.452,26,55,0.473,7,18,0.389,21,29,0.724,94,33,93,0.355,30,73,0.411,3,20,0.15,13,23,0.565,82
1888,CHO,2016-01-01,94,@,TOR,0,240,34,85,0.4,24,53,0.453,10,32,0.313,16,18,0.889,94,36,91,0.396,21,58,0.362,15,33,0.455,17,18,0.944,104
1889,MIN,2015-12-30,94,,UTA,1,240,36,77,0.468,31,67,0.463,5,10,0.5,17,27,0.63,94,28,80,0.35,18,41,0.439,10,39,0.256,14,20,0.7,80
1890,TOR,2015-12-30,94,,WAS,1,240,28,82,0.341,22,58,0.379,6,24,0.25,32,39,0.821,94,35,87,0.402,27,65,0.415,8,22,0.364,13,17,0.765,91
1891,SAC,2015-12-27,94,,POR,0,240,30,76,0.395,21,52,0.404,9,24,0.375,25,31,0.806,94,38,92,0.413,28,59,0.475,10,33,0.303,12,16,0.75,98
1892,LAC,2015-12-25,94,@,LAL,1,240,38,85,0.447,28,59,0.475,10,26,0.385,8,11,0.727,94,32,77,0.416,25,54,0.463,7,23,0.304,13,25,0.52,84
1893,MIA,2015-12-25,94,,NOP,1,265,35,88,0.398,29,62,0.468,6,26,0.231,18,27,0.667,94,36,90,0.4,30,70,0.429,6,20,0.3,10,11,0.909,88
1894,TOR,2015-12-20,94,,SAC,0,240,35,94,0.372,27,65,0.415,8,29,0.276,16,17,0.941,94,40,76,0.526,31,55,0.564,9,21,0.429,15,24,0.625,104
1895,MIA,2015-12-18,94,,TOR,0,240,35,74,0.473,26,49,0.531,9,25,0.36,15,17,0.882,94,41,80,0.513,33,59,0.559,8,21,0.381,18,22,0.818,108
1896,POR,2015-12-18,94,@,ORL,0,240,32,73,0.438,21,41,0.512,11,32,0.344,19,26,0.731,94,39,84,0.464,37,69,0.536,2,15,0.133,22,31,0.71,102
1897,UTA,2015-12-16,94,,NOP,0,240,32,67,0.478,25,47,0.532,7,20,0.35,23,29,0.793,94,34,73,0.466,24,52,0.462,10,21,0.476,26,28,0.929,104
1898,PHO,2015-12-14,94,@,DAL,0,240,33,80,0.413,24,55,0.436,9,25,0.36,19,27,0.704,94,38,77,0.494,26,45,0.578,12,32,0.375,16,21,0.762,104
1899,NOP,2015-12-12,94,@,CHI,0,240,40,89,0.449,34,73,0.466,6,16,0.375,8,11,0.727,94,33,78,0.423,25,58,0.431,8,20,0.4,24,29,0.828,98
1900,OKC,2015-12-11,94,@,UTA,1,240,37,79,0.468,31,62,0.5,6,17,0.353,14,16,0.875,94,33,78,0.423,25,50,0.5,8,28,0.286,16,24,0.667,90
1901,ATL,2015-12-10,94,@,OKC,0,240,35,78,0.449,25,50,0.5,10,28,0.357,14,23,0.609,94,39,80,0.488,30,63,0.476,9,17,0.529,20,26,0.769,107
1902,SAS,2015-12-09,94,@,TOR,0,240,34,76,0.447,27,51,0.529,7,25,0.28,19,24,0.792,94,37,64,0.578,34,54,0.63,3,10,0.3,20,22,0.909,97
1903,UTA,2015-12-03,94,,ORL,0,240,31,72,0.431,17,39,0.436,14,33,0.424,18,24,0.75,94,40,89,0.449,32,66,0.485,8,23,0.348,15,15,1.0,103
1904,BRK,2015-12-01,94,,PHO,1,240,41,84,0.488,37,71,0.521,4,13,0.308,8,12,0.667,94,33,75,0.44,23,47,0.489,10,28,0.357,15,22,0.682,91
1905,DEN,2015-11-24,94,,LAC,0,240,31,78,0.397,23,53,0.434,8,25,0.32,24,29,0.828,94,37,79,0.468,29,59,0.492,8,20,0.4,29,47,0.617,111
1906,CHI,2015-11-20,94,@,GSW,0,240,35,88,0.398,28,66,0.424,7,22,0.318,17,23,0.739,94,39,79,0.494,29,50,0.58,10,29,0.345,18,24,0.75,106
1907,CHO,2015-11-17,94,@,NYK,0,240,36,82,0.439,31,62,0.5,5,20,0.25,17,25,0.68,94,36,89,0.404,26,69,0.377,10,20,0.5,20,21,0.952,102
1908,POR,2015-11-15,94,@,CHO,0,240,35,89,0.393,30,68,0.441,5,21,0.238,19,21,0.905,94,41,83,0.494,32,52,0.615,9,31,0.29,15,19,0.789,106
1909,LAC,2015-11-09,94,,MEM,1,240,28,68,0.412,23,49,0.469,5,19,0.263,33,37,0.892,94,35,80,0.438,33,69,0.478,2,11,0.182,20,29,0.69,92
1910,MIL,2015-11-07,94,,BRK,1,240,37,82,0.451,29,62,0.468,8,20,0.4,12,16,0.75,94,34,82,0.415,31,73,0.425,3,9,0.333,15,19,0.789,86
1911,CHO,2015-11-07,94,@,SAS,0,240,34,73,0.466,28,54,0.519,6,19,0.316,20,31,0.645,94,45,81,0.556,36,60,0.6,9,21,0.429,15,23,0.652,114
1912,SAC,2015-11-07,94,,GSW,0,240,38,87,0.437,32,68,0.471,6,19,0.316,12,16,0.75,94,38,92,0.413,30,53,0.566,8,39,0.205,19,22,0.864,103
1913,DAL,2015-11-05,94,,CHO,0,240,32,82,0.39,26,53,0.491,6,29,0.207,24,27,0.889,94,44,89,0.494,38,62,0.613,6,27,0.222,14,17,0.824,108
1914,IND,2015-11-03,94,@,DET,1,240,38,88,0.432,31,65,0.477,7,23,0.304,11,12,0.917,94,33,86,0.384,28,64,0.438,5,22,0.227,11,17,0.647,82
1915,NOP,2015-11-03,94,,ORL,0,240,32,90,0.356,20,54,0.37,12,36,0.333,18,25,0.72,94,42,90,0.467,35,72,0.486,7,18,0.389,12,12,1.0,103
1916,SAS,2015-11-02,94,@,NYK,1,240,39,79,0.494,35,66,0.53,4,13,0.308,12,17,0.706,94,32,89,0.36,28,76,0.368,4,13,0.308,16,21,0.762,84
1917,ATL,2015-11-01,94,@,CHO,1,240,37,88,0.42,30,59,0.508,7,29,0.241,13,14,0.929,94,32,86,0.372,18,49,0.367,14,37,0.378,14,15,0.933,92
1918,CHO,2015-10-30,94,@,ATL,0,240,36,88,0.409,24,58,0.414,12,30,0.4,10,13,0.769,94,36,83,0.434,28,60,0.467,8,23,0.348,17,22,0.773,97
1919,CHI,2015-10-30,94,@,DET,0,265,34,84,0.405,27,62,0.435,7,22,0.318,19,26,0.731,94,39,104,0.375,33,76,0.434,6,28,0.214,14,28,0.5,98
1920,CHO,2015-10-28,94,@,MIA,0,240,33,84,0.393,27,60,0.45,6,24,0.25,22,29,0.759,94,36,73,0.493,24,53,0.453,12,20,0.6,20,21,0.952,104
1921,NOP,2015-10-28,94,@,POR,0,240,36,91,0.396,25,58,0.431,11,33,0.333,11,18,0.611,94,44,88,0.5,32,56,0.571,12,32,0.375,12,14,0.857,112
1922,ATL,2015-10-27,94,,DET,0,240,37,82,0.451,29,55,0.527,8,27,0.296,12,15,0.8,94,37,96,0.385,25,67,0.373,12,29,0.414,20,26,0.769,106
1923,DET,2016-04-12,93,,MIA,0,240,34,84,0.405,29,66,0.439,5,18,0.278,20,30,0.667,93,38,78,0.487,31,58,0.534,7,20,0.35,16,22,0.727,99
1924,TOR,2016-04-10,93,@,NYK,1,240,37,78,0.474,30,58,0.517,7,20,0.35,12,19,0.632,93,32,89,0.36,25,69,0.362,7,20,0.35,18,21,0.857,89
1925,MEM,2016-04-08,93,@,DAL,0,240,35,87,0.402,28,65,0.431,7,22,0.318,16,22,0.727,93,30,60,0.5,18,29,0.621,12,31,0.387,31,39,0.795,103
1926,NOP,2016-04-05,93,@,PHI,0,240,37,82,0.451,30,64,0.469,7,18,0.389,12,16,0.75,93,40,88,0.455,27,54,0.5,13,34,0.382,14,17,0.824,107
1927,MIA,2016-04-02,93,@,POR,0,240,34,88,0.386,28,69,0.406,6,19,0.316,19,27,0.704,93,41,79,0.519,31,64,0.484,10,15,0.667,18,23,0.783,110
1928,SAC,2016-03-28,93,@,POR,0,240,37,89,0.416,30,74,0.405,7,15,0.467,12,19,0.632,93,38,80,0.475,24,51,0.471,14,29,0.483,15,18,0.833,105
1929,NYK,2016-03-26,93,,CLE,0,240,33,79,0.418,25,56,0.446,8,23,0.348,19,28,0.679,93,37,83,0.446,23,49,0.469,14,34,0.412,19,25,0.76,107
1930,UTA,2016-03-26,93,@,MIN,1,240,39,83,0.47,30,62,0.484,9,21,0.429,6,7,0.857,93,32,84,0.381,28,73,0.384,4,11,0.364,16,19,0.842,84
1931,CHO,2016-03-19,93,,DEN,0,240,35,83,0.422,26,51,0.51,9,32,0.281,14,20,0.7,93,38,87,0.437,29,69,0.42,9,18,0.5,16,23,0.696,101
1932,SAS,2016-03-12,93,,OKC,1,240,34,85,0.4,30,61,0.492,4,24,0.167,21,25,0.84,93,31,81,0.383,29,63,0.46,2,18,0.111,21,25,0.84,85
1933,WAS,2016-03-11,93,@,UTA,0,240,35,80,0.438,28,56,0.5,7,24,0.292,16,22,0.727,93,38,67,0.567,29,51,0.569,9,16,0.563,29,38,0.763,114
1934,POR,2016-03-02,93,@,BOS,0,240,34,84,0.405,23,55,0.418,11,29,0.379,14,20,0.7,93,43,107,0.402,36,81,0.444,7,26,0.269,23,24,0.958,116
1935,IND,2016-02-22,93,@,MIA,0,265,36,92,0.391,31,77,0.403,5,15,0.333,16,25,0.64,93,38,100,0.38,36,87,0.414,2,13,0.154,23,34,0.676,101
1936,BOS,2016-02-19,93,@,UTA,0,240,30,81,0.37,23,56,0.411,7,25,0.28,26,36,0.722,93,37,68,0.544,27,45,0.6,10,23,0.435,27,44,0.614,111
1937,MIA,2016-02-07,93,,LAC,0,240,33,83,0.398,26,66,0.394,7,17,0.412,20,29,0.69,93,37,81,0.457,28,56,0.5,9,25,0.36,17,33,0.515,100
1938,ORL,2016-02-05,93,,LAC,0,240,34,81,0.42,30,61,0.492,4,20,0.2,21,28,0.75,93,40,74,0.541,32,47,0.681,8,27,0.296,19,23,0.826,107
1939,MIA,2016-02-03,93,@,DAL,1,240,37,88,0.42,35,73,0.479,2,15,0.133,17,23,0.739,93,34,87,0.391,26,67,0.388,8,20,0.4,14,19,0.737,90
1940,TOR,2016-02-01,93,@,DEN,0,240,29,78,0.372,21,53,0.396,8,25,0.32,27,39,0.692,93,45,83,0.542,35,61,0.574,10,22,0.455,12,15,0.8,112
1941,MIN,2016-01-31,93,@,POR,0,240,35,80,0.438,31,64,0.484,4,16,0.25,19,28,0.679,93,32,76,0.421,26,49,0.531,6,27,0.222,26,30,0.867,96
1942,CHI,2016-01-31,93,@,LAC,0,240,40,93,0.43,35,78,0.449,5,15,0.333,8,11,0.727,93,45,84,0.536,28,52,0.538,17,32,0.531,13,19,0.684,120
1943,LAL,2016-01-29,93,@,LAC,0,240,34,78,0.436,29,65,0.446,5,13,0.385,20,25,0.8,93,40,81,0.494,32,55,0.582,8,26,0.308,17,24,0.708,105
1944,NYK,2016-01-28,93,@,TOR,0,240,38,87,0.437,31,69,0.449,7,18,0.389,10,20,0.5,93,37,85,0.435,29,65,0.446,8,20,0.4,21,29,0.724,103
1945,PHO,2016-01-27,93,@,CLE,0,240,33,70,0.471,25,50,0.5,8,20,0.4,19,25,0.76,93,45,81,0.556,34,53,0.642,11,28,0.393,14,16,0.875,115
1946,LAL,2016-01-20,93,,SAC,0,240,32,90,0.356,28,65,0.431,4,25,0.16,25,31,0.806,93,43,89,0.483,37,69,0.536,6,20,0.3,20,28,0.714,112
1947,MIN,2016-01-15,93,@,OKC,0,240,34,85,0.4,29,73,0.397,5,12,0.417,20,23,0.87,93,47,89,0.528,42,66,0.636,5,23,0.217,14,22,0.636,113
1948,DAL,2016-01-10,93,@,MIN,1,240,36,77,0.468,30,57,0.526,6,20,0.3,15,21,0.714,93,33,79,0.418,29,63,0.46,4,16,0.25,17,22,0.773,87
1949,HOU,2016-01-04,93,@,UTA,1,240,33,68,0.485,22,42,0.524,11,26,0.423,16,21,0.762,93,30,75,0.4,18,46,0.391,12,29,0.414,19,25,0.76,91
1950,LAL,2016-01-01,93,,PHI,1,240,33,87,0.379,28,71,0.394,5,16,0.313,22,29,0.759,93,31,84,0.369,27,60,0.45,4,24,0.167,18,25,0.72,84
1951,BRK,2015-12-30,93,@,ORL,0,240,35,83,0.422,32,63,0.508,3,20,0.15,20,22,0.909,93,36,82,0.439,27,56,0.482,9,26,0.346,19,21,0.905,100
1952,CLE,2015-12-29,93,@,DEN,1,240,38,86,0.442,34,64,0.531,4,22,0.182,13,22,0.591,93,37,89,0.416,32,65,0.492,5,24,0.208,8,11,0.727,87
1953,MIL,2015-12-28,93,@,DAL,0,240,38,79,0.481,34,65,0.523,4,14,0.286,13,15,0.867,93,38,84,0.452,28,62,0.452,10,22,0.455,17,26,0.654,103
1954,IND,2015-12-28,93,,ATL,1,240,38,87,0.437,31,61,0.508,7,26,0.269,10,18,0.556,93,31,74,0.419,25,49,0.51,6,25,0.24,19,25,0.76,87
1955,DET,2015-12-26,93,,BOS,0,240,35,91,0.385,29,66,0.439,6,25,0.24,17,25,0.68,93,39,84,0.464,35,61,0.574,4,23,0.174,17,23,0.739,99
1956,DET,2015-12-22,93,@,MIA,1,240,35,78,0.449,20,48,0.417,15,30,0.5,8,14,0.571,93,39,88,0.443,35,70,0.5,4,18,0.222,10,12,0.833,92
1957,CHO,2015-12-12,93,,BOS,0,240,36,88,0.409,25,53,0.472,11,35,0.314,10,10,1.0,93,40,96,0.417,31,71,0.437,9,25,0.36,9,10,0.9,98
1958,MEM,2015-12-09,93,@,DET,1,240,41,88,0.466,37,73,0.507,4,15,0.267,7,13,0.538,93,37,87,0.425,29,58,0.5,8,29,0.276,10,15,0.667,92
1959,LAL,2015-12-07,93,@,TOR,0,240,34,83,0.41,27,64,0.422,7,19,0.368,18,20,0.9,93,34,74,0.459,25,49,0.51,9,25,0.36,25,32,0.781,102
1960,NOP,2015-12-07,93,,BOS,0,240,37,90,0.411,33,77,0.429,4,13,0.308,15,18,0.833,93,40,81,0.494,28,53,0.528,12,28,0.429,19,24,0.792,111
1961,PHO,2015-12-06,93,@,MEM,0,240,36,82,0.439,27,51,0.529,9,31,0.29,12,17,0.706,93,36,90,0.4,31,75,0.413,5,15,0.333,18,24,0.75,95
1962,MIN,2015-12-01,93,,ORL,0,240,29,77,0.377,25,58,0.431,4,19,0.211,31,38,0.816,93,38,86,0.442,33,69,0.478,5,17,0.294,15,20,0.75,96
1963,HOU,2015-11-25,93,,MEM,0,240,30,71,0.423,20,37,0.541,10,34,0.294,23,27,0.852,93,39,80,0.488,36,64,0.563,3,16,0.188,21,23,0.913,102
1964,CHI,2015-11-24,93,@,POR,1,240,33,86,0.384,26,68,0.382,7,18,0.389,20,23,0.87,93,31,88,0.352,25,66,0.379,6,22,0.273,20,27,0.741,88
1965,LAL,2015-11-22,93,,POR,0,240,32,88,0.364,26,70,0.371,6,18,0.333,23,27,0.852,93,43,87,0.494,35,62,0.565,8,25,0.32,13,17,0.765,107
1966,UTA,2015-11-20,93,@,DAL,0,240,35,80,0.438,29,60,0.483,6,20,0.3,17,21,0.81,93,39,83,0.47,31,55,0.564,8,28,0.286,16,17,0.941,102
1967,NYK,2015-11-20,93,@,OKC,1,240,33,72,0.458,21,52,0.404,12,20,0.6,15,23,0.652,93,35,92,0.38,32,63,0.508,3,29,0.103,17,23,0.739,90
1968,UTA,2015-11-18,93,,TOR,1,240,35,72,0.486,28,50,0.56,7,22,0.318,16,22,0.727,93,34,80,0.425,29,60,0.483,5,20,0.25,16,18,0.889,89
1969,SAS,2015-11-16,93,,POR,1,240,38,89,0.427,31,66,0.47,7,23,0.304,10,13,0.769,93,31,75,0.413,24,56,0.429,7,19,0.368,11,13,0.846,80
1970,ATL,2015-11-13,93,@,BOS,0,240,36,76,0.474,30,56,0.536,6,20,0.3,15,20,0.75,93,42,103,0.408,31,70,0.443,11,33,0.333,11,12,0.917,106
1971,UTA,2015-11-13,93,@,ORL,0,240,34,87,0.391,26,62,0.419,8,25,0.32,17,23,0.739,93,32,76,0.421,22,49,0.449,10,27,0.37,28,31,0.903,102
1972,NYK,2015-11-11,93,@,CHO,0,240,42,86,0.488,38,65,0.585,4,21,0.19,5,7,0.714,93,35,84,0.417,27,61,0.443,8,23,0.348,17,28,0.607,95
1973,CHI,2015-11-07,93,,MIN,0,265,33,93,0.355,22,61,0.361,11,32,0.344,16,23,0.696,93,39,96,0.406,32,80,0.4,7,16,0.438,17,27,0.63,102
1974,DEN,2015-11-01,93,@,OKC,0,240,35,92,0.38,26,66,0.394,9,26,0.346,14,19,0.737,93,45,86,0.523,32,61,0.525,13,25,0.52,14,18,0.778,117
1975,LAL,2015-11-01,93,,DAL,0,240,31,85,0.365,21,51,0.412,10,34,0.294,21,28,0.75,93,40,87,0.46,29,57,0.509,11,30,0.367,12,16,0.75,103
1976,MIL,2016-04-13,92,,IND,0,240,37,87,0.425,30,64,0.469,7,23,0.304,11,13,0.846,92,39,90,0.433,28,66,0.424,11,24,0.458,8,10,0.8,97
1977,UTA,2016-04-11,92,,DAL,0,240,35,77,0.455,26,44,0.591,9,33,0.273,13,18,0.722,92,36,81,0.444,25,49,0.51,11,32,0.344,18,22,0.818,101
1978,GSW,2016-04-10,92,@,SAS,1,240,34,77,0.442,24,50,0.48,10,27,0.37,14,18,0.778,92,34,90,0.378,31,73,0.425,3,17,0.176,15,19,0.789,86
1979,CHI,2016-04-05,92,@,MEM,0,240,34,77,0.442,23,48,0.479,11,29,0.379,13,19,0.684,92,39,87,0.448,32,68,0.471,7,19,0.368,23,26,0.885,108
1980,IND,2016-04-03,92,@,NYK,1,240,34,81,0.42,27,59,0.458,7,22,0.318,17,20,0.85,92,33,96,0.344,26,71,0.366,7,25,0.28,14,20,0.7,87
1981,NOP,2016-03-30,92,@,SAS,0,240,36,80,0.45,28,63,0.444,8,17,0.471,12,18,0.667,92,36,75,0.48,24,51,0.471,12,24,0.5,16,22,0.727,100
1982,SAS,2016-03-26,92,@,OKC,0,240,37,86,0.43,33,71,0.465,4,15,0.267,14,17,0.824,92,44,85,0.518,37,65,0.569,7,20,0.35,16,18,0.889,111
1983,IND,2016-03-24,92,,NOP,1,240,36,79,0.456,29,59,0.492,7,20,0.35,13,15,0.867,92,35,85,0.412,31,69,0.449,4,16,0.25,10,14,0.714,84
1984,DET,2016-03-21,92,,MIL,1,240,35,85,0.412,26,52,0.5,9,33,0.273,13,17,0.765,92,41,76,0.539,36,67,0.537,5,9,0.556,4,7,0.571,91
1985,CHI,2016-03-19,92,,UTA,1,240,39,80,0.488,33,61,0.541,6,19,0.316,8,11,0.727,92,35,86,0.407,27,59,0.458,8,27,0.296,7,12,0.583,85
1986,NOP,2016-03-12,92,@,MIL,0,240,35,89,0.393,29,60,0.483,6,29,0.207,16,21,0.762,92,40,81,0.494,36,68,0.529,4,13,0.308,19,24,0.792,103
1987,PHO,2016-03-03,92,@,MIA,0,240,33,82,0.402,28,60,0.467,5,22,0.227,21,27,0.778,92,40,83,0.482,31,66,0.47,9,17,0.529,19,25,0.76,108
1988,PHO,2016-03-01,92,@,CHO,0,240,33,91,0.363,27,64,0.422,6,27,0.222,20,27,0.741,92,45,93,0.484,32,66,0.485,13,27,0.481,23,27,0.852,126
1989,SAC,2016-02-24,92,,SAS,0,240,39,96,0.406,33,78,0.423,6,18,0.333,8,15,0.533,92,44,85,0.518,36,66,0.545,8,19,0.421,12,15,0.8,108
1990,ATL,2016-02-22,92,,GSW,0,240,36,86,0.419,26,52,0.5,10,34,0.294,10,16,0.625,92,39,89,0.438,25,44,0.568,14,45,0.311,10,12,0.833,102
1991,OKC,2016-02-21,92,,CLE,0,240,37,90,0.411,32,69,0.464,5,21,0.238,13,19,0.684,92,41,80,0.513,31,57,0.544,10,23,0.435,23,27,0.852,115
1992,WAS,2016-02-11,92,@,MIL,0,240,34,88,0.386,28,56,0.5,6,32,0.188,18,24,0.75,92,36,82,0.439,32,68,0.471,4,14,0.286,23,32,0.719,99
1993,DET,2016-02-10,92,,DEN,0,240,38,88,0.432,28,61,0.459,10,27,0.37,6,7,0.857,92,39,83,0.47,33,64,0.516,6,19,0.316,19,24,0.792,103
1994,PHI,2016-02-08,92,,LAC,0,265,34,90,0.378,28,65,0.431,6,25,0.24,18,21,0.857,92,35,95,0.368,30,73,0.411,5,22,0.227,23,31,0.742,98
1995,ORL,2016-02-01,92,@,SAS,0,240,39,96,0.406,34,79,0.43,5,17,0.294,9,11,0.818,92,40,78,0.513,31,54,0.574,9,24,0.375,18,21,0.857,107
1996,ATL,2016-01-28,92,@,IND,0,240,33,83,0.398,26,55,0.473,7,28,0.25,19,21,0.905,92,38,78,0.487,29,63,0.46,9,15,0.6,26,30,0.867,111
1997,DAL,2016-01-26,92,@,LAL,1,240,33,76,0.434,27,51,0.529,6,25,0.24,20,26,0.769,92,30,74,0.405,23,49,0.469,7,25,0.28,23,28,0.821,90
1998,UTA,2016-01-25,92,,DET,0,240,34,85,0.4,25,56,0.446,9,29,0.31,15,18,0.833,92,34,75,0.453,23,53,0.434,11,22,0.5,16,33,0.485,95
1999,PHI,2016-01-24,92,,BOS,0,240,35,89,0.393,27,63,0.429,8,26,0.308,14,20,0.7,92,43,97,0.443,32,72,0.444,11,25,0.44,15,19,0.789,112
2000,CHO,2016-01-16,92,,MIL,0,240,33,87,0.379,24,51,0.471,9,36,0.25,17,22,0.773,92,39,72,0.542,34,60,0.567,5,12,0.417,22,26,0.846,105
2001,CHO,2016-01-10,92,@,DEN,0,240,30,83,0.361,18,47,0.383,12,36,0.333,20,24,0.833,92,32,77,0.416,20,50,0.4,12,27,0.444,19,23,0.826,95
2002,BOS,2016-01-07,92,@,CHI,0,240,35,98,0.357,30,73,0.411,5,25,0.2,17,22,0.773,92,39,94,0.415,30,72,0.417,9,22,0.409,14,17,0.824,101
2003,UTA,2016-01-02,92,,MEM,1,265,31,75,0.413,22,48,0.458,9,27,0.333,21,28,0.75,92,33,81,0.407,26,63,0.413,7,18,0.389,14,26,0.538,87
2004,MEM,2015-12-26,92,@,CHO,0,240,37,90,0.411,30,71,0.423,7,19,0.368,11,21,0.524,92,28,69,0.406,14,37,0.378,14,32,0.438,28,32,0.875,98
2005,MIA,2015-12-22,92,,DET,0,240,39,88,0.443,35,70,0.5,4,18,0.222,10,12,0.833,92,35,78,0.449,20,48,0.417,15,30,0.5,8,14,0.571,93
2006,IND,2015-12-21,92,@,SAS,0,240,38,90,0.422,31,71,0.437,7,19,0.368,9,15,0.6,92,46,89,0.517,40,69,0.58,6,20,0.3,8,9,0.889,106
2007,DET,2015-12-09,92,,MEM,0,240,37,87,0.425,29,58,0.5,8,29,0.276,10,15,0.667,92,41,88,0.466,37,73,0.507,4,15,0.267,7,13,0.538,93
2008,MIL,2015-11-30,92,,DEN,1,240,35,77,0.455,29,59,0.492,6,18,0.333,16,22,0.727,92,28,75,0.373,22,56,0.393,6,19,0.316,12,16,0.75,74
2009,CHI,2015-11-30,92,,SAS,1,240,37,86,0.43,31,70,0.443,6,16,0.375,12,20,0.6,92,37,90,0.411,35,76,0.461,2,14,0.143,13,18,0.722,89
2010,MEM,2015-11-29,92,,PHI,1,240,34,81,0.42,30,68,0.441,4,13,0.308,20,27,0.741,92,30,77,0.39,18,41,0.439,12,36,0.333,12,16,0.75,84
2011,DAL,2015-11-28,92,,DEN,1,240,33,77,0.429,26,51,0.51,7,26,0.269,19,27,0.704,92,30,75,0.4,22,50,0.44,8,25,0.32,13,17,0.765,81
2012,CHI,2015-11-27,92,@,IND,0,240,32,92,0.348,21,66,0.318,11,26,0.423,17,20,0.85,92,37,87,0.425,29,59,0.492,8,28,0.286,22,29,0.759,104
2013,SAS,2015-11-21,92,,MEM,1,240,34,72,0.472,27,51,0.529,7,21,0.333,17,22,0.773,92,32,74,0.432,31,65,0.477,1,9,0.111,17,17,1.0,82
2014,DAL,2015-11-16,92,@,PHI,1,240,30,76,0.395,23,52,0.442,7,24,0.292,25,30,0.833,92,34,76,0.447,29,54,0.537,5,22,0.227,13,20,0.65,86
2015,SAS,2015-11-14,92,,PHI,1,240,33,85,0.388,28,69,0.406,5,16,0.313,21,25,0.84,92,33,82,0.402,25,60,0.417,8,22,0.364,9,11,0.818,83
2016,MIA,2015-11-12,92,,UTA,1,240,36,77,0.468,32,64,0.5,4,13,0.308,16,25,0.64,92,34,89,0.382,30,72,0.417,4,17,0.235,19,25,0.76,91
2017,DET,2015-11-11,92,@,SAC,0,240,34,89,0.382,25,57,0.439,9,32,0.281,15,20,0.75,92,37,74,0.5,28,58,0.483,9,16,0.563,18,24,0.75,101
2018,MEM,2015-11-09,92,@,LAC,0,240,35,80,0.438,33,69,0.478,2,11,0.182,20,29,0.69,92,28,68,0.412,23,49,0.469,5,19,0.263,33,37,0.892,94
2019,NYK,2015-11-06,92,,MIL,0,240,33,81,0.407,29,57,0.509,4,24,0.167,22,28,0.786,92,35,81,0.432,32,67,0.478,3,14,0.214,26,29,0.897,99
2020,PHO,2015-11-06,92,,DET,0,240,37,92,0.402,27,62,0.435,10,30,0.333,8,13,0.615,92,37,74,0.5,29,52,0.558,8,22,0.364,18,36,0.5,100
2021,ORL,2015-11-06,92,,TOR,1,240,33,77,0.429,24,52,0.462,9,25,0.36,17,22,0.773,92,30,86,0.349,25,63,0.397,5,23,0.217,22,29,0.759,87
2022,UTA,2015-11-04,92,,POR,0,240,33,88,0.375,28,64,0.438,5,24,0.208,21,33,0.636,92,41,77,0.532,30,52,0.577,11,25,0.44,15,32,0.469,108
2023,MIA,2015-11-03,92,,ATL,0,240,38,86,0.442,33,58,0.569,5,28,0.179,11,16,0.688,92,37,90,0.411,30,69,0.435,7,21,0.333,17,22,0.773,98
2024,CHI,2015-11-01,92,,ORL,1,240,33,87,0.379,26,59,0.441,7,28,0.25,19,22,0.864,92,35,90,0.389,28,67,0.418,7,23,0.304,10,17,0.588,87
2025,CHO,2015-11-01,92,,ATL,0,240,32,86,0.372,18,49,0.367,14,37,0.378,14,15,0.933,92,37,88,0.42,30,59,0.508,7,29,0.241,13,14,0.929,94
2026,HOU,2015-10-30,92,,GSW,0,240,30,82,0.366,25,59,0.424,5,23,0.217,27,36,0.75,92,43,93,0.462,34,67,0.507,9,26,0.346,17,25,0.68,112
2027,MIA,2015-10-30,92,@,CLE,0,240,33,77,0.429,27,56,0.482,6,21,0.286,20,22,0.909,92,39,86,0.453,33,61,0.541,6,25,0.24,18,21,0.857,102
2028,POR,2015-10-30,92,@,PHO,0,240,34,86,0.395,25,62,0.403,9,24,0.375,15,19,0.789,92,37,83,0.446,33,65,0.508,4,18,0.222,32,42,0.762,110
2029,DET,2015-10-28,92,,UTA,1,240,30,74,0.405,23,55,0.418,7,19,0.368,25,34,0.735,92,35,75,0.467,33,63,0.524,2,12,0.167,15,21,0.714,87
2030,DAL,2016-04-13,91,,SAS,0,240,31,77,0.403,19,38,0.5,12,39,0.308,17,21,0.81,91,35,74,0.473,29,51,0.569,6,23,0.261,20,26,0.769,96
2031,DAL,2016-04-10,91,@,LAC,0,240,30,74,0.405,22,44,0.5,8,30,0.267,23,33,0.697,91,37,76,0.487,28,58,0.483,9,18,0.5,15,37,0.405,98
2032,LAC,2016-04-06,91,@,LAL,1,240,37,83,0.446,30,58,0.517,7,25,0.28,10,14,0.714,91,32,90,0.356,28,71,0.394,4,19,0.211,13,17,0.765,81
2033,PHI,2016-04-01,91,@,CHO,0,240,33,90,0.367,23,51,0.451,10,39,0.256,15,21,0.714,91,36,84,0.429,29,57,0.509,7,27,0.259,21,27,0.778,100
2034,BRK,2016-04-01,91,@,NYK,0,240,36,101,0.356,32,77,0.416,4,24,0.167,15,20,0.75,91,42,84,0.5,28,61,0.459,14,23,0.609,7,7,1.0,105
2035,DAL,2016-03-30,91,,NYK,1,240,35,85,0.412,27,60,0.45,8,25,0.32,13,17,0.765,91,35,77,0.455,32,60,0.533,3,17,0.176,16,18,0.889,89
2036,NYK,2016-03-28,91,@,NOP,0,240,36,89,0.404,26,58,0.448,10,31,0.323,9,13,0.692,91,32,75,0.427,24,56,0.429,8,19,0.421,27,37,0.73,99
2037,MIL,2016-03-26,91,,CHO,0,240,37,84,0.44,33,69,0.478,4,15,0.267,13,15,0.867,91,41,74,0.554,25,45,0.556,16,29,0.552,17,21,0.81,115
2038,NOP,2016-03-26,91,,TOR,0,240,37,85,0.435,33,70,0.471,4,15,0.267,13,20,0.65,91,39,73,0.534,27,44,0.614,12,29,0.414,25,28,0.893,115
2039,UTA,2016-03-24,91,@,OKC,0,240,35,73,0.479,30,51,0.588,5,22,0.227,16,23,0.696,91,45,83,0.542,36,61,0.59,9,22,0.409,14,22,0.636,113
2040,BOS,2016-03-23,91,,TOR,1,240,35,80,0.438,27,60,0.45,8,20,0.4,13,21,0.619,91,31,89,0.348,25,67,0.373,6,22,0.273,11,20,0.55,79
2041,DEN,2016-03-21,91,@,CLE,0,240,32,81,0.395,24,59,0.407,8,22,0.364,19,25,0.76,91,48,86,0.558,33,55,0.6,15,31,0.484,13,17,0.765,124
2042,MIL,2016-03-21,91,@,DET,0,240,41,76,0.539,36,67,0.537,5,9,0.556,4,7,0.571,91,35,85,0.412,26,52,0.5,9,33,0.273,13,17,0.765,92
2043,CHO,2016-03-21,91,,SAS,1,240,35,87,0.402,27,68,0.397,8,19,0.421,13,19,0.684,91,37,86,0.43,33,69,0.478,4,17,0.235,10,13,0.769,88
2044,IND,2016-03-21,91,,PHI,1,240,35,81,0.432,25,55,0.455,10,26,0.385,11,13,0.846,91,31,80,0.388,27,62,0.435,4,18,0.222,9,14,0.643,75
2045,BOS,2016-03-18,91,@,TOR,0,240,36,82,0.439,27,61,0.443,9,21,0.429,10,12,0.833,91,37,77,0.481,24,49,0.49,13,28,0.464,18,25,0.72,105
2046,ATL,2016-03-08,91,@,UTA,1,240,38,80,0.475,30,55,0.545,8,25,0.32,7,14,0.5,91,30,86,0.349,23,60,0.383,7,26,0.269,17,23,0.739,84
2047,MIN,2016-03-08,91,,SAS,0,240,36,79,0.456,32,64,0.5,4,15,0.267,15,19,0.789,91,47,85,0.553,43,66,0.652,4,19,0.211,18,19,0.947,116
2048,SAS,2016-03-07,91,@,IND,0,240,34,96,0.354,30,68,0.441,4,28,0.143,19,22,0.864,91,32,78,0.41,25,62,0.403,7,16,0.438,28,30,0.933,99
2049,MIL,2016-02-27,91,,DET,0,240,38,78,0.487,31,66,0.47,7,12,0.583,8,12,0.667,91,37,88,0.42,25,58,0.431,12,30,0.4,16,24,0.667,102
2050,PHI,2016-02-24,91,@,DET,0,240,33,83,0.398,26,60,0.433,7,23,0.304,18,26,0.692,91,39,83,0.47,28,55,0.509,11,28,0.393,22,34,0.647,111
2051,CHI,2016-02-08,91,@,CHO,0,240,35,90,0.389,25,65,0.385,10,25,0.4,11,14,0.786,91,35,80,0.438,21,44,0.477,14,36,0.389,24,31,0.774,108
2052,MEM,2016-02-05,91,@,NYK,1,240,33,76,0.434,29,58,0.5,4,18,0.222,21,24,0.875,91,30,80,0.375,20,51,0.392,10,29,0.345,15,17,0.882,85
2053,DAL,2016-01-31,91,,PHO,1,240,31,78,0.397,23,49,0.469,8,29,0.276,21,23,0.913,91,27,74,0.365,22,51,0.431,5,23,0.217,19,24,0.792,78
2054,DAL,2016-01-29,91,,BRK,1,240,37,80,0.463,29,59,0.492,8,21,0.381,9,15,0.6,91,28,78,0.359,24,58,0.414,4,20,0.2,19,23,0.826,79
2055,CHO,2016-01-29,91,@,POR,0,240,31,80,0.388,21,51,0.412,10,29,0.345,19,28,0.679,91,45,92,0.489,38,72,0.528,7,20,0.35,12,16,0.75,109
2056,LAL,2016-01-28,91,,CHI,0,240,32,85,0.376,23,60,0.383,9,25,0.36,18,23,0.783,91,47,95,0.495,41,78,0.526,6,17,0.353,14,16,0.875,114
2057,LAC,2016-01-26,91,@,IND,1,240,32,78,0.41,17,41,0.415,15,37,0.405,12,24,0.5,91,35,83,0.422,30,67,0.448,5,16,0.313,14,24,0.583,89
2058,WAS,2016-01-25,91,,BOS,0,240,32,75,0.427,25,51,0.49,7,24,0.292,20,30,0.667,91,44,90,0.489,35,68,0.515,9,22,0.409,19,23,0.826,116
2059,SAC,2016-01-21,91,,ATL,1,240,33,92,0.359,26,68,0.382,7,24,0.292,18,24,0.75,91,35,84,0.417,27,51,0.529,8,33,0.242,10,15,0.667,88
2060,CLE,2016-01-20,91,@,BRK,1,240,36,77,0.468,31,60,0.517,5,17,0.294,14,20,0.7,91,35,84,0.417,31,65,0.477,4,19,0.211,4,8,0.5,78
2061,MIL,2016-01-19,91,@,MIA,1,240,36,74,0.486,31,62,0.5,5,12,0.417,14,16,0.875,91,27,74,0.365,22,52,0.423,5,22,0.227,20,26,0.769,79
2062,CLE,2016-01-15,91,@,HOU,1,240,34,87,0.391,26,52,0.5,8,35,0.229,15,23,0.652,91,26,74,0.351,20,49,0.408,6,25,0.24,19,29,0.655,77
2063,MEM,2016-01-12,91,,HOU,0,240,33,72,0.458,26,54,0.481,7,18,0.389,18,24,0.75,91,33,77,0.429,15,42,0.357,18,35,0.514,23,27,0.852,107
2064,NOP,2016-01-12,91,@,LAL,0,240,38,91,0.418,32,68,0.471,6,23,0.261,9,14,0.643,91,32,87,0.368,26,58,0.448,6,29,0.207,25,32,0.781,95
2065,MEM,2016-01-08,91,,DEN,1,240,30,82,0.366,22,64,0.344,8,18,0.444,23,30,0.767,91,32,87,0.368,28,68,0.412,4,19,0.211,16,19,0.842,84
2066,IND,2016-01-08,91,@,NOP,1,240,36,81,0.444,31,60,0.517,5,21,0.238,14,19,0.737,91,31,83,0.373,22,54,0.407,9,29,0.31,15,20,0.75,86
2067,TOR,2016-01-06,91,@,BRK,1,240,35,80,0.438,31,58,0.534,4,22,0.182,17,18,0.944,91,31,78,0.397,26,62,0.419,5,16,0.313,7,12,0.583,74
2068,NOP,2016-01-06,91,,DAL,0,240,34,92,0.37,27,62,0.435,7,30,0.233,16,20,0.8,91,37,87,0.425,30,59,0.508,7,28,0.25,19,22,0.864,100
2069,MEM,2016-01-04,91,@,POR,1,240,35,91,0.385,32,76,0.421,3,15,0.2,18,26,0.692,91,28,72,0.389,21,44,0.477,7,28,0.25,15,24,0.625,78
2070,UTA,2016-01-04,91,,HOU,0,240,30,75,0.4,18,46,0.391,12,29,0.414,19,25,0.76,91,33,68,0.485,22,42,0.524,11,26,0.423,16,21,0.762,93
2071,ORL,2016-01-01,91,@,WAS,0,240,40,85,0.471,35,65,0.538,5,20,0.25,6,8,0.75,91,43,92,0.467,35,66,0.53,8,26,0.308,9,10,0.9,103
2072,GSW,2015-12-30,91,@,DAL,0,240,33,81,0.407,26,62,0.419,7,19,0.368,18,24,0.75,91,42,82,0.512,28,55,0.509,14,27,0.519,16,20,0.8,114
2073,WAS,2015-12-30,91,@,TOR,0,240,35,87,0.402,27,65,0.415,8,22,0.364,13,17,0.765,91,28,82,0.341,22,58,0.379,6,24,0.25,32,39,0.821,94
2074,WAS,2015-12-28,91,,LAC,0,240,34,87,0.391,27,63,0.429,7,24,0.292,16,24,0.667,91,41,78,0.526,34,55,0.618,7,23,0.304,19,25,0.76,108
2075,PHI,2015-12-28,91,@,UTA,0,240,36,86,0.419,31,65,0.477,5,21,0.238,14,19,0.737,91,28,84,0.333,21,58,0.362,7,26,0.269,32,36,0.889,95
2076,NYK,2015-12-27,91,@,BOS,0,240,33,89,0.371,29,70,0.414,4,19,0.211,21,24,0.875,91,36,85,0.424,28,65,0.431,8,20,0.4,20,29,0.69,100
2077,CLE,2015-12-23,91,,NYK,1,240,32,83,0.386,27,61,0.443,5,22,0.227,22,25,0.88,91,32,82,0.39,27,66,0.409,5,16,0.313,15,16,0.938,84
2078,MEM,2015-12-23,91,@,WAS,0,240,33,72,0.458,30,55,0.545,3,17,0.176,22,32,0.688,91,37,82,0.451,26,57,0.456,11,25,0.44,15,19,0.789,100
2079,CHI,2015-12-19,91,@,NYK,0,240,37,94,0.394,32,73,0.438,5,21,0.238,12,17,0.706,91,41,82,0.5,36,62,0.581,5,20,0.25,20,24,0.833,107
2080,PHI,2015-12-10,91,@,BRK,0,240,34,87,0.391,30,56,0.536,4,31,0.129,19,22,0.864,91,37,74,0.5,31,60,0.517,6,14,0.429,20,27,0.741,100
2081,LAL,2015-12-06,91,@,DET,0,240,32,80,0.4,27,62,0.435,5,18,0.278,22,29,0.759,91,41,93,0.441,32,69,0.464,9,24,0.375,20,26,0.769,111
2082,NYK,2015-12-05,91,@,MIL,0,240,32,76,0.421,26,51,0.51,6,25,0.24,21,28,0.75,91,44,89,0.494,42,85,0.494,2,4,0.5,16,24,0.667,106
2083,BRK,2015-12-04,91,@,NYK,0,240,39,91,0.429,36,80,0.45,3,11,0.273,10,15,0.667,91,39,87,0.448,27,60,0.45,12,27,0.444,18,21,0.857,108
2084,LAC,2015-12-02,91,,IND,0,240,30,79,0.38,24,52,0.462,6,27,0.222,25,39,0.641,91,32,76,0.421,25,56,0.446,7,20,0.35,32,39,0.821,103
2085,PHO,2015-12-01,91,@,BRK,0,240,33,75,0.44,23,47,0.489,10,28,0.357,15,22,0.682,91,41,84,0.488,37,71,0.521,4,13,0.308,8,12,0.667,94
2086,LAL,2015-12-01,91,@,PHI,0,240,33,89,0.371,25,55,0.455,8,34,0.235,17,24,0.708,91,37,79,0.468,23,47,0.489,14,32,0.438,15,23,0.652,103
2087,BOS,2015-11-29,91,@,ORL,0,240,36,88,0.409,31,61,0.508,5,27,0.185,14,20,0.7,91,45,93,0.484,36,68,0.529,9,25,0.36,11,16,0.688,110
2088,SAC,2015-11-27,91,,MIN,0,240,37,86,0.43,29,64,0.453,8,22,0.364,9,15,0.6,91,37,77,0.481,28,52,0.538,9,25,0.36,18,19,0.947,101
2089,SAS,2015-11-27,91,@,DEN,1,240,36,75,0.48,28,53,0.528,8,22,0.364,11,14,0.786,91,31,77,0.403,24,57,0.421,7,20,0.35,11,13,0.846,80
2090,NYK,2015-11-25,91,@,ORL,0,240,31,83,0.373,22,56,0.393,9,27,0.333,20,25,0.8,91,34,86,0.395,29,70,0.414,5,16,0.313,27,32,0.844,100
2091,LAC,2015-11-25,91,,UTA,0,240,38,75,0.507,34,63,0.54,4,12,0.333,11,17,0.647,91,39,77,0.506,33,64,0.516,6,13,0.462,18,25,0.72,102
2092,TOR,2015-11-22,91,@,LAC,1,240,29,78,0.372,25,61,0.41,4,17,0.235,29,31,0.935,91,29,74,0.392,22,42,0.524,7,32,0.219,15,20,0.75,80
2093,PHI,2015-11-21,91,@,MIA,0,240,31,82,0.378,21,51,0.412,10,31,0.323,19,24,0.792,91,30,69,0.435,25,51,0.49,5,18,0.278,31,45,0.689,96
2094,ORL,2015-11-21,91,,SAC,0,240,38,92,0.413,29,61,0.475,9,31,0.29,6,8,0.75,91,31,81,0.383,24,61,0.393,7,20,0.35,28,31,0.903,97
2095,LAC,2015-11-20,91,@,POR,0,240,38,86,0.442,31,62,0.5,7,24,0.292,8,16,0.5,91,38,90,0.422,30,65,0.462,8,25,0.32,18,24,0.75,102
2096,LAL,2015-11-20,91,,TOR,0,240,35,77,0.455,27,52,0.519,8,25,0.32,13,17,0.765,91,34,78,0.436,19,45,0.422,15,33,0.455,19,24,0.792,102
2097,MIA,2015-11-17,91,,MIN,0,240,36,79,0.456,31,55,0.564,5,24,0.208,14,30,0.467,91,36,97,0.371,32,76,0.421,4,21,0.19,27,35,0.771,103
2098,UTA,2015-11-12,91,@,MIA,0,240,34,89,0.382,30,72,0.417,4,17,0.235,19,25,0.76,91,36,77,0.468,32,64,0.5,4,13,0.308,16,25,0.64,92
2099,BOS,2015-11-11,91,,IND,0,240,32,77,0.416,28,53,0.528,4,24,0.167,23,32,0.719,91,38,79,0.481,32,62,0.516,6,17,0.353,20,31,0.645,102
2100,MIL,2015-11-04,91,,PHI,1,240,35,86,0.407,27,63,0.429,8,23,0.348,13,17,0.765,91,34,81,0.42,28,53,0.528,6,28,0.214,13,15,0.867,87
2101,DAL,2015-11-03,91,,TOR,0,240,33,86,0.384,26,63,0.413,7,23,0.304,18,25,0.72,91,37,82,0.451,32,65,0.492,5,17,0.294,23,26,0.885,102
2102,BRK,2015-10-31,91,@,MEM,0,240,38,79,0.481,35,66,0.53,3,13,0.231,12,18,0.667,91,34,80,0.425,25,57,0.439,9,23,0.391,24,28,0.857,101
2103,NYK,2016-04-12,90,@,IND,0,240,36,80,0.45,26,53,0.491,10,27,0.37,8,9,0.889,90,41,80,0.513,35,61,0.574,6,19,0.316,14,20,0.7,102
2104,CHO,2016-04-05,90,@,TOR,0,240,32,88,0.364,21,53,0.396,11,35,0.314,15,21,0.714,90,34,78,0.436,28,55,0.509,6,23,0.261,22,31,0.71,96
2105,PHO,2016-04-05,90,@,ATL,0,240,30,81,0.37,18,50,0.36,12,31,0.387,18,30,0.6,90,39,95,0.411,28,61,0.459,11,34,0.324,14,19,0.737,103
2106,CHI,2016-04-02,90,,DET,0,240,34,88,0.386,25,63,0.397,9,25,0.36,13,15,0.867,90,32,76,0.421,22,56,0.393,10,20,0.5,20,34,0.588,94
2107,BOS,2016-03-28,90,@,LAC,0,240,31,89,0.348,24,70,0.343,7,19,0.368,21,27,0.778,90,44,84,0.524,33,59,0.559,11,25,0.44,15,18,0.833,114
2108,DEN,2016-03-27,90,@,LAC,0,240,37,94,0.394,30,65,0.462,7,29,0.241,9,13,0.692,90,38,80,0.475,28,52,0.538,10,28,0.357,19,26,0.731,105
2109,MIL,2016-03-25,90,@,ATL,0,240,35,84,0.417,32,71,0.451,3,13,0.231,17,26,0.654,90,41,97,0.423,36,65,0.554,5,32,0.156,14,17,0.824,101
2110,LAL,2016-03-18,90,,PHO,0,240,31,86,0.36,25,63,0.397,6,23,0.261,22,26,0.846,90,32,89,0.36,24,59,0.407,8,30,0.267,23,26,0.885,95
2111,LAC,2016-03-13,90,,CLE,0,240,32,79,0.405,22,47,0.468,10,32,0.313,16,19,0.842,90,41,84,0.488,23,47,0.489,18,37,0.486,14,20,0.7,114
2112,NYK,2016-03-13,90,@,LAL,1,240,33,75,0.44,28,54,0.519,5,21,0.238,19,27,0.704,90,34,85,0.4,31,69,0.449,3,16,0.188,16,21,0.762,87
2113,DAL,2016-03-07,90,,LAC,0,240,30,81,0.37,26,56,0.464,4,25,0.16,26,32,0.813,90,39,83,0.47,27,51,0.529,12,32,0.375,19,29,0.655,109
2114,MIL,2016-03-07,90,@,CHI,0,240,36,91,0.396,29,73,0.397,7,18,0.389,11,17,0.647,90,39,78,0.5,29,53,0.547,10,25,0.4,12,15,0.8,100
2115,CHI,2016-02-10,90,,ATL,0,240,38,86,0.442,33,72,0.458,5,14,0.357,9,12,0.75,90,43,90,0.478,30,57,0.526,13,33,0.394,14,15,0.933,113
2116,BRK,2016-02-10,90,,MEM,0,240,33,71,0.465,22,49,0.449,11,22,0.5,13,19,0.684,90,45,86,0.523,36,66,0.545,9,20,0.45,10,12,0.833,109
2117,DAL,2016-02-05,90,,SAS,0,240,33,73,0.452,30,58,0.517,3,15,0.2,21,27,0.778,90,41,80,0.513,29,58,0.5,12,22,0.545,22,25,0.88,116
2118,DAL,2016-02-03,90,,MIA,0,240,34,87,0.391,26,67,0.388,8,20,0.4,14,19,0.737,90,37,88,0.42,35,73,0.479,2,15,0.133,17,23,0.739,93
2119,MIN,2016-01-29,90,@,UTA,0,240,35,75,0.467,33,65,0.508,2,10,0.2,18,26,0.692,90,40,76,0.526,30,51,0.588,10,25,0.4,13,16,0.813,103
2120,LAL,2016-01-26,90,,DAL,0,240,30,74,0.405,23,49,0.469,7,25,0.28,23,28,0.821,90,33,76,0.434,27,51,0.529,6,25,0.24,20,26,0.769,92
2121,SAS,2016-01-25,90,@,GSW,0,240,31,74,0.419,26,60,0.433,5,14,0.357,23,31,0.742,90,44,85,0.518,33,59,0.559,11,26,0.423,21,25,0.84,120
2122,MIA,2016-01-13,90,@,LAC,0,240,31,70,0.443,22,46,0.478,9,24,0.375,19,29,0.655,90,40,94,0.426,29,69,0.42,11,25,0.44,13,16,0.813,104
2123,MIA,2016-01-06,90,,NYK,0,240,37,82,0.451,35,65,0.538,2,17,0.118,14,15,0.933,90,39,70,0.557,36,62,0.581,3,8,0.375,17,18,0.944,98
2124,CHO,2016-01-02,90,,OKC,0,240,29,84,0.345,23,62,0.371,6,22,0.273,26,34,0.765,90,35,79,0.443,26,56,0.464,9,23,0.391,30,37,0.811,109
2125,MIN,2015-12-31,90,@,DET,0,240,35,86,0.407,30,72,0.417,5,14,0.357,15,19,0.789,90,41,86,0.477,27,51,0.529,14,35,0.4,19,28,0.679,115
2126,MIA,2015-12-29,90,@,MEM,0,265,35,79,0.443,24,50,0.48,11,29,0.379,9,18,0.5,90,38,87,0.437,34,72,0.472,4,15,0.267,19,20,0.95,99
2127,MIL,2015-12-26,90,,TOR,0,240,34,81,0.42,28,67,0.418,6,14,0.429,16,18,0.889,90,42,81,0.519,29,52,0.558,13,29,0.448,14,19,0.737,111
2128,PHI,2015-12-22,90,,MEM,0,240,31,66,0.47,24,43,0.558,7,23,0.304,21,32,0.656,90,40,85,0.471,35,70,0.5,5,15,0.333,19,24,0.792,104
2129,MIL,2015-12-16,90,@,LAC,0,240,38,88,0.432,33,72,0.458,5,16,0.313,9,11,0.818,90,36,75,0.48,25,54,0.463,11,21,0.524,20,24,0.833,103
2130,POR,2015-12-16,90,@,OKC,0,240,32,92,0.348,21,66,0.318,11,26,0.423,15,18,0.833,90,38,79,0.481,36,65,0.554,2,14,0.143,28,37,0.757,106
2131,TOR,2015-12-14,90,@,IND,0,240,29,79,0.367,19,51,0.373,10,28,0.357,22,26,0.846,90,41,86,0.477,31,64,0.484,10,22,0.455,14,16,0.875,106
2132,TOR,2015-12-11,90,,MIL,1,240,34,70,0.486,27,50,0.54,7,20,0.35,15,23,0.652,90,33,80,0.413,29,69,0.42,4,11,0.364,13,16,0.813,83
2133,UTA,2015-12-11,90,,OKC,0,240,33,78,0.423,25,50,0.5,8,28,0.286,16,24,0.667,90,37,79,0.468,31,62,0.5,6,17,0.353,14,16,0.875,94
2134,MIL,2015-12-07,90,,POR,1,240,30,73,0.411,26,60,0.433,4,13,0.308,26,33,0.788,90,33,85,0.388,25,52,0.481,8,33,0.242,14,18,0.778,88
2135,DEN,2015-12-02,90,@,CHI,0,240,36,93,0.387,31,78,0.397,5,15,0.333,13,22,0.591,90,36,89,0.404,30,72,0.417,6,17,0.353,21,27,0.778,99
2136,CLE,2015-11-28,90,,BRK,1,240,35,87,0.402,26,60,0.433,9,27,0.333,11,17,0.647,90,33,81,0.407,29,64,0.453,4,17,0.235,18,24,0.75,88
2137,CHO,2015-11-27,90,,CLE,0,240,33,80,0.413,28,55,0.509,5,25,0.2,19,25,0.76,90,34,81,0.42,26,56,0.464,8,25,0.32,19,25,0.76,95
2138,NOP,2015-11-27,90,@,LAC,0,240,34,94,0.362,29,74,0.392,5,20,0.25,17,23,0.739,90,40,83,0.482,33,64,0.516,7,19,0.368,24,30,0.8,111
2139,MIL,2015-11-27,90,@,ORL,0,240,31,74,0.419,23,48,0.479,8,26,0.308,20,22,0.909,90,43,82,0.524,31,55,0.564,12,27,0.444,16,22,0.727,114
2140,OKC,2015-11-20,90,,NYK,0,240,35,92,0.38,32,63,0.508,3,29,0.103,17,23,0.739,90,33,72,0.458,21,52,0.404,12,20,0.6,15,23,0.652,93
2141,SAS,2015-11-20,90,@,NOP,0,240,34,84,0.405,25,67,0.373,9,17,0.529,13,16,0.813,90,40,88,0.455,32,66,0.485,8,22,0.364,16,17,0.941,104
2142,BRK,2015-11-17,90,,ATL,1,240,37,84,0.44,28,64,0.438,9,20,0.45,7,13,0.538,90,33,76,0.434,21,47,0.447,12,29,0.414,10,14,0.714,88
2143,CLE,2015-11-13,90,@,NYK,1,240,33,78,0.423,27,50,0.54,6,28,0.214,18,31,0.581,90,29,79,0.367,20,52,0.385,9,27,0.333,17,21,0.81,84
2144,DAL,2015-11-13,90,,LAL,1,240,30,82,0.366,23,55,0.418,7,27,0.259,23,29,0.793,90,29,88,0.33,20,61,0.328,9,27,0.333,15,18,0.833,82
2145,IND,2015-11-06,90,,MIA,1,240,36,80,0.45,31,65,0.477,5,15,0.333,13,24,0.542,90,36,81,0.444,30,61,0.492,6,20,0.3,9,13,0.692,87
2146,POR,2015-10-31,90,,PHO,0,240,33,79,0.418,25,49,0.51,8,30,0.267,16,28,0.571,90,39,94,0.415,28,62,0.452,11,32,0.344,12,16,0.75,101
2147,NYK,2016-04-10,89,,TOR,0,240,32,89,0.36,25,69,0.362,7,20,0.35,18,21,0.857,89,37,78,0.474,30,58,0.517,7,20,0.35,12,19,0.632,93
2148,DET,2016-04-05,89,@,MIA,0,240,32,80,0.4,27,58,0.466,5,22,0.227,20,25,0.8,89,44,84,0.524,35,70,0.5,9,14,0.643,10,14,0.714,107
2149,DET,2016-04-01,89,,DAL,0,240,31,81,0.383,18,48,0.375,13,33,0.394,14,24,0.583,89,39,85,0.459,31,61,0.508,8,24,0.333,12,14,0.857,98
2150,NYK,2016-03-30,89,@,DAL,0,240,35,77,0.455,32,60,0.533,3,17,0.176,16,18,0.889,89,35,85,0.412,27,60,0.45,8,25,0.32,13,17,0.765,91
2151,CHI,2016-03-26,89,@,ORL,0,240,36,88,0.409,30,64,0.469,6,24,0.25,11,17,0.647,89,48,89,0.539,41,70,0.586,7,19,0.368,8,12,0.667,111
2152,UTA,2016-03-23,89,@,HOU,1,240,31,77,0.403,20,48,0.417,11,29,0.379,16,20,0.8,89,33,74,0.446,24,51,0.471,9,23,0.391,12,22,0.545,87
2153,NYK,2016-03-19,89,@,WAS,0,240,32,81,0.395,22,60,0.367,10,21,0.476,15,17,0.882,89,39,87,0.448,31,58,0.534,8,29,0.276,13,17,0.765,99
2154,MIL,2016-03-15,89,,TOR,0,240,34,77,0.442,32,64,0.5,2,13,0.154,19,26,0.731,89,39,83,0.47,25,53,0.472,14,30,0.467,15,17,0.882,107
2155,BRK,2016-03-11,89,@,PHI,0,240,33,87,0.379,28,70,0.4,5,17,0.294,18,22,0.818,89,38,84,0.452,29,56,0.518,9,28,0.321,10,15,0.667,95
2156,DET,2016-03-05,89,@,NYK,0,240,36,92,0.391,30,66,0.455,6,26,0.231,11,15,0.733,89,42,79,0.532,38,63,0.603,4,16,0.25,14,18,0.778,102
2157,CHI,2016-03-02,89,@,ORL,0,240,38,99,0.384,32,80,0.4,6,19,0.316,7,11,0.636,89,39,97,0.402,32,76,0.421,7,21,0.333,17,22,0.773,102
2158,MIA,2016-02-27,89,@,BOS,0,240,36,87,0.414,35,74,0.473,1,13,0.077,16,23,0.696,89,39,96,0.406,34,80,0.425,5,16,0.313,18,22,0.818,101
2159,NOP,2016-02-23,89,@,WAS,0,240,29,83,0.349,23,60,0.383,6,23,0.261,25,33,0.758,89,43,94,0.457,31,68,0.456,12,26,0.462,11,17,0.647,109
2160,UTA,2016-02-18,89,@,WAS,0,240,31,77,0.403,27,62,0.435,4,15,0.267,23,29,0.793,89,42,86,0.488,35,68,0.515,7,18,0.389,12,21,0.571,103
2161,DET,2016-02-08,89,,TOR,0,240,36,80,0.45,28,52,0.538,8,28,0.286,9,17,0.529,89,39,70,0.557,28,50,0.56,11,20,0.55,14,17,0.824,103
2162,IND,2016-02-08,89,,LAL,1,240,31,78,0.397,27,51,0.529,4,27,0.148,23,33,0.697,89,29,93,0.312,21,58,0.362,8,35,0.229,21,26,0.808,87
2163,PHO,2016-02-06,89,,UTA,0,240,30,80,0.375,21,56,0.375,9,24,0.375,20,26,0.769,89,34,78,0.436,29,62,0.468,5,16,0.313,25,31,0.806,98
2164,NYK,2016-02-02,89,,BOS,0,240,31,82,0.378,25,62,0.403,6,20,0.3,21,28,0.75,89,40,90,0.444,37,71,0.521,3,19,0.158,14,17,0.824,97
2165,WAS,2016-01-26,89,@,TOR,0,240,32,78,0.41,28,63,0.444,4,15,0.267,21,28,0.75,89,35,79,0.443,24,50,0.48,11,29,0.379,25,32,0.781,106
2166,IND,2016-01-26,89,,LAC,0,240,35,83,0.422,30,67,0.448,5,16,0.313,14,24,0.583,89,32,78,0.41,17,41,0.415,15,37,0.405,12,24,0.5,91
2167,MIA,2016-01-25,89,@,CHI,1,240,37,81,0.457,34,67,0.507,3,14,0.214,12,17,0.706,89,35,88,0.398,30,70,0.429,5,18,0.278,9,12,0.75,84
2168,PHO,2016-01-21,89,,SAS,0,240,32,81,0.395,26,63,0.413,6,18,0.333,19,23,0.826,89,42,86,0.488,33,72,0.458,9,14,0.643,24,28,0.857,117
2169,POR,2016-01-16,89,@,PHI,0,240,34,87,0.391,29,58,0.5,5,29,0.172,16,24,0.667,89,42,76,0.553,32,53,0.604,10,23,0.435,20,30,0.667,114
2170,DAL,2016-01-13,89,@,OKC,0,240,32,82,0.39,26,51,0.51,6,31,0.194,19,25,0.76,89,38,82,0.463,23,49,0.469,15,33,0.455,17,29,0.586,108
2171,BRK,2016-01-09,89,@,DET,0,240,38,82,0.463,33,73,0.452,5,9,0.556,8,10,0.8,89,43,92,0.467,35,65,0.538,8,27,0.296,9,14,0.643,103
2172,ORL,2016-01-04,89,@,DET,0,240,36,81,0.444,30,61,0.492,6,20,0.3,11,11,1.0,89,43,88,0.489,29,58,0.5,14,30,0.467,15,21,0.714,115
2173,NOP,2015-12-31,89,,LAC,0,240,36,82,0.439,29,57,0.509,7,25,0.28,10,15,0.667,89,35,90,0.389,25,56,0.446,10,34,0.294,15,19,0.789,95
2174,NOP,2015-12-28,89,@,ORL,0,240,37,83,0.446,32,63,0.508,5,20,0.25,10,15,0.667,89,45,82,0.549,38,65,0.585,7,17,0.412,7,11,0.636,104
2175,GSW,2015-12-25,89,,CLE,1,240,32,78,0.41,27,60,0.45,5,18,0.278,20,27,0.741,89,30,95,0.316,25,65,0.385,5,30,0.167,18,25,0.72,83
2176,CHO,2015-12-23,89,,BOS,0,240,29,81,0.358,21,53,0.396,8,28,0.286,23,32,0.719,89,36,85,0.424,29,56,0.518,7,29,0.241,23,26,0.885,102
2177,POR,2015-12-23,89,@,NOP,0,240,33,95,0.347,26,67,0.388,7,28,0.25,16,24,0.667,89,41,85,0.482,28,54,0.519,13,31,0.419,20,23,0.87,115
2178,PHO,2015-12-21,89,@,UTA,0,240,31,79,0.392,24,55,0.436,7,24,0.292,20,22,0.909,89,36,79,0.456,27,54,0.5,9,25,0.36,29,37,0.784,110
2179,CLE,2015-12-15,89,@,BOS,1,240,36,78,0.462,28,55,0.509,8,23,0.348,9,10,0.9,89,28,87,0.322,19,55,0.345,9,32,0.281,12,14,0.857,77
2180,SAS,2015-11-30,89,@,CHI,0,240,37,90,0.411,35,76,0.461,2,14,0.143,13,18,0.722,89,37,86,0.43,31,70,0.443,6,16,0.375,12,20,0.6,92
2181,UTA,2015-11-23,89,,OKC,0,240,28,73,0.384,23,54,0.426,5,19,0.263,28,40,0.7,89,42,77,0.545,31,50,0.62,11,27,0.407,16,18,0.889,111
2182,TOR,2015-11-18,89,@,UTA,0,240,34,80,0.425,29,60,0.483,5,20,0.25,16,18,0.889,89,35,72,0.486,28,50,0.56,7,22,0.318,16,22,0.727,93
2183,UTA,2015-11-07,89,,MEM,1,240,31,74,0.419,19,47,0.404,12,27,0.444,15,18,0.833,89,30,91,0.33,24,72,0.333,6,19,0.316,13,14,0.929,79
2184,SAC,2015-11-03,89,,MEM,0,240,29,74,0.392,22,54,0.407,7,20,0.35,24,40,0.6,89,40,83,0.482,37,63,0.587,3,20,0.15,20,25,0.8,103
2185,HOU,2015-11-01,89,@,MIA,0,240,32,79,0.405,22,43,0.512,10,36,0.278,15,18,0.833,89,42,86,0.488,33,64,0.516,9,22,0.409,16,21,0.762,109
2186,MIA,2016-04-13,88,@,BOS,0,240,38,88,0.432,36,69,0.522,2,19,0.105,10,12,0.833,88,37,86,0.43,32,72,0.444,5,14,0.357,19,22,0.864,98
2187,DAL,2016-04-06,88,,HOU,1,240,33,80,0.413,23,47,0.489,10,33,0.303,12,14,0.857,88,34,78,0.436,28,58,0.483,6,20,0.3,12,18,0.667,86
2188,SAS,2016-04-05,88,@,UTA,1,240,32,72,0.444,25,55,0.455,7,17,0.412,17,19,0.895,88,32,68,0.471,27,51,0.529,5,17,0.294,17,21,0.81,86
2189,DAL,2016-04-03,88,@,MIN,1,240,32,83,0.386,18,43,0.419,14,40,0.35,10,17,0.588,88,29,71,0.408,25,50,0.5,4,21,0.19,16,18,0.889,78
2190,DET,2016-03-29,88,,OKC,1,240,33,87,0.379,29,68,0.426,4,19,0.211,18,20,0.9,88,31,82,0.378,25,61,0.41,6,21,0.286,14,22,0.636,82
2191,DEN,2016-03-28,88,,DAL,0,240,31,70,0.443,22,46,0.478,9,24,0.375,17,19,0.895,88,36,88,0.409,25,56,0.446,11,32,0.344,14,15,0.933,97
2192,LAL,2016-03-27,88,,WAS,0,240,33,87,0.379,26,59,0.441,7,28,0.25,15,17,0.882,88,39,72,0.542,32,54,0.593,7,18,0.389,16,29,0.552,101
2193,MIA,2016-03-23,88,@,SAS,0,240,37,77,0.481,30,63,0.476,7,14,0.5,7,12,0.583,88,42,81,0.519,34,67,0.507,8,14,0.571,20,24,0.833,112
2194,SAS,2016-03-21,88,@,CHO,0,240,37,86,0.43,33,69,0.478,4,17,0.235,10,13,0.769,88,35,87,0.402,27,68,0.397,8,19,0.421,13,19,0.684,91
2195,SAC,2016-03-20,88,@,NYK,1,240,35,88,0.398,28,63,0.444,7,25,0.28,11,14,0.786,88,32,91,0.352,28,72,0.389,4,19,0.211,12,15,0.8,80
2196,UTA,2016-03-04,88,@,MEM,0,240,32,75,0.427,27,56,0.482,5,19,0.263,19,29,0.655,88,37,81,0.457,33,63,0.524,4,18,0.222,16,19,0.842,94
2197,CHI,2016-02-26,88,@,ATL,0,240,32,88,0.364,27,68,0.397,5,20,0.25,19,22,0.864,88,37,89,0.416,30,55,0.545,7,34,0.206,22,24,0.917,103
2198,CLE,2016-02-22,88,,DET,0,240,34,79,0.43,26,53,0.491,8,26,0.308,12,13,0.923,88,37,80,0.463,29,55,0.527,8,25,0.32,14,21,0.667,96
2199,NYK,2016-01-22,88,,LAC,0,240,33,85,0.388,29,67,0.433,4,18,0.222,18,20,0.9,88,43,76,0.566,30,53,0.566,13,23,0.565,17,24,0.708,116
2200,ATL,2016-01-21,88,@,SAC,0,240,35,84,0.417,27,51,0.529,8,33,0.242,10,15,0.667,88,33,92,0.359,26,68,0.382,7,24,0.292,18,24,0.75,91
2201,MIL,2016-01-10,88,@,NYK,0,240,32,80,0.4,29,67,0.433,3,13,0.231,21,30,0.7,88,39,84,0.464,32,60,0.533,7,24,0.292,15,18,0.833,100
2202,WAS,2016-01-08,88,,TOR,0,240,33,84,0.393,25,59,0.424,8,25,0.32,14,15,0.933,88,34,75,0.453,29,61,0.475,5,14,0.357,24,26,0.923,97
2203,LAL,2016-01-05,88,,GSW,0,240,29,91,0.319,24,70,0.343,5,21,0.238,25,30,0.833,88,40,86,0.465,27,55,0.491,13,31,0.419,16,21,0.762,109
2204,MIN,2015-12-26,88,,IND,0,240,35,75,0.467,31,63,0.492,4,12,0.333,14,18,0.778,88,40,80,0.5,31,54,0.574,9,26,0.346,13,14,0.929,102
2205,HOU,2015-12-25,88,,SAS,1,240,32,74,0.432,25,59,0.424,7,15,0.467,17,26,0.654,88,36,88,0.409,31,68,0.456,5,20,0.25,7,8,0.875,84
2206,NOP,2015-12-25,88,@,MIA,0,265,36,90,0.4,30,70,0.429,6,20,0.3,10,11,0.909,88,35,88,0.398,29,62,0.468,6,26,0.231,18,27,0.667,94
2207,NOP,2015-12-18,88,@,PHO,0,240,26,71,0.366,22,49,0.449,4,22,0.182,32,38,0.842,88,44,84,0.524,38,68,0.559,6,16,0.375,10,17,0.588,104
2208,DEN,2015-12-18,88,@,UTA,0,240,31,79,0.392,25,51,0.49,6,28,0.214,20,25,0.8,88,34,73,0.466,24,48,0.5,10,25,0.4,19,25,0.76,97
2209,MEM,2015-12-18,88,@,DAL,0,240,30,80,0.375,24,63,0.381,6,17,0.353,22,24,0.917,88,34,78,0.436,24,49,0.49,10,29,0.345,19,21,0.905,97
2210,ATL,2015-12-14,88,,MIA,0,240,33,84,0.393,25,51,0.49,8,33,0.242,14,15,0.933,88,40,89,0.449,33,73,0.452,7,16,0.438,13,15,0.867,100
2211,MEM,2015-12-08,88,,OKC,0,240,33,81,0.407,30,67,0.448,3,14,0.214,19,22,0.864,88,47,84,0.56,34,58,0.586,13,26,0.5,18,23,0.783,125
2212,POR,2015-12-07,88,@,MIL,0,240,33,85,0.388,25,52,0.481,8,33,0.242,14,18,0.778,88,30,73,0.411,26,60,0.433,4,13,0.308,26,33,0.788,90
2213,BRK,2015-11-28,88,@,CLE,0,240,33,81,0.407,29,64,0.453,4,17,0.235,18,24,0.75,88,35,87,0.402,26,60,0.433,9,27,0.333,11,17,0.647,90
2214,ATL,2015-11-28,88,@,SAS,0,240,37,87,0.425,31,61,0.508,6,26,0.231,8,13,0.615,88,40,85,0.471,31,68,0.456,9,17,0.529,19,20,0.95,108
2215,SAS,2015-11-25,88,,DAL,1,240,33,81,0.407,25,53,0.472,8,28,0.286,14,19,0.737,88,34,83,0.41,28,61,0.459,6,22,0.273,9,12,0.75,83
2216,POR,2015-11-24,88,,CHI,0,240,31,88,0.352,25,66,0.379,6,22,0.273,20,27,0.741,88,33,86,0.384,26,68,0.382,7,18,0.389,20,23,0.87,93
2217,DET,2015-11-23,88,@,MIL,0,240,31,91,0.341,25,63,0.397,6,28,0.214,20,24,0.833,88,43,83,0.518,34,70,0.486,9,13,0.692,14,17,0.824,109
2218,PHI,2015-11-20,88,@,CHO,0,240,32,79,0.405,24,53,0.453,8,26,0.308,16,22,0.727,88,40,81,0.494,28,56,0.5,12,25,0.48,21,22,0.955,113
2219,ATL,2015-11-17,88,@,BRK,0,240,33,76,0.434,21,47,0.447,12,29,0.414,10,14,0.714,88,37,84,0.44,28,64,0.438,9,20,0.45,7,13,0.538,90
2220,LAL,2015-11-10,88,@,MIA,0,240,34,77,0.442,23,55,0.418,11,22,0.5,9,12,0.75,88,38,84,0.452,33,64,0.516,5,20,0.25,20,27,0.741,101
2221,SAC,2015-11-09,88,,SAS,0,240,34,84,0.405,27,65,0.415,7,19,0.368,13,19,0.684,88,46,87,0.529,40,64,0.625,6,23,0.261,8,11,0.727,106
2222,PHI,2015-11-09,88,,CHI,0,240,35,100,0.35,30,75,0.4,5,25,0.2,13,23,0.565,88,41,96,0.427,31,71,0.437,10,25,0.4,19,23,0.826,111
2223,DAL,2015-10-29,88,@,LAC,0,240,35,97,0.361,29,67,0.433,6,30,0.2,12,15,0.8,88,38,87,0.437,30,56,0.536,8,31,0.258,20,33,0.606,104
2224,WAS,2015-10-28,88,@,ORL,1,240,33,84,0.393,26,56,0.464,7,28,0.25,15,25,0.6,88,37,100,0.37,32,74,0.432,5,26,0.192,8,12,0.667,87
2225,TOR,2016-04-07,87,@,ATL,0,240,32,84,0.381,24,63,0.381,8,21,0.381,15,20,0.75,87,33,76,0.434,21,44,0.477,12,32,0.375,17,21,0.81,95
2226,NYK,2016-04-03,87,,IND,0,240,33,96,0.344,26,71,0.366,7,25,0.28,14,20,0.7,87,34,81,0.42,27,59,0.458,7,22,0.318,17,20,0.85,92
2227,BRK,2016-04-03,87,,NOP,0,240,33,85,0.388,25,62,0.403,8,23,0.348,13,21,0.619,87,42,76,0.553,34,54,0.63,8,22,0.364,14,23,0.609,106
2228,BRK,2016-03-31,87,@,CLE,0,240,35,94,0.372,31,73,0.425,4,21,0.19,13,21,0.619,87,38,87,0.437,26,49,0.531,12,38,0.316,19,24,0.792,107
2229,MEM,2016-03-28,87,,SAS,0,240,33,83,0.398,27,64,0.422,6,19,0.316,15,24,0.625,87,37,72,0.514,32,57,0.561,5,15,0.333,22,30,0.733,101
2230,HOU,2016-03-23,87,,UTA,0,240,33,74,0.446,24,51,0.471,9,23,0.391,12,22,0.545,87,31,77,0.403,20,48,0.417,11,29,0.379,16,20,0.8,89
2231,SAS,2016-03-19,87,,GSW,1,240,32,78,0.41,24,57,0.421,8,21,0.381,15,18,0.833,87,31,82,0.378,22,46,0.478,9,36,0.25,8,10,0.8,79
2232,LAC,2016-03-15,87,@,SAS,0,240,32,69,0.464,24,50,0.48,8,19,0.421,15,22,0.682,87,44,82,0.537,36,62,0.581,8,20,0.4,12,16,0.75,108
2233,LAL,2016-03-13,87,,NYK,0,240,34,85,0.4,31,69,0.449,3,16,0.188,16,21,0.762,87,33,75,0.44,28,54,0.519,5,21,0.238,19,27,0.704,90
2234,ATL,2016-02-28,87,,CHO,1,240,38,77,0.494,30,60,0.5,8,17,0.471,3,5,0.6,87,27,81,0.333,20,49,0.408,7,32,0.219,15,23,0.652,76
2235,DEN,2016-02-24,87,@,LAC,1,240,34,90,0.378,28,66,0.424,6,24,0.25,13,17,0.765,87,30,85,0.353,17,39,0.436,13,46,0.283,8,14,0.571,81
2236,LAL,2016-02-08,87,@,IND,0,240,29,93,0.312,21,58,0.362,8,35,0.229,21,26,0.808,87,31,78,0.397,27,51,0.529,4,27,0.148,23,33,0.697,89
2237,ATL,2016-01-31,87,@,MIA,0,240,27,70,0.386,22,48,0.458,5,22,0.227,28,32,0.875,87,39,81,0.481,34,61,0.557,5,20,0.25,22,26,0.846,105
2238,ORL,2016-01-20,87,,PHI,0,240,33,84,0.393,29,67,0.433,4,17,0.235,17,26,0.654,87,36,74,0.486,27,55,0.491,9,19,0.474,15,21,0.714,96
2239,MIA,2016-01-20,87,@,WAS,0,240,33,68,0.485,26,53,0.491,7,15,0.467,14,18,0.778,87,45,86,0.523,40,70,0.571,5,16,0.313,11,13,0.846,106
2240,PHO,2016-01-17,87,@,MIN,0,240,35,81,0.432,32,66,0.485,3,15,0.2,14,25,0.56,87,39,69,0.565,32,51,0.627,7,18,0.389,32,40,0.8,117
2241,MIN,2016-01-10,87,,DAL,0,240,33,79,0.418,29,63,0.46,4,16,0.25,17,22,0.773,87,36,77,0.468,30,57,0.526,6,20,0.3,15,21,0.714,93
2242,MEM,2016-01-02,87,@,UTA,0,265,33,81,0.407,26,63,0.413,7,18,0.389,14,26,0.538,87,31,75,0.413,22,48,0.458,9,27,0.333,21,28,0.75,92
2243,DEN,2015-12-29,87,,CLE,0,240,37,89,0.416,32,65,0.492,5,24,0.208,8,11,0.727,87,38,86,0.442,34,64,0.531,4,22,0.182,13,22,0.591,93
2244,ATL,2015-12-28,87,@,IND,0,240,31,74,0.419,25,49,0.51,6,25,0.24,19,25,0.76,87,38,87,0.437,31,61,0.508,7,26,0.269,10,18,0.556,93
2245,LAL,2015-12-17,87,,HOU,0,240,36,84,0.429,31,60,0.517,5,24,0.208,10,18,0.556,87,34,88,0.386,22,57,0.386,12,31,0.387,27,42,0.643,107
2246,LAL,2015-12-11,87,@,SAS,0,240,36,88,0.409,27,63,0.429,9,25,0.36,6,10,0.6,87,44,82,0.537,38,68,0.559,6,14,0.429,15,25,0.6,109
2247,LAL,2015-12-04,87,@,ATL,0,240,32,86,0.372,19,59,0.322,13,27,0.481,10,13,0.769,87,37,74,0.5,27,48,0.563,10,26,0.385,16,20,0.8,100
2248,PHI,2015-12-02,87,@,NYK,0,240,32,86,0.372,23,56,0.411,9,30,0.3,14,24,0.583,87,38,88,0.432,34,69,0.493,4,19,0.211,19,22,0.864,99
2249,POR,2015-11-30,87,@,LAC,0,240,33,87,0.379,28,64,0.438,5,23,0.217,16,27,0.593,87,33,85,0.388,25,66,0.379,8,19,0.421,28,56,0.5,102
2250,CHO,2015-11-29,87,,MIL,1,240,27,70,0.386,12,39,0.308,15,31,0.484,18,22,0.818,87,33,82,0.402,25,54,0.463,8,28,0.286,8,14,0.571,82
2251,BRK,2015-11-29,87,,DET,1,240,35,81,0.432,31,69,0.449,4,12,0.333,13,16,0.813,87,34,101,0.337,28,77,0.364,6,24,0.25,9,21,0.429,83
2252,NOP,2015-11-28,87,@,UTA,0,240,29,69,0.42,24,52,0.462,5,17,0.294,24,30,0.8,87,38,82,0.463,29,64,0.453,9,18,0.5,16,21,0.762,101
2253,DET,2015-11-27,87,@,OKC,0,240,31,90,0.344,22,61,0.361,9,29,0.31,16,20,0.8,87,37,79,0.468,30,55,0.545,7,24,0.292,22,26,0.846,103
2254,WAS,2015-11-25,87,@,CHO,0,240,31,87,0.356,21,55,0.382,10,32,0.313,15,18,0.833,87,39,83,0.47,31,57,0.544,8,26,0.308,15,15,1.0,101
2255,NOP,2015-11-15,87,@,NYK,0,240,32,71,0.451,26,50,0.52,6,21,0.286,17,19,0.895,87,38,88,0.432,34,70,0.486,4,18,0.222,15,19,0.789,95
2256,TOR,2015-11-06,87,@,ORL,0,240,30,86,0.349,25,63,0.397,5,23,0.217,22,29,0.759,87,33,77,0.429,24,52,0.462,9,25,0.36,17,22,0.773,92
2257,MIA,2015-11-06,87,@,IND,0,240,36,81,0.444,30,61,0.492,6,20,0.3,9,13,0.692,87,36,80,0.45,31,65,0.477,5,15,0.333,13,24,0.542,90
2258,BRK,2015-11-04,87,@,ATL,0,240,36,83,0.434,31,62,0.5,5,21,0.238,10,13,0.769,87,37,76,0.487,29,54,0.537,8,22,0.364,19,24,0.792,101
2259,PHI,2015-11-04,87,@,MIL,0,240,34,81,0.42,28,53,0.528,6,28,0.214,13,15,0.867,87,35,86,0.407,27,63,0.429,8,23,0.348,13,17,0.765,91
2260,MIL,2015-11-01,87,@,TOR,0,240,29,69,0.42,24,50,0.48,5,19,0.263,24,24,1.0,87,41,90,0.456,30,65,0.462,11,25,0.44,13,20,0.65,106
2261,ORL,2015-11-01,87,@,CHI,0,240,35,90,0.389,28,67,0.418,7,23,0.304,10,17,0.588,87,33,87,0.379,26,59,0.441,7,28,0.25,19,22,0.864,92
2262,BOS,2015-11-01,87,,SAS,0,240,35,98,0.357,29,69,0.42,6,29,0.207,11,14,0.786,87,36,83,0.434,31,64,0.484,5,19,0.263,18,25,0.72,95
2263,ORL,2015-10-28,87,,WAS,0,240,37,100,0.37,32,74,0.432,5,26,0.192,8,12,0.667,87,33,84,0.393,26,56,0.464,7,28,0.25,15,25,0.6,88
2264,UTA,2015-10-28,87,@,DET,0,240,35,75,0.467,33,63,0.524,2,12,0.167,15,21,0.714,87,30,74,0.405,23,55,0.418,7,19,0.368,25,34,0.735,92
2265,SAS,2016-04-10,86,,GSW,0,240,34,90,0.378,31,73,0.425,3,17,0.176,15,19,0.789,86,34,77,0.442,24,50,0.48,10,27,0.37,14,18,0.778,92
2266,HOU,2016-04-06,86,@,DAL,0,240,34,78,0.436,28,58,0.483,6,20,0.3,12,18,0.667,86,33,80,0.413,23,47,0.489,10,33,0.303,12,14,0.857,88
2267,UTA,2016-04-05,86,,SAS,0,240,32,68,0.471,27,51,0.529,5,17,0.294,17,21,0.81,86,32,72,0.444,25,55,0.455,7,17,0.412,17,19,0.895,88
2268,PHO,2016-04-03,86,,UTA,0,240,33,78,0.423,25,51,0.49,8,27,0.296,12,19,0.632,86,39,81,0.481,29,54,0.537,10,27,0.37,13,17,0.765,101
2269,MEM,2016-03-17,86,@,MIL,0,240,34,92,0.37,31,79,0.392,3,13,0.231,15,17,0.882,86,37,75,0.493,32,56,0.571,5,19,0.263,17,25,0.68,96
2270,NOP,2016-03-03,86,,SAS,0,240,35,89,0.393,27,65,0.415,8,24,0.333,8,8,1.0,86,36,81,0.444,28,60,0.467,8,21,0.381,14,15,0.933,94
2271,DET,2016-02-19,86,@,WAS,0,240,35,82,0.427,28,59,0.475,7,23,0.304,9,17,0.529,86,36,78,0.462,29,56,0.518,7,22,0.318,19,26,0.731,98
2272,SAS,2016-02-18,86,@,LAC,0,240,35,83,0.422,31,66,0.47,4,17,0.235,12,15,0.8,86,39,78,0.5,27,53,0.509,12,25,0.48,15,20,0.75,105
2273,PHI,2016-02-03,86,,ATL,0,240,35,84,0.417,29,57,0.509,6,27,0.222,10,14,0.714,86,48,92,0.522,38,72,0.528,10,20,0.5,18,25,0.72,124
2274,BRK,2016-01-22,86,,UTA,0,240,33,75,0.44,27,59,0.458,6,16,0.375,14,18,0.778,86,43,75,0.573,34,59,0.576,9,16,0.563,13,15,0.867,108
2275,BRK,2016-01-16,86,@,ATL,0,240,34,78,0.436,28,58,0.483,6,20,0.3,12,19,0.632,86,44,79,0.557,36,50,0.72,8,29,0.276,18,24,0.75,114
2276,UTA,2016-01-10,86,@,LAL,1,240,31,69,0.449,26,53,0.491,5,16,0.313,19,25,0.76,86,29,89,0.326,26,68,0.382,3,21,0.143,13,15,0.867,74
2277,NOP,2016-01-08,86,,IND,0,240,31,83,0.373,22,54,0.407,9,29,0.31,15,20,0.75,86,36,81,0.444,31,60,0.517,5,21,0.238,14,19,0.737,91
2278,ORL,2016-01-06,86,,IND,0,240,32,79,0.405,26,48,0.542,6,31,0.194,16,17,0.941,86,32,76,0.421,26,54,0.481,6,22,0.273,25,29,0.862,95
2279,DEN,2015-12-26,86,@,SAS,0,240,38,86,0.442,33,68,0.485,5,18,0.278,5,6,0.833,86,39,81,0.481,32,71,0.451,7,10,0.7,16,17,0.941,101
2280,PHI,2015-12-20,86,@,CLE,0,240,30,86,0.349,25,62,0.403,5,24,0.208,21,30,0.7,86,40,85,0.471,29,60,0.483,11,25,0.44,17,21,0.81,108
2281,ATL,2015-12-02,86,,TOR,0,240,33,90,0.367,25,63,0.397,8,27,0.296,12,16,0.75,86,36,79,0.456,30,54,0.556,6,25,0.24,18,24,0.75,96
2282,MIL,2015-11-21,86,@,IND,0,240,34,79,0.43,29,62,0.468,5,17,0.294,13,19,0.684,86,47,91,0.516,32,61,0.525,15,30,0.5,14,23,0.609,123
2283,MIN,2015-11-20,86,,DET,0,240,33,77,0.429,30,64,0.469,3,13,0.231,17,25,0.68,86,40,87,0.46,34,59,0.576,6,28,0.214,10,13,0.769,96
2284,MIL,2015-11-17,86,@,WAS,0,240,31,72,0.431,21,51,0.412,10,21,0.476,14,24,0.583,86,37,70,0.529,25,48,0.521,12,22,0.545,29,41,0.707,115
2285,PHI,2015-11-16,86,,DAL,0,240,34,76,0.447,29,54,0.537,5,22,0.227,13,20,0.65,86,30,76,0.395,23,52,0.442,7,24,0.292,25,30,0.833,92
2286,BRK,2015-11-07,86,@,MIL,0,240,34,82,0.415,31,73,0.425,3,9,0.333,15,19,0.789,86,37,82,0.451,29,62,0.468,8,20,0.4,12,16,0.75,94
2287,NYK,2015-11-04,86,@,CLE,0,240,33,84,0.393,25,60,0.417,8,24,0.333,12,15,0.8,86,33,83,0.398,26,56,0.464,7,27,0.259,23,32,0.719,96
2288,MIN,2016-04-01,85,@,UTA,0,240,35,79,0.443,26,56,0.464,9,23,0.391,6,10,0.6,85,38,72,0.528,30,50,0.6,8,22,0.364,14,23,0.609,98
2289,PHI,2016-03-29,85,,CHO,0,240,30,96,0.313,14,52,0.269,16,44,0.364,9,10,0.9,85,38,87,0.437,31,62,0.5,7,25,0.28,17,18,0.944,100
2290,MIL,2016-03-20,85,,UTA,0,240,34,65,0.523,31,57,0.544,3,8,0.375,14,17,0.824,85,34,83,0.41,21,45,0.467,13,38,0.342,13,14,0.929,94
2291,UTA,2016-03-19,85,@,CHI,0,240,35,86,0.407,27,59,0.458,8,27,0.296,7,12,0.583,85,39,80,0.488,33,61,0.541,6,19,0.316,8,11,0.727,92
2292,NYK,2016-03-16,85,@,GSW,0,240,36,91,0.396,29,72,0.403,7,19,0.368,6,10,0.6,85,46,91,0.505,28,54,0.519,18,37,0.486,11,12,0.917,121
2293,CLE,2016-03-14,85,@,UTA,0,240,35,88,0.398,25,45,0.556,10,43,0.233,5,8,0.625,85,35,71,0.493,23,44,0.523,12,27,0.444,12,14,0.857,94
2294,OKC,2016-03-12,85,@,SAS,0,240,31,81,0.383,29,63,0.46,2,18,0.111,21,25,0.84,85,34,85,0.4,30,61,0.492,4,24,0.167,21,25,0.84,93
2295,NYK,2016-03-01,85,,POR,0,240,33,88,0.375,27,67,0.403,6,21,0.286,13,18,0.722,85,37,88,0.42,25,58,0.431,12,30,0.4,18,20,0.9,104
2296,MEM,2016-02-21,85,@,TOR,0,240,28,76,0.368,25,56,0.446,3,20,0.15,26,32,0.813,85,33,81,0.407,26,53,0.491,7,28,0.25,25,31,0.806,98
2297,NYK,2016-02-05,85,,MEM,0,240,30,80,0.375,20,51,0.392,10,29,0.345,15,17,0.882,85,33,76,0.434,29,58,0.5,4,18,0.222,21,24,0.875,91
2298,UTA,2016-02-03,85,,DEN,1,240,33,74,0.446,28,52,0.538,5,22,0.227,14,20,0.7,85,26,70,0.371,22,52,0.423,4,18,0.222,25,33,0.758,81
2299,LAC,2016-01-27,85,@,ATL,1,240,33,85,0.388,28,58,0.483,5,27,0.185,14,21,0.667,85,33,79,0.418,23,56,0.411,10,23,0.435,7,14,0.5,83
2300,UTA,2016-01-13,85,@,POR,0,240,31,76,0.408,23,57,0.404,8,19,0.421,15,22,0.682,85,39,88,0.443,28,62,0.452,11,26,0.423,10,15,0.667,99
2301,PHI,2016-01-10,85,,CLE,0,240,35,77,0.455,29,59,0.492,6,18,0.333,9,19,0.474,85,35,90,0.389,26,58,0.448,9,32,0.281,16,23,0.696,95
2302,MIN,2016-01-02,85,,MIL,0,240,33,84,0.393,30,70,0.429,3,14,0.214,16,24,0.667,85,32,75,0.427,24,59,0.407,8,16,0.5,23,28,0.821,95
2303,UTA,2015-12-23,85,@,GSW,0,240,33,80,0.413,26,60,0.433,7,20,0.35,12,14,0.857,85,39,83,0.47,30,60,0.5,9,23,0.391,16,16,1.0,103
2304,LAL,2015-12-23,85,,OKC,0,240,32,89,0.36,25,64,0.391,7,25,0.28,14,22,0.636,85,51,95,0.537,46,76,0.605,5,19,0.263,13,17,0.765,120
2305,BRK,2015-12-20,85,,MIN,0,240,32,78,0.41,27,57,0.474,5,21,0.238,16,20,0.8,85,38,80,0.475,35,68,0.515,3,12,0.25,21,24,0.875,100
2306,MEM,2015-12-16,85,@,CHI,0,240,32,76,0.421,27,57,0.474,5,19,0.263,16,28,0.571,85,38,86,0.442,29,62,0.468,9,24,0.375,13,19,0.684,98
2307,NYK,2015-12-09,85,@,UTA,0,240,31,78,0.397,23,57,0.404,8,21,0.381,15,27,0.556,85,39,80,0.488,30,59,0.508,9,21,0.429,19,23,0.826,106
2308,ORL,2015-12-08,85,@,DEN,1,240,38,88,0.432,37,72,0.514,1,16,0.063,8,10,0.8,85,28,84,0.333,21,60,0.35,7,24,0.292,11,20,0.55,74
2309,CLE,2015-12-01,85,,WAS,0,240,28,83,0.337,19,53,0.358,9,30,0.3,20,23,0.87,85,39,83,0.47,32,55,0.582,7,28,0.25,12,16,0.75,97
2310,PHI,2015-11-18,85,,IND,0,240,35,76,0.461,30,51,0.588,5,25,0.2,10,16,0.625,85,42,92,0.457,30,65,0.462,12,27,0.444,16,20,0.8,112
2311,OKC,2015-11-15,85,,BOS,0,240,28,77,0.364,22,52,0.423,6,25,0.24,23,29,0.793,85,39,82,0.476,30,59,0.508,9,23,0.391,13,20,0.65,100
2312,DET,2015-11-15,85,@,LAL,0,240,35,96,0.365,28,69,0.406,7,27,0.259,8,15,0.533,85,31,75,0.413,25,56,0.446,6,19,0.316,29,39,0.744,97
2313,PHI,2015-11-13,85,@,OKC,0,240,30,86,0.349,25,69,0.362,5,17,0.294,20,28,0.714,85,39,97,0.402,31,72,0.431,8,25,0.32,16,21,0.762,102
2314,HOU,2015-10-28,85,,DEN,0,240,30,87,0.345,22,52,0.423,8,35,0.229,17,26,0.654,85,40,79,0.506,27,52,0.519,13,27,0.481,12,18,0.667,105
2315,MEM,2016-04-12,84,@,LAC,0,240,35,86,0.407,30,66,0.455,5,20,0.25,9,14,0.643,84,41,75,0.547,29,50,0.58,12,25,0.48,16,21,0.762,110
2316,DEN,2016-04-10,84,,UTA,0,240,32,80,0.4,26,53,0.491,6,27,0.222,14,19,0.737,84,36,79,0.456,24,48,0.5,12,31,0.387,16,21,0.762,100
2317,MIN,2016-03-26,84,,UTA,0,240,32,84,0.381,28,73,0.384,4,11,0.364,16,19,0.842,84,39,83,0.47,30,62,0.484,9,21,0.429,6,7,0.857,93
2318,NOP,2016-03-24,84,@,IND,0,240,35,85,0.412,31,69,0.449,4,16,0.25,10,14,0.714,84,36,79,0.456,29,59,0.492,7,20,0.35,13,15,0.867,92
2319,ORL,2016-03-12,84,@,POR,0,240,34,91,0.374,27,65,0.415,7,26,0.269,9,18,0.5,84,47,84,0.56,30,49,0.612,17,35,0.486,10,11,0.909,121
2320,UTA,2016-03-08,84,,ATL,0,240,30,86,0.349,23,60,0.383,7,26,0.269,17,23,0.739,84,38,80,0.475,30,55,0.545,8,25,0.32,7,14,0.5,91
2321,ORL,2016-03-04,84,,PHO,0,240,35,101,0.347,28,74,0.378,7,27,0.259,7,14,0.5,84,35,78,0.449,30,64,0.469,5,14,0.357,27,39,0.692,102
2322,PHO,2016-02-22,84,@,LAC,0,240,31,88,0.352,24,64,0.375,7,24,0.292,15,20,0.75,84,44,80,0.55,31,56,0.554,13,24,0.542,23,35,0.657,124
2323,NOP,2016-02-06,84,@,CLE,0,240,34,87,0.391,29,64,0.453,5,23,0.217,11,16,0.688,84,39,90,0.433,25,49,0.51,14,41,0.341,7,7,1.0,99
2324,UTA,2016-02-05,84,,MIL,1,240,30,77,0.39,22,50,0.44,8,27,0.296,16,23,0.696,84,30,71,0.423,23,57,0.404,7,14,0.5,14,21,0.667,81
2325,PHO,2016-01-29,84,@,NYK,0,240,35,85,0.412,28,59,0.475,7,26,0.269,7,12,0.583,84,36,84,0.429,29,64,0.453,7,20,0.35,23,26,0.885,102
2326,CHI,2016-01-25,84,,MIA,0,240,35,88,0.398,30,70,0.429,5,18,0.278,9,12,0.75,84,37,81,0.457,34,67,0.507,3,14,0.214,12,17,0.706,89
2327,NYK,2016-01-23,84,@,CHO,0,240,29,77,0.377,22,53,0.415,7,24,0.292,19,32,0.594,84,28,82,0.341,19,51,0.373,9,31,0.29,32,37,0.865,97
2328,ATL,2016-01-13,84,@,CHO,0,240,30,81,0.37,23,56,0.411,7,25,0.28,17,21,0.81,84,36,82,0.439,23,43,0.535,13,39,0.333,22,26,0.846,107
2329,DEN,2016-01-08,84,@,MEM,0,240,32,87,0.368,28,68,0.412,4,19,0.211,16,19,0.842,84,30,82,0.366,22,64,0.344,8,18,0.444,23,30,0.767,91
2330,PHI,2016-01-01,84,@,LAL,0,240,31,84,0.369,27,60,0.45,4,24,0.167,18,25,0.72,84,33,87,0.379,28,71,0.394,5,16,0.313,22,29,0.759,93
2331,LAL,2015-12-25,84,,LAC,0,240,32,77,0.416,25,54,0.463,7,23,0.304,13,25,0.52,84,38,85,0.447,28,59,0.475,10,26,0.385,8,11,0.727,94
2332,SAS,2015-12-25,84,@,HOU,0,240,36,88,0.409,31,68,0.456,5,20,0.25,7,8,0.875,84,32,74,0.432,25,59,0.424,7,15,0.467,17,26,0.654,88
2333,NYK,2015-12-23,84,@,CLE,0,240,32,82,0.39,27,66,0.409,5,16,0.313,15,16,0.938,84,32,83,0.386,27,61,0.443,5,22,0.227,22,25,0.88,91
2334,IND,2015-12-19,84,@,MEM,0,240,30,77,0.39,25,49,0.51,5,28,0.179,19,25,0.76,84,37,83,0.446,32,64,0.5,5,19,0.263,17,21,0.81,96
2335,DET,2015-12-07,84,@,CHO,0,240,32,87,0.368,22,53,0.415,10,34,0.294,10,22,0.455,84,36,84,0.429,28,58,0.483,8,26,0.308,24,35,0.686,104
2336,CLE,2015-12-05,84,@,MIA,0,240,31,85,0.365,25,57,0.439,6,28,0.214,16,24,0.667,84,37,68,0.544,30,52,0.577,7,16,0.438,18,29,0.621,99
2337,PHI,2015-11-29,84,@,MEM,0,240,30,77,0.39,18,41,0.439,12,36,0.333,12,16,0.75,84,34,81,0.42,30,68,0.441,4,13,0.308,20,27,0.741,92
2338,TOR,2015-11-28,84,@,WAS,1,240,31,72,0.431,20,48,0.417,11,24,0.458,11,14,0.786,84,27,82,0.329,20,59,0.339,7,23,0.304,21,27,0.778,82
2339,BOS,2015-11-25,84,,PHI,1,240,31,91,0.341,22,62,0.355,9,29,0.31,13,18,0.722,84,31,83,0.373,24,56,0.429,7,27,0.259,11,15,0.733,80
2340,PHO,2015-11-23,84,@,SAS,0,240,34,73,0.466,27,54,0.5,7,19,0.368,9,10,0.9,84,42,82,0.512,33,62,0.532,9,20,0.45,5,10,0.5,98
2341,HOU,2015-11-20,84,@,MEM,0,240,28,74,0.378,22,45,0.489,6,29,0.207,22,37,0.595,84,36,85,0.424,28,61,0.459,8,24,0.333,16,19,0.842,96
2342,NYK,2015-11-13,84,,CLE,0,240,29,79,0.367,20,52,0.385,9,27,0.333,17,21,0.81,84,33,78,0.423,27,50,0.54,6,28,0.214,18,31,0.581,90
2343,MEM,2015-11-11,84,,GSW,0,240,24,70,0.343,21,55,0.382,3,15,0.2,33,36,0.917,84,36,75,0.48,25,48,0.521,11,27,0.407,17,23,0.739,100
2344,ORL,2015-11-09,84,@,IND,0,240,31,78,0.397,21,45,0.467,10,33,0.303,12,17,0.706,84,34,77,0.442,23,52,0.442,11,25,0.44,18,22,0.818,97
2345,DEN,2015-11-05,84,,UTA,0,240,28,72,0.389,23,52,0.442,5,20,0.25,23,34,0.676,84,37,85,0.435,26,61,0.426,11,24,0.458,11,17,0.647,96
2346,MIN,2015-11-05,84,,MIA,0,240,30,85,0.353,26,73,0.356,4,12,0.333,20,22,0.909,84,37,76,0.487,33,62,0.532,4,14,0.286,18,25,0.72,96
2347,NYK,2015-11-02,84,,SAS,0,240,32,89,0.36,28,76,0.368,4,13,0.308,16,21,0.762,84,39,79,0.494,35,66,0.53,4,13,0.308,12,17,0.706,94
2348,MEM,2016-03-12,83,@,ATL,0,240,33,95,0.347,27,72,0.375,6,23,0.261,11,14,0.786,83,36,84,0.429,25,50,0.5,11,34,0.324,12,17,0.706,95
2349,WAS,2016-03-04,83,@,CLE,0,240,32,81,0.395,29,61,0.475,3,20,0.15,16,24,0.667,83,42,90,0.467,30,63,0.476,12,27,0.444,12,16,0.75,108
2350,MIL,2016-01-28,83,@,MEM,0,240,29,79,0.367,28,63,0.444,1,16,0.063,24,27,0.889,83,38,80,0.475,28,52,0.538,10,28,0.357,17,20,0.85,103
2351,ATL,2016-01-27,83,,LAC,0,240,33,79,0.418,23,56,0.411,10,23,0.435,7,14,0.5,83,33,85,0.388,28,58,0.483,5,27,0.185,14,21,0.667,85
2352,CLE,2016-01-23,83,,CHI,0,240,35,94,0.372,31,70,0.443,4,24,0.167,9,22,0.409,83,38,87,0.437,31,70,0.443,7,17,0.412,13,15,0.867,96
2353,DAL,2016-01-17,83,@,SAS,0,240,29,81,0.358,23,58,0.397,6,23,0.261,19,25,0.76,83,42,90,0.467,37,70,0.529,5,20,0.25,23,28,0.821,112
2354,DAL,2016-01-15,83,@,CHI,1,240,30,77,0.39,22,55,0.4,8,22,0.364,15,17,0.882,83,31,86,0.36,29,67,0.433,2,19,0.105,13,15,0.867,77
2355,MIA,2016-01-09,83,@,UTA,0,240,34,82,0.415,28,63,0.444,6,19,0.316,9,17,0.529,83,39,71,0.549,30,51,0.588,9,20,0.45,11,18,0.611,98
2356,CHO,2016-01-09,83,@,LAC,0,240,31,84,0.369,24,61,0.393,7,23,0.304,14,19,0.737,83,40,91,0.44,32,60,0.533,8,31,0.258,9,10,0.9,97
2357,ORL,2016-01-08,83,@,BRK,1,240,33,83,0.398,20,55,0.364,13,28,0.464,4,6,0.667,83,29,73,0.397,22,51,0.431,7,22,0.318,12,20,0.6,77
2358,CLE,2015-12-25,83,@,GSW,0,240,30,95,0.316,25,65,0.385,5,30,0.167,18,25,0.72,83,32,78,0.41,27,60,0.45,5,18,0.278,20,27,0.741,89
2359,MIN,2015-12-23,83,,SAS,0,240,30,72,0.417,27,62,0.435,3,10,0.3,20,25,0.8,83,44,82,0.537,34,58,0.586,10,24,0.417,10,14,0.714,108
2360,MIA,2015-12-11,83,@,IND,0,240,35,81,0.432,30,61,0.492,5,20,0.25,8,13,0.615,83,36,86,0.419,30,58,0.517,6,28,0.214,18,20,0.9,96
2361,MIL,2015-12-11,83,@,TOR,0,240,33,80,0.413,29,69,0.42,4,11,0.364,13,16,0.813,83,34,70,0.486,27,50,0.54,7,20,0.35,15,23,0.652,90
2362,CHI,2015-12-10,83,,LAC,1,240,31,87,0.356,24,64,0.375,7,23,0.304,14,16,0.875,83,30,88,0.341,20,66,0.303,10,22,0.455,10,12,0.833,80
2363,MEM,2015-12-03,83,,SAS,0,240,30,80,0.375,28,64,0.438,2,16,0.125,21,25,0.84,83,40,80,0.5,30,62,0.484,10,18,0.556,13,18,0.722,103
2364,DET,2015-11-29,83,@,BRK,0,240,34,101,0.337,28,77,0.364,6,24,0.25,9,21,0.429,83,35,81,0.432,31,69,0.449,4,12,0.333,13,16,0.813,87
2365,DAL,2015-11-25,83,@,SAS,0,240,34,83,0.41,28,61,0.459,6,22,0.273,9,12,0.75,83,33,81,0.407,25,53,0.472,8,28,0.286,14,19,0.737,88
2366,PHI,2015-11-14,83,@,SAS,0,240,33,82,0.402,25,60,0.417,8,22,0.364,9,11,0.818,83,33,85,0.388,28,69,0.406,5,16,0.313,21,25,0.84,92
2367,MIL,2015-11-10,83,,BOS,0,240,30,73,0.411,24,56,0.429,6,17,0.353,17,23,0.739,83,38,86,0.442,31,56,0.554,7,30,0.233,16,19,0.842,99
2368,OKC,2016-03-29,82,@,DET,0,240,31,82,0.378,25,61,0.41,6,21,0.286,14,22,0.636,82,33,87,0.379,29,68,0.426,4,19,0.211,18,20,0.9,88
2369,LAL,2016-01-31,82,,CHO,0,240,27,80,0.338,19,51,0.373,8,29,0.276,20,23,0.87,82,36,96,0.375,23,60,0.383,13,36,0.361,16,26,0.615,101
2370,LAL,2016-01-16,82,@,UTA,0,240,31,90,0.344,22,67,0.328,9,23,0.391,11,18,0.611,82,41,83,0.494,29,59,0.492,12,24,0.5,15,18,0.833,109
2371,DET,2016-01-02,82,@,IND,0,240,33,93,0.355,30,73,0.411,3,20,0.15,13,23,0.565,82,33,73,0.452,26,55,0.473,7,18,0.389,21,29,0.724,94
2372,DAL,2016-01-01,82,@,MIA,0,240,32,88,0.364,25,57,0.439,7,31,0.226,11,14,0.786,82,46,82,0.561,38,64,0.594,8,18,0.444,6,9,0.667,106
2373,BRK,2015-12-14,82,,ORL,0,240,31,80,0.388,24,61,0.393,7,19,0.368,13,16,0.813,82,41,76,0.539,32,55,0.582,9,21,0.429,14,20,0.7,105
2374,MIL,2015-11-29,82,@,CHO,0,240,33,82,0.402,25,54,0.463,8,28,0.286,8,14,0.571,82,27,70,0.386,12,39,0.308,15,31,0.484,18,22,0.818,87
2375,WAS,2015-11-28,82,,TOR,0,240,27,82,0.329,20,59,0.339,7,23,0.304,21,27,0.778,82,31,72,0.431,20,48,0.417,11,24,0.458,11,14,0.786,84
2376,MEM,2015-11-21,82,@,SAS,0,240,32,74,0.432,31,65,0.477,1,9,0.111,17,17,1.0,82,34,72,0.472,27,51,0.529,7,21,0.333,17,22,0.773,92
2377,LAL,2015-11-13,82,@,DAL,0,240,29,88,0.33,20,61,0.328,9,27,0.333,15,18,0.833,82,30,82,0.366,23,55,0.418,7,27,0.259,23,29,0.793,90
2378,DET,2015-11-03,82,,IND,0,240,33,86,0.384,28,64,0.438,5,22,0.227,11,17,0.647,82,38,88,0.432,31,65,0.477,7,23,0.304,11,12,0.917,94
2379,SAC,2016-04-13,81,@,HOU,0,240,32,96,0.333,21,59,0.356,11,37,0.297,6,13,0.462,81,47,97,0.485,37,62,0.597,10,35,0.286,12,19,0.632,116
2380,LAL,2016-04-06,81,,LAC,0,240,32,90,0.356,28,71,0.394,4,19,0.211,13,17,0.765,81,37,83,0.446,30,58,0.517,7,25,0.28,10,14,0.714,91
2381,LAL,2016-04-05,81,@,LAC,0,240,26,83,0.313,20,63,0.317,6,20,0.3,23,25,0.92,81,40,78,0.513,33,58,0.569,7,20,0.35,16,26,0.615,103
2382,MEM,2016-03-14,81,@,HOU,0,240,30,101,0.297,26,84,0.31,4,17,0.235,17,28,0.607,81,46,85,0.541,30,52,0.577,16,33,0.485,22,34,0.647,130
2383,DET,2016-03-14,81,@,WAS,0,240,32,79,0.405,29,56,0.518,3,23,0.13,14,22,0.636,81,51,90,0.567,43,72,0.597,8,18,0.444,14,18,0.778,124
2384,DET,2016-03-02,81,@,SAS,0,240,31,78,0.397,25,59,0.424,6,19,0.316,13,23,0.565,81,43,84,0.512,40,70,0.571,3,14,0.214,8,9,0.889,97
2385,NYK,2016-02-28,81,,MIA,0,240,32,87,0.368,26,72,0.361,6,15,0.4,11,12,0.917,81,40,84,0.476,39,76,0.513,1,8,0.125,17,21,0.81,98
2386,LAC,2016-02-24,81,,DEN,0,240,30,85,0.353,17,39,0.436,13,46,0.283,8,14,0.571,81,34,90,0.378,28,66,0.424,6,24,0.25,13,17,0.765,87
2387,MIL,2016-02-05,81,@,UTA,0,240,30,71,0.423,23,57,0.404,7,14,0.5,14,21,0.667,81,30,77,0.39,22,50,0.44,8,27,0.296,16,23,0.696,84
2388,DEN,2016-02-03,81,@,UTA,0,240,26,70,0.371,22,52,0.423,4,18,0.222,25,33,0.758,81,33,74,0.446,28,52,0.538,5,22,0.227,14,20,0.7,85
2389,MIA,2016-01-22,81,@,TOR,0,240,33,81,0.407,29,64,0.453,4,17,0.235,11,17,0.647,81,35,75,0.467,22,50,0.44,13,25,0.52,18,21,0.857,101
2390,ORL,2016-01-18,81,@,ATL,0,240,30,87,0.345,24,65,0.369,6,22,0.273,15,20,0.75,81,41,80,0.513,32,61,0.525,9,19,0.474,7,10,0.7,98
2391,NYK,2016-01-01,81,@,CHI,0,240,31,84,0.369,25,65,0.385,6,19,0.316,13,17,0.765,81,39,85,0.459,29,69,0.42,10,16,0.625,20,25,0.8,108
2392,DAL,2015-12-16,81,@,IND,0,240,33,90,0.367,25,57,0.439,8,33,0.242,7,10,0.7,81,43,89,0.483,32,60,0.533,11,29,0.379,10,17,0.588,107
2393,UTA,2015-12-14,81,@,SAS,0,240,32,79,0.405,29,68,0.426,3,11,0.273,14,17,0.824,81,42,75,0.56,33,54,0.611,9,21,0.429,25,27,0.926,118
2394,MIA,2015-12-09,81,@,CHO,0,240,29,75,0.387,23,54,0.426,6,21,0.286,17,24,0.708,81,40,81,0.494,29,54,0.537,11,27,0.407,8,17,0.471,99
2395,DEN,2015-11-28,81,@,DAL,0,240,30,75,0.4,22,50,0.44,8,25,0.32,13,17,0.765,81,33,77,0.429,26,51,0.51,7,26,0.269,19,27,0.704,92
2396,MIA,2015-11-25,81,@,DET,0,240,32,79,0.405,26,59,0.441,6,20,0.3,11,16,0.688,81,41,98,0.418,25,67,0.373,16,31,0.516,6,7,0.857,104
2397,DEN,2015-11-14,81,@,PHO,0,240,34,98,0.347,28,63,0.444,6,35,0.171,7,8,0.875,81,37,84,0.44,26,60,0.433,11,24,0.458,20,26,0.769,105
2398,NOP,2015-11-13,81,@,TOR,0,240,30,82,0.366,23,59,0.39,7,23,0.304,14,20,0.7,81,34,77,0.442,25,56,0.446,9,21,0.429,23,27,0.852,100
2399,MIL,2016-04-05,80,,CLE,0,240,35,88,0.398,31,72,0.431,4,16,0.25,6,12,0.5,80,41,75,0.547,23,39,0.59,18,36,0.5,9,10,0.9,109
2400,NYK,2016-03-20,80,,SAC,0,240,32,91,0.352,28,72,0.389,4,19,0.211,12,15,0.8,80,35,88,0.398,28,63,0.444,7,25,0.28,11,14,0.786,88
2401,UTA,2015-12-30,80,@,MIN,0,240,28,80,0.35,18,41,0.439,10,39,0.256,14,20,0.7,80,36,77,0.468,31,67,0.463,5,10,0.5,17,27,0.63,94
2402,LAC,2015-12-10,80,@,CHI,0,240,30,88,0.341,20,66,0.303,10,22,0.455,10,12,0.833,80,31,87,0.356,24,64,0.375,7,23,0.304,14,16,0.875,83
2403,DEN,2015-11-27,80,,SAS,0,240,31,77,0.403,24,57,0.421,7,20,0.35,11,13,0.846,80,36,75,0.48,28,53,0.528,8,22,0.364,11,14,0.786,91
2404,PHI,2015-11-25,80,@,BOS,0,240,31,83,0.373,24,56,0.429,7,27,0.259,11,15,0.733,80,31,91,0.341,22,62,0.355,9,29,0.31,13,18,0.722,84
2405,LAC,2015-11-22,80,,TOR,0,240,29,74,0.392,22,42,0.524,7,32,0.219,15,20,0.75,80,29,78,0.372,25,61,0.41,4,17,0.235,29,31,0.935,91
2406,POR,2015-11-16,80,@,SAS,0,240,31,75,0.413,24,56,0.429,7,19,0.368,11,13,0.846,80,38,89,0.427,31,66,0.47,7,23,0.304,10,13,0.769,93
2407,LAL,2016-04-11,79,@,OKC,0,240,23,81,0.284,16,50,0.32,7,31,0.226,26,30,0.867,79,42,96,0.438,30,59,0.508,12,37,0.324,16,27,0.593,112
2408,MIN,2016-03-30,79,,LAC,0,240,30,87,0.345,22,64,0.344,8,23,0.348,11,17,0.647,79,37,84,0.44,28,53,0.528,9,31,0.29,16,18,0.889,99
2409,TOR,2016-03-23,79,@,BOS,0,240,31,89,0.348,25,67,0.373,6,22,0.273,11,20,0.55,79,35,80,0.438,27,60,0.45,8,20,0.4,13,21,0.619,91
2410,GSW,2016-03-19,79,@,SAS,0,240,31,82,0.378,22,46,0.478,9,36,0.25,8,10,0.8,79,32,78,0.41,24,57,0.421,8,21,0.381,15,18,0.833,87
2411,HOU,2016-02-06,79,,POR,0,240,25,77,0.325,18,41,0.439,7,36,0.194,22,30,0.733,79,35,87,0.402,24,52,0.462,11,35,0.314,15,23,0.652,96
2412,BRK,2016-01-29,79,@,DAL,0,240,28,78,0.359,24,58,0.414,4,20,0.2,19,23,0.826,79,37,80,0.463,29,59,0.492,8,21,0.381,9,15,0.6,91
2413,MIA,2016-01-19,79,,MIL,0,240,27,74,0.365,22,52,0.423,5,22,0.227,20,26,0.769,79,36,74,0.486,31,62,0.5,5,12,0.417,14,16,0.875,91
2414,BRK,2016-01-11,79,,SAS,0,240,33,73,0.452,31,61,0.508,2,12,0.167,11,13,0.846,79,44,82,0.537,40,69,0.58,4,13,0.308,14,19,0.737,106
2415,ORL,2016-01-02,79,@,CLE,0,240,29,76,0.382,23,51,0.451,6,25,0.24,15,17,0.882,79,34,82,0.415,22,45,0.489,12,37,0.324,24,39,0.615,104
2416,PHO,2015-12-30,79,@,SAS,0,240,32,81,0.395,27,63,0.429,5,18,0.278,10,18,0.556,79,43,76,0.566,37,62,0.597,6,14,0.429,20,33,0.606,112
2417,MEM,2015-11-07,79,@,UTA,0,240,30,91,0.33,24,72,0.333,6,19,0.316,13,14,0.929,79,31,74,0.419,19,47,0.404,12,27,0.444,15,18,0.833,89
2418,MIN,2016-04-03,78,,DAL,0,240,29,71,0.408,25,50,0.5,4,21,0.19,16,18,0.889,78,32,83,0.386,18,43,0.419,14,40,0.35,10,17,0.588,88
2419,UTA,2016-02-25,78,,SAS,0,240,33,77,0.429,30,60,0.5,3,17,0.176,9,12,0.75,78,38,79,0.481,29,61,0.475,9,18,0.5,11,12,0.917,96
2420,PHO,2016-01-31,78,@,DAL,0,240,27,74,0.365,22,51,0.431,5,23,0.217,19,24,0.792,78,31,78,0.397,23,49,0.469,8,29,0.276,21,23,0.913,91
2421,BRK,2016-01-20,78,,CLE,0,240,35,84,0.417,31,65,0.477,4,19,0.211,4,8,0.5,78,36,77,0.468,31,60,0.517,5,17,0.294,14,20,0.7,91
2422,DEN,2016-01-06,78,@,MIN,1,240,29,81,0.358,21,61,0.344,8,20,0.4,12,17,0.706,78,28,73,0.384,25,62,0.403,3,11,0.273,15,20,0.75,74
2423,POR,2016-01-04,78,,MEM,0,240,28,72,0.389,21,44,0.477,7,28,0.25,15,24,0.625,78,35,91,0.385,32,76,0.421,3,15,0.2,18,26,0.692,91
2424,LAL,2015-12-19,78,@,OKC,0,240,30,86,0.349,22,58,0.379,8,28,0.286,10,17,0.588,78,46,84,0.548,37,65,0.569,9,19,0.474,17,25,0.68,118
2425,ATL,2015-12-12,78,,SAS,0,240,30,80,0.375,25,56,0.446,5,24,0.208,13,16,0.813,78,36,74,0.486,26,54,0.481,10,20,0.5,21,22,0.955,103
2426,NYK,2015-11-27,78,,MIA,0,240,32,85,0.376,29,71,0.408,3,14,0.214,11,15,0.733,78,33,76,0.434,26,59,0.441,7,17,0.412,24,28,0.857,97
2427,WAS,2015-11-27,78,@,BOS,0,240,27,84,0.321,22,66,0.333,5,18,0.278,19,22,0.864,78,42,97,0.433,30,64,0.469,12,33,0.364,15,19,0.789,111
2428,NYK,2015-11-23,78,@,MIA,0,240,28,87,0.322,24,63,0.381,4,24,0.167,18,21,0.857,78,31,81,0.383,26,62,0.419,5,19,0.263,28,36,0.778,95
2429,DEN,2015-10-30,78,,MIN,0,240,29,95,0.305,24,70,0.343,5,25,0.2,15,20,0.75,78,30,71,0.423,28,60,0.467,2,11,0.182,33,41,0.805,95
2430,LAL,2016-03-04,77,,ATL,0,240,29,85,0.341,24,58,0.414,5,27,0.185,14,20,0.7,77,37,68,0.544,24,40,0.6,13,28,0.464,19,26,0.731,106
2431,HOU,2016-01-15,77,,CLE,0,240,26,74,0.351,20,49,0.408,6,25,0.24,19,29,0.655,77,34,87,0.391,26,52,0.5,8,35,0.229,15,23,0.652,91
2432,CHI,2016-01-15,77,,DAL,0,240,31,86,0.36,29,67,0.433,2,19,0.105,13,15,0.867,77,30,77,0.39,22,55,0.4,8,22,0.364,15,17,0.882,83
2433,BRK,2016-01-08,77,,ORL,0,240,29,73,0.397,22,51,0.431,7,22,0.318,12,20,0.6,77,33,83,0.398,20,55,0.364,13,28,0.464,4,6,0.667,83
2434,PHO,2016-01-03,77,@,LAL,0,240,32,89,0.36,26,62,0.419,6,27,0.222,7,9,0.778,77,38,84,0.452,30,62,0.484,8,22,0.364,13,17,0.765,97
2435,BOS,2015-12-15,77,,CLE,0,240,28,87,0.322,19,55,0.345,9,32,0.281,12,14,0.857,77,36,78,0.462,28,55,0.509,8,23,0.348,9,10,0.9,89
2436,LAL,2015-11-24,77,@,GSW,0,240,31,83,0.373,28,62,0.452,3,21,0.143,12,16,0.75,77,45,92,0.489,33,57,0.579,12,35,0.343,9,15,0.6,111
2437,CHO,2016-02-28,76,@,ATL,0,240,27,81,0.333,20,49,0.408,7,32,0.219,15,23,0.652,76,38,77,0.494,30,60,0.5,8,17,0.471,3,5,0.6,87
2438,CLE,2015-12-26,76,@,POR,0,240,28,77,0.364,17,46,0.37,11,31,0.355,9,15,0.6,76,41,89,0.461,32,67,0.478,9,22,0.409,14,19,0.737,105
2439,PHI,2015-12-13,76,@,TOR,0,240,28,84,0.333,18,56,0.321,10,28,0.357,10,14,0.714,76,32,78,0.41,25,56,0.446,7,22,0.318,25,34,0.735,96
2440,ORL,2015-12-11,76,,CLE,0,240,28,72,0.389,22,50,0.44,6,22,0.273,14,20,0.7,76,41,72,0.569,30,51,0.588,11,21,0.524,18,27,0.667,111
2441,TOR,2015-11-08,76,@,MIA,0,240,28,71,0.394,25,52,0.481,3,19,0.158,17,22,0.773,76,35,83,0.422,27,63,0.429,8,20,0.4,18,25,0.72,96
2442,IND,2015-10-31,76,,UTA,0,240,28,70,0.4,24,53,0.453,4,17,0.235,16,21,0.762,76,39,88,0.443,33,73,0.452,6,15,0.4,13,18,0.722,97
2443,MEM,2015-10-28,76,,CLE,0,240,29,82,0.354,27,66,0.409,2,16,0.125,16,22,0.727,76,41,84,0.488,28,55,0.509,13,29,0.448,11,17,0.647,106
2444,LAL,2016-03-28,75,@,UTA,0,240,26,85,0.306,19,65,0.292,7,20,0.35,16,22,0.727,75,46,89,0.517,29,57,0.509,17,32,0.531,14,19,0.737,123
2445,PHI,2016-03-21,75,@,IND,0,240,31,80,0.388,27,62,0.435,4,18,0.222,9,14,0.643,75,35,81,0.432,25,55,0.455,10,26,0.385,11,13,0.846,91
2446,IND,2016-03-13,75,@,ATL,0,240,33,87,0.379,28,63,0.444,5,24,0.208,4,7,0.571,75,40,85,0.471,25,55,0.455,15,30,0.5,9,10,0.9,104
2447,WAS,2016-01-03,75,,MIA,0,240,31,91,0.341,27,61,0.443,4,30,0.133,9,13,0.692,75,39,86,0.453,30,63,0.476,9,23,0.391,10,12,0.833,97
2448,BRK,2015-10-30,75,@,SAS,0,240,31,77,0.403,26,61,0.426,5,16,0.313,8,15,0.533,75,40,86,0.465,31,64,0.484,9,22,0.409,13,13,1.0,102
2449,MIA,2016-01-17,74,@,OKC,0,240,30,72,0.417,26,58,0.448,4,14,0.286,10,11,0.909,74,40,88,0.455,33,66,0.5,7,22,0.318,12,12,1.0,99
2450,LAL,2016-01-10,74,,UTA,0,240,29,89,0.326,26,68,0.382,3,21,0.143,13,15,0.867,74,31,69,0.449,26,53,0.491,5,16,0.313,19,25,0.76,86
2451,MIN,2016-01-06,74,,DEN,0,240,28,73,0.384,25,62,0.403,3,11,0.273,15,20,0.75,74,29,81,0.358,21,61,0.344,8,20,0.4,12,17,0.706,78
2452,BRK,2016-01-06,74,,TOR,0,240,31,78,0.397,26,62,0.419,5,16,0.313,7,12,0.583,74,35,80,0.438,31,58,0.534,4,22,0.182,17,18,0.944,91
2453,DEN,2015-12-08,74,,ORL,0,240,28,84,0.333,21,60,0.35,7,24,0.292,11,20,0.55,74,38,88,0.432,37,72,0.514,1,16,0.063,8,10,0.8,85
2454,DEN,2015-11-30,74,@,MIL,0,240,28,75,0.373,22,56,0.393,6,19,0.316,12,16,0.75,74,35,77,0.455,29,59,0.492,6,18,0.333,16,22,0.727,92
2455,CHO,2016-01-27,73,@,UTA,0,240,25,68,0.368,19,43,0.442,6,25,0.24,17,21,0.81,73,40,81,0.494,28,50,0.56,12,31,0.387,10,15,0.667,102
2456,PHI,2015-10-30,71,,UTA,0,240,19,63,0.302,13,48,0.271,6,15,0.4,27,37,0.73,71,36,88,0.409,29,75,0.387,7,13,0.538,20,25,0.8,99
2457,MIL,2015-12-02,70,@,SAS,0,240,26,78,0.333,23,64,0.359,3,14,0.214,15,18,0.833,70,37,90,0.411,30,69,0.435,7,21,0.333,14,20,0.7,95
2458,PHO,2016-03-17,69,@,UTA,0,240,28,82,0.341,22,56,0.393,6,26,0.231,7,14,0.5,69,43,88,0.489,32,63,0.508,11,25,0.44,6,9,0.667,103
2459,MEM,2015-11-02,69,@,GSW,0,240,26,96,0.271,23,73,0.315,3,23,0.13,14,20,0.7,69,43,84,0.512,32,59,0.542,11,25,0.44,22,30,0.733,119
2460,PHI,2015-12-07,68,,SAS,0,240,26,75,0.347,22,51,0.431,4,24,0.167,12,21,0.571,68,47,76,0.618,43,65,0.662,4,11,0.364,21,25,0.84,119
