Rk,Team,Date,PTS,Unnamed: 4,Opp,Result,MP,FG,FGA,FG%,2P,2PA,2P%,3P,3PA,3P%,FT,FTA,FT%,PTS.1,FG.1,FGA.1,FG%.1,2P.1,2PA.1,2P%.1,3P.1,3PA.1,3P%.1,FT.1,FTA.1,FT%.1,PTS.2
1,CHI,2019-03-01,168,@,ATL,1,340,56,119,0.471,35,71,0.493,21,48,0.438,35,48,0.729,168,61,123,0.496,39,63,0.619,22,60,0.367,17,25,0.68,161
2,ATL,2019-03-01,161,,CHI,0,340,61,123,0.496,39,63,0.619,22,60,0.367,17,25,0.68,161,56,119,0.471,35,71,0.493,21,48,0.438,35,48,0.729,168
3,SAS,2019-01-10,154,,OKC,1,290,56,99,0.566,40,80,0.5,16,19,0.842,26,29,0.897,154,58,114,0.509,43,79,0.544,15,35,0.429,16,24,0.667,147
4,HOU,2019-04-07,149,,PHO,1,240,53,100,0.53,26,43,0.605,27,57,0.474,16,21,0.762,149,43,93,0.462,32,59,0.542,11,34,0.324,16,21,0.762,113
5,ORL,2019-04-05,149,,ATL,1,240,56,92,0.609,38,55,0.691,18,37,0.486,19,25,0.76,149,41,94,0.436,31,55,0.564,10,39,0.256,21,31,0.677,113
6,PHI,2019-01-15,149,,MIN,1,240,55,92,0.598,34,49,0.694,21,43,0.488,18,21,0.857,149,35,90,0.389,27,67,0.403,8,23,0.348,29,35,0.829,107
7,WAS,2018-12-22,149,,PHO,1,315,56,111,0.505,43,75,0.573,13,36,0.361,24,27,0.889,149,55,115,0.478,44,80,0.55,11,35,0.314,25,33,0.758,146
8,GSW,2018-10-29,149,@,CHI,1,240,53,96,0.552,29,51,0.569,24,45,0.533,19,26,0.731,149,46,94,0.489,35,59,0.593,11,35,0.314,21,34,0.618,124
9,NOP,2018-10-19,149,,SAC,1,240,56,95,0.589,40,64,0.625,16,31,0.516,21,33,0.636,149,50,96,0.521,40,71,0.563,10,25,0.4,19,26,0.731,129
10,POR,2019-03-25,148,,BRK,1,290,53,121,0.438,39,76,0.513,14,45,0.311,28,36,0.778,148,49,103,0.476,34,61,0.557,15,42,0.357,31,44,0.705,144
11,OKC,2019-02-22,148,,UTA,1,290,55,118,0.466,37,74,0.5,18,44,0.409,20,25,0.8,148,52,105,0.495,34,65,0.523,18,40,0.45,25,31,0.806,147
12,BRK,2019-02-13,148,@,CLE,1,315,52,113,0.46,34,68,0.5,18,45,0.4,26,34,0.765,148,54,120,0.45,36,78,0.462,18,42,0.429,13,18,0.722,139
13,MIL,2019-02-06,148,,WAS,1,240,56,93,0.602,37,63,0.587,19,30,0.633,17,26,0.654,148,48,92,0.522,31,55,0.564,17,37,0.459,16,19,0.842,129
14,UTA,2019-02-22,147,@,OKC,0,290,52,105,0.495,34,65,0.523,18,40,0.45,25,31,0.806,147,55,118,0.466,37,74,0.5,18,44,0.409,20,25,0.8,148
15,GSW,2019-01-16,147,,NOP,1,240,49,102,0.48,25,53,0.472,24,49,0.49,25,31,0.806,147,47,98,0.48,28,61,0.459,19,37,0.514,27,33,0.818,140
16,OKC,2019-01-10,147,@,SAS,0,290,58,114,0.509,43,79,0.544,15,35,0.429,16,24,0.667,147,56,99,0.566,40,80,0.5,16,19,0.842,26,29,0.897,154
17,GSW,2019-01-11,146,,CHI,1,240,53,92,0.576,35,53,0.66,18,39,0.462,22,26,0.846,146,35,78,0.449,26,58,0.448,9,20,0.45,30,34,0.882,109
18,PHO,2018-12-22,146,@,WAS,0,315,55,115,0.478,44,80,0.55,11,35,0.314,25,33,0.758,146,56,111,0.505,43,75,0.573,13,36,0.361,24,27,0.889,149
19,SAC,2018-11-01,146,@,ATL,1,240,53,98,0.541,39,63,0.619,14,35,0.4,26,32,0.813,146,42,87,0.483,34,56,0.607,8,31,0.258,23,34,0.676,115
20,BRK,2019-01-16,145,@,HOU,1,265,56,108,0.519,40,72,0.556,16,36,0.444,17,22,0.773,145,45,105,0.429,22,35,0.629,23,70,0.329,29,34,0.853,142
21,BRK,2019-03-25,144,@,POR,0,290,49,103,0.476,34,61,0.557,15,42,0.357,31,44,0.705,144,53,121,0.438,39,76,0.513,14,45,0.311,28,36,0.778,148
22,MIL,2019-01-04,144,,ATL,1,240,55,100,0.55,41,60,0.683,14,40,0.35,20,28,0.714,144,37,85,0.435,23,44,0.523,14,41,0.341,24,35,0.686,112
23,BRK,2018-12-16,144,,ATL,1,240,49,88,0.557,33,48,0.688,16,40,0.4,30,33,0.909,144,47,85,0.553,33,56,0.589,14,29,0.483,19,25,0.76,127
24,MIL,2018-11-04,144,,SAC,1,240,46,95,0.484,24,39,0.615,22,56,0.393,30,33,0.909,144,42,95,0.442,28,59,0.475,14,36,0.389,11,22,0.5,109
25,GSW,2018-10-24,144,,WAS,1,240,53,92,0.576,38,59,0.644,15,33,0.455,23,25,0.92,144,42,93,0.452,30,51,0.588,12,42,0.286,26,28,0.929,122
26,LAC,2019-04-10,143,,UTA,1,265,54,106,0.509,42,78,0.538,12,28,0.429,23,30,0.767,143,47,106,0.443,33,71,0.465,14,35,0.4,29,33,0.879,137
27,PHI,2019-02-10,143,,LAL,1,240,56,97,0.577,44,73,0.603,12,24,0.5,19,22,0.864,143,48,93,0.516,38,66,0.576,10,27,0.37,14,19,0.737,120
28,MIL,2018-11-21,143,,POR,1,240,57,108,0.528,42,63,0.667,15,45,0.333,14,17,0.824,143,34,93,0.366,25,52,0.481,9,41,0.22,23,28,0.821,100
29,SAS,2018-10-22,143,@,LAL,1,265,50,97,0.515,35,69,0.507,15,28,0.536,28,38,0.737,143,55,107,0.514,41,68,0.603,14,39,0.359,18,26,0.692,142
30,HOU,2019-01-16,142,,BRK,0,265,45,105,0.429,22,35,0.629,23,70,0.329,29,34,0.853,142,56,108,0.519,40,72,0.556,16,36,0.444,17,22,0.773,145
31,ATL,2019-01-15,142,,OKC,1,240,56,90,0.622,38,53,0.717,18,37,0.486,12,16,0.75,142,43,94,0.457,34,62,0.548,9,32,0.281,31,41,0.756,126
32,GSW,2019-01-15,142,@,DEN,1,240,57,95,0.6,36,56,0.643,21,39,0.538,7,10,0.7,142,42,92,0.457,28,58,0.483,14,34,0.412,13,16,0.813,111
33,LAL,2018-10-22,142,,SAS,0,265,55,107,0.514,41,68,0.603,14,39,0.359,18,26,0.692,142,50,97,0.515,35,69,0.507,15,28,0.536,28,38,0.737,143
34,MIL,2019-02-27,141,@,SAC,1,265,54,112,0.482,37,67,0.552,17,45,0.378,16,21,0.762,141,53,118,0.449,41,85,0.482,12,33,0.364,22,30,0.733,140
35,GSW,2019-02-06,141,,SAS,1,240,55,95,0.579,39,61,0.639,16,34,0.471,15,21,0.714,141,35,81,0.432,23,49,0.469,12,32,0.375,20,21,0.952,102
36,HOU,2019-01-11,141,,CLE,1,240,46,89,0.517,26,37,0.703,20,52,0.385,29,32,0.906,141,40,89,0.449,31,56,0.554,9,33,0.273,24,26,0.923,113
37,SAC,2018-12-12,141,,MIN,1,240,50,86,0.581,31,48,0.646,19,38,0.5,22,32,0.688,141,50,93,0.538,41,71,0.577,9,22,0.409,21,27,0.778,130
38,LAC,2019-03-11,140,,BOS,1,240,53,86,0.616,40,58,0.69,13,28,0.464,21,25,0.84,140,44,91,0.484,30,55,0.545,14,36,0.389,13,19,0.684,115
39,SAC,2019-02-27,140,,MIL,0,265,53,118,0.449,41,85,0.482,12,33,0.364,22,30,0.733,140,54,112,0.482,37,67,0.552,17,45,0.378,16,21,0.762,141
40,MIL,2019-02-23,140,,MIN,1,240,50,95,0.526,31,52,0.596,19,43,0.442,21,22,0.955,140,50,102,0.49,38,76,0.5,12,26,0.462,16,20,0.8,128
41,NOP,2019-01-16,140,@,GSW,0,240,47,98,0.48,28,61,0.459,19,37,0.514,27,33,0.818,140,49,102,0.48,25,53,0.472,24,49,0.49,25,31,0.806,147
42,TOR,2019-01-13,140,@,WAS,1,290,49,104,0.471,36,68,0.529,13,36,0.361,29,36,0.806,140,54,118,0.458,35,74,0.473,19,44,0.432,11,18,0.611,138
43,NOP,2019-01-09,140,,CLE,1,240,46,84,0.548,34,55,0.618,12,29,0.414,36,39,0.923,140,42,88,0.477,28,58,0.483,14,30,0.467,26,30,0.867,124
44,NOP,2018-11-19,140,,SAS,1,240,59,102,0.578,49,76,0.645,10,26,0.385,12,14,0.857,140,45,94,0.479,33,70,0.471,12,24,0.5,24,30,0.8,126
45,DAL,2018-10-20,140,,MIN,1,240,49,98,0.5,32,48,0.667,17,50,0.34,25,34,0.735,140,44,84,0.524,30,57,0.526,14,27,0.519,34,40,0.85,136
46,CLE,2019-02-13,139,,BRK,0,315,54,120,0.45,36,78,0.462,18,42,0.429,13,18,0.722,139,52,113,0.46,34,68,0.5,18,45,0.4,26,34,0.765,148
47,UTA,2018-12-04,139,,SAS,1,240,51,84,0.607,31,51,0.608,20,33,0.606,17,20,0.85,139,44,90,0.489,37,68,0.544,7,22,0.318,10,11,0.909,105
48,PHO,2019-03-16,138,@,NOP,1,265,51,100,0.51,42,71,0.592,9,29,0.31,27,36,0.75,138,47,102,0.461,32,72,0.444,15,30,0.5,27,41,0.659,136
49,HOU,2019-01-19,138,,LAL,1,265,42,100,0.42,17,32,0.531,25,68,0.368,29,36,0.806,138,50,96,0.521,40,59,0.678,10,37,0.27,24,30,0.8,134
50,LAL,2019-01-17,138,@,OKC,1,265,50,99,0.505,31,59,0.525,19,40,0.475,19,21,0.905,138,41,104,0.394,19,50,0.38,22,54,0.407,24,36,0.667,128
51,WAS,2019-01-13,138,,TOR,0,290,54,118,0.458,35,74,0.473,19,44,0.432,11,18,0.611,138,49,104,0.471,36,68,0.529,13,36,0.361,29,36,0.806,140
52,DEN,2018-11-15,138,,ATL,1,240,53,94,0.564,40,63,0.635,13,31,0.419,19,25,0.76,138,32,92,0.348,23,50,0.46,9,42,0.214,20,27,0.741,93
53,UTA,2019-04-10,137,@,LAC,0,265,47,106,0.443,33,71,0.465,14,35,0.4,29,33,0.879,137,54,106,0.509,42,78,0.538,12,28,0.429,23,30,0.767,143
54,GSW,2019-03-31,137,,CHO,1,240,53,88,0.602,32,55,0.582,21,33,0.636,10,12,0.833,137,30,85,0.353,22,53,0.415,8,32,0.25,22,25,0.88,90
55,UTA,2019-03-20,137,@,NYK,1,240,48,85,0.565,28,43,0.651,20,42,0.476,21,25,0.84,137,45,86,0.523,32,55,0.582,13,31,0.419,13,21,0.619,116
56,ATL,2019-02-04,137,@,WAS,1,240,46,91,0.505,26,51,0.51,20,40,0.5,25,29,0.862,137,48,97,0.495,36,59,0.61,12,38,0.316,21,29,0.724,129
57,POR,2019-04-10,136,,SAC,1,240,53,91,0.582,39,67,0.582,14,24,0.583,16,22,0.727,136,50,96,0.521,32,53,0.604,18,43,0.419,13,16,0.813,131
58,ATL,2019-03-31,136,,MIL,1,265,52,118,0.441,30,57,0.526,22,61,0.361,10,17,0.588,136,48,116,0.414,31,61,0.508,17,55,0.309,22,23,0.957,135
59,NOP,2019-03-16,136,,PHO,0,265,47,102,0.461,32,72,0.444,15,30,0.5,27,41,0.659,136,51,100,0.51,42,71,0.592,9,29,0.31,27,36,0.75,138
60,IND,2019-02-05,136,,LAL,1,240,56,98,0.571,37,64,0.578,19,34,0.559,5,8,0.625,136,35,75,0.467,31,54,0.574,4,21,0.19,20,26,0.769,94
61,DEN,2019-02-01,136,,HOU,1,240,51,82,0.622,37,51,0.725,14,31,0.452,20,23,0.87,136,45,85,0.529,29,41,0.707,16,44,0.364,16,21,0.762,122
62,HOU,2018-12-19,136,,WAS,1,240,47,85,0.553,21,30,0.7,26,55,0.473,16,21,0.762,136,45,84,0.536,35,54,0.648,10,30,0.333,18,23,0.783,118
63,NYK,2018-12-01,136,,MIL,1,265,51,96,0.531,31,62,0.5,20,34,0.588,14,21,0.667,136,46,94,0.489,28,52,0.538,18,42,0.429,24,31,0.774,134
64,HOU,2018-11-30,136,@,SAS,1,240,49,98,0.5,27,44,0.614,22,54,0.407,16,20,0.8,136,39,86,0.453,29,58,0.5,10,28,0.357,17,20,0.85,105
65,CLE,2018-10-30,136,,ATL,1,240,45,90,0.5,32,65,0.492,13,25,0.52,33,43,0.767,136,44,82,0.537,29,47,0.617,15,35,0.429,11,17,0.647,114
66,LAC,2018-10-28,136,,WAS,1,240,56,103,0.544,40,74,0.541,16,29,0.552,8,13,0.615,136,38,97,0.392,33,70,0.471,5,27,0.185,23,28,0.821,104
67,MIN,2018-10-20,136,@,DAL,0,240,44,84,0.524,30,57,0.526,14,27,0.519,34,40,0.85,136,49,98,0.5,32,48,0.667,17,50,0.34,25,34,0.735,140
68,IND,2019-04-10,135,@,ATL,1,240,45,98,0.459,33,68,0.485,12,30,0.4,33,39,0.846,135,43,103,0.417,26,62,0.419,17,41,0.415,31,38,0.816,134
69,HOU,2019-04-03,135,@,LAC,1,240,47,88,0.534,29,50,0.58,18,38,0.474,23,29,0.793,135,38,82,0.463,30,56,0.536,8,26,0.308,19,31,0.613,103
70,MIL,2019-03-31,135,@,ATL,0,265,48,116,0.414,31,61,0.508,17,55,0.309,22,23,0.957,135,52,118,0.441,30,57,0.526,22,61,0.361,10,17,0.588,136
71,WAS,2019-03-16,135,,MEM,1,240,41,81,0.506,24,46,0.522,17,35,0.486,36,43,0.837,135,48,90,0.533,36,57,0.632,12,33,0.364,20,26,0.769,128
72,MIN,2019-03-09,135,,WAS,1,265,51,114,0.447,39,78,0.5,12,36,0.333,21,24,0.875,135,48,100,0.48,32,56,0.571,16,44,0.364,18,24,0.75,130
73,WAS,2019-03-03,135,,MIN,1,240,49,98,0.5,38,65,0.585,11,33,0.333,26,32,0.813,135,52,99,0.525,48,72,0.667,4,27,0.148,13,19,0.684,121
74,BRK,2019-02-06,135,,DEN,1,240,46,90,0.511,27,56,0.482,19,34,0.559,24,33,0.727,135,50,99,0.505,37,64,0.578,13,35,0.371,17,21,0.81,130
75,SAC,2019-01-30,135,,ATL,1,240,54,99,0.545,43,64,0.672,11,35,0.314,16,21,0.762,135,38,86,0.442,22,40,0.55,16,46,0.348,21,25,0.84,113
76,CHO,2019-01-19,135,,PHO,1,240,48,88,0.545,32,54,0.593,16,34,0.471,23,27,0.852,135,39,87,0.448,28,54,0.519,11,33,0.333,26,33,0.788,115
77,DEN,2019-01-17,135,,CHI,1,240,50,96,0.521,30,56,0.536,20,40,0.5,15,20,0.75,135,44,93,0.473,34,65,0.523,10,28,0.357,7,11,0.636,105
78,BOS,2019-01-09,135,,IND,1,240,50,88,0.568,36,56,0.643,14,32,0.438,21,24,0.875,135,39,91,0.429,30,63,0.476,9,28,0.321,21,33,0.636,108
79,HOU,2019-01-03,135,@,GSW,1,265,45,99,0.455,24,45,0.533,21,54,0.389,24,28,0.857,135,53,102,0.52,39,65,0.6,14,37,0.378,14,15,0.933,134
80,WAS,2018-11-26,135,,HOU,1,265,50,89,0.562,39,60,0.65,11,29,0.379,24,32,0.75,135,46,97,0.474,28,49,0.571,18,48,0.375,21,27,0.778,131
81,MIL,2018-11-24,135,,SAS,1,240,49,86,0.57,34,46,0.739,15,40,0.375,22,29,0.759,135,49,92,0.533,39,71,0.549,10,21,0.476,21,28,0.75,129
82,CHO,2018-10-26,135,,CHI,1,240,53,93,0.57,39,61,0.639,14,32,0.438,15,16,0.938,135,37,85,0.435,21,49,0.429,16,36,0.444,16,22,0.727,106
83,ATL,2019-04-10,134,,IND,0,240,43,103,0.417,26,62,0.419,17,41,0.415,31,38,0.816,134,45,98,0.459,33,68,0.485,12,30,0.4,33,39,0.846,135
84,LAC,2019-02-13,134,,PHO,1,240,50,84,0.595,39,62,0.629,11,22,0.5,23,30,0.767,134,40,86,0.465,32,56,0.571,8,30,0.267,19,25,0.76,107
85,WAS,2019-02-09,134,@,CHI,1,240,55,95,0.579,43,68,0.632,12,27,0.444,12,14,0.857,134,49,97,0.505,43,74,0.581,6,23,0.261,21,28,0.75,125
86,BOS,2019-02-03,134,,OKC,1,240,54,91,0.593,41,57,0.719,13,34,0.382,13,17,0.765,134,45,92,0.489,31,57,0.544,14,35,0.4,25,34,0.735,129
87,LAL,2019-01-19,134,@,HOU,0,265,50,96,0.521,40,59,0.678,10,37,0.27,24,30,0.8,134,42,100,0.42,17,32,0.531,25,68,0.368,29,36,0.806,138
88,GSW,2019-01-03,134,,HOU,0,265,53,102,0.52,39,65,0.6,14,37,0.378,14,15,0.933,134,45,99,0.455,24,45,0.533,21,54,0.389,24,28,0.857,135
89,BRK,2018-12-26,134,,CHO,1,290,51,104,0.49,32,57,0.561,19,47,0.404,13,18,0.722,134,47,106,0.443,32,75,0.427,15,31,0.484,23,30,0.767,132
90,MIL,2018-12-01,134,@,NYK,0,265,46,94,0.489,28,52,0.538,18,42,0.429,24,31,0.774,134,51,96,0.531,31,62,0.5,20,34,0.588,14,21,0.667,136
91,MIL,2018-11-08,134,@,GSW,1,240,52,101,0.515,43,66,0.652,9,35,0.257,21,27,0.778,134,42,87,0.483,32,59,0.542,10,28,0.357,17,22,0.773,111
92,OKC,2018-11-02,134,@,WAS,1,240,49,86,0.57,34,54,0.63,15,32,0.469,21,26,0.808,134,44,86,0.512,35,56,0.625,9,30,0.3,14,18,0.778,111
93,NOP,2019-04-07,133,@,SAC,1,240,52,101,0.515,33,59,0.559,19,42,0.452,10,12,0.833,133,50,109,0.459,34,69,0.493,16,40,0.4,13,17,0.765,129
94,BRK,2019-04-06,133,@,MIL,1,240,48,97,0.495,29,52,0.558,19,45,0.422,18,23,0.783,133,49,88,0.557,33,54,0.611,16,34,0.471,14,21,0.667,128
95,PHO,2019-04-05,133,,NOP,1,265,51,104,0.49,37,68,0.544,14,36,0.389,17,21,0.81,133,49,101,0.485,41,78,0.526,8,23,0.348,20,27,0.741,126
96,DEN,2019-03-12,133,,MIN,1,240,51,85,0.6,33,55,0.6,18,30,0.6,13,15,0.867,133,41,89,0.461,30,59,0.508,11,30,0.367,14,14,1.0,107
97,MIL,2019-01-13,133,@,ATL,1,240,49,92,0.533,38,62,0.613,11,30,0.367,24,33,0.727,133,39,96,0.406,27,58,0.466,12,38,0.316,24,30,0.8,114
98,NOP,2019-01-05,133,@,CLE,1,240,47,81,0.58,33,54,0.611,14,27,0.519,25,29,0.862,133,36,88,0.409,24,55,0.436,12,33,0.364,14,18,0.778,98
99,BOS,2018-12-08,133,@,CHI,1,240,50,93,0.538,28,50,0.56,22,43,0.512,11,15,0.733,133,31,81,0.383,25,57,0.439,6,24,0.25,9,14,0.643,77
100,SAS,2018-12-07,133,,LAL,1,240,46,91,0.505,33,60,0.55,13,31,0.419,28,33,0.848,133,46,100,0.46,35,64,0.547,11,36,0.306,17,21,0.81,120
101,LAC,2018-11-29,133,@,SAC,1,240,50,90,0.556,38,62,0.613,12,28,0.429,21,28,0.75,133,46,96,0.479,39,72,0.542,7,24,0.292,22,26,0.846,121
102,UTA,2018-11-25,133,@,SAC,1,240,49,92,0.533,39,62,0.629,10,30,0.333,25,33,0.758,133,40,85,0.471,31,62,0.5,9,23,0.391,23,31,0.742,112
103,PHI,2018-11-09,133,,CHO,1,265,45,94,0.479,33,57,0.579,12,37,0.324,31,41,0.756,133,43,110,0.391,27,70,0.386,16,40,0.4,30,40,0.75,132
104,LAC,2018-10-26,133,@,HOU,1,240,43,79,0.544,31,56,0.554,12,23,0.522,35,38,0.921,133,38,98,0.388,23,57,0.404,15,41,0.366,22,25,0.88,113
105,DET,2018-10-23,133,,PHI,1,265,51,108,0.472,39,75,0.52,12,33,0.364,19,27,0.704,133,49,98,0.5,35,55,0.636,14,43,0.326,20,28,0.714,132
106,ATL,2018-10-21,133,@,CLE,1,240,48,98,0.49,26,51,0.51,22,47,0.468,15,19,0.789,133,46,99,0.465,36,72,0.5,10,27,0.37,9,14,0.643,111
107,MEM,2019-04-10,132,,GSW,1,240,48,98,0.49,27,52,0.519,21,46,0.457,15,18,0.833,132,46,92,0.5,33,62,0.532,13,30,0.433,12,14,0.857,117
108,OKC,2019-04-07,132,@,MIN,1,240,48,92,0.522,34,58,0.586,14,34,0.412,22,26,0.846,132,46,85,0.541,36,62,0.581,10,23,0.435,24,29,0.828,126
109,POR,2019-04-01,132,@,MIN,1,240,50,91,0.549,35,61,0.574,15,30,0.5,17,24,0.708,132,47,96,0.49,36,67,0.537,11,29,0.379,17,19,0.895,122
110,LAC,2019-03-30,132,,CLE,1,240,53,85,0.624,38,52,0.731,15,33,0.455,11,16,0.688,132,41,92,0.446,38,69,0.551,3,23,0.13,23,28,0.821,108
111,ATL,2019-03-13,132,,MEM,1,240,52,103,0.505,35,58,0.603,17,45,0.378,11,14,0.786,132,38,89,0.427,24,49,0.49,14,40,0.35,21,26,0.808,111
112,WAS,2019-03-06,132,,DAL,1,240,50,93,0.538,38,60,0.633,12,33,0.364,20,25,0.8,132,45,93,0.484,30,52,0.577,15,41,0.366,18,28,0.643,123
113,OKC,2019-02-05,132,,ORL,1,240,46,92,0.5,33,62,0.532,13,30,0.433,27,37,0.73,132,42,90,0.467,31,53,0.585,11,37,0.297,27,34,0.794,122
114,POR,2019-01-30,132,,UTA,1,240,48,90,0.533,32,58,0.552,16,32,0.5,20,23,0.87,132,38,85,0.447,27,51,0.529,11,34,0.324,18,21,0.857,105
115,GSW,2019-01-28,132,@,IND,1,240,53,98,0.541,40,67,0.597,13,31,0.419,13,16,0.813,132,40,94,0.426,28,64,0.438,12,30,0.4,8,10,0.8,100
116,SAS,2019-01-27,132,,WAS,1,240,49,86,0.57,33,52,0.635,16,34,0.471,18,21,0.857,132,40,89,0.449,22,43,0.512,18,46,0.391,21,29,0.724,119
117,DEN,2019-01-25,132,,PHO,1,240,47,94,0.5,32,58,0.552,15,36,0.417,23,29,0.793,132,32,76,0.421,25,46,0.543,7,30,0.233,24,26,0.923,95
118,PHI,2019-01-08,132,,WAS,1,240,49,88,0.557,32,55,0.582,17,33,0.515,17,25,0.68,132,42,84,0.5,28,52,0.538,14,32,0.438,17,21,0.81,115
119,PHI,2019-01-02,132,@,PHO,1,240,40,74,0.541,29,50,0.58,11,24,0.458,41,54,0.759,132,43,95,0.453,32,61,0.525,11,34,0.324,30,36,0.833,127
120,GSW,2018-12-31,132,@,PHO,1,240,46,84,0.548,32,56,0.571,14,28,0.5,26,32,0.813,132,37,85,0.435,28,59,0.475,9,26,0.346,26,30,0.867,109
121,CHO,2018-12-26,132,@,BRK,0,290,47,106,0.443,32,75,0.427,15,31,0.484,23,30,0.767,132,51,104,0.49,32,57,0.561,19,47,0.404,13,18,0.722,134
122,LAC,2018-12-22,132,,DEN,1,240,53,92,0.576,43,72,0.597,10,20,0.5,16,17,0.941,132,41,97,0.423,32,66,0.485,9,31,0.29,20,25,0.8,111
123,OKC,2018-12-19,132,@,SAC,1,240,51,102,0.5,38,70,0.543,13,32,0.406,17,27,0.63,132,39,93,0.419,26,59,0.441,13,34,0.382,22,33,0.667,113
124,MIN,2018-12-17,132,,SAC,1,240,48,96,0.5,38,69,0.551,10,27,0.37,26,30,0.867,132,38,90,0.422,24,52,0.462,14,38,0.368,15,23,0.652,105
125,NOP,2018-12-05,132,,DAL,1,240,51,92,0.554,34,63,0.54,17,29,0.586,13,20,0.65,132,39,91,0.429,25,45,0.556,14,46,0.304,14,21,0.667,106
126,HOU,2018-11-17,132,,SAC,1,240,46,81,0.568,26,34,0.765,20,47,0.426,20,24,0.833,132,46,102,0.451,35,67,0.522,11,35,0.314,9,12,0.75,112
127,CHO,2018-11-09,132,@,PHI,0,265,43,110,0.391,27,70,0.386,16,40,0.4,30,40,0.75,132,45,94,0.479,33,57,0.579,12,37,0.324,31,41,0.756,133
128,POR,2018-11-01,132,,NOP,1,240,44,87,0.506,26,52,0.5,18,35,0.514,26,31,0.839,132,40,94,0.426,32,65,0.492,8,29,0.276,31,37,0.838,119
129,UTA,2018-10-27,132,@,NOP,1,240,46,88,0.523,36,56,0.643,10,32,0.313,30,37,0.811,132,40,95,0.421,31,61,0.508,9,34,0.265,22,29,0.759,111
130,PHI,2018-10-23,132,@,DET,0,265,49,98,0.5,35,55,0.636,14,43,0.326,20,28,0.714,132,51,108,0.472,39,75,0.52,12,33,0.364,19,27,0.704,133
131,IND,2018-10-20,132,,BRK,1,240,51,92,0.554,35,68,0.515,16,24,0.667,14,22,0.636,132,41,86,0.477,25,49,0.51,16,37,0.432,14,22,0.636,112
132,SAC,2019-04-10,131,@,POR,0,240,50,96,0.521,32,53,0.604,18,43,0.419,13,16,0.813,131,53,91,0.582,39,67,0.582,14,24,0.583,16,22,0.727,136
133,GSW,2019-04-07,131,,LAC,1,240,53,97,0.546,41,60,0.683,12,37,0.324,13,15,0.867,131,38,79,0.481,28,60,0.467,10,19,0.526,18,29,0.621,104
134,MIL,2019-04-01,131,@,BRK,1,240,47,94,0.5,36,60,0.6,11,34,0.324,26,30,0.867,131,39,94,0.415,23,50,0.46,16,44,0.364,27,34,0.794,121
135,MIN,2019-03-29,131,,GSW,1,265,45,103,0.437,31,65,0.477,14,38,0.368,27,34,0.794,131,46,98,0.469,28,58,0.483,18,40,0.45,20,28,0.714,130
136,DET,2019-03-10,131,,CHI,1,240,49,91,0.538,30,56,0.536,19,35,0.543,14,22,0.636,131,41,82,0.5,32,64,0.5,9,18,0.5,17,26,0.654,108
137,MIL,2019-03-09,131,,CHO,1,240,44,90,0.489,27,46,0.587,17,44,0.386,26,30,0.867,131,44,93,0.473,29,54,0.537,15,39,0.385,11,14,0.786,114
138,DET,2019-03-06,131,,MIN,1,240,50,93,0.538,36,60,0.6,14,33,0.424,17,22,0.773,131,41,84,0.488,29,57,0.509,12,27,0.444,20,21,0.952,114
139,MIN,2019-03-05,131,,OKC,1,240,47,89,0.528,36,67,0.537,11,22,0.5,26,35,0.743,131,42,94,0.447,24,48,0.5,18,46,0.391,18,31,0.581,120
140,MIL,2019-03-01,131,@,LAL,1,240,48,93,0.516,34,53,0.642,14,40,0.35,21,24,0.875,131,46,96,0.479,33,56,0.589,13,40,0.325,15,18,0.833,120
141,ATL,2019-02-27,131,,MIN,1,265,46,108,0.426,34,79,0.43,12,29,0.414,27,32,0.844,131,44,102,0.431,32,64,0.5,12,38,0.316,23,33,0.697,123
142,NOP,2019-02-14,131,,OKC,1,240,50,92,0.543,38,66,0.576,12,26,0.462,19,24,0.792,131,50,106,0.472,40,62,0.645,10,44,0.227,12,13,0.923,122
143,MIL,2019-02-02,131,@,WAS,1,240,45,91,0.495,28,52,0.538,17,39,0.436,24,24,1.0,131,43,93,0.462,33,60,0.55,10,33,0.303,19,26,0.731,115
144,IND,2019-01-15,131,,PHO,1,240,46,89,0.517,34,64,0.531,12,25,0.48,27,36,0.75,131,40,95,0.421,32,68,0.471,8,27,0.296,9,18,0.5,97
145,PHI,2018-12-19,131,,NYK,1,240,47,88,0.534,32,58,0.552,15,30,0.5,22,25,0.88,131,37,86,0.43,27,55,0.491,10,31,0.323,25,31,0.806,109
146,POR,2018-12-17,131,@,LAC,1,240,47,86,0.547,37,66,0.561,10,20,0.5,27,31,0.871,131,42,83,0.506,32,56,0.571,10,27,0.37,33,39,0.846,127
147,WAS,2018-12-05,131,@,ATL,1,240,46,95,0.484,34,57,0.596,12,38,0.316,27,32,0.844,131,41,92,0.446,29,54,0.537,12,38,0.316,23,31,0.742,117
148,SAS,2018-12-02,131,,POR,1,240,50,83,0.602,39,68,0.574,11,15,0.733,20,22,0.909,131,45,86,0.523,33,57,0.579,12,29,0.414,16,16,1.0,118
149,MEM,2018-11-30,131,@,BRK,1,290,50,101,0.495,38,71,0.535,12,30,0.4,19,22,0.864,131,42,94,0.447,26,50,0.52,16,44,0.364,25,30,0.833,125
150,TOR,2018-11-29,131,,GSW,1,265,47,90,0.522,32,52,0.615,15,38,0.395,22,24,0.917,131,50,103,0.485,39,73,0.534,11,30,0.367,17,20,0.85,128
151,HOU,2018-11-26,131,@,WAS,0,265,46,97,0.474,28,49,0.571,18,48,0.375,21,27,0.778,131,50,89,0.562,39,60,0.65,11,29,0.379,24,32,0.75,135
152,ORL,2018-11-18,131,,NYK,1,240,48,84,0.571,35,52,0.673,13,32,0.406,22,26,0.846,131,40,87,0.46,32,63,0.508,8,24,0.333,29,35,0.829,117
153,GSW,2018-10-31,131,,NOP,1,240,47,89,0.528,31,57,0.544,16,32,0.5,21,30,0.7,131,44,92,0.478,32,57,0.561,12,35,0.343,21,27,0.778,121
154,LAL,2018-10-24,131,@,PHO,1,240,52,100,0.52,42,72,0.583,10,28,0.357,17,23,0.739,131,44,84,0.524,34,53,0.642,10,31,0.323,15,21,0.714,113
155,SAC,2018-10-21,131,@,OKC,1,240,50,91,0.549,40,69,0.58,10,22,0.455,21,28,0.75,131,46,104,0.442,37,65,0.569,9,39,0.231,19,30,0.633,120
156,MEM,2018-10-19,131,,ATL,1,240,44,81,0.543,31,55,0.564,13,26,0.5,30,43,0.698,131,41,83,0.494,27,53,0.509,14,30,0.467,21,36,0.583,117
157,MIN,2018-10-19,131,,CLE,1,240,44,87,0.506,34,62,0.548,10,25,0.4,33,35,0.943,131,45,93,0.484,37,70,0.529,8,23,0.348,25,29,0.862,123
158,NOP,2018-10-17,131,@,HOU,1,240,52,98,0.531,42,73,0.575,10,25,0.4,17,22,0.773,131,39,92,0.424,23,44,0.523,16,48,0.333,18,24,0.75,112
159,ATL,2019-04-03,130,,PHI,1,240,48,92,0.522,36,56,0.643,12,36,0.333,22,28,0.786,130,45,98,0.459,35,67,0.522,10,31,0.323,22,38,0.579,122
160,HOU,2019-04-02,130,@,SAC,1,240,46,94,0.489,20,33,0.606,26,61,0.426,12,17,0.706,130,42,95,0.442,35,72,0.486,7,23,0.304,14,20,0.7,105
161,LAL,2019-03-31,130,@,NOP,1,240,48,101,0.475,33,63,0.524,15,38,0.395,19,22,0.864,130,38,83,0.458,30,52,0.577,8,31,0.258,18,21,0.857,102
162,GSW,2019-03-29,130,@,MIN,0,265,46,98,0.469,28,58,0.483,18,40,0.45,20,28,0.714,130,45,103,0.437,31,65,0.477,14,38,0.368,27,34,0.794,131
163,ATL,2019-03-26,130,@,NOP,1,240,44,97,0.454,25,46,0.543,19,51,0.373,23,26,0.885,130,39,83,0.47,27,49,0.551,12,34,0.353,30,40,0.75,120
164,PHI,2019-03-17,130,@,MIL,1,240,47,100,0.47,32,68,0.471,15,32,0.469,21,30,0.7,130,43,95,0.453,27,45,0.6,16,50,0.32,23,28,0.821,125
165,MIL,2019-03-12,130,@,NOP,1,240,48,97,0.495,38,61,0.623,10,36,0.278,24,28,0.857,130,46,107,0.43,36,60,0.6,10,47,0.213,11,16,0.688,113
166,WAS,2019-03-09,130,@,MIN,0,265,48,100,0.48,32,56,0.571,16,44,0.364,18,24,0.75,130,51,114,0.447,39,78,0.5,12,36,0.333,21,24,0.875,135
167,NOP,2019-03-01,130,@,PHO,1,240,50,87,0.575,34,60,0.567,16,27,0.593,14,20,0.7,130,40,94,0.426,28,60,0.467,12,34,0.353,24,28,0.857,116
168,NYK,2019-02-24,130,,SAS,1,240,50,98,0.51,34,61,0.557,16,37,0.432,14,19,0.737,130,42,94,0.447,36,70,0.514,6,24,0.25,28,31,0.903,118
169,POR,2019-02-23,130,@,PHI,1,240,49,99,0.495,44,76,0.579,5,23,0.217,27,29,0.931,130,42,87,0.483,33,63,0.524,9,24,0.375,22,28,0.786,115
170,MIN,2019-02-11,130,,LAC,1,240,47,90,0.522,41,72,0.569,6,18,0.333,30,36,0.833,130,37,72,0.514,25,43,0.581,12,29,0.414,34,39,0.872,120
171,DEN,2019-02-06,130,@,BRK,0,240,50,99,0.505,37,64,0.578,13,35,0.371,17,21,0.81,130,46,90,0.511,27,56,0.482,19,34,0.559,24,33,0.727,135
172,GSW,2019-01-21,130,@,LAL,1,240,50,98,0.51,34,61,0.557,16,37,0.432,14,19,0.737,130,42,84,0.5,37,64,0.578,5,20,0.25,22,38,0.579,111
173,WAS,2018-12-29,130,,CHO,1,240,48,93,0.516,35,56,0.625,13,37,0.351,21,24,0.875,130,47,90,0.522,34,59,0.576,13,31,0.419,19,24,0.792,126
174,GSW,2018-12-14,130,@,SAC,1,240,44,96,0.458,29,56,0.518,15,40,0.375,27,36,0.75,130,45,96,0.469,30,52,0.577,15,44,0.341,20,25,0.8,125
175,BOS,2018-12-12,130,@,WAS,1,265,47,104,0.452,36,66,0.545,11,38,0.289,25,25,1.0,130,46,91,0.505,34,58,0.586,12,33,0.364,21,29,0.724,125
176,MIN,2018-12-12,130,@,SAC,0,240,50,93,0.538,41,71,0.577,9,22,0.409,21,27,0.778,130,50,86,0.581,31,48,0.646,19,38,0.5,22,32,0.688,141
177,ORL,2018-11-17,130,,LAL,1,240,50,93,0.538,39,61,0.639,11,32,0.344,19,23,0.826,130,43,90,0.478,33,60,0.55,10,30,0.333,21,25,0.84,117
178,DAL,2019-04-07,129,@,MEM,1,265,45,98,0.459,33,57,0.579,12,41,0.293,27,34,0.794,129,42,98,0.429,23,54,0.426,19,44,0.432,24,28,0.857,127
179,SAC,2019-04-07,129,,NOP,0,240,50,109,0.459,34,69,0.493,16,40,0.4,13,17,0.765,129,52,101,0.515,33,59,0.559,19,42,0.452,10,12,0.833,133
180,SAS,2019-04-05,129,@,WAS,1,240,51,91,0.56,41,66,0.621,10,25,0.4,17,20,0.85,129,42,88,0.477,33,56,0.589,9,32,0.281,19,22,0.864,112
181,LAL,2019-03-29,129,,CHO,1,240,51,91,0.56,33,53,0.623,18,38,0.474,9,12,0.75,129,42,88,0.477,27,49,0.551,15,39,0.385,16,17,0.941,115
182,ATL,2019-03-23,129,,PHI,1,240,49,106,0.462,34,59,0.576,15,47,0.319,16,21,0.762,129,42,91,0.462,32,68,0.471,10,23,0.435,33,39,0.846,127
183,NOP,2019-03-18,129,@,DAL,1,265,49,104,0.471,37,65,0.569,12,39,0.308,19,22,0.864,129,46,105,0.438,37,70,0.529,9,35,0.257,24,29,0.828,125
184,SAC,2019-03-17,129,,CHI,1,240,54,103,0.524,46,80,0.575,8,23,0.348,13,16,0.813,129,39,88,0.443,29,62,0.468,10,26,0.385,14,21,0.667,102
185,BOS,2019-03-16,129,,ATL,1,240,44,93,0.473,31,57,0.544,13,36,0.361,28,37,0.757,129,43,100,0.43,28,60,0.467,15,40,0.375,19,24,0.792,120
186,OKC,2019-03-07,129,@,POR,1,265,48,105,0.457,40,78,0.513,8,27,0.296,25,32,0.781,129,37,94,0.394,28,53,0.528,9,41,0.22,38,47,0.809,121
187,DET,2019-03-02,129,@,CLE,1,240,47,87,0.54,27,50,0.54,20,37,0.541,15,17,0.882,129,27,79,0.342,14,45,0.311,13,34,0.382,26,32,0.813,93
188,TOR,2019-02-13,129,,WAS,1,240,44,92,0.478,28,54,0.519,16,38,0.421,25,30,0.833,129,37,84,0.44,23,44,0.523,14,40,0.35,32,39,0.821,120
189,POR,2019-02-13,129,,GSW,1,240,43,93,0.462,27,56,0.482,16,37,0.432,27,34,0.794,129,39,97,0.402,26,59,0.441,13,38,0.342,16,18,0.889,107
190,CHO,2019-02-09,129,@,ATL,1,240,48,88,0.545,29,46,0.63,19,42,0.452,14,18,0.778,129,46,86,0.535,32,53,0.604,14,33,0.424,14,19,0.737,120
191,LAL,2019-02-07,129,@,BOS,1,240,50,97,0.515,28,56,0.5,22,41,0.537,7,18,0.389,129,46,94,0.489,30,56,0.536,16,38,0.421,20,20,1.0,128
192,WAS,2019-02-06,129,@,MIL,0,240,48,92,0.522,31,55,0.564,17,37,0.459,16,19,0.842,129,56,93,0.602,37,63,0.587,19,30,0.633,17,26,0.654,148
193,DET,2019-02-04,129,,DEN,1,240,48,88,0.545,32,51,0.627,16,37,0.432,17,20,0.85,129,41,92,0.446,32,64,0.5,9,28,0.321,12,22,0.545,103
194,WAS,2019-02-04,129,,ATL,0,240,48,97,0.495,36,59,0.61,12,38,0.316,21,29,0.724,129,46,91,0.505,26,51,0.51,20,40,0.5,25,29,0.862,137
195,OKC,2019-02-03,129,@,BOS,0,240,45,92,0.489,31,57,0.544,14,35,0.4,25,34,0.735,129,54,91,0.593,41,57,0.719,13,34,0.382,13,17,0.765,134
196,UTA,2019-01-16,129,@,LAC,1,240,44,86,0.512,33,53,0.623,11,33,0.333,30,37,0.811,129,45,98,0.459,35,76,0.461,10,22,0.455,9,14,0.643,109
197,POR,2019-01-16,129,,CLE,1,240,47,89,0.528,31,60,0.517,16,29,0.552,19,23,0.826,129,45,95,0.474,39,76,0.513,6,19,0.316,16,19,0.842,112
198,POR,2018-12-30,129,,PHI,1,240,49,83,0.59,37,61,0.607,12,22,0.545,19,25,0.76,129,34,96,0.354,26,53,0.491,8,43,0.186,19,27,0.704,95
199,MIL,2018-12-29,129,,BRK,1,240,47,96,0.49,26,45,0.578,21,51,0.412,14,16,0.875,129,38,79,0.481,23,44,0.523,15,35,0.429,24,35,0.686,115
200,UTA,2018-12-29,129,,NYK,1,240,51,93,0.548,35,57,0.614,16,36,0.444,11,14,0.786,129,32,86,0.372,17,54,0.315,15,32,0.469,18,22,0.818,97
201,IND,2018-12-26,129,@,ATL,1,240,46,83,0.554,33,56,0.589,13,27,0.481,24,33,0.727,129,45,89,0.506,28,53,0.528,17,36,0.472,14,18,0.778,121
202,GSW,2018-12-23,129,,LAC,1,240,42,93,0.452,28,53,0.528,14,40,0.35,31,36,0.861,129,43,80,0.538,25,57,0.439,18,23,0.783,23,29,0.793,127
203,DET,2018-12-19,129,@,MIN,1,265,46,94,0.489,26,46,0.565,20,48,0.417,17,28,0.607,129,45,103,0.437,36,70,0.514,9,33,0.273,24,29,0.828,123
204,SAS,2018-12-19,129,@,ORL,1,240,50,77,0.649,38,58,0.655,12,19,0.632,17,21,0.81,129,34,89,0.382,22,58,0.379,12,31,0.387,10,17,0.588,90
205,BOS,2018-12-14,129,,ATL,1,240,46,95,0.484,27,56,0.482,19,39,0.487,18,20,0.9,129,36,86,0.419,20,48,0.417,16,38,0.421,20,32,0.625,108
206,SAC,2018-12-07,129,@,CLE,1,240,56,98,0.571,43,69,0.623,13,29,0.448,4,7,0.571,129,43,81,0.531,33,55,0.6,10,26,0.385,14,19,0.737,110
207,GSW,2018-12-05,129,@,CLE,1,240,45,85,0.529,27,51,0.529,18,34,0.529,21,24,0.875,129,39,89,0.438,28,57,0.491,11,32,0.344,16,23,0.696,105
208,LAC,2018-12-03,129,@,NOP,1,240,49,83,0.59,41,63,0.651,8,20,0.4,23,30,0.767,129,49,92,0.533,36,58,0.621,13,34,0.382,15,22,0.682,126
209,SAS,2018-11-24,129,@,MIL,0,240,49,92,0.533,39,71,0.549,10,21,0.476,21,28,0.75,129,49,86,0.57,34,46,0.739,15,40,0.375,22,29,0.759,135
210,NOP,2018-11-16,129,,NYK,1,240,48,99,0.485,38,65,0.585,10,34,0.294,23,32,0.719,129,48,98,0.49,37,64,0.578,11,34,0.324,17,24,0.708,124
211,TOR,2018-10-30,129,,PHI,1,240,47,92,0.511,36,65,0.554,11,27,0.407,24,28,0.857,129,38,91,0.418,24,51,0.471,14,40,0.35,22,30,0.733,112
212,SAC,2018-10-19,129,@,NOP,0,240,50,96,0.521,40,71,0.563,10,25,0.4,19,26,0.731,129,56,95,0.589,40,64,0.625,16,31,0.516,21,33,0.636,149
213,MIL,2019-04-06,128,,BRK,0,240,49,88,0.557,33,54,0.611,16,34,0.471,14,21,0.667,128,48,97,0.495,29,52,0.558,19,45,0.422,18,23,0.783,133
214,MIL,2019-04-04,128,@,PHI,1,240,42,93,0.452,30,59,0.508,12,34,0.353,32,43,0.744,128,45,95,0.474,27,59,0.458,18,36,0.5,14,18,0.778,122
215,UTA,2019-03-29,128,,WAS,1,240,48,87,0.552,34,55,0.618,14,32,0.438,18,18,1.0,128,48,98,0.49,33,61,0.541,15,37,0.405,13,22,0.591,124
216,MIL,2019-03-28,128,,LAC,1,240,45,86,0.523,29,49,0.592,16,37,0.432,22,27,0.815,128,42,92,0.457,25,59,0.424,17,33,0.515,17,22,0.773,118
217,TOR,2019-03-18,128,,NYK,1,240,49,88,0.557,32,48,0.667,17,40,0.425,13,22,0.591,128,28,85,0.329,20,50,0.4,8,35,0.229,28,32,0.875,92
218,MEM,2019-03-16,128,@,WAS,0,240,48,90,0.533,36,57,0.632,12,33,0.364,20,26,0.769,128,41,81,0.506,24,46,0.522,17,35,0.486,36,43,0.837,135
219,LAC,2019-03-15,128,,CHI,1,240,44,99,0.444,34,79,0.43,10,20,0.5,30,35,0.857,128,42,80,0.525,31,59,0.525,11,21,0.524,26,33,0.788,121
220,ATL,2019-03-10,128,,NOP,1,240,48,98,0.49,31,61,0.508,17,37,0.459,15,18,0.833,128,45,101,0.446,27,60,0.45,18,41,0.439,8,8,1.0,116
221,BOS,2019-03-05,128,@,GSW,1,240,49,96,0.51,35,62,0.565,14,34,0.412,16,17,0.941,128,34,85,0.4,26,50,0.52,8,35,0.229,19,23,0.826,95
222,LAC,2019-03-03,128,,NYK,1,240,48,98,0.49,29,63,0.46,19,35,0.543,13,17,0.765,128,35,88,0.398,24,59,0.407,11,29,0.379,26,34,0.765,107
223,MIN,2019-02-23,128,@,MIL,0,240,50,102,0.49,38,76,0.5,12,26,0.462,16,20,0.8,128,50,95,0.526,31,52,0.596,19,43,0.442,21,22,0.955,140
224,NOP,2019-02-23,128,,LAL,1,240,50,96,0.521,35,56,0.625,15,40,0.375,13,16,0.813,128,44,81,0.543,34,52,0.654,10,29,0.345,17,26,0.654,115
225,BOS,2019-02-07,128,,LAL,0,240,46,94,0.489,30,56,0.536,16,38,0.421,20,20,1.0,128,50,97,0.515,28,56,0.5,22,41,0.537,7,18,0.389,129
226,UTA,2019-02-01,128,,ATL,1,240,46,87,0.529,34,52,0.654,12,35,0.343,24,30,0.8,128,39,98,0.398,25,52,0.481,14,46,0.304,20,24,0.833,112
227,POR,2019-01-18,128,,NOP,1,240,48,103,0.466,37,69,0.536,11,34,0.324,21,26,0.808,128,41,84,0.488,33,59,0.559,8,25,0.32,22,27,0.815,112
228,OKC,2019-01-17,128,,LAL,0,265,41,104,0.394,19,50,0.38,22,54,0.407,24,36,0.667,128,50,99,0.505,31,59,0.525,19,40,0.475,19,21,0.905,138
229,LAC,2019-01-08,128,,CHO,1,240,48,93,0.516,34,63,0.54,14,30,0.467,18,21,0.857,128,36,90,0.4,24,57,0.421,12,33,0.364,25,29,0.862,109
230,PHO,2018-12-17,128,@,NYK,1,240,48,92,0.522,39,65,0.6,9,27,0.333,23,27,0.852,128,40,99,0.404,31,64,0.484,9,35,0.257,21,29,0.724,110
231,WAS,2018-12-16,128,,LAL,1,240,54,106,0.509,41,75,0.547,13,31,0.419,7,10,0.7,128,44,91,0.484,33,55,0.6,11,36,0.306,11,18,0.611,110
232,PHI,2018-12-16,128,@,CLE,1,240,51,91,0.56,40,64,0.625,11,27,0.407,15,20,0.75,128,41,88,0.466,29,58,0.5,12,30,0.4,11,17,0.647,105
233,LAL,2018-12-15,128,@,CHO,1,240,49,92,0.533,35,58,0.603,14,34,0.412,16,24,0.667,128,39,92,0.424,32,63,0.508,7,29,0.241,15,18,0.833,100
234,POR,2018-12-14,128,,TOR,1,240,48,94,0.511,35,67,0.522,13,27,0.481,19,21,0.905,128,43,78,0.551,25,47,0.532,18,31,0.581,18,21,0.857,122
235,BOS,2018-12-06,128,,NYK,1,240,49,92,0.533,36,54,0.667,13,38,0.342,17,20,0.85,128,36,91,0.396,24,56,0.429,12,35,0.343,16,20,0.8,100
236,GSW,2018-12-03,128,@,ATL,1,240,48,82,0.585,35,58,0.603,13,24,0.542,19,22,0.864,128,44,90,0.489,39,64,0.609,5,26,0.192,18,24,0.75,111
237,BOS,2018-11-30,128,,CLE,1,240,49,92,0.533,32,61,0.525,17,31,0.548,13,16,0.813,128,30,77,0.39,23,55,0.418,7,22,0.318,28,35,0.8,95
238,GSW,2018-11-29,128,@,TOR,0,265,50,103,0.485,39,73,0.534,11,30,0.367,17,20,0.85,128,47,90,0.522,32,52,0.615,15,38,0.395,22,24,0.917,131
239,MIN,2018-11-28,128,,SAS,1,240,50,99,0.505,32,58,0.552,18,41,0.439,10,15,0.667,128,34,87,0.391,26,60,0.433,8,27,0.296,13,13,1.0,89
240,DAL,2018-11-28,128,@,HOU,1,240,46,85,0.541,29,51,0.569,17,34,0.5,19,24,0.792,128,40,87,0.46,27,42,0.643,13,45,0.289,15,23,0.652,108
241,OKC,2018-11-14,128,,NYK,1,240,51,95,0.537,35,62,0.565,16,33,0.485,10,12,0.833,128,39,88,0.443,32,62,0.516,7,26,0.269,18,23,0.783,103
242,LAC,2018-11-10,128,,MIL,1,265,46,99,0.465,32,65,0.492,14,34,0.412,22,27,0.815,128,47,105,0.448,31,59,0.525,16,46,0.348,16,23,0.696,126
243,TOR,2018-11-10,128,,NYK,1,240,42,79,0.532,28,44,0.636,14,35,0.4,30,40,0.75,128,44,96,0.458,38,74,0.514,6,22,0.273,18,22,0.818,112
244,MIN,2018-10-31,128,,UTA,1,240,50,86,0.581,38,61,0.623,12,25,0.48,16,24,0.667,128,47,97,0.485,34,67,0.507,13,30,0.433,18,30,0.6,125
245,OKC,2018-10-30,128,,LAC,1,240,48,94,0.511,39,77,0.506,9,17,0.529,23,32,0.719,128,35,74,0.473,28,54,0.519,7,20,0.35,33,43,0.767,110
246,GSW,2018-10-26,128,@,NYK,1,240,51,87,0.586,35,54,0.648,16,33,0.485,10,12,0.833,128,39,90,0.433,26,51,0.51,13,39,0.333,9,12,0.75,100
247,POR,2018-10-25,128,@,ORL,1,240,48,87,0.552,37,60,0.617,11,27,0.407,21,26,0.808,128,43,86,0.5,31,56,0.554,12,30,0.4,16,20,0.8,114
248,POR,2018-10-18,128,,LAL,1,240,44,100,0.44,31,63,0.492,13,37,0.351,27,29,0.931,128,45,93,0.484,38,63,0.603,7,30,0.233,22,29,0.759,119
249,OKC,2019-04-10,127,@,MIL,1,240,48,99,0.485,25,45,0.556,23,54,0.426,8,13,0.615,127,43,100,0.43,28,54,0.519,15,46,0.326,15,21,0.714,116
250,MEM,2019-04-07,127,,DAL,0,265,42,98,0.429,23,54,0.426,19,44,0.432,24,28,0.857,127,45,98,0.459,33,57,0.579,12,41,0.293,27,34,0.794,129
251,MIL,2019-03-24,127,,CLE,1,240,48,87,0.552,33,46,0.717,15,41,0.366,16,21,0.762,127,41,96,0.427,30,55,0.545,11,41,0.268,12,17,0.706,105
252,PHI,2019-03-23,127,@,ATL,0,240,42,91,0.462,32,68,0.471,10,23,0.435,33,39,0.846,127,49,106,0.462,34,59,0.576,15,47,0.319,16,21,0.762,129
253,POR,2019-03-09,127,,PHO,1,240,43,86,0.5,30,57,0.526,13,29,0.448,28,36,0.778,127,43,103,0.417,34,76,0.447,9,27,0.333,25,29,0.862,120
254,TOR,2019-03-08,127,@,NOP,1,240,53,99,0.535,40,62,0.645,13,37,0.351,8,9,0.889,127,43,105,0.41,33,66,0.5,10,39,0.256,8,13,0.615,104
255,BRK,2019-03-04,127,,DAL,1,240,48,85,0.565,31,44,0.705,17,41,0.415,14,19,0.737,127,31,87,0.356,19,42,0.452,12,45,0.267,14,22,0.636,88
256,ORL,2019-02-14,127,,CHO,1,240,48,92,0.522,31,53,0.585,17,39,0.436,14,18,0.778,127,33,94,0.351,29,63,0.46,4,31,0.129,19,26,0.731,89
257,TOR,2019-02-11,127,,BRK,1,240,50,92,0.543,41,61,0.672,9,31,0.29,18,20,0.9,127,46,88,0.523,26,47,0.553,20,41,0.488,13,18,0.722,125
258,POR,2019-02-07,127,,SAS,1,240,49,91,0.538,38,60,0.633,11,31,0.355,18,18,1.0,127,48,91,0.527,36,70,0.514,12,21,0.571,10,14,0.714,118
259,HOU,2019-02-06,127,@,SAC,1,240,45,100,0.45,25,49,0.51,20,51,0.392,17,18,0.944,127,39,91,0.429,28,58,0.483,11,33,0.333,12,20,0.6,101
260,SAC,2019-02-04,127,,SAS,1,240,50,90,0.556,37,58,0.638,13,32,0.406,14,23,0.609,127,42,98,0.429,33,66,0.5,9,32,0.281,19,21,0.905,112
261,OKC,2019-01-21,127,@,NYK,1,240,45,83,0.542,30,54,0.556,15,29,0.517,22,27,0.815,127,39,87,0.448,32,64,0.5,7,23,0.304,24,32,0.75,109
262,POR,2019-01-11,127,,CHO,1,240,52,93,0.559,37,53,0.698,15,40,0.375,8,9,0.889,127,36,90,0.4,23,60,0.383,13,30,0.433,11,16,0.688,96
263,GSW,2019-01-05,127,@,SAC,1,240,47,93,0.505,26,46,0.565,21,47,0.447,12,14,0.857,127,46,97,0.474,26,61,0.426,20,36,0.556,11,14,0.786,123
264,PHO,2019-01-02,127,,PHI,0,240,43,95,0.453,32,61,0.525,11,34,0.324,30,36,0.833,127,40,74,0.541,29,50,0.58,11,24,0.458,41,54,0.759,132
265,HOU,2018-12-27,127,,BOS,1,240,41,86,0.477,23,41,0.561,18,45,0.4,27,35,0.771,127,38,81,0.469,26,50,0.52,12,31,0.387,25,31,0.806,113
266,LAC,2018-12-26,127,,SAC,1,240,48,96,0.5,36,68,0.529,12,28,0.429,19,23,0.826,127,49,104,0.471,39,74,0.527,10,30,0.333,10,15,0.667,118
267,LAL,2018-12-25,127,@,GSW,1,240,47,85,0.553,34,52,0.654,13,33,0.394,20,27,0.741,127,38,93,0.409,29,57,0.509,9,36,0.25,16,21,0.762,101
268,LAC,2018-12-23,127,@,GSW,0,240,43,80,0.538,25,57,0.439,18,23,0.783,23,29,0.793,127,42,93,0.452,28,53,0.528,14,40,0.35,31,36,0.861,129
269,LAC,2018-12-17,127,,POR,0,240,42,83,0.506,32,56,0.571,10,27,0.37,33,39,0.846,127,47,86,0.547,37,66,0.561,10,20,0.5,27,31,0.871,131
270,ATL,2018-12-16,127,@,BRK,0,240,47,85,0.553,33,56,0.589,14,29,0.483,19,25,0.76,127,49,88,0.557,33,48,0.688,16,40,0.4,30,33,0.909,144
271,BRK,2018-12-12,127,@,PHI,1,240,38,74,0.514,24,46,0.522,14,28,0.5,37,43,0.86,127,50,91,0.549,38,63,0.603,12,28,0.429,12,16,0.75,124
272,PHI,2018-11-25,127,@,BRK,1,240,44,91,0.484,32,62,0.516,12,29,0.414,27,33,0.818,127,50,88,0.568,40,63,0.635,10,25,0.4,15,20,0.75,125
273,CHO,2018-11-21,127,,IND,1,240,45,80,0.563,27,51,0.529,18,29,0.621,19,22,0.864,127,41,84,0.488,30,51,0.588,11,33,0.333,16,17,0.941,109
274,LAC,2018-11-19,127,@,ATL,1,240,40,93,0.43,30,60,0.5,10,33,0.303,37,47,0.787,127,45,101,0.446,33,63,0.524,12,38,0.316,17,19,0.895,119
275,LAC,2018-11-17,127,@,BRK,1,240,48,95,0.505,37,72,0.514,11,23,0.478,20,24,0.833,127,40,88,0.455,27,60,0.45,13,28,0.464,26,34,0.765,119
276,TOR,2018-10-22,127,,CHO,1,240,50,87,0.575,35,48,0.729,15,39,0.385,12,14,0.857,127,41,97,0.423,32,69,0.464,9,28,0.321,15,18,0.833,106
277,PHI,2018-10-18,127,,CHI,1,240,44,93,0.473,32,57,0.561,12,36,0.333,27,30,0.9,127,44,101,0.436,33,68,0.485,11,33,0.333,9,12,0.75,108
278,MIN,2019-04-07,126,,OKC,0,240,46,85,0.541,36,62,0.581,10,23,0.435,24,29,0.828,126,48,92,0.522,34,58,0.586,14,34,0.412,22,26,0.846,132
279,NOP,2019-04-05,126,@,PHO,0,265,49,101,0.485,41,78,0.526,8,23,0.348,20,27,0.741,126,51,104,0.49,37,68,0.544,14,36,0.389,17,21,0.81,133
280,DAL,2019-03-23,126,@,GSW,1,240,44,83,0.53,23,34,0.676,21,49,0.429,17,22,0.773,126,36,90,0.4,32,60,0.533,4,30,0.133,15,21,0.714,91
281,MEM,2019-03-20,126,,HOU,1,265,41,89,0.461,28,52,0.538,13,37,0.351,31,39,0.795,126,42,94,0.447,21,46,0.457,21,48,0.438,20,20,1.0,125
282,CHI,2019-03-20,126,,WAS,1,265,50,106,0.472,38,83,0.458,12,23,0.522,14,17,0.824,126,44,93,0.473,30,51,0.588,14,42,0.333,18,23,0.783,120
283,POR,2019-03-20,126,,DAL,1,240,45,91,0.495,29,55,0.527,16,36,0.444,20,25,0.8,126,43,87,0.494,33,57,0.579,10,30,0.333,22,25,0.88,118
284,CLE,2019-03-18,126,,DET,1,240,46,79,0.582,35,57,0.614,11,22,0.5,23,27,0.852,126,42,94,0.447,24,50,0.48,18,44,0.409,17,21,0.81,119
285,BOS,2019-03-14,126,,SAC,1,240,49,97,0.505,40,69,0.58,9,28,0.321,19,26,0.731,126,48,95,0.505,37,61,0.607,11,34,0.324,13,23,0.565,120
286,CLE,2019-03-11,126,,TOR,1,240,44,94,0.468,26,53,0.491,18,41,0.439,20,21,0.952,126,40,84,0.476,29,45,0.644,11,39,0.282,10,17,0.588,101
287,MIA,2019-03-08,126,,CLE,1,240,45,79,0.57,33,54,0.611,12,25,0.48,24,33,0.727,126,39,81,0.481,20,38,0.526,19,43,0.442,13,16,0.813,110
288,MIA,2019-02-27,126,,GSW,1,240,42,83,0.506,24,42,0.571,18,41,0.439,24,30,0.8,126,44,89,0.494,27,41,0.659,17,48,0.354,20,28,0.714,125
289,CHI,2019-02-23,126,,BOS,1,240,47,88,0.534,35,58,0.603,12,30,0.4,20,21,0.952,126,45,92,0.489,35,63,0.556,10,29,0.345,16,21,0.762,116
290,IND,2019-02-22,126,,NOP,1,240,44,93,0.473,30,61,0.492,14,32,0.438,24,35,0.686,126,43,93,0.462,35,66,0.53,8,27,0.296,17,30,0.567,111
291,PHI,2019-02-13,126,@,NYK,1,240,42,78,0.538,34,55,0.618,8,23,0.348,34,43,0.791,126,40,100,0.4,31,71,0.437,9,29,0.31,22,27,0.815,111
292,BOS,2019-01-30,126,,CHO,1,240,50,90,0.556,38,61,0.623,12,29,0.414,14,16,0.875,126,39,89,0.438,26,49,0.531,13,40,0.325,3,7,0.429,94
293,SAS,2019-01-29,126,,PHO,1,240,47,100,0.47,32,66,0.485,15,34,0.441,17,20,0.85,126,48,80,0.6,35,51,0.686,13,29,0.448,15,19,0.789,124
294,OKC,2019-01-29,126,@,ORL,1,240,49,91,0.538,40,70,0.571,9,21,0.429,19,26,0.731,126,44,102,0.431,30,61,0.492,14,41,0.341,15,18,0.833,117
295,DEN,2019-01-26,126,,PHI,1,240,48,94,0.511,40,70,0.571,8,24,0.333,22,29,0.759,126,38,91,0.418,24,55,0.436,14,36,0.389,20,27,0.741,110
296,SAS,2019-01-26,126,@,NOP,1,240,47,91,0.516,36,67,0.537,11,24,0.458,21,25,0.84,126,45,96,0.469,38,69,0.551,7,27,0.259,17,24,0.708,114
297,GSW,2019-01-24,126,@,WAS,1,240,50,88,0.568,43,68,0.632,7,20,0.35,19,21,0.905,126,44,95,0.463,29,53,0.547,15,42,0.357,15,21,0.714,118
298,OKC,2019-01-15,126,@,ATL,0,240,43,94,0.457,34,62,0.548,9,32,0.281,31,41,0.756,126,56,90,0.622,38,53,0.717,18,37,0.486,12,16,0.75,142
299,BRK,2019-01-02,126,,NOP,1,240,47,93,0.505,31,62,0.5,16,31,0.516,16,21,0.762,126,46,87,0.529,36,64,0.563,10,23,0.435,19,27,0.704,121
300,CHO,2018-12-29,126,@,WAS,0,240,47,90,0.522,34,59,0.576,13,31,0.419,19,24,0.792,126,48,93,0.516,35,56,0.625,13,37,0.351,21,24,0.875,130
301,PHI,2018-12-22,126,,TOR,1,240,46,85,0.541,38,61,0.623,8,24,0.333,26,35,0.743,126,37,95,0.389,27,55,0.491,10,40,0.25,17,19,0.895,101
302,TOR,2018-12-21,126,,CLE,1,240,48,91,0.527,39,60,0.65,9,31,0.29,21,26,0.808,126,39,82,0.476,30,58,0.517,9,24,0.375,23,30,0.767,110
303,DEN,2018-12-18,126,,DAL,1,240,50,90,0.556,38,61,0.623,12,29,0.414,14,18,0.778,126,40,86,0.465,25,49,0.51,15,37,0.405,23,30,0.767,118
304,NYK,2018-12-14,126,@,CHO,1,265,47,98,0.48,35,64,0.547,12,34,0.353,20,31,0.645,126,48,102,0.471,28,54,0.519,20,48,0.417,8,10,0.8,124
305,HOU,2018-12-13,126,,LAL,1,240,42,85,0.494,27,51,0.529,15,34,0.441,27,32,0.844,126,43,80,0.538,33,48,0.688,10,32,0.313,15,27,0.556,111
306,NOP,2018-12-03,126,,LAC,0,240,49,92,0.533,36,58,0.621,13,34,0.382,15,22,0.682,126,49,83,0.59,41,63,0.651,8,20,0.4,23,30,0.767,129
307,HOU,2018-11-21,126,,DET,1,240,40,72,0.556,27,39,0.692,13,33,0.394,33,36,0.917,126,40,85,0.471,24,51,0.471,16,34,0.471,28,37,0.757,124
308,SAS,2018-11-19,126,@,NOP,0,240,45,94,0.479,33,70,0.471,12,24,0.5,24,30,0.8,126,59,102,0.578,49,76,0.645,10,26,0.385,12,14,0.857,140
309,LAL,2018-11-14,126,,POR,1,240,44,93,0.473,29,61,0.475,15,32,0.469,23,26,0.885,126,41,93,0.441,27,60,0.45,14,33,0.424,21,23,0.913,117
310,NOP,2018-11-12,126,@,TOR,1,240,54,99,0.545,44,72,0.611,10,27,0.37,8,13,0.615,126,39,97,0.402,26,52,0.5,13,45,0.289,19,22,0.864,110
311,MIL,2018-11-10,126,@,LAC,0,265,47,105,0.448,31,59,0.525,16,46,0.348,16,23,0.696,126,46,99,0.465,32,65,0.492,14,34,0.412,22,27,0.815,128
312,CHO,2018-11-03,126,,CLE,1,240,52,91,0.571,42,61,0.689,10,30,0.333,12,13,0.923,126,35,81,0.432,25,55,0.455,10,26,0.385,14,15,0.933,94
313,DEN,2018-10-23,126,,SAC,1,240,51,99,0.515,40,69,0.58,11,30,0.367,13,15,0.867,126,45,86,0.523,32,55,0.582,13,31,0.419,9,20,0.45,112
314,NYK,2018-10-17,126,,ATL,1,240,45,99,0.455,33,66,0.5,12,33,0.364,24,31,0.774,126,41,90,0.456,31,54,0.574,10,36,0.278,15,18,0.833,107
315,PHI,2019-04-10,125,,CHI,1,240,52,93,0.559,40,67,0.597,12,26,0.462,9,15,0.6,125,45,95,0.474,36,71,0.507,9,24,0.375,10,15,0.667,109
316,SAC,2019-03-26,125,@,DAL,1,240,44,87,0.506,34,64,0.531,10,23,0.435,27,32,0.844,125,39,77,0.506,24,32,0.75,15,45,0.333,28,32,0.875,121
317,CHO,2019-03-26,125,,SAS,1,265,46,100,0.46,33,58,0.569,13,42,0.31,20,28,0.714,125,44,108,0.407,31,69,0.449,13,39,0.333,15,21,0.714,116
318,UTA,2019-03-25,125,,PHO,1,240,48,86,0.558,38,65,0.585,10,21,0.476,19,23,0.826,125,31,76,0.408,24,53,0.453,7,23,0.304,23,28,0.821,92
319,HOU,2019-03-20,125,@,MEM,0,265,42,94,0.447,21,46,0.457,21,48,0.438,20,20,1.0,125,41,89,0.461,28,52,0.538,13,37,0.351,31,39,0.795,126
320,DAL,2019-03-18,125,,NOP,0,265,46,105,0.438,37,70,0.529,9,35,0.257,24,29,0.828,125,49,104,0.471,37,65,0.569,12,39,0.308,19,22,0.864,129
321,MIL,2019-03-17,125,,PHI,0,240,43,95,0.453,27,45,0.6,16,50,0.32,23,28,0.821,125,47,100,0.47,32,68,0.471,15,32,0.469,21,30,0.7,130
322,POR,2019-03-12,125,@,LAC,1,240,47,96,0.49,35,65,0.538,12,31,0.387,19,26,0.731,125,38,95,0.4,29,80,0.363,9,15,0.6,19,27,0.704,104
323,TOR,2019-03-10,125,@,MIA,1,240,42,74,0.568,21,34,0.618,21,40,0.525,20,26,0.769,125,42,92,0.457,34,65,0.523,8,27,0.296,12,21,0.571,104
324,CLE,2019-02-28,125,@,NYK,1,240,41,80,0.513,27,46,0.587,14,34,0.412,29,36,0.806,125,46,95,0.484,35,63,0.556,11,32,0.344,15,23,0.652,118
325,GSW,2019-02-27,125,@,MIA,0,240,44,89,0.494,27,41,0.659,17,48,0.354,20,28,0.714,125,42,83,0.506,24,42,0.571,18,41,0.439,24,30,0.8,126
326,LAL,2019-02-27,125,,NOP,1,240,49,94,0.521,41,69,0.594,8,25,0.32,19,31,0.613,125,46,102,0.451,39,67,0.582,7,35,0.2,20,27,0.741,119
327,WAS,2019-02-27,125,@,BRK,1,240,44,96,0.458,33,59,0.559,11,37,0.297,26,31,0.839,125,39,85,0.459,31,50,0.62,8,35,0.229,30,39,0.769,116
328,UTA,2019-02-23,125,,DAL,1,240,41,85,0.482,27,47,0.574,14,38,0.368,29,33,0.879,125,41,97,0.423,28,61,0.459,13,36,0.361,14,18,0.778,109
329,DET,2019-02-22,125,@,ATL,1,240,46,95,0.484,31,55,0.564,15,40,0.375,18,28,0.643,125,43,88,0.489,23,46,0.5,20,42,0.476,16,19,0.842,122
330,GSW,2019-02-21,125,,SAC,1,240,43,94,0.457,24,48,0.5,19,46,0.413,20,24,0.833,125,43,99,0.434,33,66,0.5,10,33,0.303,27,34,0.794,123
331,BRK,2019-02-11,125,@,TOR,0,240,46,88,0.523,26,47,0.553,20,41,0.488,13,18,0.722,125,50,92,0.543,41,61,0.672,9,31,0.29,18,20,0.9,127
332,UTA,2019-02-09,125,,SAS,1,240,47,90,0.522,31,49,0.633,16,41,0.39,15,20,0.75,125,40,89,0.449,33,67,0.493,7,22,0.318,18,20,0.9,105
333,CHI,2019-02-09,125,,WAS,0,240,49,97,0.505,43,74,0.581,6,23,0.261,21,28,0.75,125,55,95,0.579,43,68,0.632,12,27,0.444,12,14,0.857,134
334,CHI,2019-02-08,125,@,BRK,1,240,46,85,0.541,32,57,0.561,14,28,0.5,19,24,0.792,125,39,94,0.415,26,53,0.491,13,41,0.317,15,16,0.938,106
335,NOP,2019-02-06,125,@,CHI,1,240,45,85,0.529,30,50,0.6,15,35,0.429,20,30,0.667,125,45,91,0.495,29,55,0.527,16,36,0.444,14,19,0.737,120
336,CHO,2019-02-02,125,,CHI,1,240,43,82,0.524,29,50,0.58,14,32,0.438,25,29,0.862,125,42,81,0.519,33,57,0.579,9,24,0.375,25,25,1.0,118
337,HOU,2019-02-02,125,@,UTA,1,240,40,87,0.46,25,48,0.521,15,39,0.385,30,37,0.811,125,31,86,0.36,20,45,0.444,11,41,0.268,25,36,0.694,98
338,UTA,2019-01-27,125,@,MIN,1,240,46,86,0.535,31,47,0.66,15,39,0.385,18,25,0.72,125,37,77,0.481,20,41,0.488,17,36,0.472,20,23,0.87,111
339,HOU,2019-01-07,125,,DEN,1,240,38,76,0.5,16,29,0.552,22,47,0.468,27,34,0.794,125,44,93,0.473,37,64,0.578,7,29,0.241,18,21,0.857,113
340,SAS,2019-01-03,125,,TOR,1,240,47,85,0.553,34,58,0.586,13,27,0.481,18,20,0.9,125,39,87,0.448,33,57,0.579,6,30,0.2,23,29,0.793,107
341,CHO,2018-12-31,125,,ORL,1,240,42,85,0.494,31,61,0.508,11,24,0.458,30,33,0.909,125,38,92,0.413,28,57,0.491,10,35,0.286,14,19,0.737,100
342,IND,2018-12-28,125,,DET,1,240,53,87,0.609,48,68,0.706,5,19,0.263,14,20,0.7,125,34,91,0.374,25,55,0.455,9,36,0.25,11,12,0.917,88
343,LAC,2018-12-20,125,,DAL,1,240,47,83,0.566,41,63,0.651,6,20,0.3,25,31,0.806,125,43,92,0.467,33,64,0.516,10,28,0.357,25,33,0.758,121
344,SAC,2018-12-14,125,,GSW,0,240,45,96,0.469,30,52,0.577,15,44,0.341,20,25,0.8,125,44,96,0.458,29,56,0.518,15,40,0.375,27,36,0.75,130
345,BRK,2018-12-14,125,,WAS,1,240,44,84,0.524,33,53,0.623,11,31,0.355,26,31,0.839,125,49,90,0.544,38,61,0.623,11,29,0.379,9,16,0.563,118
346,SAS,2018-12-13,125,,LAC,1,240,48,83,0.578,38,61,0.623,10,22,0.455,19,24,0.792,125,30,84,0.357,20,53,0.377,10,31,0.323,17,24,0.708,87
347,WAS,2018-12-12,125,,BOS,0,265,46,91,0.505,34,58,0.586,12,33,0.364,21,29,0.724,125,47,104,0.452,36,66,0.545,11,38,0.289,25,25,1.0,130
348,BRK,2018-11-30,125,,MEM,0,290,42,94,0.447,26,50,0.52,16,44,0.364,25,30,0.833,125,50,101,0.495,38,71,0.535,12,30,0.4,19,22,0.864,131
349,NOP,2018-11-28,125,,WAS,1,240,46,95,0.484,35,59,0.593,11,36,0.306,22,28,0.786,125,41,95,0.432,28,56,0.5,13,39,0.333,9,16,0.563,104
350,TOR,2018-11-25,125,,MIA,1,240,47,90,0.522,36,55,0.655,11,35,0.314,20,25,0.8,125,39,95,0.411,24,59,0.407,15,36,0.417,22,32,0.688,115
351,BRK,2018-11-25,125,,PHI,0,240,50,88,0.568,40,63,0.635,10,25,0.4,15,20,0.75,125,44,91,0.484,32,62,0.516,12,29,0.414,27,33,0.818,127
352,GSW,2018-11-23,125,,POR,1,240,48,85,0.565,31,53,0.585,17,32,0.531,12,16,0.75,125,38,93,0.409,29,69,0.42,9,24,0.375,12,22,0.545,97
353,TOR,2018-11-23,125,,WAS,1,240,46,93,0.495,29,54,0.537,17,39,0.436,16,19,0.842,125,40,100,0.4,31,54,0.574,9,46,0.196,18,19,0.947,107
354,WAS,2018-11-20,125,,LAC,1,240,40,93,0.43,27,54,0.5,13,39,0.333,32,39,0.821,125,46,89,0.517,35,62,0.565,11,27,0.407,15,18,0.833,118
355,NOP,2018-11-17,125,,DEN,1,240,42,87,0.483,32,62,0.516,10,25,0.4,31,34,0.912,125,46,95,0.484,31,56,0.554,15,39,0.385,8,13,0.615,115
356,UTA,2018-10-31,125,@,MIN,0,240,47,97,0.485,34,67,0.507,13,30,0.433,18,30,0.6,125,50,86,0.581,38,61,0.623,12,25,0.48,16,24,0.667,128
357,CHO,2018-10-30,125,,MIA,1,240,44,81,0.543,31,53,0.585,13,28,0.464,24,29,0.828,125,41,87,0.471,30,59,0.508,11,28,0.393,20,24,0.833,113
358,MIL,2018-10-26,125,@,MIN,1,240,49,92,0.533,30,46,0.652,19,46,0.413,8,11,0.727,125,36,112,0.321,26,69,0.377,10,43,0.233,13,18,0.722,95
359,WAS,2018-10-22,125,@,POR,1,265,46,110,0.418,31,73,0.425,15,37,0.405,18,26,0.692,125,43,108,0.398,32,69,0.464,11,39,0.282,27,31,0.871,124
360,CHO,2019-04-09,124,@,CLE,1,240,45,78,0.577,23,34,0.676,22,44,0.5,12,17,0.706,124,40,89,0.449,29,59,0.492,11,30,0.367,6,8,0.75,97
361,TOR,2019-03-30,124,@,CHI,1,240,46,89,0.517,28,51,0.549,18,38,0.474,14,18,0.778,124,41,97,0.423,32,67,0.478,9,30,0.3,10,16,0.625,101
362,WAS,2019-03-29,124,@,UTA,0,240,48,98,0.49,33,61,0.541,15,37,0.405,13,22,0.591,124,48,87,0.552,34,55,0.618,14,32,0.438,18,18,1.0,128
363,WAS,2019-03-27,124,@,PHO,1,240,43,90,0.478,34,65,0.523,9,25,0.36,29,43,0.674,124,43,87,0.494,29,50,0.58,14,37,0.378,21,26,0.808,121
364,LAL,2019-03-26,124,,WAS,1,240,48,89,0.539,37,56,0.661,11,33,0.333,17,23,0.739,124,39,90,0.433,33,58,0.569,6,32,0.188,22,27,0.815,106
365,LAC,2019-03-24,124,@,NYK,1,240,38,86,0.442,23,51,0.451,15,35,0.429,33,37,0.892,124,41,86,0.477,32,53,0.604,9,33,0.273,22,25,0.88,113
366,IND,2019-03-24,124,,DEN,1,240,51,91,0.56,43,73,0.589,8,18,0.444,14,17,0.824,124,33,93,0.355,26,64,0.406,7,29,0.241,15,16,0.938,88
367,CHO,2019-03-23,124,,BOS,1,240,42,95,0.442,24,57,0.421,18,38,0.474,22,28,0.786,124,44,93,0.473,25,50,0.5,19,43,0.442,10,15,0.667,117
368,NYK,2019-03-17,124,,LAL,1,240,44,76,0.579,32,50,0.64,12,26,0.462,24,29,0.828,124,47,97,0.485,40,70,0.571,7,27,0.259,22,28,0.786,123
369,PHO,2019-02-25,124,@,MIA,1,240,45,89,0.506,32,57,0.561,13,32,0.406,21,25,0.84,124,48,97,0.495,39,68,0.574,9,29,0.31,16,20,0.8,121
370,ORL,2019-02-10,124,@,ATL,1,240,43,91,0.473,30,54,0.556,13,37,0.351,25,28,0.893,124,37,80,0.463,24,48,0.5,13,32,0.406,21,25,0.84,108
371,PHO,2019-01-29,124,@,SAS,0,240,48,80,0.6,35,51,0.686,13,29,0.448,15,19,0.789,124,47,100,0.47,32,66,0.485,15,34,0.441,17,20,0.85,126
372,DEN,2019-01-19,124,,CLE,1,240,50,89,0.562,35,52,0.673,15,37,0.405,9,11,0.818,124,35,72,0.486,25,43,0.581,10,29,0.345,22,26,0.846,102
373,MIL,2019-01-15,124,,MIA,1,240,48,96,0.5,31,57,0.544,17,39,0.436,11,18,0.611,124,36,86,0.419,28,52,0.538,8,34,0.235,6,8,0.75,86
374,POR,2019-01-09,124,,CHI,1,240,47,83,0.566,36,57,0.632,11,26,0.423,19,21,0.905,124,43,93,0.462,34,71,0.479,9,22,0.409,17,19,0.895,112
375,CLE,2019-01-09,124,@,NOP,0,240,42,88,0.477,28,58,0.483,14,30,0.467,26,30,0.867,124,46,84,0.548,34,55,0.618,12,29,0.414,36,39,0.923,140
376,SAS,2018-12-21,124,,MIN,1,240,46,87,0.529,27,54,0.5,19,33,0.576,13,18,0.722,124,33,83,0.398,27,62,0.435,6,21,0.286,26,31,0.839,98
377,CHO,2018-12-14,124,,NYK,0,265,48,102,0.471,28,54,0.519,20,48,0.417,8,10,0.8,124,47,98,0.48,35,64,0.547,12,34,0.353,20,31,0.645,126
378,PHI,2018-12-12,124,,BRK,0,240,50,91,0.549,38,63,0.603,12,28,0.429,12,16,0.75,124,38,74,0.514,24,46,0.522,14,28,0.5,37,43,0.86,127
379,DEN,2018-12-05,124,@,ORL,1,265,45,82,0.549,34,63,0.54,11,19,0.579,23,37,0.622,124,45,95,0.474,25,46,0.543,20,49,0.408,8,8,1.0,118
380,OKC,2018-11-30,124,,ATL,1,240,46,88,0.523,28,47,0.596,18,41,0.439,14,15,0.933,124,43,96,0.448,32,60,0.533,11,36,0.306,12,20,0.6,109
381,BOS,2018-11-26,124,@,NOP,1,240,48,97,0.495,29,58,0.5,19,39,0.487,9,10,0.9,124,34,77,0.442,22,45,0.489,12,32,0.375,27,29,0.931,107
382,ATL,2018-11-25,124,,CHO,1,240,50,94,0.532,34,55,0.618,16,39,0.41,8,11,0.727,124,41,92,0.446,23,47,0.489,18,45,0.4,23,28,0.821,123
383,WAS,2018-11-24,124,,NOP,1,240,51,90,0.567,41,61,0.672,10,29,0.345,12,23,0.522,124,43,90,0.478,32,59,0.542,11,31,0.355,17,21,0.81,114
384,CHI,2018-11-21,124,,PHO,1,240,46,81,0.568,35,56,0.625,11,25,0.44,21,24,0.875,124,48,98,0.49,38,64,0.594,10,34,0.294,10,10,1.0,116
385,TOR,2018-11-21,124,@,ATL,1,240,48,90,0.533,37,61,0.607,11,29,0.379,17,23,0.739,124,42,93,0.452,32,57,0.561,10,36,0.278,14,18,0.778,108
386,DET,2018-11-21,124,@,HOU,0,240,40,85,0.471,24,51,0.471,16,34,0.471,28,37,0.757,124,40,72,0.556,27,39,0.692,13,33,0.394,33,36,0.917,126
387,NYK,2018-11-16,124,@,NOP,0,240,48,98,0.49,37,64,0.578,11,34,0.324,17,24,0.708,124,48,99,0.485,38,65,0.585,10,34,0.294,23,32,0.719,129
388,PHI,2018-11-12,124,@,MIA,1,240,39,83,0.47,24,47,0.511,15,36,0.417,31,39,0.795,124,37,77,0.481,24,46,0.522,13,31,0.419,27,33,0.818,114
389,DET,2018-11-09,124,@,ATL,1,240,46,97,0.474,26,50,0.52,20,47,0.426,12,19,0.632,124,36,79,0.456,29,51,0.569,7,28,0.25,30,40,0.75,109
390,TOR,2018-11-05,124,@,UTA,1,240,49,86,0.57,36,53,0.679,13,33,0.394,13,14,0.929,124,38,86,0.442,30,55,0.545,8,31,0.258,27,41,0.659,111
391,MIN,2018-10-29,124,,LAL,1,240,42,98,0.429,28,69,0.406,14,29,0.483,26,30,0.867,124,49,104,0.471,37,71,0.521,12,33,0.364,10,15,0.667,120
392,MIL,2018-10-29,124,,TOR,1,240,45,92,0.489,26,47,0.553,19,45,0.422,15,19,0.789,124,39,103,0.379,30,58,0.517,9,45,0.2,22,28,0.786,109
393,CHI,2018-10-29,124,,GSW,0,240,46,94,0.489,35,59,0.593,11,35,0.314,21,34,0.618,124,53,96,0.552,29,51,0.569,24,45,0.533,19,26,0.731,149
394,MIL,2018-10-22,124,,NYK,1,240,45,96,0.469,28,56,0.5,17,40,0.425,17,24,0.708,124,45,99,0.455,35,70,0.5,10,29,0.345,13,15,0.867,113
395,POR,2018-10-22,124,,WAS,0,265,43,108,0.398,32,69,0.464,11,39,0.282,27,31,0.871,124,46,110,0.418,31,73,0.425,15,37,0.405,18,26,0.692,125
396,HOU,2018-10-20,124,@,LAL,1,240,44,96,0.458,28,54,0.519,16,42,0.381,20,30,0.667,124,48,100,0.48,40,68,0.588,8,32,0.25,11,18,0.611,115
397,GSW,2018-10-19,124,@,UTA,1,240,49,87,0.563,39,68,0.574,10,19,0.526,16,18,0.889,124,40,89,0.449,21,43,0.488,19,46,0.413,24,29,0.828,123
398,OKC,2019-04-05,123,,DET,1,240,48,101,0.475,36,72,0.5,12,29,0.414,15,22,0.682,123,35,81,0.432,20,40,0.5,15,41,0.366,25,31,0.806,110
399,PHI,2019-03-28,123,,BRK,1,240,45,90,0.5,33,65,0.508,12,25,0.48,21,28,0.75,123,40,90,0.444,29,58,0.5,11,32,0.344,19,29,0.655,110
400,ORL,2019-03-22,123,,MEM,1,265,44,93,0.473,30,54,0.556,14,39,0.359,21,27,0.778,123,47,93,0.505,32,55,0.582,15,38,0.395,10,21,0.476,119
401,TOR,2019-03-20,123,@,OKC,1,265,45,87,0.517,31,51,0.608,14,36,0.389,19,21,0.905,123,43,103,0.417,30,60,0.5,13,43,0.302,15,29,0.517,114
402,BRK,2019-03-19,123,@,SAC,1,240,47,94,0.5,35,59,0.593,12,35,0.343,17,23,0.739,123,49,95,0.516,40,70,0.571,9,25,0.36,14,20,0.7,121
403,LAL,2019-03-17,123,@,NYK,0,240,47,97,0.485,40,70,0.571,7,27,0.259,22,28,0.786,123,44,76,0.579,32,50,0.64,12,26,0.462,24,29,0.828,124
404,PHI,2019-03-15,123,,SAC,1,240,46,91,0.505,39,67,0.582,7,24,0.292,24,27,0.889,123,43,94,0.457,34,67,0.507,9,27,0.333,19,24,0.792,114
405,LAL,2019-03-12,123,@,CHI,1,240,47,86,0.547,34,53,0.642,13,33,0.394,16,20,0.8,123,42,91,0.462,31,64,0.484,11,27,0.407,12,12,1.0,107
406,DAL,2019-03-06,123,@,WAS,0,240,45,93,0.484,30,52,0.577,15,41,0.366,18,28,0.643,123,50,93,0.538,38,60,0.633,12,33,0.364,20,25,0.8,132
407,ATL,2019-03-03,123,@,CHI,1,240,42,89,0.472,21,47,0.447,21,42,0.5,18,28,0.643,123,47,92,0.511,39,65,0.6,8,27,0.296,16,21,0.762,118
408,CHO,2019-03-01,123,@,BRK,1,240,50,94,0.532,41,73,0.562,9,21,0.429,14,17,0.824,123,44,86,0.512,34,54,0.63,10,32,0.313,14,18,0.778,112
409,MIN,2019-02-27,123,@,ATL,0,265,44,102,0.431,32,64,0.5,12,38,0.316,23,33,0.697,123,46,108,0.426,34,79,0.43,12,29,0.414,27,32,0.844,131
410,POR,2019-02-25,123,@,CLE,1,240,44,78,0.564,26,49,0.531,18,29,0.621,17,22,0.773,123,37,89,0.416,24,55,0.436,13,34,0.382,23,26,0.885,110
411,DEN,2019-02-24,123,,LAC,1,240,44,85,0.518,32,51,0.627,12,34,0.353,23,35,0.657,123,30,87,0.345,27,66,0.409,3,21,0.143,33,37,0.892,96
412,CHO,2019-02-22,123,,WAS,1,240,46,96,0.479,33,63,0.524,13,33,0.394,18,22,0.818,123,42,97,0.433,32,58,0.552,10,39,0.256,16,18,0.889,110
413,SAC,2019-02-21,123,@,GSW,0,240,43,99,0.434,33,66,0.5,10,33,0.303,27,34,0.794,123,43,94,0.457,24,48,0.5,19,46,0.413,20,24,0.833,125
414,LAC,2019-02-09,123,@,BOS,1,240,40,84,0.476,28,54,0.519,12,30,0.4,31,40,0.775,123,39,92,0.424,30,66,0.455,9,26,0.346,25,31,0.806,112
415,LAL,2019-01-31,123,@,LAC,1,265,42,92,0.457,31,66,0.47,11,26,0.423,28,35,0.8,123,46,104,0.442,32,61,0.525,14,43,0.326,14,26,0.538,120
416,ATL,2019-01-28,123,@,LAC,1,240,44,87,0.506,34,53,0.642,10,34,0.294,25,29,0.862,123,41,85,0.482,31,58,0.534,10,27,0.37,26,28,0.929,118
417,TOR,2019-01-27,123,@,DAL,1,240,37,83,0.446,20,49,0.408,17,34,0.5,32,38,0.842,123,43,88,0.489,32,52,0.615,11,36,0.306,23,34,0.676,120
418,BOS,2019-01-23,123,,CLE,1,240,45,86,0.523,33,61,0.541,12,25,0.48,21,23,0.913,123,38,87,0.437,25,57,0.439,13,30,0.433,14,20,0.7,103
419,OKC,2019-01-22,123,,POR,1,240,43,85,0.506,32,62,0.516,11,23,0.478,26,33,0.788,123,43,95,0.453,33,59,0.559,10,36,0.278,18,22,0.818,114
420,BRK,2019-01-21,123,,SAC,1,240,45,90,0.5,32,55,0.582,13,35,0.371,20,24,0.833,123,39,93,0.419,29,68,0.426,10,25,0.4,6,11,0.545,94
421,ATL,2019-01-11,123,@,PHI,1,240,45,81,0.556,33,56,0.589,12,25,0.48,21,27,0.778,123,45,87,0.517,34,54,0.63,11,33,0.333,20,27,0.741,121
422,WAS,2019-01-09,123,,PHI,1,240,47,87,0.54,34,60,0.567,13,27,0.481,16,21,0.762,123,37,86,0.43,29,59,0.492,8,27,0.296,24,31,0.774,106
423,IND,2019-01-08,123,@,CLE,1,240,49,91,0.538,39,65,0.6,10,26,0.385,15,19,0.789,123,41,76,0.539,28,47,0.596,13,29,0.448,20,23,0.87,115
424,TOR,2019-01-05,123,@,MIL,1,240,42,82,0.512,28,51,0.549,14,31,0.452,25,31,0.806,123,40,81,0.494,26,44,0.591,14,37,0.378,22,27,0.815,116
425,DEN,2019-01-05,123,,CHO,1,240,47,102,0.461,33,63,0.524,14,39,0.359,15,20,0.75,123,39,82,0.476,28,53,0.528,11,29,0.379,21,26,0.808,110
426,SAC,2019-01-05,123,,GSW,0,240,46,97,0.474,26,61,0.426,20,36,0.556,11,14,0.786,123,47,93,0.505,26,46,0.565,21,47,0.447,12,14,0.857,127
427,NOP,2018-12-31,123,,MIN,1,240,45,87,0.517,31,62,0.5,14,25,0.56,19,21,0.905,123,43,93,0.462,34,65,0.523,9,28,0.321,19,23,0.826,114
428,ATL,2018-12-28,123,@,MIN,1,265,47,100,0.47,31,65,0.477,16,35,0.457,13,20,0.65,123,44,98,0.449,33,66,0.5,11,32,0.344,21,38,0.553,120
429,MIL,2018-12-19,123,,NOP,1,240,43,85,0.506,30,52,0.577,13,33,0.394,24,30,0.8,123,43,92,0.467,24,50,0.48,19,42,0.452,10,15,0.667,115
430,MIN,2018-12-19,123,,DET,0,265,45,103,0.437,36,70,0.514,9,33,0.273,24,29,0.828,123,46,94,0.489,26,46,0.565,20,48,0.417,17,28,0.607,129
431,SAS,2018-12-17,123,,PHI,1,240,49,87,0.563,40,64,0.625,9,23,0.391,16,17,0.941,123,40,98,0.408,29,61,0.475,11,37,0.297,5,7,0.714,96
432,TOR,2018-12-11,123,@,LAC,1,240,50,96,0.521,36,67,0.537,14,29,0.483,9,12,0.75,123,38,86,0.442,31,61,0.508,7,25,0.28,16,19,0.842,99
433,LAC,2018-12-10,123,@,PHO,1,265,45,85,0.529,38,64,0.594,7,21,0.333,26,33,0.788,123,47,94,0.5,38,69,0.551,9,25,0.36,16,20,0.8,119
434,PHI,2018-11-30,123,,WAS,1,240,43,98,0.439,31,60,0.517,12,38,0.316,25,33,0.758,123,37,92,0.402,29,64,0.453,8,28,0.286,16,19,0.842,98
435,CHO,2018-11-25,123,@,ATL,0,240,41,92,0.446,23,47,0.489,18,45,0.4,23,28,0.821,123,50,94,0.532,34,55,0.618,16,39,0.41,8,11,0.727,124
436,OKC,2018-11-21,123,@,GSW,1,240,51,106,0.481,38,71,0.535,13,35,0.371,8,15,0.533,123,36,83,0.434,29,54,0.537,7,29,0.241,16,24,0.667,95
437,MIL,2018-11-16,123,,CHI,1,240,47,93,0.505,29,50,0.58,18,43,0.419,11,17,0.647,123,41,94,0.436,28,61,0.459,13,33,0.394,9,13,0.692,104
438,BOS,2018-11-16,123,,TOR,1,265,47,89,0.528,38,63,0.603,9,26,0.346,20,24,0.833,123,42,97,0.433,34,68,0.5,8,29,0.276,24,29,0.828,116
439,UTA,2018-11-09,123,,BOS,1,240,43,77,0.558,30,43,0.698,13,34,0.382,24,30,0.8,123,39,88,0.443,22,45,0.489,17,43,0.395,20,22,0.909,115
440,ATL,2018-11-03,123,,MIA,1,240,46,88,0.523,33,56,0.589,13,32,0.406,18,23,0.783,123,41,85,0.482,25,45,0.556,16,40,0.4,20,26,0.769,118
441,SAC,2018-10-29,123,@,MIA,1,240,48,97,0.495,36,71,0.507,12,26,0.462,15,25,0.6,123,38,92,0.413,25,53,0.472,13,39,0.333,24,34,0.706,113
442,MIL,2018-10-24,123,,PHI,1,240,41,100,0.41,28,57,0.491,13,43,0.302,28,30,0.933,123,38,92,0.413,27,58,0.466,11,34,0.324,21,30,0.7,108
443,GSW,2018-10-22,123,,PHO,1,240,45,88,0.511,31,51,0.608,14,37,0.378,19,26,0.731,123,39,86,0.453,30,52,0.577,9,34,0.265,16,18,0.889,103
444,UTA,2018-10-19,123,,GSW,0,240,40,89,0.449,21,43,0.488,19,46,0.413,24,29,0.828,123,49,87,0.563,39,68,0.574,10,19,0.526,16,18,0.889,124
445,CLE,2018-10-19,123,@,MIN,0,240,45,93,0.484,37,70,0.529,8,23,0.348,25,29,0.862,123,44,87,0.506,34,62,0.548,10,25,0.4,33,35,0.943,131
446,UTA,2018-10-17,123,@,SAC,1,240,41,79,0.519,28,52,0.538,13,27,0.481,28,38,0.737,123,49,95,0.516,42,76,0.553,7,19,0.368,12,18,0.667,117
447,ORL,2019-04-10,122,@,CHO,1,240,48,88,0.545,37,58,0.638,11,30,0.367,15,20,0.75,122,41,78,0.526,33,49,0.673,8,29,0.276,24,27,0.889,114
448,MIA,2019-04-09,122,,PHI,1,240,46,87,0.529,33,60,0.55,13,27,0.481,17,23,0.739,122,40,98,0.408,35,73,0.479,5,25,0.2,14,16,0.875,99
449,MEM,2019-04-05,122,@,DAL,1,240,46,96,0.479,30,55,0.545,16,41,0.39,14,16,0.875,122,41,96,0.427,24,49,0.49,17,47,0.362,13,21,0.619,112
450,LAL,2019-04-05,122,@,LAC,1,240,43,96,0.448,29,64,0.453,14,32,0.438,22,27,0.815,122,40,91,0.44,30,62,0.484,10,29,0.345,27,31,0.871,117
451,PHI,2019-04-04,122,,MIL,0,240,45,95,0.474,27,59,0.458,18,36,0.5,14,18,0.778,122,42,93,0.452,30,59,0.508,12,34,0.353,32,43,0.744,128
452,PHI,2019-04-03,122,@,ATL,0,240,45,98,0.459,35,67,0.522,10,31,0.323,22,38,0.579,122,48,92,0.522,36,56,0.643,12,36,0.333,22,28,0.786,130
453,DAL,2019-04-01,122,,PHI,1,240,46,97,0.474,34,65,0.523,12,32,0.375,18,27,0.667,122,36,93,0.387,30,60,0.5,6,33,0.182,24,32,0.75,102
454,PHO,2019-04-01,122,,CLE,1,240,46,84,0.548,33,47,0.702,13,37,0.351,17,20,0.85,122,45,99,0.455,37,77,0.481,8,22,0.364,15,22,0.682,113
455,MIN,2019-04-01,122,,POR,0,240,47,96,0.49,36,67,0.537,11,29,0.379,17,19,0.895,122,50,91,0.549,35,61,0.574,15,30,0.5,17,24,0.708,132
456,LAC,2019-03-26,122,@,MIN,1,240,46,85,0.541,30,53,0.566,16,32,0.5,14,14,1.0,122,41,94,0.436,32,67,0.478,9,27,0.333,20,33,0.606,111
457,POR,2019-03-15,122,@,NOP,1,240,43,96,0.448,33,69,0.478,10,27,0.37,26,32,0.813,122,45,94,0.479,37,64,0.578,8,30,0.267,12,25,0.48,110
458,GSW,2019-03-08,122,,DEN,1,240,45,84,0.536,27,49,0.551,18,35,0.514,14,21,0.667,122,33,87,0.379,21,54,0.389,12,33,0.364,27,35,0.771,105
459,IND,2019-02-28,122,,MIN,1,240,40,84,0.476,24,57,0.421,16,27,0.593,26,31,0.839,122,42,89,0.472,34,63,0.54,8,26,0.308,23,34,0.676,115
460,ATL,2019-02-22,122,,DET,0,240,43,88,0.489,23,46,0.5,20,42,0.476,16,19,0.842,122,46,95,0.484,31,55,0.564,15,40,0.375,18,28,0.643,125
461,OKC,2019-02-14,122,@,NOP,0,240,50,106,0.472,40,62,0.645,10,44,0.227,12,13,0.923,122,50,92,0.543,38,66,0.576,12,26,0.462,19,24,0.792,131
462,CHI,2019-02-13,122,,MEM,1,240,45,80,0.563,37,60,0.617,8,20,0.4,24,29,0.828,122,43,89,0.483,32,58,0.552,11,31,0.355,13,17,0.765,110
463,NOP,2019-02-08,122,,MIN,1,240,43,91,0.473,34,61,0.557,9,30,0.3,27,28,0.964,122,46,91,0.505,37,70,0.529,9,21,0.429,16,22,0.727,117
464,MIL,2019-02-08,122,@,DAL,1,240,51,93,0.548,41,57,0.719,10,36,0.278,10,12,0.833,122,36,87,0.414,14,34,0.412,22,53,0.415,13,20,0.65,107
465,ORL,2019-02-07,122,,MIN,1,240,45,83,0.542,34,57,0.596,11,26,0.423,21,23,0.913,122,46,99,0.465,36,73,0.493,10,26,0.385,10,12,0.833,112
466,ORL,2019-02-05,122,@,OKC,0,240,42,90,0.467,31,53,0.585,11,37,0.297,27,34,0.794,122,46,92,0.5,33,62,0.532,13,30,0.433,27,37,0.73,132
467,HOU,2019-02-01,122,@,DEN,0,240,45,85,0.529,29,41,0.707,16,44,0.364,16,21,0.762,122,51,82,0.622,37,51,0.725,14,31,0.452,20,23,0.87,136
468,BRK,2019-01-29,122,,CHI,1,240,42,94,0.447,32,59,0.542,10,35,0.286,28,40,0.7,122,47,94,0.5,38,66,0.576,9,28,0.321,14,19,0.737,117
469,LAC,2019-01-27,122,,SAC,1,240,42,88,0.477,31,59,0.525,11,29,0.379,27,29,0.931,122,37,93,0.398,29,57,0.509,8,36,0.222,26,30,0.867,108
470,OKC,2019-01-24,122,,NOP,1,240,50,101,0.495,36,69,0.522,14,32,0.438,8,16,0.5,122,49,101,0.485,39,65,0.6,10,36,0.278,8,12,0.667,116
471,PHI,2019-01-23,122,,SAS,1,240,47,93,0.505,30,57,0.526,17,36,0.472,11,14,0.786,122,47,82,0.573,34,55,0.618,13,27,0.481,13,15,0.867,120
472,ORL,2019-01-21,122,@,ATL,1,240,46,91,0.505,35,62,0.565,11,29,0.379,19,21,0.905,122,39,86,0.453,30,56,0.536,9,30,0.3,16,23,0.696,103
473,BOS,2019-01-18,122,,MEM,1,240,44,86,0.512,27,48,0.563,17,38,0.447,17,22,0.773,122,41,92,0.446,25,57,0.439,16,35,0.457,18,20,0.9,116
474,OKC,2019-01-12,122,,SAS,1,240,43,93,0.462,32,70,0.457,11,23,0.478,25,29,0.862,122,44,96,0.458,34,65,0.523,10,31,0.323,14,20,0.7,112
475,TOR,2019-01-11,122,,BRK,1,240,48,105,0.457,37,70,0.529,11,35,0.314,15,24,0.625,122,37,88,0.42,26,58,0.448,11,30,0.367,20,30,0.667,105
476,GSW,2019-01-08,122,,NYK,1,240,49,96,0.51,35,51,0.686,14,45,0.311,10,12,0.833,122,35,88,0.398,29,64,0.453,6,24,0.25,19,21,0.905,95
477,DAL,2019-01-02,122,@,CHO,1,240,44,95,0.463,26,50,0.52,18,45,0.4,16,18,0.889,122,32,90,0.356,26,58,0.448,6,32,0.188,14,19,0.737,84
478,TOR,2019-01-01,122,,UTA,1,240,45,82,0.549,38,62,0.613,7,20,0.35,25,35,0.714,122,42,97,0.433,33,65,0.508,9,32,0.281,23,29,0.793,116
479,OKC,2018-12-31,122,,DAL,1,240,46,103,0.447,40,79,0.506,6,24,0.25,24,35,0.686,122,31,74,0.419,17,36,0.472,14,38,0.368,26,34,0.765,102
480,SAS,2018-12-29,122,@,LAC,1,240,44,87,0.506,38,64,0.594,6,23,0.261,28,31,0.903,122,36,82,0.439,27,62,0.435,9,20,0.45,30,38,0.789,111
481,DEN,2018-12-29,122,@,PHO,1,240,42,76,0.553,24,41,0.585,18,35,0.514,20,26,0.769,122,49,91,0.538,38,62,0.613,11,29,0.379,9,14,0.643,118
482,PHO,2018-12-26,122,@,ORL,1,265,48,95,0.505,35,71,0.493,13,24,0.542,13,17,0.765,122,44,96,0.458,30,60,0.5,14,36,0.389,18,22,0.818,120
483,DAL,2018-12-26,122,,NOP,1,240,39,81,0.481,27,46,0.587,12,35,0.343,32,38,0.842,122,42,90,0.467,30,63,0.476,12,27,0.444,23,30,0.767,119
484,SAC,2018-12-23,122,,NOP,1,240,42,100,0.42,28,69,0.406,14,31,0.452,24,33,0.727,122,44,94,0.468,38,68,0.559,6,26,0.231,23,28,0.821,117
485,TOR,2018-12-14,122,@,POR,0,240,43,78,0.551,25,47,0.532,18,31,0.581,18,21,0.857,122,48,94,0.511,35,67,0.522,13,27,0.481,19,21,0.905,128
486,OKC,2018-12-10,122,,UTA,1,240,43,85,0.506,35,64,0.547,8,21,0.381,28,39,0.718,122,43,84,0.512,35,55,0.636,8,29,0.276,19,30,0.633,113
487,SAC,2018-12-04,122,@,PHO,1,240,45,84,0.536,34,60,0.567,11,24,0.458,21,32,0.656,122,38,87,0.437,26,44,0.591,12,43,0.279,17,21,0.81,105
488,TOR,2018-11-27,122,@,MEM,1,240,42,69,0.609,24,36,0.667,18,33,0.545,20,28,0.714,122,43,85,0.506,33,56,0.589,10,29,0.345,18,21,0.857,114
489,PHI,2018-11-17,122,@,CHO,1,265,39,93,0.419,28,58,0.483,11,35,0.314,33,38,0.868,122,42,99,0.424,32,68,0.471,10,31,0.323,25,27,0.926,119
490,TOR,2018-11-17,122,@,CHI,1,240,48,89,0.539,34,54,0.63,14,35,0.4,12,13,0.923,122,30,86,0.349,22,59,0.373,8,27,0.296,15,21,0.714,83
491,OKC,2018-11-05,122,,NOP,1,240,45,93,0.484,35,66,0.53,10,27,0.37,22,31,0.71,122,41,84,0.488,32,55,0.582,9,29,0.31,25,30,0.833,116
492,BRK,2018-11-04,122,,PHI,1,240,50,105,0.476,41,77,0.532,9,28,0.321,13,18,0.722,122,31,65,0.477,27,45,0.6,4,20,0.2,31,41,0.756,97
493,PHI,2018-11-01,122,,LAC,1,240,44,93,0.473,31,66,0.47,13,27,0.481,21,28,0.75,122,38,86,0.442,29,63,0.46,9,23,0.391,28,33,0.848,113
494,WAS,2018-10-24,122,@,GSW,0,240,42,93,0.452,30,51,0.588,12,42,0.286,26,28,0.929,122,53,92,0.576,38,59,0.644,15,33,0.455,23,25,0.92,144
495,TOR,2019-04-01,121,,ORL,1,240,42,84,0.5,23,47,0.489,19,37,0.514,18,22,0.818,121,43,93,0.462,31,60,0.517,12,33,0.364,11,15,0.733,109
496,BRK,2019-04-01,121,,MIL,0,240,39,94,0.415,23,50,0.46,16,44,0.364,27,34,0.794,121,47,94,0.5,36,60,0.6,11,34,0.324,26,30,0.867,131
497,ORL,2019-03-30,121,@,IND,1,240,47,92,0.511,32,54,0.593,15,38,0.395,12,14,0.857,121,48,90,0.533,39,66,0.591,9,24,0.375,11,17,0.647,116
498,NOP,2019-03-28,121,,SAC,1,240,49,97,0.505,40,69,0.58,9,28,0.321,14,14,1.0,121,47,95,0.495,37,72,0.514,10,23,0.435,14,16,0.875,118
499,PHO,2019-03-27,121,,WAS,0,240,43,87,0.494,29,50,0.58,14,37,0.378,21,26,0.808,121,43,90,0.478,34,65,0.523,9,25,0.36,29,43,0.674,124
500,DAL,2019-03-26,121,,SAC,0,240,39,77,0.506,24,32,0.75,15,45,0.333,28,32,0.875,121,44,87,0.506,34,64,0.531,10,23,0.435,27,32,0.844,125
501,GSW,2019-03-24,121,,DET,1,240,46,74,0.622,33,49,0.673,13,25,0.52,16,19,0.842,121,39,84,0.464,27,53,0.509,12,31,0.387,24,25,0.96,114
502,HOU,2019-03-19,121,@,ATL,1,240,40,78,0.513,21,31,0.677,19,47,0.404,22,30,0.733,121,39,84,0.464,24,44,0.545,15,40,0.375,12,15,0.8,105
503,SAC,2019-03-19,121,,BRK,0,240,49,95,0.516,40,70,0.571,9,25,0.36,14,20,0.7,121,47,94,0.5,35,59,0.593,12,35,0.343,17,23,0.739,123
504,DAL,2019-03-16,121,,CLE,1,240,46,89,0.517,30,55,0.545,16,34,0.471,13,16,0.813,121,40,86,0.465,25,48,0.521,15,38,0.395,21,22,0.955,116
505,CHI,2019-03-15,121,@,LAC,0,240,42,80,0.525,31,59,0.525,11,21,0.524,26,33,0.788,121,44,99,0.444,34,79,0.43,10,20,0.5,30,35,0.857,128
506,WAS,2019-03-11,121,,SAC,1,240,40,86,0.465,26,49,0.531,14,37,0.378,27,33,0.818,121,41,91,0.451,32,64,0.5,9,27,0.333,24,32,0.75,115
507,SAS,2019-03-10,121,,MIL,1,240,49,100,0.49,37,71,0.521,12,29,0.414,11,15,0.733,121,41,87,0.471,27,51,0.529,14,36,0.389,18,25,0.72,114
508,POR,2019-03-07,121,,OKC,0,265,37,94,0.394,28,53,0.528,9,41,0.22,38,47,0.809,121,48,105,0.457,40,78,0.513,8,27,0.296,25,32,0.781,129
509,MIN,2019-03-03,121,@,WAS,0,240,52,99,0.525,48,72,0.667,4,27,0.148,13,19,0.684,121,49,98,0.5,38,65,0.585,11,33,0.333,26,32,0.813,135
510,HOU,2019-02-28,121,,MIA,1,240,38,77,0.494,19,31,0.613,19,46,0.413,26,28,0.929,121,42,81,0.519,27,53,0.509,15,28,0.536,19,24,0.792,118
511,DEN,2019-02-26,121,,OKC,1,240,41,88,0.466,28,60,0.467,13,28,0.464,26,35,0.743,121,43,95,0.453,33,57,0.579,10,38,0.263,16,25,0.64,112
512,GSW,2019-02-25,121,@,CHO,1,240,48,95,0.505,34,54,0.63,14,41,0.341,11,13,0.846,121,40,91,0.44,33,58,0.569,7,33,0.212,23,26,0.885,110
513,LAC,2019-02-25,121,,DAL,1,240,45,100,0.45,28,55,0.509,17,45,0.378,14,18,0.778,121,37,76,0.487,23,40,0.575,14,36,0.389,24,27,0.889,112
514,MIA,2019-02-25,121,,PHO,0,240,48,97,0.495,39,68,0.574,9,29,0.31,16,20,0.8,121,45,89,0.506,32,57,0.561,13,32,0.406,21,25,0.84,124
515,MIN,2019-02-13,121,,HOU,1,240,49,90,0.544,39,70,0.557,10,20,0.5,13,17,0.765,121,40,98,0.408,21,45,0.467,19,53,0.358,12,13,0.923,111
516,DET,2019-02-11,121,,WAS,1,240,44,85,0.518,29,49,0.592,15,36,0.417,18,21,0.857,121,42,84,0.5,28,45,0.622,14,39,0.359,14,19,0.737,112
517,TOR,2019-02-03,121,,LAC,1,240,43,94,0.457,34,61,0.557,9,33,0.273,26,31,0.839,121,38,89,0.427,36,77,0.468,2,12,0.167,25,29,0.862,103
518,PHI,2019-01-29,121,@,LAL,1,240,42,93,0.452,27,57,0.474,15,36,0.417,22,28,0.786,121,43,92,0.467,36,69,0.522,7,23,0.304,12,16,0.75,105
519,NOP,2019-01-29,121,@,HOU,1,240,46,90,0.511,37,59,0.627,9,31,0.29,20,25,0.8,121,40,101,0.396,21,45,0.467,19,56,0.339,17,24,0.708,116
520,HOU,2019-01-25,121,,TOR,1,240,41,91,0.451,31,45,0.689,10,46,0.217,29,33,0.879,121,44,91,0.484,30,55,0.545,14,36,0.389,17,18,0.944,119
521,ATL,2019-01-23,121,@,CHI,1,240,45,90,0.5,30,50,0.6,15,40,0.375,16,21,0.762,121,35,79,0.443,27,53,0.509,8,26,0.308,23,27,0.852,101
522,PHI,2019-01-21,121,,HOU,1,240,43,88,0.489,35,65,0.538,8,23,0.348,27,33,0.818,121,31,86,0.36,20,44,0.455,11,42,0.262,20,26,0.769,93
523,NOP,2019-01-14,121,@,LAC,1,240,46,105,0.438,38,80,0.475,8,25,0.32,21,28,0.75,121,41,86,0.477,23,50,0.46,18,36,0.5,17,24,0.708,117
524,PHI,2019-01-11,121,,ATL,0,240,45,87,0.517,34,54,0.63,11,33,0.333,20,27,0.741,121,45,81,0.556,33,56,0.589,12,25,0.48,21,27,0.778,123
525,IND,2019-01-11,121,@,NYK,1,240,49,94,0.521,37,68,0.544,12,26,0.462,11,11,1.0,121,39,88,0.443,25,49,0.51,14,39,0.359,14,16,0.875,106
526,DEN,2019-01-10,121,,LAC,1,240,50,99,0.505,39,71,0.549,11,28,0.393,10,13,0.769,121,38,87,0.437,32,63,0.508,6,24,0.25,18,26,0.692,100
527,TOR,2019-01-06,121,,IND,1,240,44,85,0.518,27,52,0.519,17,33,0.515,16,17,0.941,121,43,94,0.457,39,77,0.506,4,17,0.235,15,20,0.75,105
528,LAC,2019-01-04,121,@,PHO,1,240,43,84,0.512,33,60,0.55,10,24,0.417,25,32,0.781,121,41,77,0.532,32,58,0.552,9,19,0.474,20,27,0.741,111
529,NOP,2019-01-02,121,@,BRK,0,240,46,87,0.529,36,64,0.563,10,23,0.435,19,27,0.704,121,47,93,0.505,31,62,0.5,16,31,0.516,16,21,0.762,126
530,MIL,2019-01-01,121,,DET,1,240,47,79,0.595,37,52,0.712,10,27,0.37,17,26,0.654,121,35,92,0.38,23,59,0.39,12,33,0.364,16,21,0.762,98
531,LAL,2018-12-30,121,,SAC,1,240,47,98,0.48,32,54,0.593,15,44,0.341,12,20,0.6,121,46,95,0.484,33,61,0.541,13,34,0.382,9,12,0.75,114
532,ATL,2018-12-26,121,,IND,0,240,45,89,0.506,28,53,0.528,17,36,0.472,14,18,0.778,121,46,83,0.554,33,56,0.589,13,27,0.481,24,33,0.727,129
533,BOS,2018-12-25,121,,PHI,1,265,45,108,0.417,31,67,0.463,14,41,0.341,17,20,0.85,121,38,92,0.413,23,52,0.442,15,40,0.375,23,29,0.793,114
534,POR,2018-12-23,121,,DAL,1,265,49,104,0.471,38,66,0.576,11,38,0.289,12,17,0.706,121,43,103,0.417,31,69,0.449,12,34,0.353,20,28,0.714,118
535,DAL,2018-12-20,121,@,LAC,0,240,43,92,0.467,33,64,0.516,10,28,0.357,25,33,0.758,121,47,83,0.566,41,63,0.651,6,20,0.3,25,31,0.806,125
536,OKC,2018-12-17,121,,CHI,1,240,43,89,0.483,35,68,0.515,8,21,0.381,27,33,0.818,121,38,85,0.447,30,63,0.476,8,22,0.364,12,16,0.75,96
537,MIA,2018-12-08,121,@,LAC,1,240,40,92,0.435,27,53,0.509,13,39,0.333,28,39,0.718,121,33,89,0.371,26,60,0.433,7,29,0.241,25,31,0.806,98
538,LAL,2018-12-05,121,,SAS,1,240,42,88,0.477,28,49,0.571,14,39,0.359,23,33,0.697,121,43,96,0.448,36,69,0.522,7,27,0.259,20,20,1.0,113
539,MIN,2018-12-05,121,,CHO,1,240,48,89,0.539,36,65,0.554,12,24,0.5,13,20,0.65,121,40,98,0.408,28,65,0.431,12,33,0.364,12,15,0.8,104
540,HOU,2018-12-01,121,,CHI,1,240,42,84,0.5,26,43,0.605,16,41,0.39,21,30,0.7,121,39,88,0.443,31,56,0.554,8,32,0.25,19,24,0.792,105
541,SAC,2018-11-29,121,,LAC,0,240,46,96,0.479,39,72,0.542,7,24,0.292,22,26,0.846,121,50,90,0.556,38,62,0.613,12,28,0.429,21,28,0.75,133
542,IND,2018-11-26,121,@,UTA,1,240,49,84,0.583,40,66,0.606,9,18,0.5,14,17,0.824,121,34,81,0.42,26,50,0.52,8,31,0.258,12,17,0.706,88
543,CLE,2018-11-23,121,@,PHI,1,240,49,93,0.527,38,71,0.535,11,22,0.5,12,16,0.75,121,40,75,0.533,28,42,0.667,12,33,0.364,20,26,0.769,112
544,PHI,2018-11-21,121,,NOP,1,240,44,98,0.449,34,69,0.493,10,29,0.345,23,26,0.885,121,42,98,0.429,31,68,0.456,11,30,0.367,25,33,0.758,120
545,IND,2018-11-19,121,,UTA,1,240,49,93,0.527,37,68,0.544,12,25,0.48,11,17,0.647,121,36,74,0.486,25,49,0.51,11,25,0.44,11,16,0.688,94
546,LAC,2018-11-12,121,,GSW,1,265,43,91,0.473,38,71,0.535,5,20,0.25,30,34,0.882,121,44,94,0.468,32,63,0.508,12,31,0.387,16,23,0.696,116
547,MIL,2018-11-11,121,@,DEN,1,240,48,84,0.571,31,50,0.62,17,34,0.5,8,13,0.615,121,41,89,0.461,23,51,0.451,18,38,0.474,14,20,0.7,114
548,SAC,2018-11-09,121,,MIN,1,240,43,95,0.453,31,63,0.492,12,32,0.375,23,29,0.793,121,39,94,0.415,32,69,0.464,7,25,0.28,25,31,0.806,110
549,TOR,2018-11-04,121,@,LAL,1,240,49,98,0.5,39,63,0.619,10,35,0.286,13,14,0.929,121,39,85,0.459,33,61,0.541,6,24,0.25,23,29,0.793,107
550,NOP,2018-10-31,121,@,GSW,0,240,44,92,0.478,32,57,0.561,12,35,0.343,21,27,0.778,121,47,89,0.528,31,57,0.544,16,32,0.5,21,30,0.7,131
551,LAL,2018-10-25,121,,DEN,1,240,46,92,0.5,36,63,0.571,10,29,0.345,19,23,0.826,121,46,92,0.5,40,69,0.58,6,23,0.261,16,20,0.8,114
552,POR,2018-10-20,121,,SAS,1,240,45,84,0.536,30,52,0.577,15,32,0.469,16,19,0.842,121,42,100,0.42,29,70,0.414,13,30,0.433,11,14,0.786,108
553,PHO,2018-10-17,121,,DAL,1,240,44,81,0.543,25,47,0.532,19,34,0.559,14,16,0.875,121,38,88,0.432,28,55,0.509,10,33,0.303,14,20,0.7,100
554,DAL,2019-04-09,120,,PHO,1,240,41,91,0.451,25,51,0.49,16,40,0.4,22,27,0.815,120,38,88,0.432,25,53,0.472,13,35,0.371,20,28,0.714,109
555,TOR,2019-04-09,120,@,MIN,1,240,46,88,0.523,30,51,0.588,16,37,0.432,12,17,0.706,120,38,91,0.418,25,49,0.51,13,42,0.31,11,14,0.786,100
556,HOU,2019-04-05,120,,NYK,1,240,43,101,0.426,21,42,0.5,22,59,0.373,12,17,0.706,120,37,82,0.451,31,55,0.564,6,27,0.222,16,27,0.593,96
557,GSW,2019-04-05,120,,CLE,1,240,46,87,0.529,26,50,0.52,20,37,0.541,8,8,1.0,120,43,97,0.443,36,67,0.537,7,30,0.233,21,23,0.913,114
558,MEM,2019-03-30,120,@,PHO,1,240,41,89,0.461,33,64,0.516,8,25,0.32,30,40,0.75,120,43,81,0.531,31,53,0.585,12,28,0.429,17,23,0.739,115
559,NOP,2019-03-26,120,,ATL,0,240,39,83,0.47,27,49,0.551,12,34,0.353,30,40,0.75,120,44,97,0.454,25,46,0.543,19,51,0.373,23,26,0.885,130
560,WAS,2019-03-20,120,@,CHI,0,265,44,93,0.473,30,51,0.588,14,42,0.333,18,23,0.783,120,50,106,0.472,38,83,0.458,12,23,0.522,14,17,0.824,126
561,ATL,2019-03-16,120,@,BOS,0,240,43,100,0.43,28,60,0.467,15,40,0.375,19,24,0.792,120,44,93,0.473,31,57,0.544,13,36,0.361,28,37,0.757,129
562,SAC,2019-03-14,120,@,BOS,0,240,48,95,0.505,37,61,0.607,11,34,0.324,13,23,0.565,120,49,97,0.505,40,69,0.58,9,28,0.321,19,26,0.731,126
563,ORL,2019-03-14,120,,CLE,1,240,45,93,0.484,31,62,0.5,14,31,0.452,16,21,0.762,120,35,86,0.407,28,55,0.509,7,31,0.226,14,15,0.933,91
564,UTA,2019-03-14,120,,MIN,1,240,44,89,0.494,31,51,0.608,13,38,0.342,19,27,0.704,120,42,91,0.462,37,67,0.552,5,24,0.208,11,15,0.733,100
565,PHO,2019-03-09,120,@,POR,0,240,43,103,0.417,34,76,0.447,9,27,0.333,25,29,0.862,120,43,86,0.5,30,57,0.526,13,29,0.448,28,36,0.778,127
566,BOS,2019-03-09,120,@,LAL,1,240,48,93,0.516,34,55,0.618,14,38,0.368,10,14,0.714,120,44,91,0.484,39,64,0.609,5,27,0.185,14,18,0.778,107
567,MEM,2019-03-05,120,,POR,1,240,40,75,0.533,27,48,0.563,13,27,0.481,27,36,0.75,120,42,79,0.532,33,50,0.66,9,29,0.31,18,21,0.857,111
568,OKC,2019-03-05,120,@,MIN,0,240,42,94,0.447,24,48,0.5,18,46,0.391,18,31,0.581,120,47,89,0.528,36,67,0.537,11,22,0.5,26,35,0.743,131
569,NOP,2019-03-02,120,@,DEN,1,240,45,92,0.489,33,62,0.532,12,30,0.4,18,26,0.692,120,39,92,0.424,30,60,0.5,9,32,0.281,25,29,0.862,112
570,GSW,2019-03-02,120,@,PHI,1,240,41,81,0.506,27,48,0.563,14,33,0.424,24,34,0.706,120,39,87,0.448,25,56,0.446,14,31,0.452,25,29,0.862,117
571,LAL,2019-03-01,120,,MIL,0,240,46,96,0.479,33,56,0.589,13,40,0.325,15,18,0.833,120,48,93,0.516,34,53,0.642,14,40,0.35,21,24,0.875,131
572,ATL,2019-02-23,120,,PHO,1,240,38,92,0.413,26,59,0.441,12,33,0.364,32,38,0.842,120,41,93,0.441,28,56,0.5,13,37,0.351,17,20,0.85,112
573,TOR,2019-02-22,120,,SAS,1,240,40,94,0.426,26,64,0.406,14,30,0.467,26,32,0.813,120,43,89,0.483,31,52,0.596,12,37,0.324,19,22,0.864,117
574,WAS,2019-02-13,120,@,TOR,0,240,37,84,0.44,23,44,0.523,14,40,0.35,32,39,0.821,120,44,92,0.478,28,54,0.519,16,38,0.421,25,30,0.833,129
575,DEN,2019-02-13,120,,SAC,1,240,45,99,0.455,37,68,0.544,8,31,0.258,22,25,0.88,120,42,93,0.452,31,61,0.508,11,32,0.344,23,28,0.821,118
576,HOU,2019-02-11,120,,DAL,1,240,42,90,0.467,19,30,0.633,23,60,0.383,13,15,0.867,120,35,73,0.479,22,37,0.595,13,36,0.361,21,27,0.778,104
577,OKC,2019-02-11,120,,POR,1,240,41,86,0.477,25,51,0.49,16,35,0.457,22,29,0.759,120,36,87,0.414,25,58,0.431,11,29,0.379,28,38,0.737,111
578,LAC,2019-02-11,120,@,MIN,0,240,37,72,0.514,25,43,0.581,12,29,0.414,34,39,0.872,120,47,90,0.522,41,72,0.569,6,18,0.333,30,36,0.833,130
579,GSW,2019-02-10,120,,MIA,1,240,44,82,0.537,31,46,0.674,13,36,0.361,19,26,0.731,120,48,105,0.457,30,62,0.484,18,43,0.419,4,8,0.5,118
580,LAL,2019-02-10,120,@,PHI,0,240,48,93,0.516,38,66,0.576,10,27,0.37,14,19,0.737,120,56,97,0.577,44,73,0.603,12,24,0.5,19,22,0.864,143
581,ATL,2019-02-09,120,,CHO,0,240,46,86,0.535,32,53,0.604,14,33,0.424,14,19,0.737,120,48,88,0.545,29,46,0.63,19,42,0.452,14,18,0.778,129
582,DET,2019-02-08,120,,NYK,1,240,42,86,0.488,29,56,0.518,13,30,0.433,23,29,0.793,120,35,78,0.449,28,56,0.5,7,22,0.318,26,41,0.634,103
583,CHI,2019-02-06,120,,NOP,0,240,45,91,0.495,29,55,0.527,16,36,0.444,14,19,0.737,120,45,85,0.529,30,50,0.6,15,35,0.429,20,30,0.667,125
584,LAC,2019-01-31,120,,LAL,0,265,46,104,0.442,32,61,0.525,14,43,0.326,14,26,0.538,120,42,92,0.457,31,66,0.47,11,26,0.423,28,35,0.8,123
585,DAL,2019-01-27,120,,TOR,0,240,43,88,0.489,32,52,0.615,11,36,0.306,23,34,0.676,120,37,83,0.446,20,49,0.408,17,34,0.5,32,38,0.842,123
586,POR,2019-01-26,120,,ATL,1,240,41,82,0.5,30,52,0.577,11,30,0.367,27,30,0.9,120,42,92,0.457,30,59,0.508,12,33,0.364,15,20,0.75,111
587,POR,2019-01-24,120,@,PHO,1,240,44,94,0.468,32,68,0.471,12,26,0.462,20,20,1.0,120,36,88,0.409,23,50,0.46,13,38,0.342,21,27,0.778,106
588,MIN,2019-01-24,120,@,LAL,1,240,44,102,0.431,34,69,0.493,10,33,0.303,22,25,0.88,120,44,87,0.506,36,59,0.61,8,28,0.286,9,14,0.643,105
589,SAS,2019-01-23,120,@,PHI,0,240,47,82,0.573,34,55,0.618,13,27,0.481,13,15,0.867,120,47,93,0.505,30,57,0.526,17,36,0.472,11,14,0.786,122
590,TOR,2019-01-22,120,,SAC,1,240,40,91,0.44,24,51,0.471,16,40,0.4,24,35,0.686,120,41,91,0.451,34,70,0.486,7,21,0.333,16,22,0.727,105
591,IND,2019-01-20,120,,CHO,1,240,47,100,0.47,33,73,0.452,14,27,0.519,12,12,1.0,120,33,82,0.402,21,47,0.447,12,35,0.343,17,25,0.68,95
592,PHI,2019-01-17,120,@,IND,1,240,46,87,0.529,28,53,0.528,18,34,0.529,10,11,0.909,120,39,97,0.402,30,68,0.441,9,29,0.31,9,12,0.75,96
593,DET,2019-01-16,120,,ORL,1,265,44,92,0.478,32,62,0.516,12,30,0.4,20,25,0.8,120,47,94,0.5,33,55,0.6,14,39,0.359,7,13,0.538,115
594,MIN,2019-01-04,120,,ORL,1,240,47,91,0.516,38,65,0.585,9,26,0.346,17,23,0.739,120,42,88,0.477,33,61,0.541,9,27,0.333,10,19,0.526,103
595,SAS,2018-12-31,120,,BOS,1,240,45,91,0.495,31,65,0.477,14,26,0.538,16,18,0.889,120,43,88,0.489,32,54,0.593,11,34,0.324,14,20,0.7,111
596,MIN,2018-12-28,120,,ATL,0,265,44,98,0.449,33,66,0.5,11,32,0.344,21,38,0.553,120,47,100,0.47,31,65,0.477,16,35,0.457,13,20,0.65,123
597,ORL,2018-12-26,120,,PHO,0,265,44,96,0.458,30,60,0.5,14,36,0.389,18,22,0.818,120,48,95,0.505,35,71,0.493,13,24,0.542,13,17,0.765,122
598,GSW,2018-12-22,120,,DAL,1,240,45,98,0.459,30,55,0.545,15,43,0.349,15,16,0.938,120,42,92,0.457,28,53,0.528,14,39,0.359,18,28,0.643,116
599,MIL,2018-12-21,120,@,BOS,1,240,41,80,0.513,25,40,0.625,16,40,0.4,22,28,0.786,120,35,91,0.385,25,57,0.439,10,34,0.294,27,36,0.75,107
600,UTA,2018-12-21,120,@,POR,1,240,47,85,0.553,31,54,0.574,16,31,0.516,10,17,0.588,120,35,87,0.402,25,55,0.455,10,32,0.313,10,18,0.556,90
601,SAC,2018-12-16,120,@,DAL,1,240,46,98,0.469,37,67,0.552,9,31,0.29,19,21,0.905,120,40,96,0.417,31,61,0.508,9,35,0.257,24,31,0.774,113
602,LAL,2018-12-07,120,@,SAS,0,240,46,100,0.46,35,64,0.547,11,36,0.306,17,21,0.81,120,46,91,0.505,33,60,0.55,13,31,0.419,28,33,0.848,133
603,LAL,2018-12-02,120,,PHO,1,240,46,92,0.5,35,65,0.538,11,27,0.407,17,23,0.739,120,37,93,0.398,24,60,0.4,13,33,0.394,9,11,0.818,96
604,NOP,2018-11-21,120,@,PHI,0,240,42,98,0.429,31,68,0.456,11,30,0.367,25,33,0.758,120,44,98,0.449,34,69,0.493,10,29,0.345,23,26,0.885,121
605,MIA,2018-11-14,120,@,BRK,1,240,46,85,0.541,38,56,0.679,8,29,0.276,20,28,0.714,120,41,101,0.406,33,73,0.452,8,28,0.286,17,24,0.708,107
606,MIN,2018-11-12,120,,BRK,1,240,42,80,0.525,32,57,0.561,10,23,0.435,26,31,0.839,120,40,101,0.396,22,51,0.431,18,50,0.36,15,22,0.682,113
607,LAC,2018-11-05,120,,MIN,1,240,43,88,0.489,29,57,0.509,14,31,0.452,20,22,0.909,120,40,85,0.471,35,64,0.547,5,21,0.238,24,30,0.8,109
608,MIA,2018-11-05,120,@,DET,1,265,44,98,0.449,32,67,0.478,12,31,0.387,20,31,0.645,120,43,105,0.41,32,70,0.457,11,35,0.314,18,28,0.643,115
609,LAC,2018-11-02,120,@,ORL,1,240,41,86,0.477,28,60,0.467,13,26,0.5,25,33,0.758,120,40,90,0.444,36,73,0.493,4,17,0.235,11,19,0.579,95
610,BRK,2018-10-31,120,,DET,1,265,43,101,0.426,31,63,0.492,12,38,0.316,22,30,0.733,120,39,93,0.419,28,59,0.475,11,34,0.324,30,39,0.769,119
611,SAS,2018-10-31,120,@,PHO,1,240,46,83,0.554,42,65,0.646,4,18,0.222,24,26,0.923,120,35,90,0.389,29,66,0.439,6,24,0.25,14,18,0.778,90
612,LAL,2018-10-29,120,@,MIN,0,240,49,104,0.471,37,71,0.521,12,33,0.364,10,15,0.667,120,42,98,0.429,28,69,0.406,14,29,0.483,26,30,0.867,124
613,GSW,2018-10-28,120,@,BRK,1,240,44,89,0.494,33,56,0.589,11,33,0.333,21,24,0.875,120,42,87,0.483,22,45,0.489,20,42,0.476,10,15,0.667,114
614,MIA,2018-10-27,120,,POR,1,240,44,96,0.458,29,57,0.509,15,39,0.385,17,26,0.654,120,37,88,0.42,25,55,0.455,12,33,0.364,25,28,0.893,111
615,OKC,2018-10-21,120,,SAC,0,240,46,104,0.442,37,65,0.569,9,39,0.231,19,30,0.633,120,50,91,0.549,40,69,0.58,10,22,0.455,21,28,0.75,131
616,CHO,2018-10-19,120,@,ORL,1,240,43,92,0.467,26,54,0.481,17,38,0.447,17,20,0.85,120,36,94,0.383,30,63,0.476,6,31,0.194,10,14,0.714,88
617,DEN,2019-04-05,119,,POR,1,240,43,84,0.512,36,57,0.632,7,27,0.259,26,29,0.897,119,42,86,0.488,32,57,0.561,10,29,0.345,16,20,0.8,110
618,UTA,2019-04-05,119,,SAC,1,240,44,85,0.518,29,52,0.558,15,33,0.455,16,25,0.64,119,38,92,0.413,33,71,0.465,5,21,0.238,17,25,0.68,98
619,OKC,2019-04-02,119,,LAL,1,240,47,102,0.461,34,58,0.586,13,44,0.295,12,20,0.6,119,40,84,0.476,24,45,0.533,16,39,0.41,7,10,0.7,103
620,HOU,2019-03-30,119,,SAC,1,240,39,83,0.47,22,31,0.71,17,52,0.327,24,27,0.889,119,42,94,0.447,27,65,0.415,15,29,0.517,9,15,0.6,108
621,ORL,2019-03-25,119,,PHI,1,240,45,87,0.517,34,58,0.586,11,29,0.379,18,23,0.783,119,36,73,0.493,30,50,0.6,6,23,0.261,20,26,0.769,98
622,MEM,2019-03-22,119,@,ORL,0,265,47,93,0.505,32,55,0.582,15,38,0.395,10,21,0.476,119,44,93,0.473,30,54,0.556,14,39,0.359,21,27,0.778,123
623,ORL,2019-03-20,119,,NOP,1,240,46,102,0.451,31,64,0.484,15,38,0.395,12,14,0.857,119,38,102,0.373,28,68,0.412,10,34,0.294,10,13,0.769,96
624,DET,2019-03-18,119,@,CLE,0,240,42,94,0.447,24,50,0.48,18,44,0.409,17,21,0.81,119,46,79,0.582,35,57,0.614,11,22,0.5,23,27,0.852,126
625,LAC,2019-03-17,119,,BRK,1,240,42,97,0.433,30,66,0.455,12,31,0.387,23,28,0.821,119,42,100,0.42,28,62,0.452,14,38,0.368,18,25,0.72,116
626,TOR,2019-03-01,119,,POR,1,240,45,81,0.556,35,53,0.66,10,28,0.357,19,21,0.905,119,42,85,0.494,28,52,0.538,14,33,0.424,19,23,0.826,117
627,NOP,2019-02-27,119,@,LAL,0,240,46,102,0.451,39,67,0.582,7,35,0.2,20,27,0.741,119,49,94,0.521,41,69,0.594,8,25,0.32,19,31,0.613,125
628,HOU,2019-02-25,119,,ATL,1,240,39,90,0.433,24,39,0.615,15,51,0.294,26,30,0.867,119,39,80,0.488,22,42,0.524,17,38,0.447,16,23,0.696,111
629,DET,2019-02-23,119,@,MIA,1,240,42,80,0.525,28,47,0.596,14,33,0.424,21,26,0.808,119,35,82,0.427,28,54,0.519,7,28,0.25,19,27,0.704,96
630,SAC,2019-02-23,119,@,OKC,1,240,44,97,0.454,37,78,0.474,7,19,0.368,24,34,0.706,119,40,105,0.381,26,59,0.441,14,46,0.304,22,28,0.786,116
631,IND,2019-02-23,119,@,WAS,1,240,47,83,0.566,36,58,0.621,11,25,0.44,14,22,0.636,119,42,79,0.532,29,44,0.659,13,35,0.371,15,21,0.714,112
632,WAS,2019-02-08,119,,CLE,1,240,46,92,0.5,34,57,0.596,12,35,0.343,15,16,0.938,119,36,96,0.375,24,58,0.414,12,38,0.316,22,25,0.88,106
633,TOR,2019-02-07,119,@,ATL,1,240,40,87,0.46,27,47,0.574,13,40,0.325,26,33,0.788,119,36,80,0.45,20,45,0.444,16,35,0.457,13,25,0.52,101
634,TOR,2019-02-05,119,@,PHI,1,240,41,89,0.461,30,58,0.517,11,31,0.355,26,32,0.813,119,31,70,0.443,24,46,0.522,7,24,0.292,38,41,0.927,107
635,WAS,2019-01-27,119,@,SAS,0,240,40,89,0.449,22,43,0.512,18,46,0.391,21,29,0.724,119,49,86,0.57,33,52,0.635,16,34,0.471,18,21,0.857,132
636,TOR,2019-01-25,119,@,HOU,0,240,44,91,0.484,30,55,0.545,14,36,0.389,17,18,0.944,119,41,91,0.451,31,45,0.689,10,46,0.217,29,33,0.879,121
637,TOR,2019-01-19,119,,MEM,1,240,44,90,0.489,27,54,0.5,17,36,0.472,14,16,0.875,119,34,80,0.425,24,51,0.471,10,29,0.345,12,15,0.8,90
638,GSW,2019-01-13,119,@,DAL,1,240,45,99,0.455,26,54,0.481,19,45,0.422,10,12,0.833,119,38,91,0.418,22,53,0.415,16,38,0.421,22,29,0.759,114
639,DAL,2019-01-11,119,@,MIN,1,240,44,97,0.454,31,59,0.525,13,38,0.342,18,24,0.75,119,47,102,0.461,37,78,0.474,10,24,0.417,11,13,0.846,115
640,MIN,2019-01-08,119,@,OKC,1,240,38,90,0.422,27,59,0.458,11,31,0.355,32,40,0.8,119,43,85,0.506,31,55,0.564,12,30,0.4,19,26,0.731,117
641,SAS,2019-01-07,119,@,DET,1,240,43,79,0.544,36,59,0.61,7,20,0.35,26,32,0.813,119,42,85,0.494,33,53,0.623,9,32,0.281,14,17,0.824,107
642,CHO,2019-01-06,119,@,PHO,1,240,44,91,0.484,37,66,0.561,7,25,0.28,24,34,0.706,119,43,83,0.518,33,58,0.569,10,25,0.4,17,19,0.895,113
643,NYK,2019-01-04,119,@,LAL,1,240,37,99,0.374,26,62,0.419,11,37,0.297,34,41,0.829,119,43,98,0.439,32,61,0.525,11,37,0.297,15,20,0.75,112
644,IND,2019-01-04,119,@,CHI,1,265,49,93,0.527,40,65,0.615,9,28,0.321,12,17,0.706,119,47,91,0.516,35,63,0.556,12,28,0.429,10,13,0.769,116
645,PHI,2019-01-01,119,@,LAC,1,240,42,87,0.483,30,61,0.492,12,26,0.462,23,33,0.697,119,42,91,0.462,37,66,0.561,5,25,0.2,24,34,0.706,113
646,NOP,2018-12-26,119,@,DAL,0,240,42,90,0.467,30,63,0.476,12,27,0.444,23,30,0.767,119,39,81,0.481,27,46,0.587,12,35,0.343,32,38,0.842,122
647,MIN,2018-12-26,119,@,CHI,1,240,46,93,0.495,35,61,0.574,11,32,0.344,16,19,0.842,119,39,95,0.411,33,72,0.458,6,23,0.261,10,16,0.625,94
648,BOS,2018-12-23,119,,CHO,1,240,43,86,0.5,30,47,0.638,13,39,0.333,20,25,0.8,119,38,88,0.432,30,56,0.536,8,32,0.25,19,26,0.731,103
649,PHO,2018-12-10,119,,LAC,0,265,47,94,0.5,38,69,0.551,9,25,0.36,16,20,0.8,119,45,85,0.529,38,64,0.594,7,21,0.333,26,33,0.788,123
650,CHO,2018-12-09,119,@,NYK,1,240,42,87,0.483,30,53,0.566,12,34,0.353,23,27,0.852,119,44,93,0.473,31,67,0.463,13,26,0.5,6,7,0.857,107
651,NOP,2018-12-02,119,@,CHO,1,240,44,86,0.512,33,54,0.611,11,32,0.344,20,24,0.833,119,39,91,0.429,29,55,0.527,10,36,0.278,21,28,0.75,109
652,UTA,2018-11-30,119,@,CHO,1,240,44,81,0.543,26,41,0.634,18,40,0.45,13,18,0.722,119,47,95,0.495,38,67,0.567,9,28,0.321,8,13,0.615,111
653,DAL,2018-11-21,119,,BRK,1,240,38,78,0.487,27,51,0.529,11,27,0.407,32,41,0.78,119,42,94,0.447,28,52,0.538,14,42,0.333,15,21,0.714,113
654,SAC,2018-11-21,119,@,UTA,1,240,47,89,0.528,36,64,0.563,11,25,0.44,14,19,0.737,119,38,88,0.432,26,49,0.531,12,39,0.308,22,31,0.71,110
655,ATL,2018-11-19,119,,LAC,0,240,45,101,0.446,33,63,0.524,12,38,0.316,17,19,0.895,119,40,93,0.43,30,60,0.5,10,33,0.303,37,47,0.787,127
656,PHI,2018-11-19,119,,PHO,1,240,41,84,0.488,35,62,0.565,6,22,0.273,31,42,0.738,119,44,87,0.506,31,54,0.574,13,33,0.394,13,24,0.542,114
657,POR,2018-11-18,119,@,WAS,1,240,39,86,0.453,28,56,0.5,11,30,0.367,30,35,0.857,119,43,96,0.448,30,64,0.469,13,32,0.406,10,21,0.476,109
658,CHO,2018-11-17,119,,PHI,0,265,42,99,0.424,32,68,0.471,10,31,0.323,25,27,0.926,119,39,93,0.419,28,58,0.483,11,35,0.314,33,38,0.868,122
659,BRK,2018-11-17,119,,LAC,0,240,40,88,0.455,27,60,0.45,13,28,0.464,26,34,0.765,119,48,95,0.505,37,72,0.514,11,23,0.478,20,24,0.833,127
660,WAS,2018-11-14,119,,CLE,1,240,44,92,0.478,31,52,0.596,13,40,0.325,18,26,0.692,119,35,77,0.455,31,56,0.554,4,21,0.19,21,31,0.677,95
661,NOP,2018-11-10,119,,PHO,1,240,42,86,0.488,31,61,0.508,11,25,0.44,24,29,0.828,119,35,86,0.407,25,50,0.5,10,36,0.278,19,20,0.95,99
662,DAL,2018-11-06,119,,WAS,1,240,39,82,0.476,24,48,0.5,15,34,0.441,26,27,0.963,119,37,87,0.425,26,52,0.5,11,35,0.314,15,20,0.75,100
663,HOU,2018-11-02,119,@,BRK,1,240,41,83,0.494,26,44,0.591,15,39,0.385,22,32,0.688,119,42,85,0.494,27,51,0.529,15,34,0.441,12,20,0.6,111
664,NOP,2018-11-01,119,@,POR,0,240,40,94,0.426,32,65,0.492,8,29,0.276,31,37,0.838,119,44,87,0.506,26,52,0.5,18,35,0.514,26,31,0.839,132
665,DET,2018-10-31,119,@,BRK,0,265,39,93,0.419,28,59,0.475,11,34,0.324,30,39,0.769,119,43,101,0.426,31,63,0.492,12,38,0.316,22,30,0.733,120
666,IND,2018-10-27,119,@,CLE,1,240,48,74,0.649,43,61,0.705,5,13,0.385,18,26,0.692,119,40,86,0.465,33,61,0.541,7,25,0.28,20,22,0.909,107
667,DEN,2018-10-20,119,,PHO,1,240,43,85,0.506,34,57,0.596,9,28,0.321,24,29,0.828,119,29,77,0.377,18,38,0.474,11,39,0.282,22,35,0.629,91
668,LAL,2018-10-18,119,@,POR,0,240,45,93,0.484,38,63,0.603,7,30,0.233,22,29,0.759,119,44,100,0.44,31,63,0.492,13,37,0.351,27,29,0.931,128
669,UTA,2019-04-09,118,,DEN,1,240,41,78,0.526,31,51,0.608,10,27,0.37,26,34,0.765,118,41,88,0.466,29,63,0.46,12,25,0.48,14,22,0.636,108
670,UTA,2019-04-03,118,@,PHO,1,240,44,77,0.571,28,45,0.622,16,32,0.5,14,18,0.778,118,42,91,0.462,37,70,0.529,5,21,0.238,8,13,0.615,97
671,PHI,2019-03-30,118,@,MIN,1,240,44,94,0.468,29,63,0.46,15,31,0.484,15,21,0.714,118,39,86,0.453,28,60,0.467,11,26,0.423,20,25,0.8,109
672,POR,2019-03-29,118,@,ATL,1,240,45,96,0.469,36,64,0.563,9,32,0.281,19,22,0.864,118,38,94,0.404,29,56,0.518,9,38,0.237,13,14,0.929,98
673,LAC,2019-03-28,118,@,MIL,0,240,42,92,0.457,25,59,0.424,17,33,0.515,17,22,0.773,118,45,86,0.523,29,49,0.592,16,37,0.432,22,27,0.815,128
674,SAC,2019-03-28,118,@,NOP,0,240,47,95,0.495,37,72,0.514,10,23,0.435,14,16,0.875,118,49,97,0.505,40,69,0.58,9,28,0.321,14,14,1.0,121
675,GSW,2019-03-27,118,@,MEM,1,240,45,84,0.536,30,53,0.566,15,31,0.484,13,15,0.867,118,39,100,0.39,29,69,0.42,10,31,0.323,15,21,0.714,103
676,POR,2019-03-27,118,@,CHI,1,240,43,83,0.518,32,51,0.627,11,32,0.344,21,25,0.84,118,39,91,0.429,34,68,0.5,5,23,0.217,15,19,0.789,98
677,DET,2019-03-21,118,@,PHO,1,240,38,90,0.422,21,48,0.438,17,42,0.405,25,34,0.735,118,35,73,0.479,28,47,0.596,7,26,0.269,21,26,0.808,98
678,PHI,2019-03-20,118,,BOS,1,240,34,90,0.378,23,57,0.404,11,33,0.333,39,43,0.907,118,45,96,0.469,33,64,0.516,12,32,0.375,13,16,0.813,115
679,DAL,2019-03-20,118,@,POR,0,240,43,87,0.494,33,57,0.579,10,30,0.333,22,25,0.88,118,45,91,0.495,29,55,0.527,16,36,0.444,20,25,0.8,126
680,PHI,2019-03-19,118,@,CHO,1,240,43,86,0.5,32,54,0.593,11,32,0.344,21,28,0.75,118,36,83,0.434,27,48,0.563,9,35,0.257,33,44,0.75,114
681,HOU,2019-03-11,118,,CHO,1,240,38,91,0.418,21,48,0.438,17,43,0.395,25,27,0.926,118,38,89,0.427,22,48,0.458,16,41,0.39,14,15,0.933,106
682,LAC,2019-03-08,118,,OKC,1,240,39,86,0.453,30,61,0.492,9,25,0.36,31,46,0.674,118,41,102,0.402,30,58,0.517,11,44,0.25,17,26,0.654,110
683,CHI,2019-03-03,118,,ATL,0,240,47,92,0.511,39,65,0.6,8,27,0.296,16,21,0.762,118,42,89,0.472,21,47,0.447,21,42,0.5,18,28,0.643,123
684,POR,2019-03-03,118,@,CHO,1,240,43,96,0.448,32,64,0.5,11,32,0.344,21,23,0.913,118,37,83,0.446,23,50,0.46,14,33,0.424,20,23,0.87,108
685,PHO,2019-03-02,118,,LAL,1,240,39,76,0.513,33,50,0.66,6,26,0.231,34,40,0.85,118,43,89,0.483,35,64,0.547,8,25,0.32,15,23,0.652,109
686,NYK,2019-02-28,118,,CLE,0,240,46,95,0.484,35,63,0.556,11,32,0.344,15,23,0.652,118,41,80,0.513,27,46,0.587,14,34,0.412,29,36,0.806,125
687,MIA,2019-02-28,118,@,HOU,0,240,42,81,0.519,27,53,0.509,15,28,0.536,19,24,0.792,118,38,77,0.494,19,31,0.613,19,46,0.413,26,28,0.929,121
688,HOU,2019-02-27,118,@,CHO,1,240,42,91,0.462,29,52,0.558,13,39,0.333,21,24,0.875,118,39,83,0.47,27,50,0.54,12,33,0.364,23,27,0.852,113
689,TOR,2019-02-26,118,,BOS,1,240,46,94,0.489,29,58,0.5,17,36,0.472,9,14,0.643,118,33,86,0.384,27,56,0.482,6,30,0.2,23,28,0.821,95
690,SAS,2019-02-24,118,@,NYK,0,240,42,94,0.447,36,70,0.514,6,24,0.25,28,31,0.903,118,50,98,0.51,34,61,0.557,16,37,0.432,14,19,0.737,130
691,HOU,2019-02-23,118,@,GSW,1,240,40,92,0.435,24,49,0.49,16,43,0.372,22,24,0.917,118,42,90,0.467,28,54,0.519,14,36,0.389,14,20,0.7,112
692,SAC,2019-02-13,118,@,DEN,0,240,42,93,0.452,31,61,0.508,11,32,0.344,23,28,0.821,118,45,99,0.455,37,68,0.544,8,31,0.258,22,25,0.88,120
693,BOS,2019-02-13,118,,DET,1,240,45,88,0.511,29,49,0.592,16,39,0.41,12,15,0.8,118,36,84,0.429,23,44,0.523,13,40,0.325,25,34,0.735,110
694,ORL,2019-02-12,118,@,NOP,1,240,42,95,0.442,29,63,0.46,13,32,0.406,21,22,0.955,118,36,94,0.383,26,65,0.4,10,29,0.345,6,8,0.75,88
695,MIA,2019-02-10,118,@,GSW,0,240,48,105,0.457,30,62,0.484,18,43,0.419,4,8,0.5,118,44,82,0.537,31,46,0.674,13,36,0.361,19,26,0.731,120
696,SAS,2019-02-07,118,@,POR,0,240,48,91,0.527,36,70,0.514,12,21,0.571,10,14,0.714,118,49,91,0.538,38,60,0.633,11,31,0.355,18,18,1.0,127
697,MIA,2019-02-05,118,@,POR,1,240,45,83,0.542,38,61,0.623,7,22,0.318,21,25,0.84,118,42,93,0.452,27,54,0.5,15,39,0.385,9,12,0.75,108
698,HOU,2019-02-04,118,@,PHO,1,240,43,87,0.494,30,46,0.652,13,41,0.317,19,25,0.76,118,45,84,0.536,38,59,0.644,7,25,0.28,13,18,0.722,110
699,CHI,2019-02-02,118,@,CHO,0,240,42,81,0.519,33,57,0.579,9,24,0.375,25,25,1.0,118,43,82,0.524,29,50,0.58,14,32,0.438,25,29,0.862,125
700,ATL,2019-02-02,118,@,PHO,1,240,43,84,0.512,29,52,0.558,14,32,0.438,18,26,0.692,118,45,96,0.469,33,64,0.516,12,32,0.375,10,18,0.556,112
701,OKC,2019-02-01,118,@,MIA,1,240,44,91,0.484,28,61,0.459,16,30,0.533,14,19,0.737,118,41,92,0.446,30,56,0.536,11,36,0.306,9,14,0.643,102
702,LAC,2019-01-28,118,,ATL,0,240,41,85,0.482,31,58,0.534,10,27,0.37,26,28,0.929,118,44,87,0.506,34,53,0.642,10,34,0.294,25,29,0.862,123
703,OKC,2019-01-27,118,,MIL,1,240,44,94,0.468,28,62,0.452,16,32,0.5,14,25,0.56,118,39,91,0.429,24,54,0.444,15,37,0.405,19,28,0.679,112
704,WAS,2019-01-24,118,,GSW,0,240,44,95,0.463,29,53,0.547,15,42,0.357,15,21,0.714,118,50,88,0.568,43,68,0.632,7,20,0.35,19,21,0.905,126
705,CHO,2019-01-23,118,@,MEM,1,240,41,77,0.532,29,47,0.617,12,30,0.4,24,31,0.774,118,38,81,0.469,29,50,0.58,9,31,0.29,22,24,0.917,107
706,MIN,2019-01-22,118,@,PHO,1,240,45,103,0.437,30,61,0.492,15,42,0.357,13,19,0.684,118,37,87,0.425,30,53,0.566,7,34,0.206,10,18,0.556,91
707,MIL,2019-01-19,118,@,ORL,1,240,47,85,0.553,35,55,0.636,12,30,0.4,12,15,0.8,118,44,93,0.473,30,61,0.492,14,32,0.438,6,9,0.667,108
708,PHO,2018-12-29,118,,DEN,0,240,49,91,0.538,38,62,0.613,11,29,0.379,9,14,0.643,118,42,76,0.553,24,41,0.585,18,35,0.514,20,26,0.769,122
709,MIA,2018-12-28,118,,CLE,1,240,48,91,0.527,38,60,0.633,10,31,0.323,12,16,0.75,118,31,81,0.383,18,44,0.409,13,37,0.351,19,22,0.864,94
710,OKC,2018-12-28,118,@,PHO,1,240,51,95,0.537,44,75,0.587,7,20,0.35,9,13,0.692,118,39,90,0.433,30,61,0.492,9,29,0.31,15,16,0.938,102
711,LAC,2018-12-28,118,@,LAL,1,240,40,91,0.44,34,72,0.472,6,19,0.316,32,34,0.941,118,36,87,0.414,25,57,0.439,11,30,0.367,24,35,0.686,107
712,SAC,2018-12-26,118,@,LAC,0,240,49,104,0.471,39,74,0.527,10,30,0.333,10,15,0.667,118,48,96,0.5,36,68,0.529,12,28,0.429,19,23,0.826,127
713,DAL,2018-12-23,118,@,POR,0,265,43,103,0.417,31,69,0.449,12,34,0.353,20,28,0.714,118,49,104,0.471,38,66,0.576,11,38,0.289,12,17,0.706,121
714,WAS,2018-12-19,118,@,HOU,0,240,45,84,0.536,35,54,0.648,10,30,0.333,18,23,0.783,118,47,85,0.553,21,30,0.7,26,55,0.473,16,21,0.762,136
715,ATL,2018-12-18,118,,WAS,1,240,37,79,0.468,25,47,0.532,12,32,0.375,32,39,0.821,118,36,83,0.434,23,43,0.535,13,40,0.325,25,36,0.694,110
716,DAL,2018-12-18,118,@,DEN,0,240,40,86,0.465,25,49,0.51,15,37,0.405,23,30,0.767,118,50,90,0.556,38,61,0.623,12,29,0.414,14,18,0.778,126
717,WAS,2018-12-14,118,@,BRK,0,240,49,90,0.544,38,61,0.623,11,29,0.379,9,16,0.563,118,44,84,0.524,33,53,0.623,11,31,0.355,26,31,0.839,125
718,NOP,2018-12-12,118,,OKC,1,240,45,97,0.464,41,79,0.519,4,18,0.222,24,30,0.8,118,42,87,0.483,29,44,0.659,13,43,0.302,17,27,0.63,114
719,UTA,2018-12-06,118,,HOU,1,240,45,89,0.506,37,57,0.649,8,32,0.25,20,27,0.741,118,34,88,0.386,26,52,0.5,8,36,0.222,15,17,0.882,91
720,ORL,2018-12-05,118,,DEN,0,265,45,95,0.474,25,46,0.543,20,49,0.408,8,8,1.0,118,45,82,0.549,34,63,0.54,11,19,0.579,23,37,0.622,124
721,POR,2018-12-02,118,@,SAS,0,240,45,86,0.523,33,57,0.579,12,29,0.414,16,16,1.0,118,50,83,0.602,39,68,0.574,11,15,0.733,20,22,0.909,131
722,BOS,2018-12-01,118,@,MIN,1,240,40,85,0.471,23,41,0.561,17,44,0.386,21,21,1.0,118,37,82,0.451,28,54,0.519,9,28,0.321,26,32,0.813,109
723,DET,2018-11-25,118,,PHO,1,240,43,93,0.462,27,52,0.519,16,41,0.39,16,25,0.64,118,42,82,0.512,34,57,0.596,8,25,0.32,15,21,0.714,107
724,POR,2018-11-20,118,@,NYK,1,240,45,95,0.474,29,60,0.483,16,35,0.457,12,17,0.706,118,42,83,0.506,29,54,0.537,13,29,0.448,17,22,0.773,114
725,LAC,2018-11-20,118,@,WAS,0,240,46,89,0.517,35,62,0.565,11,27,0.407,15,18,0.833,118,40,93,0.43,27,54,0.5,13,39,0.333,32,39,0.821,125
726,DAL,2018-11-14,118,,UTA,1,240,45,77,0.584,33,49,0.673,12,28,0.429,16,24,0.667,118,25,81,0.309,19,46,0.413,6,35,0.171,12,19,0.632,68
727,OKC,2018-11-12,118,,PHO,1,240,43,92,0.467,30,65,0.462,13,27,0.481,19,20,0.95,118,39,81,0.481,32,55,0.582,7,26,0.269,16,19,0.842,101
728,POR,2018-11-06,118,,MIL,1,240,48,91,0.527,31,48,0.646,17,43,0.395,5,8,0.625,118,40,92,0.435,24,50,0.48,16,42,0.381,7,8,0.875,103
729,MIA,2018-11-03,118,@,ATL,0,240,41,85,0.482,25,45,0.556,16,40,0.4,20,26,0.769,118,46,88,0.523,33,56,0.589,13,32,0.406,18,23,0.783,123
730,NYK,2018-11-02,118,@,DAL,1,240,46,84,0.548,39,55,0.709,7,29,0.241,19,26,0.731,118,40,81,0.494,29,52,0.558,11,29,0.379,15,24,0.625,106
731,DET,2018-10-20,118,@,CHI,1,240,41,101,0.406,23,61,0.377,18,40,0.45,18,23,0.783,118,44,87,0.506,37,66,0.561,7,21,0.333,21,26,0.808,116
732,MIL,2018-10-19,118,,IND,1,240,44,93,0.473,27,47,0.574,17,46,0.37,13,21,0.619,118,38,87,0.437,32,69,0.464,6,18,0.333,19,27,0.704,101
733,GSW,2019-04-10,117,@,MEM,0,240,46,92,0.5,33,62,0.532,13,30,0.433,12,14,0.857,117,48,98,0.49,27,52,0.519,21,46,0.457,15,18,0.833,132
734,TOR,2019-04-07,117,,MIA,1,265,39,87,0.448,23,46,0.5,16,41,0.39,23,27,0.852,117,41,100,0.41,28,66,0.424,13,34,0.382,14,19,0.737,109
735,LAC,2019-04-05,117,,LAL,0,240,40,91,0.44,30,62,0.484,10,29,0.345,27,31,0.871,117,43,96,0.448,29,64,0.453,14,32,0.438,22,27,0.815,122
736,BOS,2019-04-05,117,@,IND,1,240,48,92,0.522,41,65,0.631,7,27,0.259,14,16,0.875,117,38,92,0.413,28,69,0.406,10,23,0.435,11,19,0.579,97
737,SAC,2019-04-04,117,,CLE,1,240,48,97,0.495,34,59,0.576,14,38,0.368,7,10,0.7,117,44,81,0.543,33,56,0.589,11,25,0.44,5,9,0.556,104
738,SAS,2019-04-02,117,,ATL,1,240,42,80,0.525,28,50,0.56,14,30,0.467,19,22,0.864,117,43,94,0.457,31,60,0.517,12,34,0.353,13,20,0.65,111
739,TOR,2019-03-28,117,@,NYK,1,240,40,89,0.449,20,42,0.476,20,47,0.426,17,22,0.773,117,31,85,0.365,25,59,0.424,6,26,0.231,24,32,0.75,92
740,POR,2019-03-23,117,,DET,1,240,43,79,0.544,32,53,0.604,11,26,0.423,20,27,0.741,117,42,84,0.5,28,50,0.56,14,34,0.412,14,14,1.0,112
741,BOS,2019-03-23,117,@,CHO,0,240,44,93,0.473,25,50,0.5,19,43,0.442,10,15,0.667,117,42,95,0.442,24,57,0.421,18,38,0.474,22,28,0.786,124
742,ATL,2019-03-21,117,,UTA,1,240,41,87,0.471,22,47,0.468,19,40,0.475,16,23,0.696,117,43,94,0.457,33,62,0.532,10,32,0.313,18,26,0.692,114
743,GSW,2019-03-19,117,@,MIN,1,240,44,91,0.484,25,49,0.51,19,42,0.452,10,14,0.714,117,36,89,0.404,27,53,0.509,9,36,0.25,26,32,0.813,107
744,HOU,2019-03-17,117,,MIN,1,240,43,94,0.457,22,44,0.5,21,50,0.42,10,14,0.714,117,38,92,0.413,28,60,0.467,10,32,0.313,16,23,0.696,102
745,MIL,2019-03-07,117,,IND,1,240,43,86,0.5,29,51,0.569,14,35,0.4,17,21,0.81,117,35,90,0.389,21,53,0.396,14,37,0.378,14,20,0.7,98
746,PHI,2019-03-02,117,,GSW,0,240,39,87,0.448,25,56,0.446,14,31,0.452,25,29,0.862,117,41,81,0.506,27,48,0.563,14,33,0.424,24,34,0.706,120
747,MIA,2019-03-02,117,,BRK,1,240,44,90,0.489,30,56,0.536,14,34,0.412,15,22,0.682,117,31,88,0.352,22,46,0.478,9,42,0.214,17,22,0.773,88
748,ORL,2019-03-02,117,@,IND,1,240,46,91,0.505,36,63,0.571,10,28,0.357,15,19,0.789,117,42,77,0.545,35,50,0.7,7,27,0.259,21,24,0.875,112
749,POR,2019-03-01,117,@,TOR,0,240,42,85,0.494,28,52,0.538,14,33,0.424,19,23,0.826,117,45,81,0.556,35,53,0.66,10,28,0.357,19,21,0.905,119
750,MIL,2019-02-25,117,@,CHI,1,240,42,91,0.462,25,42,0.595,17,49,0.347,16,23,0.696,117,41,92,0.446,32,66,0.485,9,26,0.346,15,22,0.682,106
751,BRK,2019-02-23,117,@,CHO,1,240,40,87,0.46,23,44,0.523,17,43,0.395,20,26,0.769,117,39,86,0.453,27,51,0.529,12,35,0.343,25,30,0.833,115
752,SAS,2019-02-22,117,@,TOR,0,240,43,89,0.483,31,52,0.596,12,37,0.324,19,22,0.864,117,40,94,0.426,26,64,0.406,14,30,0.467,26,32,0.813,120
753,ATL,2019-02-12,117,,LAL,1,240,40,92,0.435,24,50,0.48,16,42,0.381,21,26,0.808,117,41,95,0.432,27,55,0.491,14,40,0.35,17,25,0.68,113
754,SAC,2019-02-10,117,,PHO,1,240,38,84,0.452,29,53,0.547,9,31,0.29,32,44,0.727,117,38,91,0.418,32,64,0.5,6,27,0.222,22,30,0.733,104
755,OKC,2019-02-09,117,@,HOU,1,240,40,89,0.449,27,55,0.491,13,34,0.382,24,30,0.8,117,37,86,0.43,21,41,0.512,16,45,0.356,22,30,0.733,112
756,MIN,2019-02-08,117,@,NOP,0,240,46,91,0.505,37,70,0.529,9,21,0.429,16,22,0.727,117,43,91,0.473,34,61,0.557,9,30,0.3,27,28,0.964,122
757,PHI,2019-02-08,117,,DEN,1,240,39,78,0.5,29,56,0.518,10,22,0.455,29,32,0.906,117,46,94,0.489,40,68,0.588,6,26,0.231,12,13,0.923,110
758,GSW,2019-02-08,117,@,PHO,1,240,41,81,0.506,31,52,0.596,10,29,0.345,25,35,0.714,117,39,101,0.386,33,70,0.471,6,31,0.194,23,30,0.767,107
759,OKC,2019-02-07,117,,MEM,1,240,43,90,0.478,26,46,0.565,17,44,0.386,14,22,0.636,117,34,77,0.442,27,53,0.509,7,24,0.292,20,23,0.87,95
760,LAC,2019-02-05,117,@,CHO,1,240,42,87,0.483,24,63,0.381,18,24,0.75,15,17,0.882,117,39,93,0.419,24,51,0.471,15,42,0.357,22,26,0.846,115
761,SAS,2019-01-31,117,,BRK,1,240,40,100,0.4,28,67,0.418,12,33,0.364,25,29,0.862,117,42,89,0.472,31,55,0.564,11,34,0.324,19,29,0.655,114
762,CHI,2019-01-29,117,@,BRK,0,240,47,94,0.5,38,66,0.576,9,28,0.321,14,19,0.737,117,42,94,0.447,32,59,0.542,10,35,0.286,28,40,0.7,122
763,ORL,2019-01-29,117,,OKC,0,240,44,102,0.431,30,61,0.492,14,41,0.341,15,18,0.833,117,49,91,0.538,40,70,0.571,9,21,0.429,19,26,0.731,126
764,OKC,2019-01-19,117,@,PHI,1,240,41,93,0.441,29,62,0.468,12,31,0.387,23,26,0.885,117,38,81,0.469,27,49,0.551,11,32,0.344,28,39,0.718,115
765,MIA,2019-01-19,117,@,CHI,1,240,45,79,0.57,32,47,0.681,13,32,0.406,14,23,0.609,117,35,89,0.393,23,62,0.371,12,27,0.444,21,26,0.808,103
766,BRK,2019-01-18,117,@,ORL,1,240,44,97,0.454,25,51,0.49,19,46,0.413,10,15,0.667,117,47,94,0.5,37,68,0.544,10,26,0.385,11,14,0.786,115
767,BOS,2019-01-16,117,,TOR,1,240,46,92,0.5,32,62,0.516,14,30,0.467,11,13,0.846,117,41,92,0.446,34,63,0.54,7,29,0.241,19,21,0.905,108
768,LAC,2019-01-14,117,,NOP,0,240,41,86,0.477,23,50,0.46,18,36,0.5,17,24,0.708,117,46,105,0.438,38,80,0.475,8,25,0.32,21,28,0.75,121
769,OKC,2019-01-08,117,,MIN,0,240,43,85,0.506,31,55,0.564,12,30,0.4,19,26,0.731,117,38,90,0.422,27,59,0.458,11,31,0.355,32,40,0.8,119
770,BRK,2019-01-06,117,@,CHI,1,240,42,83,0.506,26,37,0.703,16,46,0.348,17,22,0.773,117,41,88,0.466,34,70,0.486,7,18,0.389,11,15,0.733,100
771,UTA,2019-01-04,117,@,CLE,1,240,42,82,0.512,28,47,0.596,14,35,0.4,19,22,0.864,117,32,82,0.39,21,61,0.344,11,21,0.524,16,17,0.941,91
772,DEN,2019-01-03,117,@,SAC,1,240,41,89,0.461,27,50,0.54,14,39,0.359,21,30,0.7,117,45,90,0.5,32,59,0.542,13,31,0.419,10,15,0.667,113
773,MIA,2019-01-02,117,@,CLE,1,240,44,86,0.512,28,55,0.509,16,31,0.516,13,17,0.765,117,34,75,0.453,21,44,0.477,13,31,0.419,11,13,0.846,92
774,SAC,2018-12-27,117,,LAL,1,240,45,101,0.446,35,72,0.486,10,29,0.345,17,21,0.81,117,45,88,0.511,35,63,0.556,10,25,0.4,16,23,0.696,116
775,UTA,2018-12-25,117,,POR,1,240,46,83,0.554,33,54,0.611,13,29,0.448,12,23,0.522,117,35,89,0.393,26,66,0.394,9,23,0.391,17,26,0.654,96
776,NOP,2018-12-23,117,@,SAC,0,240,44,94,0.468,38,68,0.559,6,26,0.231,23,28,0.821,117,42,100,0.42,28,69,0.406,14,31,0.452,24,33,0.727,122
777,PHI,2018-12-07,117,@,DET,1,240,44,90,0.489,35,58,0.603,9,32,0.281,20,21,0.952,117,37,89,0.416,30,61,0.492,7,28,0.25,30,37,0.811,111
778,ATL,2018-12-05,117,,WAS,0,240,41,92,0.446,29,54,0.537,12,38,0.316,23,31,0.742,117,46,95,0.484,34,57,0.596,12,38,0.316,27,32,0.844,131
779,PHI,2018-11-28,117,,NYK,1,240,47,87,0.54,35,62,0.565,12,25,0.48,11,16,0.688,117,32,92,0.348,26,63,0.413,6,29,0.207,21,22,0.955,91
780,DEN,2018-11-27,117,,LAL,1,240,47,97,0.485,38,72,0.528,9,25,0.36,14,15,0.933,117,34,87,0.391,29,52,0.558,5,35,0.143,12,18,0.667,85
781,GSW,2018-11-24,117,,SAC,1,240,41,88,0.466,31,54,0.574,10,34,0.294,25,29,0.862,117,42,97,0.433,31,69,0.449,11,28,0.393,21,29,0.724,116
782,CLE,2018-11-24,117,,HOU,1,240,44,90,0.489,37,68,0.544,7,22,0.318,22,29,0.759,117,37,74,0.5,22,35,0.629,15,39,0.385,19,28,0.679,108
783,NYK,2018-11-21,117,@,BOS,1,240,44,89,0.494,29,59,0.492,15,30,0.5,14,17,0.824,117,38,97,0.392,28,64,0.438,10,33,0.303,23,32,0.719,109
784,CHO,2018-11-19,117,,BOS,1,240,43,89,0.483,28,48,0.583,15,41,0.366,16,22,0.727,117,45,89,0.506,36,57,0.632,9,32,0.281,13,18,0.722,112
785,SAC,2018-11-19,117,,OKC,1,240,45,102,0.441,29,64,0.453,16,38,0.421,11,17,0.647,117,45,108,0.417,33,67,0.493,12,41,0.293,11,16,0.688,113
786,NYK,2018-11-18,117,@,ORL,0,240,40,87,0.46,32,63,0.508,8,24,0.333,29,35,0.829,117,48,84,0.571,35,52,0.673,13,32,0.406,22,26,0.846,131
787,LAL,2018-11-17,117,@,ORL,0,240,43,90,0.478,33,60,0.55,10,30,0.333,21,25,0.84,117,50,93,0.538,39,61,0.639,11,32,0.344,19,23,0.826,130
788,POR,2018-11-14,117,@,LAL,0,240,41,93,0.441,27,60,0.45,14,33,0.424,21,23,0.913,117,44,93,0.473,29,61,0.475,15,32,0.469,23,26,0.885,126
789,WAS,2018-11-12,117,,ORL,1,240,40,79,0.506,27,46,0.587,13,33,0.394,24,33,0.727,117,43,89,0.483,28,59,0.475,15,30,0.5,8,11,0.727,109
790,ORL,2018-11-09,117,,WAS,1,240,44,86,0.512,31,55,0.564,13,31,0.419,16,19,0.842,117,42,82,0.512,31,55,0.564,11,27,0.407,13,19,0.684,108
791,UTA,2018-11-07,117,,DAL,1,240,43,89,0.483,30,52,0.577,13,37,0.351,18,26,0.692,117,29,73,0.397,21,49,0.429,8,24,0.333,36,40,0.9,102
792,GSW,2018-11-05,117,,MEM,1,240,41,81,0.506,28,57,0.491,13,24,0.542,22,23,0.957,117,38,83,0.458,29,56,0.518,9,27,0.333,16,21,0.762,101
793,ORL,2018-11-04,117,@,SAS,1,240,46,91,0.505,34,59,0.576,12,32,0.375,13,18,0.722,117,38,88,0.432,26,53,0.491,12,35,0.343,22,25,0.88,110
794,BOS,2018-11-01,117,,MIL,1,240,41,92,0.446,17,37,0.459,24,55,0.436,11,13,0.846,117,41,85,0.482,32,56,0.571,9,29,0.31,22,30,0.733,113
795,OKC,2018-10-28,117,,PHO,1,240,43,85,0.506,36,61,0.59,7,24,0.292,24,35,0.686,117,38,86,0.442,30,59,0.508,8,27,0.296,26,27,0.963,110
796,MEM,2018-10-27,117,,PHO,1,240,44,79,0.557,35,53,0.66,9,26,0.346,20,22,0.909,117,36,78,0.462,27,45,0.6,9,33,0.273,15,19,0.789,96
797,NOP,2018-10-26,117,,BRK,1,240,44,98,0.449,35,75,0.467,9,23,0.391,20,26,0.769,117,43,98,0.439,24,58,0.414,19,40,0.475,10,15,0.667,115
798,TOR,2018-10-20,117,@,WAS,1,240,39,88,0.443,29,59,0.492,10,29,0.345,29,36,0.806,117,37,89,0.416,24,50,0.48,13,39,0.333,26,32,0.813,113
799,ATL,2018-10-19,117,@,MEM,0,240,41,83,0.494,27,53,0.509,14,30,0.467,21,36,0.583,117,44,81,0.543,31,55,0.564,13,26,0.5,30,43,0.698,131
800,SAC,2018-10-17,117,,UTA,0,240,49,95,0.516,42,76,0.553,7,19,0.368,12,18,0.667,117,41,79,0.519,28,52,0.538,13,27,0.481,28,38,0.737,123
801,MIL,2019-04-10,116,,OKC,0,240,43,100,0.43,28,54,0.519,15,46,0.326,15,21,0.714,116,48,99,0.485,25,45,0.556,23,54,0.426,8,13,0.615,127
802,BOS,2019-04-09,116,@,WAS,1,240,45,99,0.455,30,55,0.545,15,44,0.341,11,23,0.478,116,41,97,0.423,27,58,0.466,14,39,0.359,14,18,0.778,110
803,ORL,2019-04-07,116,@,BOS,1,240,41,90,0.456,29,57,0.509,12,33,0.364,22,22,1.0,116,42,89,0.472,30,58,0.517,12,31,0.387,12,14,0.857,108
804,PHI,2019-04-06,116,@,CHI,1,240,46,88,0.523,37,61,0.607,9,27,0.333,15,26,0.577,116,38,89,0.427,30,64,0.469,8,25,0.32,12,15,0.8,96
805,POR,2019-04-03,116,,MEM,1,240,48,94,0.511,38,63,0.603,10,31,0.323,10,16,0.625,116,31,80,0.388,20,47,0.426,11,33,0.333,16,19,0.842,89
806,GSW,2019-04-02,116,,DEN,1,240,50,92,0.543,37,58,0.638,13,34,0.382,3,8,0.375,116,36,96,0.375,29,66,0.439,7,30,0.233,23,29,0.793,102
807,IND,2019-03-30,116,,ORL,0,240,48,90,0.533,39,66,0.591,9,24,0.375,11,17,0.647,116,47,92,0.511,32,54,0.593,15,38,0.395,12,14,0.857,121
808,SAS,2019-03-28,116,,CLE,1,240,45,85,0.529,31,52,0.596,14,33,0.424,12,17,0.706,116,45,92,0.489,33,63,0.524,12,29,0.414,8,10,0.8,110
809,BOS,2019-03-26,116,@,CLE,1,240,46,91,0.505,36,66,0.545,10,25,0.4,14,19,0.737,116,39,80,0.488,30,52,0.577,9,28,0.321,19,25,0.76,106
810,SAS,2019-03-26,116,@,CHO,0,265,44,108,0.407,31,69,0.449,13,39,0.333,15,21,0.714,116,46,100,0.46,33,58,0.569,13,42,0.31,20,28,0.714,125
811,MIL,2019-03-22,116,,MIA,1,240,43,85,0.506,26,51,0.51,17,34,0.5,13,20,0.65,116,32,85,0.376,21,48,0.438,11,37,0.297,12,23,0.522,87
812,OKC,2019-03-22,116,@,TOR,1,240,42,94,0.447,22,51,0.431,20,43,0.465,12,14,0.857,116,39,78,0.5,26,53,0.491,13,25,0.52,18,21,0.857,109
813,SAC,2019-03-21,116,,DAL,1,240,41,87,0.471,28,52,0.538,13,35,0.371,21,28,0.75,116,36,92,0.391,24,52,0.462,12,40,0.3,16,23,0.696,100
814,NYK,2019-03-20,116,,UTA,0,240,45,86,0.523,32,55,0.582,13,31,0.419,13,21,0.619,116,48,85,0.565,28,43,0.651,20,42,0.476,21,25,0.84,137
815,CHI,2019-03-18,116,@,PHO,1,240,46,89,0.517,42,73,0.575,4,16,0.25,20,24,0.833,116,39,84,0.464,32,58,0.552,7,26,0.269,16,26,0.615,101
816,MIA,2019-03-18,116,@,OKC,1,240,46,97,0.474,37,68,0.544,9,29,0.31,15,16,0.938,116,38,87,0.437,28,50,0.56,10,37,0.27,21,27,0.778,107
817,UTA,2019-03-18,116,@,WAS,1,240,49,91,0.538,35,54,0.648,14,37,0.378,4,6,0.667,116,34,81,0.42,26,54,0.481,8,27,0.296,19,22,0.864,95
818,BRK,2019-03-17,116,@,LAC,0,240,42,100,0.42,28,62,0.452,14,38,0.368,18,25,0.72,116,42,97,0.433,30,66,0.455,12,31,0.387,23,28,0.821,119
819,CLE,2019-03-16,116,@,DAL,0,240,40,86,0.465,25,48,0.521,15,38,0.395,21,22,0.955,116,46,89,0.517,30,55,0.545,16,34,0.471,13,16,0.813,121
820,CHO,2019-03-15,116,@,WAS,1,240,46,101,0.455,32,70,0.457,14,31,0.452,10,12,0.833,116,41,84,0.488,28,50,0.56,13,34,0.382,15,19,0.789,110
821,NOP,2019-03-10,116,@,ATL,0,240,45,101,0.446,27,60,0.45,18,41,0.439,8,8,1.0,116,48,98,0.49,31,61,0.508,17,37,0.459,15,18,0.833,128
822,SAS,2019-03-02,116,,OKC,1,240,45,91,0.495,37,72,0.514,8,19,0.421,18,25,0.72,116,40,88,0.455,33,59,0.559,7,29,0.241,15,24,0.625,102
823,PHO,2019-03-01,116,,NOP,0,240,40,94,0.426,28,60,0.467,12,34,0.353,24,28,0.857,116,50,87,0.575,34,60,0.567,16,27,0.593,14,20,0.7,130
824,LAC,2019-03-01,116,@,SAC,1,240,40,92,0.435,28,61,0.459,12,31,0.387,24,33,0.727,116,41,93,0.441,35,72,0.486,6,21,0.286,21,25,0.84,109
825,BRK,2019-02-27,116,,WAS,0,240,39,85,0.459,31,50,0.62,8,35,0.229,30,39,0.769,116,44,96,0.458,33,59,0.559,11,37,0.297,26,31,0.839,125
826,BOS,2019-02-23,116,@,CHI,0,240,45,92,0.489,35,63,0.556,10,29,0.345,16,21,0.762,116,47,88,0.534,35,58,0.603,12,30,0.4,20,21,0.952,126
827,OKC,2019-02-23,116,,SAC,0,240,40,105,0.381,26,59,0.441,14,46,0.304,22,28,0.786,116,44,97,0.454,37,78,0.474,7,19,0.368,24,34,0.706,119
828,IND,2019-02-07,116,,LAC,1,240,49,87,0.563,40,65,0.615,9,22,0.409,9,11,0.818,116,37,85,0.435,31,68,0.456,6,17,0.353,12,19,0.632,92
829,UTA,2019-02-06,116,,PHO,1,240,42,84,0.5,31,56,0.554,11,28,0.393,21,32,0.656,116,35,75,0.467,32,58,0.552,3,17,0.176,15,19,0.789,88
830,CLE,2019-01-29,116,,WAS,1,240,45,84,0.536,30,50,0.6,15,34,0.441,11,24,0.458,116,42,87,0.483,30,51,0.588,12,36,0.333,17,23,0.739,113
831,HOU,2019-01-29,116,,NOP,0,240,40,101,0.396,21,45,0.467,19,56,0.339,17,24,0.708,116,46,90,0.511,37,59,0.627,9,31,0.29,20,25,0.8,121
832,LAL,2019-01-27,116,,PHO,1,240,47,89,0.528,37,66,0.561,10,23,0.435,12,18,0.667,116,34,85,0.4,27,59,0.458,7,26,0.269,27,32,0.844,102
833,NOP,2019-01-24,116,@,OKC,0,240,49,101,0.485,39,65,0.6,10,36,0.278,8,12,0.667,116,50,101,0.495,36,69,0.522,14,32,0.438,8,16,0.5,122
834,MIL,2019-01-21,116,,DAL,1,240,42,91,0.462,30,59,0.508,12,32,0.375,20,22,0.909,116,41,99,0.414,27,59,0.458,14,40,0.35,10,17,0.588,106
835,MIN,2019-01-20,116,,PHO,1,240,39,91,0.429,33,67,0.493,6,24,0.25,32,40,0.8,116,40,86,0.465,28,47,0.596,12,39,0.308,22,32,0.688,114
836,MEM,2019-01-18,116,@,BOS,0,240,41,92,0.446,25,57,0.439,16,35,0.457,18,20,0.9,116,44,86,0.512,27,48,0.563,17,38,0.447,17,22,0.773,122
837,SAS,2019-01-18,116,@,MIN,1,240,41,82,0.5,30,58,0.517,11,24,0.458,23,29,0.793,116,37,84,0.44,30,58,0.517,7,26,0.269,32,38,0.842,113
838,ORL,2019-01-13,116,,HOU,1,240,41,85,0.482,32,61,0.525,9,24,0.375,25,28,0.893,116,38,86,0.442,28,44,0.636,10,42,0.238,23,27,0.852,109
839,DEN,2019-01-13,116,,POR,1,240,45,81,0.556,36,59,0.61,9,22,0.409,17,20,0.85,116,40,88,0.455,28,54,0.519,12,34,0.353,21,22,0.955,113
840,BRK,2019-01-09,116,,ATL,1,240,43,95,0.453,33,65,0.508,10,30,0.333,20,26,0.769,116,36,99,0.364,30,64,0.469,6,35,0.171,22,25,0.88,100
841,MIL,2019-01-09,116,@,HOU,1,240,44,91,0.484,36,64,0.563,8,27,0.296,20,24,0.833,116,32,85,0.376,14,37,0.378,18,48,0.375,27,32,0.844,109
842,BOS,2019-01-07,116,,BRK,1,240,47,93,0.505,35,61,0.574,12,32,0.375,10,12,0.833,116,32,79,0.405,21,37,0.568,11,42,0.262,20,22,0.909,95
843,WAS,2019-01-06,116,@,OKC,1,240,44,101,0.436,34,64,0.531,10,37,0.27,18,22,0.818,116,38,88,0.432,28,63,0.444,10,25,0.4,12,19,0.632,98
844,MIL,2019-01-05,116,,TOR,0,240,40,81,0.494,26,44,0.591,14,37,0.378,22,27,0.815,116,42,82,0.512,28,51,0.549,14,31,0.452,25,31,0.806,123
845,CHI,2019-01-04,116,,IND,0,265,47,91,0.516,35,63,0.556,12,28,0.429,10,13,0.769,116,49,93,0.527,40,65,0.615,9,28,0.321,12,17,0.706,119
846,UTA,2019-01-01,116,@,TOR,0,240,42,97,0.433,33,65,0.508,9,32,0.281,23,29,0.793,116,45,82,0.549,38,62,0.613,7,20,0.35,25,35,0.714,122
847,IND,2018-12-31,116,,ATL,1,240,42,84,0.5,31,60,0.517,11,24,0.458,21,29,0.724,116,41,95,0.432,28,63,0.444,13,32,0.406,13,19,0.684,108
848,ORL,2018-12-28,116,,TOR,1,240,44,93,0.473,35,67,0.522,9,26,0.346,19,22,0.864,116,28,95,0.295,16,61,0.262,12,34,0.353,19,24,0.792,87
849,LAL,2018-12-27,116,@,SAC,0,240,45,88,0.511,35,63,0.556,10,25,0.4,16,23,0.696,116,45,101,0.446,35,72,0.486,10,29,0.345,17,21,0.81,117
850,DAL,2018-12-22,116,@,GSW,0,240,42,92,0.457,28,53,0.528,14,39,0.359,18,28,0.643,116,45,98,0.459,30,55,0.545,15,43,0.349,15,16,0.938,120
851,PHI,2018-12-10,116,,DET,1,240,39,88,0.443,24,51,0.471,15,37,0.405,23,35,0.657,116,41,84,0.488,32,63,0.508,9,21,0.429,11,21,0.524,102
852,GSW,2018-12-10,116,,MIN,1,240,39,93,0.419,20,50,0.4,19,43,0.442,19,21,0.905,116,38,83,0.458,31,58,0.534,7,25,0.28,25,31,0.806,108
853,NOP,2018-12-09,116,@,DET,1,240,42,79,0.532,30,49,0.612,12,30,0.4,20,23,0.87,116,43,98,0.439,34,69,0.493,9,29,0.31,13,24,0.542,108
854,CLE,2018-12-08,116,,WAS,1,240,47,89,0.528,32,58,0.552,15,31,0.484,7,10,0.7,116,38,86,0.442,24,48,0.5,14,38,0.368,11,16,0.688,101
855,MIL,2018-11-28,116,,CHI,1,240,43,87,0.494,31,52,0.596,12,35,0.343,18,24,0.75,116,40,89,0.449,29,52,0.558,11,37,0.297,22,29,0.759,113
856,GSW,2018-11-26,116,,ORL,1,240,41,84,0.488,28,49,0.571,13,35,0.371,21,23,0.913,116,40,90,0.444,26,60,0.433,14,30,0.467,16,21,0.762,110
857,SAC,2018-11-24,116,@,GSW,0,240,42,97,0.433,31,69,0.449,11,28,0.393,21,29,0.724,116,41,88,0.466,31,54,0.574,10,34,0.294,25,29,0.862,117
858,PHO,2018-11-23,116,@,MIL,1,240,45,90,0.5,36,64,0.563,9,26,0.346,17,22,0.773,116,42,87,0.483,32,43,0.744,10,44,0.227,20,30,0.667,114
859,DET,2018-11-23,116,,HOU,1,265,40,88,0.455,33,61,0.541,7,27,0.259,29,40,0.725,116,41,98,0.418,31,62,0.5,10,36,0.278,19,21,0.905,111
860,PHO,2018-11-21,116,@,CHI,0,240,48,98,0.49,38,64,0.594,10,34,0.294,10,10,1.0,116,46,81,0.568,35,56,0.625,11,25,0.44,21,24,0.875,124
861,TOR,2018-11-16,116,@,BOS,0,265,42,97,0.433,34,68,0.5,8,29,0.276,24,29,0.828,116,47,89,0.528,38,63,0.603,9,26,0.346,20,24,0.833,123
862,LAC,2018-11-15,116,,SAS,1,240,40,85,0.471,32,62,0.516,8,23,0.348,28,35,0.8,116,41,102,0.402,32,73,0.438,9,29,0.31,20,25,0.8,111
863,PHO,2018-11-14,116,,SAS,1,240,47,84,0.56,32,53,0.604,15,31,0.484,7,8,0.875,116,35,83,0.422,28,60,0.467,7,23,0.304,19,24,0.792,96
864,MEM,2018-11-14,116,@,MIL,1,240,42,83,0.506,28,47,0.596,14,36,0.389,18,24,0.75,116,41,81,0.506,32,46,0.696,9,35,0.257,22,27,0.815,113
865,GSW,2018-11-12,116,@,LAC,0,265,44,94,0.468,32,63,0.508,12,31,0.387,16,23,0.696,116,43,91,0.473,38,71,0.535,5,20,0.25,30,34,0.882,121
866,GSW,2018-11-10,116,,BRK,1,240,46,83,0.554,39,67,0.582,7,16,0.438,17,21,0.81,116,36,77,0.468,29,53,0.547,7,24,0.292,21,29,0.724,100
867,WAS,2018-11-10,116,@,MIA,1,240,40,83,0.482,32,61,0.525,8,22,0.364,28,38,0.737,116,39,88,0.443,27,55,0.491,12,33,0.364,20,26,0.769,110
868,BOS,2018-11-08,116,@,PHO,1,265,39,97,0.402,25,60,0.417,14,37,0.378,24,31,0.774,116,41,93,0.441,30,58,0.517,11,35,0.314,16,19,0.842,109
869,POR,2018-11-08,116,,LAC,1,240,40,97,0.412,30,71,0.423,10,26,0.385,26,28,0.929,116,41,89,0.461,33,66,0.5,8,23,0.348,15,20,0.75,105
870,NOP,2018-11-05,116,@,OKC,0,240,41,84,0.488,32,55,0.582,9,29,0.31,25,30,0.833,116,45,93,0.484,35,66,0.53,10,27,0.37,22,31,0.71,122
871,CHI,2018-11-05,116,@,NYK,1,290,43,95,0.453,35,65,0.538,8,30,0.267,22,30,0.733,116,41,106,0.387,34,80,0.425,7,26,0.269,26,29,0.897,115
872,GSW,2018-11-02,116,,MIN,1,240,43,88,0.489,30,54,0.556,13,34,0.382,17,22,0.773,116,38,101,0.376,25,56,0.446,13,45,0.289,10,14,0.714,99
873,DEN,2018-10-29,116,,NOP,1,240,42,93,0.452,31,58,0.534,11,35,0.314,21,23,0.913,116,43,82,0.524,32,58,0.552,11,24,0.458,14,20,0.7,111
874,TOR,2018-10-26,116,,DAL,1,240,44,91,0.484,33,64,0.516,11,27,0.407,17,20,0.85,116,38,92,0.413,26,62,0.419,12,30,0.4,19,24,0.792,107
875,SAC,2018-10-26,116,,WAS,1,240,44,95,0.463,30,58,0.517,14,37,0.378,14,23,0.609,116,40,86,0.465,26,44,0.591,14,42,0.333,18,23,0.783,112
876,IND,2018-10-24,116,@,SAS,1,240,46,87,0.529,29,55,0.527,17,32,0.531,7,8,0.875,116,35,87,0.402,29,68,0.426,6,19,0.316,20,21,0.952,96
877,NOP,2018-10-23,116,,LAC,1,240,40,93,0.43,34,69,0.493,6,24,0.25,30,40,0.75,116,41,87,0.471,36,67,0.537,5,20,0.25,22,27,0.815,109
878,PHI,2018-10-20,116,,ORL,1,240,45,94,0.479,28,61,0.459,17,33,0.515,9,10,0.9,116,41,90,0.456,25,61,0.41,16,29,0.552,17,22,0.773,115
879,CHI,2018-10-20,116,,DET,0,240,44,87,0.506,37,66,0.561,7,21,0.333,21,26,0.808,116,41,101,0.406,23,61,0.377,18,40,0.45,18,23,0.783,118
880,TOR,2018-10-17,116,,CLE,1,240,45,92,0.489,31,59,0.525,14,33,0.424,12,20,0.6,116,34,85,0.4,27,66,0.409,7,19,0.368,29,39,0.744,104
881,DET,2019-04-10,115,@,NYK,1,240,41,85,0.482,27,52,0.519,14,33,0.424,19,20,0.95,115,31,77,0.403,22,47,0.468,9,30,0.3,18,25,0.72,89
882,POR,2019-04-07,115,,DEN,1,240,41,89,0.461,32,61,0.525,9,28,0.321,24,29,0.828,115,42,95,0.442,29,62,0.468,13,33,0.394,11,20,0.55,108
883,MIL,2019-04-07,115,,ATL,1,240,40,91,0.44,31,50,0.62,9,41,0.22,26,34,0.765,115,40,100,0.4,23,55,0.418,17,45,0.378,10,19,0.526,107
884,TOR,2019-04-03,115,@,BRK,1,240,44,105,0.419,29,67,0.433,15,38,0.395,12,14,0.857,115,41,86,0.477,31,54,0.574,10,32,0.313,13,21,0.619,105
885,CHI,2019-04-03,115,@,WAS,1,240,48,90,0.533,43,71,0.606,5,19,0.263,14,17,0.824,115,45,97,0.464,40,70,0.571,5,27,0.185,19,26,0.731,114
886,CHO,2019-04-03,115,@,NOP,1,240,38,90,0.422,26,56,0.464,12,34,0.353,27,32,0.844,115,40,85,0.471,25,44,0.568,15,41,0.366,14,17,0.824,109
887,PHO,2019-03-30,115,,MEM,0,240,43,81,0.531,31,53,0.585,12,28,0.429,17,23,0.739,115,41,89,0.461,33,64,0.516,8,25,0.32,30,40,0.75,120
888,DEN,2019-03-29,115,@,OKC,1,240,48,85,0.565,34,52,0.654,14,33,0.424,5,6,0.833,115,43,88,0.489,35,61,0.574,8,27,0.296,11,16,0.688,105
889,CHO,2019-03-29,115,@,LAL,0,240,42,88,0.477,27,49,0.551,15,39,0.385,16,17,0.941,115,51,91,0.56,33,53,0.623,18,38,0.474,9,12,0.75,129
890,DET,2019-03-28,115,,ORL,1,240,46,86,0.535,29,51,0.569,17,35,0.486,6,12,0.5,115,37,94,0.394,29,63,0.46,8,31,0.258,16,20,0.8,98
891,UTA,2019-03-27,115,,LAL,1,240,41,83,0.494,31,51,0.608,10,32,0.313,23,36,0.639,115,37,97,0.381,28,70,0.4,9,27,0.333,17,24,0.708,100
892,MEM,2019-03-25,115,,OKC,1,240,40,89,0.449,29,56,0.518,11,33,0.333,24,31,0.774,115,38,95,0.4,26,59,0.441,12,36,0.333,15,20,0.75,103
893,SAS,2019-03-24,115,@,BOS,1,240,50,98,0.51,42,74,0.568,8,24,0.333,7,8,0.875,115,38,94,0.404,31,59,0.525,7,35,0.2,13,16,0.813,96
894,CHO,2019-03-24,115,@,TOR,1,240,41,93,0.441,23,52,0.442,18,41,0.439,15,17,0.882,115,45,77,0.584,34,51,0.667,11,26,0.423,13,13,1.0,114
895,BOS,2019-03-20,115,@,PHI,0,240,45,96,0.469,33,64,0.516,12,32,0.375,13,16,0.813,115,34,90,0.378,23,57,0.404,11,33,0.333,39,43,0.907,118
896,LAC,2019-03-19,115,,IND,1,240,43,89,0.483,33,55,0.6,10,34,0.294,19,27,0.704,115,45,87,0.517,38,66,0.576,7,21,0.333,12,17,0.706,109
897,MIL,2019-03-19,115,,LAL,1,240,41,89,0.461,26,42,0.619,15,47,0.319,18,27,0.667,115,33,86,0.384,17,43,0.395,16,43,0.372,19,23,0.826,101
898,SAC,2019-03-11,115,@,WAS,0,240,41,91,0.451,32,64,0.5,9,27,0.333,24,32,0.75,115,40,86,0.465,26,49,0.531,14,37,0.378,27,33,0.818,121
899,BOS,2019-03-11,115,@,LAC,0,240,44,91,0.484,30,55,0.545,14,36,0.389,13,19,0.684,115,53,86,0.616,40,58,0.69,13,28,0.464,21,25,0.84,140
900,PHO,2019-03-10,115,@,GSW,1,240,42,86,0.488,32,61,0.525,10,25,0.4,21,27,0.778,115,42,95,0.442,32,52,0.615,10,43,0.233,17,22,0.773,111
901,DEN,2019-03-06,115,@,LAL,1,240,45,98,0.459,32,56,0.571,13,42,0.31,12,17,0.706,115,40,84,0.476,33,53,0.623,7,31,0.226,12,23,0.522,99
902,NOP,2019-03-04,115,@,UTA,1,240,46,96,0.479,37,76,0.487,9,20,0.45,14,18,0.778,115,43,92,0.467,29,54,0.537,14,38,0.368,12,14,0.857,112
903,SAC,2019-03-04,115,,NYK,1,240,39,83,0.47,28,54,0.519,11,29,0.379,26,33,0.788,115,39,85,0.459,27,56,0.482,12,29,0.414,18,28,0.643,108
904,HOU,2019-03-03,115,@,BOS,1,240,38,80,0.475,17,29,0.586,21,51,0.412,18,29,0.621,115,37,77,0.481,29,49,0.592,8,28,0.286,22,29,0.759,104
905,UTA,2019-03-02,115,,MIL,1,240,44,96,0.458,32,67,0.478,12,29,0.414,15,26,0.577,115,37,96,0.385,22,57,0.386,15,39,0.385,22,30,0.733,111
906,MIN,2019-02-28,115,@,IND,0,240,42,89,0.472,34,63,0.54,8,26,0.308,23,34,0.676,115,40,84,0.476,24,57,0.421,16,27,0.593,26,31,0.839,122
907,LAL,2019-02-23,115,@,NOP,0,240,44,81,0.543,34,52,0.654,10,29,0.345,17,26,0.654,115,50,96,0.521,35,56,0.625,15,40,0.375,13,16,0.813,128
908,CHO,2019-02-23,115,,BRK,0,240,39,86,0.453,27,51,0.529,12,35,0.343,25,30,0.833,115,40,87,0.46,23,44,0.523,17,43,0.395,20,26,0.769,117
909,PHI,2019-02-23,115,,POR,0,240,42,87,0.483,33,63,0.524,9,24,0.375,22,28,0.786,115,49,99,0.495,44,76,0.579,5,23,0.217,27,29,0.931,130
910,MIN,2019-02-22,115,@,NYK,1,240,41,87,0.471,30,63,0.476,11,24,0.458,22,32,0.688,115,37,86,0.43,26,57,0.456,11,29,0.379,19,24,0.792,104
911,GSW,2019-02-12,115,,UTA,1,240,44,89,0.494,31,48,0.646,13,41,0.317,14,21,0.667,115,41,87,0.471,31,61,0.508,10,26,0.385,16,21,0.762,108
912,CHO,2019-02-05,115,,LAC,0,240,39,93,0.419,24,51,0.471,15,42,0.357,22,26,0.846,115,42,87,0.483,24,63,0.381,18,24,0.75,15,17,0.882,117
913,GSW,2019-02-02,115,,LAL,1,240,43,91,0.473,32,57,0.561,11,34,0.324,18,19,0.947,115,42,96,0.438,35,69,0.507,7,27,0.259,10,17,0.588,101
914,WAS,2019-02-02,115,,MIL,0,240,43,93,0.462,33,60,0.55,10,33,0.303,19,26,0.731,115,45,91,0.495,28,52,0.538,17,39,0.436,24,24,1.0,131
915,SAC,2019-02-02,115,,PHI,1,240,42,92,0.457,31,62,0.5,11,30,0.367,20,24,0.833,115,41,93,0.441,34,60,0.567,7,33,0.212,19,25,0.76,108
916,MIL,2019-01-29,115,@,DET,1,240,47,87,0.54,34,55,0.618,13,32,0.406,8,10,0.8,115,42,89,0.472,30,52,0.577,12,37,0.324,9,12,0.75,105
917,GSW,2019-01-26,115,@,BOS,1,240,37,83,0.446,25,50,0.5,12,33,0.364,29,34,0.853,115,41,99,0.414,26,59,0.441,15,40,0.375,14,15,0.933,111
918,PHI,2019-01-19,115,,OKC,0,240,38,81,0.469,27,49,0.551,11,32,0.344,28,39,0.718,115,41,93,0.441,29,62,0.468,12,31,0.387,23,26,0.885,117
919,PHO,2019-01-19,115,@,CHO,0,240,39,87,0.448,28,54,0.519,11,33,0.333,26,33,0.788,115,48,88,0.545,32,54,0.593,16,34,0.471,23,27,0.852,135
920,ORL,2019-01-18,115,,BRK,0,240,47,94,0.5,37,68,0.544,10,26,0.385,11,14,0.786,115,44,97,0.454,25,51,0.49,19,46,0.413,10,15,0.667,117
921,UTA,2019-01-18,115,,CLE,1,240,44,85,0.518,31,48,0.646,13,37,0.351,14,15,0.933,115,36,87,0.414,29,63,0.46,7,24,0.292,20,26,0.769,99
922,ORL,2019-01-16,115,@,DET,0,265,47,94,0.5,33,55,0.6,14,39,0.359,7,13,0.538,115,44,92,0.478,32,62,0.516,12,30,0.4,20,25,0.8,120
923,SAC,2019-01-14,115,,POR,1,240,43,87,0.494,33,61,0.541,10,26,0.385,19,24,0.792,115,37,92,0.402,27,61,0.443,10,31,0.323,23,29,0.793,107
924,MIN,2019-01-11,115,,DAL,0,240,47,102,0.461,37,78,0.474,10,24,0.417,11,13,0.846,115,44,97,0.454,31,59,0.525,13,38,0.342,18,24,0.75,119
925,MIA,2019-01-10,115,,BOS,1,240,46,96,0.479,28,57,0.491,18,39,0.462,5,8,0.625,115,36,89,0.404,24,55,0.436,12,34,0.353,15,17,0.882,99
926,WAS,2019-01-08,115,@,PHI,0,240,42,84,0.5,28,52,0.538,14,32,0.438,17,21,0.81,115,49,88,0.557,32,55,0.582,17,33,0.515,17,25,0.68,132
927,CLE,2019-01-08,115,,IND,0,240,41,76,0.539,28,47,0.596,13,29,0.448,20,23,0.87,115,49,91,0.538,39,65,0.6,10,26,0.385,15,19,0.789,123
928,PHO,2019-01-08,115,,SAC,1,240,45,88,0.511,35,63,0.556,10,25,0.4,15,19,0.789,115,38,80,0.475,23,51,0.451,15,29,0.517,20,29,0.69,111
929,MIA,2019-01-04,115,,WAS,1,240,44,91,0.484,35,62,0.565,9,29,0.31,18,25,0.72,115,42,98,0.429,32,62,0.516,10,36,0.278,15,19,0.789,109
930,BOS,2019-01-02,115,,MIN,1,240,45,76,0.592,33,46,0.717,12,30,0.4,13,15,0.867,115,40,84,0.476,33,61,0.541,7,23,0.304,15,21,0.714,102
931,DEN,2019-01-01,115,,NYK,1,240,44,95,0.463,32,61,0.525,12,34,0.353,15,23,0.652,115,42,93,0.452,31,66,0.47,11,27,0.407,13,18,0.722,108
932,GSW,2018-12-29,115,@,POR,1,240,40,80,0.5,28,55,0.509,12,25,0.48,23,28,0.821,115,39,91,0.429,30,60,0.5,9,31,0.29,18,22,0.818,105
933,BRK,2018-12-29,115,@,MIL,0,240,38,79,0.481,23,44,0.523,15,35,0.429,24,35,0.686,115,47,96,0.49,26,45,0.578,21,51,0.412,14,16,0.875,129
934,MIA,2018-12-23,115,@,ORL,1,240,43,85,0.506,27,54,0.5,16,31,0.516,13,19,0.684,115,29,70,0.414,19,42,0.452,10,28,0.357,23,32,0.719,91
935,NOP,2018-12-19,115,@,MIL,0,240,43,92,0.467,24,50,0.48,19,42,0.452,10,15,0.667,115,43,85,0.506,30,52,0.577,13,33,0.394,24,30,0.8,123
936,BRK,2018-12-18,115,,LAL,1,240,44,91,0.484,30,57,0.526,14,34,0.412,13,19,0.684,115,42,90,0.467,29,50,0.58,13,40,0.325,13,23,0.565,110
937,MIA,2018-12-07,115,@,PHO,1,240,42,86,0.488,27,49,0.551,15,37,0.405,16,18,0.889,115,36,79,0.456,22,45,0.489,14,34,0.412,12,16,0.75,98
938,MIL,2018-12-05,115,,DET,1,240,38,82,0.463,24,41,0.585,14,41,0.341,25,30,0.833,115,35,95,0.368,26,57,0.456,9,38,0.237,13,19,0.684,92
939,LAC,2018-11-28,115,,PHO,1,240,40,86,0.465,29,65,0.446,11,21,0.524,24,32,0.75,115,39,89,0.438,31,63,0.492,8,26,0.308,13,18,0.722,99
940,POR,2018-11-28,115,,ORL,1,240,37,85,0.435,18,46,0.391,19,39,0.487,22,32,0.688,115,42,81,0.519,28,51,0.549,14,30,0.467,14,15,0.933,112
941,DET,2018-11-27,115,,NYK,1,240,38,80,0.475,31,56,0.554,7,24,0.292,32,45,0.711,115,36,91,0.396,27,64,0.422,9,27,0.333,27,32,0.844,108
942,ATL,2018-11-27,115,@,MIA,1,240,38,80,0.475,26,49,0.531,12,31,0.387,27,32,0.844,115,40,87,0.46,27,49,0.551,13,38,0.342,20,30,0.667,113
943,MIA,2018-11-25,115,@,TOR,0,240,39,95,0.411,24,59,0.407,15,36,0.417,22,32,0.688,115,47,90,0.522,36,55,0.655,11,35,0.314,20,25,0.8,125
944,DEN,2018-11-17,115,@,NOP,0,240,46,95,0.484,31,56,0.554,15,39,0.385,8,13,0.615,115,42,87,0.483,32,62,0.516,10,25,0.4,31,34,0.912,125
945,BRK,2018-11-16,115,@,WAS,1,240,38,90,0.422,29,57,0.509,9,33,0.273,30,38,0.789,115,37,87,0.425,34,69,0.493,3,18,0.167,27,34,0.794,104
946,HOU,2018-11-11,115,,IND,1,240,36,74,0.486,16,27,0.593,20,47,0.426,23,32,0.719,115,36,78,0.462,25,49,0.51,11,29,0.379,20,26,0.769,103
947,ORL,2018-11-11,115,@,NYK,1,240,44,98,0.449,27,56,0.482,17,42,0.405,10,11,0.909,115,31,88,0.352,26,60,0.433,5,28,0.179,22,30,0.733,89
948,BOS,2018-11-09,115,@,UTA,0,240,39,88,0.443,22,45,0.489,17,43,0.395,20,22,0.909,115,43,77,0.558,30,43,0.698,13,34,0.382,24,30,0.8,123
949,NYK,2018-11-05,115,,CHI,0,290,41,106,0.387,34,80,0.425,7,26,0.269,26,29,0.897,115,43,95,0.453,35,65,0.538,8,30,0.267,22,30,0.733,116
950,DET,2018-11-05,115,,MIA,0,265,43,105,0.41,32,70,0.457,11,35,0.314,18,28,0.643,115,44,98,0.449,32,67,0.478,12,31,0.387,20,31,0.645,120
951,DEN,2018-11-05,115,,BOS,1,240,41,90,0.456,28,56,0.5,13,34,0.382,20,28,0.714,115,44,87,0.506,35,56,0.625,9,31,0.29,10,12,0.833,107
952,ATL,2018-11-01,115,,SAC,0,240,42,87,0.483,34,56,0.607,8,31,0.258,23,34,0.676,115,53,98,0.541,39,63,0.619,14,35,0.4,26,32,0.813,146
953,NYK,2018-10-29,115,,BRK,1,240,45,92,0.489,36,68,0.529,9,24,0.375,16,18,0.889,115,34,84,0.405,23,46,0.5,11,38,0.289,17,22,0.773,96
954,BRK,2018-10-26,115,@,NOP,0,240,43,98,0.439,24,58,0.414,19,40,0.475,10,15,0.667,115,44,98,0.449,35,75,0.467,9,23,0.391,20,26,0.769,117
955,DAL,2018-10-22,115,,CHI,1,240,40,93,0.43,25,46,0.543,15,47,0.319,20,21,0.952,115,41,80,0.513,28,57,0.491,13,23,0.565,14,21,0.667,109
956,LAC,2018-10-21,115,,HOU,1,240,42,89,0.472,37,64,0.578,5,25,0.2,26,26,1.0,115,43,89,0.483,28,54,0.519,15,35,0.429,11,15,0.733,112
957,LAL,2018-10-20,115,,HOU,0,240,48,100,0.48,40,68,0.588,8,32,0.25,11,18,0.611,115,44,96,0.458,28,54,0.519,16,42,0.381,20,30,0.667,124
958,ORL,2018-10-20,115,@,PHI,0,240,41,90,0.456,25,61,0.41,16,29,0.552,17,22,0.773,115,45,94,0.479,28,61,0.459,17,33,0.515,9,10,0.9,116
959,CHO,2019-04-10,114,,ORL,0,240,41,78,0.526,33,49,0.673,8,29,0.276,24,27,0.889,114,48,88,0.545,37,58,0.638,11,30,0.367,15,20,0.75,122
960,CLE,2019-04-05,114,@,GSW,0,240,43,97,0.443,36,67,0.537,7,30,0.233,21,23,0.913,114,46,87,0.529,26,50,0.52,20,37,0.541,8,8,1.0,120
961,WAS,2019-04-03,114,,CHI,0,240,45,97,0.464,40,70,0.571,5,27,0.185,19,26,0.731,114,48,90,0.533,43,71,0.606,5,19,0.263,14,17,0.824,115
962,ORL,2019-04-03,114,,NYK,1,240,45,99,0.455,34,67,0.507,11,32,0.344,13,20,0.65,114,38,85,0.447,32,58,0.552,6,27,0.222,18,21,0.857,100
963,BOS,2019-03-29,114,,IND,1,240,44,86,0.512,31,59,0.525,13,27,0.481,13,17,0.765,114,42,90,0.467,30,63,0.476,12,27,0.444,16,23,0.696,112
964,TOR,2019-03-24,114,,CHO,0,240,45,77,0.584,34,51,0.667,11,26,0.423,13,13,1.0,114,41,93,0.441,23,52,0.442,18,41,0.439,15,17,0.882,115
965,DET,2019-03-24,114,@,GSW,0,240,39,84,0.464,27,53,0.509,12,31,0.387,24,25,0.96,114,46,74,0.622,33,49,0.673,13,25,0.52,16,19,0.842,121
966,UTA,2019-03-23,114,@,CHI,1,240,46,95,0.484,35,63,0.556,11,32,0.344,11,15,0.733,114,33,92,0.359,31,76,0.408,2,16,0.125,15,20,0.75,83
967,UTA,2019-03-21,114,@,ATL,0,240,43,94,0.457,33,62,0.532,10,32,0.313,18,26,0.692,114,41,87,0.471,22,47,0.468,19,40,0.475,16,23,0.696,117
968,OKC,2019-03-20,114,,TOR,0,265,43,103,0.417,30,60,0.5,13,43,0.302,15,29,0.517,114,45,87,0.517,31,51,0.608,14,36,0.389,19,21,0.905,123
969,CHO,2019-03-19,114,,PHI,0,240,36,83,0.434,27,48,0.563,9,35,0.257,33,44,0.75,114,43,86,0.5,32,54,0.593,11,32,0.344,21,28,0.75,118
970,DEN,2019-03-18,114,@,BOS,1,240,46,94,0.489,32,55,0.582,14,39,0.359,8,10,0.8,114,39,93,0.419,27,54,0.5,12,39,0.308,15,19,0.789,105
971,UTA,2019-03-16,114,,BRK,1,240,39,91,0.429,26,55,0.473,13,36,0.361,23,31,0.742,114,33,95,0.347,21,59,0.356,12,36,0.333,20,22,0.909,98
972,SAC,2019-03-15,114,@,PHI,0,240,43,94,0.457,34,67,0.507,9,27,0.333,19,24,0.792,114,46,91,0.505,39,67,0.582,7,24,0.292,24,27,0.889,123
973,UTA,2019-03-13,114,@,PHO,1,240,42,90,0.467,30,57,0.526,12,33,0.364,18,25,0.72,114,36,82,0.439,29,63,0.46,7,19,0.368,18,23,0.783,97
974,MIL,2019-03-10,114,@,SAS,0,240,41,87,0.471,27,51,0.529,14,36,0.389,18,25,0.72,114,49,100,0.49,37,71,0.521,12,29,0.414,11,15,0.733,121
975,BRK,2019-03-09,114,@,ATL,1,240,33,86,0.384,18,42,0.429,15,44,0.341,33,54,0.611,114,39,105,0.371,31,64,0.484,8,41,0.195,26,32,0.813,112
976,CHO,2019-03-09,114,@,MIL,0,240,44,93,0.473,29,54,0.537,15,39,0.385,11,14,0.786,114,44,90,0.489,27,46,0.587,17,44,0.386,26,30,0.867,131
977,MEM,2019-03-08,114,,UTA,1,240,46,90,0.511,37,68,0.544,9,22,0.409,13,15,0.867,114,35,82,0.427,17,34,0.5,18,48,0.375,16,24,0.667,104
978,MIN,2019-03-06,114,@,DET,0,240,41,84,0.488,29,57,0.509,12,27,0.444,20,21,0.952,114,50,93,0.538,36,60,0.6,14,33,0.424,17,22,0.773,131
979,UTA,2019-03-06,114,@,NOP,1,240,46,88,0.523,38,58,0.655,8,30,0.267,14,22,0.636,114,41,89,0.461,32,65,0.492,9,24,0.375,13,20,0.65,104
980,PHI,2019-03-05,114,,ORL,1,240,42,89,0.472,31,61,0.508,11,28,0.393,19,21,0.905,114,42,93,0.452,29,61,0.475,13,32,0.406,9,12,0.75,106
981,PHO,2019-03-04,114,,MIL,1,240,41,91,0.451,34,69,0.493,7,22,0.318,25,31,0.806,114,35,95,0.368,23,53,0.434,12,42,0.286,23,31,0.742,105
982,MIA,2019-03-04,114,,ATL,1,240,44,79,0.557,35,56,0.625,9,23,0.391,17,24,0.708,114,38,91,0.418,21,45,0.467,17,46,0.37,20,25,0.8,113
983,DEN,2019-02-22,114,@,DAL,1,240,42,103,0.408,28,66,0.424,14,37,0.378,16,25,0.64,114,34,84,0.405,24,43,0.558,10,41,0.244,26,33,0.788,104
984,BRK,2019-01-31,114,@,SAS,0,240,42,89,0.472,31,55,0.564,11,34,0.324,19,29,0.655,114,40,100,0.4,28,67,0.418,12,33,0.364,25,29,0.862,117
985,DAL,2019-01-30,114,@,NYK,1,240,45,84,0.536,30,46,0.652,15,38,0.395,9,11,0.818,114,32,78,0.41,26,52,0.5,6,26,0.231,20,28,0.714,90
986,NOP,2019-01-26,114,,SAS,0,240,45,96,0.469,38,69,0.551,7,27,0.259,17,24,0.708,114,47,91,0.516,36,67,0.537,11,24,0.458,21,25,0.84,126
987,UTA,2019-01-23,114,,DEN,1,240,38,88,0.432,19,42,0.452,19,46,0.413,19,27,0.704,114,42,88,0.477,34,61,0.557,8,27,0.296,16,20,0.8,108
988,BRK,2019-01-23,114,,ORL,1,240,43,90,0.478,33,58,0.569,10,32,0.313,18,23,0.783,114,38,89,0.427,27,55,0.491,11,34,0.324,23,28,0.821,110
989,HOU,2019-01-23,114,@,NYK,1,240,37,90,0.411,26,46,0.565,11,44,0.25,29,38,0.763,114,37,81,0.457,26,51,0.51,11,30,0.367,25,30,0.833,110
990,POR,2019-01-22,114,@,OKC,0,240,43,95,0.453,33,59,0.559,10,36,0.278,18,22,0.818,114,43,85,0.506,32,62,0.516,11,23,0.478,26,33,0.788,123
991,PHO,2019-01-20,114,@,MIN,0,240,40,86,0.465,28,47,0.596,12,39,0.308,22,32,0.688,114,39,91,0.429,33,67,0.493,6,24,0.25,32,40,0.8,116
992,CHO,2019-01-17,114,,SAC,1,240,39,87,0.448,28,49,0.571,11,38,0.289,25,29,0.862,114,39,88,0.443,28,55,0.509,11,33,0.333,6,13,0.462,95
993,DAL,2019-01-13,114,,GSW,0,240,38,91,0.418,22,53,0.415,16,38,0.421,22,29,0.759,114,45,99,0.455,26,54,0.481,19,45,0.422,10,12,0.833,119
994,ATL,2019-01-13,114,,MIL,0,240,39,96,0.406,27,58,0.466,12,38,0.316,24,30,0.8,114,49,92,0.533,38,62,0.613,11,30,0.367,24,33,0.727,133
995,MIL,2019-01-07,114,,UTA,1,240,46,98,0.469,37,73,0.507,9,25,0.36,13,16,0.813,114,36,86,0.419,22,49,0.449,14,37,0.378,16,23,0.696,102
996,NOP,2019-01-07,114,,MEM,1,240,44,79,0.557,38,62,0.613,6,17,0.353,20,29,0.69,114,35,78,0.449,25,48,0.521,10,30,0.333,15,18,0.833,95
997,BOS,2019-01-04,114,,DAL,1,240,42,96,0.438,21,51,0.412,21,45,0.467,9,11,0.818,114,34,88,0.386,23,44,0.523,11,44,0.25,14,19,0.737,93
998,WAS,2019-01-02,114,,ATL,1,240,43,92,0.467,32,63,0.508,11,29,0.379,17,23,0.739,114,40,95,0.421,30,64,0.469,10,31,0.323,8,13,0.615,98
999,MIN,2018-12-31,114,@,NOP,0,240,43,93,0.462,34,65,0.523,9,28,0.321,19,23,0.826,114,45,87,0.517,31,62,0.5,14,25,0.56,19,21,0.905,123
1000,SAC,2018-12-30,114,@,LAL,0,240,46,95,0.484,33,61,0.541,13,34,0.382,9,12,0.75,114,47,98,0.48,32,54,0.593,15,44,0.341,12,20,0.6,121
1001,NOP,2018-12-28,114,,DAL,1,240,44,96,0.458,40,73,0.548,4,23,0.174,22,27,0.815,114,37,78,0.474,22,46,0.478,15,32,0.469,23,33,0.697,112
1002,PHI,2018-12-27,114,@,UTA,1,240,43,86,0.5,30,51,0.588,13,35,0.371,15,18,0.833,114,33,86,0.384,22,51,0.431,11,35,0.314,20,27,0.741,97
1003,PHI,2018-12-25,114,@,BOS,0,265,38,92,0.413,23,52,0.442,15,40,0.375,23,29,0.793,114,45,108,0.417,31,67,0.463,14,41,0.341,17,20,0.85,121
1004,MIN,2018-12-23,114,@,OKC,1,240,41,83,0.494,27,56,0.482,14,27,0.519,18,27,0.667,114,43,90,0.478,34,65,0.523,9,25,0.36,17,22,0.773,112
1005,IND,2018-12-21,114,@,BRK,1,240,44,82,0.537,33,56,0.589,11,26,0.423,15,18,0.833,114,33,72,0.458,17,41,0.415,16,31,0.516,24,34,0.706,106
1006,ATL,2018-12-21,114,@,NYK,1,240,43,91,0.473,33,62,0.532,10,29,0.345,18,24,0.75,114,41,84,0.488,33,57,0.579,8,27,0.296,17,24,0.708,107
1007,MIL,2018-12-14,114,@,CLE,1,240,40,94,0.426,28,53,0.528,12,41,0.293,22,28,0.786,114,35,87,0.402,22,51,0.431,13,36,0.361,19,21,0.905,102
1008,OKC,2018-12-12,114,@,NOP,0,240,42,87,0.483,29,44,0.659,13,43,0.302,17,27,0.63,114,45,97,0.464,41,79,0.519,4,18,0.222,24,30,0.8,118
1009,DAL,2018-12-12,114,,ATL,1,240,35,75,0.467,23,41,0.561,12,34,0.353,32,43,0.744,114,43,93,0.462,32,60,0.533,11,33,0.333,10,14,0.714,107
1010,CHI,2018-12-07,114,,OKC,1,240,43,82,0.524,31,57,0.544,12,25,0.48,16,23,0.696,114,43,94,0.457,33,66,0.5,10,28,0.357,16,24,0.667,112
1011,OKC,2018-12-05,114,@,BRK,1,240,43,99,0.434,30,61,0.492,13,38,0.342,15,26,0.577,114,37,86,0.43,22,50,0.44,15,36,0.417,23,30,0.767,112
1012,DAL,2018-12-02,114,,LAC,1,240,42,95,0.442,34,72,0.472,8,23,0.348,22,26,0.846,114,42,95,0.442,33,71,0.465,9,24,0.375,17,22,0.773,110
1013,LAL,2018-11-30,114,,DAL,1,240,42,86,0.488,33,56,0.589,9,30,0.3,21,32,0.656,114,34,86,0.395,24,47,0.511,10,39,0.256,25,34,0.735,103
1014,MEM,2018-11-27,114,,TOR,0,240,43,85,0.506,33,56,0.589,10,29,0.345,18,21,0.857,114,42,69,0.609,24,36,0.667,18,33,0.545,20,28,0.714,122
1015,NOP,2018-11-24,114,@,WAS,0,240,43,90,0.478,32,59,0.542,11,31,0.355,17,21,0.81,114,51,90,0.567,41,61,0.672,10,29,0.345,12,23,0.522,124
1016,NYK,2018-11-23,114,,NOP,1,240,41,91,0.451,29,58,0.5,12,33,0.364,20,27,0.741,114,40,101,0.396,33,73,0.452,7,28,0.25,22,29,0.759,109
1017,MIL,2018-11-23,114,,PHO,0,240,42,87,0.483,32,43,0.744,10,44,0.227,20,30,0.667,114,45,90,0.5,36,64,0.563,9,26,0.346,17,22,0.773,116
1018,BOS,2018-11-23,114,@,ATL,1,240,42,91,0.462,29,51,0.569,13,40,0.325,17,21,0.81,114,35,81,0.432,29,46,0.63,6,35,0.171,20,29,0.69,96
1019,NYK,2018-11-20,114,,POR,0,240,42,83,0.506,29,54,0.537,13,29,0.448,17,22,0.773,114,45,95,0.474,29,60,0.483,16,35,0.457,12,17,0.706,118
1020,PHO,2018-11-19,114,@,PHI,0,240,44,87,0.506,31,54,0.574,13,33,0.394,13,24,0.542,114,41,84,0.488,35,62,0.565,6,22,0.273,31,42,0.738,119
1021,MIA,2018-11-12,114,,PHI,0,240,37,77,0.481,24,46,0.522,13,31,0.419,27,33,0.818,114,39,83,0.47,24,47,0.511,15,36,0.417,31,39,0.795,124
1022,DEN,2018-11-11,114,,MIL,0,240,41,89,0.461,23,51,0.451,18,38,0.474,14,20,0.7,114,48,84,0.571,31,50,0.62,17,34,0.5,8,13,0.615,121
1023,LAL,2018-11-07,114,,MIN,1,240,44,91,0.484,29,57,0.509,15,34,0.441,11,14,0.786,114,41,91,0.451,21,51,0.412,20,40,0.5,8,9,0.889,110
1024,TOR,2018-11-07,114,@,SAC,1,240,41,89,0.461,30,53,0.566,11,36,0.306,21,23,0.913,114,42,88,0.477,34,65,0.523,8,23,0.348,13,18,0.722,105
1025,LAL,2018-11-03,114,@,POR,1,240,45,86,0.523,37,65,0.569,8,21,0.381,16,25,0.64,114,44,104,0.423,38,69,0.551,6,35,0.171,16,22,0.727,110
1026,LAL,2018-10-31,114,,DAL,1,240,43,84,0.512,33,67,0.493,10,17,0.588,18,24,0.75,114,43,86,0.5,30,57,0.526,13,29,0.448,14,19,0.737,113
1027,ATL,2018-10-30,114,@,CLE,0,240,44,82,0.537,29,47,0.617,15,35,0.429,11,17,0.647,114,45,90,0.5,32,65,0.492,13,25,0.52,33,43,0.767,136
1028,BRK,2018-10-28,114,,GSW,0,240,42,87,0.483,22,45,0.489,20,42,0.476,10,15,0.667,114,44,89,0.494,33,56,0.589,11,33,0.333,21,24,0.875,120
1029,ORL,2018-10-25,114,,POR,0,240,43,86,0.5,31,56,0.554,12,30,0.4,16,20,0.8,114,48,87,0.552,37,60,0.617,11,27,0.407,21,26,0.808,128
1030,DEN,2018-10-25,114,@,LAL,0,240,46,92,0.5,40,69,0.58,6,23,0.261,16,20,0.8,114,46,92,0.5,36,63,0.571,10,29,0.345,19,23,0.826,121
1031,BRK,2019-04-10,113,,MIA,1,240,43,114,0.377,22,56,0.393,21,58,0.362,6,7,0.857,113,38,98,0.388,30,57,0.526,8,41,0.195,10,15,0.667,94
1032,PHO,2019-04-07,113,@,HOU,0,240,43,93,0.462,32,59,0.542,11,34,0.324,16,21,0.762,113,53,100,0.53,26,43,0.605,27,57,0.474,16,21,0.762,149
1033,LAL,2019-04-07,113,,UTA,1,240,46,89,0.517,39,64,0.609,7,25,0.28,14,21,0.667,113,38,84,0.452,25,42,0.595,13,42,0.31,20,28,0.714,109
1034,NYK,2019-04-07,113,,WAS,1,240,41,80,0.513,24,46,0.522,17,34,0.5,14,19,0.737,113,43,103,0.417,33,69,0.478,10,34,0.294,14,18,0.778,110
1035,CHO,2019-04-05,113,,TOR,1,240,44,94,0.468,31,55,0.564,13,39,0.333,12,14,0.857,113,43,80,0.538,34,54,0.63,9,26,0.346,16,20,0.8,111
1036,ATL,2019-04-05,113,@,ORL,0,240,41,94,0.436,31,55,0.564,10,39,0.256,21,31,0.677,113,56,92,0.609,38,55,0.691,18,37,0.486,19,25,0.76,149
1037,DEN,2019-04-03,113,,SAS,1,240,47,87,0.54,35,54,0.648,12,33,0.364,7,12,0.583,113,31,81,0.383,26,54,0.481,5,27,0.185,18,25,0.72,85
1038,NYK,2019-04-01,113,,CHI,1,240,37,74,0.5,19,36,0.528,18,38,0.474,21,25,0.84,113,42,94,0.447,38,77,0.494,4,17,0.235,17,23,0.739,105
1039,CLE,2019-04-01,113,@,PHO,0,240,45,99,0.455,37,77,0.481,8,22,0.364,15,22,0.682,113,46,84,0.548,33,47,0.702,13,37,0.351,17,20,0.85,122
1040,SAC,2019-03-31,113,@,SAS,1,240,39,81,0.481,28,56,0.5,11,25,0.44,24,28,0.857,113,44,94,0.468,36,67,0.537,8,27,0.296,10,14,0.714,106
1041,LAC,2019-03-31,113,,MEM,1,240,36,75,0.48,29,48,0.604,7,27,0.259,34,38,0.895,113,32,85,0.376,24,52,0.462,8,33,0.242,24,29,0.828,96
1042,NYK,2019-03-24,113,,LAC,0,240,41,86,0.477,32,53,0.604,9,33,0.273,22,25,0.88,113,38,86,0.442,23,51,0.451,15,35,0.429,33,37,0.892,124
1043,HOU,2019-03-24,113,@,NOP,1,240,42,86,0.488,21,37,0.568,21,49,0.429,8,9,0.889,113,38,92,0.413,31,64,0.484,7,28,0.25,7,10,0.7,90
1044,MIA,2019-03-23,113,@,WAS,1,240,44,88,0.5,32,49,0.653,12,39,0.308,13,19,0.684,113,41,96,0.427,32,66,0.485,9,30,0.3,17,23,0.739,108
1045,CHO,2019-03-21,113,,MIN,1,240,43,100,0.43,34,71,0.479,9,29,0.31,18,24,0.75,113,39,88,0.443,29,60,0.483,10,28,0.357,18,29,0.621,106
1046,DEN,2019-03-21,113,@,WAS,1,240,46,87,0.529,32,57,0.561,14,30,0.467,7,11,0.636,113,40,79,0.506,32,51,0.627,8,28,0.286,20,21,0.952,108
1047,MIL,2019-03-15,113,@,MIA,1,240,42,88,0.477,30,55,0.545,12,33,0.364,17,24,0.708,113,38,93,0.409,30,71,0.423,8,22,0.364,14,25,0.56,98
1048,NOP,2019-03-12,113,,MIL,0,240,46,107,0.43,36,60,0.6,10,47,0.213,11,16,0.688,113,48,97,0.495,38,61,0.623,10,36,0.278,24,28,0.857,130
1049,BRK,2019-03-06,113,,CLE,1,240,43,91,0.473,31,58,0.534,12,33,0.364,15,26,0.577,113,35,87,0.402,19,49,0.388,16,38,0.421,21,29,0.724,107
1050,LAC,2019-03-04,113,@,LAL,1,240,41,83,0.494,30,54,0.556,11,29,0.379,20,24,0.833,113,38,91,0.418,28,53,0.528,10,38,0.263,19,24,0.792,105
1051,ATL,2019-03-04,113,@,MIA,0,240,38,91,0.418,21,45,0.467,17,46,0.37,20,25,0.8,113,44,79,0.557,35,56,0.625,9,23,0.391,17,24,0.708,114
1052,CHO,2019-02-27,113,,HOU,0,240,39,83,0.47,27,50,0.54,12,33,0.364,23,27,0.852,113,42,91,0.462,29,52,0.558,13,39,0.333,21,24,0.875,118
1053,DET,2019-02-25,113,,IND,1,240,39,88,0.443,21,47,0.447,18,41,0.439,17,26,0.654,113,40,87,0.46,30,61,0.492,10,26,0.385,19,21,0.905,109
1054,ORL,2019-02-24,113,@,TOR,1,240,42,91,0.462,28,55,0.509,14,36,0.389,15,20,0.75,113,38,91,0.418,27,63,0.429,11,28,0.393,11,14,0.786,98
1055,POR,2019-02-21,113,@,BRK,1,240,46,105,0.438,39,73,0.534,7,32,0.219,14,16,0.875,113,36,92,0.391,29,56,0.518,7,36,0.194,20,26,0.769,99
1056,LAL,2019-02-12,113,@,ATL,0,240,41,95,0.432,27,55,0.491,14,40,0.35,17,25,0.68,113,40,92,0.435,24,50,0.48,16,42,0.381,21,26,0.808,117
1057,MIL,2019-02-04,113,@,BRK,1,240,43,101,0.426,33,62,0.532,10,39,0.256,17,25,0.68,113,33,102,0.324,28,60,0.467,5,42,0.119,23,28,0.821,94
1058,SAS,2019-02-02,113,,NOP,1,240,44,92,0.478,35,69,0.507,9,23,0.391,16,18,0.889,113,43,96,0.448,33,61,0.541,10,35,0.286,12,12,1.0,108
1059,BOS,2019-02-01,113,@,NYK,1,240,46,100,0.46,33,63,0.524,13,37,0.351,8,10,0.8,113,39,86,0.453,30,55,0.545,9,31,0.29,12,12,1.0,99
1060,PHI,2019-01-31,113,@,GSW,1,240,41,88,0.466,29,51,0.569,12,37,0.324,19,24,0.792,113,41,88,0.466,30,50,0.6,11,38,0.289,11,16,0.688,104
1061,ATL,2019-01-30,113,@,SAC,0,240,38,86,0.442,22,40,0.55,16,46,0.348,21,25,0.84,113,54,99,0.545,43,64,0.672,11,35,0.314,16,21,0.762,135
1062,WAS,2019-01-29,113,@,CLE,0,240,42,87,0.483,30,51,0.588,12,36,0.333,17,23,0.739,113,45,84,0.536,30,50,0.6,15,34,0.441,11,24,0.458,116
1063,BOS,2019-01-19,113,@,ATL,1,240,39,88,0.443,27,56,0.482,12,32,0.375,23,25,0.92,113,40,92,0.435,28,51,0.549,12,41,0.293,13,14,0.929,105
1064,MIN,2019-01-18,113,,SAS,0,240,37,84,0.44,30,58,0.517,7,26,0.269,32,38,0.842,113,41,82,0.5,30,58,0.517,11,24,0.458,23,29,0.793,116
1065,POR,2019-01-13,113,@,DEN,0,240,40,88,0.455,28,54,0.519,12,34,0.353,21,22,0.955,113,45,81,0.556,36,59,0.61,9,22,0.409,17,20,0.85,116
1066,CLE,2019-01-11,113,@,HOU,0,240,40,89,0.449,31,56,0.554,9,33,0.273,24,26,0.923,113,46,89,0.517,26,37,0.703,20,52,0.385,29,32,0.906,141
1067,UTA,2019-01-11,113,,LAL,1,240,38,96,0.396,23,54,0.426,15,42,0.357,22,32,0.688,113,37,103,0.359,32,76,0.421,5,27,0.185,16,24,0.667,95
1068,WAS,2019-01-11,113,,MIL,1,240,40,82,0.488,22,49,0.449,18,33,0.545,15,20,0.75,113,40,89,0.449,27,49,0.551,13,40,0.325,13,17,0.765,106
1069,LAL,2019-01-09,113,,DET,1,240,46,82,0.561,38,59,0.644,8,23,0.348,13,18,0.722,113,39,86,0.453,25,42,0.595,14,44,0.318,8,14,0.571,100
1070,DEN,2019-01-07,113,@,HOU,0,240,44,93,0.473,37,64,0.578,7,29,0.241,18,21,0.857,113,38,76,0.5,16,29,0.552,22,47,0.468,27,34,0.794,125
1071,PHO,2019-01-06,113,,CHO,0,240,43,83,0.518,33,58,0.569,10,25,0.4,17,19,0.895,113,44,91,0.484,37,66,0.561,7,25,0.28,24,34,0.706,119
1072,SAC,2019-01-03,113,,DEN,0,240,45,90,0.5,32,59,0.542,13,31,0.419,10,15,0.667,113,41,89,0.461,27,50,0.54,14,39,0.359,21,30,0.7,117
1073,POR,2019-01-01,113,@,SAC,1,265,39,90,0.433,30,58,0.517,9,32,0.281,26,30,0.867,113,44,115,0.383,33,82,0.402,11,33,0.333,9,12,0.75,108
1074,LAC,2019-01-01,113,,PHI,0,240,42,91,0.462,37,66,0.561,5,25,0.2,24,34,0.706,113,42,87,0.483,30,61,0.492,12,26,0.462,23,33,0.697,119
1075,HOU,2018-12-31,113,,MEM,1,240,31,70,0.443,13,29,0.448,18,41,0.439,33,45,0.733,113,38,82,0.463,32,57,0.561,6,25,0.24,19,30,0.633,101
1076,MIN,2018-12-30,113,@,MIA,1,240,38,94,0.404,30,70,0.429,8,24,0.333,29,36,0.806,113,37,90,0.411,29,66,0.439,8,24,0.333,22,28,0.786,104
1077,BOS,2018-12-27,113,@,HOU,0,240,38,81,0.469,26,50,0.52,12,31,0.387,25,31,0.806,113,41,86,0.477,23,41,0.561,18,45,0.4,27,35,0.771,127
1078,HOU,2018-12-25,113,,OKC,1,240,44,97,0.454,30,53,0.566,14,44,0.318,11,17,0.647,113,43,98,0.439,34,68,0.5,9,30,0.3,14,21,0.667,109
1079,SAC,2018-12-19,113,,OKC,0,240,39,93,0.419,26,59,0.441,13,34,0.382,22,33,0.667,113,51,102,0.5,38,70,0.543,13,32,0.406,17,27,0.63,132
1080,DAL,2018-12-16,113,,SAC,0,240,40,96,0.417,31,61,0.508,9,35,0.257,24,31,0.774,113,46,98,0.469,37,67,0.552,9,31,0.29,19,21,0.905,120
1081,DET,2018-12-15,113,,BOS,1,240,39,80,0.488,29,50,0.58,10,30,0.333,25,35,0.714,113,39,94,0.415,30,61,0.492,9,33,0.273,17,23,0.739,104
1082,IND,2018-12-14,113,@,PHI,1,240,42,95,0.442,34,75,0.453,8,20,0.4,21,24,0.875,113,36,88,0.409,27,52,0.519,9,36,0.25,20,27,0.741,101
1083,CLE,2018-12-12,113,,NYK,1,240,43,91,0.473,33,57,0.579,10,34,0.294,17,21,0.81,113,41,94,0.436,30,67,0.448,11,27,0.407,13,14,0.929,106
1084,IND,2018-12-12,113,,MIL,1,240,43,91,0.473,31,61,0.508,12,30,0.4,15,20,0.75,113,38,91,0.418,27,48,0.563,11,43,0.256,10,15,0.667,97
1085,TOR,2018-12-12,113,@,GSW,1,240,44,91,0.484,35,63,0.556,9,28,0.321,16,19,0.842,113,39,82,0.476,33,56,0.589,6,26,0.231,9,13,0.692,93
1086,BOS,2018-12-10,113,,NOP,1,240,44,90,0.489,32,51,0.627,12,39,0.308,13,19,0.684,113,39,87,0.448,31,61,0.508,8,26,0.308,14,19,0.737,100
1087,UTA,2018-12-10,113,@,OKC,0,240,43,84,0.512,35,55,0.636,8,29,0.276,19,30,0.633,113,43,85,0.506,35,64,0.547,8,21,0.381,28,39,0.718,122
1088,POR,2018-12-08,113,,MIN,1,240,39,83,0.47,29,50,0.58,10,33,0.303,25,30,0.833,113,40,91,0.44,33,75,0.44,7,16,0.438,18,22,0.818,105
1089,CHO,2018-12-07,113,,DEN,1,240,33,86,0.384,20,51,0.392,13,35,0.371,34,38,0.895,113,39,101,0.386,31,66,0.47,8,35,0.229,21,26,0.808,107
1090,TOR,2018-12-05,113,,PHI,1,240,43,100,0.43,35,71,0.493,8,29,0.276,19,22,0.864,113,40,88,0.455,29,53,0.547,11,35,0.314,11,14,0.786,102
1091,SAS,2018-12-05,113,@,LAL,0,240,43,96,0.448,36,69,0.522,7,27,0.259,20,20,1.0,113,42,88,0.477,28,49,0.571,14,39,0.359,23,33,0.697,121
1092,DEN,2018-11-30,113,@,POR,1,240,40,87,0.46,26,57,0.456,14,30,0.467,19,26,0.731,113,45,85,0.529,39,63,0.619,6,22,0.273,16,21,0.762,112
1093,CHI,2018-11-28,113,@,MIL,0,240,40,89,0.449,29,52,0.558,11,37,0.297,22,29,0.759,113,43,87,0.494,31,52,0.596,12,35,0.343,18,24,0.75,116
1094,MIA,2018-11-27,113,,ATL,0,240,40,87,0.46,27,49,0.551,13,38,0.342,20,30,0.667,113,38,80,0.475,26,49,0.531,12,31,0.387,27,32,0.844,115
1095,DAL,2018-11-24,113,,BOS,1,240,42,87,0.483,26,46,0.565,16,41,0.39,13,21,0.619,113,41,86,0.477,31,58,0.534,10,28,0.357,12,13,0.923,104
1096,BRK,2018-11-21,113,@,DAL,0,240,42,94,0.447,28,52,0.538,14,42,0.333,15,21,0.714,113,38,78,0.487,27,51,0.529,11,27,0.407,32,41,0.78,119
1097,OKC,2018-11-19,113,@,SAC,0,240,45,108,0.417,33,67,0.493,12,41,0.293,11,16,0.688,113,45,102,0.441,29,64,0.453,16,38,0.421,11,17,0.647,117
1098,DET,2018-11-19,113,,CLE,1,240,41,89,0.461,28,51,0.549,13,38,0.342,18,19,0.947,113,35,79,0.443,27,58,0.466,8,21,0.381,24,34,0.706,102
1099,LAL,2018-11-18,113,@,MIA,1,240,42,95,0.442,31,68,0.456,11,27,0.407,18,21,0.857,113,35,87,0.402,22,55,0.4,13,32,0.406,14,19,0.737,97
1100,PHI,2018-11-16,113,,UTA,1,240,41,81,0.506,30,58,0.517,11,23,0.478,20,32,0.625,113,41,88,0.466,37,66,0.561,4,22,0.182,21,37,0.568,107
1101,MIL,2018-11-14,113,,MEM,0,240,41,81,0.506,32,46,0.696,9,35,0.257,22,27,0.815,113,42,83,0.506,28,47,0.596,14,36,0.389,18,24,0.75,116
1102,CLE,2018-11-13,113,,CHO,1,240,45,85,0.529,32,61,0.525,13,24,0.542,10,12,0.833,113,33,95,0.347,25,54,0.463,8,41,0.195,15,19,0.789,89
1103,BRK,2018-11-12,113,@,MIN,0,240,40,101,0.396,22,51,0.431,18,50,0.36,15,22,0.682,113,42,80,0.525,32,57,0.561,10,23,0.435,26,31,0.839,120
1104,CHO,2018-11-11,113,@,DET,1,240,43,85,0.506,32,57,0.561,11,28,0.393,16,18,0.889,113,38,104,0.365,26,60,0.433,12,44,0.273,15,19,0.789,103
1105,CHO,2018-11-06,113,,ATL,1,240,45,92,0.489,32,61,0.525,13,31,0.419,10,18,0.556,113,41,85,0.482,35,55,0.636,6,30,0.2,14,18,0.778,102
1106,LAC,2018-11-01,113,@,PHI,0,240,38,86,0.442,29,63,0.46,9,23,0.391,28,33,0.848,113,44,93,0.473,31,66,0.47,13,27,0.481,21,28,0.75,122
1107,MIL,2018-11-01,113,@,BOS,0,240,41,85,0.482,32,56,0.571,9,29,0.31,22,30,0.733,113,41,92,0.446,17,37,0.459,24,55,0.436,11,13,0.846,117
1108,DAL,2018-10-31,113,@,LAL,0,240,43,86,0.5,30,57,0.526,13,29,0.448,14,19,0.737,113,43,84,0.512,33,67,0.493,10,17,0.588,18,24,0.75,114
1109,MIA,2018-10-30,113,@,CHO,0,240,41,87,0.471,30,59,0.508,11,28,0.393,20,24,0.833,113,44,81,0.543,31,53,0.585,13,28,0.464,24,29,0.828,125
1110,MIA,2018-10-29,113,,SAC,0,240,38,92,0.413,25,53,0.472,13,39,0.333,24,34,0.706,113,48,97,0.495,36,71,0.507,12,26,0.462,15,25,0.6,123
1111,SAS,2018-10-29,113,,DAL,1,265,42,91,0.462,33,71,0.465,9,20,0.45,20,21,0.952,113,43,91,0.473,33,57,0.579,10,34,0.294,12,17,0.706,108
1112,PHI,2018-10-29,113,,ATL,1,240,41,99,0.414,27,52,0.519,14,47,0.298,17,18,0.944,113,35,94,0.372,27,57,0.474,8,37,0.216,14,21,0.667,92
1113,UTA,2018-10-28,113,@,DAL,1,240,42,80,0.525,32,55,0.582,10,25,0.4,19,22,0.864,113,38,91,0.418,29,63,0.46,9,28,0.321,19,25,0.76,104
1114,MIL,2018-10-27,113,,ORL,1,240,41,82,0.5,31,52,0.596,10,30,0.333,21,23,0.913,113,33,101,0.327,23,58,0.397,10,43,0.233,15,17,0.882,91
1115,HOU,2018-10-26,113,,LAC,0,240,38,98,0.388,23,57,0.404,15,41,0.366,22,25,0.88,113,43,79,0.544,31,56,0.554,12,23,0.522,35,38,0.921,133
1116,PHO,2018-10-24,113,,LAL,0,240,44,84,0.524,34,53,0.642,10,31,0.323,15,21,0.714,113,52,100,0.52,42,72,0.583,10,28,0.357,17,23,0.739,131
1117,NYK,2018-10-22,113,@,MIL,0,240,45,99,0.455,35,70,0.5,10,29,0.345,13,15,0.867,113,45,96,0.469,28,56,0.5,17,40,0.425,17,24,0.708,124
1118,CHO,2018-10-20,113,@,MIA,1,240,41,93,0.441,25,51,0.49,16,42,0.381,15,23,0.652,113,41,89,0.461,30,55,0.545,11,34,0.324,19,27,0.704,112
1119,WAS,2018-10-20,113,,TOR,0,240,37,89,0.416,24,50,0.48,13,39,0.333,26,32,0.813,113,39,88,0.443,29,59,0.492,10,29,0.345,29,36,0.806,117
1120,TOR,2018-10-19,113,,BOS,1,240,43,92,0.467,30,57,0.526,13,35,0.371,14,19,0.737,113,40,99,0.404,26,63,0.413,14,36,0.389,7,10,0.7,101
1121,MIA,2018-10-18,113,@,WAS,1,240,38,97,0.392,26,62,0.419,12,35,0.343,25,34,0.735,113,38,81,0.469,31,55,0.564,7,26,0.269,29,39,0.744,112
1122,MIL,2018-10-17,113,@,CHO,1,240,42,85,0.494,28,51,0.549,14,34,0.412,15,20,0.75,113,41,92,0.446,25,54,0.463,16,38,0.421,14,22,0.636,112
1123,GSW,2019-04-09,112,@,NOP,1,240,43,89,0.483,31,59,0.525,12,30,0.4,14,21,0.667,112,44,99,0.444,35,66,0.53,9,33,0.273,6,10,0.6,103
1124,OKC,2019-04-09,112,,HOU,1,240,40,96,0.417,24,55,0.436,16,41,0.39,16,20,0.8,112,38,88,0.432,20,35,0.571,18,53,0.34,17,20,0.85,111
1125,SAS,2019-04-07,112,@,CLE,1,240,43,82,0.524,34,60,0.567,9,22,0.409,17,22,0.773,112,31,79,0.392,23,50,0.46,8,29,0.276,20,27,0.741,90
1126,DAL,2019-04-05,112,,MEM,0,240,41,96,0.427,24,49,0.49,17,47,0.362,13,21,0.619,112,46,96,0.479,30,55,0.545,16,41,0.39,14,16,0.875,122
1127,WAS,2019-04-05,112,,SAS,0,240,42,88,0.477,33,56,0.589,9,32,0.281,19,22,0.864,112,51,91,0.56,41,66,0.621,10,25,0.4,17,20,0.85,129
1128,BOS,2019-04-03,112,@,MIA,1,240,38,80,0.475,29,56,0.518,9,24,0.375,27,31,0.871,112,39,95,0.411,27,59,0.458,12,36,0.333,12,20,0.6,102
1129,IND,2019-03-29,112,@,BOS,0,240,42,90,0.467,30,63,0.476,12,27,0.444,16,23,0.696,112,44,86,0.512,31,59,0.525,13,27,0.481,13,17,0.765,114
1130,HOU,2019-03-28,112,,DEN,1,240,40,87,0.46,25,47,0.532,15,40,0.375,17,20,0.85,112,31,84,0.369,27,60,0.45,4,24,0.167,19,20,0.95,85
1131,TOR,2019-03-26,112,,CHI,1,240,42,86,0.488,30,58,0.517,12,28,0.429,16,16,1.0,112,39,86,0.453,31,63,0.492,8,23,0.348,17,20,0.85,103
1132,DET,2019-03-23,112,@,POR,0,240,42,84,0.5,28,50,0.56,14,34,0.412,14,14,1.0,112,43,79,0.544,32,53,0.604,11,26,0.423,20,27,0.741,117
1133,SAC,2019-03-23,112,,PHO,1,240,39,92,0.424,22,54,0.407,17,38,0.447,17,22,0.773,112,36,88,0.409,27,54,0.5,9,34,0.265,22,26,0.846,103
1134,MIN,2019-03-23,112,@,MEM,1,240,40,83,0.482,28,57,0.491,12,26,0.462,20,21,0.952,112,36,96,0.375,26,63,0.413,10,33,0.303,17,22,0.773,99
1135,GSW,2019-03-21,112,,IND,1,240,44,89,0.494,31,53,0.585,13,36,0.361,11,16,0.688,112,35,91,0.385,29,68,0.426,6,23,0.261,13,17,0.765,89
1136,SAS,2019-03-12,112,@,DAL,1,240,43,82,0.524,35,60,0.583,8,22,0.364,18,18,1.0,112,38,82,0.463,24,43,0.558,14,39,0.359,15,26,0.577,105
1137,ATL,2019-03-09,112,,BRK,0,240,39,105,0.371,31,64,0.484,8,41,0.195,26,32,0.813,112,33,86,0.384,18,42,0.429,15,44,0.341,33,54,0.611,114
1138,DET,2019-03-08,112,@,CHI,1,240,45,83,0.542,36,56,0.643,9,27,0.333,13,21,0.619,112,42,82,0.512,37,65,0.569,5,17,0.294,15,23,0.652,104
1139,CHO,2019-03-08,112,,WAS,1,240,40,96,0.417,26,55,0.473,14,41,0.341,18,20,0.9,112,40,86,0.465,31,59,0.525,9,27,0.333,22,26,0.846,111
1140,UTA,2019-03-04,112,,NOP,0,240,43,92,0.467,29,54,0.537,14,38,0.368,12,14,0.857,112,46,96,0.479,37,76,0.487,9,20,0.45,14,18,0.778,115
1141,DET,2019-03-03,112,,TOR,1,265,40,86,0.465,28,53,0.528,12,33,0.364,20,29,0.69,112,37,96,0.385,23,57,0.404,14,39,0.359,19,24,0.792,107
1142,DEN,2019-03-02,112,,NOP,0,240,39,92,0.424,30,60,0.5,9,32,0.281,25,29,0.862,112,45,92,0.489,33,62,0.532,12,30,0.4,18,26,0.692,120
1143,IND,2019-03-02,112,,ORL,0,240,42,77,0.545,35,50,0.7,7,27,0.259,21,24,0.875,112,46,91,0.505,36,63,0.571,10,28,0.357,15,19,0.789,117
1144,BRK,2019-03-01,112,,CHO,0,240,44,86,0.512,34,54,0.63,10,32,0.313,14,18,0.778,112,50,94,0.532,41,73,0.562,9,21,0.429,14,17,0.824,123
1145,OKC,2019-02-26,112,@,DEN,0,240,43,95,0.453,33,57,0.579,10,38,0.263,16,25,0.64,112,41,88,0.466,28,60,0.467,13,28,0.464,26,35,0.743,121
1146,MIN,2019-02-25,112,,SAC,1,240,42,83,0.506,34,52,0.654,8,31,0.258,20,28,0.714,112,37,95,0.389,28,69,0.406,9,26,0.346,22,29,0.759,105
1147,DAL,2019-02-25,112,@,LAC,0,240,37,76,0.487,23,40,0.575,14,36,0.389,24,27,0.889,112,45,100,0.45,28,55,0.509,17,45,0.378,14,18,0.778,121
1148,GSW,2019-02-23,112,,HOU,0,240,42,90,0.467,28,54,0.519,14,36,0.389,14,20,0.7,112,40,92,0.435,24,49,0.49,16,43,0.372,22,24,0.917,118
1149,PHO,2019-02-23,112,@,ATL,0,240,41,93,0.441,28,56,0.5,13,37,0.351,17,20,0.85,112,38,92,0.413,26,59,0.441,12,33,0.364,32,38,0.842,120
1150,CLE,2019-02-23,112,,MEM,1,240,39,88,0.443,23,46,0.5,16,42,0.381,18,23,0.783,112,40,90,0.444,35,65,0.538,5,25,0.2,22,28,0.786,107
1151,WAS,2019-02-23,112,,IND,0,240,42,79,0.532,29,44,0.659,13,35,0.371,15,21,0.714,112,47,83,0.566,36,58,0.621,11,25,0.44,14,22,0.636,119
1152,LAC,2019-02-22,112,@,MEM,1,240,35,75,0.467,29,50,0.58,6,25,0.24,36,42,0.857,112,33,90,0.367,24,58,0.414,9,32,0.281,31,36,0.861,106
1153,MIA,2019-02-13,112,@,DAL,1,240,44,81,0.543,32,51,0.627,12,30,0.4,12,16,0.75,112,34,88,0.386,19,36,0.528,15,52,0.288,18,22,0.818,101
1154,BOS,2019-02-12,112,@,PHI,1,240,41,88,0.466,28,59,0.475,13,29,0.448,17,21,0.81,112,39,80,0.488,30,53,0.566,9,27,0.333,22,31,0.71,109
1155,MIL,2019-02-11,112,@,CHI,1,240,38,80,0.475,26,42,0.619,12,38,0.316,24,29,0.828,112,37,96,0.385,28,68,0.412,9,28,0.321,16,18,0.889,99
1156,WAS,2019-02-11,112,@,DET,0,240,42,84,0.5,28,45,0.622,14,39,0.359,14,19,0.737,112,44,85,0.518,29,49,0.592,15,36,0.417,18,21,0.857,121
1157,HOU,2019-02-09,112,,OKC,0,240,37,86,0.43,21,41,0.512,16,45,0.356,22,30,0.733,112,40,89,0.449,27,55,0.491,13,34,0.382,24,30,0.8,117
1158,BOS,2019-02-09,112,,LAC,0,240,39,92,0.424,30,66,0.455,9,26,0.346,25,31,0.806,112,40,84,0.476,28,54,0.519,12,30,0.4,31,40,0.775,123
1159,MIN,2019-02-07,112,@,ORL,0,240,46,99,0.465,36,73,0.493,10,26,0.385,10,12,0.833,112,45,83,0.542,34,57,0.596,11,26,0.423,21,23,0.913,122
1160,SAS,2019-02-04,112,@,SAC,0,240,42,98,0.429,33,66,0.5,9,32,0.281,19,21,0.905,112,50,90,0.556,37,58,0.638,13,32,0.406,14,23,0.609,127
1161,PHO,2019-02-02,112,,ATL,0,240,45,96,0.469,33,64,0.516,12,32,0.375,10,18,0.556,112,43,84,0.512,29,52,0.558,14,32,0.438,18,26,0.692,118
1162,ATL,2019-02-01,112,@,UTA,0,240,39,98,0.398,25,52,0.481,14,46,0.304,20,24,0.833,112,46,87,0.529,34,52,0.654,12,35,0.343,24,30,0.8,128
1163,BOS,2019-01-28,112,,BRK,1,240,45,100,0.45,32,60,0.533,13,40,0.325,9,10,0.9,112,39,103,0.379,26,69,0.377,13,34,0.382,13,16,0.813,104
1164,MIL,2019-01-27,112,@,OKC,0,240,39,91,0.429,24,54,0.444,15,37,0.405,19,28,0.679,112,44,94,0.468,28,62,0.452,16,32,0.5,14,25,0.56,118
1165,GSW,2019-01-18,112,@,LAC,1,240,42,86,0.488,33,49,0.673,9,37,0.243,19,27,0.704,112,31,85,0.365,27,60,0.45,4,25,0.16,28,35,0.8,94
1166,NOP,2019-01-18,112,@,POR,0,240,41,84,0.488,33,59,0.559,8,25,0.32,22,27,0.815,112,48,103,0.466,37,69,0.536,11,34,0.324,21,26,0.808,128
1167,CLE,2019-01-16,112,@,POR,0,240,45,95,0.474,39,76,0.513,6,19,0.316,16,19,0.842,112,47,89,0.528,31,60,0.517,16,29,0.552,19,23,0.826,129
1168,HOU,2019-01-14,112,,MEM,1,240,37,84,0.44,19,36,0.528,18,48,0.375,20,22,0.909,112,36,71,0.507,26,49,0.531,10,22,0.455,12,22,0.545,94
1169,MIA,2019-01-12,112,,MEM,1,240,40,80,0.5,25,49,0.51,15,31,0.484,17,24,0.708,112,39,81,0.481,30,52,0.577,9,29,0.31,21,27,0.778,108
1170,SAS,2019-01-12,112,@,OKC,0,240,44,96,0.458,34,65,0.523,10,31,0.323,14,20,0.7,112,43,93,0.462,32,70,0.457,11,23,0.478,25,29,0.862,122
1171,SAC,2019-01-10,112,,DET,1,240,44,86,0.512,35,64,0.547,9,22,0.409,15,20,0.75,112,35,82,0.427,24,44,0.545,11,38,0.289,21,24,0.875,102
1172,CHI,2019-01-09,112,@,POR,0,240,43,93,0.462,34,71,0.479,9,22,0.409,17,19,0.895,112,47,83,0.566,36,57,0.632,11,26,0.423,19,21,0.905,124
1173,ATL,2019-01-04,112,@,MIL,0,240,37,85,0.435,23,44,0.523,14,41,0.341,24,35,0.686,112,55,100,0.55,41,60,0.683,14,40,0.35,20,28,0.714,144
1174,LAL,2019-01-04,112,,NYK,0,240,43,98,0.439,32,61,0.525,11,37,0.297,15,20,0.75,112,37,99,0.374,26,62,0.419,11,37,0.297,34,41,0.829,119
1175,ORL,2019-01-02,112,@,CHI,1,240,44,76,0.579,33,50,0.66,11,26,0.423,13,18,0.722,112,36,86,0.419,29,66,0.439,7,20,0.35,5,8,0.625,84
1176,BOS,2018-12-29,112,@,MEM,1,240,40,80,0.5,24,44,0.545,16,36,0.444,16,18,0.889,112,36,76,0.474,29,50,0.58,7,26,0.269,24,29,0.828,103
1177,DAL,2018-12-28,112,@,NOP,0,240,37,78,0.474,22,46,0.478,15,32,0.469,23,33,0.697,112,44,96,0.458,40,73,0.548,4,23,0.174,22,27,0.815,114
1178,MIL,2018-12-27,112,,NYK,1,240,42,93,0.452,31,61,0.508,11,32,0.344,17,21,0.81,112,36,97,0.371,23,66,0.348,13,31,0.419,11,16,0.688,96
1179,CHI,2018-12-23,112,@,CLE,1,240,43,78,0.551,32,56,0.571,11,22,0.5,15,17,0.882,112,38,84,0.452,31,61,0.508,7,23,0.304,9,14,0.643,92
1180,OKC,2018-12-23,112,,MIN,0,240,43,90,0.478,34,65,0.523,9,25,0.36,17,22,0.773,112,41,83,0.494,27,56,0.482,14,27,0.519,18,27,0.667,114
1181,LAL,2018-12-21,112,,NOP,1,240,43,92,0.467,35,60,0.583,8,32,0.25,18,25,0.72,112,44,102,0.431,36,75,0.48,8,27,0.296,8,16,0.5,104
1182,BRK,2018-12-08,112,@,NYK,1,240,43,88,0.489,32,66,0.485,11,22,0.5,15,25,0.6,112,39,83,0.47,31,57,0.544,8,26,0.308,18,30,0.6,104
1183,IND,2018-12-07,112,@,ORL,1,240,44,93,0.473,35,67,0.522,9,26,0.346,15,18,0.833,112,36,89,0.404,28,56,0.5,8,33,0.242,10,13,0.769,90
1184,OKC,2018-12-07,112,@,CHI,0,240,43,94,0.457,33,66,0.5,10,28,0.357,16,24,0.667,112,43,82,0.524,31,57,0.544,12,25,0.48,16,23,0.696,114
1185,BRK,2018-12-05,112,,OKC,0,240,37,86,0.43,22,50,0.44,15,36,0.417,23,30,0.767,112,43,99,0.434,30,61,0.492,13,38,0.342,15,26,0.577,114
1186,POR,2018-11-30,112,,DEN,0,240,45,85,0.529,39,63,0.619,6,22,0.273,16,21,0.762,112,40,87,0.46,26,57,0.456,14,30,0.467,19,26,0.731,113
1187,ORL,2018-11-28,112,@,POR,0,240,42,81,0.519,28,51,0.549,14,30,0.467,14,15,0.933,112,37,85,0.435,18,46,0.391,19,39,0.487,22,32,0.688,115
1188,SAC,2018-11-25,112,,UTA,0,240,40,85,0.471,31,62,0.5,9,23,0.391,23,31,0.742,112,49,92,0.533,39,62,0.629,10,30,0.333,25,33,0.758,133
1189,DEN,2018-11-23,112,,ORL,1,240,44,93,0.473,35,65,0.538,9,28,0.321,15,17,0.882,112,32,79,0.405,24,47,0.511,8,32,0.25,15,19,0.789,87
1190,LAC,2018-11-23,112,,MEM,1,265,40,94,0.426,32,71,0.451,8,23,0.348,24,27,0.889,112,42,92,0.457,33,65,0.508,9,27,0.333,14,18,0.778,107
1191,PHI,2018-11-23,112,,CLE,0,240,40,75,0.533,28,42,0.667,12,33,0.364,20,26,0.769,112,49,93,0.527,38,71,0.535,11,22,0.5,12,16,0.75,121
1192,MIN,2018-11-23,112,@,BRK,1,240,44,92,0.478,35,67,0.522,9,25,0.36,15,17,0.882,112,33,79,0.418,19,34,0.559,14,45,0.311,22,26,0.846,102
1193,BOS,2018-11-19,112,@,CHO,0,240,45,89,0.506,36,57,0.632,9,32,0.281,13,18,0.722,112,43,89,0.483,28,48,0.583,15,41,0.366,16,22,0.727,117
1194,SAC,2018-11-17,112,@,HOU,0,240,46,102,0.451,35,67,0.522,11,35,0.314,9,12,0.75,112,46,81,0.568,26,34,0.765,20,47,0.426,20,24,0.833,132
1195,DAL,2018-11-17,112,,GSW,1,240,40,86,0.465,30,52,0.577,10,34,0.294,22,34,0.647,112,42,94,0.447,33,61,0.541,9,33,0.273,16,17,0.941,109
1196,MIN,2018-11-16,112,,POR,1,240,46,92,0.5,34,64,0.531,12,28,0.429,8,11,0.727,112,37,88,0.42,29,59,0.492,8,29,0.276,14,20,0.7,96
1197,MEM,2018-11-16,112,,SAC,1,240,43,85,0.506,32,60,0.533,11,25,0.44,15,24,0.625,112,37,80,0.463,25,47,0.532,12,33,0.364,18,24,0.75,104
1198,MEM,2018-11-10,112,,PHI,1,265,45,103,0.437,34,73,0.466,11,30,0.367,11,15,0.733,112,44,85,0.518,36,54,0.667,8,31,0.258,10,16,0.625,106
1199,NYK,2018-11-10,112,@,TOR,0,240,44,96,0.458,38,74,0.514,6,22,0.273,18,22,0.818,112,42,79,0.532,28,44,0.636,14,35,0.4,30,40,0.75,128
1200,BRK,2018-11-09,112,@,DEN,1,240,36,88,0.409,24,55,0.436,12,33,0.364,28,42,0.667,112,40,87,0.46,35,69,0.507,5,18,0.278,25,34,0.735,110
1201,NYK,2018-11-07,112,@,ATL,1,240,34,77,0.442,23,47,0.489,11,30,0.367,33,47,0.702,112,37,92,0.402,26,54,0.481,11,38,0.289,22,29,0.759,107
1202,PHI,2018-10-30,112,@,TOR,0,240,38,91,0.418,24,51,0.471,14,40,0.35,22,30,0.733,112,47,92,0.511,36,65,0.554,11,27,0.407,24,28,0.857,129
1203,WAS,2018-10-26,112,@,SAC,0,240,40,86,0.465,26,44,0.591,14,42,0.333,18,23,0.783,112,44,95,0.463,30,58,0.517,14,37,0.378,14,23,0.609,116
1204,TOR,2018-10-24,112,,MIN,1,240,46,89,0.517,35,57,0.614,11,32,0.344,9,12,0.75,112,40,96,0.417,25,66,0.379,15,30,0.5,10,16,0.625,105
1205,CHI,2018-10-24,112,,CHO,1,240,37,77,0.481,27,48,0.563,10,29,0.345,28,35,0.8,112,37,85,0.435,27,50,0.54,10,35,0.286,26,29,0.897,110
1206,SAC,2018-10-23,112,@,DEN,0,240,45,86,0.523,32,55,0.582,13,31,0.419,9,20,0.45,112,51,99,0.515,40,69,0.58,11,30,0.367,13,15,0.867,126
1207,HOU,2018-10-21,112,@,LAC,0,240,43,89,0.483,28,54,0.519,15,35,0.429,11,15,0.733,112,42,89,0.472,37,64,0.578,5,25,0.2,26,26,1.0,115
1208,MIA,2018-10-20,112,,CHO,0,240,41,89,0.461,30,55,0.545,11,34,0.324,19,27,0.704,112,41,93,0.441,25,51,0.49,16,42,0.381,15,23,0.652,113
1209,BRK,2018-10-20,112,@,IND,0,240,41,86,0.477,25,49,0.51,16,37,0.432,14,22,0.636,112,51,92,0.554,35,68,0.515,16,24,0.667,14,22,0.636,132
1210,WAS,2018-10-18,112,,MIA,0,240,38,81,0.469,31,55,0.564,7,26,0.269,29,39,0.744,112,38,97,0.392,26,62,0.419,12,35,0.343,25,34,0.735,113
1211,SAS,2018-10-17,112,,MIN,1,240,40,93,0.43,29,68,0.426,11,25,0.44,21,29,0.724,112,39,91,0.429,33,72,0.458,6,19,0.316,24,27,0.889,108
1212,HOU,2018-10-17,112,,NOP,0,240,39,92,0.424,23,44,0.523,16,48,0.333,18,24,0.75,112,52,98,0.531,42,73,0.575,10,25,0.4,17,22,0.773,131
1213,CHO,2018-10-17,112,,MIL,0,240,41,92,0.446,25,54,0.463,16,38,0.421,14,22,0.636,112,42,85,0.494,28,51,0.549,14,34,0.412,15,20,0.75,113
1214,HOU,2019-04-09,111,@,OKC,0,240,38,88,0.432,20,35,0.571,18,53,0.34,17,20,0.85,111,40,96,0.417,24,55,0.436,16,41,0.39,16,20,0.8,112
1215,MIN,2019-04-05,111,,MIA,1,240,43,86,0.5,35,62,0.565,8,24,0.333,17,21,0.81,111,45,88,0.511,35,54,0.648,10,34,0.294,9,12,0.75,109
1216,TOR,2019-04-05,111,@,CHO,0,240,43,80,0.538,34,54,0.63,9,26,0.346,16,20,0.8,111,44,94,0.468,31,55,0.564,13,39,0.333,12,14,0.857,113
1217,ATL,2019-04-02,111,@,SAS,0,240,43,94,0.457,31,60,0.517,12,34,0.353,13,20,0.65,111,42,80,0.525,28,50,0.56,14,30,0.467,19,22,0.864,117
1218,UTA,2019-04-01,111,,CHO,1,240,38,79,0.481,23,44,0.523,15,35,0.429,20,26,0.769,111,36,90,0.4,29,60,0.483,7,30,0.233,23,29,0.793,102
1219,IND,2019-04-01,111,,DET,1,240,42,77,0.545,32,55,0.582,10,22,0.455,17,22,0.773,111,38,88,0.432,26,55,0.473,12,33,0.364,14,19,0.737,102
1220,MIN,2019-03-26,111,,LAC,0,240,41,94,0.436,32,67,0.478,9,27,0.333,20,33,0.606,111,46,85,0.541,30,53,0.566,16,32,0.5,14,14,1.0,122
1221,LAL,2019-03-24,111,,SAC,1,240,39,85,0.459,26,45,0.578,13,40,0.325,20,24,0.833,111,39,104,0.375,25,71,0.352,14,33,0.424,14,23,0.609,106
1222,BRK,2019-03-22,111,@,LAL,1,240,37,92,0.402,21,50,0.42,16,42,0.381,21,28,0.75,111,37,96,0.385,28,60,0.467,9,36,0.25,23,32,0.719,106
1223,HOU,2019-03-22,111,,SAS,1,240,36,86,0.419,22,49,0.449,14,37,0.378,25,32,0.781,111,41,90,0.456,34,66,0.515,7,24,0.292,16,17,0.941,105
1224,DEN,2019-03-22,111,@,NYK,1,240,40,96,0.417,25,58,0.431,15,38,0.395,16,19,0.842,111,34,90,0.378,25,58,0.431,9,32,0.281,16,21,0.762,93
1225,SAS,2019-03-18,111,,GSW,1,240,41,88,0.466,31,62,0.5,10,26,0.385,19,22,0.864,111,41,88,0.466,28,49,0.571,13,39,0.333,10,12,0.833,105
1226,DET,2019-03-15,111,,LAL,1,240,37,86,0.43,20,47,0.426,17,39,0.436,20,32,0.625,111,36,86,0.419,30,61,0.492,6,25,0.24,19,26,0.731,97
1227,TOR,2019-03-14,111,,LAL,1,240,36,91,0.396,20,50,0.4,16,41,0.39,23,29,0.793,111,38,85,0.447,31,54,0.574,7,31,0.226,15,24,0.625,98
1228,MEM,2019-03-13,111,@,ATL,0,240,38,89,0.427,24,49,0.49,14,40,0.35,21,26,0.808,111,52,103,0.505,35,58,0.603,17,45,0.378,11,14,0.786,132
1229,GSW,2019-03-10,111,,PHO,0,240,42,95,0.442,32,52,0.615,10,43,0.233,17,22,0.773,111,42,86,0.488,32,61,0.525,10,25,0.4,21,27,0.778,115
1230,ORL,2019-03-08,111,,DAL,1,240,42,87,0.483,28,58,0.483,14,29,0.483,13,18,0.722,111,42,89,0.472,32,55,0.582,10,34,0.294,12,16,0.75,106
1231,WAS,2019-03-08,111,@,CHO,0,240,40,86,0.465,31,59,0.525,9,27,0.333,22,26,0.846,111,40,96,0.417,26,55,0.473,14,41,0.341,18,20,0.9,112
1232,SAS,2019-03-06,111,@,ATL,1,240,44,89,0.494,34,56,0.607,10,33,0.303,13,18,0.722,111,36,92,0.391,23,49,0.469,13,43,0.302,19,24,0.792,104
1233,BOS,2019-03-06,111,@,SAC,1,240,40,79,0.506,27,46,0.587,13,33,0.394,18,21,0.857,111,40,80,0.5,27,51,0.529,13,29,0.448,16,22,0.727,109
1234,POR,2019-03-05,111,@,MEM,0,240,42,79,0.532,33,50,0.66,9,29,0.31,18,21,0.857,111,40,75,0.533,27,48,0.563,13,27,0.481,27,36,0.75,120
1235,MEM,2019-03-02,111,@,DAL,1,240,39,78,0.5,25,44,0.568,14,34,0.412,19,24,0.792,111,26,85,0.306,19,45,0.422,7,40,0.175,22,33,0.667,81
1236,MIL,2019-03-02,111,@,UTA,0,240,37,96,0.385,22,57,0.386,15,39,0.385,22,30,0.733,111,44,96,0.458,32,67,0.478,12,29,0.414,15,26,0.577,115
1237,UTA,2019-02-28,111,@,DEN,1,240,37,84,0.44,21,41,0.512,16,43,0.372,21,33,0.636,111,40,99,0.404,33,74,0.446,7,25,0.28,17,24,0.708,104
1238,UTA,2019-02-27,111,,LAC,1,240,38,92,0.413,27,58,0.466,11,34,0.324,24,32,0.75,111,37,94,0.394,32,68,0.471,5,26,0.192,26,30,0.867,105
1239,ATL,2019-02-25,111,@,HOU,0,240,39,80,0.488,22,42,0.524,17,38,0.447,16,23,0.696,111,39,90,0.433,24,39,0.615,15,51,0.294,26,30,0.867,119
1240,PHI,2019-02-25,111,@,NOP,1,240,44,101,0.436,34,70,0.486,10,31,0.323,13,19,0.684,111,44,104,0.423,39,76,0.513,5,28,0.179,17,24,0.708,110
1241,NOP,2019-02-22,111,@,IND,0,240,43,93,0.462,35,66,0.53,8,27,0.296,17,30,0.567,111,44,93,0.473,30,61,0.492,14,32,0.438,24,35,0.686,126
1242,LAL,2019-02-21,111,,HOU,1,240,38,86,0.442,30,56,0.536,8,30,0.267,27,33,0.818,111,40,88,0.455,28,47,0.596,12,41,0.293,14,15,0.933,106
1243,CLE,2019-02-21,111,,PHO,1,240,42,85,0.494,29,49,0.592,13,36,0.361,14,20,0.7,111,35,84,0.417,25,52,0.481,10,32,0.313,18,25,0.72,98
1244,NYK,2019-02-13,111,,PHI,0,240,40,100,0.4,31,71,0.437,9,29,0.31,22,27,0.815,111,42,78,0.538,34,55,0.618,8,23,0.348,34,43,0.791,126
1245,HOU,2019-02-13,111,@,MIN,0,240,40,98,0.408,21,45,0.467,19,53,0.358,12,13,0.923,111,49,90,0.544,39,70,0.557,10,20,0.5,13,17,0.765,121
1246,POR,2019-02-11,111,@,OKC,0,240,36,87,0.414,25,58,0.431,11,29,0.379,28,38,0.737,111,41,86,0.477,25,51,0.49,16,35,0.457,22,29,0.759,120
1247,LAC,2019-02-02,111,@,DET,1,240,40,82,0.488,30,62,0.484,10,20,0.5,21,34,0.618,111,35,83,0.422,18,41,0.439,17,42,0.405,14,20,0.7,101
1248,DAL,2019-02-02,111,@,CLE,1,240,40,84,0.476,24,45,0.533,16,39,0.41,15,19,0.789,111,34,85,0.4,30,62,0.484,4,23,0.174,26,33,0.788,98
1249,MIN,2019-01-27,111,,UTA,0,240,37,77,0.481,20,41,0.488,17,36,0.472,20,23,0.87,111,46,86,0.535,31,47,0.66,15,39,0.385,18,25,0.72,125
1250,ATL,2019-01-26,111,@,POR,0,240,42,92,0.457,30,59,0.508,12,33,0.364,15,20,0.75,111,41,82,0.5,30,52,0.577,11,30,0.367,27,30,0.9,120
1251,BOS,2019-01-26,111,,GSW,0,240,41,99,0.414,26,59,0.441,15,40,0.375,14,15,0.933,111,37,83,0.446,25,50,0.5,12,33,0.364,29,34,0.853,115
1252,LAC,2019-01-23,111,@,MIA,1,240,45,85,0.529,38,63,0.603,7,22,0.318,14,21,0.667,111,39,83,0.47,31,55,0.564,8,28,0.286,13,22,0.591,99
1253,LAL,2019-01-21,111,,GSW,0,240,42,84,0.5,37,64,0.578,5,20,0.25,22,38,0.579,111,50,98,0.51,34,61,0.557,16,37,0.432,14,19,0.737,130
1254,IND,2019-01-19,111,,DAL,1,240,42,85,0.494,34,61,0.557,8,24,0.333,19,24,0.792,111,37,88,0.42,28,51,0.549,9,37,0.243,16,20,0.8,99
1255,TOR,2019-01-17,111,,PHO,1,240,43,86,0.5,36,58,0.621,7,28,0.25,18,25,0.72,111,36,84,0.429,27,54,0.5,9,30,0.3,28,36,0.778,109
1256,MIL,2019-01-16,111,@,MEM,1,240,40,84,0.476,28,50,0.56,12,34,0.353,19,22,0.864,111,37,95,0.389,27,64,0.422,10,31,0.323,17,25,0.68,101
1257,DEN,2019-01-15,111,,GSW,0,240,42,92,0.457,28,58,0.483,14,34,0.412,13,16,0.813,111,57,95,0.6,36,56,0.643,21,39,0.538,7,10,0.7,142
1258,SAC,2019-01-08,111,@,PHO,0,240,38,80,0.475,23,51,0.451,15,29,0.517,20,29,0.69,111,45,88,0.511,35,63,0.556,10,25,0.4,15,19,0.789,115
1259,SAC,2019-01-07,111,,ORL,1,240,45,98,0.459,35,64,0.547,10,34,0.294,11,20,0.55,111,32,87,0.368,19,50,0.38,13,37,0.351,18,24,0.75,95
1260,POR,2019-01-07,111,,NYK,1,240,40,85,0.471,29,54,0.537,11,31,0.355,20,29,0.69,111,36,89,0.404,29,66,0.439,7,23,0.304,22,27,0.815,101
1261,OKC,2019-01-04,111,@,POR,1,240,40,94,0.426,32,69,0.464,8,25,0.32,23,26,0.885,111,41,95,0.432,32,64,0.5,9,31,0.29,18,21,0.857,109
1262,PHO,2019-01-04,111,,LAC,0,240,41,77,0.532,32,58,0.552,9,19,0.474,20,27,0.741,111,43,84,0.512,33,60,0.55,10,24,0.417,25,32,0.781,121
1263,BOS,2018-12-31,111,@,SAS,0,240,43,88,0.489,32,54,0.593,11,34,0.324,14,20,0.7,111,45,91,0.495,31,65,0.477,14,26,0.538,16,18,0.889,120
1264,LAC,2018-12-29,111,,SAS,0,240,36,82,0.439,27,62,0.435,9,20,0.45,30,38,0.789,111,44,87,0.506,38,64,0.594,6,23,0.261,28,31,0.903,122
1265,ATL,2018-12-29,111,,CLE,1,240,43,98,0.439,33,61,0.541,10,37,0.27,15,25,0.6,111,40,85,0.471,35,62,0.565,5,23,0.217,23,29,0.793,108
1266,SAS,2018-12-26,111,,DEN,1,240,42,90,0.467,32,58,0.552,10,32,0.313,17,22,0.773,111,35,90,0.389,17,50,0.34,18,40,0.45,15,23,0.652,103
1267,BRK,2018-12-23,111,,PHO,1,240,40,85,0.471,30,58,0.517,10,27,0.37,21,33,0.636,111,43,89,0.483,40,72,0.556,3,17,0.176,14,16,0.875,103
1268,DEN,2018-12-22,111,@,LAC,0,240,41,97,0.423,32,66,0.485,9,31,0.29,20,25,0.8,111,53,92,0.576,43,72,0.597,10,20,0.5,16,17,0.941,132
1269,PHO,2018-12-19,111,@,BOS,1,240,41,96,0.427,30,69,0.435,11,27,0.407,18,22,0.818,111,38,85,0.447,23,46,0.5,15,39,0.385,12,14,0.857,103
1270,LAL,2018-12-13,111,@,HOU,0,240,43,80,0.538,33,48,0.688,10,32,0.313,15,27,0.556,111,42,85,0.494,27,51,0.529,15,34,0.441,27,32,0.844,126
1271,UTA,2018-12-12,111,,MIA,1,240,40,76,0.526,24,44,0.545,16,32,0.5,15,21,0.714,111,29,77,0.377,17,44,0.386,12,33,0.364,14,24,0.583,84
1272,SAS,2018-12-11,111,,PHO,1,240,41,83,0.494,28,62,0.452,13,21,0.619,16,19,0.842,111,33,82,0.402,25,54,0.463,8,28,0.286,12,14,0.857,86
1273,HOU,2018-12-11,111,,POR,1,240,42,85,0.494,33,56,0.589,9,29,0.31,18,27,0.667,111,38,87,0.437,28,62,0.452,10,25,0.4,18,21,0.857,104
1274,LAL,2018-12-08,111,@,MEM,1,240,43,97,0.443,27,57,0.474,16,40,0.4,9,12,0.75,111,34,84,0.405,28,54,0.519,6,30,0.2,14,18,0.778,88
1275,DET,2018-12-07,111,,PHI,0,240,37,89,0.416,30,61,0.492,7,28,0.25,30,37,0.811,111,44,90,0.489,35,58,0.603,9,32,0.281,20,21,0.952,117
1276,DAL,2018-12-04,111,,POR,1,240,38,88,0.432,27,58,0.466,11,30,0.367,24,35,0.686,111,38,84,0.452,31,60,0.517,7,24,0.292,19,23,0.826,102
1277,ATL,2018-12-03,111,,GSW,0,240,44,90,0.489,39,64,0.609,5,26,0.192,18,24,0.75,111,48,82,0.585,35,58,0.603,13,24,0.542,19,22,0.864,128
1278,DET,2018-12-01,111,,GSW,1,240,43,98,0.439,31,63,0.492,12,35,0.343,13,20,0.65,111,39,85,0.459,33,59,0.559,6,26,0.231,18,21,0.857,102
1279,SAC,2018-12-01,111,,IND,1,240,41,91,0.451,28,62,0.452,13,29,0.448,16,24,0.667,111,43,82,0.524,33,58,0.569,10,24,0.417,14,18,0.778,110
1280,CHO,2018-11-30,111,,UTA,0,240,47,95,0.495,38,67,0.567,9,28,0.321,8,13,0.615,111,44,81,0.543,26,41,0.634,18,40,0.45,13,18,0.722,119
1281,MIN,2018-11-24,111,,CHI,1,240,42,103,0.408,35,69,0.507,7,34,0.206,20,23,0.87,111,32,81,0.395,22,48,0.458,10,33,0.303,22,31,0.71,96
1282,HOU,2018-11-23,111,@,DET,0,265,41,98,0.418,31,62,0.5,10,36,0.278,19,21,0.905,111,40,88,0.455,33,61,0.541,7,27,0.259,29,40,0.725,116
1283,SAS,2018-11-23,111,@,IND,1,240,42,83,0.506,32,62,0.516,10,21,0.476,17,24,0.708,111,46,99,0.465,43,75,0.573,3,24,0.125,5,9,0.556,100
1284,SAS,2018-11-15,111,@,LAC,0,240,41,102,0.402,32,73,0.438,9,29,0.31,20,25,0.8,111,40,85,0.471,32,62,0.516,8,23,0.348,28,35,0.8,116
1285,ORL,2018-11-14,111,,PHI,1,240,40,80,0.5,28,52,0.538,12,28,0.429,19,22,0.864,111,41,86,0.477,27,57,0.474,14,29,0.483,10,15,0.667,106
1286,BOS,2018-11-14,111,,CHI,1,240,42,90,0.467,27,56,0.482,15,34,0.441,12,14,0.857,111,33,84,0.393,26,61,0.426,7,23,0.304,9,9,1.0,82
1287,DAL,2018-11-10,111,,OKC,1,240,43,77,0.558,29,48,0.604,14,29,0.483,11,17,0.647,111,38,97,0.392,29,63,0.46,9,34,0.265,11,18,0.611,96
1288,GSW,2018-11-08,111,,MIL,0,240,42,87,0.483,32,59,0.542,10,28,0.357,17,22,0.773,111,52,101,0.515,43,66,0.652,9,35,0.257,21,27,0.778,134
1289,UTA,2018-11-05,111,,TOR,0,240,38,86,0.442,30,55,0.545,8,31,0.258,27,41,0.659,111,49,86,0.57,36,53,0.679,13,33,0.394,13,14,0.929,124
1290,POR,2018-11-04,111,,MIN,1,240,38,86,0.442,31,58,0.534,7,28,0.25,28,32,0.875,111,29,93,0.312,22,63,0.349,7,30,0.233,16,21,0.762,81
1291,WAS,2018-11-02,111,,OKC,0,240,44,86,0.512,35,56,0.625,9,30,0.3,14,18,0.778,111,49,86,0.57,34,54,0.63,15,32,0.469,21,26,0.808,134
1292,BRK,2018-11-02,111,,HOU,0,240,42,85,0.494,27,51,0.529,15,34,0.441,12,20,0.6,111,41,83,0.494,26,44,0.591,15,39,0.385,22,32,0.688,119
1293,OKC,2018-11-01,111,@,CHO,1,240,41,96,0.427,33,59,0.559,8,37,0.216,21,29,0.724,111,38,93,0.409,27,52,0.519,11,41,0.268,20,22,0.909,107
1294,NOP,2018-10-29,111,@,DEN,0,240,43,82,0.524,32,58,0.552,11,24,0.458,14,20,0.7,111,42,93,0.452,31,58,0.534,11,35,0.314,21,23,0.913,116
1295,POR,2018-10-27,111,@,MIA,0,240,37,88,0.42,25,55,0.455,12,33,0.364,25,28,0.893,111,44,96,0.458,29,57,0.509,15,39,0.385,17,26,0.654,120
1296,NOP,2018-10-27,111,,UTA,0,240,40,95,0.421,31,61,0.508,9,34,0.265,22,29,0.759,111,46,88,0.523,36,56,0.643,10,32,0.313,30,37,0.811,132
1297,ATL,2018-10-24,111,,DAL,1,240,37,91,0.407,22,53,0.415,15,38,0.395,22,31,0.71,111,38,91,0.418,26,51,0.51,12,40,0.3,16,26,0.615,104
1298,CLE,2018-10-21,111,,ATL,0,240,46,99,0.465,36,72,0.5,10,27,0.37,9,14,0.643,111,48,98,0.49,26,51,0.51,22,47,0.468,15,19,0.789,133
1299,IND,2018-10-17,111,,MEM,1,240,47,83,0.566,37,57,0.649,10,26,0.385,7,13,0.538,111,25,84,0.298,15,55,0.273,10,29,0.345,23,28,0.821,83
1300,WAS,2019-04-09,110,,BOS,0,240,41,97,0.423,27,58,0.466,14,39,0.359,14,18,0.778,110,45,99,0.455,30,55,0.545,15,44,0.341,11,23,0.478,116
1301,WAS,2019-04-07,110,@,NYK,0,240,43,103,0.417,33,69,0.478,10,34,0.294,14,18,0.778,110,41,80,0.513,24,46,0.522,17,34,0.5,14,19,0.737,113
1302,DET,2019-04-05,110,@,OKC,0,240,35,81,0.432,20,40,0.5,15,41,0.366,25,31,0.806,110,48,101,0.475,36,72,0.5,12,29,0.414,15,22,0.682,123
1303,POR,2019-04-05,110,@,DEN,0,240,42,86,0.488,32,57,0.561,10,29,0.345,16,20,0.8,110,43,84,0.512,36,57,0.632,7,27,0.259,26,29,0.897,119
1304,MIN,2019-04-03,110,@,DAL,1,240,42,86,0.488,32,59,0.542,10,27,0.37,16,20,0.8,110,43,94,0.457,36,55,0.655,7,39,0.179,15,19,0.789,108
1305,BOS,2019-04-01,110,,MIA,1,240,36,91,0.396,19,51,0.373,17,40,0.425,21,24,0.875,110,40,88,0.455,30,51,0.588,10,37,0.27,15,18,0.833,105
1306,BRK,2019-03-30,110,,BOS,1,240,38,83,0.458,26,45,0.578,12,38,0.316,22,28,0.786,110,35,83,0.422,27,63,0.429,8,20,0.4,18,23,0.783,96
1307,BRK,2019-03-28,110,@,PHI,0,240,40,90,0.444,29,58,0.5,11,32,0.344,19,29,0.655,110,45,90,0.5,33,65,0.508,12,25,0.48,21,28,0.75,123
1308,CLE,2019-03-28,110,@,SAS,0,240,45,92,0.489,33,63,0.524,12,29,0.414,8,10,0.8,110,45,85,0.529,31,52,0.596,14,33,0.424,12,17,0.706,116
1309,LAC,2019-03-22,110,@,CLE,1,240,42,82,0.512,36,56,0.643,6,26,0.231,20,23,0.87,110,43,90,0.478,31,59,0.525,12,31,0.387,10,13,0.769,108
1310,MIA,2019-03-20,110,@,SAS,1,240,40,86,0.465,24,51,0.471,16,35,0.457,14,18,0.778,110,38,88,0.432,24,54,0.444,14,34,0.412,15,21,0.714,105
1311,DET,2019-03-17,110,,TOR,1,240,39,83,0.47,31,56,0.554,8,27,0.296,24,27,0.889,110,39,82,0.476,21,46,0.457,18,36,0.5,11,14,0.786,107
1312,GSW,2019-03-16,110,@,OKC,1,240,39,83,0.47,24,48,0.5,15,35,0.429,17,22,0.773,110,31,96,0.323,18,55,0.327,13,41,0.317,13,23,0.565,88
1313,WAS,2019-03-15,110,,CHO,0,240,41,84,0.488,28,50,0.56,13,34,0.382,15,19,0.789,110,46,101,0.455,32,70,0.457,14,31,0.452,10,12,0.833,116
1314,NOP,2019-03-15,110,,POR,0,240,45,94,0.479,37,64,0.578,8,30,0.267,12,25,0.48,110,43,96,0.448,33,69,0.478,10,27,0.37,26,32,0.813,122
1315,OKC,2019-03-08,110,@,LAC,0,240,41,102,0.402,30,58,0.517,11,44,0.25,17,26,0.654,110,39,86,0.453,30,61,0.492,9,25,0.36,31,46,0.674,118
1316,CLE,2019-03-08,110,@,MIA,0,240,39,81,0.481,20,38,0.526,19,43,0.442,13,16,0.813,110,45,79,0.57,33,54,0.611,12,25,0.48,24,33,0.727,126
1317,DAL,2019-02-27,110,,IND,1,240,40,81,0.494,24,44,0.545,16,37,0.432,14,23,0.609,110,37,77,0.481,27,49,0.551,10,28,0.357,17,21,0.81,101
1318,CLE,2019-02-25,110,,POR,0,240,37,89,0.416,24,55,0.436,13,34,0.382,23,26,0.885,110,44,78,0.564,26,49,0.531,18,29,0.621,17,22,0.773,123
1319,CHO,2019-02-25,110,,GSW,0,240,40,91,0.44,33,58,0.569,7,33,0.212,23,26,0.885,110,48,95,0.505,34,54,0.63,14,41,0.341,11,13,0.846,121
1320,MEM,2019-02-25,110,,LAL,1,240,41,93,0.441,32,57,0.561,9,36,0.25,19,23,0.826,110,40,89,0.449,30,62,0.484,10,27,0.37,15,20,0.75,105
1321,NOP,2019-02-25,110,,PHI,0,240,44,104,0.423,39,76,0.513,5,28,0.179,17,24,0.708,110,44,101,0.436,34,70,0.486,10,31,0.323,13,19,0.684,111
1322,CHI,2019-02-22,110,@,ORL,1,240,40,90,0.444,28,61,0.459,12,29,0.414,18,19,0.947,110,41,81,0.506,27,47,0.574,14,34,0.412,13,24,0.542,109
1323,WAS,2019-02-22,110,@,CHO,0,240,42,97,0.433,32,58,0.552,10,39,0.256,16,18,0.889,110,46,96,0.479,33,63,0.524,13,33,0.394,18,22,0.818,123
1324,DET,2019-02-13,110,@,BOS,0,240,36,84,0.429,23,44,0.523,13,40,0.325,25,34,0.735,110,45,88,0.511,29,49,0.592,16,39,0.41,12,15,0.8,118
1325,MEM,2019-02-13,110,@,CHI,0,240,43,89,0.483,32,58,0.552,11,31,0.355,13,17,0.765,110,45,80,0.563,37,60,0.617,8,20,0.4,24,29,0.828,122
1326,DEN,2019-02-08,110,@,PHI,0,240,46,94,0.489,40,68,0.588,6,26,0.231,12,13,0.923,110,39,78,0.5,29,56,0.518,10,22,0.455,29,32,0.906,117
1327,PHO,2019-02-04,110,,HOU,0,240,45,84,0.536,38,59,0.644,7,25,0.28,13,18,0.722,110,43,87,0.494,30,46,0.652,13,41,0.317,19,25,0.76,118
1328,PHI,2019-01-26,110,@,DEN,0,240,38,91,0.418,24,55,0.436,14,36,0.389,20,27,0.741,110,48,94,0.511,40,70,0.571,8,24,0.333,22,29,0.759,126
1329,NYK,2019-01-23,110,,HOU,0,240,37,81,0.457,26,51,0.51,11,30,0.367,25,30,0.833,110,37,90,0.411,26,46,0.565,11,44,0.25,29,38,0.763,114
1330,ORL,2019-01-23,110,@,BRK,0,240,38,89,0.427,27,55,0.491,11,34,0.324,23,28,0.821,110,43,90,0.478,33,58,0.569,10,32,0.313,18,23,0.783,114
1331,IND,2019-01-23,110,,TOR,1,240,40,92,0.435,31,66,0.47,9,26,0.346,21,25,0.84,110,38,92,0.413,26,53,0.491,12,39,0.308,18,23,0.783,106
1332,UTA,2019-01-12,110,,CHI,1,240,38,88,0.432,22,43,0.512,16,45,0.356,18,25,0.72,110,40,97,0.412,33,72,0.458,7,25,0.28,15,17,0.882,102
1333,MIN,2019-01-12,110,,NOP,1,240,40,93,0.43,29,54,0.537,11,39,0.282,19,24,0.792,110,40,87,0.46,35,63,0.556,5,24,0.208,21,24,0.875,106
1334,POR,2019-01-05,110,,HOU,1,240,43,94,0.457,34,66,0.515,9,28,0.321,15,20,0.75,110,39,84,0.464,26,46,0.565,13,38,0.342,10,12,0.833,101
1335,UTA,2019-01-05,110,@,DET,1,240,39,82,0.476,32,61,0.525,7,21,0.333,25,32,0.781,110,39,82,0.476,28,57,0.491,11,25,0.44,16,20,0.8,105
1336,CHO,2019-01-05,110,@,DEN,0,240,39,82,0.476,28,53,0.528,11,29,0.379,21,26,0.808,110,47,102,0.461,33,63,0.524,14,39,0.359,15,20,0.75,123
1337,POR,2018-12-27,110,@,GSW,1,265,38,105,0.362,25,65,0.385,13,40,0.325,21,23,0.913,110,45,106,0.425,32,62,0.516,13,44,0.295,6,15,0.4,109
1338,CLE,2018-12-21,110,@,TOR,0,240,39,82,0.476,30,58,0.517,9,24,0.375,23,30,0.767,110,48,91,0.527,39,60,0.65,9,31,0.29,21,26,0.808,126
1339,CHO,2018-12-19,110,,CLE,1,240,47,92,0.511,37,67,0.552,10,25,0.4,6,9,0.667,110,41,85,0.482,31,62,0.5,10,23,0.435,7,12,0.583,99
1340,WAS,2018-12-18,110,@,ATL,0,240,36,83,0.434,23,43,0.535,13,40,0.325,25,36,0.694,110,37,79,0.468,25,47,0.532,12,32,0.375,32,39,0.821,118
1341,LAL,2018-12-18,110,@,BRK,0,240,42,90,0.467,29,50,0.58,13,40,0.325,13,23,0.565,110,44,91,0.484,30,57,0.526,14,34,0.412,13,19,0.684,115
1342,GSW,2018-12-17,110,,MEM,1,240,37,85,0.435,25,54,0.463,12,31,0.387,24,27,0.889,110,36,79,0.456,29,54,0.537,7,25,0.28,14,18,0.778,93
1343,NYK,2018-12-17,110,,PHO,0,240,40,99,0.404,31,64,0.484,9,35,0.257,21,29,0.724,110,48,92,0.522,39,65,0.6,9,27,0.333,23,27,0.852,128
1344,IND,2018-12-16,110,,NYK,1,240,40,87,0.46,28,53,0.528,12,34,0.353,18,23,0.783,110,37,89,0.416,27,57,0.474,10,32,0.313,15,22,0.682,99
1345,LAL,2018-12-16,110,@,WAS,0,240,44,91,0.484,33,55,0.6,11,36,0.306,11,18,0.611,110,54,106,0.509,41,75,0.547,13,31,0.419,7,10,0.7,128
1346,OKC,2018-12-15,110,,LAC,1,240,42,90,0.467,33,68,0.485,9,22,0.409,17,24,0.708,110,38,75,0.507,25,50,0.5,13,25,0.52,15,22,0.682,104
1347,SAS,2018-12-09,110,,UTA,1,240,47,89,0.528,42,75,0.56,5,14,0.357,11,12,0.917,110,37,85,0.435,28,56,0.5,9,29,0.31,14,19,0.737,97
1348,CLE,2018-12-07,110,,SAC,0,240,43,81,0.531,33,55,0.6,10,26,0.385,14,19,0.737,110,56,98,0.571,43,69,0.623,13,29,0.448,4,7,0.571,129
1349,WAS,2018-12-03,110,@,NYK,1,240,44,92,0.478,31,60,0.517,13,32,0.406,9,12,0.75,110,37,90,0.411,25,56,0.446,12,34,0.353,21,28,0.75,107
1350,OKC,2018-12-03,110,@,DET,1,240,43,85,0.506,36,60,0.6,7,25,0.28,17,20,0.85,110,31,94,0.33,25,62,0.403,6,32,0.188,15,19,0.789,83
1351,LAC,2018-12-02,110,@,DAL,0,240,42,95,0.442,33,71,0.465,9,24,0.375,17,22,0.773,110,42,95,0.442,34,72,0.472,8,23,0.348,22,26,0.846,114
1352,IND,2018-12-01,110,@,SAC,0,240,43,82,0.524,33,58,0.569,10,24,0.417,14,18,0.778,110,41,91,0.451,28,62,0.452,13,29,0.448,16,24,0.667,111
1353,CHO,2018-11-26,110,,MIL,1,240,38,81,0.469,25,52,0.481,13,29,0.448,21,30,0.7,110,37,90,0.411,21,44,0.477,16,46,0.348,17,21,0.81,107
1354,ORL,2018-11-26,110,@,GSW,0,240,40,90,0.444,26,60,0.433,14,30,0.467,16,21,0.762,110,41,84,0.488,28,49,0.571,13,35,0.371,21,23,0.913,116
1355,UTA,2018-11-21,110,,SAC,0,240,38,88,0.432,26,49,0.531,12,39,0.308,22,31,0.71,110,47,89,0.528,36,64,0.563,11,25,0.44,14,19,0.737,119
1356,OKC,2018-11-17,110,@,PHO,1,240,38,85,0.447,31,61,0.508,7,24,0.292,27,32,0.844,110,37,82,0.451,25,53,0.472,12,29,0.414,14,21,0.667,100
1357,GSW,2018-11-13,110,,ATL,1,240,39,91,0.429,27,64,0.422,12,27,0.444,20,21,0.952,110,40,89,0.449,28,57,0.491,12,32,0.375,11,15,0.733,103
1358,TOR,2018-11-12,110,,NOP,0,240,39,97,0.402,26,52,0.5,13,45,0.289,19,22,0.864,110,54,99,0.545,44,72,0.611,10,27,0.37,8,13,0.615,126
1359,MIA,2018-11-10,110,,WAS,0,240,39,88,0.443,27,55,0.491,12,33,0.364,20,26,0.769,110,40,83,0.482,32,61,0.525,8,22,0.364,28,38,0.737,116
1360,IND,2018-11-09,110,@,MIA,1,240,43,79,0.544,36,59,0.61,7,20,0.35,17,29,0.586,110,36,80,0.45,22,53,0.415,14,27,0.519,16,27,0.593,102
1361,DEN,2018-11-09,110,,BRK,0,240,40,87,0.46,35,69,0.507,5,18,0.278,25,34,0.735,110,36,88,0.409,24,55,0.436,12,33,0.364,28,42,0.667,112
1362,MIN,2018-11-09,110,@,SAC,0,240,39,94,0.415,32,69,0.464,7,25,0.28,25,31,0.806,110,43,95,0.453,31,63,0.492,12,32,0.375,23,29,0.793,121
1363,MIN,2018-11-07,110,@,LAL,0,240,41,91,0.451,21,51,0.412,20,40,0.5,8,9,0.889,110,44,91,0.484,29,57,0.509,15,34,0.441,11,14,0.786,114
1364,SAS,2018-11-04,110,,ORL,0,240,38,88,0.432,26,53,0.491,12,35,0.343,22,25,0.88,110,46,91,0.505,34,59,0.576,12,32,0.375,13,18,0.722,117
1365,POR,2018-11-03,110,,LAL,0,240,44,104,0.423,38,69,0.551,6,35,0.171,16,22,0.727,110,45,86,0.523,37,65,0.569,8,21,0.381,16,25,0.64,114
1366,MEM,2018-11-02,110,@,UTA,1,240,38,75,0.507,25,49,0.51,13,26,0.5,21,34,0.618,110,36,77,0.468,22,41,0.537,14,36,0.389,14,25,0.56,100
1367,DEN,2018-11-01,110,@,CLE,1,240,41,85,0.482,31,59,0.525,10,26,0.385,18,21,0.857,110,34,83,0.41,29,65,0.446,5,18,0.278,18,19,0.947,91
1368,LAC,2018-10-30,110,@,OKC,0,240,35,74,0.473,28,54,0.519,7,20,0.35,33,43,0.767,110,48,94,0.511,39,77,0.506,9,17,0.529,23,32,0.719,128
1369,PHO,2018-10-28,110,@,OKC,0,240,38,86,0.442,30,59,0.508,8,27,0.296,26,27,0.963,110,43,85,0.506,36,61,0.59,7,24,0.292,24,35,0.686,117
1370,SAS,2018-10-27,110,,LAL,1,240,44,91,0.484,41,75,0.547,3,16,0.188,19,24,0.792,110,41,86,0.477,28,53,0.528,13,33,0.394,11,18,0.611,106
1371,DET,2018-10-25,110,,CLE,1,240,41,78,0.526,30,50,0.6,11,28,0.393,17,29,0.586,110,41,89,0.461,33,65,0.508,8,24,0.333,13,15,0.867,103
1372,CHO,2018-10-24,110,@,CHI,0,240,37,85,0.435,27,50,0.54,10,35,0.286,26,29,0.897,110,37,77,0.481,27,48,0.563,10,29,0.345,28,35,0.8,112
1373,MIA,2018-10-24,110,,NYK,1,240,39,82,0.476,26,53,0.491,13,29,0.448,19,28,0.679,110,33,91,0.363,21,58,0.362,12,33,0.364,9,14,0.643,87
1374,CHI,2019-04-10,109,@,PHI,0,240,45,95,0.474,36,71,0.507,9,24,0.375,10,15,0.667,109,52,93,0.559,40,67,0.597,12,26,0.462,9,15,0.6,125
1375,PHO,2019-04-09,109,@,DAL,0,240,38,88,0.432,25,53,0.472,13,35,0.371,20,28,0.714,109,41,91,0.451,25,51,0.49,16,40,0.4,22,27,0.815,120
1376,UTA,2019-04-07,109,@,LAL,0,240,38,84,0.452,25,42,0.595,13,42,0.31,20,28,0.714,109,46,89,0.517,39,64,0.609,7,25,0.28,14,21,0.667,113
1377,MIA,2019-04-07,109,@,TOR,0,265,41,100,0.41,28,66,0.424,13,34,0.382,14,19,0.737,109,39,87,0.448,23,46,0.5,16,41,0.39,23,27,0.852,117
1378,MIA,2019-04-05,109,@,MIN,0,240,45,88,0.511,35,54,0.648,10,34,0.294,9,12,0.75,109,43,86,0.5,35,62,0.565,8,24,0.333,17,21,0.81,111
1379,NOP,2019-04-03,109,,CHO,0,240,40,85,0.471,25,44,0.568,15,41,0.366,14,17,0.824,109,38,90,0.422,26,56,0.464,12,34,0.353,27,32,0.844,115
1380,ORL,2019-04-01,109,@,TOR,0,240,43,93,0.462,31,60,0.517,12,33,0.364,11,15,0.733,109,42,84,0.5,23,47,0.489,19,37,0.514,18,22,0.818,121
1381,MIN,2019-03-30,109,,PHI,0,240,39,86,0.453,28,60,0.467,11,26,0.423,20,25,0.8,109,44,94,0.468,29,63,0.46,15,31,0.484,15,21,0.714,118
1382,TOR,2019-03-22,109,,OKC,0,240,39,78,0.5,26,53,0.491,13,25,0.52,18,21,0.857,109,42,94,0.447,22,51,0.431,20,43,0.465,12,14,0.857,116
1383,IND,2019-03-19,109,@,LAC,0,240,45,87,0.517,38,66,0.576,7,21,0.333,12,17,0.706,109,43,89,0.483,33,55,0.6,10,34,0.294,19,27,0.704,115
1384,SAS,2019-03-15,109,,NYK,1,240,47,88,0.534,40,67,0.597,7,21,0.333,8,10,0.8,109,35,86,0.407,27,66,0.409,8,20,0.4,5,9,0.556,83
1385,SAC,2019-03-06,109,,BOS,0,240,40,80,0.5,27,51,0.529,13,29,0.448,16,22,0.727,109,40,79,0.506,27,46,0.587,13,33,0.394,18,21,0.857,111
1386,LAL,2019-03-02,109,@,PHO,0,240,43,89,0.483,35,64,0.547,8,25,0.32,15,23,0.652,109,39,76,0.513,33,50,0.66,6,26,0.231,34,40,0.85,118
1387,SAC,2019-03-01,109,,LAC,0,240,41,93,0.441,35,72,0.486,6,21,0.286,21,25,0.84,109,40,92,0.435,28,61,0.459,12,31,0.387,24,33,0.727,116
1388,CHI,2019-02-27,109,@,MEM,1,240,39,82,0.476,31,58,0.534,8,24,0.333,23,25,0.92,109,41,94,0.436,32,67,0.478,9,27,0.333,16,18,0.889,107
1389,IND,2019-02-25,109,@,DET,0,240,40,87,0.46,30,61,0.492,10,26,0.385,19,21,0.905,109,39,88,0.443,21,47,0.447,18,41,0.439,17,26,0.654,113
1390,DAL,2019-02-23,109,@,UTA,0,240,41,97,0.423,28,61,0.459,13,36,0.361,14,18,0.778,109,41,85,0.482,27,47,0.574,14,38,0.368,29,33,0.879,125
1391,ORL,2019-02-22,109,,CHI,0,240,41,81,0.506,27,47,0.574,14,34,0.412,13,24,0.542,109,40,90,0.444,28,61,0.459,12,29,0.414,18,19,0.947,110
1392,PHI,2019-02-12,109,,BOS,0,240,39,80,0.488,30,53,0.566,9,27,0.333,22,31,0.71,109,41,88,0.466,28,59,0.475,13,29,0.448,17,21,0.81,112
1393,IND,2019-02-04,109,@,NOP,1,240,41,91,0.451,31,63,0.492,10,28,0.357,17,24,0.708,109,39,90,0.433,30,52,0.577,9,38,0.237,20,24,0.833,107
1394,BRK,2019-01-25,109,,NYK,1,240,34,84,0.405,25,51,0.49,9,33,0.273,32,47,0.681,109,37,87,0.425,29,56,0.518,8,31,0.258,17,26,0.654,99
1395,NYK,2019-01-21,109,,OKC,0,240,39,87,0.448,32,64,0.5,7,23,0.304,24,32,0.75,109,45,83,0.542,30,54,0.556,15,29,0.517,22,27,0.815,127
1396,POR,2019-01-21,109,@,UTA,1,240,45,90,0.5,37,72,0.514,8,18,0.444,11,15,0.733,109,36,91,0.396,29,58,0.5,7,33,0.212,25,31,0.806,104
1397,PHO,2019-01-17,109,@,TOR,0,240,36,84,0.429,27,54,0.5,9,30,0.3,28,36,0.778,109,43,86,0.5,36,58,0.621,7,28,0.25,18,25,0.72,111
1398,LAC,2019-01-16,109,,UTA,0,240,45,98,0.459,35,76,0.461,10,22,0.455,9,14,0.643,109,44,86,0.512,33,53,0.623,11,33,0.333,30,37,0.811,129
1399,BRK,2019-01-14,109,,BOS,1,240,37,86,0.43,24,48,0.5,13,38,0.342,22,25,0.88,109,37,91,0.407,26,55,0.473,11,36,0.306,17,23,0.739,102
1400,HOU,2019-01-13,109,@,ORL,0,240,38,86,0.442,28,44,0.636,10,42,0.238,23,27,0.852,109,41,85,0.482,32,61,0.525,9,24,0.375,25,28,0.893,116
1401,DET,2019-01-12,109,@,LAC,1,240,37,85,0.435,21,48,0.438,16,37,0.432,19,22,0.864,109,36,74,0.486,27,56,0.482,9,18,0.5,23,29,0.793,104
1402,CHI,2019-01-11,109,@,GSW,0,240,35,78,0.449,26,58,0.448,9,20,0.45,30,34,0.882,109,53,92,0.576,35,53,0.66,18,39,0.462,22,26,0.846,146
1403,HOU,2019-01-09,109,,MIL,0,240,32,85,0.376,14,37,0.378,18,48,0.375,27,32,0.844,109,44,91,0.484,36,64,0.563,8,27,0.296,20,24,0.833,116
1404,CHO,2019-01-08,109,@,LAC,0,240,36,90,0.4,24,57,0.421,12,33,0.364,25,29,0.862,109,48,93,0.516,34,63,0.54,14,30,0.467,18,21,0.857,128
1405,BRK,2019-01-04,109,@,MEM,1,240,36,79,0.456,23,45,0.511,13,34,0.382,24,26,0.923,109,42,93,0.452,37,69,0.536,5,24,0.208,11,15,0.733,100
1406,WAS,2019-01-04,109,@,MIA,0,240,42,98,0.429,32,62,0.516,10,36,0.278,15,19,0.789,109,44,91,0.484,35,62,0.565,9,29,0.31,18,25,0.72,115
1407,POR,2019-01-04,109,,OKC,0,240,41,95,0.432,32,64,0.5,9,31,0.29,18,21,0.857,109,40,94,0.426,32,69,0.464,8,25,0.32,23,26,0.885,111
1408,PHO,2018-12-31,109,,GSW,0,240,37,85,0.435,28,59,0.475,9,26,0.346,26,30,0.867,109,46,84,0.548,32,56,0.571,14,28,0.5,26,32,0.813,132
1409,ORL,2018-12-30,109,,DET,1,240,40,85,0.471,33,61,0.541,7,24,0.292,22,24,0.917,109,39,92,0.424,31,61,0.508,8,31,0.258,21,23,0.913,107
1410,GSW,2018-12-27,109,,POR,0,265,45,106,0.425,32,62,0.516,13,44,0.295,6,15,0.4,109,38,105,0.362,25,65,0.385,13,40,0.325,21,23,0.913,110
1411,OKC,2018-12-25,109,@,HOU,0,240,43,98,0.439,34,68,0.5,9,30,0.3,14,21,0.667,109,44,97,0.454,30,53,0.566,14,44,0.318,11,17,0.647,113
1412,MIL,2018-12-25,109,@,NYK,1,240,40,89,0.449,34,57,0.596,6,32,0.188,23,34,0.676,109,35,97,0.361,27,68,0.397,8,29,0.276,17,21,0.81,95
1413,NYK,2018-12-19,109,@,PHI,0,240,37,86,0.43,27,55,0.491,10,31,0.323,25,31,0.806,109,47,88,0.534,32,58,0.552,15,30,0.5,22,25,0.88,131
1414,DEN,2018-12-14,109,,OKC,1,240,42,83,0.506,31,49,0.633,11,34,0.324,14,15,0.933,109,37,90,0.411,30,71,0.423,7,19,0.368,17,29,0.586,98
1415,IND,2018-12-10,109,,WAS,1,240,41,76,0.539,31,56,0.554,10,20,0.5,17,22,0.773,109,37,88,0.42,27,58,0.466,10,30,0.333,17,24,0.708,101
1416,CHO,2018-12-02,109,,NOP,0,240,39,91,0.429,29,55,0.527,10,36,0.278,21,28,0.75,109,44,86,0.512,33,54,0.611,11,32,0.344,20,24,0.833,119
1417,MIN,2018-12-01,109,,BOS,0,240,37,82,0.451,28,54,0.519,9,28,0.321,26,32,0.813,109,40,85,0.471,23,41,0.561,17,44,0.386,21,21,1.0,118
1418,ATL,2018-11-30,109,@,OKC,0,240,43,96,0.448,32,60,0.533,11,36,0.306,12,20,0.6,109,46,88,0.523,28,47,0.596,18,41,0.439,14,15,0.933,124
1419,IND,2018-11-27,109,@,PHO,1,240,38,90,0.422,27,64,0.422,11,26,0.423,22,29,0.759,109,41,92,0.446,31,62,0.5,10,30,0.333,12,18,0.667,104
1420,OKC,2018-11-23,109,,CHO,1,240,41,93,0.441,30,60,0.5,11,33,0.333,16,24,0.667,109,43,94,0.457,37,63,0.587,6,31,0.194,12,14,0.857,104
1421,NOP,2018-11-23,109,@,NYK,0,240,40,101,0.396,33,73,0.452,7,28,0.25,22,29,0.759,109,41,91,0.451,29,58,0.5,12,33,0.364,20,27,0.741,114
1422,BOS,2018-11-21,109,,NYK,0,240,38,97,0.392,28,64,0.438,10,33,0.303,23,32,0.719,109,44,89,0.494,29,59,0.492,15,30,0.5,14,17,0.824,117
1423,IND,2018-11-21,109,@,CHO,0,240,41,84,0.488,30,51,0.588,11,33,0.333,16,17,0.941,109,45,80,0.563,27,51,0.529,18,29,0.621,19,22,0.864,127
1424,LAL,2018-11-21,109,@,CLE,1,240,40,78,0.513,31,53,0.585,9,25,0.36,20,28,0.714,109,39,102,0.382,26,68,0.382,13,34,0.382,14,15,0.933,105
1425,WAS,2018-11-18,109,,POR,0,240,43,96,0.448,30,64,0.469,13,32,0.406,10,21,0.476,109,39,86,0.453,28,56,0.5,11,30,0.367,30,35,0.857,119
1426,GSW,2018-11-17,109,@,DAL,0,240,42,94,0.447,33,61,0.541,9,33,0.273,16,17,0.941,109,40,86,0.465,30,52,0.577,10,34,0.294,22,34,0.647,112
1427,HOU,2018-11-13,109,@,DEN,1,240,39,71,0.549,26,34,0.765,13,37,0.351,18,26,0.692,109,38,76,0.5,27,51,0.529,11,25,0.44,12,16,0.75,99
1428,ORL,2018-11-12,109,@,WAS,0,240,43,89,0.483,28,59,0.475,15,30,0.5,8,11,0.727,109,40,79,0.506,27,46,0.587,13,33,0.394,24,33,0.727,117
1429,ATL,2018-11-09,109,,DET,0,240,36,79,0.456,29,51,0.569,7,28,0.25,30,40,0.75,109,46,97,0.474,26,50,0.52,20,47,0.426,12,19,0.632,124
1430,PHO,2018-11-08,109,,BOS,0,265,41,93,0.441,30,58,0.517,11,35,0.314,16,19,0.842,109,39,97,0.402,25,60,0.417,14,37,0.378,24,31,0.774,116
1431,MIN,2018-11-05,109,@,LAC,0,240,40,85,0.471,35,64,0.547,5,21,0.238,24,30,0.8,109,43,88,0.489,29,57,0.509,14,31,0.452,20,22,0.909,120
1432,SAC,2018-11-04,109,@,MIL,0,240,42,95,0.442,28,59,0.475,14,36,0.389,11,22,0.5,109,46,95,0.484,24,39,0.615,22,56,0.393,30,33,0.909,144
1433,PHI,2018-11-03,109,,DET,1,240,28,69,0.406,19,40,0.475,9,29,0.31,44,51,0.863,109,33,83,0.398,28,53,0.528,5,30,0.167,28,41,0.683,99
1434,SAS,2018-11-03,109,,NOP,1,240,45,96,0.469,37,73,0.507,8,23,0.348,11,14,0.786,109,36,77,0.468,30,56,0.536,6,21,0.286,17,30,0.567,95
1435,TOR,2018-10-29,109,@,MIL,0,240,39,103,0.379,30,58,0.517,9,45,0.2,22,28,0.786,109,45,92,0.489,26,47,0.553,19,45,0.422,15,19,0.789,124
1436,BOS,2018-10-27,109,@,DET,1,240,39,86,0.453,25,52,0.481,14,34,0.412,17,25,0.68,109,33,89,0.371,26,52,0.5,7,37,0.189,16,20,0.8,89
1437,LAC,2018-10-23,109,@,NOP,0,240,41,87,0.471,36,67,0.537,5,20,0.25,22,27,0.815,109,40,93,0.43,34,69,0.493,6,24,0.25,30,40,0.75,116
1438,CHI,2018-10-22,109,@,DAL,0,240,41,80,0.513,28,57,0.491,13,23,0.565,14,21,0.667,109,40,93,0.43,25,46,0.543,15,47,0.319,20,21,0.952,115
1439,DEN,2019-04-09,108,@,UTA,0,240,41,88,0.466,29,63,0.46,12,25,0.48,14,22,0.636,108,41,78,0.526,31,51,0.608,10,27,0.37,26,34,0.765,118
1440,BOS,2019-04-07,108,,ORL,0,240,42,89,0.472,30,58,0.517,12,31,0.387,12,14,0.857,108,41,90,0.456,29,57,0.509,12,33,0.364,22,22,1.0,116
1441,BRK,2019-04-07,108,@,IND,1,240,40,88,0.455,29,52,0.558,11,36,0.306,17,22,0.773,108,41,85,0.482,31,58,0.534,10,27,0.37,4,7,0.571,96
1442,DEN,2019-04-07,108,@,POR,0,240,42,95,0.442,29,62,0.468,13,33,0.394,11,20,0.55,108,41,89,0.461,32,61,0.525,9,28,0.321,24,29,0.828,115
1443,GSW,2019-04-04,108,@,LAL,1,240,43,98,0.439,25,52,0.481,18,46,0.391,4,5,0.8,108,37,104,0.356,29,67,0.433,8,37,0.216,8,14,0.571,90
1444,DAL,2019-04-03,108,,MIN,0,240,43,94,0.457,36,55,0.655,7,39,0.179,15,19,0.789,108,42,86,0.488,32,59,0.542,10,27,0.37,16,20,0.8,110
1445,IND,2019-04-03,108,@,DET,1,240,43,92,0.467,37,71,0.521,6,21,0.286,16,22,0.727,108,31,80,0.388,20,39,0.513,11,41,0.268,16,24,0.667,89
1446,CLE,2019-03-30,108,@,LAC,0,240,41,92,0.446,38,69,0.551,3,23,0.13,23,28,0.821,108,53,85,0.624,38,52,0.731,15,33,0.455,11,16,0.688,132
1447,SAC,2019-03-30,108,@,HOU,0,240,42,94,0.447,27,65,0.415,15,29,0.517,9,15,0.6,108,39,83,0.47,22,31,0.71,17,52,0.327,24,27,0.889,119
1448,MIL,2019-03-26,108,,HOU,1,240,42,94,0.447,28,60,0.467,14,34,0.412,10,13,0.769,108,36,99,0.364,20,47,0.426,16,52,0.308,6,7,0.857,94
1449,WAS,2019-03-23,108,,MIA,0,240,41,96,0.427,32,66,0.485,9,30,0.3,17,23,0.739,108,44,88,0.5,32,49,0.653,12,39,0.308,13,19,0.684,113
1450,CLE,2019-03-22,108,,LAC,0,240,43,90,0.478,31,59,0.525,12,31,0.387,10,13,0.769,108,42,82,0.512,36,56,0.643,6,26,0.231,20,23,0.87,110
1451,WAS,2019-03-21,108,,DEN,0,240,40,79,0.506,32,51,0.627,8,28,0.286,20,21,0.952,108,46,87,0.529,32,57,0.561,14,30,0.467,7,11,0.636,113
1452,SAS,2019-03-16,108,,POR,1,240,37,79,0.468,29,62,0.468,8,17,0.471,26,30,0.867,108,42,101,0.416,35,73,0.479,7,28,0.25,12,14,0.857,103
1453,HOU,2019-03-15,108,,PHO,1,240,36,83,0.434,25,43,0.581,11,40,0.275,25,33,0.758,108,38,89,0.427,31,63,0.492,7,26,0.269,19,25,0.76,102
1454,IND,2019-03-14,108,,OKC,1,240,37,82,0.451,30,60,0.5,7,22,0.318,27,32,0.844,108,38,86,0.442,24,56,0.429,14,30,0.467,16,20,0.8,106
1455,MIA,2019-03-13,108,,DET,1,240,39,84,0.464,28,56,0.5,11,28,0.393,19,24,0.792,108,27,77,0.351,19,40,0.475,8,37,0.216,12,18,0.667,74
1456,OKC,2019-03-13,108,,BRK,1,240,41,96,0.427,30,68,0.441,11,28,0.393,15,19,0.789,108,35,84,0.417,22,49,0.449,13,35,0.371,13,19,0.684,96
1457,CHI,2019-03-10,108,@,DET,0,240,41,82,0.5,32,64,0.5,9,18,0.5,17,26,0.654,108,49,91,0.538,30,56,0.536,19,35,0.543,14,22,0.636,131
1458,CHI,2019-03-06,108,,PHI,1,240,41,93,0.441,35,70,0.5,6,23,0.261,20,27,0.741,108,40,87,0.46,32,63,0.508,8,24,0.333,19,24,0.792,107
1459,NYK,2019-03-04,108,@,SAC,0,240,39,85,0.459,27,56,0.482,12,29,0.414,18,28,0.643,108,39,83,0.47,28,54,0.519,11,29,0.379,26,33,0.788,115
1460,CHO,2019-03-03,108,,POR,0,240,37,83,0.446,23,50,0.46,14,33,0.424,20,23,0.87,108,43,96,0.448,32,64,0.5,11,32,0.344,21,23,0.913,118
1461,PHI,2019-02-28,108,@,OKC,1,240,42,91,0.462,30,61,0.492,12,30,0.4,12,19,0.632,108,38,87,0.437,30,60,0.5,8,27,0.296,20,28,0.714,104
1462,NYK,2019-02-26,108,,ORL,1,240,38,89,0.427,31,65,0.477,7,24,0.292,25,32,0.781,108,39,89,0.438,28,57,0.491,11,32,0.344,14,20,0.7,103
1463,UTA,2019-02-12,108,@,GSW,0,240,41,87,0.471,31,61,0.508,10,26,0.385,16,21,0.762,108,44,89,0.494,31,48,0.646,13,41,0.317,14,21,0.667,115
1464,SAS,2019-02-12,108,@,MEM,1,240,36,86,0.419,23,65,0.354,13,21,0.619,23,29,0.793,108,44,89,0.494,36,65,0.554,8,24,0.333,11,16,0.688,107
1465,ATL,2019-02-10,108,,ORL,0,240,37,80,0.463,24,48,0.5,13,32,0.406,21,25,0.84,108,43,91,0.473,30,54,0.556,13,37,0.351,25,28,0.893,124
1466,POR,2019-02-05,108,,MIA,0,240,42,93,0.452,27,54,0.5,15,39,0.385,9,12,0.75,108,45,83,0.542,38,61,0.623,7,22,0.318,21,25,0.84,118
1467,MEM,2019-02-05,108,,MIN,1,240,36,86,0.419,21,52,0.404,15,34,0.441,21,29,0.724,108,39,87,0.448,30,58,0.517,9,29,0.31,19,20,0.95,106
1468,NOP,2019-02-02,108,@,SAS,0,240,43,96,0.448,33,61,0.541,10,35,0.286,12,12,1.0,108,44,92,0.478,35,69,0.507,9,23,0.391,16,18,0.889,113
1469,PHI,2019-02-02,108,@,SAC,0,240,41,93,0.441,34,60,0.567,7,33,0.212,19,25,0.76,108,42,92,0.457,31,62,0.5,11,30,0.367,20,24,0.833,115
1470,SAC,2019-01-27,108,@,LAC,0,240,37,93,0.398,29,57,0.509,8,36,0.222,26,30,0.867,108,42,88,0.477,31,59,0.525,11,29,0.379,27,29,0.931,122
1471,MIL,2019-01-25,108,,CHO,1,240,41,89,0.461,35,58,0.603,6,31,0.194,20,23,0.87,108,36,90,0.4,26,51,0.51,10,39,0.256,17,25,0.68,99
1472,DEN,2019-01-23,108,@,UTA,0,240,42,88,0.477,34,61,0.557,8,27,0.296,16,20,0.8,108,38,88,0.432,19,42,0.452,19,46,0.413,19,27,0.704,114
1473,ORL,2019-01-19,108,,MIL,0,240,44,93,0.473,30,61,0.492,14,32,0.438,6,9,0.667,108,47,85,0.553,35,55,0.636,12,30,0.4,12,15,0.8,118
1474,TOR,2019-01-16,108,@,BOS,0,240,41,92,0.446,34,63,0.54,7,29,0.241,19,21,0.905,108,46,92,0.5,32,62,0.516,14,30,0.467,11,13,0.846,117
1475,CHO,2019-01-14,108,@,SAS,1,240,43,92,0.467,30,56,0.536,13,36,0.361,9,11,0.818,108,38,82,0.463,31,62,0.5,7,20,0.35,10,12,0.833,93
1476,PHI,2019-01-13,108,@,NYK,1,240,40,87,0.46,34,67,0.507,6,20,0.3,22,30,0.733,108,37,86,0.43,27,55,0.491,10,31,0.323,21,30,0.7,105
1477,MEM,2019-01-12,108,@,MIA,0,240,39,81,0.481,30,52,0.577,9,29,0.31,21,27,0.778,108,40,80,0.5,25,49,0.51,15,31,0.484,17,24,0.708,112
1478,IND,2019-01-09,108,@,BOS,0,240,39,91,0.429,30,63,0.476,9,28,0.321,21,33,0.636,108,50,88,0.568,36,56,0.643,14,32,0.438,21,24,0.875,135
1479,MIN,2019-01-06,108,,LAL,1,240,41,89,0.461,30,57,0.526,11,32,0.344,15,21,0.714,108,32,87,0.368,27,65,0.415,5,22,0.227,17,28,0.607,86
1480,SAS,2019-01-05,108,,MEM,1,240,36,73,0.493,29,51,0.569,7,22,0.318,29,35,0.829,108,31,82,0.378,20,54,0.37,11,28,0.393,15,19,0.789,88
1481,NYK,2019-01-01,108,@,DEN,0,240,42,93,0.452,31,66,0.47,11,27,0.407,13,18,0.722,108,44,95,0.463,32,61,0.525,12,34,0.353,15,23,0.652,115
1482,SAC,2019-01-01,108,,POR,0,265,44,115,0.383,33,82,0.402,11,33,0.333,9,12,0.75,108,39,90,0.433,30,58,0.517,9,32,0.281,26,30,0.867,113
1483,ATL,2018-12-31,108,@,IND,0,240,41,95,0.432,28,63,0.444,13,32,0.406,13,19,0.684,108,42,84,0.5,31,60,0.517,11,24,0.458,21,29,0.724,116
1484,HOU,2018-12-29,108,@,NOP,1,240,35,81,0.432,19,35,0.543,16,46,0.348,22,28,0.786,108,41,92,0.446,32,64,0.5,9,28,0.321,13,17,0.765,104
1485,CLE,2018-12-29,108,@,ATL,0,240,40,85,0.471,35,62,0.565,5,23,0.217,23,29,0.793,108,43,98,0.439,33,61,0.541,10,37,0.27,15,25,0.6,111
1486,HOU,2018-12-22,108,,SAS,1,240,37,95,0.389,18,41,0.439,19,54,0.352,15,21,0.714,108,42,88,0.477,32,64,0.5,10,24,0.417,7,11,0.636,101
1487,UTA,2018-12-19,108,,GSW,1,240,37,93,0.398,21,51,0.412,16,42,0.381,18,22,0.818,108,38,95,0.4,28,64,0.438,10,31,0.323,17,18,0.944,103
1488,ATL,2018-12-14,108,@,BOS,0,240,36,86,0.419,20,48,0.417,16,38,0.421,20,32,0.625,108,46,95,0.484,27,56,0.482,19,39,0.487,18,20,0.9,129
1489,CHO,2018-12-12,108,,DET,1,240,35,85,0.412,26,57,0.456,9,28,0.321,29,37,0.784,108,40,86,0.465,27,52,0.519,13,34,0.382,14,21,0.667,107
1490,LAL,2018-12-10,108,,MIA,1,240,41,90,0.456,27,58,0.466,14,32,0.438,12,20,0.6,108,42,94,0.447,31,60,0.517,11,34,0.324,10,13,0.769,105
1491,MIN,2018-12-10,108,@,GSW,0,240,38,83,0.458,31,58,0.534,7,25,0.28,25,31,0.806,108,39,93,0.419,20,50,0.4,19,43,0.442,19,21,0.905,116
1492,MIL,2018-12-10,108,,CLE,1,240,42,96,0.438,27,60,0.45,15,36,0.417,9,11,0.818,108,36,96,0.375,26,66,0.394,10,30,0.333,10,15,0.667,92
1493,SAC,2018-12-10,108,@,CHI,1,240,40,88,0.455,24,51,0.471,16,37,0.432,12,15,0.8,108,34,76,0.447,26,48,0.542,8,28,0.286,13,13,1.0,89
1494,DET,2018-12-09,108,,NOP,0,240,43,98,0.439,34,69,0.493,9,29,0.31,13,24,0.542,108,42,79,0.532,30,49,0.612,12,30,0.4,20,23,0.87,116
1495,POR,2018-12-06,108,,PHO,1,240,41,85,0.482,32,58,0.552,9,27,0.333,17,27,0.63,108,35,91,0.385,30,64,0.469,5,27,0.185,11,14,0.786,86
1496,CHO,2018-11-28,108,,ATL,1,240,38,83,0.458,34,63,0.54,4,20,0.2,28,37,0.757,108,32,93,0.344,21,49,0.429,11,44,0.25,19,22,0.864,94
1497,HOU,2018-11-28,108,,DAL,0,240,40,87,0.46,27,42,0.643,13,45,0.289,15,23,0.652,108,46,85,0.541,29,51,0.569,17,34,0.5,19,24,0.792,128
1498,NYK,2018-11-27,108,@,DET,0,240,36,91,0.396,27,64,0.422,9,27,0.333,27,32,0.844,108,38,80,0.475,31,56,0.554,7,24,0.292,32,45,0.711,115
1499,SAS,2018-11-26,108,@,CHI,1,240,45,93,0.484,35,63,0.556,10,30,0.333,8,9,0.889,108,42,90,0.467,28,57,0.491,14,33,0.424,9,11,0.818,107
1500,ORL,2018-11-25,108,@,LAL,1,240,42,93,0.452,31,62,0.5,11,31,0.355,13,14,0.929,108,37,79,0.468,27,53,0.509,10,26,0.385,20,31,0.645,104
1501,HOU,2018-11-24,108,@,CLE,0,240,37,74,0.5,22,35,0.629,15,39,0.385,19,28,0.679,108,44,90,0.489,37,68,0.544,7,22,0.318,22,29,0.759,117
1502,ATL,2018-11-21,108,,TOR,0,240,42,93,0.452,32,57,0.561,10,36,0.278,14,18,0.778,108,48,90,0.533,37,61,0.607,11,29,0.379,17,23,0.739,124
1503,WAS,2018-11-09,108,@,ORL,0,240,42,82,0.512,31,55,0.564,11,27,0.407,13,19,0.684,108,44,86,0.512,31,55,0.564,13,31,0.419,16,19,0.842,117
1504,WAS,2018-11-04,108,,NYK,1,240,36,83,0.434,30,57,0.526,6,26,0.231,30,39,0.769,108,39,93,0.419,34,66,0.515,5,27,0.185,12,16,0.75,95
1505,DEN,2018-10-31,108,@,CHI,1,265,45,99,0.455,38,73,0.521,7,26,0.269,11,18,0.611,108,39,92,0.424,23,58,0.397,16,34,0.471,13,18,0.722,107
1506,BOS,2018-10-30,108,,DET,1,240,37,84,0.44,28,53,0.528,9,31,0.29,25,32,0.781,108,37,88,0.42,29,58,0.5,8,30,0.267,23,27,0.852,105
1507,DAL,2018-10-29,108,@,SAS,0,265,43,91,0.473,33,57,0.579,10,34,0.294,12,17,0.706,108,42,91,0.462,33,71,0.465,9,20,0.45,20,21,0.952,113
1508,PHI,2018-10-24,108,@,MIL,0,240,38,92,0.413,27,58,0.466,11,34,0.324,21,30,0.7,108,41,100,0.41,28,57,0.491,13,43,0.302,28,30,0.933,123
1509,SAS,2018-10-20,108,@,POR,0,240,42,100,0.42,29,70,0.414,13,30,0.433,11,14,0.786,108,45,84,0.536,30,52,0.577,15,32,0.469,16,19,0.842,121
1510,LAC,2018-10-19,108,,OKC,1,240,35,81,0.432,24,55,0.436,11,26,0.423,27,36,0.75,108,34,95,0.358,27,62,0.435,7,33,0.212,17,23,0.739,92
1511,CHI,2018-10-18,108,@,PHI,0,240,44,101,0.436,33,68,0.485,11,33,0.333,9,12,0.75,108,44,93,0.473,32,57,0.561,12,36,0.333,27,30,0.9,127
1512,MIN,2018-10-17,108,@,SAS,0,240,39,91,0.429,33,72,0.458,6,19,0.316,24,27,0.889,108,40,93,0.43,29,68,0.426,11,25,0.44,21,29,0.724,112
1513,GSW,2018-10-16,108,,OKC,1,240,42,95,0.442,35,69,0.507,7,26,0.269,17,18,0.944,108,33,91,0.363,23,54,0.426,10,37,0.27,24,37,0.649,100
1514,ATL,2019-04-07,107,@,MIL,0,240,40,100,0.4,23,55,0.418,17,45,0.378,10,19,0.526,107,40,91,0.44,31,50,0.62,9,41,0.22,26,34,0.765,115
1515,OKC,2019-03-27,107,,IND,1,240,41,92,0.446,28,56,0.5,13,36,0.361,12,19,0.632,107,40,92,0.435,27,61,0.443,13,31,0.419,6,11,0.545,99
1516,CLE,2019-03-20,107,,MIL,1,240,39,93,0.419,28,54,0.519,11,39,0.282,18,24,0.75,107,36,91,0.396,23,59,0.39,13,32,0.406,17,21,0.81,102
1517,MIN,2019-03-19,107,,GSW,0,240,36,89,0.404,27,53,0.509,9,36,0.25,26,32,0.813,107,44,91,0.484,25,49,0.51,19,42,0.452,10,14,0.714,117
1518,OKC,2019-03-18,107,,MIA,0,240,38,87,0.437,28,50,0.56,10,37,0.27,21,27,0.778,107,46,97,0.474,37,68,0.544,9,29,0.31,15,16,0.938,116
1519,TOR,2019-03-17,107,@,DET,0,240,39,82,0.476,21,46,0.457,18,36,0.5,11,14,0.786,107,39,83,0.47,31,56,0.554,8,27,0.296,24,27,0.889,110
1520,CHI,2019-03-12,107,,LAL,0,240,42,91,0.462,31,64,0.484,11,27,0.407,12,12,1.0,107,47,86,0.547,34,53,0.642,13,33,0.394,16,20,0.8,123
1521,MIN,2019-03-12,107,@,DEN,0,240,41,89,0.461,30,59,0.508,11,30,0.367,14,14,1.0,107,51,85,0.6,33,55,0.6,18,30,0.6,13,15,0.867,133
1522,LAL,2019-03-09,107,,BOS,0,240,44,91,0.484,39,64,0.609,5,27,0.185,14,18,0.778,107,48,93,0.516,34,55,0.618,14,38,0.368,10,14,0.714,120
1523,HOU,2019-03-08,107,,PHI,1,240,42,85,0.494,29,44,0.659,13,41,0.317,10,15,0.667,107,35,95,0.368,32,69,0.464,3,26,0.115,18,23,0.783,91
1524,PHI,2019-03-06,107,@,CHI,0,240,40,87,0.46,32,63,0.508,8,24,0.333,19,24,0.792,107,41,93,0.441,35,70,0.5,6,23,0.261,20,27,0.741,108
1525,PHO,2019-03-06,107,,NYK,1,240,39,81,0.481,27,52,0.519,12,29,0.414,17,22,0.773,107,35,77,0.455,29,62,0.468,6,15,0.4,20,25,0.8,96
1526,CLE,2019-03-06,107,@,BRK,0,240,35,87,0.402,19,49,0.388,16,38,0.421,21,29,0.724,107,43,91,0.473,31,58,0.534,12,33,0.364,15,26,0.577,113
1527,HOU,2019-03-05,107,@,TOR,1,240,38,85,0.447,23,51,0.451,15,34,0.441,16,18,0.889,107,37,89,0.416,28,57,0.491,9,32,0.281,12,16,0.75,95
1528,NYK,2019-03-03,107,@,LAC,0,240,35,88,0.398,24,59,0.407,11,29,0.379,26,34,0.765,107,48,98,0.49,29,63,0.46,19,35,0.543,13,17,0.765,128
1529,CLE,2019-03-03,107,,ORL,1,240,36,83,0.434,22,40,0.55,14,43,0.326,21,23,0.913,107,39,88,0.443,33,62,0.532,6,26,0.231,9,11,0.818,93
1530,TOR,2019-03-03,107,@,DET,0,265,37,96,0.385,23,57,0.404,14,39,0.359,19,24,0.792,107,40,86,0.465,28,53,0.528,12,33,0.364,20,29,0.69,112
1531,BOS,2019-03-01,107,,WAS,1,240,42,94,0.447,32,59,0.542,10,35,0.286,13,17,0.765,107,36,89,0.404,26,51,0.51,10,38,0.263,14,19,0.737,96
1532,MEM,2019-02-27,107,,CHI,0,240,41,94,0.436,32,67,0.478,9,27,0.333,16,18,0.889,107,39,82,0.476,31,58,0.534,8,24,0.333,23,25,0.92,109
1533,MEM,2019-02-23,107,@,CLE,0,240,40,90,0.444,35,65,0.538,5,25,0.2,22,28,0.786,107,39,88,0.443,23,46,0.5,16,42,0.381,18,23,0.783,112
1534,GSW,2019-02-13,107,@,POR,0,240,39,97,0.402,26,59,0.441,13,38,0.342,16,18,0.889,107,43,93,0.462,27,56,0.482,16,37,0.432,27,34,0.794,129
1535,PHO,2019-02-13,107,@,LAC,0,240,40,86,0.465,32,56,0.571,8,30,0.267,19,25,0.76,107,50,84,0.595,39,62,0.629,11,22,0.5,23,30,0.767,134
1536,MEM,2019-02-12,107,,SAS,0,240,44,89,0.494,36,65,0.554,8,24,0.333,11,16,0.688,107,36,86,0.419,23,65,0.354,13,21,0.619,23,29,0.793,108
1537,CLE,2019-02-11,107,,NYK,1,240,38,95,0.4,24,51,0.471,14,44,0.318,17,19,0.895,107,42,92,0.457,35,66,0.53,7,26,0.269,13,20,0.65,104
1538,DAL,2019-02-08,107,,MIL,0,240,36,87,0.414,14,34,0.412,22,53,0.415,13,20,0.65,107,51,93,0.548,41,57,0.719,10,36,0.278,10,12,0.833,122
1539,PHO,2019-02-08,107,,GSW,0,240,39,101,0.386,33,70,0.471,6,31,0.194,23,30,0.767,107,41,81,0.506,31,52,0.596,10,29,0.345,25,35,0.714,117
1540,PHI,2019-02-05,107,,TOR,0,240,31,70,0.443,24,46,0.522,7,24,0.292,38,41,0.927,107,41,89,0.461,30,58,0.517,11,31,0.355,26,32,0.813,119
1541,NOP,2019-02-04,107,,IND,0,240,39,90,0.433,30,52,0.577,9,38,0.237,20,24,0.833,107,41,91,0.451,31,63,0.492,10,28,0.357,17,24,0.708,109
1542,DEN,2019-02-02,107,@,MIN,1,240,42,89,0.472,29,56,0.518,13,33,0.394,10,14,0.714,107,42,89,0.472,31,55,0.564,11,34,0.324,11,16,0.688,106
1543,ORL,2019-01-31,107,,IND,1,240,38,82,0.463,27,57,0.474,11,25,0.44,20,22,0.909,107,41,91,0.451,37,72,0.514,4,19,0.211,14,16,0.875,100
1544,WAS,2019-01-30,107,,IND,1,240,41,78,0.526,29,50,0.58,12,28,0.429,13,21,0.619,107,33,84,0.393,24,53,0.453,9,31,0.29,14,18,0.778,89
1545,MEM,2019-01-23,107,,CHO,0,240,38,81,0.469,29,50,0.58,9,31,0.29,22,24,0.917,107,41,77,0.532,29,47,0.617,12,30,0.4,24,31,0.774,118
1546,BOS,2019-01-21,107,,MIA,1,240,43,87,0.494,31,57,0.544,12,30,0.4,9,10,0.9,107,36,86,0.419,25,51,0.49,11,35,0.314,16,18,0.889,99
1547,MIN,2019-01-15,107,@,PHI,0,240,35,90,0.389,27,67,0.403,8,23,0.348,29,35,0.829,107,55,92,0.598,34,49,0.694,21,43,0.488,18,21,0.857,149
1548,LAL,2019-01-15,107,,CHI,1,240,38,82,0.463,30,56,0.536,8,26,0.308,23,34,0.676,107,37,92,0.402,28,61,0.459,9,31,0.29,17,24,0.708,100
1549,POR,2019-01-14,107,@,SAC,0,240,37,92,0.402,27,61,0.443,10,31,0.323,23,29,0.793,107,43,87,0.494,33,61,0.541,10,26,0.385,19,24,0.792,115
1550,LAL,2019-01-07,107,@,DAL,1,240,41,94,0.436,33,65,0.508,8,29,0.276,17,27,0.63,107,36,86,0.419,28,56,0.5,8,30,0.267,17,24,0.708,97
1551,DET,2019-01-07,107,,SAS,0,240,42,85,0.494,33,53,0.623,9,32,0.281,14,17,0.824,107,43,79,0.544,36,59,0.61,7,20,0.35,26,32,0.813,119
1552,TOR,2019-01-03,107,@,SAS,0,240,39,87,0.448,33,57,0.579,6,30,0.2,23,29,0.793,107,47,85,0.553,34,58,0.586,13,27,0.481,18,20,0.9,125
1553,OKC,2019-01-02,107,@,LAL,1,240,40,105,0.381,33,74,0.446,7,31,0.226,20,31,0.645,107,37,89,0.416,30,62,0.484,7,27,0.259,19,32,0.594,100
1554,DET,2018-12-30,107,@,ORL,0,240,39,92,0.424,31,61,0.508,8,31,0.258,21,23,0.913,107,40,85,0.471,33,61,0.541,7,24,0.292,22,24,0.917,109
1555,LAL,2018-12-28,107,,LAC,0,240,36,87,0.414,25,57,0.439,11,30,0.367,24,35,0.686,107,40,91,0.44,34,72,0.472,6,19,0.316,32,34,0.941,118
1556,MEM,2018-12-23,107,@,LAL,1,240,42,90,0.467,28,64,0.438,14,26,0.538,9,14,0.643,107,37,75,0.493,27,45,0.6,10,30,0.333,15,22,0.682,99
1557,OKC,2018-12-22,107,@,UTA,1,240,42,89,0.472,33,64,0.516,9,25,0.36,14,22,0.636,107,42,93,0.452,31,59,0.525,11,34,0.324,11,18,0.611,106
1558,BOS,2018-12-21,107,,MIL,0,240,35,91,0.385,25,57,0.439,10,34,0.294,27,36,0.75,107,41,80,0.513,25,40,0.625,16,40,0.4,22,28,0.786,120
1559,NYK,2018-12-21,107,,ATL,0,240,41,84,0.488,33,57,0.579,8,27,0.296,17,24,0.708,107,43,91,0.473,33,62,0.532,10,29,0.345,18,24,0.75,114
1560,MIL,2018-12-17,107,@,DET,1,240,44,88,0.5,35,63,0.556,9,25,0.36,10,15,0.667,107,39,88,0.443,25,53,0.472,14,35,0.4,12,15,0.8,104
1561,PHO,2018-12-15,107,,MIN,1,240,41,90,0.456,32,62,0.516,9,28,0.321,16,20,0.8,107,39,96,0.406,32,61,0.525,7,35,0.2,14,19,0.737,99
1562,DET,2018-12-12,107,@,CHO,0,240,40,86,0.465,27,52,0.519,13,34,0.382,14,21,0.667,107,35,85,0.412,26,57,0.456,9,28,0.321,29,37,0.784,108
1563,ATL,2018-12-12,107,@,DAL,0,240,43,93,0.462,32,60,0.533,11,33,0.333,10,14,0.714,107,35,75,0.467,23,41,0.561,12,34,0.353,32,43,0.744,114
1564,NYK,2018-12-09,107,,CHO,0,240,44,93,0.473,31,67,0.463,13,26,0.5,6,7,0.857,107,42,87,0.483,30,53,0.566,12,34,0.353,23,27,0.852,119
1565,IND,2018-12-08,107,,SAC,1,240,40,92,0.435,32,62,0.516,8,30,0.267,19,22,0.864,107,38,90,0.422,29,58,0.5,9,32,0.281,12,15,0.8,97
1566,DAL,2018-12-08,107,,HOU,1,240,41,83,0.494,29,53,0.547,12,30,0.4,13,16,0.813,107,39,86,0.453,24,39,0.615,15,47,0.319,11,13,0.846,104
1567,MEM,2018-12-07,107,@,NOP,1,240,39,83,0.47,31,64,0.484,8,19,0.421,21,28,0.75,107,38,84,0.452,31,55,0.564,7,29,0.241,20,24,0.833,103
1568,DEN,2018-12-07,107,@,CHO,0,240,39,101,0.386,31,66,0.47,8,35,0.229,21,26,0.808,107,33,86,0.384,20,51,0.392,13,35,0.371,34,38,0.895,113
1569,NYK,2018-12-03,107,,WAS,0,240,37,90,0.411,25,56,0.446,12,34,0.353,21,28,0.75,107,44,92,0.478,31,60,0.517,13,32,0.406,9,12,0.75,110
1570,DET,2018-11-30,107,,CHI,1,240,41,92,0.446,28,58,0.483,13,34,0.382,12,16,0.75,107,37,86,0.43,34,65,0.523,3,21,0.143,11,14,0.786,88
1571,MIL,2018-11-26,107,@,CHO,0,240,37,90,0.411,21,44,0.477,16,46,0.348,17,21,0.81,107,38,81,0.469,25,52,0.481,13,29,0.448,21,30,0.7,110
1572,CHI,2018-11-26,107,,SAS,0,240,42,90,0.467,28,57,0.491,14,33,0.424,9,11,0.818,107,45,93,0.484,35,63,0.556,10,30,0.333,8,9,0.889,108
1573,NOP,2018-11-26,107,,BOS,0,240,34,77,0.442,22,45,0.489,12,32,0.375,27,29,0.931,107,48,97,0.495,29,58,0.5,19,39,0.487,9,10,0.9,124
1574,PHO,2018-11-25,107,@,DET,0,240,42,82,0.512,34,57,0.596,8,25,0.32,15,21,0.714,107,43,93,0.462,27,52,0.519,16,41,0.39,16,25,0.64,118
1575,MEM,2018-11-23,107,@,LAC,0,265,42,92,0.457,33,65,0.508,9,27,0.333,14,18,0.778,107,40,94,0.426,32,71,0.451,8,23,0.348,24,27,0.889,112
1576,WAS,2018-11-23,107,@,TOR,0,240,40,100,0.4,31,54,0.574,9,46,0.196,18,19,0.947,107,46,93,0.495,29,54,0.537,17,39,0.436,16,19,0.842,125
1577,UTA,2018-11-16,107,@,PHI,0,240,41,88,0.466,37,66,0.561,4,22,0.182,21,37,0.568,107,41,81,0.506,30,58,0.517,11,23,0.478,20,32,0.625,113
1578,HOU,2018-11-15,107,,GSW,1,240,35,87,0.402,19,40,0.475,16,47,0.34,21,26,0.808,107,32,76,0.421,28,58,0.483,4,18,0.222,18,22,0.818,86
1579,BRK,2018-11-14,107,,MIA,0,240,41,101,0.406,33,73,0.452,8,28,0.286,17,24,0.708,107,46,85,0.541,38,56,0.679,8,29,0.276,20,28,0.714,120
1580,MIN,2018-11-14,107,,NOP,1,240,37,90,0.411,23,58,0.397,14,32,0.438,19,24,0.792,107,40,94,0.426,31,66,0.47,9,28,0.321,11,18,0.611,100
1581,LAL,2018-11-11,107,,ATL,1,240,39,92,0.424,25,54,0.463,14,38,0.368,15,24,0.625,107,41,95,0.432,28,58,0.483,13,37,0.351,11,13,0.846,106
1582,NOP,2018-11-07,107,,CHI,1,240,42,94,0.447,31,64,0.484,11,30,0.367,12,17,0.706,107,38,96,0.396,29,65,0.446,9,31,0.29,13,17,0.765,98
1583,ATL,2018-11-07,107,,NYK,0,240,37,92,0.402,26,54,0.481,11,38,0.289,22,29,0.759,107,34,77,0.442,23,47,0.489,11,30,0.367,33,47,0.702,112
1584,BOS,2018-11-05,107,@,DEN,0,240,44,87,0.506,35,56,0.625,9,31,0.29,10,12,0.833,107,41,90,0.456,28,56,0.5,13,34,0.382,20,28,0.714,115
1585,LAL,2018-11-04,107,,TOR,0,240,39,85,0.459,33,61,0.541,6,24,0.25,23,29,0.793,107,49,98,0.5,39,63,0.619,10,35,0.286,13,14,0.929,121
1586,TOR,2018-11-02,107,@,PHO,1,240,41,81,0.506,29,48,0.604,12,33,0.364,13,21,0.619,107,40,91,0.44,32,65,0.492,8,26,0.308,10,18,0.556,98
1587,IND,2018-11-02,107,@,CHI,1,240,40,85,0.471,33,59,0.559,7,26,0.269,20,22,0.909,107,42,89,0.472,29,58,0.5,13,31,0.419,8,9,0.889,105
1588,CHO,2018-11-01,107,,OKC,0,240,38,93,0.409,27,52,0.519,11,41,0.268,20,22,0.909,107,41,96,0.427,33,59,0.559,8,37,0.216,21,29,0.724,111
1589,IND,2018-10-31,107,@,NYK,1,240,45,83,0.542,39,63,0.619,6,20,0.3,11,17,0.647,107,34,79,0.43,22,54,0.407,12,25,0.48,21,24,0.875,101
1590,CHI,2018-10-31,107,,DEN,0,265,39,92,0.424,23,58,0.397,16,34,0.471,13,18,0.722,107,45,99,0.455,38,73,0.521,7,26,0.269,11,18,0.611,108
1591,MEM,2018-10-30,107,,WAS,1,240,36,74,0.486,23,46,0.5,13,28,0.464,22,31,0.71,107,32,74,0.432,18,39,0.462,14,35,0.4,17,20,0.85,95
1592,SAC,2018-10-30,107,@,ORL,1,240,41,84,0.488,33,62,0.532,8,22,0.364,17,26,0.654,107,36,91,0.396,25,48,0.521,11,43,0.256,16,22,0.727,99
1593,CLE,2018-10-27,107,,IND,0,240,40,86,0.465,33,61,0.541,7,25,0.28,20,22,0.909,107,48,74,0.649,43,61,0.705,5,13,0.385,18,26,0.692,119
1594,DAL,2018-10-26,107,@,TOR,0,240,38,92,0.413,26,62,0.419,12,30,0.4,19,24,0.792,107,44,91,0.484,33,64,0.516,11,27,0.407,17,20,0.85,116
1595,BRK,2018-10-19,107,,NYK,1,240,37,75,0.493,25,45,0.556,12,30,0.4,21,24,0.875,107,39,97,0.402,30,69,0.435,9,28,0.321,18,20,0.9,105
1596,DEN,2018-10-17,107,@,LAC,1,240,33,87,0.379,25,63,0.397,8,24,0.333,33,42,0.786,107,35,88,0.398,27,60,0.45,8,28,0.286,20,24,0.833,98
1597,ATL,2018-10-17,107,@,NYK,0,240,41,90,0.456,31,54,0.574,10,36,0.278,15,18,0.833,107,45,99,0.455,33,66,0.5,12,33,0.364,24,31,0.774,126
1598,SAS,2019-03-31,106,,SAC,0,240,44,94,0.468,36,67,0.537,8,27,0.296,10,14,0.714,106,39,81,0.481,28,56,0.5,11,25,0.44,24,28,0.857,113
1599,DAL,2019-03-31,106,@,OKC,1,240,37,87,0.425,21,43,0.488,16,44,0.364,16,23,0.696,106,38,98,0.388,27,55,0.491,11,43,0.256,16,22,0.727,103
1600,CLE,2019-03-26,106,,BOS,0,240,39,80,0.488,30,52,0.577,9,28,0.321,19,25,0.76,106,46,91,0.505,36,66,0.545,10,25,0.4,14,19,0.737,116
1601,WAS,2019-03-26,106,@,LAL,0,240,39,90,0.433,33,58,0.569,6,32,0.188,22,27,0.815,106,48,89,0.539,37,56,0.661,11,33,0.333,17,23,0.739,124
1602,SAC,2019-03-24,106,@,LAL,0,240,39,104,0.375,25,71,0.352,14,33,0.424,14,23,0.609,106,39,85,0.459,26,45,0.578,13,40,0.325,20,24,0.833,111
1603,LAL,2019-03-22,106,,BRK,0,240,37,96,0.385,28,60,0.467,9,36,0.25,23,32,0.719,106,37,92,0.402,21,50,0.42,16,42,0.381,21,28,0.75,111
1604,MIN,2019-03-21,106,@,CHO,0,240,39,88,0.443,29,60,0.483,10,28,0.357,18,29,0.621,106,43,100,0.43,34,71,0.479,9,29,0.31,18,24,0.75,113
1605,POR,2019-03-18,106,,IND,1,240,37,79,0.468,24,47,0.511,13,32,0.406,19,21,0.905,106,35,83,0.422,25,59,0.424,10,24,0.417,18,22,0.818,98
1606,OKC,2019-03-14,106,@,IND,0,240,38,86,0.442,24,56,0.429,14,30,0.467,16,20,0.8,106,37,82,0.451,30,60,0.5,7,22,0.318,27,32,0.844,108
1607,GSW,2019-03-13,106,@,HOU,1,240,42,85,0.494,30,53,0.566,12,32,0.375,10,10,1.0,106,37,78,0.474,26,37,0.703,11,41,0.268,19,23,0.826,104
1608,PHI,2019-03-12,106,,CLE,1,240,42,85,0.494,34,62,0.548,8,23,0.348,14,17,0.824,106,40,101,0.396,27,63,0.429,13,38,0.342,6,8,0.75,99
1609,CHO,2019-03-11,106,@,HOU,0,240,38,89,0.427,22,48,0.458,16,41,0.39,14,15,0.933,106,38,91,0.418,21,48,0.438,17,43,0.395,25,27,0.926,118
1610,PHI,2019-03-10,106,,IND,1,240,38,87,0.437,31,64,0.484,7,23,0.304,23,30,0.767,106,31,83,0.373,26,67,0.388,5,16,0.313,22,37,0.595,89
1611,DAL,2019-03-08,106,@,ORL,0,240,42,89,0.472,32,55,0.582,10,34,0.294,12,16,0.75,106,42,87,0.483,28,58,0.483,14,29,0.483,13,18,0.722,111
1612,ORL,2019-03-05,106,@,PHI,0,240,42,93,0.452,29,61,0.475,13,32,0.406,9,12,0.75,106,42,89,0.472,31,61,0.508,11,28,0.393,19,21,0.905,114
1613,CHI,2019-02-25,106,,MIL,0,240,41,92,0.446,32,66,0.485,9,26,0.346,15,22,0.682,106,42,91,0.462,25,42,0.595,17,49,0.347,16,23,0.696,117
1614,MEM,2019-02-22,106,,LAC,0,240,33,90,0.367,24,58,0.414,9,32,0.281,31,36,0.861,106,35,75,0.467,29,50,0.58,6,25,0.24,36,42,0.857,112
1615,HOU,2019-02-21,106,@,LAL,0,240,40,88,0.455,28,47,0.596,12,41,0.293,14,15,0.933,106,38,86,0.442,30,56,0.536,8,30,0.267,27,33,0.818,111
1616,PHI,2019-02-21,106,,MIA,1,240,37,82,0.451,30,56,0.536,7,26,0.269,25,35,0.714,106,45,94,0.479,39,72,0.542,6,22,0.273,6,12,0.5,102
1617,NYK,2019-02-14,106,@,ATL,1,240,38,84,0.452,26,53,0.491,12,31,0.387,18,26,0.692,106,33,91,0.363,23,53,0.434,10,38,0.263,15,19,0.789,91
1618,MIL,2019-02-13,106,@,IND,1,240,38,86,0.442,29,55,0.527,9,31,0.29,21,29,0.724,106,37,88,0.42,27,61,0.443,10,27,0.37,13,15,0.867,97
1619,BRK,2019-02-08,106,,CHI,0,240,39,94,0.415,26,53,0.491,13,41,0.317,15,16,0.938,106,46,85,0.541,32,57,0.561,14,28,0.5,19,24,0.792,125
1620,CLE,2019-02-08,106,@,WAS,0,240,36,96,0.375,24,58,0.414,12,38,0.316,22,25,0.88,106,46,92,0.5,34,57,0.596,12,35,0.343,15,16,0.938,119
1621,MIN,2019-02-05,106,@,MEM,0,240,39,87,0.448,30,58,0.517,9,29,0.31,19,20,0.95,106,36,86,0.419,21,52,0.404,15,34,0.441,21,29,0.724,108
1622,MIN,2019-02-02,106,,DEN,0,240,42,89,0.472,31,55,0.564,11,34,0.324,11,16,0.688,106,42,89,0.472,29,56,0.518,13,33,0.394,10,14,0.714,107
1623,MIA,2019-01-27,106,@,NYK,1,240,39,84,0.464,27,51,0.529,12,33,0.364,16,18,0.889,106,36,84,0.429,29,58,0.5,7,26,0.269,18,24,0.75,97
1624,MEM,2019-01-26,106,,IND,1,240,39,80,0.488,30,52,0.577,9,28,0.321,19,28,0.679,106,32,74,0.432,23,47,0.489,9,27,0.333,30,36,0.833,103
1625,LAC,2019-01-25,106,@,CHI,1,240,38,82,0.463,30,61,0.492,8,21,0.381,22,29,0.759,106,40,102,0.392,30,67,0.448,10,35,0.286,11,12,0.917,101
1626,UTA,2019-01-25,106,,MIN,1,240,37,94,0.394,24,54,0.444,13,40,0.325,19,25,0.76,106,38,90,0.422,30,64,0.469,8,26,0.308,18,21,0.857,102
1627,DAL,2019-01-25,106,,DET,1,240,37,81,0.457,23,45,0.511,14,36,0.389,18,30,0.6,106,35,85,0.412,23,47,0.489,12,38,0.316,19,25,0.76,101
1628,PHO,2019-01-24,106,,POR,0,240,36,88,0.409,23,50,0.46,13,38,0.342,21,27,0.778,106,44,94,0.468,32,68,0.471,12,26,0.462,20,20,1.0,120
1629,TOR,2019-01-23,106,@,IND,0,240,38,92,0.413,26,53,0.491,12,39,0.308,18,23,0.783,106,40,92,0.435,31,66,0.47,9,26,0.346,21,25,0.84,110
1630,DAL,2019-01-22,106,,LAC,1,240,38,81,0.469,28,47,0.596,10,34,0.294,20,29,0.69,106,33,91,0.363,23,55,0.418,10,36,0.278,22,29,0.759,98
1631,DAL,2019-01-21,106,@,MIL,0,240,41,99,0.414,27,59,0.458,14,40,0.35,10,17,0.588,106,42,91,0.462,30,59,0.508,12,32,0.375,20,22,0.909,116
1632,NOP,2019-01-12,106,@,MIN,0,240,40,87,0.46,35,63,0.556,5,24,0.208,21,24,0.875,106,40,93,0.43,29,54,0.537,11,39,0.282,19,24,0.792,110
1633,MIL,2019-01-11,106,@,WAS,0,240,40,89,0.449,27,49,0.551,13,40,0.325,13,17,0.765,106,40,82,0.488,22,49,0.449,18,33,0.545,15,20,0.75,113
1634,NYK,2019-01-11,106,,IND,0,240,39,88,0.443,25,49,0.51,14,39,0.359,14,16,0.875,106,49,94,0.521,37,68,0.544,12,26,0.462,11,11,1.0,121
1635,UTA,2019-01-09,106,,ORL,1,240,41,84,0.488,29,51,0.569,12,33,0.364,12,14,0.857,106,33,83,0.398,20,50,0.4,13,33,0.394,14,20,0.7,93
1636,PHI,2019-01-09,106,@,WAS,0,240,37,86,0.43,29,59,0.492,8,27,0.296,24,31,0.774,106,47,87,0.54,34,60,0.567,13,27,0.481,16,21,0.762,123
1637,LAC,2019-01-06,106,,ORL,1,240,40,93,0.43,32,71,0.451,8,22,0.364,18,23,0.783,106,33,89,0.371,24,58,0.414,9,31,0.29,21,29,0.724,96
1638,ATL,2019-01-06,106,,MIA,1,240,43,91,0.473,33,67,0.493,10,24,0.417,10,13,0.769,106,31,87,0.356,26,53,0.491,5,34,0.147,15,27,0.556,82
1639,PHI,2019-01-05,106,,DAL,1,240,39,83,0.47,33,57,0.579,6,26,0.231,22,33,0.667,106,38,88,0.432,29,57,0.509,9,31,0.29,15,23,0.652,100
1640,TOR,2018-12-26,106,@,MIA,1,240,37,79,0.468,24,49,0.49,13,30,0.433,19,23,0.826,106,43,83,0.518,31,54,0.574,12,29,0.414,6,12,0.5,104
1641,DET,2018-12-26,106,,WAS,1,240,37,80,0.463,23,43,0.535,14,37,0.378,18,19,0.947,106,38,83,0.458,29,50,0.58,9,33,0.273,10,13,0.769,95
1642,UTA,2018-12-22,106,,OKC,0,240,42,93,0.452,31,59,0.525,11,34,0.324,11,18,0.611,106,42,89,0.472,33,64,0.516,9,25,0.36,14,22,0.636,107
1643,BRK,2018-12-21,106,,IND,0,240,33,72,0.458,17,41,0.415,16,31,0.516,24,34,0.706,106,44,82,0.537,33,56,0.589,11,26,0.423,15,18,0.833,114
1644,NYK,2018-12-12,106,@,CLE,0,240,41,94,0.436,30,67,0.448,11,27,0.407,13,14,0.929,106,43,91,0.473,33,57,0.579,10,34,0.294,17,21,0.81,113
1645,ATL,2018-12-08,106,,DEN,1,240,40,93,0.43,25,51,0.49,15,42,0.357,11,16,0.688,106,36,97,0.371,27,61,0.443,9,36,0.25,17,21,0.81,98
1646,BRK,2018-12-07,106,,TOR,1,265,43,98,0.439,32,63,0.508,11,35,0.314,9,13,0.692,106,35,89,0.393,24,54,0.444,11,35,0.314,24,29,0.828,105
1647,DAL,2018-12-05,106,@,NOP,0,240,39,91,0.429,25,45,0.556,14,46,0.304,14,21,0.667,106,51,92,0.554,34,63,0.54,17,29,0.586,13,20,0.65,132
1648,DEN,2018-12-03,106,@,TOR,1,240,40,89,0.449,29,61,0.475,11,28,0.393,15,24,0.625,106,40,87,0.46,29,46,0.63,11,41,0.268,12,12,1.0,103
1649,TOR,2018-12-01,106,@,CLE,1,240,39,80,0.488,32,54,0.593,7,26,0.269,21,25,0.84,106,34,88,0.386,29,66,0.439,5,22,0.227,22,25,0.88,95
1650,MIA,2018-11-30,106,,NOP,1,240,40,93,0.43,29,60,0.483,11,33,0.333,15,24,0.625,106,35,82,0.427,29,54,0.537,6,28,0.214,25,29,0.862,101
1651,DET,2018-11-14,106,@,TOR,1,240,44,91,0.484,34,58,0.586,10,33,0.303,8,13,0.615,106,45,92,0.489,41,72,0.569,4,20,0.2,10,17,0.588,104
1652,PHI,2018-11-14,106,@,ORL,0,240,41,86,0.477,27,57,0.474,14,29,0.483,10,15,0.667,106,40,80,0.5,28,52,0.538,12,28,0.429,19,22,0.864,111
1653,ATL,2018-11-11,106,@,LAL,0,240,41,95,0.432,28,58,0.483,13,37,0.351,11,13,0.846,106,39,92,0.424,25,54,0.463,14,38,0.368,15,24,0.625,107
1654,PHI,2018-11-10,106,@,MEM,0,265,44,85,0.518,36,54,0.667,8,31,0.258,10,16,0.625,106,45,103,0.437,34,73,0.466,11,30,0.367,11,15,0.733,112
1655,DAL,2018-11-02,106,,NYK,0,240,40,81,0.494,29,52,0.558,11,29,0.379,15,24,0.625,106,46,84,0.548,39,55,0.709,7,29,0.241,19,26,0.731,118
1656,LAL,2018-10-27,106,@,SAS,0,240,41,86,0.477,28,53,0.528,13,33,0.394,11,18,0.611,106,44,91,0.484,41,75,0.547,3,16,0.188,19,24,0.792,110
1657,CHI,2018-10-26,106,@,CHO,0,240,37,85,0.435,21,49,0.429,16,36,0.444,16,22,0.727,106,53,93,0.57,39,61,0.639,14,32,0.438,15,16,0.938,135
1658,CHO,2018-10-22,106,@,TOR,0,240,41,97,0.423,32,69,0.464,9,28,0.321,15,18,0.833,106,50,87,0.575,35,48,0.729,15,39,0.385,12,14,0.857,127
1659,SAS,2019-04-10,105,,DAL,1,240,41,88,0.466,33,64,0.516,8,24,0.333,15,18,0.833,105,37,91,0.407,26,54,0.481,11,37,0.297,9,12,0.75,94
1660,BRK,2019-04-03,105,,TOR,0,240,41,86,0.477,31,54,0.574,10,32,0.313,13,21,0.619,105,44,105,0.419,29,67,0.433,15,38,0.395,12,14,0.857,115
1661,SAC,2019-04-02,105,,HOU,0,240,42,95,0.442,35,72,0.486,7,23,0.304,14,20,0.7,105,46,94,0.489,20,33,0.606,26,61,0.426,12,17,0.706,130
1662,CHI,2019-04-01,105,@,NYK,0,240,42,94,0.447,38,77,0.494,4,17,0.235,17,23,0.739,105,37,74,0.5,19,36,0.528,18,38,0.474,21,25,0.84,113
1663,MIA,2019-04-01,105,@,BOS,0,240,40,88,0.455,30,51,0.588,10,37,0.27,15,18,0.833,105,36,91,0.396,19,51,0.373,17,40,0.425,21,24,0.875,110
1664,OKC,2019-03-29,105,,DEN,0,240,43,88,0.489,35,61,0.574,8,27,0.296,11,16,0.688,105,48,85,0.565,34,52,0.654,14,33,0.424,5,6,0.833,115
1665,MIA,2019-03-28,105,,DAL,1,240,39,89,0.438,32,59,0.542,7,30,0.233,20,27,0.741,105,36,92,0.391,20,45,0.444,16,47,0.34,11,17,0.647,99
1666,CLE,2019-03-24,105,@,MIL,0,240,41,96,0.427,30,55,0.545,11,41,0.268,12,17,0.706,105,48,87,0.552,33,46,0.717,15,41,0.366,16,21,0.762,127
1667,SAS,2019-03-22,105,@,HOU,0,240,41,90,0.456,34,66,0.515,7,24,0.292,16,17,0.941,105,36,86,0.419,22,49,0.449,14,37,0.378,25,32,0.781,111
1668,SAS,2019-03-20,105,,MIA,0,240,38,88,0.432,24,54,0.444,14,34,0.412,15,21,0.714,105,40,86,0.465,24,51,0.471,16,35,0.457,14,18,0.778,110
1669,ATL,2019-03-19,105,,HOU,0,240,39,84,0.464,24,44,0.545,15,40,0.375,12,15,0.8,105,40,78,0.513,21,31,0.677,19,47,0.404,22,30,0.733,121
1670,BOS,2019-03-18,105,,DEN,0,240,39,93,0.419,27,54,0.5,12,39,0.308,15,19,0.789,105,46,94,0.489,32,55,0.582,14,39,0.359,8,10,0.8,114
1671,GSW,2019-03-18,105,@,SAS,0,240,41,88,0.466,28,49,0.571,13,39,0.333,10,12,0.833,105,41,88,0.466,31,62,0.5,10,26,0.385,19,22,0.864,111
1672,DAL,2019-03-12,105,,SAS,0,240,38,82,0.463,24,43,0.558,14,39,0.359,15,26,0.577,105,43,82,0.524,35,60,0.583,8,22,0.364,18,18,1.0,112
1673,MEM,2019-03-10,105,,ORL,1,240,34,82,0.415,25,51,0.49,9,31,0.29,28,31,0.903,105,31,87,0.356,19,49,0.388,12,38,0.316,23,27,0.852,97
1674,DEN,2019-03-08,105,@,GSW,0,240,33,87,0.379,21,54,0.389,12,33,0.364,27,35,0.771,105,45,84,0.536,27,49,0.551,18,35,0.514,14,21,0.667,122
1675,IND,2019-03-05,105,,CHI,1,240,38,84,0.452,27,59,0.458,11,25,0.44,18,24,0.75,105,36,93,0.387,32,68,0.471,4,25,0.16,20,24,0.833,96
1676,MIL,2019-03-04,105,@,PHO,0,240,35,95,0.368,23,53,0.434,12,42,0.286,23,31,0.742,105,41,91,0.451,34,69,0.493,7,22,0.318,25,31,0.806,114
1677,LAL,2019-03-04,105,,LAC,0,240,38,91,0.418,28,53,0.528,10,38,0.263,19,24,0.792,105,41,83,0.494,30,54,0.556,11,29,0.379,20,24,0.833,113
1678,LAC,2019-02-27,105,@,UTA,0,240,37,94,0.394,32,68,0.471,5,26,0.192,26,30,0.867,105,38,92,0.413,27,58,0.466,11,34,0.324,24,32,0.75,111
1679,SAS,2019-02-27,105,,DET,1,240,42,81,0.519,33,64,0.516,9,17,0.529,12,17,0.706,105,36,100,0.36,21,62,0.339,15,38,0.395,6,7,0.857,93
1680,SAC,2019-02-25,105,@,MIN,0,240,37,95,0.389,28,69,0.406,9,26,0.346,22,29,0.759,105,42,83,0.506,34,52,0.654,8,31,0.258,20,28,0.714,112
1681,LAL,2019-02-25,105,@,MEM,0,240,40,89,0.449,30,62,0.484,10,27,0.37,15,20,0.75,105,41,93,0.441,32,57,0.561,9,36,0.25,19,23,0.826,110
1682,IND,2019-02-09,105,,CLE,1,240,45,84,0.536,36,58,0.621,9,26,0.346,6,10,0.6,105,35,79,0.443,19,43,0.442,16,36,0.444,4,9,0.444,90
1683,SAS,2019-02-09,105,@,UTA,0,240,40,89,0.449,33,67,0.493,7,22,0.318,18,20,0.9,105,47,90,0.522,31,49,0.633,16,41,0.39,15,20,0.75,125
1684,DET,2019-02-05,105,@,NYK,1,240,37,79,0.468,25,45,0.556,12,34,0.353,19,24,0.792,105,36,90,0.4,27,57,0.474,9,33,0.273,11,15,0.733,92
1685,MIL,2019-01-31,105,@,TOR,1,240,39,79,0.494,25,41,0.61,14,38,0.368,13,17,0.765,105,37,93,0.398,30,66,0.455,7,27,0.259,11,13,0.846,92
1686,DEN,2019-01-30,105,@,NOP,1,240,42,89,0.472,33,59,0.559,9,30,0.3,12,19,0.632,105,37,89,0.416,22,53,0.415,15,36,0.417,10,13,0.769,99
1687,UTA,2019-01-30,105,@,POR,0,240,38,85,0.447,27,51,0.529,11,34,0.324,18,21,0.857,105,48,90,0.533,32,58,0.552,16,32,0.5,20,23,0.87,132
1688,CHI,2019-01-30,105,@,MIA,1,240,40,78,0.513,32,59,0.542,8,19,0.421,17,21,0.81,105,34,89,0.382,22,47,0.468,12,42,0.286,9,13,0.692,89
1689,LAL,2019-01-29,105,,PHI,0,240,43,92,0.467,36,69,0.522,7,23,0.304,12,16,0.75,105,42,93,0.452,27,57,0.474,15,36,0.417,22,28,0.786,121
1690,DET,2019-01-29,105,,MIL,0,240,42,89,0.472,30,52,0.577,12,37,0.324,9,12,0.75,105,47,87,0.54,34,55,0.618,13,32,0.406,8,10,0.8,115
1691,LAL,2019-01-24,105,,MIN,0,240,44,87,0.506,36,59,0.61,8,28,0.286,9,14,0.643,105,44,102,0.431,34,69,0.493,10,33,0.303,22,25,0.88,120
1692,SAC,2019-01-22,105,@,TOR,0,240,41,91,0.451,34,70,0.486,7,21,0.333,16,22,0.727,105,40,91,0.44,24,51,0.471,16,40,0.4,24,35,0.686,120
1693,NOP,2019-01-21,105,@,MEM,1,240,39,74,0.527,30,48,0.625,9,26,0.346,18,26,0.692,105,33,88,0.375,24,53,0.453,9,35,0.257,10,17,0.588,85
1694,ATL,2019-01-19,105,,BOS,0,240,40,92,0.435,28,51,0.549,12,41,0.293,13,14,0.929,105,39,88,0.443,27,56,0.482,12,32,0.375,23,25,0.92,113
1695,CHI,2019-01-17,105,@,DEN,0,240,44,93,0.473,34,65,0.523,10,28,0.357,7,11,0.636,105,50,96,0.521,30,56,0.536,20,40,0.5,15,20,0.75,135
1696,SAS,2019-01-16,105,@,DAL,1,240,41,83,0.494,28,53,0.528,13,30,0.433,10,12,0.833,105,37,86,0.43,22,44,0.5,15,42,0.357,12,16,0.75,101
1697,NYK,2019-01-13,105,,PHI,0,240,37,86,0.43,27,55,0.491,10,31,0.323,21,30,0.7,105,40,87,0.46,34,67,0.507,6,20,0.3,22,30,0.733,108
1698,ORL,2019-01-12,105,,BOS,1,240,36,84,0.429,25,46,0.543,11,38,0.289,22,24,0.917,105,38,90,0.422,30,58,0.517,8,32,0.25,19,28,0.679,103
1699,BRK,2019-01-11,105,@,TOR,0,240,37,88,0.42,26,58,0.448,11,30,0.367,20,30,0.667,105,48,105,0.457,37,70,0.529,11,35,0.314,15,24,0.625,122
1700,IND,2019-01-06,105,@,TOR,0,240,43,94,0.457,39,77,0.506,4,17,0.235,15,20,0.75,105,44,85,0.518,27,52,0.519,17,33,0.515,16,17,0.941,121
1701,DET,2019-01-05,105,,UTA,0,240,39,82,0.476,28,57,0.491,11,25,0.44,16,20,0.8,105,39,82,0.476,32,61,0.525,7,21,0.333,25,32,0.781,110
1702,DAL,2018-12-30,105,,OKC,1,240,37,81,0.457,23,42,0.548,14,39,0.359,17,22,0.773,105,40,93,0.43,31,55,0.564,9,38,0.237,14,21,0.667,103
1703,POR,2018-12-29,105,,GSW,0,240,39,91,0.429,30,60,0.5,9,31,0.29,18,22,0.818,105,40,80,0.5,28,55,0.509,12,25,0.48,23,28,0.821,115
1704,IND,2018-12-23,105,,WAS,1,240,43,97,0.443,34,67,0.507,9,30,0.3,10,12,0.833,105,28,76,0.368,19,41,0.463,9,35,0.257,24,26,0.923,89
1705,SAC,2018-12-17,105,@,MIN,0,240,38,90,0.422,24,52,0.462,14,38,0.368,15,23,0.652,105,48,96,0.5,38,69,0.551,10,27,0.37,26,30,0.867,132
1706,CLE,2018-12-16,105,,PHI,0,240,41,88,0.466,29,58,0.5,12,30,0.4,11,17,0.647,105,51,91,0.56,40,64,0.625,11,27,0.407,15,20,0.75,128
1707,HOU,2018-12-15,105,@,MEM,1,240,35,73,0.479,22,36,0.611,13,37,0.351,22,25,0.88,105,40,75,0.533,35,52,0.673,5,23,0.217,12,17,0.706,97
1708,DEN,2018-12-10,105,,MEM,1,240,39,77,0.506,30,49,0.612,9,28,0.321,18,23,0.783,105,37,74,0.5,28,47,0.596,9,27,0.333,16,17,0.941,99
1709,MIA,2018-12-10,105,@,LAL,0,240,42,94,0.447,31,60,0.517,11,34,0.324,10,13,0.769,105,41,90,0.456,27,58,0.466,14,32,0.438,12,20,0.6,108
1710,MIN,2018-12-08,105,@,POR,0,240,40,91,0.44,33,75,0.44,7,16,0.438,18,22,0.818,105,39,83,0.47,29,50,0.58,10,33,0.303,25,30,0.833,113
1711,TOR,2018-12-07,105,@,BRK,0,265,35,89,0.393,24,54,0.444,11,35,0.314,24,29,0.828,105,43,98,0.439,32,63,0.508,11,35,0.314,9,13,0.692,106
1712,GSW,2018-12-07,105,@,MIL,1,240,40,89,0.449,21,43,0.488,19,46,0.413,6,7,0.857,105,36,92,0.391,29,53,0.547,7,39,0.179,16,23,0.696,95
1713,CLE,2018-12-05,105,,GSW,0,240,39,89,0.438,28,57,0.491,11,32,0.344,16,23,0.696,105,45,85,0.529,27,51,0.529,18,34,0.529,21,24,0.875,129
1714,ORL,2018-12-04,105,@,MIA,1,240,38,86,0.442,24,58,0.414,14,28,0.5,15,20,0.75,105,38,91,0.418,26,56,0.464,12,35,0.343,2,5,0.4,90
1715,PHO,2018-12-04,105,,SAC,0,240,38,87,0.437,26,44,0.591,12,43,0.279,17,21,0.81,105,45,84,0.536,34,60,0.567,11,24,0.458,21,32,0.656,122
1716,SAS,2018-12-04,105,@,UTA,0,240,44,90,0.489,37,68,0.544,7,22,0.318,10,11,0.909,105,51,84,0.607,31,51,0.608,20,33,0.606,17,20,0.85,139
1717,CHI,2018-12-01,105,@,HOU,0,240,39,88,0.443,31,56,0.554,8,32,0.25,19,24,0.792,105,42,84,0.5,26,43,0.605,16,41,0.39,21,30,0.7,121
1718,SAS,2018-11-30,105,,HOU,0,240,39,86,0.453,29,58,0.5,10,28,0.357,17,20,0.85,105,49,98,0.5,27,44,0.614,22,54,0.407,16,20,0.8,136
1719,DEN,2018-11-24,105,@,OKC,1,240,39,95,0.411,29,65,0.446,10,30,0.333,17,24,0.708,105,37,103,0.359,28,64,0.438,9,39,0.231,15,23,0.652,98
1720,CLE,2018-11-21,105,,LAL,0,240,39,102,0.382,26,68,0.382,13,34,0.382,14,15,0.933,105,40,78,0.513,31,53,0.585,9,25,0.36,20,28,0.714,109
1721,LAC,2018-11-08,105,@,POR,0,240,41,89,0.461,33,66,0.5,8,23,0.348,15,20,0.75,105,40,97,0.412,30,71,0.423,10,26,0.385,26,28,0.929,116
1722,SAC,2018-11-07,105,,TOR,0,240,42,88,0.477,34,65,0.523,8,23,0.348,13,18,0.722,105,41,89,0.461,30,53,0.566,11,36,0.306,21,23,0.913,114
1723,CHI,2018-11-02,105,,IND,0,240,42,89,0.472,29,58,0.5,13,31,0.419,8,9,0.889,105,40,85,0.471,33,59,0.559,7,26,0.269,20,22,0.909,107
1724,DET,2018-10-30,105,@,BOS,0,240,37,88,0.42,29,58,0.5,8,30,0.267,23,27,0.852,105,37,84,0.44,28,53,0.528,9,31,0.29,25,32,0.781,108
1725,PHI,2018-10-27,105,,CHO,1,240,35,91,0.385,25,63,0.397,10,28,0.357,25,30,0.833,105,37,95,0.389,28,60,0.467,9,35,0.257,20,24,0.833,103
1726,MIN,2018-10-24,105,@,TOR,0,240,40,96,0.417,25,66,0.379,15,30,0.5,10,16,0.625,105,46,89,0.517,35,57,0.614,11,32,0.344,9,12,0.75,112
1727,NYK,2018-10-19,105,@,BRK,0,240,39,97,0.402,30,69,0.435,9,28,0.321,18,20,0.9,105,37,75,0.493,25,45,0.556,12,30,0.4,21,24,0.875,107
1728,BOS,2018-10-16,105,,PHI,1,240,42,97,0.433,31,60,0.517,11,37,0.297,10,14,0.714,105,34,87,0.391,29,61,0.475,5,26,0.192,14,23,0.609,87
1729,POR,2019-04-09,104,@,LAL,1,240,37,90,0.411,26,53,0.491,11,37,0.297,19,22,0.864,104,40,94,0.426,30,65,0.462,10,29,0.345,11,17,0.647,101
1730,LAC,2019-04-07,104,@,GSW,0,240,38,79,0.481,28,60,0.467,10,19,0.526,18,29,0.621,104,53,97,0.546,41,60,0.683,12,37,0.324,13,15,0.867,131
1731,CHO,2019-04-07,104,@,DET,1,240,38,88,0.432,28,57,0.491,10,31,0.323,18,23,0.783,104,34,92,0.37,24,51,0.471,10,41,0.244,13,15,0.867,91
1732,CLE,2019-04-04,104,@,SAC,0,240,44,81,0.543,33,56,0.589,11,25,0.44,5,9,0.556,104,48,97,0.495,34,59,0.576,14,38,0.368,7,10,0.7,117
1733,ORL,2019-03-26,104,@,MIA,1,240,37,89,0.416,23,47,0.489,14,42,0.333,16,23,0.696,104,36,86,0.419,26,53,0.491,10,33,0.303,17,21,0.81,99
1734,HOU,2019-03-13,104,,GSW,0,240,37,78,0.474,26,37,0.703,11,41,0.268,19,23,0.826,104,42,85,0.494,30,53,0.566,12,32,0.375,10,10,1.0,106
1735,LAC,2019-03-12,104,,POR,0,240,38,95,0.4,29,80,0.363,9,15,0.6,19,27,0.704,104,47,96,0.49,35,65,0.538,12,31,0.387,19,26,0.731,125
1736,MIA,2019-03-10,104,,TOR,0,240,42,92,0.457,34,65,0.523,8,27,0.296,12,21,0.571,104,42,74,0.568,21,34,0.618,21,40,0.525,20,26,0.769,125
1737,UTA,2019-03-08,104,@,MEM,0,240,35,82,0.427,17,34,0.5,18,48,0.375,16,24,0.667,104,46,90,0.511,37,68,0.544,9,22,0.409,13,15,0.867,114
1738,NOP,2019-03-08,104,,TOR,0,240,43,105,0.41,33,66,0.5,10,39,0.256,8,13,0.615,104,53,99,0.535,40,62,0.645,13,37,0.351,8,9,0.889,127
1739,CHI,2019-03-08,104,,DET,0,240,42,82,0.512,37,65,0.569,5,17,0.294,15,23,0.652,104,45,83,0.542,36,56,0.643,9,27,0.333,13,21,0.619,112
1740,NOP,2019-03-06,104,,UTA,0,240,41,89,0.461,32,65,0.492,9,24,0.375,13,20,0.65,104,46,88,0.523,38,58,0.655,8,30,0.267,14,22,0.636,114
1741,ATL,2019-03-06,104,,SAS,0,240,36,92,0.391,23,49,0.469,13,43,0.302,19,24,0.792,104,44,89,0.494,34,56,0.607,10,33,0.303,13,18,0.722,111
1742,SAS,2019-03-04,104,,DEN,1,240,41,85,0.482,33,60,0.55,8,25,0.32,14,19,0.737,104,41,95,0.432,24,55,0.436,17,40,0.425,4,4,1.0,103
1743,BOS,2019-03-03,104,,HOU,0,240,37,77,0.481,29,49,0.592,8,28,0.286,22,29,0.759,104,38,80,0.475,17,29,0.586,21,51,0.412,18,29,0.621,115
1744,OKC,2019-02-28,104,,PHI,0,240,38,87,0.437,30,60,0.5,8,27,0.296,20,28,0.714,104,42,91,0.462,30,61,0.492,12,30,0.4,12,19,0.632,108
1745,DEN,2019-02-28,104,,UTA,0,240,40,99,0.404,33,74,0.446,7,25,0.28,17,24,0.708,104,37,84,0.44,21,41,0.512,16,43,0.372,21,33,0.636,111
1746,DAL,2019-02-22,104,,DEN,0,240,34,84,0.405,24,43,0.558,10,41,0.244,26,33,0.788,104,42,103,0.408,28,66,0.424,14,37,0.378,16,25,0.64,114
1747,NYK,2019-02-22,104,,MIN,0,240,37,86,0.43,26,57,0.456,11,29,0.379,19,24,0.792,104,41,87,0.471,30,63,0.476,11,24,0.458,22,32,0.688,115
1748,DAL,2019-02-11,104,@,HOU,0,240,35,73,0.479,22,37,0.595,13,36,0.361,21,27,0.778,104,42,90,0.467,19,30,0.633,23,60,0.383,13,15,0.867,120
1749,NYK,2019-02-11,104,@,CLE,0,240,42,92,0.457,35,66,0.53,7,26,0.269,13,20,0.65,104,38,95,0.4,24,51,0.471,14,44,0.318,17,19,0.895,107
1750,PHO,2019-02-10,104,@,SAC,0,240,38,91,0.418,32,64,0.5,6,27,0.222,22,30,0.733,104,38,84,0.452,29,53,0.547,9,31,0.29,32,44,0.727,117
1751,TOR,2019-02-09,104,@,NYK,1,240,33,86,0.384,19,51,0.373,14,35,0.4,24,29,0.828,104,39,94,0.415,29,69,0.42,10,25,0.4,11,19,0.579,99
1752,GSW,2019-01-31,104,,PHI,0,240,41,88,0.466,30,50,0.6,11,38,0.289,11,16,0.688,104,41,88,0.466,29,51,0.569,12,37,0.324,19,24,0.792,113
1753,BRK,2019-01-28,104,@,BOS,0,240,39,103,0.379,26,69,0.377,13,34,0.382,13,16,0.813,104,45,100,0.45,32,60,0.533,13,40,0.325,9,10,0.9,112
1754,CLE,2019-01-27,104,@,CHI,1,240,39,92,0.424,26,58,0.448,13,34,0.382,13,15,0.867,104,39,88,0.443,30,62,0.484,9,26,0.346,14,17,0.824,101
1755,UTA,2019-01-21,104,,POR,0,240,36,91,0.396,29,58,0.5,7,33,0.212,25,31,0.806,104,45,90,0.5,37,72,0.514,8,18,0.444,11,15,0.733,109
1756,CHI,2019-01-21,104,@,CLE,1,240,36,76,0.474,21,46,0.457,15,30,0.5,17,22,0.773,104,31,87,0.356,25,60,0.417,6,27,0.222,20,29,0.69,88
1757,SAC,2019-01-12,104,,CHO,1,240,41,99,0.414,27,62,0.435,14,37,0.378,8,12,0.667,104,36,88,0.409,24,52,0.462,12,36,0.333,13,22,0.591,97
1758,LAC,2019-01-12,104,,DET,0,240,36,74,0.486,27,56,0.482,9,18,0.5,23,29,0.793,104,37,85,0.435,21,48,0.438,16,37,0.432,19,22,0.864,109
1759,DAL,2019-01-09,104,,PHO,1,240,30,70,0.429,18,36,0.5,12,34,0.353,32,45,0.711,104,36,84,0.429,29,59,0.492,7,25,0.28,15,21,0.714,94
1760,TOR,2019-01-08,104,,ATL,1,240,37,80,0.463,27,48,0.563,10,32,0.313,20,27,0.741,104,40,87,0.46,30,60,0.5,10,27,0.37,11,16,0.688,101
1761,MIA,2018-12-30,104,,MIN,0,240,37,90,0.411,29,66,0.439,8,24,0.333,22,28,0.786,104,38,94,0.404,30,70,0.429,8,24,0.333,29,36,0.806,113
1762,NOP,2018-12-29,104,,HOU,0,240,41,92,0.446,32,64,0.5,9,28,0.321,13,17,0.765,104,35,81,0.432,19,35,0.543,16,46,0.348,22,28,0.786,108
1763,MIA,2018-12-26,104,,TOR,0,240,43,83,0.518,31,54,0.574,12,29,0.414,6,12,0.5,104,37,79,0.468,24,49,0.49,13,30,0.433,19,23,0.826,106
1764,NOP,2018-12-21,104,@,LAL,0,240,44,102,0.431,36,75,0.48,8,27,0.296,8,16,0.5,104,43,92,0.467,35,60,0.583,8,32,0.25,18,25,0.72,112
1765,DET,2018-12-17,104,,MIL,0,240,39,88,0.443,25,53,0.472,14,35,0.4,12,15,0.8,104,44,88,0.5,35,63,0.556,9,25,0.36,10,15,0.667,107
1766,LAC,2018-12-15,104,@,OKC,0,240,38,75,0.507,25,50,0.5,13,25,0.52,15,22,0.682,104,42,90,0.467,33,68,0.485,9,22,0.409,17,24,0.708,110
1767,BOS,2018-12-15,104,@,DET,0,240,39,94,0.415,30,61,0.492,9,33,0.273,17,23,0.739,104,39,80,0.488,29,50,0.58,10,30,0.333,25,35,0.714,113
1768,POR,2018-12-11,104,@,HOU,0,240,38,87,0.437,28,62,0.452,10,25,0.4,18,21,0.857,104,42,85,0.494,33,56,0.589,9,29,0.31,18,27,0.667,111
1769,MIL,2018-12-09,104,@,TOR,1,240,36,87,0.414,21,48,0.438,15,39,0.385,17,20,0.85,104,39,94,0.415,24,50,0.48,15,44,0.341,6,7,0.857,99
1770,NYK,2018-12-08,104,,BRK,0,240,39,83,0.47,31,57,0.544,8,26,0.308,18,30,0.6,104,43,88,0.489,32,66,0.485,11,22,0.5,15,25,0.6,112
1771,HOU,2018-12-08,104,@,DAL,0,240,39,86,0.453,24,39,0.615,15,47,0.319,11,13,0.846,104,41,83,0.494,29,53,0.547,12,30,0.4,13,16,0.813,107
1772,CHO,2018-12-05,104,@,MIN,0,240,40,98,0.408,28,65,0.431,12,33,0.364,12,15,0.8,104,48,89,0.539,36,65,0.554,12,24,0.5,13,20,0.65,121
1773,LAL,2018-11-29,104,,IND,1,240,42,86,0.488,35,62,0.565,7,24,0.292,13,23,0.565,104,32,86,0.372,22,63,0.349,10,23,0.435,22,27,0.815,96
1774,WAS,2018-11-28,104,@,NOP,0,240,41,95,0.432,28,56,0.5,13,39,0.333,9,16,0.563,104,46,95,0.484,35,59,0.593,11,36,0.306,22,28,0.786,125
1775,PHO,2018-11-27,104,,IND,0,240,41,92,0.446,31,62,0.5,10,30,0.333,12,18,0.667,104,38,90,0.422,27,64,0.422,11,26,0.423,22,29,0.759,109
1776,LAC,2018-11-25,104,@,POR,1,240,38,90,0.422,33,65,0.508,5,25,0.2,23,34,0.676,104,42,97,0.433,34,59,0.576,8,38,0.211,8,10,0.8,100
1777,LAL,2018-11-25,104,,ORL,0,240,37,79,0.468,27,53,0.509,10,26,0.385,20,31,0.645,104,42,93,0.452,31,62,0.5,11,31,0.355,13,14,0.929,108
1778,BOS,2018-11-24,104,@,DAL,0,240,41,86,0.477,31,58,0.534,10,28,0.357,12,13,0.923,104,42,87,0.483,26,46,0.565,16,41,0.39,13,21,0.619,113
1779,CHO,2018-11-23,104,@,OKC,0,240,43,94,0.457,37,63,0.587,6,31,0.194,12,14,0.857,104,41,93,0.441,30,60,0.5,11,33,0.333,16,24,0.667,109
1780,MEM,2018-11-21,104,@,SAS,1,240,39,81,0.481,31,56,0.554,8,25,0.32,18,21,0.857,104,35,82,0.427,28,60,0.467,7,22,0.318,26,30,0.867,103
1781,BRK,2018-11-20,104,@,MIA,1,240,38,88,0.432,30,57,0.526,8,31,0.258,20,26,0.769,104,36,100,0.36,29,68,0.426,7,32,0.219,13,20,0.65,92
1782,MIL,2018-11-19,104,,DEN,1,240,40,88,0.455,29,52,0.558,11,36,0.306,13,22,0.591,104,40,94,0.426,28,53,0.528,12,41,0.293,6,9,0.667,98
1783,SAS,2018-11-18,104,,GSW,1,240,41,92,0.446,31,68,0.456,10,24,0.417,12,17,0.706,104,35,86,0.407,30,60,0.5,5,26,0.192,17,21,0.81,92
1784,WAS,2018-11-16,104,,BRK,0,240,37,87,0.425,34,69,0.493,3,18,0.167,27,34,0.794,104,38,90,0.422,29,57,0.509,9,33,0.273,30,38,0.789,115
1785,SAC,2018-11-16,104,@,MEM,0,240,37,80,0.463,25,47,0.532,12,33,0.364,18,24,0.75,104,43,85,0.506,32,60,0.533,11,25,0.44,15,24,0.625,112
1786,CHI,2018-11-16,104,@,MIL,0,240,41,94,0.436,28,61,0.459,13,33,0.394,9,13,0.692,104,47,93,0.505,29,50,0.58,18,43,0.419,11,17,0.647,123
1787,TOR,2018-11-14,104,,DET,0,240,45,92,0.489,41,72,0.569,4,20,0.2,10,17,0.588,104,44,91,0.484,34,58,0.586,10,33,0.303,8,13,0.615,106
1788,SAC,2018-11-12,104,,SAS,1,240,43,86,0.5,32,62,0.516,11,24,0.458,7,12,0.583,104,38,87,0.437,28,56,0.5,10,31,0.323,13,16,0.813,99
1789,BRK,2018-11-06,104,@,PHO,1,240,41,92,0.446,32,56,0.571,9,36,0.25,13,19,0.684,104,28,81,0.346,19,56,0.339,9,25,0.36,17,20,0.85,82
1790,POR,2018-10-30,104,@,HOU,1,240,38,80,0.475,30,60,0.5,8,20,0.4,20,23,0.87,104,31,96,0.323,21,53,0.396,10,43,0.233,13,23,0.565,85
1791,DAL,2018-10-28,104,,UTA,0,240,38,91,0.418,29,63,0.46,9,28,0.321,19,25,0.76,104,42,80,0.525,32,55,0.582,10,25,0.4,19,22,0.864,113
1792,WAS,2018-10-28,104,@,LAC,0,240,38,97,0.392,33,70,0.471,5,27,0.185,23,28,0.821,104,56,103,0.544,40,74,0.541,16,29,0.552,8,13,0.615,136
1793,DAL,2018-10-24,104,@,ATL,0,240,38,91,0.418,26,51,0.51,12,40,0.3,16,26,0.615,104,37,91,0.407,22,53,0.415,15,38,0.395,22,31,0.71,111
1794,ORL,2018-10-17,104,,MIA,1,240,39,94,0.415,32,69,0.464,7,25,0.28,19,31,0.613,104,38,97,0.392,29,64,0.453,9,33,0.273,16,22,0.727,101
1795,CLE,2018-10-17,104,@,TOR,0,240,34,85,0.4,27,66,0.409,7,19,0.368,29,39,0.744,104,45,92,0.489,31,59,0.525,14,33,0.424,12,20,0.6,116
1796,NOP,2019-04-09,103,,GSW,0,240,44,99,0.444,35,66,0.53,9,33,0.273,6,10,0.6,103,43,89,0.483,31,59,0.525,12,30,0.4,14,21,0.667,112
1797,LAC,2019-04-03,103,,HOU,0,240,38,82,0.463,30,56,0.536,8,26,0.308,19,31,0.613,103,47,88,0.534,29,50,0.58,18,38,0.474,23,29,0.793,135
1798,LAL,2019-04-02,103,@,OKC,0,240,40,84,0.476,24,45,0.533,16,39,0.41,7,10,0.7,103,47,102,0.461,34,58,0.586,13,44,0.295,12,20,0.6,119
1799,OKC,2019-03-31,103,,DAL,0,240,38,98,0.388,27,55,0.491,11,43,0.256,16,22,0.727,103,37,87,0.425,21,43,0.488,16,44,0.364,16,23,0.696,106
1800,MEM,2019-03-27,103,,GSW,0,240,39,100,0.39,29,69,0.42,10,31,0.323,15,21,0.714,103,45,84,0.536,30,53,0.566,15,31,0.484,13,15,0.867,118
1801,CHI,2019-03-26,103,@,TOR,0,240,39,86,0.453,31,63,0.492,8,23,0.348,17,20,0.85,103,42,86,0.488,30,58,0.517,12,28,0.429,16,16,1.0,112
1802,OKC,2019-03-25,103,@,MEM,0,240,38,95,0.4,26,59,0.441,12,36,0.333,15,20,0.75,103,40,89,0.449,29,56,0.518,11,33,0.333,24,31,0.774,115
1803,PHO,2019-03-23,103,@,SAC,0,240,36,88,0.409,27,54,0.5,9,34,0.265,22,26,0.846,103,39,92,0.424,22,54,0.407,17,38,0.447,17,22,0.773,112
1804,POR,2019-03-16,103,@,SAS,0,240,42,101,0.416,35,73,0.479,7,28,0.25,12,14,0.857,103,37,79,0.468,29,62,0.468,8,17,0.471,26,30,0.867,108
1805,IND,2019-03-12,103,,NYK,1,240,37,85,0.435,29,57,0.509,8,28,0.286,21,29,0.724,103,35,80,0.438,22,52,0.423,13,28,0.464,15,18,0.833,98
1806,BRK,2019-03-11,103,,DET,1,240,39,79,0.494,28,48,0.583,11,31,0.355,14,22,0.636,103,27,97,0.278,19,63,0.302,8,34,0.235,13,16,0.813,75
1807,MIN,2019-03-10,103,,NYK,1,240,42,94,0.447,33,64,0.516,9,30,0.3,10,13,0.769,103,37,86,0.43,27,61,0.443,10,25,0.4,8,14,0.571,92
1808,DEN,2019-03-04,103,@,SAS,0,240,41,95,0.432,24,55,0.436,17,40,0.425,4,4,1.0,103,41,85,0.482,33,60,0.55,8,25,0.32,14,19,0.737,104
1809,ORL,2019-02-28,103,,GSW,1,240,40,89,0.449,29,58,0.5,11,31,0.355,12,15,0.8,103,39,97,0.402,30,57,0.526,9,40,0.225,9,10,0.9,96
1810,ORL,2019-02-26,103,@,NYK,0,240,39,89,0.438,28,57,0.491,11,32,0.344,14,20,0.7,103,38,89,0.427,31,65,0.477,7,24,0.292,25,32,0.781,108
1811,DEN,2019-02-11,103,,MIA,1,240,38,89,0.427,22,52,0.423,16,37,0.432,11,13,0.846,103,34,82,0.415,25,49,0.51,9,33,0.273,10,16,0.625,87
1812,ORL,2019-02-09,103,@,MIL,1,240,44,94,0.468,34,67,0.507,10,27,0.37,5,6,0.833,103,31,95,0.326,25,60,0.417,6,35,0.171,15,18,0.833,83
1813,NYK,2019-02-08,103,@,DET,0,240,35,78,0.449,28,56,0.5,7,22,0.318,26,41,0.634,103,42,86,0.488,29,56,0.518,13,30,0.433,23,29,0.793,120
1814,BOS,2019-02-05,103,@,CLE,1,240,40,82,0.488,31,56,0.554,9,26,0.346,14,14,1.0,103,40,96,0.417,31,63,0.492,9,33,0.273,7,8,0.875,96
1815,DEN,2019-02-04,103,@,DET,0,240,41,92,0.446,32,64,0.5,9,28,0.321,12,22,0.545,103,48,88,0.545,32,51,0.627,16,37,0.432,17,20,0.85,129
1816,LAC,2019-02-03,103,@,TOR,0,240,38,89,0.427,36,77,0.468,2,12,0.167,25,29,0.862,103,43,94,0.457,34,61,0.557,9,33,0.273,26,31,0.839,121
1817,HOU,2019-01-27,103,,ORL,1,240,38,80,0.475,26,44,0.591,12,36,0.333,15,21,0.714,103,39,97,0.402,29,62,0.468,10,35,0.286,10,17,0.588,98
1818,IND,2019-01-26,103,@,MEM,0,240,32,74,0.432,23,47,0.489,9,27,0.333,30,36,0.833,103,39,80,0.488,30,52,0.577,9,28,0.321,19,28,0.679,106
1819,CLE,2019-01-23,103,@,BOS,0,240,38,87,0.437,25,57,0.439,13,30,0.433,14,20,0.7,103,45,86,0.523,33,61,0.541,12,25,0.48,21,23,0.913,123
1820,ATL,2019-01-21,103,,ORL,0,240,39,86,0.453,30,56,0.536,9,30,0.3,16,23,0.696,103,46,91,0.505,35,62,0.565,11,29,0.379,19,21,0.905,122
1821,LAC,2019-01-20,103,@,SAS,1,240,39,85,0.459,28,64,0.438,11,21,0.524,14,24,0.583,103,39,84,0.464,31,65,0.477,8,19,0.421,9,17,0.529,95
1822,CHI,2019-01-19,103,,MIA,0,240,35,89,0.393,23,62,0.371,12,27,0.444,21,26,0.808,103,45,79,0.57,32,47,0.681,13,32,0.406,14,23,0.609,117
1823,SAC,2019-01-19,103,@,DET,1,240,40,89,0.449,30,64,0.469,10,25,0.4,13,18,0.722,103,36,82,0.439,26,53,0.491,10,29,0.345,19,25,0.76,101
1824,BOS,2019-01-12,103,@,ORL,0,240,38,90,0.422,30,58,0.517,8,32,0.25,19,28,0.679,103,36,84,0.429,25,46,0.543,11,38,0.289,22,24,0.917,105
1825,DEN,2019-01-08,103,@,MIA,1,240,41,87,0.471,32,60,0.533,9,27,0.333,12,17,0.706,103,38,83,0.458,30,52,0.577,8,31,0.258,15,25,0.6,99
1826,ORL,2019-01-04,103,@,MIN,0,240,42,88,0.477,33,61,0.541,9,27,0.333,10,19,0.526,103,47,91,0.516,38,65,0.585,9,26,0.346,17,23,0.739,120
1827,OKC,2018-12-30,103,@,DAL,0,240,40,93,0.43,31,55,0.564,9,38,0.237,14,21,0.667,103,37,81,0.457,23,42,0.548,14,39,0.359,17,22,0.773,105
1828,MEM,2018-12-29,103,,BOS,0,240,36,76,0.474,29,50,0.58,7,26,0.269,24,29,0.828,103,40,80,0.5,24,44,0.545,16,36,0.444,16,18,0.889,112
1829,DEN,2018-12-26,103,@,SAS,0,240,35,90,0.389,17,50,0.34,18,40,0.45,15,23,0.652,103,42,90,0.467,32,58,0.552,10,32,0.313,17,22,0.773,111
1830,PHO,2018-12-23,103,@,BRK,0,240,43,89,0.483,40,72,0.556,3,17,0.176,14,16,0.875,103,40,85,0.471,30,58,0.517,10,27,0.37,21,33,0.636,111
1831,CHO,2018-12-23,103,@,BOS,0,240,38,88,0.432,30,56,0.536,8,32,0.25,19,26,0.731,103,43,86,0.5,30,47,0.638,13,39,0.333,20,25,0.8,119
1832,BOS,2018-12-19,103,,PHO,0,240,38,85,0.447,23,46,0.5,15,39,0.385,12,14,0.857,103,41,96,0.427,30,69,0.435,11,27,0.407,18,22,0.818,111
1833,GSW,2018-12-19,103,@,UTA,0,240,38,95,0.4,28,64,0.438,10,31,0.323,17,18,0.944,103,37,93,0.398,21,51,0.412,16,42,0.381,18,22,0.818,108
1834,NOP,2018-12-07,103,,MEM,0,240,38,84,0.452,31,55,0.564,7,29,0.241,20,24,0.833,103,39,83,0.47,31,64,0.484,8,19,0.421,21,28,0.75,107
1835,TOR,2018-12-03,103,,DEN,0,240,40,87,0.46,29,46,0.63,11,41,0.268,12,12,1.0,103,40,89,0.449,29,61,0.475,11,28,0.393,15,24,0.625,106
1836,MIN,2018-12-03,103,,HOU,1,240,36,82,0.439,25,60,0.417,11,22,0.5,20,28,0.714,103,32,74,0.432,21,35,0.6,11,39,0.282,16,19,0.842,91
1837,PHI,2018-12-02,103,,MEM,1,240,36,74,0.486,28,52,0.538,8,22,0.364,23,30,0.767,103,33,79,0.418,22,51,0.431,11,28,0.393,18,23,0.783,95
1838,DAL,2018-11-30,103,@,LAL,0,240,34,86,0.395,24,47,0.511,10,39,0.256,25,34,0.735,103,42,86,0.488,33,56,0.589,9,30,0.3,21,32,0.656,114
1839,NYK,2018-11-25,103,@,MEM,1,240,34,91,0.374,26,69,0.377,8,22,0.364,27,32,0.844,103,38,86,0.442,27,56,0.482,11,30,0.367,11,19,0.579,98
1840,MIA,2018-11-23,103,@,CHI,1,240,37,87,0.425,27,53,0.509,10,34,0.294,19,31,0.613,103,35,94,0.372,28,66,0.424,7,28,0.25,19,20,0.95,96
1841,SAS,2018-11-21,103,,MEM,0,240,35,82,0.427,28,60,0.467,7,22,0.318,26,30,0.867,103,39,81,0.481,31,56,0.554,8,25,0.32,18,21,0.857,104
1842,DEN,2018-11-21,103,@,MIN,1,240,42,89,0.472,28,54,0.519,14,35,0.4,5,6,0.833,103,35,79,0.443,26,47,0.553,9,32,0.281,22,26,0.846,101
1843,NYK,2018-11-14,103,@,OKC,0,240,39,88,0.443,32,62,0.516,7,26,0.269,18,23,0.783,103,51,95,0.537,35,62,0.565,16,33,0.485,10,12,0.833,128
1844,ATL,2018-11-13,103,@,GSW,0,240,40,89,0.449,28,57,0.491,12,32,0.375,11,15,0.733,103,39,91,0.429,27,64,0.422,12,27,0.444,20,21,0.952,110
1845,DAL,2018-11-12,103,@,CHI,1,240,37,79,0.468,27,46,0.587,10,33,0.303,19,29,0.655,103,35,89,0.393,27,56,0.482,8,33,0.242,20,22,0.909,98
1846,IND,2018-11-11,103,@,HOU,0,240,36,78,0.462,25,49,0.51,11,29,0.379,20,26,0.769,103,36,74,0.486,16,27,0.593,20,47,0.426,23,32,0.719,115
1847,DET,2018-11-11,103,,CHO,0,240,38,104,0.365,26,60,0.433,12,44,0.273,15,19,0.789,103,43,85,0.506,32,57,0.561,11,28,0.393,16,18,0.889,113
1848,DET,2018-11-07,103,@,ORL,1,240,37,90,0.411,26,53,0.491,11,37,0.297,18,20,0.9,103,40,87,0.46,31,60,0.517,9,27,0.333,7,9,0.778,96
1849,MIL,2018-11-06,103,@,POR,0,240,40,92,0.435,24,50,0.48,16,42,0.381,7,8,0.875,103,48,91,0.527,31,48,0.646,17,43,0.395,5,8,0.625,118
1850,DEN,2018-11-03,103,,UTA,1,240,41,83,0.494,32,55,0.582,9,28,0.321,12,19,0.632,103,33,81,0.407,27,50,0.54,6,31,0.194,16,24,0.667,88
1851,POR,2018-10-29,103,@,IND,1,240,38,78,0.487,28,52,0.538,10,26,0.385,17,18,0.944,103,37,90,0.411,31,71,0.437,6,19,0.316,13,20,0.65,93
1852,CHO,2018-10-27,103,@,PHI,0,240,37,95,0.389,28,60,0.467,9,35,0.257,20,24,0.833,103,35,91,0.385,25,63,0.397,10,28,0.357,25,30,0.833,105
1853,CLE,2018-10-25,103,@,DET,0,240,41,89,0.461,33,65,0.508,8,24,0.333,13,15,0.867,103,41,78,0.526,30,50,0.6,11,28,0.393,17,29,0.586,110
1854,PHO,2018-10-22,103,@,GSW,0,240,39,86,0.453,30,52,0.577,9,34,0.265,16,18,0.889,103,45,88,0.511,31,51,0.608,14,37,0.378,19,26,0.731,123
1855,BOS,2018-10-20,103,@,NYK,1,240,33,82,0.402,24,57,0.421,9,25,0.36,28,33,0.848,103,36,87,0.414,24,52,0.462,12,35,0.343,17,27,0.63,101
1856,DET,2018-10-17,103,,BRK,1,240,39,92,0.424,33,68,0.485,6,24,0.25,19,22,0.864,103,40,82,0.488,35,55,0.636,5,27,0.185,15,22,0.682,100
1857,MIA,2019-04-03,102,,BOS,0,240,39,95,0.411,27,59,0.458,12,36,0.333,12,20,0.6,102,38,80,0.475,29,56,0.518,9,24,0.375,27,31,0.871,112
1858,DEN,2019-04-02,102,@,GSW,0,240,36,96,0.375,29,66,0.439,7,30,0.233,23,29,0.793,102,50,92,0.543,37,58,0.638,13,34,0.382,3,8,0.375,116
1859,DET,2019-04-01,102,@,IND,0,240,38,88,0.432,26,55,0.473,12,33,0.364,14,19,0.737,102,42,77,0.545,32,55,0.582,10,22,0.455,17,22,0.773,111
1860,CHO,2019-04-01,102,@,UTA,0,240,36,90,0.4,29,60,0.483,7,30,0.233,23,29,0.793,102,38,79,0.481,23,44,0.523,15,35,0.429,20,26,0.769,111
1861,PHI,2019-04-01,102,@,DAL,0,240,36,93,0.387,30,60,0.5,6,33,0.182,24,32,0.75,102,46,97,0.474,34,65,0.523,12,32,0.375,18,27,0.667,122
1862,NOP,2019-03-31,102,,LAL,0,240,38,83,0.458,30,52,0.577,8,31,0.258,18,21,0.857,102,48,101,0.475,33,63,0.524,15,38,0.395,19,22,0.864,130
1863,MIL,2019-03-20,102,@,CLE,0,240,36,91,0.396,23,59,0.39,13,32,0.406,17,21,0.81,102,39,93,0.419,28,54,0.519,11,39,0.282,18,24,0.75,107
1864,MIN,2019-03-17,102,@,HOU,0,240,38,92,0.413,28,60,0.467,10,32,0.313,16,23,0.696,102,43,94,0.457,22,44,0.5,21,50,0.42,10,14,0.714,117
1865,CHI,2019-03-17,102,@,SAC,0,240,39,88,0.443,29,62,0.468,10,26,0.385,14,21,0.667,102,54,103,0.524,46,80,0.575,8,23,0.348,13,16,0.813,129
1866,DEN,2019-03-16,102,,IND,1,240,39,82,0.476,28,44,0.636,11,38,0.289,13,20,0.65,102,34,75,0.453,28,51,0.549,6,24,0.25,26,37,0.703,100
1867,PHO,2019-03-15,102,@,HOU,0,240,38,89,0.427,31,63,0.492,7,26,0.269,19,25,0.76,102,36,83,0.434,25,43,0.581,11,40,0.275,25,33,0.758,108
1868,SAC,2019-03-09,102,@,NYK,1,240,36,95,0.379,24,59,0.407,12,36,0.333,18,22,0.818,102,35,94,0.372,25,59,0.424,10,35,0.286,14,21,0.667,94
1869,OKC,2019-03-02,102,@,SAS,0,240,40,88,0.455,33,59,0.559,7,29,0.241,15,24,0.625,102,45,91,0.495,37,72,0.514,8,19,0.421,18,25,0.72,116
1870,MIA,2019-02-21,102,@,PHI,0,240,45,94,0.479,39,72,0.542,6,22,0.273,6,12,0.5,102,37,82,0.451,30,56,0.536,7,26,0.269,25,35,0.714,106
1871,DAL,2019-02-10,102,,POR,1,240,36,87,0.414,24,50,0.48,12,37,0.324,18,23,0.783,102,42,86,0.488,33,57,0.579,9,29,0.31,8,14,0.571,101
1872,SAC,2019-02-08,102,,MIA,1,240,37,90,0.411,28,64,0.438,9,26,0.346,19,25,0.76,102,38,88,0.432,27,55,0.491,11,33,0.333,9,19,0.474,96
1873,SAS,2019-02-06,102,@,GSW,0,240,35,81,0.432,23,49,0.469,12,32,0.375,20,21,0.952,102,55,95,0.579,39,61,0.639,16,34,0.471,15,21,0.714,141
1874,ORL,2019-02-02,102,,BRK,1,240,41,94,0.436,31,67,0.463,10,27,0.37,10,12,0.833,102,33,91,0.363,23,53,0.434,10,38,0.263,13,16,0.813,89
1875,MIA,2019-02-01,102,,OKC,0,240,41,92,0.446,30,56,0.536,11,36,0.306,9,14,0.643,102,44,91,0.484,28,61,0.459,16,30,0.533,14,19,0.737,118
1876,PHO,2019-01-27,102,@,LAL,0,240,34,85,0.4,27,59,0.458,7,26,0.269,27,32,0.844,102,47,89,0.528,37,66,0.561,10,23,0.435,12,18,0.667,116
1877,MIN,2019-01-25,102,@,UTA,0,240,38,90,0.422,30,64,0.469,8,26,0.308,18,21,0.857,102,37,94,0.394,24,54,0.444,13,40,0.325,19,25,0.76,106
1878,CLE,2019-01-19,102,@,DEN,0,240,35,72,0.486,25,43,0.581,10,29,0.345,22,26,0.846,102,50,89,0.562,35,52,0.673,15,37,0.405,9,11,0.818,124
1879,BOS,2019-01-14,102,@,BRK,0,240,37,91,0.407,26,55,0.473,11,36,0.306,17,23,0.739,102,37,86,0.43,24,48,0.5,13,38,0.342,22,25,0.88,109
1880,PHO,2019-01-12,102,,DEN,1,240,38,92,0.413,30,66,0.455,8,26,0.308,18,25,0.72,102,34,88,0.386,24,57,0.421,10,31,0.323,15,22,0.682,93
1881,CHI,2019-01-12,102,@,UTA,0,240,40,97,0.412,33,72,0.458,7,25,0.28,15,17,0.882,102,38,88,0.432,22,43,0.512,16,45,0.356,18,25,0.72,110
1882,DET,2019-01-10,102,@,SAC,0,240,35,82,0.427,24,44,0.545,11,38,0.289,21,24,0.875,102,44,86,0.512,35,64,0.547,9,22,0.409,15,20,0.75,112
1883,UTA,2019-01-07,102,@,MIL,0,240,36,86,0.419,22,49,0.449,14,37,0.378,16,23,0.696,102,46,98,0.469,37,73,0.507,9,25,0.36,13,16,0.813,114
1884,MIN,2019-01-02,102,@,BOS,0,240,40,84,0.476,33,61,0.541,7,23,0.304,15,21,0.714,102,45,76,0.592,33,46,0.717,12,30,0.4,13,15,0.867,115
1885,DAL,2018-12-31,102,@,OKC,0,240,31,74,0.419,17,36,0.472,14,38,0.368,26,34,0.765,102,46,103,0.447,40,79,0.506,6,24,0.25,24,35,0.686,122
1886,PHO,2018-12-28,102,,OKC,0,240,39,90,0.433,30,61,0.492,9,29,0.31,15,16,0.938,102,51,95,0.537,44,75,0.587,7,20,0.35,9,13,0.692,118
1887,DEN,2018-12-28,102,,SAS,1,240,39,85,0.459,29,56,0.518,10,29,0.345,14,17,0.824,102,40,89,0.449,32,62,0.516,8,27,0.296,11,20,0.55,99
1888,SAC,2018-12-21,102,,MEM,1,240,33,88,0.375,18,47,0.383,15,41,0.366,21,29,0.724,102,37,80,0.463,21,48,0.438,16,32,0.5,9,10,0.9,99
1889,HOU,2018-12-17,102,,UTA,1,240,32,86,0.372,20,49,0.408,12,37,0.324,26,31,0.839,102,32,82,0.39,22,47,0.468,10,35,0.286,23,31,0.742,97
1890,MIA,2018-12-16,102,@,NOP,1,240,38,91,0.418,28,56,0.5,10,35,0.286,16,23,0.696,102,35,86,0.407,22,50,0.44,13,36,0.361,13,17,0.765,96
1891,CLE,2018-12-14,102,,MIL,0,240,35,87,0.402,22,51,0.431,13,36,0.361,19,21,0.905,102,40,94,0.426,28,53,0.528,12,41,0.293,22,28,0.786,114
1892,DET,2018-12-10,102,@,PHI,0,240,41,84,0.488,32,63,0.508,9,21,0.429,11,21,0.524,102,39,88,0.443,24,51,0.471,15,37,0.405,23,35,0.657,116
1893,PHI,2018-12-05,102,@,TOR,0,240,40,88,0.455,29,53,0.547,11,35,0.314,11,14,0.786,102,43,100,0.43,35,71,0.493,8,29,0.276,19,22,0.864,113
1894,POR,2018-12-04,102,@,DAL,0,240,38,84,0.452,31,60,0.517,7,24,0.292,19,23,0.826,102,38,88,0.432,27,58,0.466,11,30,0.367,24,35,0.686,111
1895,MIA,2018-12-02,102,,UTA,1,240,36,91,0.396,23,60,0.383,13,31,0.419,17,24,0.708,102,39,89,0.438,28,56,0.5,11,33,0.333,11,15,0.733,100
1896,WAS,2018-12-01,102,,BRK,1,240,41,79,0.519,33,53,0.623,8,26,0.308,12,18,0.667,102,30,81,0.37,22,48,0.458,8,33,0.242,20,25,0.8,88
1897,GSW,2018-12-01,102,@,DET,0,240,39,85,0.459,33,59,0.559,6,26,0.231,18,21,0.857,102,43,98,0.439,31,63,0.492,12,35,0.343,13,20,0.65,111
1898,MIN,2018-11-26,102,@,CLE,1,240,40,86,0.465,32,60,0.533,8,26,0.308,14,19,0.737,102,36,86,0.419,26,55,0.473,10,31,0.323,13,14,0.929,95
1899,BRK,2018-11-23,102,,MIN,0,240,33,79,0.418,19,34,0.559,14,45,0.311,22,26,0.846,102,44,92,0.478,35,67,0.522,9,25,0.36,15,17,0.882,112
1900,CLE,2018-11-19,102,@,DET,0,240,35,79,0.443,27,58,0.466,8,21,0.381,24,34,0.706,102,41,89,0.461,28,51,0.549,13,38,0.342,18,19,0.947,113
1901,MIA,2018-11-09,102,,IND,0,240,36,80,0.45,22,53,0.415,14,27,0.519,16,27,0.593,102,43,79,0.544,36,59,0.61,7,20,0.35,17,29,0.586,110
1902,DAL,2018-11-07,102,@,UTA,0,240,29,73,0.397,21,49,0.429,8,24,0.333,36,40,0.9,102,43,89,0.483,30,52,0.577,13,37,0.351,18,26,0.692,117
1903,ATL,2018-11-06,102,@,CHO,0,240,41,85,0.482,35,55,0.636,6,30,0.2,14,18,0.778,102,45,92,0.489,32,61,0.525,13,31,0.419,10,18,0.556,113
1904,ORL,2018-11-05,102,,CLE,1,240,39,87,0.448,28,53,0.528,11,34,0.324,13,15,0.867,102,41,80,0.513,31,57,0.544,10,23,0.435,8,12,0.667,100
1905,PHO,2018-11-04,102,,MEM,1,240,33,64,0.516,19,32,0.594,14,32,0.438,22,26,0.846,102,36,76,0.474,29,53,0.547,7,23,0.304,21,29,0.724,100
1906,IND,2018-11-03,102,,BOS,1,240,36,86,0.419,25,54,0.463,11,32,0.344,19,25,0.76,102,38,88,0.432,19,42,0.452,19,46,0.413,6,9,0.667,101
1907,BRK,2018-10-24,102,@,CLE,1,240,38,87,0.437,24,53,0.453,14,34,0.412,12,15,0.8,102,34,89,0.382,31,71,0.437,3,18,0.167,15,16,0.938,86
1908,LAL,2019-04-09,101,,POR,0,240,40,94,0.426,30,65,0.462,10,29,0.345,11,17,0.647,101,37,90,0.411,26,53,0.491,11,37,0.297,19,22,0.864,104
1909,CHI,2019-03-30,101,,TOR,0,240,41,97,0.423,32,67,0.478,9,30,0.3,10,16,0.625,101,46,89,0.517,28,51,0.549,18,38,0.474,14,18,0.778,124
1910,LAL,2019-03-19,101,@,MIL,0,240,33,86,0.384,17,43,0.395,16,43,0.372,19,23,0.826,101,41,89,0.461,26,42,0.619,15,47,0.319,18,27,0.667,115
1911,PHO,2019-03-18,101,,CHI,0,240,39,84,0.464,32,58,0.552,7,26,0.269,16,26,0.615,101,46,89,0.517,42,73,0.575,4,16,0.25,20,24,0.833,116
1912,ORL,2019-03-17,101,,ATL,1,240,33,85,0.388,24,48,0.5,9,37,0.243,26,33,0.788,101,38,91,0.418,30,56,0.536,8,35,0.229,7,10,0.7,91
1913,TOR,2019-03-11,101,@,CLE,0,240,40,84,0.476,29,45,0.644,11,39,0.282,10,17,0.588,101,44,94,0.468,26,53,0.491,18,41,0.439,20,21,0.952,126
1914,IND,2019-02-27,101,@,DAL,0,240,37,77,0.481,27,49,0.551,10,28,0.357,17,21,0.81,101,40,81,0.494,24,44,0.545,16,37,0.432,14,23,0.609,110
1915,BRK,2019-02-25,101,,SAS,1,240,35,81,0.432,16,31,0.516,19,50,0.38,12,16,0.75,101,35,96,0.365,31,72,0.431,4,24,0.167,11,12,0.917,85
1916,DAL,2019-02-13,101,,MIA,0,240,34,88,0.386,19,36,0.528,15,52,0.288,18,22,0.818,101,44,81,0.543,32,51,0.627,12,30,0.4,12,16,0.75,112
1917,POR,2019-02-10,101,@,DAL,0,240,42,86,0.488,33,57,0.579,9,29,0.31,8,14,0.571,101,36,87,0.414,24,50,0.48,12,37,0.324,18,23,0.783,102
1918,ATL,2019-02-07,101,,TOR,0,240,36,80,0.45,20,45,0.444,16,35,0.457,13,25,0.52,101,40,87,0.46,27,47,0.574,13,40,0.325,26,33,0.788,119
1919,SAC,2019-02-06,101,,HOU,0,240,39,91,0.429,28,58,0.483,11,33,0.333,12,20,0.6,101,45,100,0.45,25,49,0.51,20,51,0.392,17,18,0.944,127
1920,DET,2019-02-02,101,,LAC,0,240,35,83,0.422,18,41,0.439,17,42,0.405,14,20,0.7,101,40,82,0.488,30,62,0.484,10,20,0.5,21,34,0.618,111
1921,LAL,2019-02-02,101,@,GSW,0,240,42,96,0.438,35,69,0.507,7,27,0.259,10,17,0.588,101,43,91,0.473,32,57,0.561,11,34,0.324,18,19,0.947,115
1922,CHO,2019-01-28,101,,NYK,1,240,39,94,0.415,28,60,0.467,11,34,0.324,12,16,0.75,101,34,85,0.4,27,62,0.435,7,23,0.304,17,26,0.654,92
1923,CHI,2019-01-27,101,,CLE,0,240,39,88,0.443,30,62,0.484,9,26,0.346,14,17,0.824,101,39,92,0.424,26,58,0.448,13,34,0.382,13,15,0.867,104
1924,DET,2019-01-25,101,@,DAL,0,240,35,85,0.412,23,47,0.489,12,38,0.316,19,25,0.76,101,37,81,0.457,23,45,0.511,14,36,0.389,18,30,0.6,106
1925,CHI,2019-01-25,101,,LAC,0,240,40,102,0.392,30,67,0.448,10,35,0.286,11,12,0.917,101,38,82,0.463,30,61,0.492,8,21,0.381,22,29,0.759,106
1926,CHI,2019-01-23,101,,ATL,0,240,35,79,0.443,27,53,0.509,8,26,0.308,23,27,0.852,101,45,90,0.5,30,50,0.6,15,40,0.375,16,21,0.762,121
1927,WAS,2019-01-21,101,,DET,1,240,36,79,0.456,28,56,0.5,8,23,0.348,21,27,0.778,101,31,77,0.403,20,43,0.465,11,34,0.324,14,18,0.778,87
1928,DET,2019-01-19,101,,SAC,0,240,36,82,0.439,26,53,0.491,10,29,0.345,19,25,0.76,101,40,89,0.449,30,64,0.469,10,25,0.4,13,18,0.722,103
1929,WAS,2019-01-17,101,,NYK,1,240,40,92,0.435,33,65,0.508,7,27,0.259,14,20,0.7,101,39,87,0.448,27,58,0.466,12,29,0.414,10,12,0.833,100
1930,MEM,2019-01-16,101,,MIL,0,240,37,95,0.389,27,64,0.422,10,31,0.323,17,25,0.68,101,40,84,0.476,28,50,0.56,12,34,0.353,19,22,0.864,111
1931,DAL,2019-01-16,101,,SAS,0,240,37,86,0.43,22,44,0.5,15,42,0.357,12,16,0.75,101,41,83,0.494,28,53,0.528,13,30,0.433,10,12,0.833,105
1932,CLE,2019-01-13,101,@,LAL,1,240,38,89,0.427,30,68,0.441,8,21,0.381,17,23,0.739,101,36,91,0.396,29,57,0.509,7,34,0.206,16,27,0.593,95
1933,ATL,2019-01-08,101,@,TOR,0,240,40,87,0.46,30,60,0.5,10,27,0.37,11,16,0.688,101,37,80,0.463,27,48,0.563,10,32,0.313,20,27,0.741,104
1934,NYK,2019-01-07,101,@,POR,0,240,36,89,0.404,29,66,0.439,7,23,0.304,22,27,0.815,101,40,85,0.471,29,54,0.537,11,31,0.355,20,29,0.69,111
1935,HOU,2019-01-05,101,@,POR,0,240,39,84,0.464,26,46,0.565,13,38,0.342,10,12,0.833,101,43,94,0.457,34,66,0.515,9,28,0.321,15,20,0.75,110
1936,DET,2019-01-02,101,@,MEM,1,240,36,83,0.434,20,43,0.465,16,40,0.4,13,22,0.591,101,36,78,0.462,32,60,0.533,4,18,0.222,18,21,0.857,94
1937,MEM,2018-12-31,101,@,HOU,0,240,38,82,0.463,32,57,0.561,6,25,0.24,19,30,0.633,101,31,70,0.443,13,29,0.448,18,41,0.439,33,45,0.733,113
1938,CHI,2018-12-28,101,@,WAS,1,240,37,79,0.468,29,57,0.509,8,22,0.364,19,25,0.76,101,34,85,0.4,25,55,0.455,9,30,0.3,15,18,0.833,92
1939,GSW,2018-12-25,101,,LAL,0,240,38,93,0.409,29,57,0.509,9,36,0.25,16,21,0.762,101,47,85,0.553,34,52,0.654,13,33,0.394,20,27,0.741,127
1940,TOR,2018-12-22,101,@,PHI,0,240,37,95,0.389,27,55,0.491,10,40,0.25,17,19,0.895,101,46,85,0.541,38,61,0.623,8,24,0.333,26,35,0.743,126
1941,SAS,2018-12-22,101,@,HOU,0,240,42,88,0.477,32,64,0.5,10,24,0.417,7,11,0.636,101,37,95,0.389,18,41,0.439,19,54,0.352,15,21,0.714,108
1942,MIA,2018-12-20,101,,HOU,1,240,36,93,0.387,27,54,0.5,9,39,0.231,20,34,0.588,101,29,82,0.354,11,28,0.393,18,54,0.333,23,30,0.767,99
1943,PHI,2018-12-14,101,,IND,0,240,36,88,0.409,27,52,0.519,9,36,0.25,20,27,0.741,101,42,95,0.442,34,75,0.453,8,20,0.4,21,24,0.875,113
1944,WAS,2018-12-10,101,@,IND,0,240,37,88,0.42,27,58,0.466,10,30,0.333,17,24,0.708,101,41,76,0.539,31,56,0.554,10,20,0.5,17,22,0.773,109
1945,DAL,2018-12-10,101,,ORL,1,240,35,82,0.427,25,47,0.532,10,35,0.286,21,25,0.84,101,32,89,0.36,24,61,0.393,8,28,0.286,4,5,0.8,76
1946,WAS,2018-12-08,101,@,CLE,0,240,38,86,0.442,24,48,0.5,14,38,0.368,11,16,0.688,101,47,89,0.528,32,58,0.552,15,31,0.484,7,10,0.7,116
1947,NOP,2018-11-30,101,@,MIA,0,240,35,82,0.427,29,54,0.537,6,28,0.214,25,29,0.862,101,40,93,0.43,29,60,0.483,11,33,0.333,15,24,0.625,106
1948,UTA,2018-11-28,101,@,BRK,1,240,39,82,0.476,30,54,0.556,9,28,0.321,14,21,0.667,101,30,86,0.349,19,56,0.339,11,30,0.367,20,28,0.714,91
1949,MIN,2018-11-21,101,,DEN,0,240,35,79,0.443,26,47,0.553,9,32,0.281,22,26,0.846,101,42,89,0.472,28,54,0.519,14,35,0.4,5,6,0.833,103
1950,PHO,2018-11-12,101,@,OKC,0,240,39,81,0.481,32,55,0.582,7,26,0.269,16,19,0.842,101,43,92,0.467,30,65,0.462,13,27,0.481,19,20,0.95,118
1951,LAL,2018-11-10,101,@,SAC,1,240,41,99,0.414,29,61,0.475,12,38,0.316,7,17,0.412,101,32,92,0.348,26,67,0.388,6,25,0.24,16,20,0.8,86
1952,MEM,2018-11-05,101,@,GSW,0,240,38,83,0.458,29,56,0.518,9,27,0.333,16,21,0.762,101,41,81,0.506,28,57,0.491,13,24,0.542,22,23,0.957,117
1953,BOS,2018-11-03,101,@,IND,0,240,38,88,0.432,19,42,0.452,19,46,0.413,6,9,0.667,101,36,86,0.419,25,54,0.463,11,32,0.344,19,25,0.76,102
1954,NYK,2018-10-31,101,,IND,0,240,34,79,0.43,22,54,0.407,12,25,0.48,21,24,0.875,101,45,83,0.542,39,63,0.619,6,20,0.3,11,17,0.647,107
1955,BOS,2018-10-25,101,@,OKC,1,240,33,86,0.384,22,54,0.407,11,32,0.344,24,33,0.727,101,37,94,0.394,30,66,0.455,7,28,0.25,14,25,0.56,95
1956,MIN,2018-10-22,101,,IND,1,240,36,85,0.424,29,52,0.558,7,33,0.212,22,24,0.917,101,36,92,0.391,28,66,0.424,8,26,0.308,11,16,0.688,91
1957,NYK,2018-10-20,101,,BOS,0,240,36,87,0.414,24,52,0.462,12,35,0.343,17,27,0.63,101,33,82,0.402,24,57,0.421,9,25,0.36,28,33,0.848,103
1958,IND,2018-10-19,101,@,MIL,0,240,38,87,0.437,32,69,0.464,6,18,0.333,19,27,0.704,101,44,93,0.473,27,47,0.574,17,46,0.37,13,21,0.619,118
1959,BOS,2018-10-19,101,@,TOR,0,240,40,99,0.404,26,63,0.413,14,36,0.389,7,10,0.7,101,43,92,0.467,30,57,0.526,13,35,0.371,14,19,0.737,113
1960,MIA,2018-10-17,101,@,ORL,0,240,38,97,0.392,29,64,0.453,9,33,0.273,16,22,0.727,101,39,94,0.415,32,69,0.464,7,25,0.28,19,31,0.613,104
1961,MIN,2019-04-09,100,,TOR,0,240,38,91,0.418,25,49,0.51,13,42,0.31,11,14,0.786,100,46,88,0.523,30,51,0.588,16,37,0.432,12,17,0.706,120
1962,DET,2019-04-09,100,,MEM,1,240,35,88,0.398,25,54,0.463,10,34,0.294,20,28,0.714,100,33,69,0.478,23,45,0.511,10,24,0.417,17,21,0.81,93
1963,NYK,2019-04-03,100,@,ORL,0,240,38,85,0.447,32,58,0.552,6,27,0.222,18,21,0.857,100,45,99,0.455,34,67,0.507,11,32,0.344,13,20,0.65,114
1964,MIA,2019-03-30,100,@,NYK,1,240,39,90,0.433,30,58,0.517,9,32,0.281,13,17,0.765,100,31,77,0.403,22,39,0.564,9,38,0.237,21,25,0.84,92
1965,LAL,2019-03-27,100,@,UTA,0,240,37,97,0.381,28,70,0.4,9,27,0.333,17,24,0.708,100,41,83,0.494,31,51,0.608,10,32,0.313,23,36,0.639,115
1966,DAL,2019-03-21,100,@,SAC,0,240,36,92,0.391,24,52,0.462,12,40,0.3,16,23,0.696,100,41,87,0.471,28,52,0.538,13,35,0.371,21,28,0.75,116
1967,IND,2019-03-16,100,@,DEN,0,240,34,75,0.453,28,51,0.549,6,24,0.25,26,37,0.703,100,39,82,0.476,28,44,0.636,11,38,0.289,13,20,0.65,102
1968,MIN,2019-03-14,100,@,UTA,0,240,42,91,0.462,37,67,0.552,5,24,0.208,11,15,0.733,100,44,89,0.494,31,51,0.608,13,38,0.342,19,27,0.704,120
1969,DEN,2019-03-14,100,,DAL,1,240,39,81,0.481,31,52,0.596,8,29,0.276,14,17,0.824,100,37,87,0.425,25,50,0.5,12,37,0.324,13,17,0.765,99
1970,WAS,2019-03-13,100,,ORL,1,240,42,90,0.467,34,63,0.54,8,27,0.296,8,12,0.667,100,35,90,0.389,23,57,0.404,12,33,0.364,8,9,0.889,90
1971,CHO,2019-02-01,100,,MEM,1,240,32,73,0.438,20,44,0.455,12,29,0.414,24,28,0.857,100,35,80,0.438,26,51,0.51,9,29,0.31,13,17,0.765,92
1972,IND,2019-01-31,100,@,ORL,0,240,41,91,0.451,37,72,0.514,4,19,0.211,14,16,0.875,100,38,82,0.463,27,57,0.474,11,25,0.44,20,22,0.909,107
1973,IND,2019-01-28,100,,GSW,0,240,40,94,0.426,28,64,0.438,12,30,0.4,8,10,0.8,100,53,98,0.541,40,67,0.597,13,31,0.419,13,16,0.813,132
1974,MIA,2019-01-25,100,@,CLE,1,240,37,79,0.468,28,56,0.5,9,23,0.391,17,25,0.68,100,37,85,0.435,27,55,0.491,10,30,0.333,10,13,0.769,94
1975,NYK,2019-01-17,100,@,WAS,0,240,39,87,0.448,27,58,0.466,12,29,0.414,10,12,0.833,100,40,92,0.435,33,65,0.508,7,27,0.259,14,20,0.7,101
1976,CHI,2019-01-15,100,@,LAL,0,240,37,92,0.402,28,61,0.459,9,31,0.29,17,24,0.708,100,38,82,0.463,30,56,0.536,8,26,0.308,23,34,0.676,107
1977,UTA,2019-01-14,100,,DET,1,240,31,80,0.388,19,43,0.442,12,37,0.324,26,36,0.722,100,35,90,0.389,24,54,0.444,11,36,0.306,13,16,0.813,94
1978,LAC,2019-01-10,100,@,DEN,0,240,38,87,0.437,32,63,0.508,6,24,0.25,18,26,0.692,100,50,99,0.505,39,71,0.549,11,28,0.393,10,13,0.769,121
1979,DET,2019-01-09,100,@,LAL,0,240,39,86,0.453,25,42,0.595,14,44,0.318,8,14,0.571,100,46,82,0.561,38,59,0.644,8,23,0.348,13,18,0.722,113
1980,ATL,2019-01-09,100,@,BRK,0,240,36,99,0.364,30,64,0.469,6,35,0.171,22,25,0.88,100,43,95,0.453,33,65,0.508,10,30,0.333,20,26,0.769,116
1981,CHI,2019-01-06,100,,BRK,0,240,41,88,0.466,34,70,0.486,7,18,0.389,11,15,0.733,100,42,83,0.506,26,37,0.703,16,46,0.348,17,22,0.773,117
1982,DAL,2019-01-05,100,@,PHI,0,240,38,88,0.432,29,57,0.509,9,31,0.29,15,23,0.652,100,39,83,0.47,33,57,0.579,6,26,0.231,22,33,0.667,106
1983,MEM,2019-01-04,100,,BRK,0,240,42,93,0.452,37,69,0.536,5,24,0.208,11,15,0.733,100,36,79,0.456,23,45,0.511,13,34,0.382,24,26,0.923,109
1984,LAL,2019-01-02,100,,OKC,0,240,37,89,0.416,30,62,0.484,7,27,0.259,19,32,0.594,100,40,105,0.381,33,74,0.446,7,31,0.226,20,31,0.645,107
1985,ORL,2018-12-31,100,@,CHO,0,240,38,92,0.413,28,57,0.491,10,35,0.286,14,19,0.737,100,42,85,0.494,31,61,0.508,11,24,0.458,30,33,0.909,125
1986,CHO,2018-12-28,100,,BRK,1,240,41,100,0.41,30,67,0.448,11,33,0.333,7,10,0.7,100,33,83,0.398,29,56,0.518,4,27,0.148,17,20,0.85,87
1987,CHO,2018-12-15,100,,LAL,0,240,39,92,0.424,32,63,0.508,7,29,0.241,15,18,0.833,100,49,92,0.533,35,58,0.603,14,34,0.412,16,24,0.667,128
1988,MIA,2018-12-14,100,@,MEM,1,240,36,82,0.439,21,43,0.488,15,39,0.385,13,18,0.722,100,35,83,0.422,27,54,0.5,8,29,0.276,19,25,0.76,97
1989,NOP,2018-12-10,100,@,BOS,0,240,39,87,0.448,31,61,0.508,8,26,0.308,14,19,0.737,100,44,90,0.489,32,51,0.627,12,39,0.308,13,19,0.684,113
1990,NYK,2018-12-06,100,@,BOS,0,240,36,91,0.396,24,56,0.429,12,35,0.343,16,20,0.8,100,49,92,0.533,36,54,0.667,13,38,0.342,17,20,0.85,128
1991,UTA,2018-12-02,100,@,MIA,0,240,39,89,0.438,28,56,0.5,11,33,0.333,11,15,0.733,100,36,91,0.396,23,60,0.383,13,31,0.419,17,24,0.708,102
1992,OKC,2018-11-28,100,,CLE,1,240,41,86,0.477,35,59,0.593,6,27,0.222,12,15,0.8,100,35,89,0.393,26,66,0.394,9,23,0.391,4,9,0.444,83
1993,POR,2018-11-25,100,,LAC,0,240,42,97,0.433,34,59,0.576,8,38,0.211,8,10,0.8,100,38,90,0.422,33,65,0.508,5,25,0.2,23,34,0.676,104
1994,IND,2018-11-23,100,,SAS,0,240,46,99,0.465,43,75,0.573,3,24,0.125,5,9,0.556,100,42,83,0.506,32,62,0.516,10,21,0.476,17,24,0.708,111
1995,POR,2018-11-21,100,@,MIL,0,240,34,93,0.366,25,52,0.481,9,41,0.22,23,28,0.821,100,57,108,0.528,42,63,0.667,15,45,0.333,14,17,0.824,143
1996,MEM,2018-11-18,100,@,MIN,1,240,35,82,0.427,23,54,0.426,12,28,0.429,18,25,0.72,100,31,80,0.388,19,51,0.373,12,29,0.414,13,16,0.813,87
1997,PHO,2018-11-17,100,,OKC,0,240,37,82,0.451,25,53,0.472,12,29,0.414,14,21,0.667,100,38,85,0.447,31,61,0.508,7,24,0.292,27,32,0.844,110
1998,NOP,2018-11-14,100,@,MIN,0,240,40,94,0.426,31,66,0.47,9,28,0.321,11,18,0.611,100,37,90,0.411,23,58,0.397,14,32,0.438,19,24,0.792,107
1999,POR,2018-11-11,100,,BOS,1,240,39,86,0.453,25,50,0.5,14,36,0.389,8,10,0.8,100,36,93,0.387,22,51,0.431,14,42,0.333,8,10,0.8,94
2000,BRK,2018-11-10,100,@,GSW,0,240,36,77,0.468,29,53,0.547,7,24,0.292,21,29,0.724,100,46,83,0.554,39,67,0.582,7,16,0.438,17,21,0.81,116
2001,PHI,2018-11-07,100,@,IND,1,240,36,79,0.456,26,47,0.553,10,32,0.313,18,22,0.818,100,37,94,0.394,29,63,0.46,8,31,0.258,12,17,0.706,94
2002,WAS,2018-11-06,100,@,DAL,0,240,37,87,0.425,26,52,0.5,11,35,0.314,15,20,0.75,100,39,82,0.476,24,48,0.5,15,34,0.441,26,27,0.963,119
2003,CLE,2018-11-05,100,@,ORL,0,240,41,80,0.513,31,57,0.544,10,23,0.435,8,12,0.667,100,39,87,0.448,28,53,0.528,11,34,0.324,13,15,0.867,102
2004,MEM,2018-11-04,100,@,PHO,0,240,36,76,0.474,29,53,0.547,7,23,0.304,21,29,0.724,100,33,64,0.516,19,32,0.594,14,32,0.438,22,26,0.846,102
2005,UTA,2018-11-02,100,,MEM,0,240,36,77,0.468,22,41,0.537,14,36,0.389,14,25,0.56,100,38,75,0.507,25,49,0.51,13,26,0.5,21,34,0.618,110
2006,NYK,2018-10-26,100,,GSW,0,240,39,90,0.433,26,51,0.51,13,39,0.333,9,12,0.75,100,51,87,0.586,35,54,0.648,16,33,0.485,10,12,0.833,128
2007,UTA,2018-10-24,100,@,HOU,1,240,34,78,0.436,24,49,0.49,10,29,0.345,22,28,0.786,100,35,87,0.402,24,47,0.511,11,40,0.275,8,14,0.571,89
2008,DEN,2018-10-21,100,,GSW,1,240,35,86,0.407,29,54,0.537,6,32,0.188,24,42,0.571,100,36,79,0.456,29,50,0.58,7,29,0.241,19,24,0.792,98
2009,BRK,2018-10-17,100,@,DET,0,240,40,82,0.488,35,55,0.636,5,27,0.185,15,22,0.682,100,39,92,0.424,33,68,0.485,6,24,0.25,19,22,0.864,103
2010,DAL,2018-10-17,100,@,PHO,0,240,38,88,0.432,28,55,0.509,10,33,0.303,14,20,0.7,100,44,81,0.543,25,47,0.532,19,34,0.559,14,16,0.875,121
2011,OKC,2018-10-16,100,@,GSW,0,240,33,91,0.363,23,54,0.426,10,37,0.27,24,37,0.649,100,42,95,0.442,35,69,0.507,7,26,0.269,17,18,0.944,108
2012,DEN,2019-04-10,99,,MIN,1,240,39,87,0.448,29,54,0.537,10,33,0.303,11,17,0.647,99,39,91,0.429,26,59,0.441,13,32,0.406,4,6,0.667,95
2013,PHI,2019-04-09,99,@,MIA,0,240,40,98,0.408,35,73,0.479,5,25,0.2,14,16,0.875,99,46,87,0.529,33,60,0.55,13,27,0.481,17,23,0.739,122
2014,DET,2019-03-30,99,,POR,1,240,37,86,0.43,32,61,0.525,5,25,0.2,20,26,0.769,99,38,102,0.373,34,81,0.42,4,21,0.19,10,11,0.909,90
2015,DAL,2019-03-28,99,@,MIA,0,240,36,92,0.391,20,45,0.444,16,47,0.34,11,17,0.647,99,39,89,0.438,32,59,0.542,7,30,0.233,20,27,0.741,105
2016,IND,2019-03-27,99,@,OKC,0,240,40,92,0.435,27,61,0.443,13,31,0.419,6,11,0.545,99,41,92,0.446,28,56,0.5,13,36,0.361,12,19,0.632,107
2017,MIA,2019-03-26,99,,ORL,0,240,36,86,0.419,26,53,0.491,10,33,0.303,17,21,0.81,99,37,89,0.416,23,47,0.489,14,42,0.333,16,23,0.696,104
2018,MEM,2019-03-23,99,,MIN,0,240,36,96,0.375,26,63,0.413,10,33,0.303,17,22,0.773,99,40,83,0.482,28,57,0.491,12,26,0.462,20,21,0.952,112
2019,DAL,2019-03-14,99,@,DEN,0,240,37,87,0.425,25,50,0.5,12,37,0.324,13,17,0.765,99,39,81,0.481,31,52,0.596,8,29,0.276,14,17,0.824,100
2020,CLE,2019-03-12,99,@,PHI,0,240,40,101,0.396,27,63,0.429,13,38,0.342,6,8,0.75,99,42,85,0.494,34,62,0.548,8,23,0.348,14,17,0.824,106
2021,LAL,2019-03-06,99,,DEN,0,240,40,84,0.476,33,53,0.623,7,31,0.226,12,23,0.522,99,45,98,0.459,32,56,0.571,13,42,0.31,12,17,0.706,115
2022,OKC,2019-03-03,99,,MEM,1,240,33,93,0.355,24,63,0.381,9,30,0.3,24,33,0.727,99,35,79,0.443,28,57,0.491,7,22,0.318,18,19,0.947,95
2023,BRK,2019-02-21,99,,POR,0,240,36,92,0.391,29,56,0.518,7,36,0.194,20,26,0.769,99,46,105,0.438,39,73,0.534,7,32,0.219,14,16,0.875,113
2024,CHI,2019-02-11,99,,MIL,0,240,37,96,0.385,28,68,0.412,9,28,0.321,16,18,0.889,99,38,80,0.475,26,42,0.619,12,38,0.316,24,29,0.828,112
2025,IND,2019-02-11,99,,CHO,1,240,38,74,0.514,30,49,0.612,8,25,0.32,15,17,0.882,99,29,90,0.322,22,50,0.44,7,40,0.175,25,33,0.758,90
2026,MEM,2019-02-09,99,,NOP,1,240,38,88,0.432,30,59,0.508,8,29,0.276,15,18,0.833,99,34,86,0.395,28,53,0.528,6,33,0.182,16,27,0.593,90
2027,NYK,2019-02-09,99,,TOR,0,240,39,94,0.415,29,69,0.42,10,25,0.4,11,19,0.579,99,33,86,0.384,19,51,0.373,14,35,0.4,24,29,0.828,104
2028,DAL,2019-02-06,99,,CHO,1,240,38,94,0.404,27,58,0.466,11,36,0.306,12,17,0.706,99,36,89,0.404,27,52,0.519,9,37,0.243,12,17,0.706,93
2029,NYK,2019-02-01,99,,BOS,0,240,39,86,0.453,30,55,0.545,9,31,0.29,12,12,1.0,99,46,100,0.46,33,63,0.524,13,37,0.351,8,10,0.8,113
2030,NOP,2019-01-30,99,,DEN,0,240,37,89,0.416,22,53,0.415,15,36,0.417,10,13,0.769,99,42,89,0.472,33,59,0.559,9,30,0.3,12,19,0.632,105
2031,MIN,2019-01-30,99,,MEM,1,265,37,95,0.389,29,60,0.483,8,35,0.229,17,22,0.773,99,36,87,0.414,30,64,0.469,6,23,0.261,19,22,0.864,97
2032,SAC,2019-01-25,99,@,MEM,1,240,37,91,0.407,25,58,0.431,12,33,0.364,13,17,0.765,99,34,80,0.425,28,60,0.467,6,20,0.3,22,27,0.815,96
2033,NYK,2019-01-25,99,@,BRK,0,240,37,87,0.425,29,56,0.518,8,31,0.258,17,26,0.654,99,34,84,0.405,25,51,0.49,9,33,0.273,32,47,0.681,109
2034,CHO,2019-01-25,99,@,MIL,0,240,36,90,0.4,26,51,0.51,10,39,0.256,17,25,0.68,99,41,89,0.461,35,58,0.603,6,31,0.194,20,23,0.87,108
2035,MIA,2019-01-23,99,,LAC,0,240,39,83,0.47,31,55,0.564,8,28,0.286,13,22,0.591,99,45,85,0.529,38,63,0.603,7,22,0.318,14,21,0.667,111
2036,MIA,2019-01-21,99,@,BOS,0,240,36,86,0.419,25,51,0.49,11,35,0.314,16,18,0.889,99,43,87,0.494,31,57,0.544,12,30,0.4,9,10,0.9,107
2037,DAL,2019-01-19,99,@,IND,0,240,37,88,0.42,28,51,0.549,9,37,0.243,16,20,0.8,99,42,85,0.494,34,61,0.557,8,24,0.333,19,24,0.792,111
2038,CLE,2019-01-18,99,@,UTA,0,240,36,87,0.414,29,63,0.46,7,24,0.292,20,26,0.769,99,44,85,0.518,31,48,0.646,13,37,0.351,14,15,0.933,115
2039,BOS,2019-01-10,99,@,MIA,0,240,36,89,0.404,24,55,0.436,12,34,0.353,15,17,0.882,99,46,96,0.479,28,57,0.491,18,39,0.462,5,8,0.625,115
2040,MIA,2019-01-08,99,,DEN,0,240,38,83,0.458,30,52,0.577,8,31,0.258,15,25,0.6,99,41,87,0.471,32,60,0.533,9,27,0.333,12,17,0.706,103
2041,SAS,2018-12-28,99,@,DEN,0,240,40,89,0.449,32,62,0.516,8,27,0.296,11,20,0.55,99,39,85,0.459,29,56,0.518,10,29,0.345,14,17,0.824,102
2042,LAL,2018-12-23,99,,MEM,0,240,37,75,0.493,27,45,0.6,10,30,0.333,15,22,0.682,99,42,90,0.467,28,64,0.438,14,26,0.538,9,14,0.643,107
2043,MEM,2018-12-21,99,@,SAC,0,240,37,80,0.463,21,48,0.438,16,32,0.5,9,10,0.9,99,33,88,0.375,18,47,0.383,15,41,0.366,21,29,0.724,102
2044,HOU,2018-12-20,99,@,MIA,0,240,29,82,0.354,11,28,0.393,18,54,0.333,23,30,0.767,99,36,93,0.387,27,54,0.5,9,39,0.231,20,34,0.588,101
2045,CLE,2018-12-19,99,@,CHO,0,240,41,85,0.482,31,62,0.5,10,23,0.435,7,12,0.583,99,47,92,0.511,37,67,0.552,10,25,0.4,6,9,0.667,110
2046,POR,2018-12-19,99,,MEM,1,240,35,75,0.467,24,49,0.49,11,26,0.423,18,20,0.9,99,33,78,0.423,24,51,0.471,9,27,0.333,17,19,0.895,92
2047,TOR,2018-12-19,99,,IND,1,240,38,93,0.409,31,63,0.492,7,30,0.233,16,21,0.762,99,38,80,0.475,29,60,0.483,9,20,0.45,11,16,0.688,96
2048,NYK,2018-12-16,99,@,IND,0,240,37,89,0.416,27,57,0.474,10,32,0.313,15,22,0.682,99,40,87,0.46,28,53,0.528,12,34,0.353,18,23,0.783,110
2049,MIN,2018-12-15,99,@,PHO,0,240,39,96,0.406,32,61,0.525,7,35,0.2,14,19,0.737,99,41,90,0.456,32,62,0.516,9,28,0.321,16,20,0.8,107
2050,PHO,2018-12-13,99,,DAL,1,240,37,92,0.402,27,65,0.415,10,27,0.37,15,18,0.833,99,31,78,0.397,26,45,0.578,5,33,0.152,22,33,0.667,89
2051,LAC,2018-12-11,99,,TOR,0,240,38,86,0.442,31,61,0.508,7,25,0.28,16,19,0.842,99,50,96,0.521,36,67,0.537,14,29,0.483,9,12,0.75,123
2052,MEM,2018-12-10,99,@,DEN,0,240,37,74,0.5,28,47,0.596,9,27,0.333,16,17,0.941,99,39,77,0.506,30,49,0.612,9,28,0.321,18,23,0.783,105
2053,TOR,2018-12-09,99,,MIL,0,240,39,94,0.415,24,50,0.48,15,44,0.341,6,7,0.857,99,36,87,0.414,21,48,0.438,15,39,0.385,17,20,0.85,104
2054,CLE,2018-12-03,99,@,BRK,1,240,38,88,0.432,34,73,0.466,4,15,0.267,19,20,0.95,99,39,99,0.394,29,59,0.492,10,40,0.25,9,16,0.563,97
2055,ORL,2018-11-30,99,@,PHO,1,240,39,82,0.476,31,55,0.564,8,27,0.296,13,18,0.722,99,34,84,0.405,27,56,0.482,7,28,0.25,10,14,0.714,85
2056,PHO,2018-11-28,99,@,LAC,0,240,39,89,0.438,31,63,0.492,8,26,0.308,13,18,0.722,99,40,86,0.465,29,65,0.446,11,21,0.524,24,32,0.75,115
2057,IND,2018-11-16,99,,MIA,1,240,36,81,0.444,22,54,0.407,14,27,0.519,13,15,0.867,99,35,93,0.376,21,57,0.368,14,36,0.389,7,10,0.7,91
2058,DEN,2018-11-13,99,,HOU,0,240,38,76,0.5,27,51,0.529,11,25,0.44,12,16,0.75,99,39,71,0.549,26,34,0.765,13,37,0.351,18,26,0.692,109
2059,SAS,2018-11-12,99,@,SAC,0,240,38,87,0.437,28,56,0.5,10,31,0.323,13,16,0.813,99,43,86,0.5,32,62,0.516,11,24,0.458,7,12,0.583,104
2060,CHI,2018-11-10,99,,CLE,1,240,39,82,0.476,32,64,0.5,7,18,0.389,14,21,0.667,99,39,91,0.429,31,70,0.443,8,21,0.381,12,18,0.667,98
2061,PHO,2018-11-10,99,@,NOP,0,240,35,86,0.407,25,50,0.5,10,36,0.278,19,20,0.95,99,42,86,0.488,31,61,0.508,11,25,0.44,24,29,0.828,119
2062,DET,2018-11-03,99,@,PHI,0,240,33,83,0.398,28,53,0.528,5,30,0.167,28,41,0.683,99,28,69,0.406,19,40,0.475,9,29,0.31,44,51,0.863,109
2063,MIN,2018-11-02,99,@,GSW,0,240,38,101,0.376,25,56,0.446,13,45,0.289,10,14,0.714,99,43,88,0.489,30,54,0.556,13,34,0.382,17,22,0.773,116
2064,ORL,2018-10-30,99,,SAC,0,240,36,91,0.396,25,48,0.521,11,43,0.256,16,22,0.727,99,41,84,0.488,33,62,0.532,8,22,0.364,17,26,0.654,107
2065,SAC,2019-04-05,98,@,UTA,0,240,38,92,0.413,33,71,0.465,5,21,0.238,17,25,0.68,98,44,85,0.518,29,52,0.558,15,33,0.455,16,25,0.64,119
2066,ATL,2019-03-29,98,,POR,0,240,38,94,0.404,29,56,0.518,9,38,0.237,13,14,0.929,98,45,96,0.469,36,64,0.563,9,32,0.281,19,22,0.864,118
2067,ORL,2019-03-28,98,@,DET,0,240,37,94,0.394,29,63,0.46,8,31,0.258,16,20,0.8,98,46,86,0.535,29,51,0.569,17,35,0.486,6,12,0.5,115
2068,CHI,2019-03-27,98,,POR,0,240,39,91,0.429,34,68,0.5,5,23,0.217,15,19,0.789,98,43,83,0.518,32,51,0.627,11,32,0.344,21,25,0.84,118
2069,PHI,2019-03-25,98,@,ORL,0,240,36,73,0.493,30,50,0.6,6,23,0.261,20,26,0.769,98,45,87,0.517,34,58,0.586,11,29,0.379,18,23,0.783,119
2070,PHO,2019-03-21,98,,DET,0,240,35,73,0.479,28,47,0.596,7,26,0.269,21,26,0.808,98,38,90,0.422,21,48,0.438,17,42,0.405,25,34,0.735,118
2071,IND,2019-03-18,98,@,POR,0,240,35,83,0.422,25,59,0.424,10,24,0.417,18,22,0.818,98,37,79,0.468,24,47,0.511,13,32,0.406,19,21,0.905,106
2072,BRK,2019-03-16,98,@,UTA,0,240,33,95,0.347,21,59,0.356,12,36,0.333,20,22,0.909,98,39,91,0.429,26,55,0.473,13,36,0.361,23,31,0.742,114
2073,MIA,2019-03-15,98,,MIL,0,240,38,93,0.409,30,71,0.423,8,22,0.364,14,25,0.56,98,42,88,0.477,30,55,0.545,12,33,0.364,17,24,0.708,113
2074,LAL,2019-03-14,98,@,TOR,0,240,38,85,0.447,31,54,0.574,7,31,0.226,15,24,0.625,98,36,91,0.396,20,50,0.4,16,41,0.39,23,29,0.793,111
2075,NYK,2019-03-12,98,@,IND,0,240,35,80,0.438,22,52,0.423,13,28,0.464,15,18,0.833,98,37,85,0.435,29,57,0.509,8,28,0.286,21,29,0.724,103
2076,OKC,2019-03-11,98,@,UTA,1,240,36,79,0.456,29,57,0.509,7,22,0.318,19,27,0.704,98,32,88,0.364,19,45,0.422,13,43,0.302,12,17,0.706,89
2077,IND,2019-03-07,98,@,MIL,0,240,35,90,0.389,21,53,0.396,14,37,0.378,14,20,0.7,98,43,86,0.5,29,51,0.569,14,35,0.4,17,21,0.81,117
2078,TOR,2019-02-24,98,,ORL,0,240,38,91,0.418,27,63,0.429,11,28,0.393,11,14,0.786,98,42,91,0.462,28,55,0.509,14,36,0.389,15,20,0.75,113
2079,MIL,2019-02-21,98,,BOS,1,240,37,88,0.42,23,49,0.469,14,39,0.359,10,14,0.714,98,39,102,0.382,25,62,0.403,14,40,0.35,5,6,0.833,97
2080,PHO,2019-02-21,98,@,CLE,0,240,35,84,0.417,25,52,0.481,10,32,0.313,18,25,0.72,98,42,85,0.494,29,49,0.592,13,36,0.361,14,20,0.7,111
2081,CLE,2019-02-02,98,,DAL,0,240,34,85,0.4,30,62,0.484,4,23,0.174,26,33,0.788,98,40,84,0.476,24,45,0.533,16,39,0.41,15,19,0.789,111
2082,UTA,2019-02-02,98,,HOU,0,240,31,86,0.36,20,45,0.444,11,41,0.268,25,36,0.694,98,40,87,0.46,25,48,0.521,15,39,0.385,30,37,0.811,125
2083,ORL,2019-01-27,98,@,HOU,0,240,39,97,0.402,29,62,0.468,10,35,0.286,10,17,0.588,98,38,80,0.475,26,44,0.591,12,36,0.333,15,21,0.714,103
2084,DET,2019-01-23,98,@,NOP,1,240,36,89,0.404,23,50,0.46,13,39,0.333,13,19,0.684,98,42,91,0.462,36,69,0.522,6,22,0.273,4,9,0.444,94
2085,LAC,2019-01-22,98,@,DAL,0,240,33,91,0.363,23,55,0.418,10,36,0.278,22,29,0.759,98,38,81,0.469,28,47,0.596,10,34,0.294,20,29,0.69,106
2086,DET,2019-01-18,98,,MIA,1,240,35,82,0.427,22,49,0.449,13,33,0.394,15,18,0.833,98,39,77,0.506,29,48,0.604,10,29,0.345,5,19,0.263,93
2087,OKC,2019-01-06,98,,WAS,0,240,38,88,0.432,28,63,0.444,10,25,0.4,12,19,0.632,98,44,101,0.436,34,64,0.531,10,37,0.27,18,22,0.818,116
2088,CLE,2019-01-05,98,,NOP,0,240,36,88,0.409,24,55,0.436,12,33,0.364,14,18,0.778,98,47,81,0.58,33,54,0.611,14,27,0.519,25,29,0.862,133
2089,ATL,2019-01-02,98,@,WAS,0,240,40,95,0.421,30,64,0.469,10,31,0.323,8,13,0.615,98,43,92,0.467,32,63,0.508,11,29,0.379,17,23,0.739,114
2090,DET,2019-01-01,98,@,MIL,0,240,35,92,0.38,23,59,0.39,12,33,0.364,16,21,0.762,98,47,79,0.595,37,52,0.712,10,27,0.37,17,26,0.654,121
2091,ATL,2018-12-23,98,@,DET,1,240,36,91,0.396,30,68,0.441,6,23,0.261,20,25,0.8,98,34,83,0.41,24,54,0.444,10,29,0.345,17,27,0.63,95
2092,MIN,2018-12-21,98,@,SAS,0,240,33,83,0.398,27,62,0.435,6,21,0.286,26,31,0.839,98,46,87,0.529,27,54,0.5,19,33,0.576,13,18,0.722,124
2093,CHO,2018-12-21,98,,DET,1,240,33,75,0.44,21,51,0.412,12,24,0.5,20,28,0.714,98,32,82,0.39,24,48,0.5,8,34,0.235,14,22,0.636,86
2094,CHI,2018-12-15,98,@,SAS,1,240,37,86,0.43,31,57,0.544,6,29,0.207,18,21,0.857,98,32,73,0.438,25,52,0.481,7,21,0.333,22,26,0.846,93
2095,OKC,2018-12-14,98,@,DEN,0,240,37,90,0.411,30,71,0.423,7,19,0.368,17,29,0.586,98,42,83,0.506,31,49,0.633,11,34,0.324,14,15,0.933,109
2096,LAC,2018-12-08,98,,MIA,0,240,33,89,0.371,26,60,0.433,7,29,0.241,25,31,0.806,98,40,92,0.435,27,53,0.509,13,39,0.333,28,39,0.718,121
2097,DEN,2018-12-08,98,@,ATL,0,240,36,97,0.371,27,61,0.443,9,36,0.25,17,21,0.81,98,40,93,0.43,25,51,0.49,15,42,0.357,11,16,0.688,106
2098,PHO,2018-12-07,98,,MIA,0,240,36,79,0.456,22,45,0.489,14,34,0.412,12,16,0.75,98,42,86,0.488,27,49,0.551,15,37,0.405,16,18,0.889,115
2099,WAS,2018-11-30,98,@,PHI,0,240,37,92,0.402,29,64,0.453,8,28,0.286,16,19,0.842,98,43,98,0.439,31,60,0.517,12,38,0.316,25,33,0.758,123
2100,MEM,2018-11-25,98,,NYK,0,240,38,86,0.442,27,56,0.482,11,30,0.367,11,19,0.579,98,34,91,0.374,26,69,0.377,8,22,0.364,27,32,0.844,103
2101,OKC,2018-11-24,98,,DEN,0,240,37,103,0.359,28,64,0.438,9,39,0.231,15,23,0.652,98,39,95,0.411,29,65,0.446,10,30,0.333,17,24,0.708,105
2102,MEM,2018-11-19,98,,DAL,1,240,37,79,0.468,25,49,0.51,12,30,0.4,12,14,0.857,98,30,88,0.341,20,56,0.357,10,32,0.313,18,21,0.857,88
2103,DEN,2018-11-19,98,@,MIL,0,240,40,94,0.426,28,53,0.528,12,41,0.293,6,9,0.667,98,40,88,0.455,29,52,0.558,11,36,0.306,13,22,0.591,104
2104,UTA,2018-11-17,98,@,BOS,1,240,35,78,0.449,24,40,0.6,11,38,0.289,17,27,0.63,98,35,91,0.385,30,58,0.517,5,33,0.152,11,20,0.55,86
2105,CHI,2018-11-12,98,,DAL,0,240,35,89,0.393,27,56,0.482,8,33,0.242,20,22,0.909,98,37,79,0.468,27,46,0.587,10,33,0.303,19,29,0.655,103
2106,CLE,2018-11-10,98,@,CHI,0,240,39,91,0.429,31,70,0.443,8,21,0.381,12,18,0.667,98,39,82,0.476,32,64,0.5,7,18,0.389,14,21,0.667,99
2107,OKC,2018-11-08,98,,HOU,1,240,36,81,0.444,27,44,0.614,9,37,0.243,17,24,0.708,98,31,82,0.378,20,40,0.5,11,42,0.262,7,10,0.7,80
2108,CHI,2018-11-07,98,@,NOP,0,240,38,96,0.396,29,65,0.446,9,31,0.29,13,17,0.765,98,42,94,0.447,31,64,0.484,11,30,0.367,12,17,0.706,107
2109,HOU,2018-11-05,98,@,IND,1,240,34,76,0.447,19,29,0.655,15,47,0.319,15,16,0.938,98,33,75,0.44,25,47,0.532,8,28,0.286,20,30,0.667,94
2110,PHO,2018-11-02,98,,TOR,0,240,40,91,0.44,32,65,0.492,8,26,0.308,10,18,0.556,98,41,81,0.506,29,48,0.604,12,33,0.364,13,21,0.619,107
2111,GSW,2018-10-21,98,@,DEN,0,240,36,79,0.456,29,50,0.58,7,29,0.241,19,24,0.792,98,35,86,0.407,29,54,0.537,6,32,0.188,24,42,0.571,100
2112,LAC,2018-10-17,98,,DEN,0,240,35,88,0.398,27,60,0.45,8,28,0.286,20,24,0.833,98,33,87,0.379,25,63,0.397,8,24,0.333,33,42,0.786,107
2113,CLE,2019-04-09,97,,CHO,0,240,40,89,0.449,29,59,0.492,11,30,0.367,6,8,0.75,97,45,78,0.577,23,34,0.676,22,44,0.5,12,17,0.706,124
2114,IND,2019-04-05,97,,BOS,0,240,38,92,0.413,28,69,0.406,10,23,0.435,11,19,0.579,97,48,92,0.522,41,65,0.631,7,27,0.259,14,16,0.875,117
2115,PHO,2019-04-03,97,,UTA,0,240,42,91,0.462,37,70,0.529,5,21,0.238,8,13,0.615,97,44,77,0.571,28,45,0.622,16,32,0.5,14,18,0.778,118
2116,LAL,2019-03-15,97,@,DET,0,240,36,86,0.419,30,61,0.492,6,25,0.24,19,26,0.731,97,37,86,0.43,20,47,0.426,17,39,0.436,20,32,0.625,111
2117,PHO,2019-03-13,97,,UTA,0,240,36,82,0.439,29,63,0.46,7,19,0.368,18,23,0.783,97,42,90,0.467,30,57,0.526,12,33,0.364,18,25,0.72,114
2118,ORL,2019-03-10,97,@,MEM,0,240,31,87,0.356,19,49,0.388,12,38,0.316,23,27,0.852,97,34,82,0.415,25,51,0.49,9,31,0.29,28,31,0.903,105
2119,POR,2019-02-27,97,@,BOS,1,240,38,90,0.422,32,57,0.561,6,33,0.182,15,20,0.75,97,40,86,0.465,35,58,0.603,5,28,0.179,7,10,0.7,92
2120,BOS,2019-02-21,97,@,MIL,0,240,39,102,0.382,25,62,0.403,14,40,0.35,5,6,0.833,97,37,88,0.42,23,49,0.469,14,39,0.359,10,14,0.714,98
2121,IND,2019-02-13,97,,MIL,0,240,37,88,0.42,27,61,0.443,10,27,0.37,13,15,0.867,97,38,86,0.442,29,55,0.527,9,31,0.29,21,29,0.724,106
2122,MEM,2019-01-30,97,@,MIN,0,265,36,87,0.414,30,64,0.469,6,23,0.261,19,22,0.864,97,37,95,0.389,29,60,0.483,8,35,0.229,17,22,0.773,99
2123,NYK,2019-01-27,97,,MIA,0,240,36,84,0.429,29,58,0.5,7,26,0.269,18,24,0.75,97,39,84,0.464,27,51,0.529,12,33,0.364,16,18,0.889,106
2124,PHO,2019-01-15,97,@,IND,0,240,40,95,0.421,32,68,0.471,8,27,0.296,9,18,0.5,97,46,89,0.517,34,64,0.531,12,25,0.48,27,36,0.75,131
2125,CHO,2019-01-12,97,@,SAC,0,240,36,88,0.409,24,52,0.462,12,36,0.333,13,22,0.591,97,41,99,0.414,27,62,0.435,14,37,0.378,8,12,0.667,104
2126,DAL,2019-01-07,97,,LAL,0,240,36,86,0.419,28,56,0.5,8,30,0.267,17,24,0.708,97,41,94,0.436,33,65,0.508,8,29,0.276,17,27,0.63,107
2127,NYK,2018-12-29,97,@,UTA,0,240,32,86,0.372,17,54,0.315,15,32,0.469,18,22,0.818,97,51,93,0.548,35,57,0.614,16,36,0.444,11,14,0.786,129
2128,UTA,2018-12-27,97,,PHI,0,240,33,86,0.384,22,51,0.431,11,35,0.314,20,27,0.741,97,43,86,0.5,30,51,0.588,13,35,0.371,15,18,0.833,114
2129,UTA,2018-12-17,97,@,HOU,0,240,32,82,0.39,22,47,0.468,10,35,0.286,23,31,0.742,97,32,86,0.372,20,49,0.408,12,37,0.324,26,31,0.839,102
2130,MEM,2018-12-15,97,,HOU,0,240,40,75,0.533,35,52,0.673,5,23,0.217,12,17,0.706,97,35,73,0.479,22,36,0.611,13,37,0.351,22,25,0.88,105
2131,MEM,2018-12-14,97,,MIA,0,240,35,83,0.422,27,54,0.5,8,29,0.276,19,25,0.76,97,36,82,0.439,21,43,0.488,15,39,0.385,13,18,0.722,100
2132,ORL,2018-12-13,97,,CHI,1,240,34,82,0.415,23,49,0.469,11,33,0.333,18,23,0.783,97,34,71,0.479,24,53,0.453,10,18,0.556,13,20,0.65,91
2133,MIL,2018-12-12,97,@,IND,0,240,38,91,0.418,27,48,0.563,11,43,0.256,10,15,0.667,97,43,91,0.473,31,61,0.508,12,30,0.4,15,20,0.75,113
2134,UTA,2018-12-09,97,@,SAS,0,240,37,85,0.435,28,56,0.5,9,29,0.31,14,19,0.737,97,47,89,0.528,42,75,0.56,5,14,0.357,11,12,0.917,110
2135,SAC,2018-12-08,97,@,IND,0,240,38,90,0.422,29,58,0.5,9,32,0.281,12,15,0.8,97,40,92,0.435,32,62,0.516,8,30,0.267,19,22,0.864,107
2136,BRK,2018-12-03,97,,CLE,0,240,39,99,0.394,29,59,0.492,10,40,0.25,9,16,0.563,97,38,88,0.432,34,73,0.466,4,15,0.267,19,20,0.95,99
2137,POR,2018-11-23,97,@,GSW,0,240,38,93,0.409,29,69,0.42,9,24,0.375,12,22,0.545,97,48,85,0.565,31,53,0.585,17,32,0.531,12,16,0.75,125
2138,MIA,2018-11-18,97,,LAL,0,240,35,87,0.402,22,55,0.4,13,32,0.406,14,19,0.737,97,42,95,0.442,31,68,0.456,11,27,0.407,18,21,0.857,113
2139,IND,2018-11-17,97,,ATL,1,240,35,87,0.402,23,57,0.404,12,30,0.4,15,21,0.714,97,31,87,0.356,23,58,0.397,8,29,0.276,19,27,0.704,89
2140,PHI,2018-11-04,97,@,BRK,0,240,31,65,0.477,27,45,0.6,4,20,0.2,31,41,0.756,97,50,105,0.476,41,77,0.532,9,28,0.321,13,18,0.722,122
2141,CHI,2018-10-27,97,@,ATL,1,240,36,83,0.434,24,50,0.48,12,33,0.364,13,16,0.813,97,27,84,0.321,15,44,0.341,12,40,0.3,19,23,0.826,85
2142,SAC,2018-10-24,97,,MEM,1,240,35,83,0.422,29,65,0.446,6,18,0.333,21,33,0.636,97,36,94,0.383,26,57,0.456,10,37,0.27,10,13,0.769,92
2143,NYK,2019-04-09,96,@,CHI,1,240,37,93,0.398,23,53,0.434,14,40,0.35,8,13,0.615,96,30,83,0.361,23,61,0.377,7,22,0.318,19,29,0.655,86
2144,IND,2019-04-07,96,,BRK,0,240,41,85,0.482,31,58,0.534,10,27,0.37,4,7,0.571,96,40,88,0.455,29,52,0.558,11,36,0.306,17,22,0.773,108
2145,CHI,2019-04-06,96,,PHI,0,240,38,89,0.427,30,64,0.469,8,25,0.32,12,15,0.8,96,46,88,0.523,37,61,0.607,9,27,0.333,15,26,0.577,116
2146,NYK,2019-04-05,96,@,HOU,0,240,37,82,0.451,31,55,0.564,6,27,0.222,16,27,0.593,96,43,101,0.426,21,42,0.5,22,59,0.373,12,17,0.706,120
2147,MEM,2019-03-31,96,@,LAC,0,240,32,85,0.376,24,52,0.462,8,33,0.242,24,29,0.828,96,36,75,0.48,29,48,0.604,7,27,0.259,34,38,0.895,113
2148,BOS,2019-03-30,96,@,BRK,0,240,35,83,0.422,27,63,0.429,8,20,0.4,18,23,0.783,96,38,83,0.458,26,45,0.578,12,38,0.316,22,28,0.786,110
2149,BOS,2019-03-24,96,,SAS,0,240,38,94,0.404,31,59,0.525,7,35,0.2,13,16,0.813,96,50,98,0.51,42,74,0.568,8,24,0.333,7,8,0.875,115
2150,NOP,2019-03-20,96,@,ORL,0,240,38,102,0.373,28,68,0.412,10,34,0.294,10,13,0.769,96,46,102,0.451,31,64,0.484,15,38,0.395,12,14,0.857,119
2151,BRK,2019-03-13,96,@,OKC,0,240,35,84,0.417,22,49,0.449,13,35,0.371,13,19,0.684,96,41,96,0.427,30,68,0.441,11,28,0.393,15,19,0.789,108
2152,NYK,2019-03-06,96,@,PHO,0,240,35,77,0.455,29,62,0.468,6,15,0.4,20,25,0.8,96,39,81,0.481,27,52,0.519,12,29,0.414,17,22,0.773,107
2153,CHI,2019-03-05,96,@,IND,0,240,36,93,0.387,32,68,0.471,4,25,0.16,20,24,0.833,96,38,84,0.452,27,59,0.458,11,25,0.44,18,24,0.75,105
2154,WAS,2019-03-01,96,@,BOS,0,240,36,89,0.404,26,51,0.51,10,38,0.263,14,19,0.737,96,42,94,0.447,32,59,0.542,10,35,0.286,13,17,0.765,107
2155,GSW,2019-02-28,96,@,ORL,0,240,39,97,0.402,30,57,0.526,9,40,0.225,9,10,0.9,96,40,89,0.449,29,58,0.5,11,31,0.355,12,15,0.8,103
2156,LAC,2019-02-24,96,@,DEN,0,240,30,87,0.345,27,66,0.409,3,21,0.143,33,37,0.892,96,44,85,0.518,32,51,0.627,12,34,0.353,23,35,0.657,123
2157,MIA,2019-02-23,96,,DET,0,240,35,82,0.427,28,54,0.519,7,28,0.25,19,27,0.704,96,42,80,0.525,28,47,0.596,14,33,0.424,21,26,0.808,119
2158,MIA,2019-02-08,96,@,SAC,0,240,38,88,0.432,27,55,0.491,11,33,0.333,9,19,0.474,96,37,90,0.411,28,64,0.438,9,26,0.346,19,25,0.76,102
2159,CLE,2019-02-05,96,,BOS,0,240,40,96,0.417,31,63,0.492,9,33,0.273,7,8,0.875,96,40,82,0.488,31,56,0.554,9,26,0.346,14,14,1.0,103
2160,MEM,2019-02-03,96,@,NYK,1,240,37,91,0.407,28,65,0.431,9,26,0.346,13,18,0.722,96,28,74,0.378,16,34,0.471,12,40,0.3,16,22,0.727,84
2161,MEM,2019-01-25,96,,SAC,0,240,34,80,0.425,28,60,0.467,6,20,0.3,22,27,0.815,96,37,91,0.407,25,58,0.431,12,33,0.364,13,17,0.765,99
2162,IND,2019-01-17,96,,PHI,0,240,39,97,0.402,30,68,0.441,9,29,0.31,9,12,0.75,96,46,87,0.529,28,53,0.528,18,34,0.529,10,11,0.909,120
2163,CHO,2019-01-11,96,@,POR,0,240,36,90,0.4,23,60,0.383,13,30,0.433,11,16,0.688,96,52,93,0.559,37,53,0.698,15,40,0.375,8,9,0.889,127
2164,MEM,2019-01-09,96,,SAS,1,240,37,90,0.411,29,57,0.509,8,33,0.242,14,20,0.7,96,30,83,0.361,19,56,0.339,11,27,0.407,15,23,0.652,86
2165,ORL,2019-01-06,96,@,LAC,0,240,33,89,0.371,24,58,0.414,9,31,0.29,21,29,0.724,96,40,93,0.43,32,71,0.451,8,22,0.364,18,23,0.783,106
2166,NYK,2018-12-27,96,@,MIL,0,240,36,97,0.371,23,66,0.348,13,31,0.419,11,16,0.688,96,42,93,0.452,31,61,0.508,11,32,0.344,17,21,0.81,112
2167,POR,2018-12-25,96,@,UTA,0,240,35,89,0.393,26,66,0.394,9,23,0.391,17,26,0.654,96,46,83,0.554,33,54,0.611,13,29,0.448,12,23,0.522,117
2168,BRK,2018-12-19,96,@,CHI,1,240,34,74,0.459,26,49,0.531,8,25,0.32,20,25,0.8,96,40,91,0.44,34,72,0.472,6,19,0.316,7,10,0.7,93
2169,IND,2018-12-19,96,@,TOR,0,240,38,80,0.475,29,60,0.483,9,20,0.45,11,16,0.688,96,38,93,0.409,31,63,0.492,7,30,0.233,16,21,0.762,99
2170,PHI,2018-12-17,96,@,SAS,0,240,40,98,0.408,29,61,0.475,11,37,0.297,5,7,0.714,96,49,87,0.563,40,64,0.625,9,23,0.391,16,17,0.941,123
2171,CHI,2018-12-17,96,@,OKC,0,240,38,85,0.447,30,63,0.476,8,22,0.364,12,16,0.75,96,43,89,0.483,35,68,0.515,8,21,0.381,27,33,0.818,121
2172,NOP,2018-12-16,96,,MIA,0,240,35,86,0.407,22,50,0.44,13,36,0.361,13,17,0.765,96,38,91,0.418,28,56,0.5,10,35,0.286,16,23,0.696,102
2173,ORL,2018-12-15,96,,UTA,1,240,34,72,0.472,23,48,0.479,11,24,0.458,17,20,0.85,96,28,89,0.315,21,60,0.35,7,29,0.241,26,28,0.929,89
2174,MEM,2018-12-05,96,,LAC,1,240,37,85,0.435,30,57,0.526,7,28,0.25,15,24,0.625,96,25,74,0.338,17,51,0.333,8,23,0.348,28,35,0.8,86
2175,IND,2018-12-04,96,,CHI,1,240,35,76,0.461,29,54,0.537,6,22,0.273,20,24,0.833,96,37,94,0.394,26,63,0.413,11,31,0.355,5,5,1.0,90
2176,PHO,2018-12-02,96,@,LAL,0,240,37,93,0.398,24,60,0.4,13,33,0.394,9,11,0.818,96,46,92,0.5,35,65,0.538,11,27,0.407,17,23,0.739,120
2177,IND,2018-11-29,96,@,LAL,0,240,32,86,0.372,22,63,0.349,10,23,0.435,22,27,0.815,96,42,86,0.488,35,62,0.565,7,24,0.292,13,23,0.565,104
2178,CHI,2018-11-24,96,@,MIN,0,240,32,81,0.395,22,48,0.458,10,33,0.303,22,31,0.71,96,42,103,0.408,35,69,0.507,7,34,0.206,20,23,0.87,111
2179,ATL,2018-11-23,96,,BOS,0,240,35,81,0.432,29,46,0.63,6,35,0.171,20,29,0.69,96,42,91,0.462,29,51,0.569,13,40,0.325,17,21,0.81,114
2180,CHI,2018-11-23,96,,MIA,0,240,35,94,0.372,28,66,0.424,7,28,0.25,19,20,0.95,96,37,87,0.425,27,53,0.509,10,34,0.294,19,31,0.613,103
2181,POR,2018-11-16,96,@,MIN,0,240,37,88,0.42,29,59,0.492,8,29,0.276,14,20,0.7,96,46,92,0.5,34,64,0.531,12,28,0.429,8,11,0.727,112
2182,SAS,2018-11-14,96,@,PHO,0,240,35,83,0.422,28,60,0.467,7,23,0.304,19,24,0.792,96,47,84,0.56,32,53,0.604,15,31,0.484,7,8,0.875,116
2183,UTA,2018-11-12,96,@,MEM,1,240,32,82,0.39,23,50,0.46,9,32,0.281,23,30,0.767,96,33,79,0.418,29,55,0.527,4,24,0.167,18,23,0.783,88
2184,OKC,2018-11-10,96,@,DAL,0,240,38,97,0.392,29,63,0.46,9,34,0.265,11,18,0.611,96,43,77,0.558,29,48,0.604,14,29,0.483,11,17,0.647,111
2185,SAS,2018-11-10,96,,HOU,1,240,33,74,0.446,23,54,0.426,10,20,0.5,20,27,0.741,96,30,90,0.333,21,49,0.429,9,41,0.22,20,29,0.69,89
2186,ORL,2018-11-07,96,,DET,0,240,40,87,0.46,31,60,0.517,9,27,0.333,7,9,0.778,96,37,90,0.411,26,53,0.491,11,37,0.297,18,20,0.9,103
2187,HOU,2018-11-03,96,@,CHI,1,240,35,83,0.422,22,41,0.537,13,42,0.31,13,20,0.65,96,28,71,0.394,22,48,0.458,6,23,0.261,26,27,0.963,88
2188,BRK,2018-10-29,96,@,NYK,0,240,34,84,0.405,23,46,0.5,11,38,0.289,17,22,0.773,96,45,92,0.489,36,68,0.529,9,24,0.375,16,18,0.889,115
2189,PHO,2018-10-27,96,@,MEM,0,240,36,78,0.462,27,45,0.6,9,33,0.273,15,19,0.789,96,44,79,0.557,35,53,0.66,9,26,0.346,20,22,0.909,117
2190,SAS,2018-10-24,96,,IND,0,240,35,87,0.402,29,68,0.426,6,19,0.316,20,21,0.952,96,46,87,0.529,29,55,0.527,17,32,0.531,7,8,0.875,116
2191,MIN,2019-04-10,95,@,DEN,0,240,39,91,0.429,26,59,0.441,13,32,0.406,4,6,0.667,95,39,87,0.448,29,54,0.537,10,33,0.303,11,17,0.647,99
2192,WAS,2019-03-31,95,@,DEN,1,240,37,92,0.402,31,68,0.456,6,24,0.25,15,20,0.75,95,35,93,0.376,28,57,0.491,7,36,0.194,13,20,0.65,90
2193,DEN,2019-03-26,95,,DET,1,240,37,87,0.425,30,60,0.5,7,27,0.259,14,20,0.7,95,36,102,0.353,25,60,0.417,11,42,0.262,9,13,0.692,92
2194,WAS,2019-03-18,95,,UTA,0,240,34,81,0.42,26,54,0.481,8,27,0.296,19,22,0.864,95,49,91,0.538,35,54,0.648,14,37,0.378,4,6,0.667,116
2195,GSW,2019-03-05,95,,BOS,0,240,34,85,0.4,26,50,0.52,8,35,0.229,19,23,0.826,95,49,96,0.51,35,62,0.565,14,34,0.412,16,17,0.941,128
2196,TOR,2019-03-05,95,,HOU,0,240,37,89,0.416,28,57,0.491,9,32,0.281,12,16,0.75,95,38,85,0.447,23,51,0.451,15,34,0.441,16,18,0.889,107
2197,MEM,2019-03-03,95,@,OKC,0,240,35,79,0.443,28,57,0.491,7,22,0.318,18,19,0.947,95,33,93,0.355,24,63,0.381,9,30,0.3,24,33,0.727,99
2198,BOS,2019-02-26,95,@,TOR,0,240,33,86,0.384,27,56,0.482,6,30,0.2,23,28,0.821,95,46,94,0.489,29,58,0.5,17,36,0.472,9,14,0.643,118
2199,MEM,2019-02-07,95,@,OKC,0,240,34,77,0.442,27,53,0.509,7,24,0.292,20,23,0.87,95,43,90,0.478,26,46,0.565,17,44,0.386,14,22,0.636,117
2200,IND,2019-02-02,95,@,MIA,1,240,38,89,0.427,31,65,0.477,7,24,0.292,12,17,0.706,95,30,71,0.423,21,41,0.512,9,30,0.3,19,26,0.731,88
2201,DEN,2019-01-28,95,@,MEM,1,240,37,84,0.44,29,48,0.604,8,36,0.222,13,14,0.929,95,35,78,0.449,26,46,0.565,9,32,0.281,13,19,0.684,92
2202,PHO,2019-01-25,95,@,DEN,0,240,32,76,0.421,25,46,0.543,7,30,0.233,24,26,0.923,95,47,94,0.5,32,58,0.552,15,36,0.417,23,29,0.793,132
2203,WAS,2019-01-25,95,@,ORL,1,240,35,79,0.443,20,52,0.385,15,27,0.556,10,12,0.833,95,38,84,0.452,31,51,0.608,7,33,0.212,8,12,0.667,91
2204,CHO,2019-01-20,95,@,IND,0,240,33,82,0.402,21,47,0.447,12,35,0.343,17,25,0.68,95,47,100,0.47,33,73,0.452,14,27,0.519,12,12,1.0,120
2205,SAS,2019-01-20,95,,LAC,0,240,39,84,0.464,31,65,0.477,8,19,0.421,9,17,0.529,95,39,85,0.459,28,64,0.438,11,21,0.524,14,24,0.583,103
2206,SAC,2019-01-17,95,@,CHO,0,240,39,88,0.443,28,55,0.509,11,33,0.333,6,13,0.462,95,39,87,0.448,28,49,0.571,11,38,0.289,25,29,0.862,114
2207,LAL,2019-01-13,95,,CLE,0,240,36,91,0.396,29,57,0.509,7,34,0.206,16,27,0.593,95,38,89,0.427,30,68,0.441,8,21,0.381,17,23,0.739,101
2208,LAL,2019-01-11,95,@,UTA,0,240,37,103,0.359,32,76,0.421,5,27,0.185,16,24,0.667,95,38,96,0.396,23,54,0.426,15,42,0.357,22,32,0.688,113
2209,NYK,2019-01-08,95,@,GSW,0,240,35,88,0.398,29,64,0.453,6,24,0.25,19,21,0.905,95,49,96,0.51,35,51,0.686,14,45,0.311,10,12,0.833,122
2210,ORL,2019-01-07,95,@,SAC,0,240,32,87,0.368,19,50,0.38,13,37,0.351,18,24,0.75,95,45,98,0.459,35,64,0.547,10,34,0.294,11,20,0.55,111
2211,BRK,2019-01-07,95,@,BOS,0,240,32,79,0.405,21,37,0.568,11,42,0.262,20,22,0.909,95,47,93,0.505,35,61,0.574,12,32,0.375,10,12,0.833,116
2212,MEM,2019-01-07,95,@,NOP,0,240,35,78,0.449,25,48,0.521,10,30,0.333,15,18,0.833,95,44,79,0.557,38,62,0.613,6,17,0.353,20,29,0.69,114
2213,PHI,2018-12-30,95,@,POR,0,240,34,96,0.354,26,53,0.491,8,43,0.186,19,27,0.704,95,49,83,0.59,37,61,0.607,12,22,0.545,19,25,0.76,129
2214,TOR,2018-12-30,95,,CHI,1,240,34,92,0.37,25,59,0.424,9,33,0.273,18,20,0.9,95,33,80,0.413,26,60,0.433,7,20,0.35,16,18,0.889,89
2215,MEM,2018-12-26,95,,CLE,1,240,36,72,0.5,31,50,0.62,5,22,0.227,18,24,0.75,95,33,93,0.355,24,64,0.375,9,29,0.31,12,15,0.8,87
2216,WAS,2018-12-26,95,@,DET,0,240,38,83,0.458,29,50,0.58,9,33,0.273,10,13,0.769,95,37,80,0.463,23,43,0.535,14,37,0.378,18,19,0.947,106
2217,NYK,2018-12-25,95,,MIL,0,240,35,97,0.361,27,68,0.397,8,29,0.276,17,21,0.81,95,40,89,0.449,34,57,0.596,6,32,0.188,23,34,0.676,109
2218,DET,2018-12-23,95,,ATL,0,240,34,83,0.41,24,54,0.444,10,29,0.345,17,27,0.63,95,36,91,0.396,30,68,0.441,6,23,0.261,20,25,0.8,98
2219,DEN,2018-12-16,95,,TOR,1,240,36,85,0.424,26,55,0.473,10,30,0.333,13,16,0.813,95,35,88,0.398,28,53,0.528,7,35,0.2,9,14,0.643,86
2220,MIL,2018-12-07,95,,GSW,0,240,36,92,0.391,29,53,0.547,7,39,0.179,16,23,0.696,95,40,89,0.449,21,43,0.488,19,46,0.413,6,7,0.857,105
2221,MEM,2018-12-02,95,@,PHI,0,240,33,79,0.418,22,51,0.431,11,28,0.393,18,23,0.783,95,36,74,0.486,28,52,0.538,8,22,0.364,23,30,0.767,103
2222,CLE,2018-12-01,95,,TOR,0,240,34,88,0.386,29,66,0.439,5,22,0.227,22,25,0.88,95,39,80,0.488,32,54,0.593,7,26,0.269,21,25,0.84,106
2223,CLE,2018-11-30,95,@,BOS,0,240,30,77,0.39,23,55,0.418,7,22,0.318,28,35,0.8,95,49,92,0.533,32,61,0.525,17,31,0.548,13,16,0.813,128
2224,CLE,2018-11-26,95,,MIN,0,240,36,86,0.419,26,55,0.473,10,31,0.323,13,14,0.929,95,40,86,0.465,32,60,0.533,8,26,0.308,14,19,0.737,102
2225,GSW,2018-11-21,95,,OKC,0,240,36,83,0.434,29,54,0.537,7,29,0.241,16,24,0.667,95,51,106,0.481,38,71,0.535,13,35,0.371,8,15,0.533,123
2226,CLE,2018-11-14,95,@,WAS,0,240,35,77,0.455,31,56,0.554,4,21,0.19,21,31,0.677,95,44,92,0.478,31,52,0.596,13,40,0.325,18,26,0.692,119
2227,OKC,2018-11-07,95,@,CLE,1,240,35,84,0.417,28,57,0.491,7,27,0.259,18,26,0.692,95,33,89,0.371,24,58,0.414,9,31,0.29,11,13,0.846,86
2228,MIA,2018-11-07,95,,SAS,1,240,36,93,0.387,26,61,0.426,10,32,0.313,13,18,0.722,95,31,94,0.33,18,62,0.29,13,32,0.406,13,14,0.929,88
2229,NYK,2018-11-04,95,@,WAS,0,240,39,93,0.419,34,66,0.515,5,27,0.185,12,16,0.75,95,36,83,0.434,30,57,0.526,6,26,0.231,30,39,0.769,108
2230,NOP,2018-11-03,95,@,SAS,0,240,36,77,0.468,30,56,0.536,6,21,0.286,17,30,0.567,95,45,96,0.469,37,73,0.507,8,23,0.348,11,14,0.786,109
2231,ORL,2018-11-02,95,,LAC,0,240,40,90,0.444,36,73,0.493,4,17,0.235,11,19,0.579,95,41,86,0.477,28,60,0.467,13,26,0.5,25,33,0.758,120
2232,WAS,2018-10-30,95,@,MEM,0,240,32,74,0.432,18,39,0.462,14,35,0.4,17,20,0.85,95,36,74,0.486,23,46,0.5,13,28,0.464,22,31,0.71,107
2233,MIN,2018-10-26,95,,MIL,0,240,36,112,0.321,26,69,0.377,10,43,0.233,13,18,0.722,95,49,92,0.533,30,46,0.652,19,46,0.413,8,11,0.727,125
2234,OKC,2018-10-25,95,,BOS,0,240,37,94,0.394,30,66,0.455,7,28,0.25,14,25,0.56,95,33,86,0.384,22,54,0.407,11,32,0.344,24,33,0.727,101
2235,MIA,2019-04-10,94,@,BRK,0,240,38,98,0.388,30,57,0.526,8,41,0.195,10,15,0.667,94,43,114,0.377,22,56,0.393,21,58,0.362,6,7,0.857,113
2236,DAL,2019-04-10,94,@,SAS,0,240,37,91,0.407,26,54,0.481,11,37,0.297,9,12,0.75,94,41,88,0.466,33,64,0.516,8,24,0.333,15,18,0.833,105
2237,HOU,2019-03-26,94,@,MIL,0,240,36,99,0.364,20,47,0.426,16,52,0.308,6,7,0.857,94,42,94,0.447,28,60,0.467,14,34,0.412,10,13,0.769,108
2238,HOU,2019-03-10,94,@,DAL,1,240,32,88,0.364,16,36,0.444,16,52,0.308,14,22,0.636,94,31,75,0.413,22,43,0.512,9,32,0.281,22,27,0.815,93
2239,NYK,2019-03-09,94,,SAC,0,240,35,94,0.372,25,59,0.424,10,35,0.286,14,21,0.667,94,36,95,0.379,24,59,0.407,12,36,0.333,18,22,0.818,102
2240,LAL,2019-02-05,94,@,IND,0,240,35,75,0.467,31,54,0.574,4,21,0.19,20,26,0.769,94,56,98,0.571,37,64,0.578,19,34,0.559,5,8,0.625,136
2241,BRK,2019-02-04,94,,MIL,0,240,33,102,0.324,28,60,0.467,5,42,0.119,23,28,0.821,94,43,101,0.426,33,62,0.532,10,39,0.256,17,25,0.68,113
2242,CHO,2019-01-30,94,@,BOS,0,240,39,89,0.438,26,49,0.531,13,40,0.325,3,7,0.429,94,50,90,0.556,38,61,0.623,12,29,0.414,14,16,0.875,126
2243,CLE,2019-01-25,94,,MIA,0,240,37,85,0.435,27,55,0.491,10,30,0.333,10,13,0.769,94,37,79,0.468,28,56,0.5,9,23,0.391,17,25,0.68,100
2244,NOP,2019-01-23,94,,DET,0,240,42,91,0.462,36,69,0.522,6,22,0.273,4,9,0.444,94,36,89,0.404,23,50,0.46,13,39,0.333,13,19,0.684,98
2245,SAC,2019-01-21,94,@,BRK,0,240,39,93,0.419,29,68,0.426,10,25,0.4,6,11,0.545,94,45,90,0.5,32,55,0.582,13,35,0.371,20,24,0.833,123
2246,LAC,2019-01-18,94,,GSW,0,240,31,85,0.365,27,60,0.45,4,25,0.16,28,35,0.8,94,42,86,0.488,33,49,0.673,9,37,0.243,19,27,0.704,112
2247,DET,2019-01-14,94,@,UTA,0,240,35,90,0.389,24,54,0.444,11,36,0.306,13,16,0.813,94,31,80,0.388,19,43,0.442,12,37,0.324,26,36,0.722,100
2248,MEM,2019-01-14,94,@,HOU,0,240,36,71,0.507,26,49,0.531,10,22,0.455,12,22,0.545,94,37,84,0.44,19,36,0.528,18,48,0.375,20,22,0.909,112
2249,PHO,2019-01-09,94,@,DAL,0,240,36,84,0.429,29,59,0.492,7,25,0.28,15,21,0.714,94,30,70,0.429,18,36,0.5,12,34,0.353,32,45,0.711,104
2250,MEM,2019-01-02,94,,DET,0,240,36,78,0.462,32,60,0.533,4,18,0.222,18,21,0.857,94,36,83,0.434,20,43,0.465,16,40,0.4,13,22,0.591,101
2251,CLE,2018-12-28,94,@,MIA,0,240,31,81,0.383,18,44,0.409,13,37,0.351,19,22,0.864,94,48,91,0.527,38,60,0.633,10,31,0.323,12,16,0.75,118
2252,CHI,2018-12-26,94,,MIN,0,240,39,95,0.411,33,72,0.458,6,23,0.261,10,16,0.625,94,46,93,0.495,35,61,0.574,11,32,0.344,16,19,0.842,119
2253,MIA,2018-12-22,94,,MIL,1,240,34,89,0.382,24,57,0.421,10,32,0.313,16,23,0.696,94,31,84,0.369,22,41,0.537,9,43,0.209,16,22,0.727,87
2254,ATL,2018-11-28,94,@,CHO,0,240,32,93,0.344,21,49,0.429,11,44,0.25,19,22,0.864,94,38,83,0.458,34,63,0.54,4,20,0.2,28,37,0.757,108
2255,UTA,2018-11-19,94,@,IND,0,240,36,74,0.486,25,49,0.51,11,25,0.44,11,16,0.688,94,49,93,0.527,37,68,0.544,12,25,0.48,11,17,0.647,121
2256,BOS,2018-11-11,94,@,POR,0,240,36,93,0.387,22,51,0.431,14,42,0.333,8,10,0.8,94,39,86,0.453,25,50,0.5,14,36,0.389,8,10,0.8,100
2257,IND,2018-11-07,94,,PHI,0,240,37,94,0.394,29,63,0.46,8,31,0.258,12,17,0.706,94,36,79,0.456,26,47,0.553,10,32,0.313,18,22,0.818,100
2258,IND,2018-11-05,94,,HOU,0,240,33,75,0.44,25,47,0.532,8,28,0.286,20,30,0.667,94,34,76,0.447,19,29,0.655,15,47,0.319,15,16,0.938,98
2259,CLE,2018-11-03,94,@,CHO,0,240,35,81,0.432,25,55,0.455,10,26,0.385,14,15,0.933,94,52,91,0.571,42,61,0.689,10,30,0.333,12,13,0.923,126
2260,MEM,2019-04-09,93,@,DET,0,240,33,69,0.478,23,45,0.511,10,24,0.417,17,21,0.81,93,35,88,0.398,25,54,0.463,10,34,0.294,20,28,0.714,100
2261,NYK,2019-03-22,93,,DEN,0,240,34,90,0.378,25,58,0.431,9,32,0.281,16,21,0.762,93,40,96,0.417,25,58,0.431,15,38,0.395,16,19,0.842,111
2262,MIA,2019-03-17,93,,CHO,1,240,34,86,0.395,21,53,0.396,13,33,0.394,12,19,0.632,93,26,83,0.313,19,47,0.404,7,36,0.194,16,18,0.889,75
2263,DAL,2019-03-10,93,,HOU,0,240,31,75,0.413,22,43,0.512,9,32,0.281,22,27,0.815,93,32,88,0.364,16,36,0.444,16,52,0.308,14,22,0.636,94
2264,ORL,2019-03-03,93,@,CLE,0,240,39,88,0.443,33,62,0.532,6,26,0.231,9,11,0.818,93,36,83,0.434,22,40,0.55,14,43,0.326,21,23,0.913,107
2265,CLE,2019-03-02,93,,DET,0,240,27,79,0.342,14,45,0.311,13,34,0.382,26,32,0.813,93,47,87,0.54,27,50,0.54,20,37,0.541,15,17,0.882,129
2266,DET,2019-02-27,93,@,SAS,0,240,36,100,0.36,21,62,0.339,15,38,0.395,6,7,0.857,93,42,81,0.519,33,64,0.516,9,17,0.529,12,17,0.706,105
2267,CHO,2019-02-06,93,@,DAL,0,240,36,89,0.404,27,52,0.519,9,37,0.243,12,17,0.706,93,38,94,0.404,27,58,0.466,11,36,0.306,12,17,0.706,99
2268,DET,2019-01-31,93,,DAL,1,240,33,86,0.384,24,53,0.453,9,33,0.273,18,23,0.783,93,36,88,0.409,29,63,0.46,7,25,0.28,10,14,0.714,89
2269,HOU,2019-01-21,93,@,PHI,0,240,31,86,0.36,20,44,0.455,11,42,0.262,20,26,0.769,93,43,88,0.489,35,65,0.538,8,23,0.348,27,33,0.818,121
2270,MIA,2019-01-18,93,@,DET,0,240,39,77,0.506,29,48,0.604,10,29,0.345,5,19,0.263,93,35,82,0.427,22,49,0.449,13,33,0.394,15,18,0.833,98
2271,SAS,2019-01-14,93,,CHO,0,240,38,82,0.463,31,62,0.5,7,20,0.35,10,12,0.833,93,43,92,0.467,30,56,0.536,13,36,0.361,9,11,0.818,108
2272,DEN,2019-01-12,93,@,PHO,0,240,34,88,0.386,24,57,0.421,10,31,0.323,15,22,0.682,93,38,92,0.413,30,66,0.455,8,26,0.308,18,25,0.72,102
2273,ORL,2019-01-09,93,@,UTA,0,240,33,83,0.398,20,50,0.4,13,33,0.394,14,20,0.7,93,41,84,0.488,29,51,0.569,12,33,0.364,12,14,0.857,106
2274,DAL,2019-01-04,93,@,BOS,0,240,34,88,0.386,23,44,0.523,11,44,0.25,14,19,0.737,93,42,96,0.438,21,51,0.412,21,45,0.467,9,11,0.818,114
2275,CHI,2018-12-19,93,,BRK,0,240,40,91,0.44,34,72,0.472,6,19,0.316,7,10,0.7,93,34,74,0.459,26,49,0.531,8,25,0.32,20,25,0.8,96
2276,MEM,2018-12-17,93,@,GSW,0,240,36,79,0.456,29,54,0.537,7,25,0.28,14,18,0.778,93,37,85,0.435,25,54,0.463,12,31,0.387,24,27,0.889,110
2277,SAS,2018-12-15,93,,CHI,0,240,32,73,0.438,25,52,0.481,7,21,0.333,22,26,0.846,93,37,86,0.43,31,57,0.544,6,29,0.207,18,21,0.857,98
2278,GSW,2018-12-12,93,,TOR,0,240,39,82,0.476,33,56,0.589,6,26,0.231,9,13,0.692,93,44,91,0.484,35,63,0.556,9,28,0.321,16,19,0.842,113
2279,TOR,2018-11-20,93,@,ORL,1,240,39,87,0.448,30,53,0.566,9,34,0.265,6,8,0.75,93,34,84,0.405,26,54,0.481,8,30,0.267,15,19,0.789,91
2280,ATL,2018-11-15,93,@,DEN,0,240,32,92,0.348,23,50,0.46,9,42,0.214,20,27,0.741,93,53,94,0.564,40,63,0.635,13,31,0.419,19,25,0.76,138
2281,IND,2018-10-29,93,,POR,0,240,37,90,0.411,31,71,0.437,6,19,0.316,13,20,0.65,93,38,78,0.487,28,52,0.538,10,26,0.385,17,18,0.944,103
2282,ORL,2018-10-22,93,@,BOS,1,240,38,93,0.409,28,58,0.483,10,35,0.286,7,10,0.7,93,37,91,0.407,28,51,0.549,9,40,0.225,7,9,0.778,90
2283,NYK,2019-03-30,92,,MIA,0,240,31,77,0.403,22,39,0.564,9,38,0.237,21,25,0.84,92,39,90,0.433,30,58,0.517,9,32,0.281,13,17,0.765,100
2284,NYK,2019-03-28,92,,TOR,0,240,31,85,0.365,25,59,0.424,6,26,0.231,24,32,0.75,92,40,89,0.449,20,42,0.476,20,47,0.426,17,22,0.773,117
2285,DET,2019-03-26,92,@,DEN,0,240,36,102,0.353,25,60,0.417,11,42,0.262,9,13,0.692,92,37,87,0.425,30,60,0.5,7,27,0.259,14,20,0.7,95
2286,PHO,2019-03-25,92,@,UTA,0,240,31,76,0.408,24,53,0.453,7,23,0.304,23,28,0.821,92,48,86,0.558,38,65,0.585,10,21,0.476,19,23,0.826,125
2287,NYK,2019-03-18,92,@,TOR,0,240,28,85,0.329,20,50,0.4,8,35,0.229,28,32,0.875,92,49,88,0.557,32,48,0.667,17,40,0.425,13,22,0.591,128
2288,NYK,2019-03-10,92,@,MIN,0,240,37,86,0.43,27,61,0.443,10,25,0.4,8,14,0.571,92,42,94,0.447,33,64,0.516,9,30,0.3,10,13,0.769,103
2289,BOS,2019-02-27,92,,POR,0,240,40,86,0.465,35,58,0.603,5,28,0.179,7,10,0.7,92,38,90,0.422,32,57,0.561,6,33,0.182,15,20,0.75,97
2290,LAC,2019-02-07,92,@,IND,0,240,37,85,0.435,31,68,0.456,6,17,0.353,12,19,0.632,92,49,87,0.563,40,65,0.615,9,22,0.409,9,11,0.818,116
2291,NYK,2019-02-05,92,,DET,0,240,36,90,0.4,27,57,0.474,9,33,0.273,11,15,0.733,92,37,79,0.468,25,45,0.556,12,34,0.353,19,24,0.792,105
2292,MEM,2019-02-01,92,@,CHO,0,240,35,80,0.438,26,51,0.51,9,29,0.31,13,17,0.765,92,32,73,0.438,20,44,0.455,12,29,0.414,24,28,0.857,100
2293,TOR,2019-01-31,92,,MIL,0,240,37,93,0.398,30,66,0.455,7,27,0.259,11,13,0.846,92,39,79,0.494,25,41,0.61,14,38,0.368,13,17,0.765,105
2294,MEM,2019-01-28,92,,DEN,0,240,35,78,0.449,26,46,0.565,9,32,0.281,13,19,0.684,92,37,84,0.44,29,48,0.604,8,36,0.222,13,14,0.929,95
2295,NYK,2019-01-28,92,@,CHO,0,240,34,85,0.4,27,62,0.435,7,23,0.304,17,26,0.654,92,39,94,0.415,28,60,0.467,11,34,0.324,12,16,0.75,101
2296,CLE,2019-01-02,92,,MIA,0,240,34,75,0.453,21,44,0.477,13,31,0.419,11,13,0.846,92,44,86,0.512,28,55,0.509,16,31,0.516,13,17,0.765,117
2297,WAS,2018-12-28,92,,CHI,0,240,34,85,0.4,25,55,0.455,9,30,0.3,15,18,0.833,92,37,79,0.468,29,57,0.509,8,22,0.364,19,25,0.76,101
2298,CLE,2018-12-23,92,,CHI,0,240,38,84,0.452,31,61,0.508,7,23,0.304,9,14,0.643,92,43,78,0.551,32,56,0.571,11,22,0.5,15,17,0.882,112
2299,MEM,2018-12-19,92,@,POR,0,240,33,78,0.423,24,51,0.471,9,27,0.333,17,19,0.895,92,35,75,0.467,24,49,0.49,11,26,0.423,18,20,0.9,99
2300,CLE,2018-12-18,92,@,IND,1,240,38,91,0.418,32,60,0.533,6,31,0.194,10,13,0.769,92,37,93,0.398,33,71,0.465,4,22,0.182,13,21,0.619,91
2301,MEM,2018-12-12,92,,POR,1,240,34,82,0.415,26,58,0.448,8,24,0.333,16,24,0.667,92,32,87,0.368,26,65,0.4,6,22,0.273,13,16,0.813,83
2302,CLE,2018-12-10,92,@,MIL,0,240,36,96,0.375,26,66,0.394,10,30,0.333,10,15,0.667,92,42,96,0.438,27,60,0.45,15,36,0.417,9,11,0.818,108
2303,DET,2018-12-05,92,@,MIL,0,240,35,95,0.368,26,57,0.456,9,38,0.237,13,19,0.684,92,38,82,0.463,24,41,0.585,14,41,0.341,25,30,0.833,115
2304,MIA,2018-11-20,92,,BRK,0,240,36,100,0.36,29,68,0.426,7,32,0.219,13,20,0.65,92,38,88,0.432,30,57,0.526,8,31,0.258,20,26,0.769,104
2305,GSW,2018-11-18,92,@,SAS,0,240,35,86,0.407,30,60,0.5,5,26,0.192,17,21,0.81,92,41,92,0.446,31,68,0.456,10,24,0.417,12,17,0.706,104
2306,ATL,2018-10-29,92,@,PHI,0,240,35,94,0.372,27,57,0.474,8,37,0.216,14,21,0.667,92,41,99,0.414,27,52,0.519,14,47,0.298,17,18,0.944,113
2307,MEM,2018-10-24,92,@,SAC,0,240,36,94,0.383,26,57,0.456,10,37,0.27,10,13,0.769,92,35,83,0.422,29,65,0.446,6,18,0.333,21,33,0.636,97
2308,MEM,2018-10-22,92,@,UTA,1,240,31,84,0.369,22,56,0.393,9,28,0.321,21,26,0.808,92,29,82,0.354,21,50,0.42,8,32,0.25,18,23,0.783,84
2309,OKC,2018-10-19,92,@,LAC,0,240,34,95,0.358,27,62,0.435,7,33,0.212,17,23,0.739,92,35,81,0.432,24,55,0.436,11,26,0.423,27,36,0.75,108
2310,DET,2019-04-07,91,,CHO,0,240,34,92,0.37,24,51,0.471,10,41,0.244,13,15,0.867,91,38,88,0.432,28,57,0.491,10,31,0.323,18,23,0.783,104
2311,GSW,2019-03-23,91,,DAL,0,240,36,90,0.4,32,60,0.533,4,30,0.133,15,21,0.714,91,44,83,0.53,23,34,0.676,21,49,0.429,17,22,0.773,126
2312,ATL,2019-03-17,91,@,ORL,0,240,38,91,0.418,30,56,0.536,8,35,0.229,7,10,0.7,91,33,85,0.388,24,48,0.5,9,37,0.243,26,33,0.788,101
2313,CLE,2019-03-14,91,@,ORL,0,240,35,86,0.407,28,55,0.509,7,31,0.226,14,15,0.933,91,45,93,0.484,31,62,0.5,14,31,0.452,16,21,0.762,120
2314,PHI,2019-03-08,91,@,HOU,0,240,35,95,0.368,32,69,0.464,3,26,0.115,18,23,0.783,91,42,85,0.494,29,44,0.659,13,41,0.317,10,15,0.667,107
2315,MIA,2019-03-06,91,@,CHO,1,240,38,90,0.422,29,64,0.453,9,26,0.346,6,11,0.545,91,30,82,0.366,16,46,0.348,14,36,0.389,10,15,0.667,84
2316,ATL,2019-02-14,91,,NYK,0,240,33,91,0.363,23,53,0.434,10,38,0.263,15,19,0.789,91,38,84,0.452,26,53,0.491,12,31,0.387,18,26,0.692,106
2317,ORL,2019-01-25,91,,WAS,0,240,38,84,0.452,31,51,0.608,7,33,0.212,8,12,0.667,91,35,79,0.443,20,52,0.385,15,27,0.556,10,12,0.833,95
2318,PHO,2019-01-22,91,,MIN,0,240,37,87,0.425,30,53,0.566,7,34,0.206,10,18,0.556,91,45,103,0.437,30,61,0.492,15,42,0.357,13,19,0.684,118
2319,CLE,2019-01-04,91,,UTA,0,240,32,82,0.39,21,61,0.344,11,21,0.524,16,17,0.941,91,42,82,0.512,28,47,0.596,14,35,0.4,19,22,0.864,117
2320,ORL,2018-12-23,91,,MIA,0,240,29,70,0.414,19,42,0.452,10,28,0.357,23,32,0.719,91,43,85,0.506,27,54,0.5,16,31,0.516,13,19,0.684,115
2321,IND,2018-12-18,91,,CLE,0,240,37,93,0.398,33,71,0.465,4,22,0.182,13,21,0.619,91,38,91,0.418,32,60,0.533,6,31,0.194,10,13,0.769,92
2322,CHI,2018-12-13,91,@,ORL,0,240,34,71,0.479,24,53,0.453,10,18,0.556,13,20,0.65,91,34,82,0.415,23,49,0.469,11,33,0.333,18,23,0.783,97
2323,HOU,2018-12-06,91,@,UTA,0,240,34,88,0.386,26,52,0.5,8,36,0.222,15,17,0.882,91,45,89,0.506,37,57,0.649,8,32,0.25,20,27,0.741,118
2324,HOU,2018-12-03,91,@,MIN,0,240,32,74,0.432,21,35,0.6,11,39,0.282,16,19,0.842,91,36,82,0.439,25,60,0.417,11,22,0.5,20,28,0.714,103
2325,BRK,2018-11-28,91,,UTA,0,240,30,86,0.349,19,56,0.339,11,30,0.367,20,28,0.714,91,39,82,0.476,30,54,0.556,9,28,0.321,14,21,0.667,101
2326,NYK,2018-11-28,91,@,PHI,0,240,32,92,0.348,26,63,0.413,6,29,0.207,21,22,0.955,91,47,87,0.54,35,62,0.565,12,25,0.48,11,16,0.688,117
2327,ORL,2018-11-20,91,,TOR,0,240,34,84,0.405,26,54,0.481,8,30,0.267,15,19,0.789,91,39,87,0.448,30,53,0.566,9,34,0.265,6,8,0.75,93
2328,MIA,2018-11-16,91,@,IND,0,240,35,93,0.376,21,57,0.368,14,36,0.389,7,10,0.7,91,36,81,0.444,22,54,0.407,14,27,0.519,13,15,0.867,99
2329,CLE,2018-11-01,91,,DEN,0,240,34,83,0.41,29,65,0.446,5,18,0.278,18,19,0.947,91,41,85,0.482,31,59,0.525,10,26,0.385,18,21,0.857,110
2330,ORL,2018-10-27,91,@,MIL,0,240,33,101,0.327,23,58,0.397,10,43,0.233,15,17,0.882,91,41,82,0.5,31,52,0.596,10,30,0.333,21,23,0.913,113
2331,IND,2018-10-22,91,@,MIN,0,240,36,92,0.391,28,66,0.424,8,26,0.308,11,16,0.688,91,36,85,0.424,29,52,0.558,7,33,0.212,22,24,0.917,101
2332,PHO,2018-10-20,91,@,DEN,0,240,29,77,0.377,18,38,0.474,11,39,0.282,22,35,0.629,91,43,85,0.506,34,57,0.596,9,28,0.321,24,29,0.828,119
2333,CLE,2019-04-07,90,,SAS,0,240,31,79,0.392,23,50,0.46,8,29,0.276,20,27,0.741,90,43,82,0.524,34,60,0.567,9,22,0.409,17,22,0.773,112
2334,LAL,2019-04-04,90,,GSW,0,240,37,104,0.356,29,67,0.433,8,37,0.216,8,14,0.571,90,43,98,0.439,25,52,0.481,18,46,0.391,4,5,0.8,108
2335,CHO,2019-03-31,90,@,GSW,0,240,30,85,0.353,22,53,0.415,8,32,0.25,22,25,0.88,90,53,88,0.602,32,55,0.582,21,33,0.636,10,12,0.833,137
2336,DEN,2019-03-31,90,,WAS,0,240,35,93,0.376,28,57,0.491,7,36,0.194,13,20,0.65,90,37,92,0.402,31,68,0.456,6,24,0.25,15,20,0.75,95
2337,POR,2019-03-30,90,@,DET,0,240,38,102,0.373,34,81,0.42,4,21,0.19,10,11,0.909,90,37,86,0.43,32,61,0.525,5,25,0.2,20,26,0.769,99
2338,NOP,2019-03-24,90,,HOU,0,240,38,92,0.413,31,64,0.484,7,28,0.25,7,10,0.7,90,42,86,0.488,21,37,0.568,21,49,0.429,8,9,0.889,113
2339,ORL,2019-03-13,90,@,WAS,0,240,35,90,0.389,23,57,0.404,12,33,0.364,8,9,0.889,90,42,90,0.467,34,63,0.54,8,27,0.296,8,12,0.667,100
2340,CHO,2019-02-11,90,@,IND,0,240,29,90,0.322,22,50,0.44,7,40,0.175,25,33,0.758,90,38,74,0.514,30,49,0.612,8,25,0.32,15,17,0.882,99
2341,CLE,2019-02-09,90,@,IND,0,240,35,79,0.443,19,43,0.442,16,36,0.444,4,9,0.444,90,45,84,0.536,36,58,0.621,9,26,0.346,6,10,0.6,105
2342,NOP,2019-02-09,90,@,MEM,0,240,34,86,0.395,28,53,0.528,6,33,0.182,16,27,0.593,90,38,88,0.432,30,59,0.508,8,29,0.276,15,18,0.833,99
2343,NYK,2019-01-30,90,,DAL,0,240,32,78,0.41,26,52,0.5,6,26,0.231,20,28,0.714,90,45,84,0.536,30,46,0.652,15,38,0.395,9,11,0.818,114
2344,MEM,2019-01-19,90,@,TOR,0,240,34,80,0.425,24,51,0.471,10,29,0.345,12,15,0.8,90,44,90,0.489,27,54,0.5,17,36,0.472,14,16,0.875,119
2345,POR,2018-12-21,90,,UTA,0,240,35,87,0.402,25,55,0.455,10,32,0.313,10,18,0.556,90,47,85,0.553,31,54,0.574,16,31,0.516,10,17,0.588,120
2346,CHI,2018-12-21,90,,ORL,1,240,33,75,0.44,28,58,0.483,5,17,0.294,19,26,0.731,90,28,86,0.326,20,53,0.377,8,33,0.242,16,24,0.667,80
2347,ORL,2018-12-19,90,,SAS,0,240,34,89,0.382,22,58,0.379,12,31,0.387,10,17,0.588,90,50,77,0.649,38,58,0.655,12,19,0.632,17,21,0.81,129
2348,ORL,2018-12-07,90,,IND,0,240,36,89,0.404,28,56,0.5,8,33,0.242,10,13,0.769,90,44,93,0.473,35,67,0.522,9,26,0.346,15,18,0.833,112
2349,MIA,2018-12-04,90,,ORL,0,240,38,91,0.418,26,56,0.464,12,35,0.343,2,5,0.4,90,38,86,0.442,24,58,0.414,14,28,0.5,15,20,0.75,105
2350,CHI,2018-12-04,90,@,IND,0,240,37,94,0.394,26,63,0.413,11,31,0.355,5,5,1.0,90,35,76,0.461,29,54,0.537,6,22,0.273,20,24,0.833,96
2351,LAL,2018-11-23,90,,UTA,1,240,36,79,0.456,29,56,0.518,7,23,0.304,11,18,0.611,90,33,85,0.388,29,62,0.468,4,23,0.174,13,17,0.765,83
2352,PHO,2018-10-31,90,,SAS,0,240,35,90,0.389,29,66,0.439,6,24,0.25,14,18,0.778,90,46,83,0.554,42,65,0.646,4,18,0.222,24,26,0.923,120
2353,BOS,2018-10-22,90,,ORL,0,240,37,91,0.407,28,51,0.549,9,40,0.225,7,9,0.778,90,38,93,0.409,28,58,0.483,10,35,0.286,7,10,0.7,93
2354,NYK,2019-04-10,89,,DET,0,240,31,77,0.403,22,47,0.468,9,30,0.3,18,25,0.72,89,41,85,0.482,27,52,0.519,14,33,0.424,19,20,0.95,115
2355,DET,2019-04-03,89,,IND,0,240,31,80,0.388,20,39,0.513,11,41,0.268,16,24,0.667,89,43,92,0.467,37,71,0.521,6,21,0.286,16,22,0.727,108
2356,MEM,2019-04-03,89,@,POR,0,240,31,80,0.388,20,47,0.426,11,33,0.333,16,19,0.842,89,48,94,0.511,38,63,0.603,10,31,0.323,10,16,0.625,116
2357,IND,2019-03-21,89,@,GSW,0,240,35,91,0.385,29,68,0.426,6,23,0.261,13,17,0.765,89,44,89,0.494,31,53,0.585,13,36,0.361,11,16,0.688,112
2358,UTA,2019-03-11,89,,OKC,0,240,32,88,0.364,19,45,0.422,13,43,0.302,12,17,0.706,89,36,79,0.456,29,57,0.509,7,22,0.318,19,27,0.704,98
2359,IND,2019-03-10,89,@,PHI,0,240,31,83,0.373,26,67,0.388,5,16,0.313,22,37,0.595,89,38,87,0.437,31,64,0.484,7,23,0.304,23,30,0.767,106
2360,CHO,2019-02-14,89,@,ORL,0,240,33,94,0.351,29,63,0.46,4,31,0.129,19,26,0.731,89,48,92,0.522,31,53,0.585,17,39,0.436,14,18,0.778,127
2361,BRK,2019-02-02,89,@,ORL,0,240,33,91,0.363,23,53,0.434,10,38,0.263,13,16,0.813,89,41,94,0.436,31,67,0.463,10,27,0.37,10,12,0.833,102
2362,DAL,2019-01-31,89,@,DET,0,240,36,88,0.409,29,63,0.46,7,25,0.28,10,14,0.714,89,33,86,0.384,24,53,0.453,9,33,0.273,18,23,0.783,93
2363,MIA,2019-01-30,89,,CHI,0,240,34,89,0.382,22,47,0.468,12,42,0.286,9,13,0.692,89,40,78,0.513,32,59,0.542,8,19,0.421,17,21,0.81,105
2364,IND,2019-01-30,89,@,WAS,0,240,33,84,0.393,24,53,0.453,9,31,0.29,14,18,0.778,89,41,78,0.526,29,50,0.58,12,28,0.429,13,21,0.619,107
2365,CHI,2018-12-30,89,@,TOR,0,240,33,80,0.413,26,60,0.433,7,20,0.35,16,18,0.889,89,34,92,0.37,25,59,0.424,9,33,0.273,18,20,0.9,95
2366,WAS,2018-12-23,89,@,IND,0,240,28,76,0.368,19,41,0.463,9,35,0.257,24,26,0.923,89,43,97,0.443,34,67,0.507,9,30,0.3,10,12,0.833,105
2367,UTA,2018-12-15,89,@,ORL,0,240,28,89,0.315,21,60,0.35,7,29,0.241,26,28,0.929,89,34,72,0.472,23,48,0.479,11,24,0.458,17,20,0.85,96
2368,DAL,2018-12-13,89,@,PHO,0,240,31,78,0.397,26,45,0.578,5,33,0.152,22,33,0.667,89,37,92,0.402,27,65,0.415,10,27,0.37,15,18,0.833,99
2369,CHI,2018-12-10,89,,SAC,0,240,34,76,0.447,26,48,0.542,8,28,0.286,13,13,1.0,89,40,88,0.455,24,51,0.471,16,37,0.432,12,15,0.8,108
2370,SAS,2018-11-28,89,@,MIN,0,240,34,87,0.391,26,60,0.433,8,27,0.296,13,13,1.0,89,50,99,0.505,32,58,0.552,18,41,0.439,10,15,0.667,128
2371,ATL,2018-11-17,89,@,IND,0,240,31,87,0.356,23,58,0.397,8,29,0.276,19,27,0.704,89,35,87,0.402,23,57,0.404,12,30,0.4,15,21,0.714,97
2372,CHO,2018-11-13,89,@,CLE,0,240,33,95,0.347,25,54,0.463,8,41,0.195,15,19,0.789,89,45,85,0.529,32,61,0.525,13,24,0.542,10,12,0.833,113
2373,NYK,2018-11-11,89,,ORL,0,240,31,88,0.352,26,60,0.433,5,28,0.179,22,30,0.733,89,44,98,0.449,27,56,0.482,17,42,0.405,10,11,0.909,115
2374,HOU,2018-11-10,89,@,SAS,0,240,30,90,0.333,21,49,0.429,9,41,0.22,20,29,0.69,89,33,74,0.446,23,54,0.426,10,20,0.5,20,27,0.741,96
2375,MEM,2018-11-07,89,,DEN,1,240,30,70,0.429,22,49,0.449,8,21,0.381,21,25,0.84,89,32,82,0.39,24,50,0.48,8,32,0.25,15,19,0.789,87
2376,DET,2018-10-27,89,,BOS,0,240,33,89,0.371,26,52,0.5,7,37,0.189,16,20,0.8,89,39,86,0.453,25,52,0.481,14,34,0.412,17,25,0.68,109
2377,HOU,2018-10-24,89,,UTA,0,240,35,87,0.402,24,47,0.511,11,40,0.275,8,14,0.571,89,34,78,0.436,24,49,0.49,10,29,0.345,22,28,0.786,100
2378,DEN,2019-03-24,88,@,IND,0,240,33,93,0.355,26,64,0.406,7,29,0.241,15,16,0.938,88,51,91,0.56,43,73,0.589,8,18,0.444,14,17,0.824,124
2379,OKC,2019-03-16,88,,GSW,0,240,31,96,0.323,18,55,0.327,13,41,0.317,13,23,0.565,88,39,83,0.47,24,48,0.5,15,35,0.429,17,22,0.773,110
2380,DAL,2019-03-04,88,@,BRK,0,240,31,87,0.356,19,42,0.452,12,45,0.267,14,22,0.636,88,48,85,0.565,31,44,0.705,17,41,0.415,14,19,0.737,127
2381,BRK,2019-03-02,88,@,MIA,0,240,31,88,0.352,22,46,0.478,9,42,0.214,17,22,0.773,88,44,90,0.489,30,56,0.536,14,34,0.412,15,22,0.682,117
2382,NOP,2019-02-12,88,,ORL,0,240,36,94,0.383,26,65,0.4,10,29,0.345,6,8,0.75,88,42,95,0.442,29,63,0.46,13,32,0.406,21,22,0.955,118
2383,PHO,2019-02-06,88,@,UTA,0,240,35,75,0.467,32,58,0.552,3,17,0.176,15,19,0.789,88,42,84,0.5,31,56,0.554,11,28,0.393,21,32,0.656,116
2384,MIA,2019-02-02,88,,IND,0,240,30,71,0.423,21,41,0.512,9,30,0.3,19,26,0.731,88,38,89,0.427,31,65,0.477,7,24,0.292,12,17,0.706,95
2385,CLE,2019-01-21,88,,CHI,0,240,31,87,0.356,25,60,0.417,6,27,0.222,20,29,0.69,88,36,76,0.474,21,46,0.457,15,30,0.5,17,22,0.773,104
2386,MEM,2019-01-05,88,@,SAS,0,240,31,82,0.378,20,54,0.37,11,28,0.393,15,19,0.789,88,36,73,0.493,29,51,0.569,7,22,0.318,29,35,0.829,108
2387,DET,2018-12-28,88,@,IND,0,240,34,91,0.374,25,55,0.455,9,36,0.25,11,12,0.917,88,53,87,0.609,48,68,0.706,5,19,0.263,14,20,0.7,125
2388,MEM,2018-12-08,88,,LAL,0,240,34,84,0.405,28,54,0.519,6,30,0.2,14,18,0.778,88,43,97,0.443,27,57,0.474,16,40,0.4,9,12,0.75,111
2389,BRK,2018-12-01,88,@,WAS,0,240,30,81,0.37,22,48,0.458,8,33,0.242,20,25,0.8,88,41,79,0.519,33,53,0.623,8,26,0.308,12,18,0.667,102
2390,CHI,2018-11-30,88,@,DET,0,240,37,86,0.43,34,65,0.523,3,21,0.143,11,14,0.786,88,41,92,0.446,28,58,0.483,13,34,0.382,12,16,0.75,107
2391,UTA,2018-11-26,88,,IND,0,240,34,81,0.42,26,50,0.52,8,31,0.258,12,17,0.706,88,49,84,0.583,40,66,0.606,9,18,0.5,14,17,0.824,121
2392,DAL,2018-11-19,88,@,MEM,0,240,30,88,0.341,20,56,0.357,10,32,0.313,18,21,0.857,88,37,79,0.468,25,49,0.51,12,30,0.4,12,14,0.857,98
2393,MEM,2018-11-12,88,,UTA,0,240,33,79,0.418,29,55,0.527,4,24,0.167,18,23,0.783,88,32,82,0.39,23,50,0.46,9,32,0.281,23,30,0.767,96
2394,SAS,2018-11-07,88,@,MIA,0,240,31,94,0.33,18,62,0.29,13,32,0.406,13,14,0.929,88,36,93,0.387,26,61,0.426,10,32,0.313,13,18,0.722,95
2395,CHI,2018-11-03,88,,HOU,0,240,28,71,0.394,22,48,0.458,6,23,0.261,26,27,0.963,88,35,83,0.422,22,41,0.537,13,42,0.31,13,20,0.65,96
2396,UTA,2018-11-03,88,@,DEN,0,240,33,81,0.407,27,50,0.54,6,31,0.194,16,24,0.667,88,41,83,0.494,32,55,0.582,9,28,0.321,12,19,0.632,103
2397,ORL,2018-10-19,88,,CHO,0,240,36,94,0.383,30,63,0.476,6,31,0.194,10,14,0.714,88,43,92,0.467,26,54,0.481,17,38,0.447,17,20,0.85,120
2398,MIA,2019-03-22,87,@,MIL,0,240,32,85,0.376,21,48,0.438,11,37,0.297,12,23,0.522,87,43,85,0.506,26,51,0.51,17,34,0.5,13,20,0.65,116
2399,MIA,2019-02-11,87,@,DEN,0,240,34,82,0.415,25,49,0.51,9,33,0.273,10,16,0.625,87,38,89,0.427,22,52,0.423,16,37,0.432,11,13,0.846,103
2400,DET,2019-01-21,87,@,WAS,0,240,31,77,0.403,20,43,0.465,11,34,0.324,14,18,0.778,87,36,79,0.456,28,56,0.5,8,23,0.348,21,27,0.778,101
2401,BRK,2018-12-28,87,@,CHO,0,240,33,83,0.398,29,56,0.518,4,27,0.148,17,20,0.85,87,41,100,0.41,30,67,0.448,11,33,0.333,7,10,0.7,100
2402,TOR,2018-12-28,87,@,ORL,0,240,28,95,0.295,16,61,0.262,12,34,0.353,19,24,0.792,87,44,93,0.473,35,67,0.522,9,26,0.346,19,22,0.864,116
2403,CLE,2018-12-26,87,@,MEM,0,240,33,93,0.355,24,64,0.375,9,29,0.31,12,15,0.8,87,36,72,0.5,31,50,0.62,5,22,0.227,18,24,0.75,95
2404,MIL,2018-12-22,87,@,MIA,0,240,31,84,0.369,22,41,0.537,9,43,0.209,16,22,0.727,87,34,89,0.382,24,57,0.421,10,32,0.313,16,23,0.696,94
2405,LAC,2018-12-13,87,@,SAS,0,240,30,84,0.357,20,53,0.377,10,31,0.323,17,24,0.708,87,48,83,0.578,38,61,0.623,10,22,0.455,19,24,0.792,125
2406,ORL,2018-11-23,87,@,DEN,0,240,32,79,0.405,24,47,0.511,8,32,0.25,15,19,0.789,87,44,93,0.473,35,65,0.538,9,28,0.321,15,17,0.882,112
2407,MIN,2018-11-18,87,,MEM,0,240,31,80,0.388,19,51,0.373,12,29,0.414,13,16,0.813,87,35,82,0.427,23,54,0.426,12,28,0.429,18,25,0.72,100
2408,DEN,2018-11-07,87,@,MEM,0,240,32,82,0.39,24,50,0.48,8,32,0.25,15,19,0.789,87,30,70,0.429,22,49,0.449,8,21,0.381,21,25,0.84,89
2409,NYK,2018-10-24,87,@,MIA,0,240,33,91,0.363,21,58,0.362,12,33,0.364,9,14,0.643,87,39,82,0.476,26,53,0.491,13,29,0.448,19,28,0.679,110
2410,PHI,2018-10-16,87,@,BOS,0,240,34,87,0.391,29,61,0.475,5,26,0.192,14,23,0.609,87,42,97,0.433,31,60,0.517,11,37,0.297,10,14,0.714,105
2411,CHI,2019-04-09,86,,NYK,0,240,30,83,0.361,23,61,0.377,7,22,0.318,19,29,0.655,86,37,93,0.398,23,53,0.434,14,40,0.35,8,13,0.615,96
2412,MIA,2019-01-15,86,@,MIL,0,240,36,86,0.419,28,52,0.538,8,34,0.235,6,8,0.75,86,48,96,0.5,31,57,0.544,17,39,0.436,11,18,0.611,124
2413,SAS,2019-01-09,86,@,MEM,0,240,30,83,0.361,19,56,0.339,11,27,0.407,15,23,0.652,86,37,90,0.411,29,57,0.509,8,33,0.242,14,20,0.7,96
2414,LAL,2019-01-06,86,@,MIN,0,240,32,87,0.368,27,65,0.415,5,22,0.227,17,28,0.607,86,41,89,0.461,30,57,0.526,11,32,0.344,15,21,0.714,108
2415,DET,2018-12-21,86,@,CHO,0,240,32,82,0.39,24,48,0.5,8,34,0.235,14,22,0.636,86,33,75,0.44,21,51,0.412,12,24,0.5,20,28,0.714,98
2416,TOR,2018-12-16,86,@,DEN,0,240,35,88,0.398,28,53,0.528,7,35,0.2,9,14,0.643,86,36,85,0.424,26,55,0.473,10,30,0.333,13,16,0.813,95
2417,PHO,2018-12-11,86,@,SAS,0,240,33,82,0.402,25,54,0.463,8,28,0.286,12,14,0.857,86,41,83,0.494,28,62,0.452,13,21,0.619,16,19,0.842,111
2418,PHO,2018-12-06,86,@,POR,0,240,35,91,0.385,30,64,0.469,5,27,0.185,11,14,0.786,86,41,85,0.482,32,58,0.552,9,27,0.333,17,27,0.63,108
2419,LAC,2018-12-05,86,@,MEM,0,240,25,74,0.338,17,51,0.333,8,23,0.348,28,35,0.8,86,37,85,0.435,30,57,0.526,7,28,0.25,15,24,0.625,96
2420,BOS,2018-11-17,86,,UTA,0,240,35,91,0.385,30,58,0.517,5,33,0.152,11,20,0.55,86,35,78,0.449,24,40,0.6,11,38,0.289,17,27,0.63,98
2421,GSW,2018-11-15,86,@,HOU,0,240,32,76,0.421,28,58,0.483,4,18,0.222,18,22,0.818,86,35,87,0.402,19,40,0.475,16,47,0.34,21,26,0.808,107
2422,SAC,2018-11-10,86,,LAL,0,240,32,92,0.348,26,67,0.388,6,25,0.24,16,20,0.8,86,41,99,0.414,29,61,0.475,12,38,0.316,7,17,0.412,101
2423,CLE,2018-11-07,86,,OKC,0,240,33,89,0.371,24,58,0.414,9,31,0.29,11,13,0.846,86,35,84,0.417,28,57,0.491,7,27,0.259,18,26,0.692,95
2424,CLE,2018-10-24,86,,BRK,0,240,34,89,0.382,31,71,0.437,3,18,0.167,15,16,0.938,86,38,87,0.437,24,53,0.453,14,34,0.412,12,15,0.8,102
2425,SAS,2019-04-03,85,@,DEN,0,240,31,81,0.383,26,54,0.481,5,27,0.185,18,25,0.72,85,47,87,0.54,35,54,0.648,12,33,0.364,7,12,0.583,113
2426,DEN,2019-03-28,85,@,HOU,0,240,31,84,0.369,27,60,0.45,4,24,0.167,19,20,0.95,85,40,87,0.46,25,47,0.532,15,40,0.375,17,20,0.85,112
2427,SAS,2019-02-25,85,@,BRK,0,240,35,96,0.365,31,72,0.431,4,24,0.167,11,12,0.917,85,35,81,0.432,16,31,0.516,19,50,0.38,12,16,0.75,101
2428,MEM,2019-01-21,85,,NOP,0,240,33,88,0.375,24,53,0.453,9,35,0.257,10,17,0.588,85,39,74,0.527,30,48,0.625,9,26,0.346,18,26,0.692,105
2429,PHO,2018-11-30,85,,ORL,0,240,34,84,0.405,27,56,0.482,7,28,0.25,10,14,0.714,85,39,82,0.476,31,55,0.564,8,27,0.296,13,18,0.722,99
2430,LAL,2018-11-27,85,@,DEN,0,240,34,87,0.391,29,52,0.558,5,35,0.143,12,18,0.667,85,47,97,0.485,38,72,0.528,9,25,0.36,14,15,0.933,117
2431,HOU,2018-10-30,85,,POR,0,240,31,96,0.323,21,53,0.396,10,43,0.233,13,23,0.565,85,38,80,0.475,30,60,0.5,8,20,0.4,20,23,0.87,104
2432,ATL,2018-10-27,85,,CHI,0,240,27,84,0.321,15,44,0.341,12,40,0.3,19,23,0.826,85,36,83,0.434,24,50,0.48,12,33,0.364,13,16,0.813,97
2433,CHO,2019-03-06,84,,MIA,0,240,30,82,0.366,16,46,0.348,14,36,0.389,10,15,0.667,84,38,90,0.422,29,64,0.453,9,26,0.346,6,11,0.545,91
2434,NYK,2019-02-03,84,,MEM,0,240,28,74,0.378,16,34,0.471,12,40,0.3,16,22,0.727,84,37,91,0.407,28,65,0.431,9,26,0.346,13,18,0.722,96
2435,CHO,2019-01-02,84,,DAL,0,240,32,90,0.356,26,58,0.448,6,32,0.188,14,19,0.737,84,44,95,0.463,26,50,0.52,18,45,0.4,16,18,0.889,122
2436,CHI,2019-01-02,84,,ORL,0,240,36,86,0.419,29,66,0.439,7,20,0.35,5,8,0.625,84,44,76,0.579,33,50,0.66,11,26,0.423,13,18,0.722,112
2437,MIA,2018-12-12,84,@,UTA,0,240,29,77,0.377,17,44,0.386,12,33,0.364,14,24,0.583,84,40,76,0.526,24,44,0.545,16,32,0.5,15,21,0.714,111
2438,UTA,2018-10-22,84,,MEM,0,240,29,82,0.354,21,50,0.42,8,32,0.25,18,23,0.783,84,31,84,0.369,22,56,0.393,9,28,0.321,21,26,0.808,92
2439,CHI,2019-03-23,83,,UTA,0,240,33,92,0.359,31,76,0.408,2,16,0.125,15,20,0.75,83,46,95,0.484,35,63,0.556,11,32,0.344,11,15,0.733,114
2440,NYK,2019-03-15,83,@,SAS,0,240,35,86,0.407,27,66,0.409,8,20,0.4,5,9,0.556,83,47,88,0.534,40,67,0.597,7,21,0.333,8,10,0.8,109
2441,MIL,2019-02-09,83,,ORL,0,240,31,95,0.326,25,60,0.417,6,35,0.171,15,18,0.833,83,44,94,0.468,34,67,0.507,10,27,0.37,5,6,0.833,103
2442,POR,2018-12-12,83,@,MEM,0,240,32,87,0.368,26,65,0.4,6,22,0.273,13,16,0.813,83,34,82,0.415,26,58,0.448,8,24,0.333,16,24,0.667,92
2443,DET,2018-12-03,83,,OKC,0,240,31,94,0.33,25,62,0.403,6,32,0.188,15,19,0.789,83,43,85,0.506,36,60,0.6,7,25,0.28,17,20,0.85,110
2444,CLE,2018-11-28,83,@,OKC,0,240,35,89,0.393,26,66,0.394,9,23,0.391,4,9,0.444,83,41,86,0.477,35,59,0.593,6,27,0.222,12,15,0.8,100
2445,UTA,2018-11-23,83,@,LAL,0,240,33,85,0.388,29,62,0.468,4,23,0.174,13,17,0.765,83,36,79,0.456,29,56,0.518,7,23,0.304,11,18,0.611,90
2446,CHI,2018-11-17,83,,TOR,0,240,30,86,0.349,22,59,0.373,8,27,0.296,15,21,0.714,83,48,89,0.539,34,54,0.63,14,35,0.4,12,13,0.923,122
2447,MEM,2018-10-17,83,@,IND,0,240,25,84,0.298,15,55,0.273,10,29,0.345,23,28,0.821,83,47,83,0.566,37,57,0.649,10,26,0.385,7,13,0.538,111
2448,MIA,2019-01-06,82,@,ATL,0,240,31,87,0.356,26,53,0.491,5,34,0.147,15,27,0.556,82,43,91,0.473,33,67,0.493,10,24,0.417,10,13,0.769,106
2449,CHI,2018-11-14,82,@,BOS,0,240,33,84,0.393,26,61,0.426,7,23,0.304,9,9,1.0,82,42,90,0.467,27,56,0.482,15,34,0.441,12,14,0.857,111
2450,PHO,2018-11-06,82,,BRK,0,240,28,81,0.346,19,56,0.339,9,25,0.36,17,20,0.85,82,41,92,0.446,32,56,0.571,9,36,0.25,13,19,0.684,104
2451,DAL,2019-03-02,81,,MEM,0,240,26,85,0.306,19,45,0.422,7,40,0.175,22,33,0.667,81,39,78,0.5,25,44,0.568,14,34,0.412,19,24,0.792,111
2452,MIN,2018-11-04,81,@,POR,0,240,29,93,0.312,22,63,0.349,7,30,0.233,16,21,0.762,81,38,86,0.442,31,58,0.534,7,28,0.25,28,32,0.875,111
2453,ORL,2018-12-21,80,@,CHI,0,240,28,86,0.326,20,53,0.377,8,33,0.242,16,24,0.667,80,33,75,0.44,28,58,0.483,5,17,0.294,19,26,0.731,90
2454,HOU,2018-11-08,80,@,OKC,0,240,31,82,0.378,20,40,0.5,11,42,0.262,7,10,0.7,80,36,81,0.444,27,44,0.614,9,37,0.243,17,24,0.708,98
2455,CHI,2018-12-08,77,,BOS,0,240,31,81,0.383,25,57,0.439,6,24,0.25,9,14,0.643,77,50,93,0.538,28,50,0.56,22,43,0.512,11,15,0.733,133
2456,ORL,2018-12-10,76,@,DAL,0,240,32,89,0.36,24,61,0.393,8,28,0.286,4,5,0.8,76,35,82,0.427,25,47,0.532,10,35,0.286,21,25,0.84,101
2457,CHO,2019-03-17,75,@,MIA,0,240,26,83,0.313,19,47,0.404,7,36,0.194,16,18,0.889,75,34,86,0.395,21,53,0.396,13,33,0.394,12,19,0.632,93
2458,DET,2019-03-11,75,@,BRK,0,240,27,97,0.278,19,63,0.302,8,34,0.235,13,16,0.813,75,39,79,0.494,28,48,0.583,11,31,0.355,14,22,0.636,103
2459,DET,2019-03-13,74,@,MIA,0,240,27,77,0.351,19,40,0.475,8,37,0.216,12,18,0.667,74,39,84,0.464,28,56,0.5,11,28,0.393,19,24,0.792,108
2460,UTA,2018-11-14,68,@,DAL,0,240,25,81,0.309,19,46,0.413,6,35,0.171,12,19,0.632,68,45,77,0.584,33,49,0.673,12,28,0.429,16,24,0.667,118
