Rk,Team,Date,PTS,Unnamed: 4,Opp,Result,MP,FG,FGA,FG%,2P,2PA,2P%,3P,3PA,3P%,FT,FTA,FT%,PTS.1,FG.1,FGA.1,FG%.1,2P.1,2PA.1,2P%.1,3P.1,3PA.1,3P%.1,FT.1,FTA.1,FT%.1,PTS.2
1,DAL,4/10/2015,144,@,DEN,1,290,57,109,0.523,46,80,0.575,11,29,0.379,19,24,0.792,144,53,125,0.424,38,82,0.463,15,43,0.349,22,25,0.88,143
2,DEN,4/10/2015,143,,DAL,0,290,53,125,0.424,38,82,0.463,15,43,0.349,22,25,0.88,143,57,109,0.523,46,80,0.575,11,29,0.379,19,24,0.792,144
3,DAL,11/21/2014,140,,LAL,1,240,51,82,0.622,33,47,0.702,18,35,0.514,20,28,0.714,140,44,85,0.518,39,72,0.542,5,13,0.385,13,21,0.619,106
4,NOP,11/14/2014,139,,MIN,1,240,56,84,0.667,41,64,0.641,15,20,0.75,12,16,0.75,139,29,72,0.403,26,58,0.448,3,14,0.214,30,41,0.732,91
5,OKC,4/15/2015,138,@,MIN,1,240,52,95,0.547,40,67,0.597,12,28,0.429,22,31,0.71,138,39,84,0.464,33,65,0.508,6,19,0.316,29,35,0.829,113
6,OKC,12/31/2014,137,,PHO,1,265,41,99,0.414,30,64,0.469,11,35,0.314,44,49,0.898,137,46,90,0.511,33,63,0.524,13,27,0.481,29,35,0.829,134
7,GSW,11/16/2014,136,@,LAL,1,240,46,86,0.535,32,58,0.552,14,28,0.5,30,34,0.882,136,39,99,0.394,36,83,0.434,3,16,0.188,34,43,0.791,115
8,DAL,4/1/2015,135,@,OKC,1,240,56,91,0.615,52,76,0.684,4,15,0.267,19,24,0.792,135,45,93,0.484,31,62,0.5,14,31,0.452,27,33,0.818,131
9,SAC,12/27/2014,135,,NYK,1,265,49,89,0.551,41,73,0.562,8,16,0.5,29,33,0.879,135,48,97,0.495,42,77,0.545,6,20,0.3,27,32,0.844,129
10,PHO,12/31/2014,134,@,OKC,0,265,46,90,0.511,33,63,0.524,13,27,0.481,29,35,0.829,134,41,99,0.414,30,64,0.469,11,35,0.314,44,49,0.898,137
11,GSW,4/15/2015,133,,DEN,1,240,47,90,0.522,34,62,0.548,13,28,0.464,26,34,0.765,133,45,83,0.542,39,65,0.6,6,18,0.333,30,36,0.833,126
12,WAS,12/8/2014,133,,BOS,1,290,49,94,0.521,42,78,0.538,7,16,0.438,28,34,0.824,133,47,102,0.461,38,80,0.475,9,22,0.409,29,32,0.906,132
13,BOS,12/8/2014,132,@,WAS,0,290,47,102,0.461,38,80,0.475,9,22,0.409,29,32,0.906,132,49,94,0.521,42,78,0.538,7,16,0.438,28,34,0.824,133
14,DAL,12/2/2014,132,@,CHI,1,290,47,102,0.461,32,72,0.444,15,30,0.5,23,27,0.852,132,47,103,0.456,39,77,0.506,8,26,0.308,27,34,0.794,129
15,ATL,4/4/2015,131,,BRK,1,240,49,82,0.598,32,49,0.653,17,33,0.515,16,19,0.842,131,39,80,0.488,29,57,0.509,10,23,0.435,11,17,0.647,99
16,OKC,4/1/2015,131,,DAL,0,240,45,93,0.484,31,62,0.5,14,31,0.452,27,33,0.818,131,56,91,0.615,52,76,0.684,4,15,0.267,19,24,0.792,135
17,OKC,2/8/2015,131,,LAC,1,240,46,88,0.523,38,68,0.559,8,20,0.4,31,38,0.816,131,42,90,0.467,30,58,0.517,12,32,0.375,12,17,0.706,108
18,GSW,1/17/2015,131,@,HOU,1,240,50,91,0.549,41,69,0.594,9,22,0.409,22,33,0.667,131,37,88,0.42,30,65,0.462,7,23,0.304,25,34,0.735,106
19,DAL,11/15/2014,131,,MIN,1,240,52,94,0.553,44,68,0.647,8,26,0.308,19,23,0.826,131,43,86,0.5,36,69,0.522,7,17,0.412,24,29,0.828,117
20,SAC,11/5/2014,131,,DEN,1,240,42,76,0.553,34,56,0.607,8,20,0.4,39,50,0.78,131,37,82,0.451,28,54,0.519,9,28,0.321,26,31,0.839,109
21,SAS,3/25/2015,130,,OKC,1,240,51,88,0.58,38,67,0.567,13,21,0.619,15,19,0.789,130,36,90,0.4,30,72,0.417,6,18,0.333,13,14,0.929,91
22,ATL,3/9/2015,130,,SAC,1,240,53,88,0.602,33,52,0.635,20,36,0.556,4,7,0.571,130,39,81,0.481,31,61,0.508,8,20,0.4,19,20,0.95,105
23,POR,11/12/2014,130,@,DEN,1,240,45,88,0.511,29,55,0.527,16,33,0.485,24,29,0.828,130,39,90,0.433,31,67,0.463,8,23,0.348,27,33,0.818,113
24,BRK,3/20/2015,129,,MIL,1,315,46,107,0.43,35,82,0.427,11,25,0.44,26,34,0.765,129,49,129,0.38,41,113,0.363,8,16,0.5,21,29,0.724,127
25,DAL,3/13/2015,129,,LAC,1,240,51,84,0.607,35,56,0.625,16,28,0.571,11,16,0.688,129,41,82,0.5,29,50,0.58,12,32,0.375,5,12,0.417,99
26,CLE,1/23/2015,129,,CHO,1,240,46,89,0.517,31,61,0.508,15,28,0.536,22,28,0.786,129,36,89,0.404,34,73,0.466,2,16,0.125,16,24,0.667,90
27,NYK,12/27/2014,129,@,SAC,0,265,48,97,0.495,42,77,0.545,6,20,0.3,27,32,0.844,129,49,89,0.551,41,73,0.562,8,16,0.5,29,33,0.879,135
28,CHI,12/22/2014,129,,TOR,1,240,40,74,0.541,34,62,0.548,6,12,0.5,43,47,0.915,129,44,100,0.44,35,70,0.5,9,30,0.3,23,32,0.719,120
29,POR,12/19/2014,129,@,SAS,1,315,47,110,0.427,34,75,0.453,13,35,0.371,22,23,0.957,129,45,109,0.413,37,89,0.416,8,20,0.4,21,26,0.808,119
30,CHI,12/2/2014,129,,DAL,0,290,47,103,0.456,39,77,0.506,8,26,0.308,27,34,0.794,129,47,102,0.461,32,72,0.444,15,30,0.5,23,27,0.852,132
31,LAL,11/30/2014,129,,TOR,1,265,47,96,0.49,37,72,0.514,10,24,0.417,25,34,0.735,129,45,104,0.433,36,70,0.514,9,34,0.265,23,31,0.742,122
32,CLE,3/12/2015,128,@,SAS,1,265,44,91,0.484,30,65,0.462,14,26,0.538,26,30,0.867,128,49,87,0.563,41,61,0.672,8,26,0.308,19,27,0.704,125
33,GSW,2/4/2015,128,,DAL,1,240,45,86,0.523,26,48,0.542,19,38,0.5,19,25,0.76,128,41,98,0.418,31,68,0.456,10,30,0.333,22,28,0.786,114
34,DET,1/21/2015,128,,ORL,1,240,49,94,0.521,39,70,0.557,10,24,0.417,20,24,0.833,128,48,97,0.495,42,82,0.512,6,15,0.4,16,16,1,118
35,GSW,12/22/2014,128,,SAC,1,240,49,91,0.538,40,66,0.606,9,25,0.36,21,24,0.875,128,43,90,0.478,35,73,0.479,8,17,0.471,14,21,0.667,108
36,GSW,12/14/2014,128,@,NOP,1,265,44,86,0.512,33,62,0.532,11,24,0.458,29,35,0.829,128,47,101,0.465,39,74,0.527,8,27,0.296,20,25,0.8,122
37,OKC,3/24/2015,127,,LAL,1,240,48,86,0.558,37,65,0.569,11,21,0.524,20,23,0.87,127,44,85,0.518,35,66,0.53,9,19,0.474,20,27,0.741,117
38,MIL,3/20/2015,127,@,BRK,0,315,49,129,0.38,41,113,0.363,8,16,0.5,21,29,0.724,127,46,107,0.43,35,82,0.427,11,25,0.44,26,34,0.765,129
39,CLE,3/10/2015,127,@,DAL,1,240,44,87,0.506,29,55,0.527,15,32,0.469,24,29,0.828,127,33,81,0.407,28,61,0.459,5,20,0.25,23,33,0.697,94
40,CLE,2/20/2015,127,@,WAS,1,240,46,90,0.511,32,57,0.561,14,33,0.424,21,28,0.75,127,38,86,0.442,37,70,0.529,1,16,0.063,12,16,0.75,89
41,HOU,2/10/2015,127,@,PHO,1,240,48,95,0.505,33,58,0.569,15,37,0.405,16,23,0.696,127,41,87,0.471,29,61,0.475,12,26,0.462,24,30,0.8,118
42,TOR,1/30/2015,127,@,BRK,1,265,47,92,0.511,40,66,0.606,7,26,0.269,26,30,0.867,127,49,101,0.485,45,82,0.549,4,19,0.211,20,26,0.769,122
43,OKC,1/18/2015,127,@,ORL,1,240,48,83,0.578,39,58,0.672,9,25,0.36,22,32,0.688,127,35,88,0.398,27,65,0.415,8,23,0.348,21,27,0.778,99
44,OKC,1/16/2015,127,,GSW,1,240,51,97,0.526,41,75,0.547,10,22,0.455,15,19,0.789,127,42,92,0.457,33,68,0.485,9,24,0.375,22,28,0.786,115
45,LAC,1/3/2015,127,,PHI,1,240,46,85,0.541,31,48,0.646,15,37,0.405,20,26,0.769,127,32,79,0.405,23,54,0.426,9,25,0.36,18,26,0.692,91
46,ATL,12/17/2014,127,@,CLE,1,240,49,76,0.645,33,48,0.688,16,28,0.571,13,16,0.813,127,37,82,0.451,29,52,0.558,8,30,0.267,16,21,0.762,98
47,LAC,12/1/2014,127,,MIN,1,240,41,80,0.513,26,46,0.565,15,34,0.441,30,36,0.833,127,35,82,0.427,33,70,0.471,2,12,0.167,29,40,0.725,101
48,CLE,11/15/2014,127,,ATL,1,240,49,90,0.544,30,59,0.508,19,31,0.613,10,13,0.769,127,40,90,0.444,37,68,0.544,3,22,0.136,11,13,0.846,94
49,GSW,11/1/2014,127,,LAL,1,240,46,83,0.554,35,60,0.583,11,23,0.478,24,28,0.857,127,41,88,0.466,37,74,0.5,4,14,0.286,18,25,0.72,104
50,DEN,4/15/2015,126,@,GSW,0,240,45,83,0.542,39,65,0.6,6,18,0.333,30,36,0.833,126,47,90,0.522,34,62,0.548,13,28,0.464,26,34,0.765,133
51,LAC,4/1/2015,126,@,POR,1,240,46,86,0.535,31,58,0.534,15,28,0.536,19,24,0.792,126,45,89,0.506,32,64,0.5,13,25,0.52,19,25,0.76,122
52,LAC,2/21/2015,126,,SAC,1,240,46,95,0.484,32,60,0.533,14,35,0.4,20,28,0.714,126,30,88,0.341,26,72,0.361,4,16,0.25,35,46,0.761,99
53,GSW,1/23/2015,126,,SAC,1,240,45,94,0.479,28,54,0.519,17,40,0.425,19,22,0.864,126,34,82,0.415,30,65,0.462,4,17,0.235,29,34,0.853,101
54,GSW,1/21/2015,126,,HOU,1,240,49,98,0.5,36,69,0.522,13,29,0.448,15,18,0.833,126,37,87,0.425,24,55,0.436,13,32,0.406,26,31,0.839,113
55,CLE,1/16/2015,126,@,LAC,1,240,46,83,0.554,36,60,0.6,10,23,0.435,24,31,0.774,126,43,91,0.473,33,62,0.532,10,29,0.345,25,36,0.694,121
56,GSW,1/2/2015,126,,TOR,1,240,49,92,0.533,37,64,0.578,12,28,0.429,16,20,0.8,126,40,86,0.465,30,61,0.492,10,25,0.4,15,20,0.75,105
57,GSW,12/30/2014,126,,PHI,1,240,46,82,0.561,34,54,0.63,12,28,0.429,22,27,0.815,126,33,86,0.384,27,66,0.409,6,20,0.3,14,23,0.609,86
58,TOR,11/26/2014,126,@,ATL,1,240,42,82,0.512,28,53,0.528,14,29,0.483,28,33,0.848,126,42,82,0.512,32,58,0.552,10,24,0.417,21,24,0.875,115
59,GSW,3/14/2015,125,,NYK,1,240,45,90,0.5,26,56,0.464,19,34,0.559,16,17,0.941,125,38,96,0.396,29,71,0.408,9,25,0.36,9,16,0.563,94
60,SAS,3/12/2015,125,,CLE,0,265,49,87,0.563,41,61,0.672,8,26,0.308,19,27,0.704,125,44,91,0.484,30,65,0.462,14,26,0.538,26,30,0.867,128
61,PHO,1/4/2015,125,,TOR,1,240,48,89,0.539,40,66,0.606,8,23,0.348,21,28,0.75,125,38,83,0.458,29,57,0.509,9,26,0.346,24,29,0.828,109
62,CLE,12/23/2014,125,,MIN,1,240,44,84,0.524,32,60,0.533,12,24,0.5,25,31,0.806,125,39,88,0.443,35,75,0.467,4,13,0.308,22,29,0.759,104
63,SAS,12/22/2014,125,,LAC,1,240,49,77,0.636,36,54,0.667,13,23,0.565,14,22,0.636,125,43,86,0.5,33,62,0.532,10,24,0.417,22,29,0.759,118
64,DAL,12/7/2014,125,,MIL,1,240,49,84,0.583,37,53,0.698,12,31,0.387,15,19,0.789,125,42,84,0.5,38,69,0.551,4,15,0.267,14,17,0.824,102
65,SAC,3/3/2015,124,@,NYK,1,240,41,83,0.494,31,65,0.477,10,18,0.556,32,37,0.865,124,30,82,0.366,26,60,0.433,4,22,0.182,22,30,0.733,86
66,OKC,2/9/2015,124,@,DEN,1,240,43,80,0.538,31,56,0.554,12,24,0.5,26,35,0.743,124,42,87,0.483,33,59,0.559,9,28,0.321,21,29,0.724,114
67,ATL,2/6/2015,124,,GSW,1,240,38,77,0.494,23,50,0.46,15,27,0.556,33,37,0.892,124,47,103,0.456,35,70,0.5,12,33,0.364,10,15,0.667,116
68,PHO,12/23/2014,124,,DAL,1,240,44,97,0.454,31,64,0.484,13,33,0.394,23,32,0.719,124,41,88,0.466,32,63,0.508,9,25,0.36,24,29,0.828,115
69,TOR,11/21/2014,124,,MIL,1,240,45,86,0.523,30,61,0.492,15,25,0.6,19,24,0.792,124,27,74,0.365,21,54,0.389,6,20,0.3,22,32,0.688,82
70,GSW,4/4/2015,123,@,DAL,1,240,43,95,0.453,29,59,0.492,14,36,0.389,23,32,0.719,123,34,80,0.425,31,64,0.484,3,16,0.188,39,54,0.722,110
71,SAS,4/3/2015,123,,DEN,1,240,47,85,0.553,33,51,0.647,14,34,0.412,15,17,0.882,123,40,87,0.46,34,70,0.486,6,17,0.353,7,11,0.636,93
72,BRK,3/21/2015,123,@,IND,1,240,46,75,0.613,40,63,0.635,6,12,0.5,25,31,0.806,123,45,90,0.5,37,67,0.552,8,23,0.348,13,18,0.722,111
73,OKC,3/20/2015,123,,ATL,1,240,43,84,0.512,30,54,0.556,13,30,0.433,24,26,0.923,123,41,82,0.5,28,53,0.528,13,29,0.448,20,25,0.8,115
74,SAS,3/15/2015,123,,MIN,1,240,49,84,0.583,37,62,0.597,12,22,0.545,13,15,0.867,123,38,86,0.442,31,71,0.437,7,15,0.467,14,18,0.778,97
75,CLE,3/15/2015,123,@,ORL,1,240,45,76,0.592,27,41,0.659,18,35,0.514,15,19,0.789,123,42,88,0.477,33,69,0.478,9,19,0.474,15,27,0.556,108
76,OKC,3/4/2015,123,,PHI,1,265,44,96,0.458,37,75,0.493,7,21,0.333,28,34,0.824,123,34,96,0.354,19,61,0.311,15,35,0.429,35,44,0.795,118
77,TOR,2/6/2015,123,,LAC,1,240,40,75,0.533,27,45,0.6,13,30,0.433,30,37,0.811,123,38,78,0.487,32,55,0.582,6,23,0.261,25,31,0.806,107
78,LAL,1/29/2015,123,,CHI,1,290,50,106,0.472,47,97,0.485,3,9,0.333,20,25,0.8,123,43,104,0.413,37,79,0.468,6,25,0.24,26,32,0.813,118
79,LAC,1/22/2015,123,,BRK,1,240,49,83,0.59,38,58,0.655,11,25,0.44,14,21,0.667,123,33,88,0.375,29,67,0.433,4,21,0.19,14,25,0.56,84
80,SAS,12/6/2014,123,,MIN,1,240,47,82,0.573,40,64,0.625,7,18,0.389,22,25,0.88,123,35,83,0.422,29,67,0.433,6,16,0.375,25,32,0.781,101
81,TOR,12/3/2014,123,@,UTA,1,240,45,79,0.57,33,58,0.569,12,21,0.571,21,24,0.875,123,42,87,0.483,34,59,0.576,8,28,0.286,12,15,0.8,104
82,DAL,11/13/2014,123,,PHI,1,240,41,80,0.513,30,48,0.625,11,32,0.344,30,36,0.833,123,23,77,0.299,16,50,0.32,7,27,0.259,17,33,0.515,70
83,SAC,4/15/2015,122,@,LAL,1,240,46,84,0.548,38,67,0.567,8,17,0.471,22,41,0.537,122,36,94,0.383,29,70,0.414,7,24,0.292,20,25,0.8,99
84,DEN,4/12/2015,122,,SAC,1,240,45,82,0.549,36,56,0.643,9,26,0.346,23,30,0.767,122,38,74,0.514,33,56,0.589,5,18,0.278,30,42,0.714,111
85,POR,4/1/2015,122,,LAC,0,240,45,89,0.506,32,64,0.5,13,25,0.52,19,25,0.76,122,46,86,0.535,31,58,0.534,15,28,0.536,19,24,0.792,126
86,GSW,3/24/2015,122,@,POR,1,240,50,83,0.602,38,57,0.667,12,26,0.462,10,11,0.909,122,39,92,0.424,24,58,0.414,15,34,0.441,15,19,0.789,108
87,OKC,3/18/2015,122,,BOS,1,240,42,88,0.477,37,69,0.536,5,19,0.263,33,39,0.846,122,44,84,0.524,31,50,0.62,13,34,0.382,17,28,0.607,118
88,BRK,3/16/2015,122,@,MIN,1,240,52,90,0.578,47,77,0.61,5,13,0.385,13,17,0.765,122,41,88,0.466,32,73,0.438,9,15,0.6,15,17,0.882,106
89,BRK,1/30/2015,122,,TOR,0,265,49,101,0.485,45,82,0.549,4,19,0.211,20,26,0.769,122,47,92,0.511,40,66,0.606,7,26,0.269,26,30,0.867,127
90,GSW,1/19/2015,122,,DEN,1,240,44,81,0.543,31,54,0.574,13,27,0.481,21,27,0.778,122,30,87,0.345,23,63,0.365,7,24,0.292,12,19,0.632,79
91,MEM,1/11/2015,122,,PHO,1,290,48,100,0.48,39,79,0.494,9,21,0.429,17,24,0.708,122,42,100,0.42,34,65,0.523,8,35,0.229,18,23,0.783,110
92,NOP,12/14/2014,122,,GSW,0,265,47,101,0.465,39,74,0.527,8,27,0.296,20,25,0.8,122,44,86,0.512,33,62,0.532,11,24,0.458,29,35,0.829,128
93,TOR,11/30/2014,122,@,LAL,0,265,45,104,0.433,36,70,0.514,9,34,0.265,23,31,0.742,122,47,96,0.49,37,72,0.514,10,24,0.417,25,34,0.735,129
94,DEN,11/28/2014,122,,PHO,1,240,41,88,0.466,33,67,0.493,8,21,0.381,32,36,0.889,122,33,85,0.388,25,62,0.403,8,23,0.348,23,29,0.793,97
95,PHO,11/21/2014,122,@,PHI,1,240,44,86,0.512,31,55,0.564,13,31,0.419,21,23,0.913,122,36,78,0.462,32,55,0.582,4,23,0.174,20,33,0.606,96
96,MIL,11/19/2014,122,@,BRK,1,315,48,108,0.444,43,84,0.512,5,24,0.208,21,28,0.75,122,44,92,0.478,35,61,0.574,9,31,0.29,21,29,0.724,118
97,CLE,11/14/2014,122,@,BOS,1,240,43,85,0.506,35,62,0.565,8,23,0.348,28,37,0.757,122,48,88,0.545,42,68,0.618,6,20,0.3,19,23,0.826,121
98,CHO,11/7/2014,122,,ATL,1,290,48,97,0.495,42,76,0.553,6,21,0.286,20,27,0.741,122,43,93,0.462,30,60,0.5,13,33,0.394,20,26,0.769,119
99,HOU,4/12/2015,121,,NOP,1,240,39,73,0.534,30,49,0.612,9,24,0.375,34,48,0.708,121,44,91,0.484,33,64,0.516,11,27,0.407,15,22,0.682,114
100,MIN,3/7/2015,121,,POR,1,240,46,85,0.541,42,78,0.538,4,7,0.571,25,31,0.806,121,43,88,0.489,29,61,0.475,14,27,0.519,13,17,0.765,113
101,NYK,2/27/2015,121,@,DET,1,290,45,109,0.413,39,91,0.429,6,18,0.333,25,26,0.962,121,39,97,0.402,31,66,0.47,8,31,0.258,29,40,0.725,115
102,GSW,2/3/2015,121,@,SAC,1,240,46,91,0.505,36,68,0.529,10,23,0.435,19,26,0.731,121,35,79,0.443,28,63,0.444,7,16,0.438,19,24,0.792,96
103,LAC,1/16/2015,121,,CLE,0,240,43,91,0.473,33,62,0.532,10,29,0.345,25,36,0.694,121,46,83,0.554,36,60,0.6,10,23,0.435,24,31,0.774,126
104,ORL,1/12/2015,121,@,CHI,1,240,48,81,0.593,41,63,0.651,7,18,0.389,18,29,0.621,121,41,84,0.488,33,57,0.579,8,27,0.296,24,33,0.727,114
105,LAC,12/8/2014,121,,PHO,1,265,44,96,0.458,35,65,0.538,9,31,0.29,24,30,0.8,121,44,91,0.484,28,54,0.519,16,37,0.432,16,20,0.8,120
106,SAS,11/21/2014,121,@,MIN,1,240,46,84,0.548,33,63,0.524,13,21,0.619,16,18,0.889,121,37,90,0.411,33,77,0.429,4,13,0.308,14,22,0.636,92
107,BOS,11/14/2014,121,,CLE,0,240,48,88,0.545,42,68,0.618,6,20,0.3,19,23,0.826,121,43,85,0.506,35,62,0.565,8,23,0.348,28,37,0.757,122
108,GSW,11/5/2014,121,,LAC,1,240,43,74,0.581,28,49,0.571,15,25,0.6,20,20,1,121,38,82,0.463,31,63,0.492,7,19,0.368,21,27,0.778,104
109,BOS,10/29/2014,121,,BRK,1,240,49,88,0.557,41,66,0.621,8,22,0.364,15,23,0.652,121,39,80,0.488,32,61,0.525,7,19,0.368,20,26,0.769,105
110,DAL,4/12/2015,120,@,LAL,1,240,45,83,0.542,35,62,0.565,10,21,0.476,20,26,0.769,120,34,78,0.436,25,54,0.463,9,24,0.375,29,36,0.806,106
111,POR,3/28/2015,120,,DEN,1,240,48,85,0.565,40,67,0.597,8,18,0.444,16,18,0.889,120,43,92,0.467,34,68,0.5,9,24,0.375,19,22,0.864,114
112,HOU,3/27/2015,120,,MIN,1,240,44,83,0.53,24,39,0.615,20,44,0.455,12,17,0.706,120,37,76,0.487,31,62,0.5,6,14,0.429,30,34,0.882,110
113,LAC,3/11/2015,120,@,OKC,1,240,35,76,0.461,20,46,0.435,15,30,0.5,35,47,0.745,120,33,76,0.434,21,51,0.412,12,25,0.48,30,36,0.833,108
114,SAS,3/6/2015,120,,DEN,1,240,43,79,0.544,34,55,0.618,9,24,0.375,25,33,0.758,120,45,86,0.523,39,69,0.565,6,17,0.353,15,23,0.652,111
115,CLE,3/4/2015,120,@,TOR,1,240,40,78,0.513,25,42,0.595,15,36,0.417,25,34,0.735,120,43,79,0.544,33,58,0.569,10,21,0.476,16,17,0.941,112
116,CLE,2/8/2015,120,,LAL,1,240,45,82,0.549,27,49,0.551,18,33,0.545,12,20,0.6,120,41,100,0.41,34,77,0.442,7,23,0.304,16,19,0.842,105
117,TOR,1/31/2015,120,@,WAS,1,265,44,88,0.5,33,62,0.532,11,26,0.423,21,30,0.7,120,37,79,0.468,27,55,0.491,10,24,0.417,32,41,0.78,116
118,LAC,1/25/2015,120,@,PHO,1,240,43,87,0.494,33,64,0.516,10,23,0.435,24,36,0.667,120,34,80,0.425,24,51,0.471,10,29,0.345,22,27,0.815,100
119,ORL,1/14/2015,120,,HOU,1,240,44,90,0.489,35,64,0.547,9,26,0.346,23,26,0.885,120,42,83,0.506,33,57,0.579,9,26,0.346,20,23,0.87,113
120,ATL,1/11/2015,120,,WAS,1,240,42,89,0.472,26,58,0.448,16,31,0.516,20,24,0.833,120,36,76,0.474,31,56,0.554,5,20,0.25,12,15,0.8,89
121,LAC,1/10/2015,120,,DAL,1,240,46,88,0.523,33,57,0.579,13,31,0.419,15,21,0.714,120,38,86,0.442,26,56,0.464,12,30,0.4,12,17,0.706,100
122,HOU,1/8/2015,120,@,NYK,1,240,41,77,0.532,25,41,0.61,16,36,0.444,22,32,0.688,120,37,80,0.463,26,54,0.481,11,26,0.423,11,21,0.524,96
123,TOR,12/22/2014,120,@,CHI,0,240,44,100,0.44,35,70,0.5,9,30,0.3,23,32,0.719,120,40,74,0.541,34,62,0.548,6,12,0.5,43,47,0.915,129
124,MEM,12/13/2014,120,@,PHI,1,265,45,93,0.484,34,67,0.507,11,26,0.423,19,27,0.704,120,40,82,0.488,29,54,0.537,11,28,0.393,24,34,0.706,115
125,PHO,12/8/2014,120,@,LAC,0,265,44,91,0.484,28,54,0.519,16,37,0.432,16,20,0.8,120,44,96,0.458,35,65,0.538,9,31,0.29,24,30,0.8,121
126,LAC,12/6/2014,120,,NOP,1,240,43,78,0.551,26,46,0.565,17,32,0.531,17,24,0.708,120,38,80,0.475,30,57,0.526,8,23,0.348,16,25,0.64,100
127,MIN,11/28/2014,120,@,LAL,1,240,45,79,0.57,35,61,0.574,10,18,0.556,20,24,0.833,120,48,89,0.539,40,68,0.588,8,21,0.381,15,22,0.682,119
128,PHO,11/26/2014,120,,DEN,1,240,45,88,0.511,32,63,0.508,13,25,0.52,17,21,0.81,120,39,90,0.433,31,65,0.477,8,25,0.32,26,34,0.765,112
129,LAC,11/15/2014,120,,PHO,1,240,36,68,0.529,22,39,0.564,14,29,0.483,34,43,0.791,120,38,99,0.384,27,69,0.391,11,30,0.367,20,23,0.87,107
130,TOR,11/9/2014,120,,PHI,1,240,43,76,0.566,36,59,0.61,7,17,0.412,27,30,0.9,120,33,87,0.379,23,53,0.434,10,34,0.294,12,18,0.667,88
131,DAL,10/30/2014,120,,UTA,1,240,47,85,0.553,39,64,0.609,8,21,0.381,18,23,0.783,120,36,83,0.434,22,48,0.458,14,35,0.4,16,18,0.889,102
132,DEN,4/8/2015,119,,LAL,1,240,44,88,0.5,31,58,0.534,13,30,0.433,18,24,0.75,119,36,75,0.48,31,59,0.525,5,16,0.313,24,35,0.686,101
133,WAS,4/8/2015,119,@,PHI,1,240,47,72,0.653,39,57,0.684,8,15,0.533,17,23,0.739,119,31,89,0.348,22,62,0.355,9,27,0.333,19,27,0.704,90
134,LAC,3/29/2015,119,@,BOS,1,240,41,84,0.488,28,52,0.538,13,32,0.406,24,40,0.6,119,39,93,0.419,31,62,0.5,8,31,0.258,20,23,0.87,106
135,LAC,3/27/2015,119,@,PHI,1,240,44,82,0.537,32,53,0.604,12,29,0.414,19,31,0.613,119,36,86,0.419,25,55,0.455,11,31,0.355,15,27,0.556,98
136,DEN,3/22/2015,119,@,ORL,1,240,42,90,0.467,30,62,0.484,12,28,0.429,23,30,0.767,119,41,85,0.482,37,68,0.544,4,17,0.235,14,17,0.824,100
137,DAL,3/16/2015,119,,OKC,1,240,42,89,0.472,32,64,0.5,10,25,0.4,25,35,0.714,119,40,90,0.444,33,64,0.516,7,26,0.269,28,35,0.8,115
138,ORL,3/6/2015,119,,SAC,1,240,48,85,0.565,35,61,0.574,13,24,0.542,10,12,0.833,119,38,85,0.447,28,58,0.483,10,27,0.37,28,38,0.737,114
139,MIA,2/23/2015,119,,PHI,1,240,46,83,0.554,35,62,0.565,11,21,0.524,16,22,0.727,119,40,84,0.476,27,53,0.509,13,31,0.419,15,28,0.536,108
140,OKC,2/22/2015,119,,DEN,1,240,48,92,0.522,40,72,0.556,8,20,0.4,15,23,0.652,119,35,97,0.361,28,70,0.4,7,27,0.259,17,20,0.85,94
141,LAC,2/19/2015,119,,SAS,1,240,42,77,0.545,34,58,0.586,8,19,0.421,27,52,0.519,119,43,84,0.512,33,56,0.589,10,28,0.357,19,23,0.826,115
142,TOR,1/28/2015,119,,SAC,1,240,43,84,0.512,26,50,0.52,17,34,0.5,16,19,0.842,119,35,73,0.479,28,56,0.5,7,17,0.412,25,29,0.862,102
143,CHI,1/16/2015,119,@,BOS,1,240,48,89,0.539,35,64,0.547,13,25,0.52,10,12,0.833,119,42,85,0.494,37,69,0.536,5,16,0.313,14,16,0.875,103
144,DAL,1/2/2015,119,@,BOS,1,240,45,96,0.469,32,69,0.464,13,27,0.481,16,17,0.941,119,38,89,0.427,26,55,0.473,12,34,0.353,13,19,0.684,101
145,DET,12/26/2014,119,,IND,1,240,47,86,0.547,37,60,0.617,10,26,0.385,15,29,0.517,119,42,83,0.506,33,63,0.524,9,20,0.45,16,22,0.727,109
146,SAS,12/19/2014,119,,POR,0,315,45,109,0.413,37,89,0.416,8,20,0.4,21,26,0.808,119,47,110,0.427,34,75,0.453,13,35,0.371,22,23,0.957,129
147,NOP,12/16/2014,119,,UTA,1,240,47,79,0.595,39,63,0.619,8,16,0.5,17,18,0.944,119,45,90,0.5,40,75,0.533,5,15,0.333,16,19,0.842,111
148,NOP,12/12/2014,119,,CLE,1,240,44,79,0.557,32,51,0.627,12,28,0.429,19,25,0.76,119,44,89,0.494,36,67,0.537,8,22,0.364,18,23,0.783,114
149,WAS,12/5/2014,119,,DEN,1,240,45,85,0.529,38,65,0.585,7,20,0.35,22,27,0.815,119,31,82,0.378,26,60,0.433,5,22,0.227,22,30,0.733,89
150,LAL,11/28/2014,119,,MIN,0,240,48,89,0.539,40,68,0.588,8,21,0.381,15,22,0.682,119,45,79,0.57,35,61,0.574,10,18,0.556,20,24,0.833,120
151,MEM,11/17/2014,119,,HOU,1,240,46,86,0.535,39,69,0.565,7,17,0.412,20,22,0.909,119,34,78,0.436,26,44,0.591,8,34,0.235,17,21,0.81,93
152,ATL,11/7/2014,119,@,CHO,0,290,43,93,0.462,30,60,0.5,13,33,0.394,20,26,0.769,119,48,97,0.495,42,76,0.553,6,21,0.286,20,27,0.741,122
153,PHO,10/29/2014,119,,LAL,1,240,45,82,0.549,29,50,0.58,16,32,0.5,13,18,0.722,119,37,86,0.43,33,73,0.452,4,13,0.308,21,25,0.84,99
154,HOU,3/19/2015,118,,DEN,1,240,37,83,0.446,25,53,0.472,12,30,0.4,32,40,0.8,118,42,93,0.452,29,57,0.509,13,36,0.361,11,19,0.579,108
155,BOS,3/18/2015,118,@,OKC,0,240,44,84,0.524,31,50,0.62,13,34,0.382,17,28,0.607,118,42,88,0.477,37,69,0.536,5,19,0.263,33,39,0.846,122
156,DEN,3/15/2015,118,@,NOP,1,290,46,104,0.442,36,73,0.493,10,31,0.323,16,20,0.8,118,46,99,0.465,40,77,0.519,6,22,0.273,13,21,0.619,111
157,POR,3/13/2015,118,,DET,1,240,46,80,0.575,35,59,0.593,11,21,0.524,15,17,0.882,118,41,91,0.451,34,66,0.515,7,25,0.28,10,12,0.833,99
158,IND,3/10/2015,118,,ORL,1,240,45,85,0.529,28,51,0.549,17,34,0.5,11,12,0.917,118,34,92,0.37,30,75,0.4,4,17,0.235,14,20,0.7,86
159,PHI,3/4/2015,118,@,OKC,0,265,34,96,0.354,19,61,0.311,15,35,0.429,35,44,0.795,118,44,96,0.458,37,75,0.493,7,21,0.333,28,34,0.824,123
160,LAL,2/22/2015,118,,BOS,1,265,43,84,0.512,36,66,0.545,7,18,0.389,25,38,0.658,118,42,98,0.429,34,65,0.523,8,33,0.242,19,27,0.704,111
161,PHO,2/10/2015,118,,HOU,0,240,41,87,0.471,29,61,0.475,12,26,0.462,24,30,0.8,118,48,95,0.505,33,58,0.569,15,37,0.405,16,23,0.696,127
162,CHI,1/29/2015,118,@,LAL,0,290,43,104,0.413,37,79,0.468,6,25,0.24,26,32,0.813,118,50,106,0.472,47,97,0.485,3,9,0.333,20,25,0.8,123
163,PHO,1/21/2015,118,,POR,1,240,47,92,0.511,38,65,0.585,9,27,0.333,15,24,0.625,118,39,87,0.448,26,55,0.473,13,32,0.406,22,28,0.786,113
164,ORL,1/21/2015,118,@,DET,0,240,48,97,0.495,42,82,0.512,6,15,0.4,16,16,1,118,49,94,0.521,39,70,0.557,10,24,0.417,20,24,0.833,128
165,DEN,1/9/2015,118,@,SAC,1,240,47,85,0.553,42,68,0.618,5,17,0.294,19,28,0.679,118,42,86,0.488,36,67,0.537,6,19,0.316,18,24,0.75,108
166,LAC,12/22/2014,118,@,SAS,0,240,43,86,0.5,33,62,0.532,10,24,0.417,22,29,0.759,118,49,77,0.636,36,54,0.667,13,23,0.565,14,22,0.636,125
167,TOR,12/21/2014,118,,NYK,1,240,42,86,0.488,28,53,0.528,14,33,0.424,20,27,0.741,118,40,82,0.488,35,68,0.515,5,14,0.357,23,26,0.885,108
168,PHO,12/5/2014,118,@,DAL,1,240,45,80,0.563,32,54,0.593,13,26,0.5,15,17,0.882,118,40,88,0.455,36,69,0.522,4,19,0.211,22,30,0.733,106
169,BRK,11/19/2014,118,,MIL,0,315,44,92,0.478,35,61,0.574,9,31,0.29,21,29,0.724,118,48,108,0.444,43,84,0.512,5,24,0.208,21,28,0.75,122
170,PHO,11/17/2014,118,@,BOS,1,240,48,93,0.516,39,72,0.542,9,21,0.429,13,16,0.813,118,45,87,0.517,41,77,0.532,4,10,0.4,20,31,0.645,114
171,CLE,11/10/2014,118,,NOP,1,240,40,81,0.494,27,54,0.5,13,27,0.481,25,30,0.833,118,41,93,0.441,29,66,0.439,12,27,0.444,17,20,0.85,111
172,CHI,11/7/2014,118,@,PHI,1,240,40,78,0.513,28,54,0.519,12,24,0.5,26,34,0.765,118,43,91,0.473,31,61,0.508,12,30,0.4,17,25,0.68,115
173,DAL,11/3/2014,118,,BOS,1,240,44,82,0.537,30,57,0.526,14,25,0.56,16,20,0.8,118,45,102,0.441,34,71,0.479,11,31,0.355,12,16,0.75,113
174,UTA,11/1/2014,118,,PHO,1,240,42,88,0.477,35,62,0.565,7,26,0.269,27,33,0.818,118,36,87,0.414,29,56,0.518,7,31,0.226,12,15,0.8,91
175,LAC,10/31/2014,118,@,LAL,1,240,34,71,0.479,22,38,0.579,12,33,0.364,38,44,0.864,118,42,82,0.512,35,62,0.565,7,20,0.35,20,28,0.714,111
176,HOU,4/15/2015,117,,UTA,1,240,41,76,0.539,29,48,0.604,12,28,0.429,23,34,0.676,117,38,101,0.376,33,74,0.446,5,27,0.185,10,18,0.556,91
177,BOS,4/12/2015,117,,CLE,1,240,46,84,0.548,36,60,0.6,10,24,0.417,15,22,0.682,117,31,79,0.392,28,57,0.491,3,22,0.136,13,19,0.684,78
178,BRK,4/10/2015,117,,WAS,1,240,45,89,0.506,33,69,0.478,12,20,0.6,15,23,0.652,117,32,82,0.39,27,67,0.403,5,15,0.333,11,17,0.647,80
179,BOS,4/4/2015,117,@,TOR,1,265,47,97,0.485,39,71,0.549,8,26,0.308,15,22,0.682,117,40,83,0.482,34,60,0.567,6,23,0.261,30,38,0.789,116
180,LAL,3/24/2015,117,@,OKC,0,240,44,85,0.518,35,66,0.53,9,19,0.474,20,27,0.741,117,48,86,0.558,37,65,0.569,11,21,0.524,20,23,0.87,127
181,PHO,3/21/2015,117,@,HOU,1,240,46,92,0.5,38,77,0.494,8,15,0.533,17,24,0.708,117,41,87,0.471,31,53,0.585,10,34,0.294,10,12,0.833,102
182,CLE,3/18/2015,117,,BRK,1,240,45,82,0.549,30,53,0.566,15,29,0.517,12,20,0.6,117,36,80,0.45,31,60,0.517,5,20,0.25,15,21,0.714,92
183,TOR,3/16/2015,117,@,IND,1,240,39,82,0.476,27,59,0.458,12,23,0.522,27,33,0.818,117,38,88,0.432,36,69,0.522,2,19,0.105,20,25,0.8,98
184,SAS,3/10/2015,117,,TOR,1,240,41,85,0.482,30,67,0.448,11,18,0.611,24,30,0.8,117,43,97,0.443,35,71,0.493,8,26,0.308,13,18,0.722,107
185,PHO,2/26/2015,117,,OKC,1,265,48,97,0.495,39,71,0.549,9,26,0.346,12,21,0.571,117,39,101,0.386,31,77,0.403,8,24,0.333,27,30,0.9,113
186,ATL,2/9/2015,117,@,MIN,1,240,44,86,0.512,34,65,0.523,10,21,0.476,19,20,0.95,117,42,93,0.452,37,77,0.481,5,16,0.313,16,22,0.727,105
187,HOU,2/6/2015,117,,MIL,1,240,41,81,0.506,26,49,0.531,15,32,0.469,20,29,0.69,117,48,95,0.505,44,78,0.564,4,17,0.235,11,15,0.733,111
188,WAS,1/25/2015,117,@,DEN,1,265,48,90,0.533,44,76,0.579,4,14,0.286,17,23,0.739,117,41,101,0.406,29,72,0.403,12,29,0.414,21,28,0.75,115
189,LAC,1/17/2015,117,@,SAC,1,240,44,92,0.478,35,64,0.547,9,28,0.321,20,31,0.645,117,41,89,0.461,36,71,0.507,5,18,0.278,21,26,0.808,108
190,GSW,1/7/2015,117,,IND,1,240,45,91,0.495,33,63,0.524,12,28,0.429,15,20,0.75,117,37,81,0.457,31,55,0.564,6,26,0.231,22,23,0.957,102
191,GSW,1/5/2015,117,,OKC,1,240,41,88,0.466,26,60,0.433,15,28,0.536,20,32,0.625,117,30,98,0.306,25,70,0.357,5,28,0.179,26,34,0.765,91
192,HOU,12/26/2014,117,@,MEM,1,265,41,91,0.451,27,57,0.474,14,34,0.412,21,28,0.75,117,43,104,0.413,36,80,0.45,7,24,0.292,18,23,0.783,111
193,MEM,12/17/2014,117,@,SAS,1,315,48,107,0.449,38,80,0.475,10,27,0.37,11,14,0.786,117,43,105,0.41,26,70,0.371,17,35,0.486,13,27,0.481,116
194,DAL,12/17/2014,117,@,DET,1,240,40,79,0.506,30,57,0.526,10,22,0.455,27,35,0.771,117,40,89,0.449,27,56,0.482,13,33,0.394,13,19,0.684,106
195,TOR,12/2/2014,117,@,SAC,1,240,44,88,0.5,34,65,0.523,10,23,0.435,19,21,0.905,117,39,75,0.52,36,65,0.554,3,10,0.3,28,37,0.757,109
196,HOU,11/29/2014,117,@,MIL,1,240,44,87,0.506,29,49,0.592,15,38,0.395,14,16,0.875,117,33,74,0.446,27,55,0.491,6,19,0.316,31,35,0.886,103
197,MEM,11/21/2014,117,,BOS,1,240,48,91,0.527,40,75,0.533,8,16,0.5,13,14,0.929,117,38,88,0.432,29,61,0.475,9,27,0.333,15,21,0.714,100
198,DEN,11/21/2014,117,,NOP,1,240,43,82,0.524,32,58,0.552,11,24,0.458,20,25,0.8,117,31,78,0.397,26,62,0.419,5,16,0.313,30,34,0.882,97
199,MIL,11/18/2014,117,,NYK,1,240,43,78,0.551,34,61,0.557,9,17,0.529,22,27,0.815,117,44,80,0.55,33,55,0.6,11,25,0.44,14,19,0.737,113
200,MIN,11/15/2014,117,@,DAL,0,240,43,86,0.5,36,69,0.522,7,17,0.412,24,29,0.828,117,52,94,0.553,44,68,0.647,8,26,0.308,19,23,0.826,131
201,IND,4/12/2015,116,,OKC,1,240,42,79,0.532,32,59,0.542,10,20,0.5,22,35,0.629,116,41,95,0.432,30,67,0.448,11,28,0.393,11,28,0.393,104
202,DET,4/12/2015,116,,CHO,1,240,41,81,0.506,25,53,0.472,16,28,0.571,18,23,0.783,116,27,79,0.342,23,64,0.359,4,15,0.267,19,29,0.655,77
203,OKC,4/10/2015,116,,SAC,1,240,44,97,0.454,34,66,0.515,10,31,0.323,18,24,0.75,116,37,81,0.457,28,57,0.491,9,24,0.375,20,28,0.714,103
204,GSW,4/9/2015,116,,POR,1,240,48,90,0.533,36,64,0.563,12,26,0.462,8,9,0.889,116,46,98,0.469,39,74,0.527,7,24,0.292,6,8,0.75,105
205,POR,4/8/2015,116,,MIN,1,240,42,85,0.494,30,52,0.577,12,33,0.364,20,23,0.87,116,32,85,0.376,29,74,0.392,3,11,0.273,24,29,0.828,91
206,SAC,4/7/2015,116,,MIN,1,240,42,80,0.525,33,56,0.589,9,24,0.375,23,34,0.676,116,45,93,0.484,39,74,0.527,6,19,0.316,15,21,0.714,111
207,TOR,4/4/2015,116,,BOS,0,265,40,83,0.482,34,60,0.567,6,23,0.261,30,38,0.789,116,47,97,0.485,39,71,0.549,8,26,0.308,15,22,0.682,117
208,BOS,3/30/2015,116,@,CHO,1,240,45,89,0.506,36,63,0.571,9,26,0.346,17,23,0.739,116,40,85,0.471,33,59,0.559,7,26,0.269,17,19,0.895,104
209,CHI,3/25/2015,116,@,TOR,1,240,45,74,0.608,33,51,0.647,12,23,0.522,14,17,0.824,116,39,83,0.47,30,62,0.484,9,21,0.429,16,19,0.842,103
210,LAC,3/18/2015,116,@,SAC,1,240,45,88,0.511,28,51,0.549,17,37,0.459,9,13,0.692,116,38,79,0.481,35,62,0.565,3,17,0.176,26,32,0.813,105
211,SAS,3/8/2015,116,,CHI,1,240,44,90,0.489,35,68,0.515,9,22,0.409,19,24,0.792,116,37,73,0.507,32,58,0.552,5,15,0.333,26,29,0.897,105
212,NOP,2/6/2015,116,@,OKC,1,240,40,83,0.482,29,63,0.46,11,20,0.55,25,30,0.833,116,40,89,0.449,32,65,0.492,8,24,0.333,25,28,0.893,113
213,GSW,2/6/2015,116,@,ATL,0,240,47,103,0.456,35,70,0.5,12,33,0.364,10,15,0.667,116,38,77,0.494,23,50,0.46,15,27,0.556,33,37,0.892,124
214,WAS,1/31/2015,116,,TOR,0,265,37,79,0.468,27,55,0.491,10,24,0.417,32,41,0.78,116,44,88,0.5,33,62,0.532,11,26,0.423,21,30,0.7,120
215,GSW,1/13/2015,116,@,UTA,1,240,46,91,0.505,33,66,0.5,13,25,0.52,11,13,0.846,116,39,81,0.481,32,60,0.533,7,21,0.333,20,24,0.833,105
216,TOR,12/28/2014,116,@,DEN,1,240,43,88,0.489,33,65,0.508,10,23,0.435,20,32,0.625,116,37,87,0.425,33,70,0.471,4,17,0.235,24,34,0.706,102
217,PHO,12/28/2014,116,@,LAL,1,240,44,87,0.506,35,65,0.538,9,22,0.409,19,24,0.792,116,42,81,0.519,30,61,0.492,12,20,0.6,11,20,0.55,107
218,SAS,12/17/2014,116,,MEM,0,315,43,105,0.41,26,70,0.371,17,35,0.486,13,27,0.481,116,48,107,0.449,38,80,0.475,10,27,0.37,11,14,0.786,117
219,PHO,12/2/2014,116,,IND,1,240,43,86,0.5,31,61,0.508,12,25,0.48,18,26,0.692,116,41,85,0.482,37,72,0.514,4,13,0.308,13,17,0.765,99
220,POR,11/9/2014,116,,DEN,1,240,45,100,0.45,29,69,0.42,16,31,0.516,10,14,0.714,116,36,91,0.396,31,78,0.397,5,13,0.385,23,30,0.767,100
221,BRK,11/3/2014,116,,OKC,1,240,44,84,0.524,33,61,0.541,11,23,0.478,17,19,0.895,116,32,82,0.39,24,59,0.407,8,23,0.348,13,21,0.619,85
222,HOU,4/5/2015,115,@,OKC,1,240,38,81,0.469,30,53,0.566,8,28,0.286,31,50,0.62,115,40,92,0.435,26,62,0.419,14,30,0.467,18,26,0.692,112
223,HOU,4/1/2015,115,,SAC,1,240,41,89,0.461,23,49,0.469,18,40,0.45,15,25,0.6,115,48,96,0.5,41,82,0.5,7,14,0.5,8,16,0.5,111
224,CHO,3/28/2015,115,,ATL,1,240,42,80,0.525,30,54,0.556,12,26,0.462,19,22,0.864,115,37,86,0.43,22,56,0.393,15,30,0.5,11,14,0.786,100
225,ATL,3/20/2015,115,@,OKC,0,240,41,82,0.5,28,53,0.528,13,29,0.448,20,25,0.8,115,43,84,0.512,30,54,0.556,13,30,0.433,24,26,0.923,123
226,OKC,3/16/2015,115,@,DAL,0,240,40,90,0.444,33,64,0.516,7,26,0.269,28,35,0.8,115,42,89,0.472,32,64,0.5,10,25,0.4,25,35,0.714,119
227,DEN,3/11/2015,115,,ATL,1,240,42,84,0.5,29,53,0.547,13,31,0.419,18,20,0.9,115,34,81,0.42,25,54,0.463,9,27,0.333,25,27,0.926,102
228,CHO,3/4/2015,115,@,BRK,1,240,42,85,0.494,34,66,0.515,8,19,0.421,23,28,0.821,115,35,88,0.398,32,72,0.444,3,16,0.188,18,24,0.75,91
229,MIA,3/2/2015,115,,PHO,1,240,43,82,0.524,36,68,0.529,7,14,0.5,22,30,0.733,115,33,78,0.423,26,47,0.553,7,31,0.226,25,38,0.658,98
230,DET,2/27/2015,115,,NYK,0,290,39,97,0.402,31,66,0.47,8,31,0.258,29,40,0.725,115,45,109,0.413,39,91,0.429,6,18,0.333,25,26,0.962,121
231,POR,2/27/2015,115,,OKC,1,240,39,89,0.438,29,63,0.46,10,26,0.385,27,31,0.871,115,45,94,0.479,41,80,0.513,4,14,0.286,18,22,0.818,112
232,BOS,2/25/2015,115,,NYK,1,240,42,83,0.506,28,52,0.538,14,31,0.452,17,20,0.85,115,34,82,0.415,32,61,0.525,2,21,0.095,24,31,0.774,94
233,BOS,2/23/2015,115,@,PHO,1,240,39,89,0.438,25,60,0.417,14,29,0.483,23,30,0.767,115,44,97,0.454,35,65,0.538,9,32,0.281,13,16,0.813,110
234,SAS,2/19/2015,115,@,LAC,0,240,43,84,0.512,33,56,0.589,10,28,0.357,19,23,0.826,115,42,77,0.545,34,58,0.586,8,19,0.421,27,52,0.519,119
235,LAC,2/9/2015,115,@,DAL,1,240,41,92,0.446,32,65,0.492,9,27,0.333,24,29,0.828,115,33,81,0.407,23,47,0.489,10,34,0.294,22,30,0.733,98
236,NOP,2/2/2015,115,,ATL,1,240,43,86,0.5,34,63,0.54,9,23,0.391,20,23,0.87,115,40,89,0.449,33,67,0.493,7,22,0.318,13,17,0.765,100
237,MIL,1/29/2015,115,@,ORL,1,240,45,87,0.517,33,62,0.532,12,25,0.48,13,18,0.722,115,37,82,0.451,32,64,0.5,5,18,0.278,21,30,0.7,100
238,DEN,1/25/2015,115,,WAS,0,265,41,101,0.406,29,72,0.403,12,29,0.414,21,28,0.75,115,48,90,0.533,44,76,0.579,4,14,0.286,17,23,0.739,117
239,PHO,1/19/2015,115,,LAL,1,240,43,86,0.5,30,54,0.556,13,32,0.406,16,22,0.727,115,34,75,0.453,26,58,0.448,8,17,0.471,24,35,0.686,100
240,GSW,1/16/2015,115,@,OKC,0,240,42,92,0.457,33,68,0.485,9,24,0.375,22,28,0.786,115,51,97,0.526,41,75,0.547,10,22,0.455,15,19,0.789,127
241,ATL,1/3/2015,115,@,POR,1,240,43,84,0.512,37,67,0.552,6,17,0.353,23,31,0.742,115,42,93,0.452,29,60,0.483,13,33,0.394,10,12,0.833,107
242,HOU,1/3/2015,115,,MIA,1,240,41,83,0.494,28,52,0.538,13,31,0.419,20,28,0.714,115,30,68,0.441,26,51,0.51,4,17,0.235,15,25,0.6,79
243,PHO,12/26/2014,115,@,SAC,1,240,46,94,0.489,32,61,0.525,14,33,0.424,9,12,0.75,115,41,93,0.441,34,73,0.466,7,20,0.35,17,24,0.708,106
244,LAL,12/23/2014,115,,GSW,1,240,46,89,0.517,34,63,0.54,12,26,0.462,11,17,0.647,115,39,84,0.464,27,58,0.466,12,26,0.462,15,17,0.882,105
245,DAL,12/23/2014,115,@,PHO,0,240,41,88,0.466,32,63,0.508,9,25,0.36,24,29,0.828,115,44,97,0.454,31,64,0.484,13,33,0.394,23,32,0.719,124
246,POR,12/23/2014,115,@,OKC,1,265,38,91,0.418,21,60,0.35,17,31,0.548,22,24,0.917,115,46,101,0.455,40,82,0.488,6,19,0.316,13,15,0.867,111
247,HOU,12/17/2014,115,@,DEN,1,265,35,85,0.412,27,57,0.474,8,28,0.286,37,48,0.771,115,40,99,0.404,27,69,0.391,13,30,0.433,18,23,0.783,111
248,PHI,12/13/2014,115,,MEM,0,265,40,82,0.488,29,54,0.537,11,28,0.393,24,34,0.706,115,45,93,0.484,34,67,0.507,11,26,0.423,19,27,0.704,120
249,CHI,12/12/2014,115,,POR,1,240,44,88,0.5,39,73,0.534,5,15,0.333,22,28,0.786,115,43,88,0.489,31,64,0.484,12,24,0.5,8,11,0.727,106
250,ATL,11/26/2014,115,,TOR,0,240,42,82,0.512,32,58,0.552,10,24,0.417,21,24,0.875,115,42,82,0.512,28,53,0.528,14,29,0.483,28,33,0.848,126
251,MIN,11/19/2014,115,,NYK,1,240,44,89,0.494,33,67,0.493,11,22,0.5,16,22,0.727,115,34,69,0.493,25,53,0.472,9,16,0.563,22,28,0.786,99
252,LAL,11/16/2014,115,,GSW,0,240,39,99,0.394,36,83,0.434,3,16,0.188,34,43,0.791,115,46,86,0.535,32,58,0.552,14,28,0.5,30,34,0.882,136
253,PHI,11/7/2014,115,,CHI,0,240,43,91,0.473,31,61,0.508,12,30,0.4,17,25,0.68,115,40,78,0.513,28,54,0.519,12,24,0.5,26,34,0.765,118
254,DAL,4/15/2015,114,,POR,1,240,39,86,0.453,30,61,0.492,9,25,0.36,27,34,0.794,114,38,91,0.418,31,66,0.47,7,25,0.28,15,18,0.833,98
255,NOP,4/12/2015,114,@,HOU,0,240,44,91,0.484,33,64,0.516,11,27,0.407,15,22,0.682,114,39,73,0.534,30,49,0.612,9,24,0.375,34,48,0.708,121
256,CHI,4/11/2015,114,,PHI,1,240,40,90,0.444,31,64,0.484,9,26,0.346,25,36,0.694,114,37,89,0.416,24,48,0.5,13,41,0.317,20,25,0.8,107
257,ATL,4/8/2015,114,@,BRK,1,240,43,86,0.5,32,58,0.552,11,28,0.393,17,25,0.68,114,41,87,0.471,34,61,0.557,7,26,0.269,22,25,0.88,111
258,BRK,4/3/2015,114,,TOR,1,240,46,88,0.523,41,72,0.569,5,16,0.313,17,23,0.739,114,42,82,0.512,34,56,0.607,8,26,0.308,17,23,0.739,109
259,CLE,4/2/2015,114,,MIA,1,240,40,80,0.5,25,45,0.556,15,35,0.429,19,25,0.76,114,32,75,0.427,25,54,0.463,7,21,0.333,17,21,0.81,88
260,DEN,3/28/2015,114,@,POR,0,240,43,92,0.467,34,68,0.5,9,24,0.375,19,22,0.864,114,48,85,0.565,40,67,0.597,8,18,0.444,16,18,0.889,120
261,SAS,3/22/2015,114,@,ATL,1,240,46,82,0.561,39,65,0.6,7,17,0.412,15,17,0.882,114,38,80,0.475,26,56,0.464,12,24,0.5,7,7,1,95
262,GSW,3/18/2015,114,,ATL,1,240,44,84,0.524,30,54,0.556,14,30,0.467,12,20,0.6,114,31,87,0.356,23,65,0.354,8,22,0.364,25,30,0.833,95
263,SAS,3/18/2015,114,@,MIL,1,240,38,76,0.5,30,56,0.536,8,20,0.4,30,38,0.789,114,39,80,0.488,32,66,0.485,7,14,0.5,18,24,0.75,103
264,PHI,3/13/2015,114,,SAC,1,240,45,95,0.474,36,63,0.571,9,32,0.281,15,23,0.652,114,35,87,0.402,31,73,0.425,4,14,0.286,33,40,0.825,107
265,DEN,3/13/2015,114,,GSW,1,240,41,82,0.5,33,65,0.508,8,17,0.471,24,37,0.649,114,39,92,0.424,31,73,0.425,8,19,0.421,17,22,0.773,103
266,NOP,3/9/2015,114,@,MIL,1,240,44,75,0.587,35,60,0.583,9,15,0.6,17,21,0.81,114,37,71,0.521,33,56,0.589,4,15,0.267,25,31,0.806,103
267,HOU,3/7/2015,114,@,DEN,1,240,40,86,0.465,30,58,0.517,10,28,0.357,24,32,0.75,114,38,92,0.413,29,62,0.468,9,30,0.3,15,19,0.789,100
268,MIA,3/7/2015,114,,SAC,1,265,41,80,0.513,34,56,0.607,7,24,0.292,25,33,0.758,114,40,88,0.455,30,63,0.476,10,25,0.4,19,24,0.792,109
269,SAC,3/6/2015,114,@,ORL,0,240,38,85,0.447,28,58,0.483,10,27,0.37,28,38,0.737,114,48,85,0.565,35,61,0.574,13,24,0.542,10,12,0.833,119
270,TOR,3/2/2015,114,@,PHI,1,240,41,80,0.513,30,53,0.566,11,27,0.407,21,24,0.875,114,41,78,0.526,33,58,0.569,8,20,0.4,13,19,0.684,103
271,GSW,2/24/2015,114,@,WAS,1,240,45,90,0.5,33,67,0.493,12,23,0.522,12,17,0.706,114,42,79,0.532,37,61,0.607,5,18,0.278,18,21,0.857,107
272,BRK,2/20/2015,114,@,LAL,1,240,42,89,0.472,32,68,0.471,10,21,0.476,20,24,0.833,114,41,89,0.461,37,66,0.561,4,23,0.174,19,29,0.655,105
273,DEN,2/9/2015,114,,OKC,0,240,42,87,0.483,33,59,0.559,9,28,0.321,21,29,0.724,114,43,80,0.538,31,56,0.554,12,24,0.5,26,35,0.743,124
274,WAS,2/7/2015,114,,BRK,1,240,44,87,0.506,35,67,0.522,9,20,0.45,17,23,0.739,114,26,77,0.338,22,59,0.373,4,18,0.222,21,31,0.677,77
275,IND,2/4/2015,114,,DET,1,240,46,77,0.597,34,56,0.607,12,21,0.571,10,18,0.556,114,43,87,0.494,31,63,0.492,12,24,0.5,11,15,0.733,109
276,DAL,2/4/2015,114,@,GSW,0,240,41,98,0.418,31,68,0.456,10,30,0.333,22,28,0.786,114,45,86,0.523,26,48,0.542,19,38,0.5,19,25,0.76,128
277,DET,1/31/2015,114,,HOU,1,240,41,82,0.5,31,57,0.544,10,25,0.4,22,35,0.629,114,39,87,0.448,28,55,0.509,11,32,0.344,12,19,0.632,101
278,TOR,1/25/2015,114,,DET,1,240,43,81,0.531,38,66,0.576,5,15,0.333,23,29,0.793,114,41,90,0.456,29,56,0.518,12,34,0.353,16,23,0.696,110
279,GSW,1/25/2015,114,,BOS,1,240,42,89,0.472,34,66,0.515,8,23,0.348,22,25,0.88,114,41,95,0.432,31,67,0.463,10,28,0.357,19,27,0.704,111
280,DEN,1/14/2015,114,,DAL,1,240,41,82,0.5,37,63,0.587,4,19,0.211,28,35,0.8,114,41,100,0.41,32,63,0.508,9,37,0.243,16,20,0.8,107
281,DET,1/12/2015,114,@,TOR,1,240,41,96,0.427,34,75,0.453,7,21,0.333,25,31,0.806,114,47,87,0.54,40,60,0.667,7,27,0.259,10,14,0.714,111
282,CHI,1/12/2015,114,,ORL,0,240,41,84,0.488,33,57,0.579,8,27,0.296,24,33,0.727,114,48,81,0.593,41,63,0.651,7,18,0.389,18,29,0.621,121
283,LAC,1/7/2015,114,,LAL,1,240,40,85,0.471,28,52,0.538,12,33,0.364,22,30,0.733,114,37,85,0.435,32,65,0.492,5,20,0.25,10,17,0.588,89
284,CHI,1/5/2015,114,,HOU,1,240,41,85,0.482,36,68,0.529,5,17,0.294,27,30,0.9,114,47,102,0.461,39,77,0.506,8,25,0.32,3,5,0.6,105
285,DET,1/4/2015,114,,SAC,1,240,45,91,0.495,33,60,0.55,12,31,0.387,12,16,0.75,114,32,75,0.427,29,60,0.483,3,15,0.2,28,36,0.778,95
286,DEN,1/3/2015,114,,MEM,1,240,41,79,0.519,34,64,0.531,7,15,0.467,25,31,0.806,114,37,86,0.43,35,72,0.486,2,14,0.143,9,13,0.692,85
287,DAL,12/30/2014,114,,WAS,1,240,43,82,0.524,35,67,0.522,8,15,0.533,20,29,0.69,114,33,74,0.446,29,62,0.468,4,12,0.333,17,27,0.63,87
288,POR,12/26/2014,114,,PHI,1,240,42,88,0.477,24,45,0.533,18,43,0.419,12,14,0.857,114,36,81,0.444,33,67,0.493,3,14,0.214,18,33,0.545,93
289,OKC,12/25/2014,114,@,SAS,1,240,42,81,0.519,33,66,0.5,9,15,0.6,21,38,0.553,114,42,81,0.519,35,58,0.603,7,23,0.304,15,21,0.714,106
290,POR,12/20/2014,114,@,NOP,1,240,48,90,0.533,39,65,0.6,9,25,0.36,9,15,0.6,114,30,85,0.353,27,70,0.386,3,15,0.2,25,28,0.893,88
291,BOS,12/19/2014,114,,MIN,1,240,48,85,0.565,40,62,0.645,8,23,0.348,10,14,0.714,114,42,93,0.452,36,81,0.444,6,12,0.5,8,16,0.5,98
292,GSW,12/18/2014,114,,OKC,1,240,48,94,0.511,36,63,0.571,12,31,0.387,6,10,0.6,114,41,86,0.477,30,61,0.492,11,25,0.44,16,24,0.667,109
293,BRK,12/13/2014,114,@,CHO,1,240,42,72,0.583,26,49,0.531,16,23,0.696,14,20,0.7,114,31,79,0.392,23,57,0.404,8,22,0.364,17,27,0.63,87
294,CLE,12/12/2014,114,@,NOP,0,240,44,89,0.494,36,67,0.537,8,22,0.364,18,23,0.783,114,44,79,0.557,32,51,0.627,12,28,0.429,19,25,0.76,119
295,OKC,12/9/2014,114,,MIL,1,240,41,82,0.5,37,61,0.607,4,21,0.19,28,34,0.824,114,34,84,0.405,30,63,0.476,4,21,0.19,29,35,0.829,101
296,MEM,12/9/2014,114,,DAL,1,240,41,85,0.482,34,71,0.479,7,14,0.5,25,29,0.862,114,38,85,0.447,20,45,0.444,18,40,0.45,11,14,0.786,105
297,HOU,12/5/2014,114,@,MIN,1,265,38,78,0.487,26,46,0.565,12,32,0.375,26,31,0.839,114,45,97,0.464,42,87,0.483,3,10,0.3,19,27,0.704,112
298,LAC,12/3/2014,114,,ORL,1,240,42,78,0.538,30,47,0.638,12,31,0.387,18,25,0.72,114,33,79,0.418,26,59,0.441,7,20,0.35,13,25,0.52,86
299,DEN,11/25/2014,114,,CHI,1,240,43,85,0.506,35,69,0.507,8,16,0.5,20,27,0.741,114,35,82,0.427,28,61,0.459,7,21,0.333,32,37,0.865,109
300,GSW,11/25/2014,114,@,MIA,1,240,43,75,0.573,30,47,0.638,13,28,0.464,15,23,0.652,114,33,85,0.388,23,62,0.371,10,23,0.435,21,27,0.778,97
301,POR,11/24/2014,114,@,PHI,1,240,44,89,0.494,37,62,0.597,7,27,0.259,19,23,0.826,114,42,84,0.5,42,76,0.553,0,8,0,20,24,0.833,104
302,LAC,11/19/2014,114,@,ORL,1,240,45,84,0.536,33,63,0.524,12,21,0.571,12,16,0.75,114,34,86,0.395,26,62,0.419,8,24,0.333,14,18,0.778,90
303,LAL,11/18/2014,114,@,ATL,1,240,47,87,0.54,41,70,0.586,6,17,0.353,14,22,0.636,114,41,85,0.482,32,58,0.552,9,27,0.333,18,23,0.783,109
304,BOS,11/17/2014,114,,PHO,0,240,45,87,0.517,41,77,0.532,4,10,0.4,20,31,0.645,114,48,93,0.516,39,72,0.542,9,21,0.429,13,16,0.813,118
305,ATL,11/14/2014,114,,MIA,1,240,42,75,0.56,31,47,0.66,11,28,0.393,19,23,0.826,114,35,74,0.473,25,53,0.472,10,21,0.476,23,25,0.92,103
306,SAC,11/7/2014,114,@,PHO,1,290,39,91,0.429,36,75,0.48,3,16,0.188,33,39,0.846,114,42,98,0.429,32,67,0.478,10,31,0.323,18,25,0.72,112
307,MIA,11/1/2014,114,@,PHI,1,240,41,83,0.494,29,59,0.492,12,24,0.5,20,29,0.69,114,35,67,0.522,28,44,0.636,7,23,0.304,19,26,0.731,96
308,CLE,10/31/2014,114,@,CHI,1,265,41,104,0.394,38,89,0.427,3,15,0.2,29,33,0.879,114,41,90,0.456,28,59,0.475,13,31,0.419,13,17,0.765,108
309,MIN,4/15/2015,113,,OKC,0,240,39,84,0.464,33,65,0.508,6,19,0.316,29,35,0.829,113,52,95,0.547,40,67,0.597,12,28,0.429,22,31,0.71,138
310,CLE,4/15/2015,113,,WAS,1,265,43,91,0.473,27,61,0.443,16,30,0.533,11,17,0.647,113,42,97,0.433,34,75,0.453,8,22,0.364,16,21,0.762,108
311,CHI,4/13/2015,113,@,BRK,1,240,44,88,0.5,32,58,0.552,12,30,0.4,13,17,0.765,113,32,87,0.368,29,75,0.387,3,12,0.25,19,22,0.864,86
312,BOS,4/8/2015,113,@,DET,1,240,36,80,0.45,28,52,0.538,8,28,0.286,33,34,0.971,113,45,84,0.536,38,66,0.576,7,18,0.389,6,10,0.6,103
313,SAS,4/7/2015,113,@,OKC,1,240,47,89,0.528,37,65,0.569,10,24,0.417,9,13,0.692,113,34,84,0.405,29,65,0.446,5,19,0.263,15,28,0.536,88
314,TOR,4/1/2015,113,@,MIN,1,240,42,76,0.553,29,46,0.63,13,30,0.433,16,23,0.696,113,41,77,0.532,36,63,0.571,5,14,0.357,12,19,0.632,99
315,NOP,4/1/2015,113,@,LAL,1,240,44,78,0.564,35,62,0.565,9,16,0.563,16,21,0.762,113,37,83,0.446,32,67,0.478,5,16,0.313,13,21,0.619,92
316,LAL,3/30/2015,113,@,PHI,1,265,40,82,0.488,30,61,0.492,10,21,0.476,23,30,0.767,113,39,96,0.406,29,66,0.439,10,30,0.333,23,38,0.605,111
317,LAC,3/20/2015,113,,WAS,1,240,45,86,0.523,33,63,0.524,12,23,0.522,11,17,0.647,113,37,86,0.43,31,67,0.463,6,19,0.316,19,23,0.826,99
318,POR,3/15/2015,113,@,TOR,1,240,45,86,0.523,32,57,0.561,13,29,0.448,10,16,0.625,113,37,78,0.474,32,60,0.533,5,18,0.278,18,23,0.783,97
319,WAS,3/14/2015,113,,SAC,1,240,43,81,0.531,30,55,0.545,13,26,0.5,14,17,0.824,113,35,77,0.455,29,58,0.5,6,19,0.316,21,28,0.75,97
320,OKC,3/13/2015,113,,MIN,1,240,44,101,0.436,33,77,0.429,11,24,0.458,14,14,1,113,34,78,0.436,31,66,0.47,3,12,0.25,28,31,0.903,99
321,SAC,3/11/2015,113,@,CHO,1,240,40,85,0.471,32,65,0.492,8,20,0.4,25,30,0.833,113,42,93,0.452,36,75,0.48,6,18,0.333,16,26,0.615,106
322,POR,3/7/2015,113,@,MIN,0,240,43,88,0.489,29,61,0.475,14,27,0.519,13,17,0.765,113,46,85,0.541,42,78,0.538,4,7,0.571,25,31,0.806,121
323,GSW,2/27/2015,113,@,TOR,1,240,42,87,0.483,29,59,0.492,13,28,0.464,16,19,0.842,113,31,77,0.403,27,55,0.491,4,22,0.182,23,28,0.821,89
324,OKC,2/26/2015,113,@,PHO,0,265,39,101,0.386,31,77,0.403,8,24,0.333,27,30,0.9,113,48,97,0.495,39,71,0.549,9,26,0.346,12,21,0.571,117
325,HOU,2/23/2015,113,,MIN,1,240,39,94,0.415,27,56,0.482,12,38,0.316,23,34,0.676,113,31,93,0.333,26,75,0.347,5,18,0.278,35,39,0.897,102
326,CHI,2/12/2015,113,,CLE,1,240,42,92,0.457,33,69,0.478,9,23,0.391,20,26,0.769,113,37,85,0.435,29,54,0.537,8,31,0.258,16,22,0.727,98
327,CLE,2/11/2015,113,,MIA,1,240,44,78,0.564,34,53,0.642,10,25,0.4,15,19,0.789,113,34,84,0.405,25,60,0.417,9,24,0.375,16,20,0.8,93
328,OKC,2/6/2015,113,,NOP,0,240,40,89,0.449,32,65,0.492,8,24,0.333,25,28,0.893,113,40,83,0.482,29,63,0.46,11,20,0.55,25,30,0.833,116
329,MIL,2/4/2015,113,,LAL,1,265,41,82,0.5,30,56,0.536,11,26,0.423,20,22,0.909,113,39,93,0.419,30,65,0.462,9,28,0.321,18,25,0.72,105
330,ATL,1/28/2015,113,,BRK,1,240,38,82,0.463,26,49,0.531,12,33,0.364,25,26,0.962,113,39,87,0.448,30,63,0.476,9,24,0.375,15,18,0.833,102
331,CHI,1/27/2015,113,@,GSW,1,265,42,98,0.429,34,69,0.493,8,29,0.276,21,23,0.913,113,48,113,0.425,39,80,0.488,9,33,0.273,6,12,0.5,111
332,NYK,1/23/2015,113,,ORL,1,240,43,91,0.473,33,66,0.5,10,25,0.4,17,21,0.81,113,44,87,0.506,37,60,0.617,7,27,0.259,11,19,0.579,106
333,HOU,1/23/2015,113,@,PHO,1,240,44,84,0.524,34,57,0.596,10,27,0.37,15,20,0.75,113,42,91,0.462,32,61,0.525,10,30,0.333,17,24,0.708,111
334,POR,1/21/2015,113,@,PHO,0,240,39,87,0.448,26,55,0.473,13,32,0.406,22,28,0.786,113,47,92,0.511,38,65,0.585,9,27,0.333,15,24,0.625,118
335,HOU,1/21/2015,113,@,GSW,0,240,37,87,0.425,24,55,0.436,13,32,0.406,26,31,0.839,113,49,98,0.5,36,69,0.522,13,29,0.448,15,18,0.833,126
336,MIN,1/17/2015,113,@,DEN,1,240,43,80,0.538,35,61,0.574,8,19,0.421,19,21,0.905,113,38,92,0.413,28,61,0.459,10,31,0.323,19,22,0.864,105
337,HOU,1/14/2015,113,@,ORL,0,240,42,83,0.506,33,57,0.579,9,26,0.346,20,23,0.87,113,44,90,0.489,35,64,0.547,9,26,0.346,23,26,0.885,120
338,HOU,1/12/2015,113,@,BRK,1,240,41,86,0.477,25,46,0.543,16,40,0.4,15,20,0.75,113,39,84,0.464,34,63,0.54,5,21,0.238,16,18,0.889,99
339,PHO,1/7/2015,113,@,MIN,1,240,46,96,0.479,41,70,0.586,5,26,0.192,16,19,0.842,113,44,92,0.478,37,75,0.493,7,17,0.412,16,19,0.842,111
340,CHI,12/25/2014,113,,LAL,1,240,42,86,0.488,32,62,0.516,10,24,0.417,19,25,0.76,113,36,92,0.391,31,76,0.408,5,16,0.313,16,21,0.762,93
341,LAC,12/15/2014,113,,DET,1,240,43,80,0.538,31,56,0.554,12,24,0.5,15,20,0.75,113,35,83,0.422,27,56,0.482,8,27,0.296,13,22,0.591,91
342,MEM,12/12/2014,113,,CHO,1,290,39,85,0.459,33,72,0.458,6,13,0.462,29,38,0.763,113,41,98,0.418,35,81,0.432,6,17,0.353,19,27,0.704,107
343,HOU,12/11/2014,113,@,SAC,1,265,38,95,0.4,23,51,0.451,15,44,0.341,22,31,0.71,113,39,84,0.464,31,66,0.47,8,18,0.444,23,34,0.676,109
344,BOS,12/5/2014,113,,LAL,1,240,46,90,0.511,38,70,0.543,8,20,0.4,13,22,0.591,113,38,92,0.413,32,76,0.421,6,16,0.375,14,19,0.737,96
345,CLE,11/26/2014,113,,WAS,1,240,38,74,0.514,32,54,0.593,6,20,0.3,31,38,0.816,113,33,71,0.465,28,58,0.483,5,13,0.385,16,22,0.727,87
346,LAC,11/24/2014,113,@,CHO,1,240,45,88,0.511,30,56,0.536,15,32,0.469,8,10,0.8,113,31,75,0.413,29,55,0.527,2,20,0.1,28,35,0.8,92
347,SAC,11/22/2014,113,@,MIN,1,240,40,81,0.494,32,55,0.582,8,26,0.308,25,30,0.833,113,37,90,0.411,31,73,0.425,6,17,0.353,21,27,0.778,101
348,NYK,11/18/2014,113,@,MIL,0,240,44,80,0.55,33,55,0.6,11,25,0.44,14,19,0.737,113,43,78,0.551,34,61,0.557,9,17,0.529,22,27,0.815,117
349,DEN,11/12/2014,113,,POR,0,240,39,90,0.433,31,67,0.463,8,23,0.348,27,33,0.818,113,45,88,0.511,29,55,0.527,16,33,0.485,24,29,0.828,130
350,HOU,11/12/2014,113,@,MIN,1,240,43,89,0.483,30,61,0.492,13,28,0.464,14,19,0.737,113,36,81,0.444,30,69,0.435,6,12,0.5,23,30,0.767,101
351,SAS,11/11/2014,113,@,GSW,1,240,46,93,0.495,36,68,0.529,10,25,0.4,11,15,0.733,113,38,70,0.543,31,50,0.62,7,20,0.35,17,20,0.85,100
352,BOS,11/3/2014,113,@,DAL,0,240,45,102,0.441,34,71,0.479,11,31,0.355,12,16,0.75,113,44,82,0.537,30,57,0.526,14,25,0.56,16,20,0.8,118
353,DET,4/15/2015,112,@,NYK,1,240,41,81,0.506,31,55,0.564,10,26,0.385,20,27,0.741,112,33,77,0.429,26,58,0.448,7,19,0.368,17,27,0.63,90
354,LAC,4/14/2015,112,@,PHO,1,240,42,87,0.483,27,49,0.551,15,38,0.395,13,18,0.722,112,39,80,0.488,28,54,0.519,11,26,0.423,12,20,0.6,101
355,NYK,4/13/2015,112,@,ATL,1,240,43,77,0.558,30,52,0.577,13,25,0.52,13,19,0.684,112,39,88,0.443,28,56,0.5,11,32,0.344,19,23,0.826,108
356,OKC,4/5/2015,112,,HOU,0,240,40,92,0.435,26,62,0.419,14,30,0.467,18,26,0.692,112,38,81,0.469,30,53,0.566,8,28,0.286,31,50,0.62,115
357,IND,4/5/2015,112,,MIA,1,240,37,85,0.435,23,55,0.418,14,30,0.467,24,36,0.667,112,37,82,0.451,35,62,0.565,2,20,0.1,13,19,0.684,89
358,GSW,3/20/2015,112,,NOP,1,240,44,88,0.5,39,69,0.565,5,19,0.263,19,23,0.826,112,33,77,0.429,22,55,0.4,11,22,0.5,19,22,0.864,96
359,MEM,3/20/2015,112,@,DAL,1,240,41,77,0.532,33,59,0.559,8,18,0.444,22,32,0.688,112,34,76,0.447,26,54,0.481,8,22,0.364,25,36,0.694,101
360,TOR,3/4/2015,112,,CLE,0,240,43,79,0.544,33,58,0.569,10,21,0.476,16,17,0.941,112,40,78,0.513,25,42,0.595,15,36,0.417,25,34,0.735,120
361,SAS,3/4/2015,112,,SAC,1,240,45,85,0.529,35,62,0.565,10,23,0.435,12,16,0.75,112,29,78,0.372,26,69,0.377,3,9,0.333,24,34,0.706,85
362,OKC,2/27/2015,112,@,POR,0,240,45,94,0.479,41,80,0.513,4,14,0.286,18,22,0.818,112,39,89,0.438,29,63,0.46,10,26,0.385,27,31,0.871,115
363,CHI,2/21/2015,112,,PHO,1,240,43,89,0.483,31,65,0.477,12,24,0.5,14,16,0.875,112,47,88,0.534,37,63,0.587,10,25,0.4,3,8,0.375,107
364,MIN,2/8/2015,112,@,DET,1,240,39,76,0.513,34,64,0.531,5,12,0.417,29,34,0.853,112,37,79,0.468,27,48,0.563,10,31,0.323,17,22,0.773,101
365,ATL,1/25/2015,112,,MIN,1,240,45,80,0.563,35,52,0.673,10,28,0.357,12,18,0.667,112,37,71,0.521,31,55,0.564,6,16,0.375,20,25,0.8,100
366,HOU,1/15/2015,112,,OKC,1,240,41,86,0.477,25,50,0.5,16,36,0.444,14,19,0.737,112,35,81,0.432,24,52,0.462,11,29,0.379,20,28,0.714,101
367,GSW,1/9/2015,112,,CLE,1,240,43,86,0.5,33,56,0.589,10,30,0.333,16,17,0.941,112,35,86,0.407,28,63,0.444,7,23,0.304,17,23,0.739,94
368,PHO,1/2/2015,112,,PHI,1,240,42,84,0.5,28,52,0.538,14,32,0.438,14,16,0.875,112,37,87,0.425,30,61,0.492,7,26,0.269,15,25,0.6,96
369,DAL,12/28/2014,112,,OKC,1,240,39,88,0.443,29,57,0.509,10,31,0.323,24,28,0.857,112,45,90,0.5,40,76,0.526,5,14,0.357,12,21,0.571,107
370,OKC,12/14/2014,112,,PHO,1,240,39,80,0.488,35,62,0.565,4,18,0.222,30,34,0.882,112,34,99,0.343,27,68,0.397,7,31,0.226,13,18,0.722,88
371,LAL,12/12/2014,112,@,SAS,1,265,44,96,0.458,32,72,0.444,12,24,0.5,12,15,0.8,112,42,90,0.467,30,59,0.508,12,31,0.387,14,21,0.667,110
372,DAL,12/10/2014,112,,NOP,1,240,44,83,0.53,35,62,0.565,9,21,0.429,15,17,0.882,112,40,88,0.455,33,70,0.471,7,18,0.389,20,24,0.833,107
373,TOR,12/8/2014,112,,DEN,1,265,41,81,0.506,32,48,0.667,9,33,0.273,21,29,0.724,112,43,104,0.413,33,74,0.446,10,30,0.333,11,15,0.733,107
374,GSW,12/6/2014,112,@,CHI,1,240,40,89,0.449,28,59,0.475,12,30,0.4,20,25,0.8,112,36,83,0.434,29,62,0.468,7,21,0.333,23,27,0.852,102
375,MIN,12/5/2014,112,,HOU,0,265,45,97,0.464,42,87,0.483,3,10,0.3,19,27,0.704,112,38,78,0.487,26,46,0.565,12,32,0.375,26,31,0.839,114
376,GSW,12/4/2014,112,,NOP,1,240,47,100,0.47,37,78,0.474,10,22,0.455,8,17,0.471,112,37,89,0.416,34,74,0.459,3,15,0.2,8,13,0.615,85
377,ATL,12/3/2014,112,@,MIA,1,240,40,74,0.541,28,49,0.571,12,25,0.48,20,23,0.87,112,36,64,0.563,30,48,0.625,6,16,0.375,24,32,0.75,102
378,NOP,12/2/2014,112,,OKC,1,240,39,88,0.443,34,71,0.479,5,17,0.294,29,45,0.644,112,37,84,0.44,30,60,0.5,7,24,0.292,23,27,0.852,104
379,LAC,11/29/2014,112,@,UTA,1,240,45,80,0.563,34,52,0.654,11,28,0.393,11,15,0.733,112,34,75,0.453,27,54,0.5,7,21,0.333,21,33,0.636,96
380,SAS,11/28/2014,112,,SAC,1,240,42,82,0.512,30,58,0.517,12,24,0.5,16,20,0.8,112,38,75,0.507,32,65,0.492,6,10,0.6,22,26,0.846,104
381,MEM,11/28/2014,112,@,POR,1,240,45,84,0.536,39,71,0.549,6,13,0.462,16,26,0.615,112,39,97,0.402,31,69,0.449,8,28,0.286,13,18,0.722,99
382,DEN,11/26/2014,112,@,PHO,0,240,39,90,0.433,31,65,0.477,8,25,0.32,26,34,0.765,112,45,88,0.511,32,63,0.508,13,25,0.52,17,21,0.81,120
383,GSW,11/15/2014,112,,CHO,1,240,45,87,0.517,34,61,0.557,11,26,0.423,11,14,0.786,112,32,84,0.381,25,67,0.373,7,17,0.412,16,28,0.571,87
384,PHO,11/12/2014,112,,BRK,1,240,39,81,0.481,31,57,0.544,8,24,0.333,26,29,0.897,112,35,74,0.473,26,53,0.491,9,21,0.429,25,32,0.781,104
385,ORL,11/7/2014,112,,MIN,1,265,46,91,0.505,41,81,0.506,5,10,0.5,15,19,0.789,112,40,93,0.43,36,75,0.48,4,18,0.222,19,25,0.76,103
386,PHO,11/7/2014,112,,SAC,0,290,42,98,0.429,32,67,0.478,10,31,0.323,18,25,0.72,112,39,91,0.429,36,75,0.48,3,16,0.188,33,39,0.846,114
387,PHO,11/4/2014,112,@,LAL,1,240,41,91,0.451,35,73,0.479,6,18,0.333,24,31,0.774,112,35,88,0.398,29,72,0.403,6,16,0.375,30,41,0.732,106
388,GSW,4/13/2015,111,,MEM,1,240,39,74,0.527,26,50,0.52,13,24,0.542,20,27,0.741,111,41,98,0.418,36,83,0.434,5,15,0.333,20,25,0.8,107
389,SAC,4/12/2015,111,@,DEN,0,240,38,74,0.514,33,56,0.589,5,18,0.278,30,42,0.714,111,45,82,0.549,36,56,0.643,9,26,0.346,23,30,0.767,122
390,UTA,4/11/2015,111,@,POR,1,240,36,79,0.456,30,62,0.484,6,17,0.353,33,42,0.786,111,41,87,0.471,35,57,0.614,6,30,0.2,17,22,0.773,105
391,BRK,4/8/2015,111,,ATL,0,240,41,87,0.471,34,61,0.557,7,26,0.269,22,25,0.88,111,43,86,0.5,32,58,0.552,11,28,0.393,17,25,0.68,114
392,MIN,4/7/2015,111,@,SAC,0,240,45,93,0.484,39,74,0.527,6,19,0.316,15,21,0.714,111,42,80,0.525,33,56,0.589,9,24,0.375,23,34,0.676,116
393,SAC,4/1/2015,111,@,HOU,0,240,48,96,0.5,41,82,0.5,7,14,0.5,8,16,0.5,111,41,89,0.461,23,49,0.469,18,40,0.45,15,25,0.6,115
394,BRK,3/31/2015,111,,IND,1,240,40,80,0.5,31,62,0.5,9,18,0.5,22,28,0.786,111,37,82,0.451,25,59,0.424,12,23,0.522,20,24,0.833,106
395,PHI,3/30/2015,111,,LAL,0,265,39,96,0.406,29,66,0.439,10,30,0.333,23,38,0.605,111,40,82,0.488,30,61,0.492,10,21,0.476,23,30,0.767,113
396,CHI,3/28/2015,111,,NYK,1,240,43,84,0.512,37,67,0.552,6,17,0.353,19,22,0.864,111,30,79,0.38,26,62,0.419,4,17,0.235,16,19,0.842,80
397,DET,3/27/2015,111,@,ORL,1,240,42,90,0.467,35,72,0.486,7,18,0.389,20,27,0.741,111,43,82,0.524,40,67,0.597,3,15,0.2,8,8,1,97
398,MIL,3/26/2015,111,,IND,1,240,39,73,0.534,30,54,0.556,9,19,0.474,24,34,0.706,111,30,71,0.423,16,41,0.39,14,30,0.467,33,43,0.767,107
399,CLE,3/25/2015,111,@,MEM,1,240,43,84,0.512,29,50,0.58,14,34,0.412,11,13,0.846,111,37,85,0.435,33,68,0.485,4,17,0.235,11,16,0.688,89
400,LAC,3/25/2015,111,@,NYK,1,240,44,78,0.564,33,50,0.66,11,28,0.393,12,18,0.667,111,29,82,0.354,24,59,0.407,5,23,0.217,17,19,0.895,80
401,IND,3/21/2015,111,,BRK,0,240,45,90,0.5,37,67,0.552,8,23,0.348,13,18,0.722,111,46,75,0.613,40,63,0.635,6,12,0.5,25,31,0.806,123
402,ORL,3/20/2015,111,,POR,1,240,43,94,0.457,38,82,0.463,5,12,0.417,20,24,0.833,111,38,80,0.475,31,56,0.554,7,24,0.292,21,24,0.875,104
403,NOP,3/15/2015,111,,DEN,0,290,46,99,0.465,40,77,0.519,6,22,0.273,13,21,0.619,111,46,104,0.442,36,73,0.493,10,31,0.323,16,20,0.8,118
404,NOP,3/10/2015,111,@,BRK,1,240,45,87,0.517,33,66,0.5,12,21,0.571,9,11,0.818,111,35,84,0.417,29,68,0.426,6,16,0.375,15,23,0.652,91
405,DEN,3/6/2015,111,@,SAS,0,240,45,86,0.523,39,69,0.565,6,17,0.353,15,23,0.652,111,43,79,0.544,34,55,0.618,9,24,0.375,25,33,0.758,120
406,POR,2/25/2015,111,,SAS,1,240,43,85,0.506,30,59,0.508,13,26,0.5,12,15,0.8,111,37,85,0.435,29,64,0.453,8,21,0.381,13,14,0.929,95
407,BOS,2/22/2015,111,@,LAL,0,265,42,98,0.429,34,65,0.523,8,33,0.242,19,27,0.704,111,43,84,0.512,36,66,0.545,7,18,0.389,25,38,0.658,118
408,MIN,2/20/2015,111,,PHO,1,240,40,86,0.465,36,71,0.507,4,15,0.267,27,38,0.711,111,40,89,0.449,33,72,0.458,7,17,0.412,22,31,0.71,109
409,DAL,2/20/2015,111,,HOU,1,240,44,93,0.473,35,69,0.507,9,24,0.375,14,18,0.778,111,36,87,0.414,24,50,0.48,12,37,0.324,16,26,0.615,100
410,MIA,2/20/2015,111,@,NYK,1,240,38,79,0.481,29,59,0.492,9,20,0.45,26,35,0.743,111,35,82,0.427,29,64,0.453,6,18,0.333,11,16,0.688,87
411,MIL,2/11/2015,111,,SAC,1,240,39,80,0.488,32,65,0.492,7,15,0.467,26,32,0.813,111,36,84,0.429,28,62,0.452,8,22,0.364,23,30,0.767,103
412,DAL,2/7/2015,111,,POR,1,265,43,105,0.41,29,69,0.42,14,36,0.389,11,16,0.688,111,37,89,0.416,27,57,0.474,10,32,0.313,17,24,0.708,101
413,MIL,2/6/2015,111,@,HOU,0,240,48,95,0.505,44,78,0.564,4,17,0.235,11,15,0.733,111,41,81,0.506,26,49,0.531,15,32,0.469,20,29,0.69,117
414,GSW,1/27/2015,111,,CHI,0,265,48,113,0.425,39,80,0.488,9,33,0.273,6,12,0.5,111,42,98,0.429,34,69,0.493,8,29,0.276,21,23,0.913,113
415,BOS,1/25/2015,111,@,GSW,0,240,41,95,0.432,31,67,0.463,10,28,0.357,19,27,0.704,111,42,89,0.472,34,66,0.515,8,23,0.348,22,25,0.88,114
416,PHO,1/23/2015,111,,HOU,0,240,42,91,0.462,32,61,0.525,10,30,0.333,17,24,0.708,111,44,84,0.524,34,57,0.596,10,27,0.37,15,20,0.75,113
417,WAS,1/19/2015,111,,PHI,1,240,45,81,0.556,38,68,0.559,7,13,0.538,14,18,0.778,111,28,85,0.329,22,61,0.361,6,24,0.25,14,23,0.609,76
418,TOR,1/12/2015,111,,DET,0,240,47,87,0.54,40,60,0.667,7,27,0.259,10,14,0.714,111,41,96,0.427,34,75,0.453,7,21,0.333,25,31,0.806,114
419,MIN,1/7/2015,111,,PHO,0,240,44,92,0.478,37,75,0.493,7,17,0.412,16,19,0.842,111,46,96,0.479,41,70,0.586,5,26,0.192,16,19,0.842,113
420,NOP,1/2/2015,111,,HOU,1,240,44,83,0.53,37,68,0.544,7,15,0.467,16,20,0.8,111,35,88,0.398,29,59,0.492,6,29,0.207,7,11,0.636,83
421,LAL,12/30/2014,111,@,DEN,1,240,40,76,0.526,26,51,0.51,14,25,0.56,17,26,0.654,111,39,87,0.448,31,61,0.508,8,26,0.308,17,27,0.63,103
422,MEM,12/26/2014,111,,HOU,0,265,43,104,0.413,36,80,0.45,7,24,0.292,18,23,0.783,111,41,91,0.451,27,57,0.474,14,34,0.412,21,28,0.75,117
423,OKC,12/23/2014,111,,POR,0,265,46,101,0.455,40,82,0.488,6,19,0.316,13,15,0.867,111,38,91,0.418,21,60,0.35,17,31,0.548,22,24,0.917,115
424,PHO,12/17/2014,111,@,CHO,1,240,43,82,0.524,34,57,0.596,9,25,0.36,16,21,0.762,111,40,86,0.465,30,62,0.484,10,24,0.417,16,22,0.727,106
425,DEN,12/17/2014,111,,HOU,0,265,40,99,0.404,27,69,0.391,13,30,0.433,18,23,0.783,111,35,85,0.412,27,57,0.474,8,28,0.286,37,48,0.771,115
426,UTA,12/16/2014,111,@,NOP,0,240,45,90,0.5,40,75,0.533,5,15,0.333,16,19,0.842,111,47,79,0.595,39,63,0.619,8,16,0.5,17,18,0.944,119
427,MIL,12/13/2014,111,,LAC,1,240,43,76,0.566,36,65,0.554,7,11,0.636,18,24,0.75,111,39,91,0.429,25,62,0.403,14,29,0.483,14,19,0.737,106
428,OKC,12/12/2014,111,@,MIN,1,240,45,88,0.511,39,64,0.609,6,24,0.25,15,20,0.75,111,36,78,0.462,35,71,0.493,1,7,0.143,19,29,0.655,92
429,WAS,12/3/2014,111,,LAL,1,240,45,93,0.484,39,74,0.527,6,19,0.316,15,19,0.789,111,33,85,0.388,21,56,0.375,12,29,0.414,17,21,0.81,95
430,CLE,12/2/2014,111,,MIL,1,240,39,73,0.534,33,52,0.635,6,21,0.286,27,38,0.711,111,45,92,0.489,38,72,0.528,7,20,0.35,11,13,0.846,108
431,SAS,11/30/2014,111,@,BOS,1,240,41,85,0.482,30,59,0.508,11,26,0.423,18,20,0.9,111,36,87,0.414,30,69,0.435,6,18,0.333,11,15,0.733,89
432,GSW,11/26/2014,111,@,ORL,1,240,44,85,0.518,32,59,0.542,12,26,0.462,11,19,0.579,111,36,87,0.414,30,67,0.448,6,20,0.3,18,24,0.75,96
433,IND,11/24/2014,111,@,DAL,1,240,37,77,0.481,24,51,0.471,13,26,0.5,24,36,0.667,111,40,80,0.5,32,56,0.571,8,24,0.333,12,21,0.571,100
434,WAS,11/22/2014,111,@,MIL,1,240,43,93,0.462,35,75,0.467,8,18,0.444,17,22,0.773,111,36,84,0.429,31,69,0.449,5,15,0.333,23,26,0.885,100
435,TOR,11/15/2014,111,,UTA,1,240,43,84,0.512,35,63,0.556,8,21,0.381,17,23,0.739,111,33,75,0.44,28,59,0.475,5,16,0.313,22,30,0.733,93
436,MEM,11/13/2014,111,,SAC,1,240,39,77,0.506,33,68,0.485,6,9,0.667,27,34,0.794,111,37,77,0.481,30,64,0.469,7,13,0.538,29,34,0.853,110
437,NOP,11/10/2014,111,@,CLE,0,240,41,93,0.441,29,66,0.439,12,27,0.444,17,20,0.85,111,40,81,0.494,27,54,0.5,13,27,0.481,25,30,0.833,118
438,LAL,10/31/2014,111,,LAC,0,240,42,82,0.512,35,62,0.565,7,20,0.35,20,28,0.714,111,34,71,0.479,22,38,0.579,12,33,0.364,38,44,0.864,118
439,LAC,4/13/2015,110,,DEN,1,240,37,82,0.451,30,61,0.492,7,21,0.333,29,37,0.784,110,38,101,0.376,26,68,0.382,12,33,0.364,15,22,0.682,103
440,GSW,4/11/2015,110,,MIN,1,240,42,93,0.452,31,62,0.5,11,31,0.355,15,21,0.714,110,35,79,0.443,24,55,0.436,11,24,0.458,20,26,0.769,101
441,SAS,4/8/2015,110,,HOU,1,240,48,95,0.505,41,74,0.554,7,21,0.333,7,9,0.778,110,39,84,0.464,29,59,0.492,10,25,0.4,10,16,0.625,98
442,MEM,4/8/2015,110,,NOP,1,240,45,88,0.511,37,71,0.521,8,17,0.471,12,14,0.857,110,28,80,0.35,22,59,0.373,6,21,0.286,12,18,0.667,74
443,DAL,4/4/2015,110,,GSW,0,240,34,80,0.425,31,64,0.484,3,16,0.188,39,54,0.722,110,43,95,0.453,29,59,0.492,14,36,0.389,23,32,0.719,123
444,MIL,4/3/2015,110,@,BOS,1,240,45,85,0.529,36,61,0.59,9,24,0.375,11,18,0.611,110,39,88,0.443,31,64,0.484,8,24,0.333,15,16,0.938,101
445,GSW,3/31/2015,110,@,LAC,1,240,38,85,0.447,30,64,0.469,8,21,0.381,26,34,0.765,110,36,82,0.439,30,60,0.5,6,22,0.273,28,33,0.848,106
446,NOP,3/29/2015,110,,MIN,1,240,43,75,0.573,37,62,0.597,6,13,0.462,18,24,0.75,110,32,75,0.427,30,63,0.476,2,12,0.167,22,24,0.917,88
447,MIN,3/27/2015,110,@,HOU,0,240,37,76,0.487,31,62,0.5,6,14,0.429,30,34,0.882,110,44,83,0.53,24,39,0.615,20,44,0.455,12,17,0.706,120
448,WAS,3/27/2015,110,,CHO,1,290,44,113,0.389,35,88,0.398,9,25,0.36,13,22,0.591,110,36,104,0.346,28,79,0.354,8,25,0.32,27,35,0.771,107
449,BOS,3/23/2015,110,@,BRK,1,240,47,92,0.511,41,70,0.586,6,22,0.273,10,14,0.714,110,32,89,0.36,31,72,0.431,1,17,0.059,26,30,0.867,91
450,HOU,3/23/2015,110,@,IND,1,240,31,65,0.477,18,41,0.439,13,24,0.542,35,37,0.946,110,40,90,0.444,32,66,0.485,8,24,0.333,12,19,0.632,100
451,ATL,3/16/2015,110,@,SAC,1,240,38,84,0.452,26,53,0.491,12,31,0.387,22,30,0.733,110,38,81,0.469,31,61,0.508,7,20,0.35,20,25,0.8,103
452,CLE,3/3/2015,110,,BOS,1,240,43,89,0.483,33,61,0.541,10,28,0.357,14,14,1,110,31,88,0.352,24,60,0.4,7,28,0.25,10,13,0.769,79
453,LAC,3/2/2015,110,@,MIN,1,240,44,92,0.478,32,59,0.542,12,33,0.364,10,19,0.526,110,36,82,0.439,32,67,0.478,4,15,0.267,29,35,0.829,105
454,BRK,3/2/2015,110,,GSW,1,240,44,89,0.494,34,68,0.5,10,21,0.476,12,16,0.75,110,42,90,0.467,31,60,0.517,11,30,0.367,13,18,0.722,108
455,POR,3/1/2015,110,@,SAC,1,240,41,83,0.494,31,59,0.525,10,24,0.417,18,20,0.9,110,39,86,0.453,36,74,0.486,3,12,0.25,18,23,0.783,99
456,CLE,2/26/2015,110,,GSW,1,240,36,77,0.468,27,49,0.551,9,28,0.321,29,35,0.829,110,39,92,0.424,28,63,0.444,11,29,0.379,10,19,0.526,99
457,PHO,2/25/2015,110,@,DEN,1,240,39,91,0.429,31,67,0.463,8,24,0.333,24,32,0.75,110,31,81,0.383,19,47,0.404,12,34,0.353,22,33,0.667,96
458,HOU,2/25/2015,110,,LAC,1,240,36,88,0.409,19,44,0.432,17,44,0.386,21,30,0.7,110,40,91,0.44,29,59,0.492,11,32,0.344,14,19,0.737,105
459,PHO,2/23/2015,110,,BOS,0,240,44,97,0.454,35,65,0.538,9,32,0.281,13,16,0.813,110,39,89,0.438,25,60,0.417,14,29,0.483,23,30,0.767,115
460,BRK,2/23/2015,110,@,DEN,1,240,43,92,0.467,39,71,0.549,4,21,0.19,20,23,0.87,110,31,94,0.33,24,67,0.358,7,27,0.259,13,22,0.591,82
461,OKC,2/21/2015,110,@,CHO,1,240,42,95,0.442,37,77,0.481,5,18,0.278,21,26,0.808,110,40,93,0.43,33,69,0.478,7,24,0.292,16,20,0.8,103
462,GSW,2/20/2015,110,,SAS,1,240,41,84,0.488,24,51,0.471,17,33,0.515,11,18,0.611,110,39,81,0.481,33,62,0.532,6,19,0.316,15,20,0.75,99
463,LAC,2/11/2015,110,,HOU,1,240,39,81,0.481,35,59,0.593,4,22,0.182,28,45,0.622,110,34,87,0.391,25,42,0.595,9,45,0.2,18,22,0.818,95
464,SAS,2/4/2015,110,,ORL,1,240,44,84,0.524,30,52,0.577,14,32,0.438,8,14,0.571,110,42,84,0.5,32,63,0.508,10,21,0.476,9,14,0.643,103
465,UTA,1/30/2015,110,,GSW,1,240,42,94,0.447,33,69,0.478,9,25,0.36,17,28,0.607,110,37,86,0.43,29,59,0.492,8,27,0.296,18,25,0.72,100
466,MIN,1/28/2015,110,,BOS,1,240,38,77,0.494,32,61,0.525,6,16,0.375,28,32,0.875,110,42,91,0.462,35,68,0.515,7,23,0.304,7,9,0.778,98
467,DET,1/25/2015,110,@,TOR,0,240,41,90,0.456,29,56,0.518,12,34,0.353,16,23,0.696,110,43,81,0.531,38,66,0.576,5,15,0.333,23,29,0.793,114
468,ATL,1/21/2015,110,,IND,1,240,39,78,0.5,26,49,0.531,13,29,0.448,19,26,0.731,110,31,78,0.397,26,53,0.491,5,25,0.2,24,26,0.923,91
469,HOU,1/19/2015,110,,IND,1,240,37,72,0.514,25,41,0.61,12,31,0.387,24,33,0.727,110,39,85,0.459,33,58,0.569,6,27,0.222,14,18,0.778,98
470,SAS,1/16/2015,110,,POR,1,240,42,94,0.447,31,65,0.477,11,29,0.379,15,17,0.882,110,37,74,0.5,31,55,0.564,6,19,0.316,16,20,0.8,96
471,PHO,1/16/2015,110,,MIN,1,240,48,87,0.552,43,72,0.597,5,15,0.333,9,11,0.818,110,42,91,0.462,34,69,0.493,8,22,0.364,7,12,0.583,99
472,ATL,1/16/2015,110,@,TOR,1,240,42,69,0.609,30,46,0.652,12,23,0.522,14,16,0.875,110,35,82,0.427,29,57,0.509,6,25,0.24,13,17,0.765,89
473,MIN,1/13/2015,110,@,IND,1,240,41,87,0.471,31,67,0.463,10,20,0.5,18,19,0.947,110,39,80,0.488,34,62,0.548,5,18,0.278,18,30,0.6,101
474,PHO,1/11/2015,110,@,MEM,0,290,42,100,0.42,34,65,0.523,8,35,0.229,18,23,0.783,110,48,100,0.48,39,79,0.494,9,21,0.429,17,24,0.708,122
475,CHO,1/10/2015,110,@,NYK,1,240,39,78,0.5,32,62,0.516,7,16,0.438,25,33,0.758,110,33,85,0.388,25,56,0.446,8,29,0.276,8,9,0.889,82
476,DEN,1/5/2015,110,@,MIN,1,240,46,84,0.548,39,65,0.6,7,19,0.368,11,16,0.688,110,38,89,0.427,28,65,0.431,10,24,0.417,15,18,0.833,101
477,SAC,1/1/2015,110,@,MIN,1,240,40,74,0.541,35,62,0.565,5,12,0.417,25,29,0.862,110,42,91,0.462,35,67,0.522,7,24,0.292,16,22,0.727,107
478,NOP,12/30/2014,110,,PHO,1,240,42,81,0.519,34,63,0.54,8,18,0.444,18,29,0.621,110,41,86,0.477,32,65,0.492,9,21,0.429,15,19,0.789,106
479,SAS,12/28/2014,110,,HOU,1,240,39,83,0.47,28,53,0.528,11,30,0.367,21,24,0.875,110,38,77,0.494,26,44,0.591,12,33,0.364,18,31,0.581,106
480,GSW,12/27/2014,110,,MIN,1,240,41,88,0.466,30,60,0.5,11,28,0.393,17,21,0.81,110,34,77,0.442,26,58,0.448,8,19,0.421,21,36,0.583,97
481,TOR,12/27/2014,110,@,LAC,1,240,41,86,0.477,28,52,0.538,13,34,0.382,15,19,0.789,110,37,81,0.457,25,56,0.446,12,25,0.48,12,15,0.8,98
482,IND,12/27/2014,110,@,BRK,1,240,44,86,0.512,35,68,0.515,9,18,0.5,13,18,0.722,110,28,77,0.364,21,52,0.404,7,25,0.28,22,27,0.815,85
483,HOU,12/22/2014,110,,POR,1,240,41,87,0.471,28,51,0.549,13,36,0.361,15,20,0.75,110,34,76,0.447,24,49,0.49,10,27,0.37,17,18,0.944,95
484,CHO,12/22/2014,110,,DEN,1,240,43,80,0.538,35,61,0.574,8,19,0.421,16,24,0.667,110,31,82,0.378,29,64,0.453,2,18,0.111,18,24,0.75,82
485,BRK,12/21/2014,110,,DET,1,240,40,76,0.526,32,56,0.571,8,20,0.4,22,29,0.759,110,40,91,0.44,31,64,0.484,9,27,0.333,16,26,0.615,105
486,TOR,12/19/2014,110,@,DET,1,240,42,88,0.477,34,61,0.557,8,27,0.296,18,24,0.75,110,41,94,0.436,33,69,0.478,8,25,0.32,10,15,0.667,100
487,IND,12/15/2014,110,,LAL,1,240,40,83,0.482,33,66,0.5,7,17,0.412,23,27,0.852,110,29,88,0.33,19,62,0.306,10,26,0.385,23,29,0.793,91
488,SAS,12/12/2014,110,,LAL,0,265,42,90,0.467,30,59,0.508,12,31,0.387,14,21,0.667,110,44,96,0.458,32,72,0.444,12,24,0.5,12,15,0.8,112
489,CLE,12/8/2014,110,@,BRK,1,240,43,90,0.478,34,65,0.523,9,25,0.36,15,22,0.682,110,36,81,0.444,32,62,0.516,4,19,0.211,12,19,0.632,88
490,DAL,11/29/2014,110,@,PHI,1,240,40,89,0.449,32,59,0.542,8,30,0.267,22,30,0.733,110,36,85,0.424,30,64,0.469,6,21,0.286,25,31,0.806,103
491,TOR,11/22/2014,110,@,CLE,1,240,32,80,0.4,24,56,0.429,8,24,0.333,38,42,0.905,110,35,81,0.432,32,65,0.492,3,16,0.188,20,29,0.69,93
492,LAC,11/20/2014,110,@,MIA,1,240,43,77,0.558,30,46,0.652,13,31,0.419,11,17,0.647,110,30,67,0.448,24,41,0.585,6,26,0.231,27,31,0.871,93
493,SAC,11/13/2014,110,@,MEM,0,240,37,77,0.481,30,64,0.469,7,13,0.538,29,34,0.853,110,39,77,0.506,33,68,0.485,6,9,0.667,27,34,0.794,111
494,BRK,11/7/2014,110,,NYK,1,240,38,74,0.514,24,50,0.48,14,24,0.583,20,26,0.769,110,37,90,0.411,29,71,0.408,8,19,0.421,17,21,0.81,99
495,CLE,11/7/2014,110,@,DEN,1,240,40,84,0.476,34,61,0.557,6,23,0.261,24,33,0.727,110,40,85,0.471,29,56,0.518,11,29,0.379,10,15,0.667,101
496,TOR,11/5/2014,110,@,BOS,1,240,42,87,0.483,35,71,0.493,7,16,0.438,19,23,0.826,110,40,78,0.513,30,52,0.577,10,26,0.385,17,18,0.944,107
497,SAC,11/3/2014,110,@,DEN,1,240,34,81,0.42,32,72,0.444,2,9,0.222,40,47,0.851,110,36,93,0.387,31,69,0.449,5,24,0.208,28,33,0.848,105
498,CLE,4/13/2015,109,,DET,1,240,43,85,0.506,26,53,0.491,17,32,0.531,6,12,0.5,109,38,83,0.458,29,58,0.5,9,25,0.36,12,20,0.6,97
499,UTA,4/13/2015,109,,DAL,1,240,41,82,0.5,30,54,0.556,11,28,0.393,16,26,0.615,109,34,82,0.415,25,62,0.403,9,20,0.45,15,23,0.652,92
500,TOR,4/3/2015,109,@,BRK,0,240,42,82,0.512,34,56,0.607,8,26,0.308,17,23,0.739,109,46,88,0.523,41,72,0.569,5,16,0.313,17,23,0.739,114
501,POR,3/30/2015,109,,PHO,1,240,44,86,0.512,32,59,0.542,12,27,0.444,9,10,0.9,109,38,87,0.437,35,71,0.493,3,16,0.188,7,10,0.7,86
502,OKC,3/29/2015,109,@,PHO,1,240,40,86,0.465,30,60,0.5,10,26,0.385,19,26,0.731,109,37,82,0.451,32,60,0.533,5,22,0.227,18,24,0.75,97
503,MIA,3/29/2015,109,,DET,1,240,39,82,0.476,32,64,0.5,7,18,0.389,24,29,0.828,109,40,83,0.482,32,58,0.552,8,25,0.32,14,22,0.636,102
504,CHO,3/22/2015,109,@,MIN,1,240,45,89,0.506,39,71,0.549,6,18,0.333,13,16,0.813,109,41,74,0.554,37,63,0.587,4,11,0.364,12,16,0.75,98
505,SAC,3/22/2015,109,,WAS,1,240,40,79,0.506,32,62,0.516,8,17,0.471,21,23,0.913,109,35,87,0.402,32,70,0.457,3,17,0.176,13,18,0.722,86
506,OKC,3/15/2015,109,,CHI,1,240,40,87,0.46,32,66,0.485,8,21,0.381,21,30,0.7,109,37,83,0.446,28,54,0.519,9,29,0.31,17,24,0.708,100
507,UTA,3/12/2015,109,,HOU,1,240,44,92,0.478,33,59,0.559,11,33,0.333,10,17,0.588,109,34,79,0.43,27,47,0.574,7,32,0.219,16,24,0.667,91
508,IND,3/12/2015,109,,MIL,1,265,39,79,0.494,30,57,0.526,9,22,0.409,22,28,0.786,109,35,91,0.385,31,77,0.403,4,14,0.286,29,36,0.806,103
509,SAC,3/7/2015,109,@,MIA,0,265,40,88,0.455,30,63,0.476,10,25,0.4,19,24,0.792,109,41,80,0.513,34,56,0.607,7,24,0.292,25,33,0.758,114
510,PHO,2/20/2015,109,@,MIN,0,240,40,89,0.449,33,72,0.458,7,17,0.412,22,31,0.71,109,40,86,0.465,36,71,0.507,4,15,0.267,27,38,0.711,111
511,SAC,2/20/2015,109,,BOS,1,240,40,83,0.482,32,61,0.525,8,22,0.364,21,26,0.808,109,40,100,0.4,34,78,0.436,6,22,0.273,15,26,0.577,101
512,MIA,2/9/2015,109,,NYK,1,240,36,74,0.486,24,52,0.462,12,22,0.545,25,29,0.862,109,36,84,0.429,29,64,0.453,7,20,0.35,16,19,0.842,95
513,POR,2/8/2015,109,@,HOU,1,240,40,76,0.526,31,47,0.66,9,29,0.31,20,23,0.87,109,31,82,0.378,18,47,0.383,13,35,0.371,23,34,0.676,98
514,DET,2/4/2015,109,@,IND,0,240,43,87,0.494,31,63,0.492,12,24,0.5,11,15,0.733,109,46,77,0.597,34,56,0.607,12,21,0.571,10,18,0.556,114
515,BRK,2/4/2015,109,@,TOR,1,240,40,81,0.494,31,62,0.5,9,19,0.474,20,23,0.87,109,35,79,0.443,25,46,0.543,10,33,0.303,13,18,0.722,93
516,MEM,1/27/2015,109,@,DAL,1,240,42,79,0.532,32,58,0.552,10,21,0.476,15,20,0.75,109,38,78,0.487,31,52,0.596,7,26,0.269,7,10,0.7,90
517,MIL,1/27/2015,109,@,MIA,1,240,39,71,0.549,30,55,0.545,9,16,0.563,22,30,0.733,109,38,75,0.507,31,55,0.564,7,20,0.35,19,26,0.731,102
518,NOP,1/25/2015,109,,DAL,1,240,40,79,0.506,32,62,0.516,8,17,0.471,21,25,0.84,109,39,81,0.481,30,57,0.526,9,24,0.375,19,25,0.76,106
519,SAS,1/20/2015,109,@,DEN,1,240,38,84,0.452,27,57,0.474,11,27,0.407,22,27,0.815,109,37,79,0.468,32,65,0.492,5,14,0.357,20,29,0.69,99
520,CLE,1/15/2015,109,@,LAL,1,240,37,78,0.474,28,48,0.583,9,30,0.3,26,36,0.722,109,39,76,0.513,31,52,0.596,8,24,0.333,16,23,0.696,102
521,TOR,1/10/2015,109,,BOS,1,240,41,91,0.451,28,61,0.459,13,30,0.433,14,19,0.737,109,39,83,0.47,33,65,0.508,6,18,0.333,12,20,0.6,96
522,TOR,1/4/2015,109,@,PHO,0,240,38,83,0.458,29,57,0.509,9,26,0.346,24,29,0.828,109,48,89,0.539,40,66,0.606,8,23,0.348,21,28,0.75,125
523,DAL,1/4/2015,109,@,CLE,1,240,44,78,0.564,32,52,0.615,12,26,0.462,9,11,0.818,109,35,86,0.407,27,61,0.443,8,25,0.32,12,17,0.706,90
524,CHI,1/3/2015,109,,BOS,1,265,37,100,0.37,31,72,0.431,6,28,0.214,29,40,0.725,109,45,100,0.45,40,83,0.482,5,17,0.294,9,11,0.818,104
525,MEM,1/2/2015,109,@,LAL,1,240,41,84,0.488,35,70,0.5,6,14,0.429,21,31,0.677,109,43,81,0.531,37,62,0.597,6,19,0.316,14,19,0.737,106
526,OKC,1/2/2015,109,,WAS,1,240,44,83,0.53,36,64,0.563,8,19,0.421,13,19,0.684,109,39,84,0.464,28,63,0.444,11,21,0.524,13,15,0.867,102
527,DET,12/30/2014,109,@,ORL,1,240,40,86,0.465,26,53,0.491,14,33,0.424,15,29,0.517,109,38,85,0.447,34,65,0.523,4,20,0.2,6,10,0.6,86
528,ATL,12/30/2014,109,,CLE,1,240,40,79,0.506,30,50,0.6,10,29,0.345,19,26,0.731,109,37,84,0.44,24,53,0.453,13,31,0.419,14,21,0.667,101
529,BRK,12/26/2014,109,@,BOS,1,240,41,83,0.494,34,62,0.548,7,21,0.333,20,28,0.714,109,45,87,0.517,36,63,0.571,9,24,0.375,8,11,0.727,107
530,IND,12/26/2014,109,@,DET,0,240,42,83,0.506,33,63,0.524,9,20,0.45,16,22,0.727,109,47,86,0.547,37,60,0.617,10,26,0.385,15,29,0.517,119
531,DEN,12/19/2014,109,,LAC,1,240,38,80,0.475,27,51,0.529,11,29,0.379,22,30,0.733,109,39,85,0.459,36,67,0.537,3,18,0.167,25,33,0.758,106
532,CHO,12/19/2014,109,@,PHI,1,240,43,98,0.439,33,74,0.446,10,24,0.417,13,17,0.765,109,32,71,0.451,20,45,0.444,12,26,0.462,15,17,0.882,91
533,OKC,12/18/2014,109,@,GSW,0,240,41,86,0.477,30,61,0.492,11,25,0.44,16,24,0.667,109,48,94,0.511,36,63,0.571,12,31,0.387,6,10,0.6,114
534,BOS,12/17/2014,109,,ORL,1,240,44,80,0.55,37,61,0.607,7,19,0.368,14,18,0.778,109,37,85,0.435,32,66,0.485,5,19,0.263,13,15,0.867,92
535,WAS,12/16/2014,109,,MIN,1,240,43,86,0.5,33,69,0.478,10,17,0.588,13,18,0.722,109,36,81,0.444,33,73,0.452,3,8,0.375,20,35,0.571,95
536,SAC,12/11/2014,109,,HOU,0,265,39,84,0.464,31,66,0.47,8,18,0.444,23,34,0.676,109,38,95,0.4,23,51,0.451,15,44,0.341,22,31,0.71,113
537,SAS,12/10/2014,109,,NYK,1,240,37,73,0.507,27,54,0.5,10,19,0.526,25,30,0.833,109,37,76,0.487,31,61,0.508,6,15,0.4,15,17,0.882,95
538,MIL,12/5/2014,109,,MIA,1,240,39,69,0.565,30,53,0.566,9,16,0.563,22,26,0.846,109,30,68,0.441,23,50,0.46,7,18,0.389,18,27,0.667,85
539,BOS,12/3/2014,109,,DET,1,265,37,93,0.398,24,63,0.381,13,30,0.433,22,27,0.815,109,37,102,0.363,29,75,0.387,8,27,0.296,20,29,0.69,102
540,SAC,12/2/2014,109,,TOR,0,240,39,75,0.52,36,65,0.554,3,10,0.3,28,37,0.757,109,44,88,0.5,34,65,0.523,10,23,0.435,19,21,0.905,117
541,ATL,12/2/2014,109,,BOS,1,240,43,82,0.524,32,58,0.552,11,24,0.458,12,14,0.857,109,41,84,0.488,29,61,0.475,12,23,0.522,11,13,0.846,105
542,SAS,12/1/2014,109,@,PHI,1,240,36,83,0.434,27,57,0.474,9,26,0.346,28,35,0.8,109,38,89,0.427,26,60,0.433,12,29,0.414,15,25,0.6,103
543,CLE,11/29/2014,109,,IND,1,240,41,78,0.526,34,62,0.548,7,16,0.438,20,32,0.625,109,35,89,0.393,28,67,0.418,7,22,0.318,20,26,0.769,97
544,CHI,11/28/2014,109,@,BOS,1,240,37,90,0.411,32,73,0.438,5,17,0.294,30,37,0.811,109,37,92,0.402,31,70,0.443,6,22,0.273,22,29,0.759,102
545,DAL,11/26/2014,109,,NYK,1,265,38,95,0.4,34,64,0.531,4,31,0.129,29,38,0.763,109,39,92,0.424,25,64,0.391,14,28,0.5,10,16,0.625,102
546,CHI,11/25/2014,109,@,DEN,0,240,35,82,0.427,28,61,0.459,7,21,0.333,32,37,0.865,109,43,85,0.506,35,69,0.507,8,16,0.5,20,27,0.741,114
547,ATL,11/18/2014,109,,LAL,0,240,41,85,0.482,32,58,0.552,9,27,0.333,18,23,0.783,109,47,87,0.54,41,70,0.586,6,17,0.353,14,22,0.636,114
548,NYK,11/16/2014,109,,DEN,1,240,41,76,0.539,35,62,0.565,6,14,0.429,21,27,0.778,109,32,82,0.39,19,48,0.396,13,34,0.382,16,26,0.615,93
549,OKC,11/12/2014,109,@,BOS,1,240,40,82,0.488,30,58,0.517,10,24,0.417,19,22,0.864,109,37,83,0.446,28,50,0.56,9,33,0.273,11,13,0.846,94
550,NOP,11/12/2014,109,,LAL,1,240,45,82,0.549,37,63,0.587,8,19,0.421,11,18,0.611,109,35,84,0.417,28,63,0.444,7,21,0.333,25,32,0.781,102
551,DEN,11/5/2014,109,@,SAC,0,240,37,82,0.451,28,54,0.519,9,28,0.321,26,31,0.839,109,42,76,0.553,34,56,0.607,8,20,0.4,39,50,0.78,131
552,DAL,11/1/2014,109,@,NOP,1,240,46,89,0.517,40,64,0.625,6,25,0.24,11,19,0.579,109,38,89,0.427,31,70,0.443,7,19,0.368,21,28,0.75,104
553,TOR,10/29/2014,109,,ATL,1,240,37,90,0.411,29,64,0.453,8,26,0.308,27,33,0.818,109,40,80,0.5,27,58,0.466,13,22,0.591,9,17,0.529,102
554,NOP,4/15/2015,108,,SAS,1,240,43,83,0.518,38,73,0.521,5,10,0.5,17,25,0.68,108,45,79,0.57,42,69,0.609,3,10,0.3,10,13,0.769,103
555,WAS,4/15/2015,108,@,CLE,0,265,42,97,0.433,34,75,0.453,8,22,0.364,16,21,0.762,108,43,91,0.473,27,61,0.443,16,30,0.533,11,17,0.647,113
556,ATL,4/13/2015,108,,NYK,0,240,39,88,0.443,28,56,0.5,11,32,0.344,19,23,0.826,108,43,77,0.558,30,52,0.577,13,25,0.52,13,19,0.684,112
557,WAS,4/12/2015,108,,ATL,1,240,39,85,0.459,30,64,0.469,9,21,0.429,21,27,0.778,108,36,87,0.414,27,58,0.466,9,29,0.31,18,24,0.75,99
558,HOU,4/2/2015,108,@,DAL,1,240,34,77,0.442,23,46,0.5,11,31,0.355,29,40,0.725,108,37,84,0.44,29,58,0.5,8,26,0.308,19,27,0.704,101
559,GSW,3/28/2015,108,@,MIL,1,240,42,82,0.512,30,57,0.526,12,25,0.48,12,14,0.857,108,33,87,0.379,31,72,0.431,2,15,0.133,27,32,0.844,95
560,SAC,3/25/2015,108,@,PHO,1,240,40,81,0.494,32,60,0.533,8,21,0.381,20,23,0.87,108,38,87,0.437,32,62,0.516,6,25,0.24,17,26,0.654,99
561,DET,3/24/2015,108,,TOR,1,240,40,93,0.43,28,64,0.438,12,29,0.414,16,24,0.667,108,35,75,0.467,28,52,0.538,7,23,0.304,27,29,0.931,104
562,POR,3/24/2015,108,,GSW,0,240,39,92,0.424,24,58,0.414,15,34,0.441,15,19,0.789,108,50,83,0.602,38,57,0.667,12,26,0.462,10,11,0.909,122
563,CLE,3/22/2015,108,@,MIL,1,240,42,84,0.5,29,53,0.547,13,31,0.419,11,16,0.688,108,38,70,0.543,35,58,0.603,3,12,0.25,11,14,0.786,90
564,CHI,3/20/2015,108,,TOR,1,240,42,79,0.532,33,51,0.647,9,28,0.321,15,17,0.882,108,30,79,0.38,20,54,0.37,10,25,0.4,22,26,0.846,92
565,MIA,3/20/2015,108,,DEN,1,240,43,81,0.531,36,65,0.554,7,16,0.438,15,19,0.789,108,37,79,0.468,30,52,0.577,7,27,0.259,10,19,0.526,91
566,DEN,3/19/2015,108,@,HOU,0,240,42,93,0.452,29,57,0.509,13,36,0.361,11,19,0.579,108,37,83,0.446,25,53,0.472,12,30,0.4,32,40,0.8,118
567,MIA,3/18/2015,108,,POR,1,240,46,87,0.529,39,77,0.506,7,10,0.7,9,14,0.643,108,41,81,0.506,31,55,0.564,10,26,0.385,12,21,0.571,104
568,GSW,3/16/2015,108,,LAL,1,240,40,84,0.476,33,57,0.579,7,27,0.259,21,23,0.913,108,39,85,0.459,31,70,0.443,8,15,0.533,19,21,0.905,105
569,BOS,3/16/2015,108,,PHI,1,240,44,88,0.5,36,68,0.529,8,20,0.4,12,15,0.8,108,34,84,0.405,26,60,0.433,8,24,0.333,13,24,0.542,89
570,ORL,3/15/2015,108,,CLE,0,240,42,88,0.477,33,69,0.478,9,19,0.474,15,27,0.556,108,45,76,0.592,27,41,0.659,18,35,0.514,15,19,0.789,123
571,OKC,3/11/2015,108,,LAC,0,240,33,76,0.434,21,51,0.412,12,25,0.48,30,36,0.833,108,35,76,0.461,20,46,0.435,15,30,0.5,35,47,0.745,120
572,OKC,3/8/2015,108,,TOR,1,240,42,82,0.512,36,61,0.59,6,21,0.286,18,25,0.72,108,42,98,0.429,31,71,0.437,11,27,0.407,9,9,1,104
573,CHO,3/8/2015,108,@,DET,1,240,41,79,0.519,35,62,0.565,6,17,0.353,20,23,0.87,108,39,89,0.438,36,75,0.48,3,14,0.214,20,25,0.8,101
574,PHO,3/6/2015,108,@,BRK,1,265,39,91,0.429,36,65,0.554,3,26,0.115,27,35,0.771,108,34,97,0.351,26,75,0.347,8,22,0.364,24,29,0.828,100
575,CHI,3/5/2015,108,,OKC,1,240,40,87,0.46,33,62,0.532,7,25,0.28,21,26,0.808,108,41,88,0.466,33,68,0.485,8,20,0.4,15,19,0.789,105
576,GSW,3/2/2015,108,@,BRK,0,240,42,90,0.467,31,60,0.517,11,30,0.367,13,18,0.722,108,44,89,0.494,34,68,0.5,10,21,0.476,12,16,0.75,110
577,OKC,3/1/2015,108,@,LAL,1,240,40,97,0.412,29,65,0.446,11,32,0.344,17,23,0.739,108,40,90,0.444,31,65,0.477,9,25,0.36,12,18,0.667,101
578,PHI,2/23/2015,108,@,MIA,0,240,40,84,0.476,27,53,0.509,13,31,0.419,15,28,0.536,108,46,83,0.554,35,62,0.565,11,21,0.524,16,22,0.727,119
579,LAC,2/8/2015,108,@,OKC,0,240,42,90,0.467,30,58,0.517,12,32,0.375,12,17,0.706,108,46,88,0.523,38,68,0.559,8,20,0.4,31,38,0.816,131
580,POR,2/5/2015,108,,PHO,1,240,40,90,0.444,32,59,0.542,8,31,0.258,20,23,0.87,108,34,88,0.386,28,65,0.431,6,23,0.261,13,17,0.765,87
581,BOS,2/3/2015,108,@,NYK,1,240,42,77,0.545,36,53,0.679,6,24,0.25,18,23,0.783,108,41,83,0.494,34,63,0.54,7,20,0.35,8,11,0.727,97
582,DET,2/3/2015,108,,MIA,1,240,42,88,0.477,33,68,0.485,9,20,0.45,15,18,0.833,108,35,74,0.473,29,60,0.483,6,14,0.429,15,23,0.652,91
583,DAL,1/31/2015,108,@,ORL,1,240,42,74,0.568,31,53,0.585,11,21,0.524,13,22,0.591,108,33,78,0.423,25,54,0.463,8,24,0.333,19,24,0.792,93
584,NOP,1/30/2015,108,,LAC,1,240,36,86,0.419,23,61,0.377,13,25,0.52,23,26,0.885,108,42,92,0.457,35,64,0.547,7,28,0.25,12,17,0.706,103
585,CLE,1/25/2015,108,,OKC,1,240,36,82,0.439,20,46,0.435,16,36,0.444,20,29,0.69,108,37,94,0.394,27,64,0.422,10,30,0.333,14,18,0.778,98
586,UTA,1/24/2015,108,,BRK,1,240,42,79,0.532,29,50,0.58,13,29,0.448,11,14,0.786,108,29,75,0.387,24,60,0.4,5,15,0.333,10,16,0.625,73
587,CLE,1/19/2015,108,,CHI,1,240,41,90,0.456,33,72,0.458,8,18,0.444,18,25,0.72,108,30,80,0.375,22,64,0.344,8,16,0.5,26,32,0.813,94
588,SAC,1/17/2015,108,,LAC,0,240,41,89,0.461,36,71,0.507,5,18,0.278,21,26,0.808,108,44,92,0.478,35,64,0.547,9,28,0.321,20,31,0.645,117
589,DAL,1/13/2015,108,@,SAC,1,265,43,100,0.43,37,76,0.487,6,24,0.25,16,23,0.696,108,38,86,0.442,37,68,0.544,1,18,0.056,27,34,0.794,104
590,BOS,1/12/2015,108,,NOP,1,240,37,88,0.42,29,64,0.453,8,24,0.333,26,31,0.839,108,31,75,0.413,25,60,0.417,6,15,0.4,32,37,0.865,100
591,SAS,1/10/2015,108,@,MIN,1,240,41,84,0.488,32,60,0.533,9,24,0.375,17,20,0.85,108,32,81,0.395,29,66,0.439,3,15,0.2,26,26,1,93
592,SAC,1/9/2015,108,,DEN,0,240,42,86,0.488,36,67,0.537,6,19,0.316,18,24,0.75,108,47,85,0.553,42,68,0.618,5,17,0.294,19,28,0.679,118
593,DET,1/7/2015,108,@,DAL,1,240,43,97,0.443,33,76,0.434,10,21,0.476,12,14,0.857,108,38,87,0.437,32,65,0.492,6,22,0.273,13,18,0.722,95
594,CHO,12/23/2014,108,@,MIL,1,240,36,82,0.439,28,61,0.459,8,21,0.381,28,36,0.778,108,39,82,0.476,31,61,0.508,8,21,0.381,15,20,0.75,101
595,SAC,12/22/2014,108,@,GSW,0,240,43,90,0.478,35,73,0.479,8,17,0.471,14,21,0.667,108,49,91,0.538,40,66,0.606,9,25,0.36,21,24,0.875,128
596,NYK,12/21/2014,108,@,TOR,0,240,40,82,0.488,35,68,0.515,5,14,0.357,23,26,0.885,108,42,86,0.488,28,53,0.528,14,33,0.424,20,27,0.741,118
597,SAC,12/21/2014,108,,LAL,1,240,38,79,0.481,31,56,0.554,7,23,0.304,25,36,0.694,108,33,87,0.379,23,61,0.377,10,26,0.385,25,30,0.833,101
598,MIL,12/18/2014,108,@,SAC,1,240,37,75,0.493,24,52,0.462,13,23,0.565,21,27,0.778,108,38,67,0.567,32,53,0.604,6,14,0.429,25,33,0.758,107
599,POR,12/15/2014,108,,SAS,1,240,41,89,0.461,34,71,0.479,7,18,0.389,19,22,0.864,108,38,78,0.487,34,67,0.507,4,11,0.364,15,22,0.682,95
600,HOU,12/13/2014,108,,DEN,1,240,39,88,0.443,29,54,0.537,10,34,0.294,20,34,0.588,108,36,96,0.375,29,68,0.426,7,28,0.25,17,26,0.654,96
601,ATL,12/8/2014,108,@,IND,1,240,40,77,0.519,31,56,0.554,9,21,0.429,19,27,0.704,108,37,84,0.44,28,57,0.491,9,27,0.333,9,17,0.529,92
602,PHI,12/6/2014,108,@,DET,1,265,40,87,0.46,33,64,0.516,7,23,0.304,21,30,0.7,108,34,87,0.391,28,64,0.438,6,23,0.261,27,35,0.771,101
603,MIL,12/2/2014,108,@,CLE,0,240,45,92,0.489,38,72,0.528,7,20,0.35,11,13,0.846,108,39,73,0.534,33,52,0.635,6,21,0.286,27,38,0.711,111
604,DEN,11/14/2014,108,@,IND,1,240,43,87,0.494,35,64,0.547,8,23,0.348,14,25,0.56,108,34,84,0.405,26,62,0.419,8,22,0.364,11,22,0.5,87
605,POR,11/6/2014,108,,DAL,1,240,40,77,0.519,28,47,0.596,12,30,0.4,16,19,0.842,108,33,90,0.367,28,67,0.418,5,23,0.217,16,16,1,87
606,HOU,11/4/2014,108,@,MIA,1,240,35,68,0.515,18,31,0.581,17,37,0.459,21,27,0.778,108,31,74,0.419,19,46,0.413,12,28,0.429,17,27,0.63,91
607,WAS,11/1/2014,108,,MIL,1,240,40,73,0.548,36,60,0.6,4,13,0.308,24,33,0.727,108,34,80,0.425,25,58,0.431,9,22,0.409,20,24,0.833,97
608,TOR,11/1/2014,108,@,ORL,1,240,33,83,0.398,29,62,0.468,4,21,0.19,38,48,0.792,108,38,81,0.469,31,61,0.508,7,20,0.35,12,24,0.5,95
609,CHI,10/31/2014,108,,CLE,0,265,41,90,0.456,28,59,0.475,13,31,0.419,13,17,0.765,108,41,104,0.394,38,89,0.427,3,15,0.2,29,33,0.879,114
610,CHO,10/29/2014,108,,MIL,1,265,41,101,0.406,35,80,0.438,6,21,0.286,20,29,0.69,108,39,80,0.488,32,66,0.485,7,14,0.5,21,24,0.875,106
611,HOU,10/28/2014,108,@,LAL,1,240,31,73,0.425,19,44,0.432,12,29,0.414,34,50,0.68,108,28,79,0.354,25,69,0.362,3,10,0.3,31,39,0.795,90
612,MIL,4/13/2015,107,@,PHI,1,240,40,81,0.494,36,72,0.5,4,9,0.444,23,36,0.639,107,32,81,0.395,26,53,0.491,6,28,0.214,27,34,0.794,97
613,MEM,4/13/2015,107,@,GSW,0,240,41,98,0.418,36,83,0.434,5,15,0.333,20,25,0.8,107,39,74,0.527,26,50,0.52,13,24,0.542,20,27,0.741,111
614,SAS,4/12/2015,107,,PHO,1,240,35,69,0.507,27,50,0.54,8,19,0.421,29,34,0.853,107,35,85,0.412,31,69,0.449,4,16,0.25,17,23,0.739,91
615,PHI,4/11/2015,107,@,CHI,0,240,37,89,0.416,24,48,0.5,13,41,0.317,20,25,0.8,107,40,90,0.444,31,64,0.484,9,26,0.346,25,36,0.694,114
616,TOR,4/11/2015,107,@,MIA,1,240,35,83,0.422,26,57,0.456,9,26,0.346,28,37,0.757,107,37,81,0.457,31,61,0.508,6,20,0.3,24,44,0.545,104
617,IND,4/10/2015,107,@,DET,1,240,38,79,0.481,27,60,0.45,11,19,0.579,20,22,0.909,107,40,89,0.449,29,66,0.439,11,23,0.478,12,23,0.522,103
618,DAL,4/8/2015,107,,PHO,1,240,45,94,0.479,41,76,0.539,4,18,0.222,13,16,0.813,107,40,82,0.488,32,57,0.561,8,25,0.32,16,19,0.842,104
619,SAS,4/5/2015,107,,GSW,1,240,44,83,0.53,37,62,0.597,7,21,0.333,12,15,0.8,107,39,91,0.429,30,63,0.476,9,28,0.321,5,10,0.5,92
620,LAC,4/4/2015,107,@,DEN,1,240,34,79,0.43,21,45,0.467,13,34,0.382,26,42,0.619,107,32,85,0.376,26,63,0.413,6,22,0.273,22,31,0.71,92
621,POR,4/3/2015,107,@,LAL,1,240,43,88,0.489,33,62,0.532,10,26,0.385,11,11,1,107,31,82,0.378,26,68,0.382,5,14,0.357,10,17,0.588,77
622,GSW,4/2/2015,107,,PHO,1,240,43,93,0.462,33,67,0.493,10,26,0.385,11,17,0.647,107,42,90,0.467,37,71,0.521,5,19,0.263,17,26,0.654,106
623,BRK,3/29/2015,107,,LAL,1,240,42,87,0.483,34,59,0.576,8,28,0.286,15,21,0.714,107,42,91,0.462,36,73,0.493,6,18,0.333,9,11,0.818,99
624,GSW,3/27/2015,107,@,MEM,1,240,39,90,0.433,23,59,0.39,16,31,0.516,13,17,0.765,107,34,76,0.447,29,63,0.46,5,13,0.385,11,15,0.733,84
625,CHO,3/27/2015,107,@,WAS,0,290,36,104,0.346,28,79,0.354,8,25,0.32,27,35,0.771,107,44,113,0.389,35,88,0.398,9,25,0.36,13,22,0.591,110
626,DEN,3/27/2015,107,,UTA,1,240,39,76,0.513,26,52,0.5,13,24,0.542,16,23,0.696,107,32,81,0.395,27,54,0.5,5,27,0.185,22,31,0.71,91
627,IND,3/26/2015,107,@,MIL,0,240,30,71,0.423,16,41,0.39,14,30,0.467,33,43,0.767,107,39,73,0.534,30,54,0.556,9,19,0.474,24,34,0.706,111
628,SAC,3/24/2015,107,,PHI,1,240,35,97,0.361,28,77,0.364,7,20,0.35,30,38,0.789,107,40,81,0.494,27,53,0.509,13,28,0.464,13,21,0.619,106
629,GSW,3/23/2015,107,,WAS,1,240,39,95,0.411,26,62,0.419,13,33,0.394,16,21,0.762,107,27,81,0.333,24,70,0.343,3,11,0.273,19,26,0.731,76
630,LAC,3/22/2015,107,,NOP,1,240,42,91,0.462,35,68,0.515,7,23,0.304,16,23,0.696,107,38,75,0.507,26,53,0.491,12,22,0.545,12,16,0.75,100
631,DET,3/21/2015,107,,CHI,1,240,44,90,0.489,33,64,0.516,11,26,0.423,8,10,0.8,107,33,77,0.429,27,56,0.482,6,21,0.286,19,24,0.792,91
632,DAL,3/18/2015,107,,ORL,1,240,39,80,0.488,26,49,0.531,13,31,0.419,16,24,0.667,107,40,87,0.46,31,59,0.525,9,28,0.321,13,14,0.929,102
633,HOU,3/17/2015,107,,ORL,1,240,39,78,0.5,28,51,0.549,11,27,0.407,18,27,0.667,107,38,89,0.427,32,67,0.478,6,22,0.273,12,17,0.706,94
634,SAC,3/13/2015,107,@,PHI,0,240,35,87,0.402,31,73,0.425,4,14,0.286,33,40,0.825,107,45,95,0.474,36,63,0.571,9,32,0.281,15,23,0.652,114
635,WAS,3/12/2015,107,,MEM,1,240,40,80,0.5,35,63,0.556,5,17,0.294,22,31,0.71,107,31,80,0.388,28,61,0.459,3,19,0.158,22,30,0.733,87
636,TOR,3/10/2015,107,@,SAS,0,240,43,97,0.443,35,71,0.493,8,26,0.308,13,18,0.722,107,41,85,0.482,30,67,0.448,11,18,0.611,24,30,0.8,117
637,SAS,2/27/2015,107,@,SAC,1,240,35,88,0.398,27,65,0.415,8,23,0.348,29,32,0.906,107,38,79,0.481,37,75,0.493,1,4,0.25,19,23,0.826,96
638,WAS,2/24/2015,107,,GSW,0,240,42,79,0.532,37,61,0.607,5,18,0.278,18,21,0.857,107,45,90,0.5,33,67,0.493,12,23,0.522,12,17,0.706,114
639,PHO,2/21/2015,107,@,CHI,0,240,47,88,0.534,37,63,0.587,10,25,0.4,3,8,0.375,107,43,89,0.483,31,65,0.477,12,24,0.5,14,16,0.875,112
640,CHI,2/7/2015,107,@,NOP,1,240,43,84,0.512,33,62,0.532,10,22,0.455,11,13,0.846,107,32,86,0.372,28,69,0.406,4,17,0.235,4,7,0.571,72
641,LAC,2/6/2015,107,@,TOR,0,240,38,78,0.487,32,55,0.582,6,23,0.261,25,31,0.806,107,40,75,0.533,27,45,0.6,13,30,0.433,30,37,0.811,123
642,BOS,2/6/2015,107,,PHI,1,240,39,86,0.453,29,59,0.492,10,27,0.37,19,25,0.76,107,35,79,0.443,24,54,0.444,11,25,0.44,15,31,0.484,96
643,DET,1/17/2015,107,,PHI,1,240,38,88,0.432,23,53,0.434,15,35,0.429,16,19,0.842,107,38,82,0.463,31,54,0.574,7,28,0.25,6,7,0.857,89
644,ATL,1/17/2015,107,@,CHI,1,240,40,84,0.476,29,58,0.5,11,26,0.423,16,21,0.762,107,37,80,0.463,28,54,0.519,9,26,0.346,16,20,0.8,99
645,DAL,1/14/2015,107,@,DEN,0,240,41,100,0.41,32,63,0.508,9,37,0.243,16,20,0.8,107,41,82,0.5,37,63,0.587,4,19,0.211,28,35,0.8,114
646,PHO,1/13/2015,107,,CLE,1,240,40,76,0.526,33,56,0.589,7,20,0.35,20,27,0.741,107,36,82,0.439,23,47,0.489,13,35,0.371,15,20,0.75,100
647,IND,1/9/2015,107,,BOS,1,265,34,92,0.37,25,69,0.362,9,23,0.391,30,34,0.882,107,41,103,0.398,31,69,0.449,10,34,0.294,11,16,0.688,103
648,ATL,1/5/2015,107,@,LAC,1,240,36,81,0.444,23,54,0.426,13,27,0.481,22,33,0.667,107,33,74,0.446,26,49,0.531,7,25,0.28,25,33,0.758,98
649,POR,1/3/2015,107,,ATL,0,240,42,93,0.452,29,60,0.483,13,33,0.394,10,12,0.833,107,43,84,0.512,37,67,0.552,6,17,0.353,23,31,0.742,115
650,MIN,1/1/2015,107,,SAC,0,240,42,91,0.462,35,67,0.522,7,24,0.292,16,22,0.727,107,40,74,0.541,35,62,0.565,5,12,0.417,25,29,0.862,110
651,BRK,12/29/2014,107,,SAC,1,240,36,80,0.45,28,59,0.475,8,21,0.381,27,39,0.692,107,37,76,0.487,28,56,0.5,9,20,0.45,16,20,0.8,99
652,LAL,12/28/2014,107,,PHO,0,240,42,81,0.519,30,61,0.492,12,20,0.6,11,20,0.55,107,44,87,0.506,35,65,0.538,9,22,0.409,19,24,0.792,116
653,OKC,12/28/2014,107,@,DAL,0,240,45,90,0.5,40,76,0.526,5,14,0.357,12,21,0.571,107,39,88,0.443,29,57,0.509,10,31,0.323,24,28,0.857,112
654,CHI,12/27/2014,107,,NOP,1,240,41,89,0.461,35,69,0.507,6,20,0.3,19,22,0.864,107,41,88,0.466,37,74,0.5,4,14,0.286,14,16,0.875,100
655,MIL,12/26/2014,107,@,ATL,1,240,40,79,0.506,32,60,0.533,8,19,0.421,19,23,0.826,107,31,76,0.408,27,53,0.509,4,23,0.174,11,14,0.786,77
656,BOS,12/26/2014,107,,BRK,0,240,45,87,0.517,36,63,0.571,9,24,0.375,8,11,0.727,107,41,83,0.494,34,62,0.548,7,21,0.333,20,28,0.714,109
657,ATL,12/23/2014,107,,LAC,1,240,34,76,0.447,22,53,0.415,12,23,0.522,27,35,0.771,107,37,92,0.402,26,63,0.413,11,29,0.379,19,28,0.679,104
658,SAC,12/18/2014,107,,MIL,0,240,38,67,0.567,32,53,0.604,6,14,0.429,25,33,0.758,107,37,75,0.493,24,52,0.462,13,23,0.565,21,27,0.778,108
659,DAL,12/16/2014,107,@,NYK,1,240,42,83,0.506,27,50,0.54,15,33,0.455,8,8,1,107,37,84,0.44,32,63,0.508,5,21,0.238,8,10,0.8,87
660,CHO,12/12/2014,107,@,MEM,0,290,41,98,0.418,35,81,0.432,6,17,0.353,19,27,0.704,107,39,85,0.459,33,72,0.458,6,13,0.462,29,38,0.763,113
661,NOP,12/10/2014,107,@,DAL,0,240,40,88,0.455,33,70,0.471,7,18,0.389,20,24,0.833,107,44,83,0.53,35,62,0.565,9,21,0.429,15,17,0.882,112
662,DEN,12/8/2014,107,@,TOR,0,265,43,104,0.413,33,74,0.446,10,30,0.333,11,15,0.733,107,41,81,0.506,32,48,0.667,9,33,0.273,21,29,0.724,112
663,SAS,12/5/2014,107,@,MEM,1,240,40,84,0.476,26,59,0.441,14,25,0.56,13,16,0.813,107,37,80,0.463,32,68,0.471,5,12,0.417,22,26,0.846,101
664,DAL,12/3/2014,107,@,MIL,1,240,42,92,0.457,34,65,0.523,8,27,0.296,15,22,0.682,107,38,73,0.521,31,62,0.5,7,11,0.636,22,32,0.688,105
665,WAS,12/1/2014,107,,MIA,1,240,39,72,0.542,29,53,0.547,10,19,0.526,19,24,0.792,107,33,72,0.458,31,50,0.62,2,22,0.091,18,30,0.6,86
666,POR,11/30/2014,107,,MIN,1,240,39,86,0.453,27,53,0.509,12,33,0.364,17,25,0.68,107,39,90,0.433,37,81,0.457,2,9,0.222,13,20,0.65,93
667,MEM,11/23/2014,107,,LAC,1,240,42,85,0.494,35,64,0.547,7,21,0.333,16,23,0.696,107,32,77,0.416,25,52,0.481,7,25,0.28,20,28,0.714,91
668,DEN,11/19/2014,107,,OKC,1,240,40,82,0.488,30,53,0.566,10,29,0.345,17,22,0.773,107,36,79,0.456,26,56,0.464,10,23,0.435,18,25,0.72,100
669,ORL,11/17/2014,107,@,DET,1,240,41,79,0.519,28,53,0.528,13,26,0.5,12,15,0.8,107,32,80,0.4,21,56,0.375,11,24,0.458,18,24,0.75,93
670,DAL,11/17/2014,107,@,CHO,1,240,43,84,0.512,33,56,0.589,10,28,0.357,11,16,0.688,107,32,80,0.4,22,58,0.379,10,22,0.455,6,13,0.462,80
671,PHO,11/15/2014,107,@,LAC,0,240,38,99,0.384,27,69,0.391,11,30,0.367,20,23,0.87,107,36,68,0.529,22,39,0.564,14,29,0.483,34,43,0.791,120
672,GSW,11/13/2014,107,,BRK,1,240,41,90,0.456,30,56,0.536,11,34,0.324,14,21,0.667,107,39,89,0.438,36,73,0.493,3,16,0.188,18,20,0.9,99
673,WAS,11/12/2014,107,,DET,1,240,40,83,0.482,37,72,0.514,3,11,0.273,24,33,0.727,107,38,81,0.469,29,59,0.492,9,22,0.409,18,22,0.818,103
674,MEM,11/11/2014,107,,LAL,1,240,41,78,0.526,37,67,0.552,4,11,0.364,21,26,0.808,107,41,87,0.471,34,65,0.523,7,22,0.318,13,17,0.765,102
675,PHO,11/9/2014,107,,GSW,1,240,34,79,0.43,22,49,0.449,12,30,0.4,27,33,0.818,107,33,69,0.478,22,45,0.489,11,24,0.458,18,21,0.857,95
676,LAL,11/9/2014,107,,CHO,1,240,42,82,0.512,36,65,0.554,6,17,0.353,17,22,0.773,107,35,79,0.443,32,65,0.492,3,14,0.214,19,27,0.704,92
677,BOS,11/5/2014,107,,TOR,0,240,40,78,0.513,30,52,0.577,10,26,0.385,17,18,0.944,107,42,87,0.483,35,71,0.493,7,16,0.438,19,23,0.826,110
678,LAC,11/3/2014,107,,UTA,1,240,41,81,0.506,31,58,0.534,10,23,0.435,15,17,0.882,107,36,77,0.468,26,50,0.52,10,27,0.37,19,24,0.792,101
679,MIA,11/2/2014,107,,TOR,1,240,35,70,0.5,26,46,0.565,9,24,0.375,28,38,0.737,107,37,79,0.468,33,63,0.524,4,16,0.25,24,39,0.615,102
680,MIA,10/29/2014,107,,WAS,1,240,39,81,0.481,30,53,0.566,9,28,0.321,20,23,0.87,107,36,75,0.48,30,56,0.536,6,19,0.316,17,24,0.708,95
681,LAL,4/12/2015,106,,DAL,0,240,34,78,0.436,25,54,0.463,9,24,0.375,29,36,0.806,106,45,83,0.542,35,62,0.565,10,21,0.476,20,26,0.769,120
682,LAL,4/10/2015,106,,MIN,1,240,41,83,0.494,32,60,0.533,9,23,0.391,15,24,0.625,106,32,74,0.432,29,59,0.492,3,15,0.2,31,34,0.912,98
683,BRK,4/6/2015,106,,POR,1,240,41,91,0.451,35,77,0.455,6,14,0.429,18,23,0.783,106,39,87,0.448,28,61,0.459,11,26,0.423,7,9,0.778,96
684,LAC,4/5/2015,106,@,LAL,1,240,40,75,0.533,25,48,0.521,15,27,0.556,11,18,0.611,106,29,75,0.387,22,58,0.379,7,17,0.412,13,22,0.591,78
685,PHO,4/2/2015,106,@,GSW,0,240,42,90,0.467,37,71,0.521,5,19,0.263,17,26,0.654,106,43,93,0.462,33,67,0.493,10,26,0.385,11,17,0.647,107
686,WAS,4/1/2015,106,,PHI,1,240,44,76,0.579,40,64,0.625,4,12,0.333,14,22,0.636,106,36,91,0.396,26,57,0.456,10,34,0.294,11,17,0.647,93
687,IND,3/31/2015,106,@,BRK,0,240,37,82,0.451,25,59,0.424,12,23,0.522,20,24,0.833,106,40,80,0.5,31,62,0.5,9,18,0.5,22,28,0.786,111
688,LAC,3/31/2015,106,,GSW,0,240,36,82,0.439,30,60,0.5,6,22,0.273,28,33,0.848,106,38,85,0.447,30,64,0.469,8,21,0.381,26,34,0.765,110
689,BOS,3/29/2015,106,,LAC,0,240,39,93,0.419,31,62,0.5,8,31,0.258,20,23,0.87,106,41,84,0.488,28,52,0.538,13,32,0.406,24,40,0.6,119
690,BRK,3/27/2015,106,,CLE,1,240,40,86,0.465,31,63,0.492,9,23,0.391,17,19,0.895,106,37,81,0.457,29,51,0.569,8,30,0.267,16,20,0.8,98
691,PHI,3/24/2015,106,@,SAC,0,240,40,81,0.494,27,53,0.509,13,28,0.464,13,21,0.619,106,35,97,0.361,28,77,0.364,7,20,0.35,30,38,0.789,107
692,MIN,3/23/2015,106,@,UTA,1,265,37,78,0.474,25,59,0.424,12,19,0.632,20,25,0.8,106,38,87,0.437,29,59,0.492,9,28,0.321,19,31,0.613,104
693,TOR,3/22/2015,106,,NYK,1,240,39,75,0.52,35,64,0.547,4,11,0.364,24,29,0.828,106,35,84,0.417,27,65,0.415,8,19,0.421,11,16,0.688,89
694,GSW,3/21/2015,106,,UTA,1,240,38,78,0.487,30,60,0.5,8,18,0.444,22,26,0.846,106,32,73,0.438,22,51,0.431,10,22,0.455,17,21,0.81,91
695,MIN,3/16/2015,106,,BRK,0,240,41,88,0.466,32,73,0.438,9,15,0.6,15,17,0.882,106,52,90,0.578,47,77,0.61,5,13,0.385,13,17,0.765,122
696,MIA,3/16/2015,106,,CLE,1,240,42,76,0.553,38,61,0.623,4,15,0.267,18,22,0.818,106,30,79,0.38,19,46,0.413,11,33,0.333,21,27,0.778,92
697,PHO,3/11/2015,106,,MIN,1,240,45,90,0.5,39,66,0.591,6,24,0.25,10,13,0.769,106,36,81,0.444,35,68,0.515,1,13,0.077,24,26,0.923,97
698,CHO,3/11/2015,106,,SAC,0,240,42,93,0.452,36,75,0.48,6,18,0.333,16,26,0.615,106,40,85,0.471,32,65,0.492,8,20,0.4,25,30,0.833,113
699,DEN,3/9/2015,106,,NYK,1,240,38,87,0.437,30,63,0.476,8,24,0.333,22,29,0.759,106,29,75,0.387,24,62,0.387,5,13,0.385,15,25,0.6,78
700,GSW,3/8/2015,106,,LAC,1,240,40,80,0.5,30,58,0.517,10,22,0.455,16,23,0.696,106,40,83,0.482,32,58,0.552,8,25,0.32,10,14,0.714,98
701,ATL,3/6/2015,106,,CLE,1,240,43,84,0.512,37,63,0.587,6,21,0.286,14,17,0.824,106,29,69,0.42,16,31,0.516,13,38,0.342,26,33,0.788,97
702,DEN,3/3/2015,106,,MIL,1,240,39,86,0.453,27,52,0.519,12,34,0.353,16,20,0.8,106,35,86,0.407,25,62,0.403,10,24,0.417,15,22,0.682,95
703,GSW,3/1/2015,106,@,BOS,1,240,40,95,0.421,28,61,0.459,12,34,0.353,14,17,0.824,106,40,109,0.367,32,78,0.41,8,31,0.258,13,17,0.765,101
704,BOS,2/27/2015,106,,CHO,1,240,40,96,0.417,26,61,0.426,14,35,0.4,12,15,0.8,106,37,82,0.451,27,61,0.443,10,21,0.476,14,17,0.824,98
705,DET,2/22/2015,106,,WAS,1,240,37,89,0.416,24,57,0.421,13,32,0.406,19,25,0.76,106,37,85,0.435,31,68,0.456,6,17,0.353,9,14,0.643,89
706,IND,2/20/2015,106,@,PHI,1,240,40,83,0.482,32,61,0.525,8,22,0.364,18,22,0.818,106,34,84,0.405,26,59,0.441,8,25,0.32,19,29,0.655,95
707,IND,2/11/2015,106,@,NOP,1,240,40,75,0.533,31,55,0.564,9,20,0.45,17,18,0.944,106,34,74,0.459,27,59,0.458,7,15,0.467,18,25,0.72,93
708,DET,2/10/2015,106,@,CHO,1,240,37,83,0.446,32,64,0.5,5,19,0.263,27,30,0.9,106,29,81,0.358,20,57,0.351,9,24,0.375,11,14,0.786,78
709,DEN,2/10/2015,106,@,LAL,1,240,43,79,0.544,39,63,0.619,4,16,0.25,16,23,0.696,106,37,85,0.435,31,67,0.463,6,18,0.333,16,27,0.593,96
710,GSW,2/7/2015,106,@,NYK,1,240,37,81,0.457,25,56,0.446,12,25,0.48,20,24,0.833,106,35,87,0.402,27,69,0.391,8,18,0.444,14,17,0.824,92
711,CLE,1/31/2015,106,@,MIN,1,240,42,87,0.483,32,55,0.582,10,32,0.313,12,19,0.632,106,34,82,0.415,28,69,0.406,6,13,0.462,16,21,0.762,90
712,GSW,1/31/2015,106,,PHO,1,240,40,87,0.46,28,55,0.509,12,32,0.375,14,18,0.778,106,33,91,0.363,24,65,0.369,9,26,0.346,12,17,0.706,87
713,PHO,1/28/2015,106,,WAS,1,240,40,88,0.455,29,59,0.492,11,29,0.379,15,18,0.833,106,37,88,0.42,29,70,0.414,8,18,0.444,16,23,0.696,98
714,DAL,1/25/2015,106,@,NOP,0,240,39,81,0.481,30,57,0.526,9,24,0.375,19,25,0.76,106,40,79,0.506,32,62,0.516,8,17,0.471,21,25,0.84,109
715,IND,1/25/2015,106,@,ORL,1,240,43,83,0.518,35,63,0.556,8,20,0.4,12,18,0.667,106,38,78,0.487,32,61,0.525,6,17,0.353,17,23,0.739,99
716,ORL,1/23/2015,106,@,NYK,0,240,44,87,0.506,37,60,0.617,7,27,0.259,11,19,0.579,106,43,91,0.473,33,66,0.5,10,25,0.4,17,21,0.81,113
717,CLE,1/21/2015,106,,UTA,1,240,42,81,0.519,37,57,0.649,5,24,0.208,17,25,0.68,106,35,84,0.417,27,62,0.435,8,22,0.364,14,18,0.778,92
718,HOU,1/17/2015,106,,GSW,0,240,37,88,0.42,30,65,0.462,7,23,0.304,25,34,0.735,106,50,91,0.549,41,69,0.594,9,22,0.409,22,33,0.667,131
719,MEM,1/16/2015,106,@,ORL,1,240,40,87,0.46,37,73,0.507,3,14,0.214,23,29,0.793,106,36,79,0.456,27,55,0.491,9,24,0.375,15,20,0.75,96
720,POR,1/11/2015,106,@,LAL,1,240,41,86,0.477,28,55,0.509,13,31,0.419,11,17,0.647,106,36,81,0.444,29,59,0.492,7,22,0.318,15,19,0.789,94
721,NOP,1/9/2015,106,,MEM,1,240,37,81,0.457,27,61,0.443,10,20,0.5,22,26,0.846,106,36,82,0.439,30,65,0.462,6,17,0.353,17,22,0.773,95
722,ATL,1/9/2015,106,@,DET,1,240,40,82,0.488,30,59,0.508,10,23,0.435,16,24,0.667,106,38,96,0.396,25,53,0.472,13,43,0.302,14,18,0.778,103
723,LAL,1/2/2015,106,,MEM,0,240,43,81,0.531,37,62,0.597,6,19,0.316,14,19,0.737,106,41,84,0.488,35,70,0.5,6,14,0.429,21,31,0.677,109
724,CHI,1/1/2015,106,,DEN,1,240,38,91,0.418,30,76,0.395,8,15,0.533,22,25,0.88,106,37,92,0.402,32,78,0.41,5,14,0.357,22,27,0.815,101
725,IND,12/31/2014,106,,MIA,1,240,35,79,0.443,25,61,0.41,10,18,0.556,26,30,0.867,106,38,77,0.494,33,61,0.541,5,16,0.313,14,18,0.778,95
726,BOS,12/31/2014,106,,SAC,1,240,44,94,0.468,39,73,0.534,5,21,0.238,13,15,0.867,106,32,87,0.368,30,72,0.417,2,15,0.133,18,28,0.643,84
727,PHO,12/30/2014,106,@,NOP,0,240,41,86,0.477,32,65,0.492,9,21,0.429,15,19,0.789,106,42,81,0.519,34,63,0.54,8,18,0.444,18,29,0.621,110
728,HOU,12/28/2014,106,@,SAS,0,240,38,77,0.494,26,44,0.591,12,33,0.364,18,31,0.581,106,39,83,0.47,28,53,0.528,11,30,0.367,21,24,0.875,110
729,SAC,12/26/2014,106,,PHO,0,240,41,93,0.441,34,73,0.466,7,20,0.35,17,24,0.708,106,46,94,0.489,32,61,0.525,14,33,0.424,9,12,0.75,115
730,DEN,12/26/2014,106,,MIN,1,240,39,95,0.411,36,76,0.474,3,19,0.158,25,32,0.781,106,41,103,0.398,38,88,0.432,3,15,0.2,17,24,0.708,102
731,SAS,12/25/2014,106,,OKC,0,240,42,81,0.519,35,58,0.603,7,23,0.304,15,21,0.714,106,42,81,0.519,33,66,0.5,9,15,0.6,21,38,0.553,114
732,LAC,12/20/2014,106,,MIL,1,240,37,81,0.457,25,55,0.455,12,26,0.462,20,27,0.741,106,43,81,0.531,35,57,0.614,8,24,0.333,8,15,0.533,102
733,LAC,12/19/2014,106,@,DEN,0,240,39,85,0.459,36,67,0.537,3,18,0.167,25,33,0.758,106,38,80,0.475,27,51,0.529,11,29,0.379,22,30,0.733,109
734,CHO,12/17/2014,106,,PHO,0,240,40,86,0.465,30,62,0.484,10,24,0.417,16,22,0.727,106,43,82,0.524,34,57,0.596,9,25,0.36,16,21,0.762,111
735,DET,12/17/2014,106,,DAL,0,240,40,89,0.449,27,56,0.482,13,33,0.394,13,19,0.684,106,40,79,0.506,30,57,0.526,10,22,0.455,27,35,0.771,117
736,LAC,12/13/2014,106,@,MIL,0,240,39,91,0.429,25,62,0.403,14,29,0.483,14,19,0.737,106,43,76,0.566,36,65,0.554,7,11,0.636,18,24,0.75,111
737,POR,12/12/2014,106,@,CHI,0,240,43,88,0.489,31,64,0.484,12,24,0.5,8,11,0.727,106,44,88,0.5,39,73,0.534,5,15,0.333,22,28,0.786,115
738,TOR,12/12/2014,106,,IND,1,240,38,91,0.418,28,65,0.431,10,26,0.385,20,22,0.909,106,33,80,0.413,25,58,0.431,8,22,0.364,20,23,0.87,94
739,DAL,12/5/2014,106,,PHO,0,240,40,88,0.455,36,69,0.522,4,19,0.211,22,30,0.733,106,45,80,0.563,32,54,0.593,13,26,0.5,15,17,0.882,118
740,LAL,12/2/2014,106,@,DET,1,240,39,81,0.481,29,64,0.453,10,17,0.588,18,24,0.75,106,33,90,0.367,27,69,0.391,6,21,0.286,24,31,0.774,96
741,GSW,11/28/2014,106,@,CHO,1,240,42,99,0.424,35,73,0.479,7,26,0.269,15,16,0.938,106,38,87,0.437,32,68,0.471,6,19,0.316,19,23,0.826,101
742,DAL,11/28/2014,106,@,TOR,1,240,40,86,0.465,29,60,0.483,11,26,0.423,15,22,0.682,106,38,91,0.418,24,58,0.414,14,33,0.424,12,16,0.75,102
743,SAS,11/26/2014,106,,IND,1,240,41,74,0.554,36,59,0.61,5,15,0.333,19,29,0.655,106,40,87,0.46,30,66,0.455,10,21,0.476,10,18,0.556,100
744,ATL,11/25/2014,106,@,WAS,1,240,36,85,0.424,29,60,0.483,7,25,0.28,27,34,0.794,106,36,84,0.429,27,64,0.422,9,20,0.45,21,29,0.724,102
745,CLE,11/24/2014,106,,ORL,1,240,42,81,0.519,36,65,0.554,6,16,0.375,16,22,0.727,106,29,80,0.363,24,63,0.381,5,17,0.294,11,15,0.733,74
746,NOP,11/22/2014,106,@,UTA,1,240,42,93,0.452,38,76,0.5,4,17,0.235,18,22,0.818,106,33,71,0.465,28,57,0.491,5,14,0.357,23,29,0.793,94
747,PHO,11/22/2014,106,@,IND,1,240,38,85,0.447,26,54,0.481,12,31,0.387,18,20,0.9,106,31,84,0.369,24,61,0.393,7,23,0.304,14,20,0.7,83
748,LAL,11/21/2014,106,@,DAL,0,240,44,85,0.518,39,72,0.542,5,13,0.385,13,21,0.619,106,51,82,0.622,33,47,0.702,18,35,0.514,20,28,0.714,140
749,NOP,11/18/2014,106,@,SAC,1,240,39,79,0.494,30,55,0.545,9,24,0.375,19,24,0.792,106,38,86,0.442,34,75,0.453,4,11,0.364,20,29,0.69,100
750,DEN,11/17/2014,106,@,CLE,1,240,41,85,0.482,29,54,0.537,12,31,0.387,12,15,0.8,106,34,79,0.43,24,50,0.48,10,29,0.345,19,23,0.826,97
751,DAL,11/11/2014,106,,SAC,1,240,38,80,0.475,28,53,0.528,10,27,0.37,20,24,0.833,106,32,72,0.444,23,53,0.434,9,19,0.474,25,32,0.781,98
752,BOS,11/8/2014,106,@,CHI,1,240,42,81,0.519,35,62,0.565,7,19,0.368,15,20,0.75,106,42,92,0.457,34,74,0.459,8,18,0.444,9,15,0.6,101
753,LAC,11/8/2014,106,,POR,1,240,40,81,0.494,35,69,0.507,5,12,0.417,21,30,0.7,106,36,80,0.45,26,55,0.473,10,25,0.4,20,25,0.8,102
754,LAL,11/4/2014,106,,PHO,0,240,35,88,0.398,29,72,0.403,6,16,0.375,30,41,0.732,106,41,91,0.451,35,73,0.479,6,18,0.333,24,31,0.774,112
755,CHI,11/1/2014,106,@,MIN,1,240,33,69,0.478,24,46,0.522,9,23,0.391,31,40,0.775,106,38,85,0.447,34,73,0.466,4,12,0.333,25,31,0.806,105
756,POR,10/29/2014,106,,OKC,1,240,39,87,0.448,28,58,0.483,11,29,0.379,17,22,0.773,106,33,81,0.407,31,65,0.477,2,16,0.125,21,26,0.808,89
757,MIL,10/29/2014,106,@,CHO,0,265,39,80,0.488,32,66,0.485,7,14,0.5,21,24,0.875,106,41,101,0.406,35,80,0.438,6,21,0.286,20,29,0.69,108
758,BOS,4/15/2015,105,@,MIL,1,240,42,85,0.494,29,55,0.527,13,30,0.433,8,14,0.571,105,41,89,0.461,34,68,0.5,7,21,0.333,11,16,0.688,100
759,MIA,4/15/2015,105,@,PHI,1,240,39,89,0.438,27,58,0.466,12,31,0.387,15,20,0.75,105,38,83,0.458,33,54,0.611,5,29,0.172,20,25,0.8,101
760,POR,4/11/2015,105,,UTA,0,240,41,87,0.471,35,57,0.614,6,30,0.2,17,22,0.773,105,36,79,0.456,30,62,0.484,6,17,0.353,33,42,0.786,111
761,POR,4/9/2015,105,@,GSW,0,240,46,98,0.469,39,74,0.527,7,24,0.292,6,8,0.75,105,48,90,0.533,36,64,0.563,12,26,0.462,8,9,0.889,116
762,ORL,4/8/2015,105,,CHI,1,240,38,82,0.463,30,59,0.508,8,23,0.348,21,24,0.875,105,34,79,0.43,22,53,0.415,12,26,0.462,23,31,0.742,103
763,MIA,4/7/2015,105,,CHO,1,240,40,81,0.494,37,66,0.561,3,15,0.2,22,28,0.786,105,39,91,0.429,34,73,0.466,5,18,0.278,17,21,0.81,100
764,LAC,4/7/2015,105,,LAL,1,240,39,81,0.481,32,57,0.561,7,24,0.292,20,30,0.667,105,35,84,0.417,26,59,0.441,9,25,0.36,21,27,0.778,100
765,DET,3/31/2015,105,,ATL,1,240,41,83,0.494,30,54,0.556,11,29,0.379,12,17,0.706,105,40,84,0.476,32,59,0.542,8,25,0.32,7,10,0.7,95
766,DET,3/22/2015,105,@,BOS,1,265,39,89,0.438,30,63,0.476,9,26,0.346,18,30,0.6,105,38,105,0.362,30,78,0.385,8,27,0.296,13,17,0.765,97
767,SAC,3/18/2015,105,,LAC,0,240,38,79,0.481,35,62,0.565,3,17,0.176,26,32,0.813,105,45,88,0.511,28,51,0.549,17,37,0.459,9,13,0.692,116
768,TOR,3/18/2015,105,,MIN,1,240,35,79,0.443,23,50,0.46,12,29,0.414,23,27,0.852,105,42,87,0.483,36,70,0.514,6,17,0.353,10,15,0.667,100
769,DET,3/17/2015,105,,MEM,1,240,39,83,0.47,27,50,0.54,12,33,0.364,15,22,0.682,105,35,80,0.438,25,62,0.403,10,18,0.556,15,17,0.882,95
770,WAS,3/16/2015,105,,POR,1,240,41,82,0.5,34,70,0.486,7,12,0.583,16,26,0.615,105,36,89,0.404,28,61,0.459,8,28,0.286,17,20,0.85,97
771,LAL,3/16/2015,105,@,GSW,0,240,39,85,0.459,31,70,0.443,8,15,0.533,19,21,0.905,105,40,84,0.476,33,57,0.579,7,27,0.259,21,23,0.913,108
772,GSW,3/11/2015,105,,DET,1,240,44,84,0.524,37,64,0.578,7,20,0.35,10,13,0.769,105,42,98,0.429,38,86,0.442,4,12,0.333,10,12,0.833,98
773,POR,3/11/2015,105,,HOU,1,240,42,92,0.457,32,59,0.542,10,33,0.303,11,14,0.786,105,38,91,0.418,27,60,0.45,11,31,0.355,13,23,0.565,100
774,SAC,3/9/2015,105,@,ATL,0,240,39,81,0.481,31,61,0.508,8,20,0.4,19,20,0.95,105,53,88,0.602,33,52,0.635,20,36,0.556,4,7,0.571,130
775,CHI,3/8/2015,105,@,SAS,0,240,37,73,0.507,32,58,0.552,5,15,0.333,26,29,0.897,105,44,90,0.489,35,68,0.515,9,22,0.409,19,24,0.792,116
776,OKC,3/5/2015,105,@,CHI,0,240,41,88,0.466,33,68,0.485,8,20,0.4,15,19,0.789,105,40,87,0.46,33,62,0.532,7,25,0.28,21,26,0.808,108
777,IND,3/4/2015,105,,NYK,1,240,38,80,0.475,28,58,0.483,10,22,0.455,19,24,0.792,105,30,76,0.395,24,60,0.4,6,16,0.375,16,23,0.696,82
778,PHO,3/4/2015,105,@,ORL,1,240,37,79,0.468,29,58,0.5,8,21,0.381,23,27,0.852,105,41,87,0.471,36,67,0.537,5,20,0.25,13,15,0.867,100
779,MIN,3/2/2015,105,,LAC,0,240,36,82,0.439,32,67,0.478,4,15,0.267,29,35,0.829,105,44,92,0.478,32,59,0.542,12,33,0.364,10,19,0.526,110
780,HOU,3/1/2015,105,,CLE,1,265,34,74,0.459,23,44,0.523,11,30,0.367,26,33,0.788,105,40,98,0.408,28,58,0.483,12,40,0.3,11,21,0.524,103
781,LAC,2/25/2015,105,@,HOU,0,240,40,91,0.44,29,59,0.492,11,32,0.344,14,19,0.737,105,36,88,0.409,19,44,0.432,17,44,0.386,21,30,0.7,110
782,OKC,2/24/2015,105,,IND,1,240,40,96,0.417,31,72,0.431,9,24,0.375,16,18,0.889,105,38,88,0.432,29,62,0.468,9,26,0.346,7,11,0.636,92
783,NOP,2/21/2015,105,@,MIA,1,240,35,83,0.422,27,62,0.435,8,21,0.381,27,31,0.871,105,33,79,0.418,28,62,0.452,5,17,0.294,20,27,0.741,91
784,TOR,2/20/2015,105,@,ATL,1,240,43,96,0.448,30,66,0.455,13,30,0.433,6,8,0.75,105,29,88,0.33,21,50,0.42,8,38,0.211,14,21,0.667,80
785,LAL,2/20/2015,105,,BRK,0,240,41,89,0.461,37,66,0.561,4,23,0.174,19,29,0.655,105,42,89,0.472,32,68,0.471,10,21,0.476,20,24,0.833,114
786,OKC,2/11/2015,105,,MEM,1,240,37,83,0.446,30,63,0.476,7,20,0.35,24,25,0.96,105,32,86,0.372,30,74,0.405,2,12,0.167,23,30,0.767,89
787,MIN,2/9/2015,105,,ATL,0,240,42,93,0.452,37,77,0.481,5,16,0.313,16,22,0.727,105,44,86,0.512,34,65,0.523,10,21,0.476,19,20,0.95,117
788,LAL,2/8/2015,105,@,CLE,0,240,41,100,0.41,34,77,0.442,7,23,0.304,16,19,0.842,105,45,82,0.549,27,49,0.551,18,33,0.545,12,20,0.6,120
789,CLE,2/5/2015,105,,LAC,1,240,31,72,0.431,23,42,0.548,8,30,0.267,35,44,0.795,105,38,91,0.418,33,69,0.478,5,22,0.227,13,20,0.65,94
790,LAL,2/4/2015,105,@,MIL,0,265,39,93,0.419,30,65,0.462,9,28,0.321,18,25,0.72,105,41,82,0.5,30,56,0.536,11,26,0.423,20,22,0.909,113
791,ATL,2/4/2015,105,,WAS,1,240,38,80,0.475,27,55,0.491,11,25,0.44,18,27,0.667,105,34,77,0.442,30,61,0.492,4,16,0.25,24,30,0.8,96
792,PHI,2/3/2015,105,,DEN,1,240,31,70,0.443,20,43,0.465,11,27,0.407,32,42,0.762,105,33,85,0.388,21,54,0.389,12,31,0.387,20,28,0.714,98
793,LAC,1/31/2015,105,@,SAS,1,240,40,91,0.44,32,69,0.464,8,22,0.364,17,18,0.944,105,28,75,0.373,18,45,0.4,10,30,0.333,19,28,0.679,85
794,ATL,1/30/2015,105,,POR,1,240,40,84,0.476,29,61,0.475,11,23,0.478,14,22,0.636,105,39,87,0.448,28,57,0.491,11,30,0.367,10,11,0.909,99
795,OKC,1/21/2015,105,@,WAS,1,265,40,102,0.392,34,73,0.466,6,29,0.207,19,23,0.826,105,38,100,0.38,31,70,0.443,7,30,0.233,20,26,0.769,103
796,CHO,1/19/2015,105,,MIN,1,240,40,89,0.449,28,67,0.418,12,22,0.545,13,19,0.684,105,29,80,0.363,23,61,0.377,6,19,0.316,16,20,0.8,80
797,DEN,1/17/2015,105,,MIN,0,240,38,92,0.413,28,61,0.459,10,31,0.323,19,22,0.864,105,43,80,0.538,35,61,0.574,8,19,0.421,19,21,0.905,113
798,WAS,1/14/2015,105,@,CHI,1,240,40,78,0.513,35,63,0.556,5,15,0.333,20,25,0.8,105,34,79,0.43,21,52,0.404,13,27,0.481,18,24,0.75,99
799,NOP,1/14/2015,105,@,DET,1,240,39,80,0.488,31,59,0.525,8,21,0.381,19,23,0.826,105,34,73,0.466,26,51,0.51,8,22,0.364,18,23,0.783,94
800,ATL,1/14/2015,105,@,BOS,1,240,36,73,0.493,26,44,0.591,10,29,0.345,23,27,0.852,105,34,83,0.41,23,50,0.46,11,33,0.333,12,14,0.857,91
801,ATL,1/13/2015,105,@,PHI,1,240,42,87,0.483,30,64,0.469,12,23,0.522,9,16,0.563,105,31,76,0.408,22,51,0.431,9,25,0.36,16,25,0.64,87
802,UTA,1/13/2015,105,,GSW,0,240,39,81,0.481,32,60,0.533,7,21,0.333,20,24,0.833,105,46,91,0.505,33,66,0.5,13,25,0.52,11,13,0.846,116
803,HOU,1/7/2015,105,@,CLE,1,240,39,86,0.453,27,52,0.519,12,34,0.353,15,24,0.625,105,34,82,0.415,24,53,0.453,10,29,0.345,15,19,0.789,93
804,DET,1/6/2015,105,@,SAS,1,240,41,87,0.471,38,68,0.559,3,19,0.158,20,28,0.714,105,36,79,0.456,27,58,0.466,9,21,0.429,23,34,0.676,104
805,HOU,1/5/2015,105,@,CHI,0,240,47,102,0.461,39,77,0.506,8,25,0.32,3,5,0.6,105,41,85,0.482,36,68,0.529,5,17,0.294,27,30,0.9,114
806,IND,1/5/2015,105,@,UTA,1,240,35,74,0.473,28,61,0.459,7,13,0.538,28,30,0.933,105,35,81,0.432,31,58,0.534,4,23,0.174,27,34,0.794,101
807,MEM,1/5/2015,105,,NYK,1,240,43,82,0.524,36,67,0.537,7,15,0.467,12,19,0.632,105,33,76,0.434,25,50,0.5,8,26,0.308,9,13,0.692,83
808,TOR,1/2/2015,105,@,GSW,0,240,40,86,0.465,30,61,0.492,10,25,0.4,15,20,0.75,105,49,92,0.533,37,64,0.578,12,28,0.429,16,20,0.8,126
809,GSW,12/23/2014,105,@,LAL,0,240,39,84,0.464,27,58,0.466,12,26,0.462,15,17,0.882,105,46,89,0.517,34,63,0.54,12,26,0.462,11,17,0.647,115
810,ATL,12/22/2014,105,@,DAL,1,240,40,81,0.494,33,62,0.532,7,19,0.368,18,27,0.667,105,39,90,0.433,28,62,0.452,11,28,0.393,13,20,0.65,102
811,CLE,12/21/2014,105,,MEM,1,240,46,76,0.605,39,62,0.629,7,14,0.5,6,10,0.6,105,39,86,0.453,38,70,0.543,1,16,0.063,12,15,0.8,91
812,DET,12/21/2014,105,@,BRK,0,240,40,91,0.44,31,64,0.484,9,27,0.333,16,26,0.615,105,40,76,0.526,32,56,0.571,8,20,0.4,22,29,0.759,110
813,WAS,12/19/2014,105,@,MIA,1,240,39,79,0.494,36,65,0.554,3,14,0.214,24,33,0.727,105,40,75,0.533,31,56,0.554,9,19,0.474,14,19,0.737,103
814,UTA,12/17/2014,105,@,MIA,1,240,35,66,0.53,21,41,0.512,14,25,0.56,21,24,0.875,105,27,70,0.386,23,53,0.434,4,17,0.235,29,40,0.725,87
815,TOR,12/17/2014,105,,BRK,1,240,41,80,0.513,31,60,0.517,10,20,0.5,13,19,0.684,105,35,81,0.432,26,54,0.481,9,27,0.333,10,22,0.455,89
816,MEM,12/16/2014,105,,GSW,1,240,42,92,0.457,37,78,0.474,5,14,0.357,16,19,0.842,105,39,95,0.411,30,64,0.469,9,31,0.29,11,12,0.917,98
817,BOS,12/15/2014,105,@,PHI,1,240,38,86,0.442,32,61,0.525,6,25,0.24,23,35,0.657,105,33,93,0.355,29,65,0.446,4,28,0.143,17,21,0.81,87
818,GSW,12/13/2014,105,@,DAL,1,240,37,83,0.446,27,51,0.529,10,32,0.313,21,27,0.778,105,36,89,0.404,31,64,0.484,5,25,0.2,21,30,0.7,98
819,DET,12/12/2014,105,@,PHO,1,240,40,84,0.476,36,69,0.522,4,15,0.267,21,27,0.778,105,39,83,0.47,29,52,0.558,10,31,0.323,15,19,0.789,103
820,GSW,12/10/2014,105,,HOU,1,240,40,81,0.494,32,58,0.552,8,23,0.348,17,20,0.85,105,37,90,0.411,28,55,0.509,9,35,0.257,10,15,0.667,93
821,CHI,12/10/2014,105,,BRK,1,240,37,79,0.468,29,57,0.509,8,22,0.364,23,32,0.719,105,29,88,0.33,26,74,0.351,3,14,0.214,19,24,0.792,80
822,DAL,12/9/2014,105,@,MEM,0,240,38,85,0.447,20,45,0.444,18,40,0.45,11,14,0.786,105,41,85,0.482,34,71,0.479,7,14,0.5,25,29,0.862,114
823,CLE,12/9/2014,105,,TOR,1,240,39,79,0.494,30,53,0.566,9,26,0.346,18,21,0.857,105,42,82,0.512,35,59,0.593,7,23,0.304,10,10,1,101
824,ORL,12/6/2014,105,@,SAC,1,240,42,83,0.506,33,57,0.579,9,26,0.346,12,14,0.857,105,35,79,0.443,31,64,0.484,4,15,0.267,22,28,0.786,96
825,CLE,12/5/2014,105,@,TOR,1,240,41,84,0.488,32,64,0.5,9,20,0.45,14,21,0.667,105,35,86,0.407,27,62,0.435,8,24,0.333,13,20,0.65,91
826,MIL,12/3/2014,105,,DAL,0,240,38,73,0.521,31,62,0.5,7,11,0.636,22,32,0.688,105,42,92,0.457,34,65,0.523,8,27,0.296,15,22,0.682,107
827,HOU,12/3/2014,105,,MEM,1,240,41,93,0.441,31,65,0.477,10,28,0.357,13,20,0.65,105,39,76,0.513,37,63,0.587,2,13,0.154,16,27,0.593,96
828,BOS,12/2/2014,105,@,ATL,0,240,41,84,0.488,29,61,0.475,12,23,0.522,11,13,0.846,105,43,82,0.524,32,58,0.552,11,24,0.458,12,14,0.857,109
829,POR,12/2/2014,105,@,DEN,1,240,43,86,0.5,38,64,0.594,5,22,0.227,14,17,0.824,105,41,81,0.506,34,61,0.557,7,20,0.35,14,19,0.737,103
830,ATL,11/29/2014,105,,CHO,1,240,40,75,0.533,28,52,0.538,12,23,0.522,13,16,0.813,105,29,88,0.33,24,65,0.369,5,23,0.217,12,16,0.75,75
831,OKC,11/28/2014,105,,NYK,1,240,38,86,0.442,28,62,0.452,10,24,0.417,19,23,0.826,105,29,75,0.387,27,56,0.482,2,19,0.105,18,24,0.75,78
832,POR,11/26/2014,105,@,CHO,1,240,39,92,0.424,27,65,0.415,12,27,0.444,15,20,0.75,105,41,94,0.436,36,79,0.456,5,15,0.333,10,15,0.667,97
833,ORL,11/21/2014,105,@,CHO,1,240,39,82,0.476,35,66,0.53,4,16,0.25,23,32,0.719,105,42,91,0.462,35,71,0.493,7,20,0.35,9,15,0.6,100
834,POR,11/21/2014,105,,CHI,1,240,39,79,0.494,30,63,0.476,9,16,0.563,18,22,0.818,105,30,83,0.361,22,61,0.361,8,22,0.364,19,28,0.679,87
835,DAL,11/19/2014,105,@,WAS,1,240,34,82,0.415,22,54,0.407,12,28,0.429,25,29,0.862,105,37,84,0.44,27,62,0.435,10,22,0.455,18,21,0.857,102
836,CHI,11/17/2014,105,@,LAC,1,240,39,80,0.488,29,54,0.537,10,26,0.385,17,25,0.68,105,36,81,0.444,29,58,0.5,7,23,0.304,10,22,0.455,89
837,MIA,11/9/2014,105,@,DAL,1,240,42,76,0.553,33,53,0.623,9,23,0.391,12,20,0.6,105,35,83,0.422,26,54,0.481,9,29,0.31,17,24,0.708,96
838,DAL,11/7/2014,105,@,UTA,1,240,42,88,0.477,33,64,0.516,9,24,0.375,12,14,0.857,105,29,68,0.426,20,40,0.5,9,28,0.321,15,19,0.789,82
839,DEN,11/3/2014,105,,SAC,0,240,36,93,0.387,31,69,0.449,5,24,0.208,28,33,0.848,105,34,81,0.42,32,72,0.444,2,9,0.222,40,47,0.851,110
840,MIN,11/1/2014,105,,CHI,0,240,38,85,0.447,34,73,0.466,4,12,0.333,25,31,0.806,105,33,69,0.478,24,46,0.522,9,23,0.391,31,40,0.775,106
841,WAS,10/30/2014,105,@,ORL,1,240,39,80,0.488,32,67,0.478,7,13,0.538,20,26,0.769,105,37,72,0.514,31,57,0.544,6,15,0.4,18,24,0.75,98
842,MEM,10/29/2014,105,,MIN,1,240,43,82,0.524,39,67,0.582,4,15,0.267,15,20,0.75,105,39,86,0.453,33,74,0.446,6,12,0.5,17,23,0.739,101
843,BRK,10/29/2014,105,@,BOS,0,240,39,80,0.488,32,61,0.525,7,19,0.368,20,26,0.769,105,49,88,0.557,41,66,0.621,8,22,0.364,15,23,0.652,121
844,OKC,4/12/2015,104,@,IND,0,240,41,95,0.432,30,67,0.448,11,28,0.393,11,28,0.393,104,42,79,0.532,32,59,0.542,10,20,0.5,22,35,0.629,116
845,MIA,4/11/2015,104,,TOR,0,240,37,81,0.457,31,61,0.508,6,20,0.3,24,44,0.545,104,35,83,0.422,26,57,0.456,9,26,0.346,28,37,0.757,107
846,SAS,4/10/2015,104,@,HOU,1,240,41,85,0.482,37,68,0.544,4,17,0.235,18,24,0.75,104,31,66,0.47,22,45,0.489,9,21,0.429,32,53,0.604,103
847,ATL,4/10/2015,104,,CHO,1,240,41,82,0.5,31,54,0.574,10,28,0.357,12,16,0.75,104,30,83,0.361,22,53,0.415,8,30,0.267,12,18,0.667,80
848,PHO,4/8/2015,104,@,DAL,0,240,40,82,0.488,32,57,0.561,8,25,0.32,16,19,0.842,104,45,94,0.479,41,76,0.539,4,18,0.222,13,16,0.813,107
849,CLE,4/8/2015,104,@,MIL,1,240,36,74,0.486,25,40,0.625,11,34,0.324,21,26,0.808,104,42,84,0.5,36,66,0.545,6,18,0.333,9,13,0.692,99
850,UTA,3/30/2015,104,@,MIN,1,240,39,82,0.476,29,49,0.592,10,33,0.303,16,18,0.889,104,28,76,0.368,22,60,0.367,6,16,0.375,22,27,0.815,84
851,CHO,3/30/2015,104,,BOS,0,240,40,85,0.471,33,59,0.559,7,26,0.269,17,19,0.895,104,45,89,0.506,36,63,0.571,9,26,0.346,17,23,0.739,116
852,IND,3/29/2015,104,,DAL,1,240,38,76,0.5,28,59,0.475,10,17,0.588,18,26,0.692,104,40,90,0.444,34,75,0.453,6,15,0.4,13,19,0.684,99
853,TOR,3/24/2015,104,@,DET,0,240,35,75,0.467,28,52,0.538,7,23,0.304,27,29,0.931,104,40,93,0.43,28,64,0.438,12,29,0.414,16,24,0.667,108
854,UTA,3/23/2015,104,,MIN,0,265,38,87,0.437,29,59,0.492,9,28,0.321,19,31,0.613,104,37,78,0.474,25,59,0.424,12,19,0.632,20,25,0.8,106
855,POR,3/20/2015,104,@,ORL,0,240,38,80,0.475,31,56,0.554,7,24,0.292,21,24,0.875,104,43,94,0.457,38,82,0.463,5,12,0.417,20,24,0.833,111
856,POR,3/18/2015,104,@,MIA,0,240,41,81,0.506,31,55,0.564,10,26,0.385,12,21,0.571,104,46,87,0.529,39,77,0.506,7,10,0.7,9,14,0.643,108
857,NYK,3/17/2015,104,,SAS,1,265,41,91,0.451,38,77,0.494,3,14,0.214,19,27,0.704,104,36,94,0.383,33,80,0.413,3,14,0.214,25,30,0.833,100
858,MIA,3/11/2015,104,,BRK,1,240,37,81,0.457,31,60,0.517,6,21,0.286,24,38,0.632,104,32,73,0.438,26,56,0.464,6,17,0.353,28,39,0.718,98
859,CHI,3/11/2015,104,@,PHI,1,265,40,87,0.46,30,63,0.476,10,24,0.417,14,20,0.7,104,36,104,0.346,25,63,0.397,11,41,0.268,12,25,0.48,95
860,TOR,3/8/2015,104,@,OKC,0,240,42,98,0.429,31,71,0.437,11,27,0.407,9,9,1,104,42,82,0.512,36,61,0.59,6,21,0.286,18,25,0.72,108
861,BOS,3/6/2015,104,@,NOP,1,240,36,79,0.456,26,56,0.464,10,23,0.435,22,25,0.88,104,38,80,0.475,30,59,0.508,8,21,0.381,14,15,0.933,98
862,GSW,3/6/2015,104,,DAL,1,240,38,81,0.469,27,58,0.466,11,23,0.478,17,19,0.895,104,32,87,0.368,26,67,0.388,6,20,0.3,19,26,0.731,89
863,ATL,3/3/2015,104,,HOU,1,240,39,86,0.453,31,57,0.544,8,29,0.276,18,21,0.857,104,39,90,0.433,25,49,0.51,14,41,0.341,4,9,0.444,96
864,CHO,3/3/2015,104,,LAL,1,240,39,79,0.494,34,66,0.515,5,13,0.385,21,31,0.677,104,39,86,0.453,33,69,0.478,6,17,0.353,19,21,0.905,103
865,BRK,2/28/2015,104,@,DAL,1,240,40,77,0.519,30,54,0.556,10,23,0.435,14,23,0.609,104,35,82,0.427,26,54,0.481,9,28,0.321,15,18,0.833,94
866,NOP,2/27/2015,104,,MIA,1,240,39,76,0.513,33,60,0.55,6,16,0.375,20,27,0.741,104,41,84,0.488,33,63,0.524,8,21,0.381,12,16,0.75,102
867,UTA,2/27/2015,104,@,DEN,1,240,39,68,0.574,30,47,0.638,9,21,0.429,17,21,0.81,104,28,84,0.333,20,52,0.385,8,32,0.25,18,29,0.621,82
868,MIL,2/25/2015,104,,PHI,1,240,44,82,0.537,39,67,0.582,5,15,0.333,11,16,0.688,104,31,75,0.413,20,50,0.4,11,25,0.44,15,19,0.789,88
869,ATL,2/25/2015,104,,DAL,1,240,39,85,0.459,26,50,0.52,13,35,0.371,13,16,0.813,104,34,80,0.425,29,49,0.592,5,31,0.161,14,18,0.778,87
870,IND,2/22/2015,104,,GSW,1,240,39,81,0.481,31,62,0.5,8,19,0.421,18,23,0.783,104,34,89,0.382,25,63,0.397,9,26,0.346,21,22,0.955,98
871,OKC,2/19/2015,104,,DAL,1,240,38,91,0.418,31,69,0.449,7,22,0.318,21,26,0.808,104,33,91,0.363,24,64,0.375,9,27,0.333,14,17,0.824,89
872,SAS,2/11/2015,104,@,DET,1,240,42,88,0.477,32,61,0.525,10,27,0.37,10,11,0.909,104,33,81,0.407,24,60,0.4,9,21,0.429,12,17,0.706,87
873,CHI,2/10/2015,104,,SAC,1,240,42,80,0.525,35,60,0.583,7,20,0.35,13,15,0.867,104,35,75,0.467,33,63,0.524,2,12,0.167,14,27,0.519,86
874,BOS,2/4/2015,104,,DEN,1,240,40,99,0.404,28,71,0.394,12,28,0.429,12,17,0.706,104,33,80,0.413,29,56,0.518,4,24,0.167,30,33,0.909,100
875,OKC,2/2/2015,104,,ORL,1,240,37,75,0.493,29,55,0.527,8,20,0.4,22,26,0.846,104,38,90,0.422,32,67,0.478,6,23,0.261,15,18,0.833,97
876,CHO,1/31/2015,104,@,DEN,1,240,44,93,0.473,44,82,0.537,0,11,0,16,25,0.64,104,33,92,0.359,28,68,0.412,5,24,0.208,15,20,0.75,86
877,TOR,1/27/2015,104,@,IND,1,240,34,73,0.466,25,47,0.532,9,26,0.346,27,34,0.794,104,34,82,0.415,27,64,0.422,7,18,0.389,16,23,0.696,91
878,CHI,1/22/2015,104,,SAS,1,240,36,76,0.474,30,57,0.526,6,19,0.316,26,32,0.813,104,30,81,0.37,24,60,0.4,6,21,0.286,15,18,0.833,81
879,GSW,1/14/2015,104,,MIA,1,240,38,81,0.469,25,52,0.481,13,29,0.448,15,19,0.789,104,30,71,0.423,24,53,0.453,6,18,0.333,23,27,0.852,89
880,SAC,1/13/2015,104,,DAL,0,265,38,86,0.442,37,68,0.544,1,18,0.056,27,34,0.794,104,43,100,0.43,37,76,0.487,6,24,0.25,16,23,0.696,108
881,MIA,1/11/2015,104,@,LAC,1,240,39,81,0.481,33,60,0.55,6,21,0.286,20,24,0.833,104,34,75,0.453,25,49,0.51,9,26,0.346,13,18,0.722,90
882,SAC,1/7/2015,104,,OKC,1,240,36,92,0.391,26,73,0.356,10,19,0.526,22,28,0.786,104,29,89,0.326,20,59,0.339,9,30,0.3,16,23,0.696,83
883,SAS,1/6/2015,104,,DET,0,240,36,79,0.456,27,58,0.466,9,21,0.429,23,34,0.676,104,41,87,0.471,38,68,0.559,3,19,0.158,20,28,0.714,105
884,CHO,1/5/2015,104,@,BOS,1,240,38,78,0.487,32,59,0.542,6,19,0.316,22,23,0.957,104,36,91,0.396,29,73,0.397,7,18,0.389,16,23,0.696,95
885,BOS,1/3/2015,104,@,CHI,0,265,45,100,0.45,40,83,0.482,5,17,0.294,9,11,0.818,104,37,100,0.37,31,72,0.431,6,28,0.214,29,40,0.725,109
886,MIL,12/29/2014,104,@,CHO,1,265,40,85,0.471,34,64,0.531,6,21,0.286,18,21,0.857,104,33,90,0.367,26,65,0.4,7,25,0.28,21,26,0.808,94
887,WAS,12/29/2014,104,@,HOU,1,240,35,73,0.479,27,55,0.491,8,18,0.444,26,28,0.929,104,40,86,0.465,31,57,0.544,9,29,0.31,14,23,0.609,103
888,LAC,12/23/2014,104,@,ATL,0,240,37,92,0.402,26,63,0.413,11,29,0.379,19,28,0.679,104,34,76,0.447,22,53,0.415,12,23,0.522,27,35,0.771,107
889,MIN,12/23/2014,104,@,CLE,0,240,39,88,0.443,35,75,0.467,4,13,0.308,22,29,0.759,104,44,84,0.524,32,60,0.533,12,24,0.5,25,31,0.806,125
890,PHO,12/21/2014,104,@,WAS,1,240,40,78,0.513,34,61,0.557,6,17,0.353,18,25,0.72,104,34,83,0.41,31,69,0.449,3,14,0.214,21,29,0.724,92
891,ATL,12/20/2014,104,@,HOU,1,240,38,74,0.514,28,48,0.583,10,26,0.385,18,24,0.75,104,34,86,0.395,19,43,0.442,15,43,0.349,14,18,0.778,97
892,CHO,12/20/2014,104,,UTA,1,240,42,87,0.483,33,65,0.508,9,22,0.409,11,16,0.688,104,33,85,0.388,25,54,0.463,8,31,0.258,12,15,0.8,86
893,OKC,12/19/2014,104,@,LAL,1,240,37,86,0.43,29,65,0.446,8,21,0.381,22,29,0.759,104,41,85,0.482,31,60,0.517,10,25,0.4,11,15,0.733,103
894,POR,12/17/2014,104,,MIL,1,240,41,87,0.471,34,64,0.531,7,23,0.304,15,29,0.517,104,37,77,0.481,30,58,0.517,7,19,0.368,16,22,0.727,97
895,OKC,12/16/2014,104,@,SAC,1,240,41,87,0.471,35,67,0.522,6,20,0.3,16,24,0.667,104,36,84,0.429,31,66,0.47,5,18,0.278,15,17,0.882,92
896,WAS,12/12/2014,104,,LAC,1,240,39,80,0.488,30,64,0.469,9,16,0.563,17,21,0.81,104,32,75,0.427,26,55,0.473,6,20,0.3,26,31,0.839,96
897,NOP,12/9/2014,104,,NYK,1,240,40,80,0.5,36,65,0.554,4,15,0.267,20,26,0.769,104,37,78,0.474,28,59,0.475,9,19,0.474,10,13,0.769,93
898,NOP,12/7/2014,104,@,LAL,1,240,43,83,0.518,35,65,0.538,8,18,0.444,10,15,0.667,104,36,90,0.4,31,71,0.437,5,19,0.263,10,15,0.667,87
899,UTA,12/3/2014,104,,TOR,0,240,42,87,0.483,34,59,0.576,8,28,0.286,12,15,0.8,104,45,79,0.57,33,58,0.569,12,21,0.571,21,24,0.875,123
900,OKC,12/2/2014,104,@,NOP,0,240,37,84,0.44,30,60,0.5,7,24,0.292,23,27,0.852,104,39,88,0.443,34,71,0.479,5,17,0.294,29,45,0.644,112
901,GSW,11/30/2014,104,@,DET,1,240,37,79,0.468,28,58,0.483,9,21,0.429,21,27,0.778,104,33,91,0.363,22,68,0.324,11,23,0.478,16,24,0.667,93
902,MIL,11/28/2014,104,@,DET,1,240,39,77,0.506,26,48,0.542,13,29,0.448,13,16,0.813,104,34,83,0.41,28,60,0.467,6,23,0.261,14,25,0.56,88
903,SAC,11/28/2014,104,@,SAS,0,240,38,75,0.507,32,65,0.492,6,10,0.6,22,26,0.846,104,42,82,0.512,30,58,0.517,12,24,0.5,16,20,0.8,112
904,LAC,11/26/2014,104,@,DET,1,240,37,78,0.474,25,50,0.5,12,28,0.429,18,19,0.947,104,35,78,0.449,25,51,0.49,10,27,0.37,18,24,0.75,98
905,PHI,11/24/2014,104,,POR,0,240,42,84,0.5,42,76,0.553,0,8,0,20,24,0.833,104,44,89,0.494,37,62,0.597,7,27,0.259,19,23,0.826,114
906,TOR,11/24/2014,104,,PHO,1,240,37,82,0.451,33,65,0.508,4,17,0.235,26,32,0.813,104,39,84,0.464,25,51,0.49,14,33,0.424,8,11,0.727,100
907,BRK,11/12/2014,104,@,PHO,0,240,35,74,0.473,26,53,0.491,9,21,0.429,25,32,0.781,104,39,81,0.481,31,57,0.544,8,24,0.333,26,29,0.897,112
908,TOR,11/11/2014,104,,ORL,1,240,35,77,0.455,26,56,0.464,9,21,0.429,25,30,0.833,104,39,81,0.481,27,56,0.482,12,25,0.48,10,16,0.625,100
909,BRK,11/9/2014,104,,ORL,1,240,40,83,0.482,36,69,0.522,4,14,0.286,20,23,0.87,104,39,75,0.52,31,60,0.517,8,15,0.533,10,16,0.625,96
910,LAC,11/5/2014,104,@,GSW,0,240,38,82,0.463,31,63,0.492,7,19,0.368,21,27,0.778,104,43,74,0.581,28,49,0.571,15,25,0.6,20,20,1,121
911,HOU,11/3/2014,104,@,PHI,1,240,32,75,0.427,16,41,0.39,16,34,0.471,24,30,0.8,104,33,74,0.446,22,52,0.423,11,22,0.5,16,23,0.696,93
912,LAL,11/1/2014,104,@,GSW,0,240,41,88,0.466,37,74,0.5,4,14,0.286,18,25,0.72,104,46,83,0.554,35,60,0.583,11,23,0.478,24,28,0.857,127
913,NOP,11/1/2014,104,,DAL,0,240,38,89,0.427,31,70,0.443,7,19,0.368,21,28,0.75,104,46,89,0.517,40,64,0.625,6,25,0.24,11,19,0.579,109
914,HOU,11/1/2014,104,,BOS,1,240,32,76,0.421,20,42,0.476,12,34,0.353,28,40,0.7,104,37,98,0.378,36,73,0.493,1,25,0.04,15,18,0.833,90
915,HOU,10/29/2014,104,@,UTA,1,240,40,77,0.519,26,50,0.52,14,27,0.519,10,14,0.714,104,38,81,0.469,35,63,0.556,3,18,0.167,14,17,0.824,93
916,CHI,10/29/2014,104,@,NYK,1,240,36,71,0.507,29,47,0.617,7,24,0.292,25,30,0.833,104,31,85,0.365,28,68,0.412,3,17,0.176,15,17,0.882,80
917,SAS,4/15/2015,103,@,NOP,0,240,45,79,0.57,42,69,0.609,3,10,0.3,10,13,0.769,103,43,83,0.518,38,73,0.521,5,10,0.5,17,25,0.68,108
918,DEN,4/13/2015,103,@,LAC,0,240,38,101,0.376,26,68,0.382,12,33,0.364,15,22,0.682,103,37,82,0.451,30,61,0.492,7,21,0.333,29,37,0.784,110
919,SAC,4/10/2015,103,@,OKC,0,240,37,81,0.457,28,57,0.491,9,24,0.375,20,28,0.714,103,44,97,0.454,34,66,0.515,10,31,0.323,18,24,0.75,116
920,DET,4/10/2015,103,,IND,0,240,40,89,0.449,29,66,0.439,11,23,0.478,12,23,0.522,103,38,79,0.481,27,60,0.45,11,19,0.579,20,22,0.909,107
921,HOU,4/10/2015,103,,SAS,0,240,31,66,0.47,22,45,0.489,9,21,0.429,32,53,0.604,103,41,85,0.482,37,68,0.544,4,17,0.235,18,24,0.75,104
922,DET,4/8/2015,103,,BOS,0,240,45,84,0.536,38,66,0.576,7,18,0.389,6,10,0.6,103,36,80,0.45,28,52,0.538,8,28,0.286,33,34,0.971,113
923,UTA,4/8/2015,103,,SAC,1,240,36,74,0.486,23,43,0.535,13,31,0.419,18,25,0.72,103,33,75,0.44,26,59,0.441,7,16,0.438,18,28,0.643,91
924,CHI,4/8/2015,103,@,ORL,0,240,34,79,0.43,22,53,0.415,12,26,0.462,23,31,0.742,103,38,82,0.463,30,59,0.508,8,23,0.348,21,24,0.875,105
925,NOP,4/7/2015,103,,GSW,1,240,36,83,0.434,27,64,0.422,9,19,0.474,22,30,0.733,103,42,95,0.442,33,73,0.452,9,22,0.409,7,10,0.7,100
926,SAS,4/1/2015,103,@,ORL,1,240,35,86,0.407,22,57,0.386,13,29,0.448,20,23,0.87,103,39,93,0.419,34,76,0.447,5,17,0.294,8,9,0.889,91
927,SAS,3/29/2015,103,,MEM,1,240,42,83,0.506,38,66,0.576,4,17,0.235,15,18,0.833,103,36,82,0.439,30,68,0.441,6,14,0.429,11,12,0.917,89
928,IND,3/25/2015,103,@,WAS,1,240,38,85,0.447,29,59,0.492,9,26,0.346,18,28,0.643,103,33,75,0.44,28,61,0.459,5,14,0.357,30,38,0.789,101
929,TOR,3/25/2015,103,,CHI,0,240,39,83,0.47,30,62,0.484,9,21,0.429,16,19,0.842,103,45,74,0.608,33,51,0.647,12,23,0.522,14,17,0.824,116
930,MEM,3/23/2015,103,@,NYK,1,240,41,79,0.519,34,67,0.507,7,12,0.583,14,19,0.737,103,32,76,0.421,28,58,0.483,4,18,0.222,14,17,0.824,82
931,CHI,3/18/2015,103,,IND,1,240,34,82,0.415,24,58,0.414,10,24,0.417,25,28,0.893,103,32,81,0.395,26,62,0.419,6,19,0.316,16,21,0.762,86
932,MIL,3/18/2015,103,,SAS,0,240,39,80,0.488,32,66,0.485,7,14,0.5,18,24,0.75,103,38,76,0.5,30,56,0.536,8,20,0.4,30,38,0.789,114
933,SAC,3/16/2015,103,,ATL,0,240,38,81,0.469,31,61,0.508,7,20,0.35,20,25,0.8,103,38,84,0.452,26,53,0.491,12,31,0.387,22,30,0.733,110
934,GSW,3/13/2015,103,@,DEN,0,240,39,92,0.424,31,73,0.425,8,19,0.421,17,22,0.773,103,41,82,0.5,33,65,0.508,8,17,0.471,24,37,0.649,114
935,MIL,3/12/2015,103,@,IND,0,265,35,91,0.385,31,77,0.403,4,14,0.286,29,36,0.806,103,39,79,0.494,30,57,0.526,9,22,0.409,22,28,0.786,109
936,MIL,3/9/2015,103,,NOP,0,240,37,71,0.521,33,56,0.589,4,15,0.267,25,31,0.806,103,44,75,0.587,35,60,0.583,9,15,0.6,17,21,0.81,114
937,ORL,3/8/2015,103,,BOS,1,240,38,87,0.437,31,65,0.477,7,22,0.318,20,30,0.667,103,35,89,0.393,20,55,0.364,15,34,0.441,13,16,0.813,98
938,HOU,3/6/2015,103,,DET,1,240,38,91,0.418,32,63,0.508,6,28,0.214,21,25,0.84,103,37,102,0.363,31,73,0.425,6,29,0.207,13,17,0.765,93
939,CHO,3/6/2015,103,,TOR,1,240,40,85,0.471,35,65,0.538,5,20,0.25,18,20,0.9,103,37,91,0.407,30,69,0.435,7,22,0.318,13,15,0.867,94
940,LAL,3/3/2015,103,@,CHO,0,240,39,86,0.453,33,69,0.478,6,17,0.353,19,21,0.905,103,39,79,0.494,34,66,0.515,5,13,0.385,21,31,0.677,104
941,PHI,3/2/2015,103,,TOR,0,240,41,78,0.526,33,58,0.569,8,20,0.4,13,19,0.684,103,41,80,0.513,30,53,0.566,11,27,0.407,21,24,0.875,114
942,CLE,3/1/2015,103,@,HOU,0,265,40,98,0.408,28,58,0.483,12,40,0.3,11,21,0.524,103,34,74,0.459,23,44,0.523,11,30,0.367,26,33,0.788,105
943,NYK,2/28/2015,103,,TOR,1,240,33,75,0.44,26,56,0.464,7,19,0.368,30,38,0.789,103,34,81,0.42,26,52,0.5,8,29,0.276,22,28,0.786,98
944,ORL,2/22/2015,103,,PHI,1,240,39,82,0.476,33,59,0.559,6,23,0.261,19,26,0.731,103,36,78,0.462,23,44,0.523,13,34,0.382,13,17,0.765,98
945,CHO,2/21/2015,103,,OKC,0,240,40,93,0.43,33,69,0.478,7,24,0.292,16,20,0.8,103,42,95,0.442,37,77,0.481,5,18,0.278,21,26,0.808,110
946,SAC,2/11/2015,103,@,MIL,0,240,36,84,0.429,28,62,0.452,8,22,0.364,23,30,0.767,103,39,80,0.488,32,65,0.492,7,15,0.467,26,32,0.813,111
947,MIL,2/9/2015,103,,BRK,1,240,37,89,0.416,30,71,0.423,7,18,0.389,22,25,0.88,103,38,76,0.5,29,51,0.569,9,25,0.36,12,19,0.632,97
948,IND,2/8/2015,103,@,CHO,1,240,37,84,0.44,30,65,0.462,7,19,0.368,22,25,0.88,103,36,77,0.468,28,63,0.444,8,14,0.571,22,28,0.786,102
949,IND,2/6/2015,103,,CLE,1,240,37,79,0.468,29,58,0.5,8,21,0.381,21,26,0.808,103,40,89,0.449,29,54,0.537,11,35,0.314,8,12,0.667,99
950,ORL,2/6/2015,103,,LAL,1,265,43,83,0.518,38,68,0.559,5,15,0.333,12,14,0.857,103,39,97,0.402,28,71,0.394,11,26,0.423,8,13,0.615,97
951,ORL,2/4/2015,103,@,SAS,0,240,42,84,0.5,32,63,0.508,10,21,0.476,9,14,0.643,103,44,84,0.524,30,52,0.577,14,32,0.438,8,14,0.571,110
952,POR,2/3/2015,103,,UTA,1,240,36,76,0.474,29,53,0.547,7,23,0.304,24,34,0.706,103,39,85,0.459,33,72,0.458,6,13,0.462,18,26,0.692,102
953,PHI,1/30/2015,103,,MIN,1,240,37,74,0.5,29,51,0.569,8,23,0.348,21,25,0.84,103,34,76,0.447,29,62,0.468,5,14,0.357,21,25,0.84,94
954,LAC,1/30/2015,103,@,NOP,0,240,42,92,0.457,35,64,0.547,7,28,0.25,12,17,0.706,103,36,86,0.419,23,61,0.377,13,25,0.52,23,26,0.885,108
955,IND,1/29/2015,103,,NYK,1,240,42,79,0.532,36,61,0.59,6,18,0.333,13,18,0.722,103,34,81,0.42,29,65,0.446,5,16,0.313,9,13,0.692,82
956,CLE,1/27/2015,103,@,DET,1,240,39,93,0.419,30,59,0.508,9,34,0.265,16,17,0.941,103,35,83,0.422,27,59,0.458,8,24,0.333,17,23,0.739,95
957,MEM,1/26/2015,103,,ORL,1,240,36,76,0.474,29,58,0.5,7,18,0.389,24,26,0.923,103,37,78,0.474,33,66,0.5,4,12,0.333,16,25,0.64,94
958,POR,1/24/2015,103,,WAS,1,240,35,87,0.402,22,56,0.393,13,31,0.419,20,20,1,103,40,82,0.488,35,67,0.522,5,15,0.333,11,14,0.786,96
959,ATL,1/23/2015,103,,OKC,1,240,40,83,0.482,30,58,0.517,10,25,0.4,13,13,1,103,36,87,0.414,26,61,0.426,10,26,0.385,11,18,0.611,93
960,WAS,1/21/2015,103,,OKC,0,265,38,100,0.38,31,70,0.443,7,30,0.233,20,26,0.769,103,40,102,0.392,34,73,0.466,6,29,0.207,19,23,0.826,105
961,BRK,1/21/2015,103,@,SAC,1,240,37,79,0.468,32,59,0.542,5,20,0.25,24,30,0.8,103,39,84,0.464,34,66,0.515,5,18,0.278,17,24,0.708,100
962,DAL,1/19/2015,103,@,MEM,1,240,34,76,0.447,24,51,0.471,10,25,0.4,25,33,0.758,103,36,85,0.424,33,63,0.524,3,22,0.136,20,22,0.909,95
963,BOS,1/16/2015,103,,CHI,0,240,42,85,0.494,37,69,0.536,5,16,0.313,14,16,0.875,103,48,89,0.539,35,64,0.547,13,25,0.52,10,12,0.833,119
964,MEM,1/14/2015,103,@,BRK,1,240,39,83,0.47,36,66,0.545,3,17,0.176,22,29,0.759,103,36,75,0.48,26,49,0.531,10,26,0.385,10,12,0.833,92
965,SAC,1/11/2015,103,,CLE,1,240,42,86,0.488,36,69,0.522,6,17,0.353,13,17,0.765,103,33,78,0.423,22,46,0.478,11,32,0.344,7,12,0.583,84
966,POR,1/10/2015,103,,ORL,1,240,36,76,0.474,26,50,0.52,10,26,0.385,21,26,0.808,103,37,92,0.402,34,71,0.479,3,21,0.143,15,20,0.75,92
967,DET,1/9/2015,103,,ATL,0,240,38,96,0.396,25,53,0.472,13,43,0.302,14,18,0.778,103,40,82,0.488,30,59,0.508,10,23,0.435,16,24,0.667,106
968,BOS,1/9/2015,103,@,IND,0,265,41,103,0.398,31,69,0.449,10,34,0.294,11,16,0.688,103,34,92,0.37,25,69,0.362,9,23,0.391,30,34,0.882,107
969,CHO,1/8/2015,103,@,TOR,1,240,42,88,0.477,38,72,0.528,4,16,0.25,15,22,0.682,103,33,83,0.398,23,52,0.442,10,31,0.323,19,25,0.76,95
970,DEN,12/30/2014,103,,LAL,0,240,39,87,0.448,31,61,0.508,8,26,0.308,17,27,0.63,103,40,76,0.526,26,51,0.51,14,25,0.56,17,26,0.654,111
971,HOU,12/29/2014,103,,WAS,0,240,40,86,0.465,31,57,0.544,9,29,0.31,14,23,0.609,103,35,73,0.479,27,55,0.491,8,18,0.444,26,28,0.929,104
972,DET,12/28/2014,103,@,CLE,1,240,41,91,0.451,24,60,0.4,17,31,0.548,4,9,0.444,103,31,82,0.378,26,53,0.491,5,29,0.172,13,17,0.765,80
973,MEM,12/27/2014,103,@,MIA,1,240,34,73,0.466,27,57,0.474,7,16,0.438,28,37,0.757,103,37,72,0.514,31,52,0.596,6,20,0.3,15,21,0.714,95
974,LAL,12/19/2014,103,,OKC,0,240,41,85,0.482,31,60,0.517,10,25,0.4,11,15,0.733,103,37,86,0.43,29,65,0.446,8,21,0.381,22,29,0.759,104
975,MIA,12/19/2014,103,,WAS,0,240,40,75,0.533,31,56,0.554,9,19,0.474,14,19,0.737,103,39,79,0.494,36,65,0.554,3,14,0.214,24,33,0.727,105
976,CHI,12/19/2014,103,@,MEM,1,240,32,73,0.438,22,47,0.468,10,26,0.385,29,33,0.879,103,37,94,0.394,35,81,0.432,2,13,0.154,21,24,0.875,97
977,CHI,12/18/2014,103,,NYK,1,240,34,75,0.453,22,52,0.423,12,23,0.522,23,30,0.767,103,38,82,0.463,32,73,0.438,6,9,0.667,15,19,0.789,97
978,PHO,12/12/2014,103,,DET,0,240,39,83,0.47,29,52,0.558,10,31,0.323,15,19,0.789,103,40,84,0.476,36,69,0.522,4,15,0.267,21,27,0.778,105
979,OKC,12/11/2014,103,,CLE,1,240,38,87,0.437,31,61,0.508,7,26,0.269,20,22,0.909,103,31,85,0.365,22,57,0.386,9,28,0.321,23,30,0.767,94
980,LAC,12/10/2014,103,@,IND,1,240,42,88,0.477,35,64,0.547,7,24,0.292,12,14,0.857,103,35,89,0.393,26,62,0.419,9,27,0.333,17,22,0.773,96
981,MIA,12/9/2014,103,@,PHO,1,240,43,80,0.538,34,63,0.54,9,17,0.529,8,12,0.667,103,37,77,0.481,20,42,0.476,17,35,0.486,6,9,0.667,97
982,MEM,12/7/2014,103,,MIA,1,240,43,73,0.589,35,60,0.583,8,13,0.615,9,11,0.818,103,39,80,0.488,34,64,0.531,5,16,0.313,4,8,0.5,87
983,POR,12/7/2014,103,@,NYK,1,240,36,85,0.424,26,57,0.456,10,28,0.357,21,29,0.724,103,41,79,0.519,36,60,0.6,5,19,0.263,12,14,0.857,99
984,OKC,12/5/2014,103,@,PHI,1,240,35,71,0.493,26,48,0.542,9,23,0.391,24,31,0.774,103,32,84,0.381,24,56,0.429,8,28,0.286,19,30,0.633,91
985,CHO,12/5/2014,103,,NYK,1,240,42,88,0.477,38,70,0.543,4,18,0.222,15,18,0.833,103,37,79,0.468,27,57,0.474,10,22,0.455,18,22,0.818,102
986,DEN,12/2/2014,103,,POR,0,240,41,81,0.506,34,61,0.557,7,20,0.35,14,19,0.737,103,43,86,0.5,38,64,0.594,5,22,0.227,14,17,0.824,105
987,DEN,12/1/2014,103,@,UTA,1,240,41,87,0.471,32,61,0.525,9,26,0.346,12,17,0.706,103,36,84,0.429,29,66,0.439,7,18,0.389,22,30,0.733,101
988,PHI,12/1/2014,103,,SAS,0,240,38,89,0.427,26,60,0.433,12,29,0.414,15,25,0.6,103,36,83,0.434,27,57,0.474,9,26,0.346,28,35,0.8,109
989,PHI,11/29/2014,103,,DAL,0,240,36,85,0.424,30,64,0.469,6,21,0.286,25,31,0.806,103,40,89,0.449,32,59,0.542,8,30,0.267,22,30,0.733,110
990,MIL,11/29/2014,103,,HOU,0,240,33,74,0.446,27,55,0.491,6,19,0.316,31,35,0.886,103,44,87,0.506,29,49,0.592,15,38,0.395,14,16,0.875,117
991,MIL,11/26/2014,103,@,MIN,1,240,40,85,0.471,35,69,0.507,5,16,0.313,18,19,0.947,103,31,81,0.383,28,67,0.418,3,14,0.214,21,34,0.618,86
992,SAC,11/20/2014,103,,CHI,1,240,38,74,0.514,34,68,0.5,4,6,0.667,23,27,0.852,103,36,84,0.429,31,65,0.477,5,19,0.263,11,16,0.688,88
993,MIA,11/14/2014,103,@,ATL,0,240,35,74,0.473,25,53,0.472,10,21,0.476,23,25,0.92,103,42,75,0.56,31,47,0.66,11,28,0.393,19,23,0.826,114
994,CHO,11/14/2014,103,@,PHO,1,240,39,91,0.429,32,75,0.427,7,16,0.438,18,19,0.947,103,37,86,0.43,29,57,0.509,8,29,0.276,13,14,0.929,95
995,DET,11/12/2014,103,@,WAS,0,240,38,81,0.469,29,59,0.492,9,22,0.409,18,22,0.818,103,40,83,0.482,37,72,0.514,3,11,0.273,24,33,0.727,107
996,ATL,11/8/2014,103,,NYK,1,240,33,81,0.407,24,59,0.407,9,22,0.409,28,36,0.778,103,40,84,0.476,32,63,0.508,8,21,0.381,8,11,0.727,96
997,MIN,11/7/2014,103,@,ORL,0,265,40,93,0.43,36,75,0.48,4,18,0.222,19,25,0.76,103,46,91,0.505,41,81,0.506,5,10,0.5,15,19,0.789,112
998,TOR,11/7/2014,103,,WAS,1,240,35,80,0.438,26,58,0.448,9,22,0.409,24,31,0.774,103,30,83,0.361,27,64,0.422,3,19,0.158,21,32,0.656,84
999,SAC,10/31/2014,103,,POR,1,240,34,81,0.42,30,71,0.423,4,10,0.4,31,35,0.886,103,34,83,0.41,25,57,0.439,9,26,0.346,17,19,0.895,94
1000,IND,10/29/2014,103,,PHI,1,240,38,81,0.469,30,56,0.536,8,25,0.32,19,28,0.679,103,34,89,0.382,28,68,0.412,6,21,0.286,17,30,0.567,91
1001,SAC,4/13/2015,102,,LAL,1,240,35,72,0.486,31,56,0.554,4,16,0.25,28,36,0.778,102,40,96,0.417,36,81,0.444,4,15,0.267,8,13,0.615,92
1002,IND,4/8/2015,102,@,NYK,1,240,38,77,0.494,34,55,0.618,4,22,0.182,22,27,0.815,102,29,84,0.345,22,67,0.328,7,17,0.412,21,26,0.808,86
1003,CHO,4/1/2015,102,,DET,1,240,38,90,0.422,29,68,0.426,9,22,0.409,17,24,0.708,102,31,88,0.352,26,66,0.394,5,22,0.227,11,18,0.611,78
1004,DET,3/29/2015,102,@,MIA,0,240,40,83,0.482,32,58,0.552,8,25,0.32,14,22,0.636,102,39,82,0.476,32,64,0.5,7,18,0.389,24,29,0.828,109
1005,NOP,3/27/2015,102,,SAC,1,240,43,84,0.512,34,64,0.531,9,20,0.45,7,12,0.583,102,35,79,0.443,28,64,0.438,7,15,0.467,11,18,0.611,88
1006,HOU,3/21/2015,102,,PHO,0,240,41,87,0.471,31,53,0.585,10,34,0.294,10,12,0.833,102,46,92,0.5,38,77,0.494,8,15,0.533,17,24,0.708,117
1007,ORL,3/18/2015,102,@,DAL,0,240,40,87,0.46,31,59,0.525,9,28,0.321,13,14,0.929,102,39,80,0.488,26,49,0.531,13,31,0.419,16,24,0.667,107
1008,PHO,3/15/2015,102,,NYK,1,240,41,83,0.494,35,65,0.538,6,18,0.333,14,23,0.609,102,32,73,0.438,27,59,0.458,5,14,0.357,20,30,0.667,89
1009,TOR,3/13/2015,102,,MIA,1,240,34,79,0.43,22,46,0.478,12,33,0.364,22,31,0.71,102,35,79,0.443,30,56,0.536,5,23,0.217,17,24,0.708,92
1010,ATL,3/11/2015,102,@,DEN,0,240,34,81,0.42,25,54,0.463,9,27,0.333,25,27,0.926,102,42,84,0.5,29,53,0.547,13,31,0.419,18,20,0.9,115
1011,MEM,3/4/2015,102,@,HOU,1,240,42,83,0.506,38,67,0.567,4,16,0.25,14,17,0.824,102,42,86,0.488,31,58,0.534,11,28,0.393,5,5,1,100
1012,GSW,3/4/2015,102,,MIL,1,240,37,73,0.507,23,39,0.59,14,34,0.412,14,25,0.56,102,34,80,0.425,29,66,0.439,5,14,0.357,20,25,0.8,93
1013,DAL,3/2/2015,102,,NOP,1,240,38,79,0.481,32,63,0.508,6,16,0.375,20,22,0.909,102,35,74,0.473,25,53,0.472,10,21,0.476,13,16,0.813,93
1014,MIA,2/27/2015,102,@,NOP,0,240,41,84,0.488,33,63,0.524,8,21,0.381,12,16,0.75,102,39,76,0.513,33,60,0.55,6,16,0.375,20,27,0.741,104
1015,HOU,2/27/2015,102,,BRK,1,240,39,84,0.464,30,52,0.577,9,32,0.281,15,17,0.882,102,38,85,0.447,34,68,0.5,4,17,0.235,18,20,0.9,98
1016,NOP,2/25/2015,102,,BRK,1,240,38,74,0.514,27,49,0.551,11,25,0.44,15,19,0.789,102,39,92,0.424,32,71,0.451,7,21,0.333,11,15,0.733,96
1017,SAC,2/25/2015,102,,MEM,1,240,39,80,0.488,33,64,0.516,6,16,0.375,18,25,0.72,102,34,84,0.405,30,68,0.441,4,16,0.25,18,23,0.783,90
1018,CLE,2/24/2015,102,@,DET,1,240,34,77,0.442,20,40,0.5,14,37,0.378,20,24,0.833,102,33,82,0.402,24,58,0.414,9,24,0.375,18,30,0.6,93
1019,MIN,2/23/2015,102,@,HOU,0,240,31,93,0.333,26,75,0.347,5,18,0.278,35,39,0.897,102,39,94,0.415,27,56,0.482,12,38,0.316,23,34,0.676,113
1020,POR,2/11/2015,102,,LAL,1,240,35,86,0.407,25,56,0.446,10,30,0.333,22,23,0.957,102,34,93,0.366,27,77,0.351,7,16,0.438,11,11,1,86
1021,CHO,2/8/2015,102,,IND,0,240,36,77,0.468,28,63,0.444,8,14,0.571,22,28,0.786,102,37,84,0.44,30,65,0.462,7,19,0.368,22,25,0.88,103
1022,UTA,2/7/2015,102,,SAC,1,240,43,86,0.5,38,67,0.567,5,19,0.263,11,17,0.647,102,32,82,0.39,29,69,0.42,3,13,0.231,23,33,0.697,90
1023,MIN,2/4/2015,102,,MIA,1,240,37,72,0.514,31,61,0.508,6,11,0.545,22,27,0.815,102,39,80,0.488,32,64,0.5,7,16,0.438,16,24,0.667,101
1024,OKC,2/4/2015,102,@,NOP,1,240,45,85,0.529,40,70,0.571,5,15,0.333,7,11,0.636,102,37,97,0.381,30,72,0.417,7,25,0.28,10,13,0.769,91
1025,UTA,2/3/2015,102,@,POR,0,240,39,85,0.459,33,72,0.458,6,13,0.462,18,26,0.692,102,36,76,0.474,29,53,0.547,7,23,0.304,24,34,0.706,103
1026,BRK,2/2/2015,102,,LAC,1,240,41,83,0.494,29,56,0.518,12,27,0.444,8,18,0.444,102,42,89,0.472,34,66,0.515,8,23,0.348,8,25,0.32,100
1027,MEM,2/2/2015,102,@,PHO,1,240,36,83,0.434,33,72,0.458,3,11,0.273,27,34,0.794,102,42,84,0.5,36,68,0.529,6,16,0.375,11,18,0.611,101
1028,BRK,1/28/2015,102,@,ATL,0,240,39,87,0.448,30,63,0.476,9,24,0.375,15,18,0.833,102,38,82,0.463,26,49,0.531,12,33,0.364,25,26,0.962,113
1029,SAC,1/28/2015,102,@,TOR,0,240,35,73,0.479,28,56,0.5,7,17,0.412,25,29,0.862,102,43,84,0.512,26,50,0.52,17,34,0.5,16,19,0.842,119
1030,MIA,1/27/2015,102,,MIL,0,240,38,75,0.507,31,55,0.564,7,20,0.35,19,26,0.731,102,39,71,0.549,30,55,0.545,9,16,0.563,22,30,0.733,109
1031,LAC,1/26/2015,102,,DEN,1,240,38,80,0.475,31,61,0.508,7,19,0.368,19,22,0.864,102,40,83,0.482,32,62,0.516,8,21,0.381,10,15,0.667,98
1032,CHI,1/23/2015,102,@,DAL,1,240,38,78,0.487,29,62,0.468,9,16,0.563,17,20,0.85,102,37,82,0.451,31,64,0.484,6,18,0.333,18,18,1,98
1033,LAC,1/19/2015,102,,BOS,1,240,39,82,0.476,30,61,0.492,9,21,0.429,15,19,0.789,102,33,84,0.393,21,55,0.382,12,29,0.414,15,21,0.714,93
1034,MEM,1/17/2015,102,,POR,1,240,39,77,0.506,31,62,0.5,8,15,0.533,16,24,0.667,102,36,93,0.387,23,57,0.404,13,36,0.361,13,15,0.867,98
1035,BRK,1/16/2015,102,@,WAS,1,240,37,81,0.457,33,69,0.478,4,12,0.333,24,31,0.774,102,31,73,0.425,27,56,0.482,4,17,0.235,14,16,0.875,80
1036,LAL,1/15/2015,102,,CLE,0,240,39,76,0.513,31,52,0.596,8,24,0.333,16,23,0.696,102,37,78,0.474,28,48,0.583,9,30,0.3,26,36,0.722,109
1037,WAS,1/9/2015,102,,CHI,1,240,41,86,0.477,33,71,0.465,8,15,0.533,12,19,0.632,102,32,83,0.386,22,57,0.386,10,26,0.385,12,19,0.632,86
1038,IND,1/7/2015,102,@,GSW,0,240,37,81,0.457,31,55,0.564,6,26,0.231,22,23,0.957,102,45,91,0.495,33,63,0.524,12,28,0.429,15,20,0.75,117
1039,PHO,1/6/2015,102,@,MIL,1,240,37,81,0.457,30,56,0.536,7,25,0.28,21,27,0.778,102,37,88,0.42,34,68,0.5,3,20,0.15,19,22,0.864,96
1040,WAS,1/2/2015,102,@,OKC,0,240,39,84,0.464,28,63,0.444,11,21,0.524,13,15,0.867,102,44,83,0.53,36,64,0.563,8,19,0.421,13,19,0.684,109
1041,HOU,12/31/2014,102,,CHO,1,240,38,88,0.432,21,45,0.467,17,43,0.395,9,14,0.643,102,29,76,0.382,26,58,0.448,3,18,0.167,22,26,0.846,83
1042,POR,12/30/2014,102,,TOR,1,265,38,95,0.4,26,59,0.441,12,36,0.333,14,18,0.778,102,40,99,0.404,36,77,0.468,4,22,0.182,13,15,0.867,97
1043,ORL,12/29/2014,102,@,MIA,1,240,41,77,0.532,30,52,0.577,11,25,0.44,9,13,0.692,102,33,63,0.524,26,49,0.531,7,14,0.5,28,40,0.7,101
1044,DEN,12/28/2014,102,,TOR,0,240,37,87,0.425,33,70,0.471,4,17,0.235,24,34,0.706,102,43,88,0.489,33,65,0.508,10,23,0.435,20,32,0.625,116
1045,ORL,12/27/2014,102,@,CHO,1,240,38,83,0.458,30,63,0.476,8,20,0.4,18,24,0.75,102,36,86,0.419,28,62,0.452,8,24,0.333,14,18,0.778,94
1046,MIN,12/26/2014,102,@,DEN,0,240,41,103,0.398,38,88,0.432,3,15,0.2,17,24,0.708,102,39,95,0.411,36,76,0.474,3,19,0.158,25,32,0.781,106
1047,DAL,12/26/2014,102,,LAL,1,240,42,83,0.506,37,65,0.569,5,18,0.278,13,24,0.542,102,36,99,0.364,25,70,0.357,11,29,0.379,15,20,0.75,98
1048,WAS,12/25/2014,102,@,NYK,1,240,44,86,0.512,37,70,0.529,7,16,0.438,7,10,0.7,102,36,80,0.45,32,58,0.552,4,22,0.182,15,19,0.789,91
1049,BRK,12/23/2014,102,,DEN,1,240,43,91,0.473,37,68,0.544,6,23,0.261,10,14,0.714,102,36,82,0.439,29,57,0.509,7,25,0.28,17,22,0.773,96
1050,DAL,12/22/2014,102,,ATL,0,240,39,90,0.433,28,62,0.452,11,28,0.393,13,20,0.65,102,40,81,0.494,33,62,0.532,7,19,0.368,18,27,0.667,105
1051,MIL,12/20/2014,102,@,LAC,0,240,43,81,0.531,35,57,0.614,8,24,0.333,8,15,0.533,102,37,81,0.457,25,55,0.455,12,26,0.462,20,27,0.741,106
1052,LAC,12/17/2014,102,,IND,1,240,34,78,0.436,28,60,0.467,6,18,0.333,28,45,0.622,102,40,90,0.444,36,71,0.507,4,19,0.211,16,23,0.696,100
1053,DEN,12/10/2014,102,,MIA,1,240,38,85,0.447,30,62,0.484,8,23,0.348,18,27,0.667,102,30,82,0.366,23,60,0.383,7,22,0.318,15,21,0.714,82
1054,GSW,12/8/2014,102,@,MIN,1,240,42,91,0.462,37,69,0.536,5,22,0.227,13,14,0.929,102,32,88,0.364,30,77,0.39,2,11,0.182,20,29,0.69,86
1055,MIL,12/7/2014,102,@,DAL,0,240,42,84,0.5,38,69,0.551,4,15,0.267,14,17,0.824,102,49,84,0.583,37,53,0.698,12,31,0.387,15,19,0.789,125
1056,CHI,12/6/2014,102,,GSW,0,240,36,83,0.434,29,62,0.468,7,21,0.333,23,27,0.852,102,40,89,0.449,28,59,0.475,12,30,0.4,20,25,0.8,112
1057,NYK,12/5/2014,102,@,CHO,0,240,37,79,0.468,27,57,0.474,10,22,0.455,18,22,0.818,102,42,88,0.477,38,70,0.543,4,18,0.222,15,18,0.833,103
1058,SAC,12/5/2014,102,,IND,1,265,36,83,0.434,34,73,0.466,2,10,0.2,28,40,0.7,102,36,96,0.375,30,70,0.429,6,26,0.231,23,29,0.793,101
1059,CHI,12/3/2014,102,@,CHO,1,240,37,80,0.463,25,52,0.481,12,28,0.429,16,21,0.762,102,36,90,0.4,34,75,0.453,2,15,0.133,21,23,0.913,95
1060,MIA,12/3/2014,102,,ATL,0,240,36,64,0.563,30,48,0.625,6,16,0.375,24,32,0.75,102,40,74,0.541,28,49,0.571,12,25,0.48,20,23,0.87,112
1061,DET,12/3/2014,102,@,BOS,0,265,37,102,0.363,29,75,0.387,8,27,0.296,20,29,0.69,102,37,93,0.398,24,63,0.381,13,30,0.433,22,27,0.815,109
1062,CHI,11/30/2014,102,@,BRK,1,240,34,69,0.493,27,45,0.6,7,24,0.292,27,34,0.794,102,32,86,0.372,30,72,0.417,2,14,0.143,18,24,0.75,84
1063,TOR,11/28/2014,102,,DAL,0,240,38,91,0.418,24,58,0.414,14,33,0.424,12,16,0.75,102,40,86,0.465,29,60,0.483,11,26,0.423,15,22,0.682,106
1064,LAC,11/28/2014,102,@,HOU,1,240,38,81,0.469,29,56,0.518,9,25,0.36,17,22,0.773,102,32,82,0.39,22,45,0.489,10,37,0.27,11,15,0.733,85
1065,BOS,11/28/2014,102,,CHI,0,240,37,92,0.402,31,70,0.443,6,22,0.273,22,29,0.759,102,37,90,0.411,32,73,0.438,5,17,0.294,30,37,0.811,109
1066,HOU,11/26/2014,102,,SAC,1,240,42,94,0.447,30,59,0.508,12,35,0.343,6,15,0.4,102,31,71,0.437,26,55,0.473,5,16,0.313,22,28,0.786,89
1067,NYK,11/26/2014,102,@,DAL,0,265,39,92,0.424,25,64,0.391,14,28,0.5,10,16,0.625,102,38,95,0.4,34,64,0.531,4,31,0.129,29,38,0.763,109
1068,WAS,11/25/2014,102,,ATL,0,240,36,84,0.429,27,64,0.422,9,20,0.45,21,29,0.724,102,36,85,0.424,29,60,0.483,7,25,0.28,27,34,0.794,106
1069,WAS,11/19/2014,102,,DAL,0,240,37,84,0.44,27,62,0.435,10,22,0.455,18,21,0.857,102,34,82,0.415,22,54,0.407,12,28,0.429,25,29,0.862,105
1070,POR,11/17/2014,102,,NOP,1,240,38,76,0.5,31,57,0.544,7,19,0.368,19,23,0.826,102,38,85,0.447,33,66,0.5,5,19,0.263,12,19,0.632,93
1071,UTA,11/14/2014,102,@,NYK,1,240,36,70,0.514,26,48,0.542,10,22,0.455,20,25,0.8,102,39,82,0.476,34,74,0.459,5,8,0.625,17,20,0.85,100
1072,LAL,11/12/2014,102,@,NOP,0,240,35,84,0.417,28,63,0.444,7,21,0.333,25,32,0.781,102,45,82,0.549,37,63,0.587,8,19,0.421,11,18,0.611,109
1073,POR,11/11/2014,102,,CHO,1,240,40,93,0.43,32,68,0.471,8,25,0.32,14,16,0.875,102,35,75,0.467,28,59,0.475,7,16,0.438,23,27,0.852,100
1074,LAL,11/11/2014,102,@,MEM,0,240,41,87,0.471,34,65,0.523,7,22,0.318,13,17,0.765,102,41,78,0.526,37,67,0.552,4,11,0.364,21,26,0.808,107
1075,CHI,11/10/2014,102,,DET,1,240,39,88,0.443,32,68,0.471,7,20,0.35,17,20,0.85,102,34,80,0.425,27,66,0.409,7,14,0.5,16,25,0.64,91
1076,POR,11/8/2014,102,@,LAC,0,240,36,80,0.45,26,55,0.473,10,25,0.4,20,25,0.8,102,40,81,0.494,35,69,0.507,5,12,0.417,21,30,0.7,106
1077,MIA,11/8/2014,102,,MIN,1,240,41,78,0.526,36,65,0.554,5,13,0.385,15,17,0.882,102,35,87,0.402,31,71,0.437,4,16,0.25,18,23,0.783,92
1078,UTA,11/5/2014,102,,CLE,1,240,39,77,0.506,32,56,0.571,7,21,0.333,17,22,0.773,102,30,72,0.417,24,56,0.429,6,16,0.375,34,40,0.85,100
1079,MEM,11/5/2014,102,@,PHO,1,240,40,80,0.5,31,63,0.492,9,17,0.529,13,17,0.765,102,32,69,0.464,24,48,0.5,8,21,0.381,19,21,0.905,91
1080,TOR,11/2/2014,102,@,MIA,0,240,37,79,0.468,33,63,0.524,4,16,0.25,24,39,0.615,102,35,70,0.5,26,46,0.565,9,24,0.375,28,38,0.737,107
1081,BRK,11/1/2014,102,@,DET,1,240,42,87,0.483,35,61,0.574,7,26,0.269,11,13,0.846,102,32,76,0.421,31,59,0.525,1,17,0.059,25,35,0.714,90
1082,OKC,11/1/2014,102,,DEN,1,240,37,80,0.463,31,60,0.517,6,20,0.3,22,31,0.71,102,35,80,0.438,28,54,0.519,7,26,0.269,14,20,0.7,91
1083,ATL,11/1/2014,102,,IND,1,240,35,69,0.507,28,49,0.571,7,20,0.35,25,33,0.758,102,31,81,0.383,19,49,0.388,12,32,0.375,18,21,0.857,92
1084,UTA,10/30/2014,102,@,DAL,0,240,36,83,0.434,22,48,0.458,14,35,0.4,16,18,0.889,102,47,85,0.553,39,64,0.609,8,21,0.381,18,23,0.783,120
1085,ATL,10/29/2014,102,@,TOR,0,240,40,80,0.5,27,58,0.466,13,22,0.591,9,17,0.529,102,37,90,0.411,29,64,0.453,8,26,0.308,27,33,0.818,109
1086,PHI,4/15/2015,101,,MIA,0,240,38,83,0.458,33,54,0.611,5,29,0.172,20,25,0.8,101,39,89,0.438,27,58,0.466,12,31,0.387,15,20,0.75,105
1087,BRK,4/15/2015,101,,ORL,1,240,39,80,0.488,30,56,0.536,9,24,0.375,14,23,0.609,101,38,79,0.481,31,59,0.525,7,20,0.35,5,13,0.385,88
1088,PHO,4/14/2015,101,,LAC,0,240,39,80,0.488,28,54,0.519,11,26,0.423,12,20,0.6,101,42,87,0.483,27,49,0.551,15,38,0.395,13,18,0.722,112
1089,OKC,4/13/2015,101,,POR,1,240,39,96,0.406,35,75,0.467,4,21,0.19,19,27,0.704,101,38,83,0.458,30,60,0.5,8,23,0.348,6,9,0.667,90
1090,MIN,4/11/2015,101,@,GSW,0,240,35,79,0.443,24,55,0.436,11,24,0.458,20,26,0.769,101,42,93,0.452,31,62,0.5,11,31,0.355,15,21,0.714,110
1091,TOR,4/10/2015,101,@,ORL,1,240,39,94,0.415,30,64,0.469,9,30,0.3,14,15,0.933,101,41,89,0.461,34,69,0.493,7,20,0.35,10,10,1,99
1092,LAL,4/8/2015,101,@,DEN,0,240,36,75,0.48,31,59,0.525,5,16,0.313,24,35,0.686,101,44,88,0.5,31,58,0.534,13,30,0.433,18,24,0.75,119
1093,UTA,4/5/2015,101,@,SAC,1,240,40,87,0.46,32,63,0.508,8,24,0.333,13,18,0.722,101,38,79,0.481,33,64,0.516,5,15,0.333,14,24,0.583,95
1094,NYK,4/5/2015,101,,PHI,1,240,37,72,0.514,34,59,0.576,3,13,0.231,24,29,0.828,101,38,99,0.384,28,67,0.418,10,32,0.313,5,8,0.625,91
1095,NOP,4/3/2015,101,@,SAC,1,240,34,87,0.391,20,58,0.345,14,29,0.483,19,28,0.679,101,37,78,0.474,31,61,0.508,6,17,0.353,15,25,0.6,95
1096,WAS,4/3/2015,101,,NYK,1,240,43,93,0.462,36,77,0.468,7,16,0.438,8,12,0.667,101,31,84,0.369,24,63,0.381,7,21,0.333,18,20,0.9,87
1097,BOS,4/3/2015,101,,MIL,0,240,39,88,0.443,31,64,0.484,8,24,0.333,15,16,0.938,101,45,85,0.529,36,61,0.59,9,24,0.375,11,18,0.611,110
1098,DAL,4/2/2015,101,,HOU,0,240,37,84,0.44,29,58,0.5,8,26,0.308,19,27,0.704,101,34,77,0.442,23,46,0.5,11,31,0.355,29,40,0.725,108
1099,ATL,3/30/2015,101,,MIL,1,240,36,79,0.456,27,50,0.54,9,29,0.31,20,24,0.833,101,34,75,0.453,30,58,0.517,4,17,0.235,16,23,0.696,88
1100,LAL,3/25/2015,101,@,MIN,1,265,39,92,0.424,33,66,0.5,6,26,0.231,17,18,0.944,101,33,78,0.423,27,56,0.482,6,22,0.273,27,30,0.9,99
1101,WAS,3/25/2015,101,,IND,0,240,33,75,0.44,28,61,0.459,5,14,0.357,30,38,0.789,101,38,85,0.447,29,59,0.492,9,26,0.346,18,28,0.643,103
1102,DAL,3/24/2015,101,,SAS,1,240,42,87,0.483,35,65,0.538,7,22,0.318,10,13,0.769,101,36,85,0.424,28,57,0.491,8,28,0.286,14,18,0.778,94
1103,LAL,3/22/2015,101,,PHI,1,240,39,81,0.481,34,67,0.507,5,14,0.357,18,22,0.818,101,32,89,0.36,23,62,0.371,9,27,0.333,14,21,0.667,87
1104,SAS,3/20/2015,101,,BOS,1,240,38,81,0.469,33,58,0.569,5,23,0.217,20,23,0.87,101,35,88,0.398,30,68,0.441,5,20,0.25,14,20,0.7,89
1105,SAC,3/20/2015,101,,CHO,1,240,37,78,0.474,28,57,0.491,9,21,0.429,18,25,0.72,101,36,91,0.396,30,73,0.411,6,18,0.333,13,16,0.813,91
1106,DAL,3/20/2015,101,,MEM,0,240,34,76,0.447,26,54,0.481,8,22,0.364,25,36,0.694,101,41,77,0.532,33,59,0.559,8,18,0.444,22,32,0.688,112
1107,CHO,3/13/2015,101,,CHI,1,240,33,89,0.371,26,70,0.371,7,19,0.368,28,33,0.848,101,31,82,0.378,16,50,0.32,15,32,0.469,14,19,0.737,91
1108,NYK,3/12/2015,101,@,LAL,1,240,36,77,0.468,27,59,0.458,9,18,0.5,20,26,0.769,101,38,90,0.422,33,72,0.458,5,18,0.278,13,21,0.619,94
1109,MEM,3/9/2015,101,@,CHI,1,240,42,84,0.5,37,70,0.529,5,14,0.357,12,17,0.706,101,35,80,0.438,25,58,0.431,10,22,0.455,11,14,0.786,91
1110,DET,3/8/2015,101,,CHO,0,240,39,89,0.438,36,75,0.48,3,14,0.214,20,25,0.8,101,41,79,0.519,35,62,0.565,6,17,0.353,20,23,0.87,108
1111,LAL,3/1/2015,101,,OKC,0,240,40,90,0.444,31,65,0.477,9,25,0.36,12,18,0.667,101,40,97,0.412,29,65,0.446,11,32,0.344,17,23,0.739,108
1112,BOS,3/1/2015,101,,GSW,0,240,40,109,0.367,32,78,0.41,8,31,0.258,13,17,0.765,101,40,95,0.421,28,61,0.459,12,34,0.353,14,17,0.824,106
1113,SAS,2/28/2015,101,@,PHO,1,240,41,92,0.446,37,73,0.507,4,19,0.211,15,17,0.882,101,25,84,0.298,20,68,0.294,5,16,0.313,19,24,0.792,74
1114,MEM,2/28/2015,101,@,MIN,1,240,38,64,0.594,34,53,0.642,4,11,0.364,21,29,0.724,101,34,88,0.386,27,69,0.391,7,19,0.368,22,27,0.815,97
1115,LAL,2/27/2015,101,,MIL,1,240,40,85,0.471,34,67,0.507,6,18,0.333,15,22,0.682,101,34,87,0.391,30,70,0.429,4,17,0.235,21,29,0.724,93
1116,CLE,2/22/2015,101,@,NYK,1,240,40,79,0.506,28,46,0.609,12,33,0.364,9,15,0.6,101,37,99,0.374,34,80,0.425,3,19,0.158,6,7,0.857,83
1117,BOS,2/20/2015,101,@,SAC,0,240,40,100,0.4,34,78,0.436,6,22,0.273,15,26,0.577,101,40,83,0.482,32,61,0.525,8,22,0.364,21,26,0.808,109
1118,DET,2/8/2015,101,,MIN,0,240,37,79,0.468,27,48,0.563,10,31,0.323,17,22,0.773,101,39,76,0.513,34,64,0.531,5,12,0.417,29,34,0.853,112
1119,POR,2/7/2015,101,@,DAL,0,265,37,89,0.416,27,57,0.474,10,32,0.313,17,24,0.708,101,43,105,0.41,29,69,0.42,14,36,0.389,11,16,0.688,111
1120,DAL,2/5/2015,101,@,SAC,1,240,41,96,0.427,29,62,0.468,12,34,0.353,7,10,0.7,101,29,79,0.367,26,58,0.448,3,21,0.143,17,22,0.773,78
1121,HOU,2/4/2015,101,,CHI,1,240,38,92,0.413,30,65,0.462,8,27,0.296,17,23,0.739,101,31,89,0.348,23,64,0.359,8,25,0.32,20,26,0.769,90
1122,MIA,2/4/2015,101,@,MIN,0,240,39,80,0.488,32,64,0.5,7,16,0.438,16,24,0.667,101,37,72,0.514,31,61,0.508,6,11,0.545,22,27,0.815,102
1123,PHO,2/2/2015,101,,MEM,0,240,42,84,0.5,36,68,0.529,6,16,0.375,11,18,0.611,101,36,83,0.434,33,72,0.458,3,11,0.273,27,34,0.794,102
1124,HOU,1/31/2015,101,@,DET,0,240,39,87,0.448,28,55,0.509,11,32,0.344,12,19,0.632,101,41,82,0.5,31,57,0.544,10,25,0.4,22,35,0.629,114
1125,CLE,1/30/2015,101,,SAC,1,240,38,80,0.475,27,49,0.551,11,31,0.355,14,22,0.636,101,30,84,0.357,27,66,0.409,3,18,0.167,27,32,0.844,90
1126,SAS,1/25/2015,101,,MIL,1,240,35,83,0.422,30,61,0.492,5,22,0.227,26,30,0.867,101,39,82,0.476,31,65,0.477,8,17,0.471,9,13,0.692,95
1127,MEM,1/24/2015,101,,PHI,1,240,37,79,0.468,31,65,0.477,6,14,0.429,21,25,0.84,101,31,81,0.383,22,57,0.386,9,24,0.375,12,22,0.545,83
1128,MIL,1/24/2015,101,,DET,1,240,41,81,0.506,30,64,0.469,11,17,0.647,8,10,0.8,101,31,86,0.36,25,61,0.41,6,25,0.24,18,25,0.72,86
1129,SAC,1/23/2015,101,@,GSW,0,240,34,82,0.415,30,65,0.462,4,17,0.235,29,34,0.853,101,45,94,0.479,28,54,0.519,17,40,0.425,19,22,0.864,126
1130,UTA,1/22/2015,101,@,MIL,1,240,32,71,0.451,18,40,0.45,14,31,0.452,23,28,0.821,101,42,92,0.457,37,79,0.468,5,13,0.385,10,12,0.833,99
1131,OKC,1/15/2015,101,@,HOU,0,240,35,81,0.432,24,52,0.462,11,29,0.379,20,28,0.714,101,41,86,0.477,25,50,0.5,16,36,0.444,14,19,0.737,112
1132,IND,1/13/2015,101,,MIN,0,240,39,80,0.488,34,62,0.548,5,18,0.278,18,30,0.6,101,41,87,0.471,31,67,0.463,10,20,0.5,18,19,0.947,110
1133,WAS,1/13/2015,101,,SAS,1,240,37,75,0.493,31,63,0.492,6,12,0.5,21,24,0.875,101,38,96,0.396,29,67,0.433,9,29,0.31,8,12,0.667,93
1134,LAL,1/9/2015,101,,ORL,1,240,36,90,0.4,29,69,0.42,7,21,0.333,22,31,0.71,101,30,76,0.395,24,62,0.387,6,14,0.429,18,23,0.783,84
1135,WAS,1/7/2015,101,,NYK,1,240,39,76,0.513,31,60,0.517,8,16,0.5,15,21,0.714,101,34,82,0.415,23,56,0.411,11,26,0.423,12,16,0.75,91
1136,MIN,1/5/2015,101,,DEN,0,240,38,89,0.427,28,65,0.431,10,24,0.417,15,18,0.833,101,46,84,0.548,39,65,0.6,7,19,0.368,11,16,0.688,110
1137,UTA,1/5/2015,101,,IND,0,240,35,81,0.432,31,58,0.534,4,23,0.174,27,34,0.794,101,35,74,0.473,28,61,0.459,7,13,0.538,28,30,0.933,105
1138,UTA,1/3/2015,101,@,MIN,1,240,38,75,0.507,27,55,0.491,11,20,0.55,14,21,0.667,101,34,86,0.395,28,67,0.418,6,19,0.316,15,18,0.833,89
1139,SAS,1/3/2015,101,,WAS,1,240,43,78,0.551,39,62,0.629,4,16,0.25,11,18,0.611,101,40,82,0.488,36,68,0.529,4,14,0.286,8,13,0.615,92
1140,BOS,1/2/2015,101,,DAL,0,240,38,89,0.427,26,55,0.473,12,34,0.353,13,19,0.684,101,45,96,0.469,32,69,0.464,13,27,0.481,16,17,0.941,119
1141,DEN,1/1/2015,101,@,CHI,0,240,37,92,0.402,32,78,0.41,5,14,0.357,22,27,0.815,101,38,91,0.418,30,76,0.395,8,15,0.533,22,25,0.88,106
1142,CLE,12/30/2014,101,@,ATL,0,240,37,84,0.44,24,53,0.453,13,31,0.419,14,21,0.667,101,40,79,0.506,30,50,0.6,10,29,0.345,19,26,0.731,109
1143,LAC,12/29/2014,101,,UTA,1,240,37,81,0.457,27,58,0.466,10,23,0.435,17,22,0.773,101,38,92,0.413,30,73,0.411,8,19,0.421,13,22,0.591,97
1144,MIA,12/29/2014,101,,ORL,0,240,33,63,0.524,26,49,0.531,7,14,0.5,28,40,0.7,101,41,77,0.532,30,52,0.577,11,25,0.44,9,13,0.692,102
1145,POR,12/28/2014,101,,NYK,1,240,38,81,0.469,22,45,0.489,16,36,0.444,9,12,0.75,101,31,93,0.333,24,66,0.364,7,27,0.259,10,15,0.667,79
1146,WAS,12/27/2014,101,,BOS,1,240,45,90,0.5,40,77,0.519,5,13,0.385,6,10,0.6,101,32,79,0.405,26,55,0.473,6,24,0.25,18,24,0.75,88
1147,MIA,12/25/2014,101,,CLE,1,240,40,84,0.476,33,63,0.524,7,21,0.333,14,17,0.824,101,32,72,0.444,26,46,0.565,6,26,0.231,21,33,0.636,91
1148,MIL,12/23/2014,101,,CHO,0,240,39,82,0.476,31,61,0.508,8,21,0.381,15,20,0.75,101,36,82,0.439,28,61,0.459,8,21,0.381,28,36,0.778,108
1149,NOP,12/21/2014,101,@,OKC,1,240,43,90,0.478,36,70,0.514,7,20,0.35,8,10,0.8,101,38,83,0.458,33,63,0.524,5,20,0.25,18,24,0.75,99
1150,LAL,12/21/2014,101,@,SAC,0,240,33,87,0.379,23,61,0.377,10,26,0.385,25,30,0.833,101,38,79,0.481,31,56,0.554,7,23,0.304,25,36,0.694,108
1151,UTA,12/19/2014,101,@,ORL,1,240,39,73,0.534,35,62,0.565,4,11,0.364,19,24,0.792,101,37,83,0.446,25,61,0.41,12,22,0.545,8,12,0.667,94
1152,NYK,12/12/2014,101,@,BOS,1,240,40,81,0.494,34,65,0.523,6,16,0.375,15,18,0.833,101,37,85,0.435,30,63,0.476,7,22,0.318,14,18,0.778,95
1153,TOR,12/9/2014,101,@,CLE,0,240,42,82,0.512,35,59,0.593,7,23,0.304,10,10,1,101,39,79,0.494,30,53,0.566,9,26,0.346,18,21,0.857,105
1154,MIL,12/9/2014,101,@,OKC,0,240,34,84,0.405,30,63,0.476,4,21,0.19,29,35,0.829,101,41,82,0.5,37,61,0.607,4,21,0.19,28,34,0.824,114
1155,SAC,12/8/2014,101,,UTA,1,240,35,74,0.473,32,66,0.485,3,8,0.375,28,36,0.778,101,32,79,0.405,29,62,0.468,3,17,0.176,25,37,0.676,92
1156,BOS,12/7/2014,101,,WAS,1,240,36,88,0.409,28,71,0.394,8,17,0.471,21,26,0.808,101,34,93,0.366,23,66,0.348,11,27,0.407,14,21,0.667,93
1157,DET,12/6/2014,101,,PHI,0,265,34,87,0.391,28,64,0.438,6,23,0.261,27,35,0.771,101,40,87,0.46,33,64,0.516,7,23,0.304,21,30,0.7,108
1158,MIN,12/6/2014,101,@,SAS,0,240,35,83,0.422,29,67,0.433,6,16,0.375,25,32,0.781,101,47,82,0.573,40,64,0.625,7,18,0.389,22,25,0.88,123
1159,MEM,12/5/2014,101,,SAS,0,240,37,80,0.463,32,68,0.471,5,12,0.417,22,26,0.846,101,40,84,0.476,26,59,0.441,14,25,0.56,13,16,0.813,107
1160,IND,12/5/2014,101,@,SAC,0,265,36,96,0.375,30,70,0.429,6,26,0.231,23,29,0.793,101,36,83,0.434,34,73,0.466,2,10,0.2,28,40,0.7,102
1161,UTA,12/1/2014,101,,DEN,0,240,36,84,0.429,29,66,0.439,7,18,0.389,22,30,0.733,101,41,87,0.471,32,61,0.525,9,26,0.346,12,17,0.706,103
1162,MIN,12/1/2014,101,@,LAC,0,240,35,82,0.427,33,70,0.471,2,12,0.167,29,40,0.725,101,41,80,0.513,26,46,0.565,15,34,0.441,30,36,0.833,127
1163,CHO,11/28/2014,101,,GSW,0,240,38,87,0.437,32,68,0.471,6,19,0.316,19,23,0.826,101,42,99,0.424,35,73,0.479,7,26,0.269,15,16,0.938,106
1164,DEN,11/23/2014,101,@,LAL,1,265,34,90,0.378,24,53,0.453,10,37,0.27,23,38,0.605,101,33,89,0.371,30,65,0.462,3,24,0.125,25,34,0.735,94
1165,MIN,11/22/2014,101,,SAC,0,240,37,90,0.411,31,73,0.425,6,17,0.353,21,27,0.778,101,40,81,0.494,32,55,0.582,8,26,0.308,25,30,0.833,113
1166,GSW,11/21/2014,101,,UTA,1,240,41,82,0.5,35,59,0.593,6,23,0.261,13,19,0.684,101,35,82,0.427,29,65,0.446,6,17,0.353,12,19,0.632,88
1167,BOS,11/19/2014,101,@,PHI,1,240,41,83,0.494,35,63,0.556,6,20,0.3,13,21,0.619,101,34,86,0.395,27,65,0.415,7,21,0.333,15,21,0.714,90
1168,ORL,11/14/2014,101,,MIL,1,240,35,80,0.438,25,56,0.446,10,24,0.417,21,27,0.778,101,36,80,0.45,34,61,0.557,2,19,0.105,11,14,0.786,85
1169,MIN,11/12/2014,101,,HOU,0,240,36,81,0.444,30,69,0.435,6,12,0.5,23,30,0.767,101,43,89,0.483,30,61,0.492,13,28,0.464,14,19,0.737,113
1170,OKC,11/9/2014,101,,SAC,1,240,36,78,0.462,30,60,0.5,6,18,0.333,23,27,0.852,101,36,80,0.45,30,56,0.536,6,24,0.25,15,22,0.682,93
1171,CHI,11/8/2014,101,,BOS,0,240,42,92,0.457,34,74,0.459,8,18,0.444,9,15,0.6,101,42,81,0.519,35,62,0.565,7,19,0.368,15,20,0.75,106
1172,DEN,11/7/2014,101,,CLE,0,240,40,85,0.471,29,56,0.518,11,29,0.379,10,15,0.667,101,40,84,0.476,34,61,0.557,6,23,0.261,24,33,0.727,110
1173,BOS,11/7/2014,101,,IND,1,240,39,85,0.459,30,58,0.517,9,27,0.333,14,16,0.875,101,40,88,0.455,35,69,0.507,5,19,0.263,13,13,1,98
1174,POR,11/4/2014,101,,CLE,1,240,37,75,0.493,29,50,0.58,8,25,0.32,19,25,0.76,101,31,85,0.365,22,64,0.344,9,21,0.429,11,14,0.786,82
1175,UTA,11/3/2014,101,@,LAC,0,240,36,77,0.468,26,50,0.52,10,27,0.37,19,24,0.792,101,41,81,0.506,31,58,0.534,10,23,0.435,15,17,0.882,107
1176,MIN,10/29/2014,101,@,MEM,0,240,39,86,0.453,33,74,0.446,6,12,0.5,17,23,0.739,101,43,82,0.524,39,67,0.582,4,15,0.267,15,20,0.75,105
1177,NOP,10/28/2014,101,,ORL,1,240,41,101,0.406,37,84,0.44,4,17,0.235,15,31,0.484,101,32,84,0.381,28,73,0.384,4,11,0.364,16,21,0.762,84
1178,SAS,10/28/2014,101,,DAL,1,240,37,70,0.529,23,42,0.548,14,28,0.5,13,16,0.813,101,38,78,0.487,30,57,0.526,8,21,0.381,16,19,0.842,100
1179,MIL,4/15/2015,100,,BOS,0,240,41,89,0.461,34,68,0.5,7,21,0.333,11,16,0.688,100,42,85,0.494,29,55,0.527,13,30,0.433,8,14,0.571,105
1180,NOP,4/13/2015,100,@,MIN,1,240,37,84,0.44,31,63,0.492,6,21,0.286,20,24,0.833,100,31,78,0.397,27,64,0.422,4,14,0.286,22,28,0.786,88
1181,HOU,4/13/2015,100,@,CHO,1,240,35,85,0.412,26,50,0.52,9,35,0.257,21,26,0.808,100,34,83,0.41,21,51,0.412,13,32,0.406,9,17,0.529,90
1182,MIA,4/13/2015,100,,ORL,1,240,39,83,0.47,36,73,0.493,3,10,0.3,19,23,0.826,100,35,85,0.412,29,64,0.453,6,21,0.286,17,28,0.607,93
1183,CHO,4/7/2015,100,@,MIA,0,240,39,91,0.429,34,73,0.466,5,18,0.278,17,21,0.81,100,40,81,0.494,37,66,0.561,3,15,0.2,22,28,0.786,105
1184,GSW,4/7/2015,100,@,NOP,0,240,42,95,0.442,33,73,0.452,9,22,0.409,7,10,0.7,100,36,83,0.434,27,64,0.422,9,19,0.474,22,30,0.733,103
1185,LAL,4/7/2015,100,@,LAC,0,240,35,84,0.417,26,59,0.441,9,25,0.36,21,27,0.778,100,39,81,0.481,32,57,0.561,7,24,0.292,20,30,0.667,105
1186,MEM,4/3/2015,100,,OKC,1,240,38,80,0.475,34,59,0.576,4,21,0.19,20,28,0.714,100,36,88,0.409,32,71,0.451,4,17,0.235,16,26,0.615,92
1187,BRK,4/1/2015,100,@,NYK,1,240,41,81,0.506,32,65,0.492,9,16,0.563,9,12,0.75,100,37,81,0.457,26,58,0.448,11,23,0.478,13,15,0.867,98
1188,BOS,4/1/2015,100,,IND,1,240,39,86,0.453,33,59,0.559,6,27,0.222,16,18,0.889,100,34,81,0.42,28,66,0.424,6,15,0.4,13,23,0.565,87
1189,ATL,3/28/2015,100,@,CHO,0,240,37,86,0.43,22,56,0.393,15,30,0.5,11,14,0.786,100,42,80,0.525,30,54,0.556,12,26,0.462,19,22,0.864,115
1190,IND,3/23/2015,100,,HOU,0,240,40,90,0.444,32,66,0.485,8,24,0.333,12,19,0.632,100,31,65,0.477,18,41,0.439,13,24,0.542,35,37,0.946,110
1191,ORL,3/22/2015,100,,DEN,0,240,41,85,0.482,37,68,0.544,4,17,0.235,14,17,0.824,100,42,90,0.467,30,62,0.484,12,28,0.429,23,30,0.767,119
1192,NOP,3/22/2015,100,@,LAC,0,240,38,75,0.507,26,53,0.491,12,22,0.545,12,16,0.75,100,42,91,0.462,35,68,0.515,7,23,0.304,16,23,0.696,107
1193,MIN,3/18/2015,100,@,TOR,0,240,42,87,0.483,36,70,0.514,6,17,0.353,10,15,0.667,100,35,79,0.443,23,50,0.46,12,29,0.414,23,27,0.852,105
1194,SAS,3/17/2015,100,@,NYK,0,265,36,94,0.383,33,80,0.413,3,14,0.214,25,30,0.833,100,41,91,0.451,38,77,0.494,3,14,0.214,19,27,0.704,104
1195,CHI,3/15/2015,100,@,OKC,0,240,37,83,0.446,28,54,0.519,9,29,0.31,17,24,0.708,100,40,87,0.46,32,66,0.485,8,21,0.381,21,30,0.7,109
1196,HOU,3/15/2015,100,@,LAC,1,240,32,86,0.372,25,56,0.446,7,30,0.233,29,36,0.806,100,36,82,0.439,24,56,0.429,12,26,0.462,14,24,0.583,98
1197,HOU,3/11/2015,100,@,POR,0,240,38,91,0.418,27,60,0.45,11,31,0.355,13,23,0.565,100,42,92,0.457,32,59,0.542,10,33,0.303,11,14,0.786,105
1198,BOS,3/9/2015,100,@,MIA,1,240,39,87,0.448,33,62,0.532,6,25,0.24,16,17,0.941,100,29,69,0.42,25,52,0.481,4,17,0.235,28,34,0.824,90
1199,DAL,3/8/2015,100,@,LAL,1,240,38,78,0.487,29,52,0.558,9,26,0.346,15,22,0.682,100,38,82,0.463,36,68,0.529,2,14,0.143,15,21,0.714,93
1200,DEN,3/7/2015,100,,HOU,0,240,38,92,0.413,29,62,0.468,9,30,0.3,15,19,0.789,100,40,86,0.465,30,58,0.517,10,28,0.357,24,32,0.75,114
1201,BRK,3/6/2015,100,,PHO,0,265,34,97,0.351,26,75,0.347,8,22,0.364,24,29,0.828,100,39,91,0.429,36,65,0.554,3,26,0.115,27,35,0.771,108
1202,ORL,3/4/2015,100,,PHO,0,240,41,87,0.471,36,67,0.537,5,20,0.25,13,15,0.867,100,37,79,0.468,29,58,0.5,8,21,0.381,23,27,0.852,105
1203,HOU,3/4/2015,100,,MEM,0,240,42,86,0.488,31,58,0.534,11,28,0.393,5,5,1,100,42,83,0.506,38,67,0.567,4,16,0.25,14,17,0.824,102
1204,DEN,3/4/2015,100,@,MIN,1,240,42,92,0.457,34,72,0.472,8,20,0.4,8,10,0.8,100,32,82,0.39,29,64,0.453,3,18,0.167,18,25,0.72,85
1205,MIA,3/4/2015,100,,LAL,1,240,32,79,0.405,29,63,0.46,3,16,0.188,33,43,0.767,100,38,88,0.432,31,70,0.443,7,18,0.389,11,17,0.647,94
1206,LAL,2/25/2015,100,@,UTA,1,240,40,89,0.449,38,78,0.487,2,11,0.182,18,21,0.857,100,34,73,0.466,27,61,0.443,7,12,0.583,22,34,0.647,97
1207,NOP,2/23/2015,100,,TOR,1,240,40,78,0.513,30,56,0.536,10,22,0.455,10,16,0.625,100,35,84,0.417,30,61,0.492,5,23,0.217,22,31,0.71,97
1208,DET,2/20/2015,100,,CHI,1,240,38,84,0.452,32,62,0.516,6,22,0.273,18,33,0.545,100,33,78,0.423,28,62,0.452,5,16,0.313,20,22,0.909,91
1209,HOU,2/20/2015,100,@,DAL,0,240,36,87,0.414,24,50,0.48,12,37,0.324,16,26,0.615,100,44,93,0.473,35,69,0.507,9,24,0.375,14,18,0.778,111
1210,UTA,2/9/2015,100,@,NOP,1,240,39,93,0.419,30,72,0.417,9,21,0.429,13,19,0.684,100,33,79,0.418,20,57,0.351,13,22,0.591,17,20,0.85,96
1211,PHO,2/6/2015,100,,UTA,1,240,38,84,0.452,24,57,0.421,14,27,0.519,10,14,0.714,100,37,80,0.463,30,60,0.5,7,20,0.35,12,18,0.667,93
1212,MEM,2/4/2015,100,@,UTA,1,240,38,80,0.475,32,67,0.478,6,13,0.462,18,22,0.818,100,33,73,0.452,26,50,0.52,7,23,0.304,17,26,0.654,90
1213,DEN,2/4/2015,100,@,BOS,0,240,33,80,0.413,29,56,0.518,4,24,0.167,30,33,0.909,100,40,99,0.404,28,71,0.394,12,28,0.429,12,17,0.706,104
1214,DAL,2/2/2015,100,,MIN,1,240,39,84,0.464,29,53,0.547,10,31,0.323,12,18,0.667,100,34,82,0.415,31,69,0.449,3,13,0.231,23,26,0.885,94
1215,ATL,2/2/2015,100,@,NOP,0,240,40,89,0.449,33,67,0.493,7,22,0.318,13,17,0.765,100,43,86,0.5,34,63,0.54,9,23,0.391,20,23,0.87,115
1216,LAC,2/2/2015,100,@,BRK,0,240,42,89,0.472,34,66,0.515,8,23,0.348,8,25,0.32,100,41,83,0.494,29,56,0.518,12,27,0.444,8,18,0.444,102
1217,GSW,1/30/2015,100,@,UTA,0,240,37,86,0.43,29,59,0.492,8,27,0.296,18,25,0.72,100,42,94,0.447,33,69,0.478,9,25,0.36,17,28,0.607,110
1218,ORL,1/29/2015,100,,MIL,0,240,37,82,0.451,32,64,0.5,5,18,0.278,21,30,0.7,100,45,87,0.517,33,62,0.532,12,25,0.48,13,18,0.722,115
1219,NYK,1/28/2015,100,,OKC,1,240,40,91,0.44,32,74,0.432,8,17,0.471,12,17,0.706,100,34,85,0.4,29,63,0.46,5,22,0.227,19,22,0.864,92
1220,PHO,1/25/2015,100,,LAC,0,240,34,80,0.425,24,51,0.471,10,29,0.345,22,27,0.815,100,43,87,0.494,33,64,0.516,10,23,0.435,24,36,0.667,120
1221,MIN,1/25/2015,100,@,ATL,0,240,37,71,0.521,31,55,0.564,6,16,0.375,20,25,0.8,100,45,80,0.563,35,52,0.673,10,28,0.357,12,18,0.667,112
1222,BOS,1/23/2015,100,@,DEN,1,240,37,75,0.493,28,54,0.519,9,21,0.429,17,27,0.63,100,37,89,0.416,31,68,0.456,6,21,0.286,19,26,0.731,99
1223,SAC,1/21/2015,100,,BRK,0,240,39,84,0.464,34,66,0.515,5,18,0.278,17,24,0.708,100,37,79,0.468,32,59,0.542,5,20,0.25,24,30,0.8,103
1224,LAL,1/19/2015,100,@,PHO,0,240,34,75,0.453,26,58,0.448,8,17,0.471,24,35,0.686,100,43,86,0.5,30,54,0.556,13,32,0.406,16,22,0.727,115
1225,LAC,1/14/2015,100,@,POR,1,240,37,88,0.42,29,65,0.446,8,23,0.348,18,19,0.947,100,35,87,0.402,29,61,0.475,6,26,0.231,18,20,0.9,94
1226,TOR,1/14/2015,100,,PHI,1,240,38,82,0.463,28,53,0.528,10,29,0.345,14,22,0.636,100,31,80,0.388,28,61,0.459,3,19,0.158,19,31,0.613,84
1227,CLE,1/13/2015,100,@,PHO,0,240,36,82,0.439,23,47,0.489,13,35,0.371,15,20,0.75,100,40,76,0.526,33,56,0.589,7,20,0.35,20,27,0.741,107
1228,NOP,1/12/2015,100,@,BOS,0,240,31,75,0.413,25,60,0.417,6,15,0.4,32,37,0.865,100,37,88,0.42,29,64,0.453,8,24,0.333,26,31,0.839,108
1229,DAL,1/10/2015,100,@,LAC,0,240,38,86,0.442,26,56,0.464,12,30,0.4,12,17,0.706,100,46,88,0.523,33,57,0.579,13,31,0.419,15,21,0.714,120
1230,SAS,1/9/2015,100,,PHO,1,240,38,89,0.427,27,66,0.409,11,23,0.478,13,18,0.722,100,37,83,0.446,30,57,0.526,7,26,0.269,14,21,0.667,95
1231,BRK,1/2/2015,100,@,ORL,1,240,41,72,0.569,34,52,0.654,7,20,0.35,11,18,0.611,100,37,88,0.42,26,66,0.394,11,22,0.5,13,20,0.65,98
1232,UTA,12/30/2014,100,,MIN,1,240,38,79,0.481,31,60,0.517,7,19,0.368,17,22,0.773,100,38,82,0.463,30,65,0.462,8,17,0.471,10,14,0.714,94
1233,NOP,12/27/2014,100,@,CHI,0,240,41,88,0.466,37,74,0.5,4,14,0.286,14,16,0.875,100,41,89,0.461,35,69,0.507,6,20,0.3,19,22,0.864,107
1234,LAC,12/25/2014,100,,GSW,1,240,34,87,0.391,25,55,0.455,9,32,0.281,23,31,0.742,100,34,80,0.425,28,52,0.538,6,28,0.214,12,22,0.545,86
1235,ORL,12/23/2014,100,,BOS,1,240,39,83,0.47,32,65,0.492,7,18,0.389,15,23,0.652,100,33,85,0.388,26,62,0.419,7,23,0.304,22,29,0.759,95
1236,MIA,12/21/2014,100,,BOS,1,240,37,78,0.474,31,57,0.544,6,21,0.286,20,26,0.769,100,33,83,0.398,27,60,0.45,6,23,0.261,12,15,0.8,84
1237,IND,12/21/2014,100,@,MIN,1,240,42,84,0.5,36,65,0.554,6,19,0.316,10,14,0.714,100,36,77,0.468,31,66,0.47,5,11,0.455,19,24,0.792,96
1238,DET,12/19/2014,100,,TOR,0,240,41,94,0.436,33,69,0.478,8,25,0.32,10,15,0.667,100,42,88,0.477,34,61,0.557,8,27,0.296,18,24,0.75,110
1239,IND,12/17/2014,100,@,LAC,0,240,40,90,0.444,36,71,0.507,4,19,0.211,16,23,0.696,100,34,78,0.436,28,60,0.467,6,18,0.333,28,45,0.622,102
1240,LAL,12/14/2014,100,@,MIN,1,240,34,81,0.42,29,64,0.453,5,17,0.294,27,34,0.794,100,38,90,0.422,35,80,0.438,3,10,0.3,15,20,0.75,94
1241,ORL,12/13/2014,100,,ATL,1,240,37,74,0.5,27,53,0.509,10,21,0.476,16,21,0.762,100,35,84,0.417,27,57,0.474,8,27,0.296,21,24,0.875,99
1242,MIA,12/12/2014,100,@,UTA,1,240,36,72,0.5,29,52,0.558,7,20,0.35,21,31,0.677,100,34,77,0.442,26,49,0.531,8,28,0.286,19,22,0.864,95
1243,UTA,12/9/2014,100,,SAS,1,240,40,80,0.5,36,66,0.545,4,14,0.286,16,22,0.727,100,39,84,0.464,35,64,0.547,4,20,0.2,14,23,0.609,96
1244,NOP,12/6/2014,100,@,LAC,0,240,38,80,0.475,30,57,0.526,8,23,0.348,16,25,0.64,100,43,78,0.551,26,46,0.565,17,32,0.531,17,24,0.708,120
1245,HOU,12/6/2014,100,,PHO,1,240,33,81,0.407,22,54,0.407,11,27,0.407,23,31,0.742,100,34,93,0.366,27,65,0.415,7,28,0.25,20,26,0.769,95
1246,ATL,11/28/2014,100,,NOP,1,240,38,76,0.5,33,59,0.559,5,17,0.294,19,22,0.864,100,36,89,0.404,29,65,0.446,7,24,0.292,12,16,0.75,91
1247,IND,11/26/2014,100,@,SAS,0,240,40,87,0.46,30,66,0.455,10,21,0.476,10,18,0.556,100,41,74,0.554,36,59,0.61,5,15,0.333,19,29,0.655,106
1248,PHO,11/24/2014,100,@,TOR,0,240,39,84,0.464,25,51,0.49,14,33,0.424,8,11,0.727,100,37,82,0.451,33,65,0.508,4,17,0.235,26,32,0.813,104
1249,DAL,11/24/2014,100,,IND,0,240,40,80,0.5,32,56,0.571,8,24,0.333,12,21,0.571,100,37,77,0.481,24,51,0.471,13,26,0.5,24,36,0.667,111
1250,MIL,11/22/2014,100,,WAS,0,240,36,84,0.429,31,69,0.449,5,15,0.333,23,26,0.885,100,43,93,0.462,35,75,0.467,8,18,0.444,17,22,0.773,111
1251,CHO,11/21/2014,100,,ORL,0,240,42,91,0.462,35,71,0.493,7,20,0.35,9,15,0.6,100,39,82,0.476,35,66,0.53,4,16,0.25,23,32,0.719,105
1252,BOS,11/21/2014,100,@,MEM,0,240,38,88,0.432,29,61,0.475,9,27,0.333,15,21,0.714,100,48,91,0.527,40,75,0.533,8,16,0.5,13,14,0.929,117
1253,OKC,11/19/2014,100,@,DEN,0,240,36,79,0.456,26,56,0.464,10,23,0.435,18,25,0.72,100,40,82,0.488,30,53,0.566,10,29,0.345,17,22,0.773,107
1254,SAC,11/18/2014,100,,NOP,0,240,38,86,0.442,34,75,0.453,4,11,0.364,20,29,0.69,100,39,79,0.494,30,55,0.545,9,24,0.375,19,24,0.792,106
1255,SAS,11/17/2014,100,,PHI,1,240,36,81,0.444,26,55,0.473,10,26,0.385,18,21,0.857,100,27,83,0.325,23,57,0.404,4,26,0.154,17,24,0.708,75
1256,NYK,11/14/2014,100,,UTA,0,240,39,82,0.476,34,74,0.459,5,8,0.625,17,20,0.85,100,36,70,0.514,26,48,0.542,10,22,0.455,20,25,0.8,102
1257,CHI,11/13/2014,100,@,TOR,1,240,37,77,0.481,33,62,0.532,4,15,0.267,22,32,0.688,100,35,89,0.393,27,64,0.422,8,25,0.32,15,21,0.714,93
1258,ATL,11/12/2014,100,,UTA,1,240,39,76,0.513,30,56,0.536,9,20,0.45,13,18,0.722,100,43,86,0.5,38,63,0.603,5,23,0.217,6,12,0.5,97
1259,GSW,11/11/2014,100,,SAS,0,240,38,70,0.543,31,50,0.62,7,20,0.35,17,20,0.85,100,46,93,0.495,36,68,0.529,10,25,0.4,11,15,0.733,113
1260,CHO,11/11/2014,100,@,POR,0,240,35,75,0.467,28,59,0.475,7,16,0.438,23,27,0.852,100,40,93,0.43,32,68,0.471,8,25,0.32,14,16,0.875,102
1261,ORL,11/11/2014,100,@,TOR,0,240,39,81,0.481,27,56,0.482,12,25,0.48,10,16,0.625,100,35,77,0.455,26,56,0.464,9,21,0.429,25,30,0.833,104
1262,DEN,11/9/2014,100,@,POR,0,240,36,91,0.396,31,78,0.397,5,13,0.385,23,30,0.767,100,45,100,0.45,29,69,0.42,16,31,0.516,10,14,0.714,116
1263,NOP,11/8/2014,100,@,SAS,1,240,40,85,0.471,32,64,0.5,8,21,0.381,12,14,0.857,100,36,80,0.45,31,62,0.5,5,18,0.278,22,29,0.759,99
1264,CLE,11/5/2014,100,@,UTA,0,240,30,72,0.417,24,56,0.429,6,16,0.375,34,40,0.85,100,39,77,0.506,32,56,0.571,7,21,0.333,17,22,0.773,102
1265,NOP,11/4/2014,100,,CHO,1,240,38,81,0.469,33,63,0.524,5,18,0.278,19,19,1,100,37,80,0.463,31,59,0.525,6,21,0.286,11,13,0.846,91
1266,TOR,11/4/2014,100,,OKC,1,240,32,81,0.395,24,50,0.48,8,31,0.258,28,33,0.848,100,34,65,0.523,28,44,0.636,6,21,0.286,14,25,0.56,88
1267,DAL,10/28/2014,100,@,SAS,0,240,38,78,0.487,30,57,0.526,8,21,0.381,16,19,0.842,100,37,70,0.529,23,42,0.548,14,28,0.5,13,16,0.813,101
1268,LAL,4/15/2015,99,,SAC,0,240,36,94,0.383,29,70,0.414,7,24,0.292,20,25,0.8,99,46,84,0.548,38,67,0.567,8,17,0.471,22,41,0.537,122
1269,IND,4/14/2015,99,,WAS,1,290,40,105,0.381,31,75,0.413,9,30,0.3,10,17,0.588,99,37,104,0.356,30,80,0.375,7,24,0.292,14,17,0.824,95
1270,ATL,4/12/2015,99,@,WAS,0,240,36,87,0.414,27,58,0.466,9,29,0.31,18,24,0.75,99,39,85,0.459,30,64,0.469,9,21,0.429,21,27,0.778,108
1271,MIL,4/10/2015,99,@,NYK,1,240,37,76,0.487,31,59,0.525,6,17,0.353,19,29,0.655,99,34,72,0.472,29,59,0.492,5,13,0.385,18,24,0.75,91
1272,BOS,4/10/2015,99,@,CLE,1,240,38,84,0.452,30,62,0.484,8,22,0.364,15,21,0.714,99,32,77,0.416,23,43,0.535,9,34,0.265,17,25,0.68,90
1273,ORL,4/10/2015,99,,TOR,0,240,41,89,0.461,34,69,0.493,7,20,0.35,10,10,1,99,39,94,0.415,30,64,0.469,9,30,0.3,14,15,0.933,101
1274,MIL,4/8/2015,99,,CLE,0,240,42,84,0.5,36,66,0.545,6,18,0.333,9,13,0.692,99,36,74,0.486,25,40,0.625,11,34,0.324,21,26,0.808,104
1275,CLE,4/5/2015,99,,CHI,1,240,35,83,0.422,19,46,0.413,16,37,0.432,13,22,0.591,99,34,76,0.447,23,49,0.469,11,27,0.407,15,21,0.714,94
1276,POR,4/4/2015,99,,NOP,1,240,36,84,0.429,30,68,0.441,6,16,0.375,21,23,0.913,99,39,85,0.459,32,69,0.464,7,16,0.438,5,10,0.5,90
1277,DET,4/4/2015,99,,MIA,1,240,36,73,0.493,24,47,0.511,12,26,0.462,15,23,0.652,99,37,77,0.481,32,57,0.561,5,20,0.25,19,26,0.731,98
1278,BRK,4/4/2015,99,@,ATL,0,240,39,80,0.488,29,57,0.509,10,23,0.435,11,17,0.647,99,49,82,0.598,32,49,0.653,17,33,0.515,16,19,0.842,131
1279,MIN,4/1/2015,99,,TOR,0,240,41,77,0.532,36,63,0.571,5,14,0.357,12,19,0.632,99,42,76,0.553,29,46,0.63,13,30,0.433,16,23,0.696,113
1280,TOR,3/30/2015,99,,HOU,1,240,35,78,0.449,27,56,0.482,8,22,0.364,21,27,0.778,99,35,84,0.417,27,57,0.474,8,27,0.296,18,31,0.581,96
1281,LAL,3/29/2015,99,@,BRK,0,240,42,91,0.462,36,73,0.493,6,18,0.333,9,11,0.818,99,42,87,0.483,34,59,0.576,8,28,0.286,15,21,0.714,107
1282,HOU,3/29/2015,99,@,WAS,1,240,34,80,0.425,25,51,0.49,9,29,0.31,22,33,0.667,99,29,75,0.387,25,60,0.417,4,15,0.267,29,37,0.784,91
1283,DAL,3/29/2015,99,@,IND,0,240,40,90,0.444,34,75,0.453,6,15,0.4,13,19,0.684,99,38,76,0.5,28,59,0.475,10,17,0.588,18,26,0.692,104
1284,ATL,3/27/2015,99,,MIA,1,240,37,72,0.514,31,54,0.574,6,18,0.333,19,24,0.792,99,32,82,0.39,21,47,0.447,11,35,0.314,11,15,0.733,86
1285,PHO,3/25/2015,99,,SAC,0,240,38,87,0.437,32,62,0.516,6,25,0.24,17,26,0.654,99,40,81,0.494,32,60,0.533,8,21,0.381,20,23,0.87,108
1286,PHI,3/25/2015,99,@,DEN,1,240,35,84,0.417,21,50,0.42,14,34,0.412,15,22,0.682,99,29,84,0.345,21,55,0.382,8,29,0.276,19,27,0.704,85
1287,MIN,3/25/2015,99,,LAL,0,265,33,78,0.423,27,56,0.482,6,22,0.273,27,30,0.9,99,39,92,0.424,33,66,0.5,6,26,0.231,17,18,0.944,101
1288,WAS,3/20/2015,99,@,LAC,0,240,37,86,0.43,31,67,0.463,6,19,0.316,19,23,0.826,99,45,86,0.523,33,63,0.524,12,23,0.522,11,17,0.647,113
1289,LAC,3/17/2015,99,,CHO,1,240,35,77,0.455,26,53,0.491,9,24,0.375,20,28,0.714,99,32,79,0.405,27,65,0.415,5,14,0.357,23,29,0.793,92
1290,MIN,3/13/2015,99,@,OKC,0,240,34,78,0.436,31,66,0.47,3,12,0.25,28,31,0.903,99,44,101,0.436,33,77,0.429,11,24,0.458,14,14,1,113
1291,LAC,3/13/2015,99,@,DAL,0,240,41,82,0.5,29,50,0.58,12,32,0.375,5,12,0.417,99,51,84,0.607,35,56,0.625,16,28,0.571,11,16,0.688,129
1292,DET,3/13/2015,99,@,POR,0,240,41,91,0.451,34,66,0.515,7,25,0.28,10,12,0.833,99,46,80,0.575,35,59,0.593,11,21,0.524,15,17,0.882,118
1293,WAS,3/6/2015,99,,MIA,1,240,38,82,0.463,31,59,0.525,7,23,0.304,16,18,0.889,99,37,79,0.468,27,52,0.519,10,27,0.37,13,19,0.684,97
1294,SAC,3/1/2015,99,,POR,0,240,39,86,0.453,36,74,0.486,3,12,0.25,18,23,0.783,99,41,83,0.494,31,59,0.525,10,24,0.417,18,20,0.9,110
1295,NOP,3/1/2015,99,@,DEN,1,240,36,74,0.486,31,52,0.596,5,22,0.227,22,30,0.733,99,37,92,0.402,28,59,0.475,9,33,0.273,9,17,0.529,92
1296,WAS,2/28/2015,99,,DET,1,240,37,78,0.474,30,58,0.517,7,20,0.35,18,25,0.72,99,38,79,0.481,30,53,0.566,8,26,0.308,11,21,0.524,95
1297,GSW,2/26/2015,99,@,CLE,0,240,39,92,0.424,28,63,0.444,11,29,0.379,10,19,0.526,99,36,77,0.468,27,49,0.551,9,28,0.321,29,35,0.829,110
1298,DAL,2/24/2015,99,,TOR,1,240,38,79,0.481,30,60,0.5,8,19,0.421,15,18,0.833,99,38,84,0.452,29,58,0.5,9,26,0.346,7,11,0.636,92
1299,SAC,2/21/2015,99,@,LAC,0,240,30,88,0.341,26,72,0.361,4,16,0.25,35,46,0.761,99,46,95,0.484,32,60,0.533,14,35,0.4,20,28,0.714,126
1300,SAS,2/20/2015,99,@,GSW,0,240,39,81,0.481,33,62,0.532,6,19,0.316,15,20,0.75,99,41,84,0.488,24,51,0.471,17,33,0.515,11,18,0.611,110
1301,CLE,2/6/2015,99,@,IND,0,240,40,89,0.449,29,54,0.537,11,35,0.314,8,12,0.667,99,37,79,0.468,29,58,0.5,8,21,0.381,21,26,0.808,103
1302,SAC,1/31/2015,99,@,IND,1,240,34,80,0.425,29,65,0.446,5,15,0.333,26,29,0.897,99,33,80,0.413,28,55,0.509,5,25,0.2,23,25,0.92,94
1303,POR,1/30/2015,99,@,ATL,0,240,39,87,0.448,28,57,0.491,11,30,0.367,10,11,0.909,99,40,84,0.476,29,61,0.475,11,23,0.478,14,22,0.636,105
1304,PHO,1/30/2015,99,,CHI,1,240,39,90,0.433,33,68,0.485,6,22,0.273,15,17,0.882,99,36,87,0.414,32,69,0.464,4,18,0.222,17,27,0.63,93
1305,MEM,1/29/2015,99,,DEN,1,240,39,88,0.443,36,72,0.5,3,16,0.188,18,27,0.667,99,29,87,0.333,27,61,0.443,2,26,0.077,9,10,0.9,69
1306,HOU,1/28/2015,99,,DAL,1,240,36,88,0.409,22,53,0.415,14,35,0.4,13,15,0.867,99,35,82,0.427,25,57,0.439,10,25,0.4,14,16,0.875,94
1307,CLE,1/28/2015,99,,POR,1,240,34,85,0.4,19,48,0.396,15,37,0.405,16,18,0.889,99,35,80,0.438,25,49,0.51,10,31,0.323,14,17,0.824,94
1308,BOS,1/26/2015,99,@,UTA,1,240,35,74,0.473,27,55,0.491,8,19,0.421,21,23,0.913,99,35,82,0.427,26,58,0.448,9,24,0.375,11,19,0.579,90
1309,NOP,1/26/2015,99,,PHI,1,240,39,86,0.453,32,70,0.457,7,16,0.438,14,19,0.737,99,28,81,0.346,26,66,0.394,2,15,0.133,16,21,0.762,74
1310,ORL,1/25/2015,99,,IND,0,240,38,78,0.487,32,61,0.525,6,17,0.353,17,23,0.739,99,43,83,0.518,35,63,0.556,8,20,0.4,12,18,0.667,106
1311,HOU,1/25/2015,99,@,LAL,1,240,35,87,0.402,22,43,0.512,13,44,0.295,16,21,0.762,99,34,79,0.43,33,66,0.5,1,13,0.077,18,25,0.72,87
1312,DEN,1/23/2015,99,,BOS,0,240,37,89,0.416,31,68,0.456,6,21,0.286,19,26,0.731,99,37,75,0.493,28,54,0.519,9,21,0.429,17,27,0.63,100
1313,SAS,1/23/2015,99,,LAL,1,240,36,84,0.429,29,60,0.483,7,24,0.292,20,27,0.741,99,33,83,0.398,28,70,0.4,5,13,0.385,14,20,0.7,85
1314,MIL,1/22/2015,99,,UTA,0,240,42,92,0.457,37,79,0.468,5,13,0.385,10,12,0.833,99,32,71,0.451,18,40,0.45,14,31,0.452,23,28,0.821,101
1315,DEN,1/20/2015,99,,SAS,0,240,37,79,0.468,32,65,0.492,5,14,0.357,20,29,0.69,99,38,84,0.452,27,57,0.474,11,27,0.407,22,27,0.815,109
1316,NYK,1/19/2015,99,,NOP,1,240,38,78,0.487,28,55,0.509,10,23,0.435,13,17,0.765,99,35,84,0.417,27,57,0.474,8,27,0.296,14,20,0.7,92
1317,ORL,1/18/2015,99,,OKC,0,240,35,88,0.398,27,65,0.415,8,23,0.348,21,27,0.778,99,48,83,0.578,39,58,0.672,9,25,0.36,22,32,0.688,127
1318,CHI,1/17/2015,99,,ATL,0,240,37,80,0.463,28,54,0.519,9,26,0.346,16,20,0.8,99,40,84,0.476,29,58,0.5,11,26,0.423,16,21,0.762,107
1319,WAS,1/17/2015,99,@,BRK,1,240,40,77,0.519,35,61,0.574,5,16,0.313,14,27,0.519,99,36,82,0.439,32,65,0.492,4,17,0.235,14,18,0.778,90
1320,MIN,1/16/2015,99,@,PHO,0,240,42,91,0.462,34,69,0.493,8,22,0.364,7,12,0.583,99,48,87,0.552,43,72,0.597,5,15,0.333,9,11,0.818,110
1321,CHI,1/14/2015,99,,WAS,0,240,34,79,0.43,21,52,0.404,13,27,0.481,18,24,0.75,99,40,78,0.513,35,63,0.556,5,15,0.333,20,25,0.8,105
1322,BRK,1/12/2015,99,,HOU,0,240,39,84,0.464,34,63,0.54,5,21,0.238,16,18,0.889,99,41,86,0.477,25,46,0.543,16,40,0.4,15,20,0.75,113
1323,OKC,1/9/2015,99,,UTA,1,240,42,91,0.462,35,70,0.5,7,21,0.333,8,9,0.889,99,36,74,0.486,29,53,0.547,7,21,0.333,15,22,0.682,94
1324,POR,1/8/2015,99,,MIA,1,240,40,95,0.421,32,68,0.471,8,27,0.296,11,15,0.733,99,29,77,0.377,26,63,0.413,3,14,0.214,22,30,0.733,83
1325,LAC,12/31/2014,99,,NYK,1,240,36,82,0.439,21,48,0.438,15,34,0.441,12,20,0.6,99,32,84,0.381,28,67,0.418,4,17,0.235,10,15,0.667,78
1326,SAC,12/29/2014,99,@,BRK,0,240,37,76,0.487,28,56,0.5,9,20,0.45,16,20,0.8,99,36,80,0.45,28,59,0.475,8,21,0.381,27,39,0.692,107
1327,CHI,12/23/2014,99,@,WAS,1,240,39,85,0.459,34,68,0.5,5,17,0.294,16,24,0.667,99,38,89,0.427,33,80,0.413,5,9,0.556,10,16,0.625,91
1328,OKC,12/21/2014,99,,NOP,0,240,38,83,0.458,33,63,0.524,5,20,0.25,18,24,0.75,99,43,90,0.478,36,70,0.514,7,20,0.35,8,10,0.8,101
1329,DAL,12/20/2014,99,,SAS,1,240,37,86,0.43,28,60,0.467,9,26,0.346,16,20,0.8,99,32,77,0.416,29,64,0.453,3,13,0.231,26,26,1,93
1330,PHO,12/20/2014,99,@,NYK,1,240,35,78,0.449,25,53,0.472,10,25,0.4,19,23,0.826,99,35,88,0.398,28,66,0.424,7,22,0.318,13,16,0.813,90
1331,NOP,12/18/2014,99,@,HOU,1,240,38,82,0.463,33,64,0.516,5,18,0.278,18,22,0.818,99,33,86,0.384,27,61,0.443,6,25,0.24,18,23,0.783,90
1332,SAS,12/14/2014,99,@,DEN,1,240,34,74,0.459,29,58,0.5,5,16,0.313,26,35,0.743,99,34,83,0.41,26,67,0.388,8,16,0.5,15,21,0.714,91
1333,ATL,12/13/2014,99,@,ORL,0,240,35,84,0.417,27,57,0.474,8,27,0.296,21,24,0.875,99,37,74,0.5,27,53,0.509,10,21,0.476,16,21,0.762,100
1334,NYK,12/7/2014,99,,POR,0,240,41,79,0.519,36,60,0.6,5,19,0.263,12,14,0.857,99,36,85,0.424,26,57,0.456,10,28,0.357,21,29,0.724,103
1335,IND,12/2/2014,99,@,PHO,0,240,41,85,0.482,37,72,0.514,4,13,0.308,13,17,0.765,99,43,86,0.5,31,61,0.508,12,25,0.48,18,26,0.692,116
1336,POR,11/28/2014,99,,MEM,0,240,39,97,0.402,31,69,0.449,8,28,0.286,13,18,0.722,99,45,84,0.536,39,71,0.549,6,13,0.462,16,26,0.615,112
1337,BRK,11/26/2014,99,@,PHI,1,240,35,71,0.493,27,47,0.574,8,24,0.333,21,28,0.75,99,34,85,0.4,25,61,0.41,9,24,0.375,14,17,0.824,91
1338,MEM,11/26/2014,99,@,LAL,1,240,36,80,0.45,31,58,0.534,5,22,0.227,22,25,0.88,99,33,81,0.407,25,62,0.403,8,19,0.421,19,24,0.792,93
1339,SAC,11/25/2014,99,@,NOP,1,240,37,77,0.481,32,63,0.508,5,14,0.357,20,24,0.833,99,33,79,0.418,30,62,0.484,3,17,0.176,20,29,0.69,89
1340,SAS,11/22/2014,99,,BRK,1,240,41,79,0.519,33,58,0.569,8,21,0.381,9,11,0.818,99,34,91,0.374,25,64,0.391,9,27,0.333,10,10,1,87
1341,MIA,11/22/2014,99,@,ORL,1,240,37,71,0.521,25,45,0.556,12,26,0.462,13,18,0.722,99,35,78,0.449,32,62,0.516,3,16,0.188,19,27,0.704,92
1342,ATL,11/21/2014,99,,DET,1,240,38,80,0.475,33,56,0.589,5,24,0.208,18,26,0.692,99,31,83,0.373,27,62,0.435,4,21,0.19,23,24,0.958,89
1343,NYK,11/19/2014,99,@,MIN,0,240,34,69,0.493,25,53,0.472,9,16,0.563,22,28,0.786,99,44,89,0.494,33,67,0.493,11,22,0.5,16,22,0.727,115
1344,IND,11/15/2014,99,@,CHI,1,240,37,77,0.481,30,59,0.508,7,18,0.389,18,25,0.72,99,35,83,0.422,31,66,0.47,4,17,0.235,16,23,0.696,90
1345,BRK,11/13/2014,99,@,GSW,0,240,39,89,0.438,36,73,0.493,3,16,0.188,18,20,0.9,99,41,90,0.456,30,56,0.536,11,34,0.324,14,21,0.667,107
1346,SAS,11/8/2014,99,,NOP,0,240,36,80,0.45,31,62,0.5,5,18,0.278,22,29,0.759,99,40,85,0.471,32,64,0.5,8,21,0.381,12,14,0.857,100
1347,NYK,11/7/2014,99,@,BRK,0,240,37,90,0.411,29,71,0.408,8,19,0.421,17,21,0.81,99,38,74,0.514,24,50,0.48,14,24,0.583,20,26,0.769,110
1348,LAL,10/29/2014,99,@,PHO,0,240,37,86,0.43,33,73,0.452,4,13,0.308,21,25,0.84,99,45,82,0.549,29,50,0.58,16,32,0.5,13,18,0.722,119
1349,POR,4/15/2015,98,@,DAL,0,240,38,91,0.418,31,66,0.47,7,25,0.28,15,18,0.833,98,39,86,0.453,30,61,0.492,9,25,0.36,27,34,0.794,114
1350,MIN,4/10/2015,98,@,LAL,0,240,32,74,0.432,29,59,0.492,3,15,0.2,31,34,0.912,98,41,83,0.494,32,60,0.533,9,23,0.391,15,24,0.625,106
1351,HOU,4/8/2015,98,@,SAS,0,240,39,84,0.464,29,59,0.492,10,25,0.4,10,16,0.625,98,48,95,0.505,41,74,0.554,7,21,0.333,7,9,0.778,110
1352,MIA,4/4/2015,98,@,DET,0,240,37,77,0.481,32,57,0.561,5,20,0.25,19,26,0.731,98,36,73,0.493,24,47,0.511,12,26,0.462,15,23,0.652,99
1353,UTA,4/1/2015,98,,DEN,1,240,37,77,0.481,28,54,0.519,9,23,0.391,15,24,0.625,98,33,95,0.347,26,62,0.419,7,33,0.212,11,12,0.917,84
1354,NYK,4/1/2015,98,,BRK,0,240,37,81,0.457,26,58,0.448,11,23,0.478,13,15,0.867,98,41,81,0.506,32,65,0.492,9,16,0.563,9,12,0.75,100
1355,PHI,3/27/2015,98,,LAC,0,240,36,86,0.419,25,55,0.455,11,31,0.355,15,27,0.556,98,44,82,0.537,32,53,0.604,12,29,0.414,19,31,0.613,119
1356,CLE,3/27/2015,98,@,BRK,0,240,37,81,0.457,29,51,0.569,8,30,0.267,16,20,0.8,98,40,86,0.465,31,63,0.492,9,23,0.391,17,19,0.895,106
1357,CHI,3/23/2015,98,,CHO,1,240,37,82,0.451,34,66,0.515,3,16,0.188,21,29,0.724,98,28,81,0.346,20,61,0.328,8,20,0.4,22,28,0.786,86
1358,MIN,3/22/2015,98,,CHO,0,240,41,74,0.554,37,63,0.587,4,11,0.364,12,16,0.75,98,45,89,0.506,39,71,0.549,6,18,0.333,13,16,0.813,109
1359,PHO,3/22/2015,98,,DAL,1,240,39,76,0.513,33,55,0.6,6,21,0.286,14,23,0.609,98,37,96,0.385,32,77,0.416,5,19,0.263,13,22,0.591,92
1360,IND,3/16/2015,98,,TOR,0,240,38,88,0.432,36,69,0.522,2,19,0.105,20,25,0.8,98,39,82,0.476,27,59,0.458,12,23,0.522,27,33,0.818,117
1361,LAC,3/15/2015,98,,HOU,0,240,36,82,0.439,24,56,0.429,12,26,0.462,14,24,0.583,98,32,86,0.372,25,56,0.446,7,30,0.233,29,36,0.806,100
1362,BRK,3/11/2015,98,@,MIA,0,240,32,73,0.438,26,56,0.464,6,17,0.353,28,39,0.718,98,37,81,0.457,31,60,0.517,6,21,0.286,24,38,0.632,104
1363,DET,3/11/2015,98,@,GSW,0,240,42,98,0.429,38,86,0.442,4,12,0.333,10,12,0.833,98,44,84,0.524,37,64,0.578,7,20,0.35,10,13,0.769,105
1364,GSW,3/9/2015,98,@,PHO,1,240,35,83,0.422,22,52,0.423,13,31,0.419,15,19,0.789,98,29,77,0.377,25,66,0.379,4,11,0.364,18,23,0.783,80
1365,LAC,3/8/2015,98,@,GSW,0,240,40,83,0.482,32,58,0.552,8,25,0.32,10,14,0.714,98,40,80,0.5,30,58,0.517,10,22,0.455,16,23,0.696,106
1366,BOS,3/8/2015,98,@,ORL,0,240,35,89,0.393,20,55,0.364,15,34,0.441,13,16,0.813,98,38,87,0.437,31,65,0.477,7,22,0.318,20,30,0.667,103
1367,IND,3/6/2015,98,,CHI,1,240,34,80,0.425,28,60,0.467,6,20,0.3,24,33,0.727,98,31,86,0.36,26,63,0.413,5,23,0.217,17,19,0.895,84
1368,NOP,3/6/2015,98,,BOS,0,240,38,80,0.475,30,59,0.508,8,21,0.381,14,15,0.933,98,36,79,0.456,26,56,0.464,10,23,0.435,22,25,0.88,104
1369,POR,3/4/2015,98,@,LAC,1,265,34,87,0.391,26,55,0.473,8,32,0.25,22,29,0.759,98,37,96,0.385,26,65,0.4,11,31,0.355,8,18,0.444,93
1370,PHO,3/2/2015,98,@,MIA,0,240,33,78,0.423,26,47,0.553,7,31,0.226,25,38,0.658,98,43,82,0.524,36,68,0.529,7,14,0.5,22,30,0.733,115
1371,CHO,3/1/2015,98,@,ORL,1,240,40,80,0.5,32,62,0.516,8,18,0.444,10,14,0.714,98,31,85,0.365,25,70,0.357,6,15,0.4,15,20,0.75,83
1372,TOR,2/28/2015,98,@,NYK,0,240,34,81,0.42,26,52,0.5,8,29,0.276,22,28,0.786,98,33,75,0.44,26,56,0.464,7,19,0.368,30,38,0.789,103
1373,BRK,2/27/2015,98,@,HOU,0,240,38,85,0.447,34,68,0.5,4,17,0.235,18,20,0.9,98,39,84,0.464,30,52,0.577,9,32,0.281,15,17,0.882,102
1374,CHO,2/27/2015,98,@,BOS,0,240,37,82,0.451,27,61,0.443,10,21,0.476,14,17,0.824,98,40,96,0.417,26,61,0.426,14,35,0.4,12,15,0.8,106
1375,CHO,2/25/2015,98,@,CHI,1,240,39,84,0.464,35,70,0.5,4,14,0.286,16,21,0.762,98,34,77,0.442,31,60,0.517,3,17,0.176,15,23,0.652,86
1376,MEM,2/22/2015,98,@,POR,1,240,42,89,0.472,39,80,0.488,3,9,0.333,11,13,0.846,98,33,82,0.402,20,49,0.408,13,33,0.394,13,16,0.813,92
1377,PHI,2/22/2015,98,@,ORL,0,240,36,78,0.462,23,44,0.523,13,34,0.382,13,17,0.765,98,39,82,0.476,33,59,0.559,6,23,0.261,19,26,0.731,103
1378,GSW,2/22/2015,98,@,IND,0,240,34,89,0.382,25,63,0.397,9,26,0.346,21,22,0.955,98,39,81,0.481,31,62,0.5,8,19,0.421,18,23,0.783,104
1379,HOU,2/21/2015,98,,TOR,1,240,35,84,0.417,29,55,0.527,6,29,0.207,22,31,0.71,98,25,77,0.325,21,59,0.356,4,18,0.222,22,28,0.786,76
1380,CLE,2/12/2015,98,@,CHI,0,240,37,85,0.435,29,54,0.537,8,31,0.258,16,22,0.727,98,42,92,0.457,33,69,0.478,9,23,0.391,20,26,0.769,113
1381,DAL,2/9/2015,98,,LAC,0,240,33,81,0.407,23,47,0.489,10,34,0.294,22,30,0.733,98,41,92,0.446,32,65,0.492,9,27,0.333,24,29,0.828,115
1382,HOU,2/8/2015,98,,POR,0,240,31,82,0.378,18,47,0.383,13,35,0.371,23,34,0.676,98,40,76,0.526,31,47,0.66,9,29,0.31,20,23,0.87,109
1383,CHI,2/8/2015,98,@,ORL,1,240,37,77,0.481,29,55,0.527,8,22,0.364,16,18,0.889,98,39,83,0.47,30,58,0.517,9,25,0.36,10,13,0.769,97
1384,DET,2/6/2015,98,,DEN,1,240,37,82,0.451,33,58,0.569,4,24,0.167,20,26,0.769,98,33,85,0.388,28,63,0.444,5,22,0.227,17,22,0.773,88
1385,SAS,2/6/2015,98,,MIA,1,240,40,83,0.482,29,54,0.537,11,29,0.379,7,9,0.778,98,36,80,0.45,31,64,0.484,5,16,0.313,8,9,0.889,85
1386,DEN,2/3/2015,98,@,PHI,0,240,33,85,0.388,21,54,0.389,12,31,0.387,20,28,0.714,98,31,70,0.443,20,43,0.465,11,27,0.407,32,42,0.762,105
1387,WAS,1/28/2015,98,@,PHO,0,240,37,88,0.42,29,70,0.414,8,18,0.444,16,23,0.696,98,40,88,0.455,29,59,0.492,11,29,0.379,15,18,0.833,106
1388,BOS,1/28/2015,98,@,MIN,0,240,42,91,0.462,35,68,0.515,7,23,0.304,7,9,0.778,98,38,77,0.494,32,61,0.525,6,16,0.375,28,32,0.875,110
1389,WAS,1/27/2015,98,@,LAL,1,240,38,78,0.487,34,62,0.548,4,16,0.25,18,27,0.667,98,37,87,0.425,32,67,0.478,5,20,0.25,13,16,0.813,92
1390,DEN,1/26/2015,98,@,LAC,0,240,40,83,0.482,32,62,0.516,8,21,0.381,10,15,0.667,98,38,80,0.475,31,61,0.508,7,19,0.368,19,22,0.864,102
1391,OKC,1/25/2015,98,@,CLE,0,240,37,94,0.394,27,64,0.422,10,30,0.333,14,18,0.778,98,36,82,0.439,20,46,0.435,16,36,0.444,20,29,0.69,108
1392,DAL,1/23/2015,98,,CHI,0,240,37,82,0.451,31,64,0.484,6,18,0.333,18,18,1,98,38,78,0.487,29,62,0.468,9,16,0.563,17,20,0.85,102
1393,NYK,1/21/2015,98,@,PHI,1,240,37,91,0.407,30,71,0.423,7,20,0.35,17,20,0.85,98,29,79,0.367,21,56,0.375,8,23,0.348,25,32,0.781,91
1394,DAL,1/21/2015,98,@,MIN,1,240,39,76,0.513,28,49,0.571,11,27,0.407,9,14,0.643,98,31,89,0.348,29,74,0.392,2,15,0.133,11,15,0.733,75
1395,IND,1/19/2015,98,@,HOU,0,240,39,85,0.459,33,58,0.569,6,27,0.222,14,18,0.778,98,37,72,0.514,25,41,0.61,12,31,0.387,24,33,0.727,110
1396,POR,1/19/2015,98,,SAC,1,240,35,88,0.398,24,52,0.462,11,36,0.306,17,26,0.654,98,34,76,0.447,30,64,0.469,4,12,0.333,22,30,0.733,94
1397,POR,1/17/2015,98,@,MEM,0,240,36,93,0.387,23,57,0.404,13,36,0.361,13,15,0.867,98,39,77,0.506,31,62,0.5,8,15,0.533,16,24,0.667,102
1398,DET,1/16/2015,98,@,IND,1,240,32,85,0.376,19,54,0.352,13,31,0.419,21,24,0.875,98,40,89,0.449,34,71,0.479,6,18,0.333,10,12,0.833,96
1399,SAS,1/14/2015,98,@,CHO,1,240,37,85,0.435,29,64,0.453,8,21,0.381,16,20,0.8,98,33,86,0.384,29,73,0.397,4,13,0.308,23,35,0.657,93
1400,DET,1/10/2015,98,,BRK,1,240,34,80,0.425,23,47,0.489,11,33,0.333,19,26,0.731,98,37,88,0.42,28,57,0.491,9,31,0.29,10,10,1,93
1401,MIL,1/9/2015,98,,MIN,1,240,39,75,0.52,27,56,0.482,12,19,0.632,8,10,0.8,98,32,79,0.405,26,57,0.456,6,22,0.273,14,17,0.824,84
1402,CHO,1/7/2015,98,,NOP,1,240,37,86,0.43,33,72,0.458,4,14,0.286,20,26,0.769,98,36,80,0.45,30,62,0.484,6,18,0.333,16,24,0.667,94
1403,POR,1/5/2015,98,,LAL,1,240,33,83,0.398,22,57,0.386,11,26,0.423,21,24,0.875,98,37,88,0.42,33,74,0.446,4,14,0.286,16,20,0.8,94
1404,LAC,1/5/2015,98,,ATL,0,240,33,74,0.446,26,49,0.531,7,25,0.28,25,33,0.758,98,36,81,0.444,23,54,0.426,13,27,0.481,22,33,0.667,107
1405,CHO,1/3/2015,98,@,ORL,1,240,35,78,0.449,31,62,0.5,4,16,0.25,24,32,0.75,98,33,87,0.379,29,68,0.426,4,19,0.211,20,21,0.952,90
1406,ATL,1/2/2015,98,@,UTA,1,240,33,81,0.407,27,58,0.466,6,23,0.261,26,30,0.867,98,32,86,0.372,22,55,0.4,10,31,0.323,18,24,0.75,92
1407,ORL,1/2/2015,98,,BRK,0,240,37,88,0.42,26,66,0.394,11,22,0.5,13,20,0.65,98,41,72,0.569,34,52,0.654,7,20,0.35,11,18,0.611,100
1408,LAC,12/27/2014,98,,TOR,0,240,37,81,0.457,25,56,0.446,12,25,0.48,12,15,0.8,98,41,86,0.477,28,52,0.538,13,34,0.382,15,19,0.789,110
1409,CLE,12/26/2014,98,@,ORL,1,240,33,80,0.413,25,50,0.5,8,30,0.267,24,26,0.923,98,36,73,0.493,27,52,0.519,9,21,0.429,8,12,0.667,89
1410,LAL,12/26/2014,98,@,DAL,0,240,36,99,0.364,25,70,0.357,11,29,0.379,15,20,0.75,98,42,83,0.506,37,65,0.569,5,18,0.278,13,24,0.542,102
1411,OKC,12/26/2014,98,,CHO,1,240,36,88,0.409,28,61,0.459,8,27,0.296,18,21,0.857,98,25,87,0.287,20,63,0.317,5,24,0.208,20,26,0.769,75
1412,MIN,12/19/2014,98,@,BOS,0,240,42,93,0.452,36,81,0.444,6,12,0.5,8,16,0.5,98,48,85,0.565,40,62,0.645,8,23,0.348,10,14,0.714,114
1413,CLE,12/17/2014,98,,ATL,0,240,37,82,0.451,29,52,0.558,8,30,0.267,16,21,0.762,98,49,76,0.645,33,48,0.688,16,28,0.571,13,16,0.813,127
1414,GSW,12/16/2014,98,@,MEM,0,240,39,95,0.411,30,64,0.469,9,31,0.29,11,12,0.917,98,42,92,0.457,37,78,0.474,5,14,0.357,16,19,0.842,105
1415,DAL,12/13/2014,98,,GSW,0,240,36,89,0.404,31,64,0.484,5,25,0.2,21,30,0.7,98,37,83,0.446,27,51,0.529,10,32,0.313,21,27,0.778,105
1416,POR,12/9/2014,98,@,DET,1,240,41,84,0.488,32,63,0.508,9,21,0.429,7,8,0.875,98,34,97,0.351,29,75,0.387,5,22,0.227,13,16,0.813,86
1417,LAL,12/9/2014,98,,SAC,1,240,38,96,0.396,33,71,0.465,5,25,0.2,17,25,0.68,98,32,70,0.457,25,55,0.455,7,15,0.467,24,37,0.649,95
1418,ORL,12/5/2014,98,@,UTA,1,240,37,74,0.5,30,57,0.526,7,17,0.412,17,20,0.85,98,36,79,0.456,28,63,0.444,8,16,0.5,13,21,0.619,93
1419,ATL,12/5/2014,98,@,BRK,1,240,35,81,0.432,22,47,0.468,13,34,0.382,15,24,0.625,98,30,80,0.375,27,62,0.435,3,18,0.167,12,19,0.632,75
1420,BRK,12/2/2014,98,@,NYK,1,240,39,89,0.438,33,72,0.458,6,17,0.353,14,20,0.7,98,35,81,0.432,24,53,0.453,11,28,0.393,12,14,0.857,93
1421,GSW,12/2/2014,98,,ORL,1,240,38,82,0.463,30,55,0.545,8,27,0.296,14,18,0.778,98,39,87,0.448,33,70,0.471,6,17,0.353,13,14,0.929,97
1422,IND,11/28/2014,98,,ORL,1,240,41,94,0.436,37,78,0.474,4,16,0.25,12,14,0.857,98,31,70,0.443,24,52,0.462,7,18,0.389,14,16,0.875,83
1423,DET,11/26/2014,98,,LAC,0,240,35,78,0.449,25,51,0.49,10,27,0.37,18,24,0.75,98,37,78,0.474,25,50,0.5,12,28,0.429,18,19,0.947,104
1424,MIL,11/25/2014,98,,DET,1,240,39,90,0.433,29,68,0.426,10,22,0.455,10,13,0.769,98,36,78,0.462,29,58,0.5,7,20,0.35,7,17,0.412,86
1425,LAL,11/19/2014,98,@,HOU,1,240,37,91,0.407,32,71,0.451,5,20,0.25,19,23,0.826,98,30,74,0.405,15,36,0.417,15,38,0.395,17,23,0.739,92
1426,UTA,11/18/2014,98,,OKC,1,240,35,81,0.432,25,57,0.439,10,24,0.417,18,26,0.692,98,30,84,0.357,22,61,0.361,8,23,0.348,13,19,0.684,81
1427,WAS,11/15/2014,98,,ORL,1,240,42,84,0.5,39,74,0.527,3,10,0.3,11,16,0.688,98,37,78,0.474,30,61,0.492,7,17,0.412,12,18,0.667,93
1428,SAC,11/11/2014,98,@,DAL,0,240,32,72,0.444,23,53,0.434,9,19,0.474,25,32,0.781,98,38,80,0.475,28,53,0.528,10,27,0.37,20,24,0.833,106
1429,GSW,11/8/2014,98,@,HOU,1,240,39,87,0.448,30,59,0.508,9,28,0.321,11,17,0.647,98,30,86,0.349,20,44,0.455,10,42,0.238,17,21,0.81,87
1430,DET,11/7/2014,98,,MIL,1,240,37,75,0.493,26,52,0.5,11,23,0.478,13,24,0.542,98,36,77,0.468,31,57,0.544,5,20,0.25,18,23,0.783,95
1431,IND,11/7/2014,98,@,BOS,0,240,40,88,0.455,35,69,0.507,5,19,0.263,13,13,1,98,39,85,0.459,30,58,0.517,9,27,0.333,14,16,0.875,101
1432,HOU,11/6/2014,98,,SAS,1,240,34,72,0.472,24,45,0.533,10,27,0.37,20,33,0.606,98,31,90,0.344,29,70,0.414,2,20,0.1,17,19,0.895,81
1433,MIN,11/5/2014,98,@,BRK,1,240,37,90,0.411,30,73,0.411,7,17,0.412,17,22,0.773,98,36,82,0.439,28,61,0.459,8,21,0.381,11,17,0.647,91
1434,DET,11/5/2014,98,,NYK,1,240,32,87,0.368,21,64,0.328,11,23,0.478,23,33,0.697,98,39,90,0.433,30,70,0.429,9,20,0.45,8,10,0.8,95
1435,WAS,11/4/2014,98,@,NYK,1,240,39,80,0.488,31,62,0.5,8,18,0.444,12,19,0.632,98,30,81,0.37,22,66,0.333,8,15,0.533,15,19,0.789,83
1436,CHI,11/4/2014,98,,ORL,1,240,35,75,0.467,28,60,0.467,7,15,0.467,21,27,0.778,98,38,88,0.432,32,74,0.432,6,14,0.429,8,14,0.571,90
1437,SAC,11/2/2014,98,@,LAC,1,240,34,68,0.5,31,58,0.534,3,10,0.3,27,33,0.818,98,33,88,0.375,24,57,0.421,9,31,0.29,17,21,0.81,92
1438,ORL,10/30/2014,98,,WAS,0,240,37,72,0.514,31,57,0.544,6,15,0.4,18,24,0.75,98,39,80,0.488,32,67,0.478,7,13,0.538,20,26,0.769,105
1439,DET,4/13/2015,97,@,CLE,0,240,38,83,0.458,29,58,0.5,9,25,0.36,12,20,0.6,97,43,85,0.506,26,53,0.491,17,32,0.531,6,12,0.5,109
1440,PHI,4/13/2015,97,,MIL,0,240,32,81,0.395,26,53,0.491,6,28,0.214,27,34,0.794,97,40,81,0.494,36,72,0.5,4,9,0.444,23,36,0.639,107
1441,ORL,4/4/2015,97,@,MIL,1,240,40,86,0.465,32,65,0.492,8,21,0.381,9,13,0.692,97,39,89,0.438,34,73,0.466,5,16,0.313,7,13,0.538,90
1442,ORL,4/3/2015,97,@,MIN,1,240,40,92,0.435,34,71,0.479,6,21,0.286,11,17,0.647,97,29,64,0.453,28,53,0.528,1,11,0.091,25,32,0.781,84
1443,MEM,3/30/2015,97,,SAC,1,240,38,83,0.458,30,60,0.5,8,23,0.348,13,17,0.765,97,33,81,0.407,28,65,0.431,5,16,0.313,12,20,0.6,83
1444,PHO,3/29/2015,97,,OKC,0,240,37,82,0.451,32,60,0.533,5,22,0.227,18,24,0.75,97,40,86,0.465,30,60,0.5,10,26,0.385,19,26,0.731,109
1445,ORL,3/27/2015,97,,DET,0,240,43,82,0.524,40,67,0.597,3,15,0.2,8,8,1,97,42,90,0.467,35,72,0.486,7,18,0.389,20,27,0.741,111
1446,BOS,3/22/2015,97,,DET,0,265,38,105,0.362,30,78,0.385,8,27,0.296,13,17,0.765,97,39,89,0.438,30,63,0.476,9,26,0.346,18,30,0.6,105
1447,MEM,3/21/2015,97,,POR,1,240,37,89,0.416,26,71,0.366,11,18,0.611,12,16,0.75,97,33,76,0.434,27,54,0.5,6,22,0.273,14,15,0.933,86
1448,PHI,3/20/2015,97,,NYK,1,240,37,88,0.42,26,58,0.448,11,30,0.367,12,15,0.8,97,25,69,0.362,17,53,0.321,8,16,0.5,23,26,0.885,81
1449,POR,3/16/2015,97,@,WAS,0,240,36,89,0.404,28,61,0.459,8,28,0.286,17,20,0.85,97,41,82,0.5,34,70,0.486,7,12,0.583,16,26,0.615,105
1450,MIN,3/15/2015,97,@,SAS,0,240,38,86,0.442,31,71,0.437,7,15,0.467,14,18,0.778,97,49,84,0.583,37,62,0.597,12,22,0.545,13,15,0.867,123
1451,TOR,3/15/2015,97,,POR,0,240,37,78,0.474,32,60,0.533,5,18,0.278,18,23,0.783,97,45,86,0.523,32,57,0.561,13,29,0.448,10,16,0.625,113
1452,SAC,3/14/2015,97,@,WAS,0,240,35,77,0.455,29,58,0.5,6,19,0.316,21,28,0.75,97,43,81,0.531,30,55,0.545,13,26,0.5,14,17,0.824,113
1453,MIN,3/11/2015,97,@,PHO,0,240,36,81,0.444,35,68,0.515,1,13,0.077,24,26,0.923,97,45,90,0.5,39,66,0.591,6,24,0.25,10,13,0.769,106
1454,MIL,3/11/2015,97,,ORL,1,240,39,79,0.494,31,61,0.508,8,18,0.444,11,16,0.688,97,34,85,0.4,24,67,0.358,10,18,0.556,13,13,1,91
1455,CLE,3/6/2015,97,@,ATL,0,240,29,69,0.42,16,31,0.516,13,38,0.342,26,33,0.788,97,43,84,0.512,37,63,0.587,6,21,0.286,14,17,0.824,106
1456,MIA,3/6/2015,97,@,WAS,0,240,37,79,0.468,27,52,0.519,10,27,0.37,13,19,0.684,97,38,82,0.463,31,59,0.525,7,23,0.304,16,18,0.889,99
1457,MEM,3/6/2015,97,,LAL,1,240,34,77,0.442,33,66,0.5,1,11,0.091,28,33,0.848,97,39,84,0.464,34,72,0.472,5,12,0.417,7,9,0.778,90
1458,CHI,3/3/2015,97,,WAS,1,240,33,78,0.423,24,49,0.49,9,29,0.31,22,30,0.733,97,35,84,0.417,27,62,0.435,8,22,0.364,14,19,0.737,92
1459,MIN,2/28/2015,97,,MEM,0,240,34,88,0.386,27,69,0.391,7,19,0.368,22,27,0.815,97,38,64,0.594,34,53,0.642,4,11,0.364,21,29,0.724,101
1460,LAC,2/27/2015,97,@,MEM,1,240,36,78,0.462,27,52,0.519,9,26,0.346,16,28,0.571,97,33,87,0.379,30,75,0.4,3,12,0.25,10,15,0.667,79
1461,MIN,2/25/2015,97,,WAS,1,240,35,81,0.432,31,68,0.456,4,13,0.308,23,28,0.821,97,33,87,0.379,29,69,0.42,4,18,0.222,7,8,0.875,77
1462,UTA,2/25/2015,97,,LAL,0,240,34,73,0.466,27,61,0.443,7,12,0.583,22,34,0.647,97,40,89,0.449,38,78,0.487,2,11,0.182,18,21,0.857,100
1463,TOR,2/23/2015,97,@,NOP,0,240,35,84,0.417,30,61,0.492,5,23,0.217,22,31,0.71,97,40,78,0.513,30,56,0.536,10,22,0.455,10,16,0.625,100
1464,ATL,2/22/2015,97,@,MIL,1,240,35,87,0.402,26,57,0.456,9,30,0.3,18,21,0.857,97,32,72,0.444,28,56,0.5,4,16,0.25,18,18,1,86
1465,BRK,2/9/2015,97,@,MIL,0,240,38,76,0.5,29,51,0.569,9,25,0.36,12,19,0.632,97,37,89,0.416,30,71,0.423,7,18,0.389,22,25,0.88,103
1466,ORL,2/8/2015,97,,CHI,0,240,39,83,0.47,30,58,0.517,9,25,0.36,10,13,0.769,97,37,77,0.481,29,55,0.527,8,22,0.364,16,18,0.889,98
1467,LAL,2/6/2015,97,@,ORL,0,265,39,97,0.402,28,71,0.394,11,26,0.423,8,13,0.615,97,43,83,0.518,38,68,0.559,5,15,0.333,12,14,0.857,103
1468,NYK,2/3/2015,97,,BOS,0,240,41,83,0.494,34,63,0.54,7,20,0.35,8,11,0.727,97,42,77,0.545,36,53,0.679,6,24,0.25,18,23,0.783,108
1469,ORL,2/2/2015,97,@,OKC,0,240,38,90,0.422,32,67,0.478,6,23,0.261,15,18,0.833,97,37,75,0.493,29,55,0.527,8,20,0.4,22,26,0.846,104
1470,CLE,2/2/2015,97,,PHI,1,240,35,78,0.449,23,51,0.451,12,27,0.444,15,22,0.682,97,31,78,0.397,19,45,0.422,12,33,0.364,10,14,0.714,84
1471,DAL,1/16/2015,97,,DEN,1,240,33,79,0.418,25,54,0.463,8,25,0.32,23,29,0.793,97,34,83,0.41,25,58,0.431,9,25,0.36,12,25,0.48,89
1472,HOU,1/10/2015,97,,UTA,1,240,33,77,0.429,20,43,0.465,13,34,0.382,18,21,0.857,97,29,70,0.414,24,53,0.453,5,17,0.294,19,21,0.905,82
1473,UTA,1/7/2015,97,@,CHI,1,240,37,78,0.474,32,62,0.516,5,16,0.313,18,24,0.75,97,28,84,0.333,22,64,0.344,6,20,0.3,15,20,0.75,77
1474,MIL,1/7/2015,97,@,PHI,1,240,41,76,0.539,33,59,0.559,8,17,0.471,7,11,0.636,97,25,83,0.301,23,58,0.397,2,25,0.08,25,29,0.862,77
1475,DET,1/2/2015,97,@,NYK,1,240,38,76,0.5,25,43,0.581,13,33,0.394,8,14,0.571,97,32,91,0.352,22,67,0.328,10,24,0.417,7,14,0.5,81
1476,TOR,12/30/2014,97,@,POR,0,265,40,99,0.404,36,77,0.468,4,22,0.182,13,15,0.867,97,38,95,0.4,26,59,0.441,12,36,0.333,14,18,0.778,102
1477,UTA,12/29/2014,97,@,LAC,0,240,38,92,0.413,30,73,0.411,8,19,0.421,13,22,0.591,97,37,81,0.457,27,58,0.466,10,23,0.435,17,22,0.773,101
1478,MIN,12/27/2014,97,@,GSW,0,240,34,77,0.442,26,58,0.448,8,19,0.421,21,36,0.583,97,41,88,0.466,30,60,0.5,11,28,0.393,17,21,0.81,110
1479,NOP,12/26/2014,97,,SAS,1,240,35,84,0.417,29,67,0.433,6,17,0.353,21,24,0.875,97,37,75,0.493,31,61,0.508,6,14,0.429,10,14,0.714,90
1480,UTA,12/22/2014,97,@,MEM,1,240,34,75,0.453,25,56,0.446,9,19,0.474,20,27,0.741,97,38,86,0.442,31,63,0.492,7,23,0.304,8,9,0.889,91
1481,HOU,12/20/2014,97,,ATL,0,240,34,86,0.395,19,43,0.442,15,43,0.349,14,18,0.778,97,38,74,0.514,28,48,0.583,10,26,0.385,18,24,0.75,104
1482,MEM,12/19/2014,97,,CHI,0,240,37,94,0.394,35,81,0.432,2,13,0.154,21,24,0.875,97,32,73,0.438,22,47,0.468,10,26,0.385,29,33,0.879,103
1483,NYK,12/18/2014,97,@,CHI,0,240,38,82,0.463,32,73,0.438,6,9,0.667,15,19,0.789,97,34,75,0.453,22,52,0.423,12,23,0.522,23,30,0.767,103
1484,MIL,12/17/2014,97,@,POR,0,240,37,77,0.481,30,58,0.517,7,19,0.368,16,22,0.727,97,41,87,0.471,34,64,0.531,7,23,0.304,15,29,0.517,104
1485,CLE,12/15/2014,97,,CHO,1,240,38,83,0.458,29,59,0.492,9,24,0.375,12,17,0.706,97,38,83,0.458,33,67,0.493,5,16,0.313,7,14,0.5,88
1486,PHO,12/9/2014,97,,MIA,0,240,37,77,0.481,20,42,0.476,17,35,0.486,6,9,0.667,97,43,80,0.538,34,63,0.54,9,17,0.529,8,12,0.667,103
1487,ORL,12/2/2014,97,@,GSW,0,240,39,87,0.448,33,70,0.471,6,17,0.353,13,14,0.929,97,38,82,0.463,30,55,0.545,8,27,0.296,14,18,0.778,98
1488,MEM,11/30/2014,97,@,SAC,1,240,38,79,0.481,35,66,0.53,3,13,0.231,18,28,0.643,97,33,70,0.471,32,59,0.542,1,11,0.091,18,27,0.667,85
1489,IND,11/29/2014,97,@,CLE,0,240,35,89,0.393,28,67,0.418,7,22,0.318,20,26,0.769,97,41,78,0.526,34,62,0.548,7,16,0.438,20,32,0.625,109
1490,PHO,11/28/2014,97,@,DEN,0,240,33,85,0.388,25,62,0.403,8,23,0.348,23,29,0.793,97,41,88,0.466,33,67,0.493,8,21,0.381,32,36,0.889,122
1491,OKC,11/26/2014,97,,UTA,1,240,40,83,0.482,28,57,0.491,12,26,0.462,5,10,0.5,97,31,70,0.443,28,54,0.519,3,16,0.188,17,28,0.607,82
1492,CHO,11/26/2014,97,,POR,0,240,41,94,0.436,36,79,0.456,5,15,0.333,10,15,0.667,97,39,92,0.424,27,65,0.415,12,27,0.444,15,20,0.75,105
1493,MIA,11/25/2014,97,,GSW,0,240,33,85,0.388,23,62,0.371,10,23,0.435,21,27,0.778,97,43,75,0.573,30,47,0.638,13,28,0.464,15,23,0.652,114
1494,CHI,11/24/2014,97,@,UTA,1,240,36,72,0.5,27,52,0.519,9,20,0.45,16,23,0.696,97,42,86,0.488,39,77,0.506,3,9,0.333,8,10,0.8,95
1495,NOP,11/21/2014,97,@,DEN,0,240,31,78,0.397,26,62,0.419,5,16,0.313,30,34,0.882,97,43,82,0.524,32,58,0.552,11,24,0.458,20,25,0.8,117
1496,CLE,11/17/2014,97,,DEN,0,240,34,79,0.43,24,50,0.48,10,29,0.345,19,23,0.826,97,41,85,0.482,29,54,0.537,12,31,0.387,12,15,0.8,106
1497,POR,11/15/2014,97,,BRK,1,240,33,78,0.423,22,52,0.423,11,26,0.423,20,27,0.741,97,35,89,0.393,34,70,0.486,1,19,0.053,16,17,0.941,87
1498,ORL,11/12/2014,97,@,NYK,1,240,33,70,0.471,27,58,0.466,6,12,0.5,25,32,0.781,97,37,86,0.43,29,63,0.46,8,23,0.348,13,14,0.929,95
1499,UTA,11/12/2014,97,@,ATL,0,240,43,86,0.5,38,63,0.603,5,23,0.217,6,12,0.5,97,39,76,0.513,30,56,0.536,9,20,0.45,13,18,0.722,100
1500,IND,11/10/2014,97,,UTA,1,240,39,90,0.433,33,75,0.44,6,15,0.4,13,15,0.867,97,32,74,0.432,26,53,0.491,6,21,0.286,16,21,0.762,86
1501,UTA,11/9/2014,97,@,DET,1,240,33,72,0.458,27,57,0.474,6,15,0.4,25,35,0.714,97,36,93,0.387,30,70,0.429,6,23,0.261,18,25,0.72,96
1502,WAS,11/8/2014,97,@,IND,1,240,39,81,0.481,37,70,0.529,2,11,0.182,17,23,0.739,97,33,77,0.429,25,53,0.472,8,24,0.333,16,25,0.64,90
1503,MIL,11/1/2014,97,@,WAS,0,240,34,80,0.425,25,58,0.431,9,22,0.409,20,24,0.833,97,40,73,0.548,36,60,0.6,4,13,0.308,24,33,0.727,108
1504,MEM,10/31/2014,97,@,IND,1,240,35,79,0.443,28,60,0.467,7,19,0.368,20,27,0.741,97,34,74,0.459,26,53,0.491,8,21,0.381,13,16,0.813,89
1505,MIN,10/30/2014,97,,DET,1,240,37,76,0.487,33,66,0.5,4,10,0.4,19,28,0.679,97,38,91,0.418,31,70,0.443,7,21,0.333,8,13,0.615,91
1506,MIL,4/12/2015,96,,BRK,1,240,41,83,0.494,35,63,0.556,6,20,0.3,8,12,0.667,96,27,83,0.325,24,65,0.369,3,18,0.167,16,22,0.727,73
1507,ATL,4/7/2015,96,,PHO,1,240,41,83,0.494,37,58,0.638,4,25,0.16,10,14,0.714,96,26,83,0.313,22,63,0.349,4,20,0.2,13,18,0.722,69
1508,POR,4/6/2015,96,@,BRK,0,240,39,87,0.448,28,61,0.459,11,26,0.423,7,9,0.778,96,41,91,0.451,35,77,0.455,6,14,0.429,18,23,0.783,106
1509,HOU,3/30/2015,96,@,TOR,0,240,35,84,0.417,27,57,0.474,8,27,0.296,18,31,0.581,96,35,78,0.449,27,56,0.482,8,22,0.364,21,27,0.778,99
1510,BOS,3/27/2015,96,@,NYK,1,240,29,69,0.42,25,49,0.51,4,20,0.2,34,43,0.791,96,38,87,0.437,31,63,0.492,7,24,0.292,9,14,0.643,92
1511,NOP,3/20/2015,96,@,GSW,0,240,33,77,0.429,22,55,0.4,11,22,0.5,19,22,0.864,96,44,88,0.5,39,69,0.565,5,19,0.263,19,23,0.826,112
1512,MEM,3/14/2015,96,,MIL,1,240,37,78,0.474,29,64,0.453,8,14,0.571,14,16,0.875,96,30,72,0.417,25,53,0.472,5,19,0.263,18,27,0.667,83
1513,ATL,3/13/2015,96,@,PHO,1,240,39,83,0.47,31,65,0.477,8,18,0.444,10,12,0.833,96,32,78,0.41,22,52,0.423,10,26,0.385,13,21,0.619,87
1514,HOU,3/3/2015,96,@,ATL,0,240,39,90,0.433,25,49,0.51,14,41,0.341,4,9,0.444,96,39,86,0.453,31,57,0.544,8,29,0.276,18,21,0.857,104
1515,LAC,3/1/2015,96,@,CHI,1,240,38,87,0.437,31,60,0.517,7,27,0.259,13,24,0.542,96,27,87,0.31,17,61,0.279,10,26,0.385,22,30,0.733,86
1516,CHI,2/27/2015,96,,MIN,1,240,37,96,0.385,28,65,0.431,9,31,0.29,13,16,0.813,96,33,77,0.429,31,63,0.492,2,14,0.143,21,31,0.677,89
1517,SAC,2/27/2015,96,,SAS,0,240,38,79,0.481,37,75,0.493,1,4,0.25,19,23,0.826,96,35,88,0.398,27,65,0.415,8,23,0.348,29,32,0.906,107
1518,BRK,2/25/2015,96,@,NOP,0,240,39,92,0.424,32,71,0.451,7,21,0.333,11,15,0.733,96,38,74,0.514,27,49,0.551,11,25,0.44,15,19,0.789,102
1519,DEN,2/25/2015,96,,PHO,0,240,31,81,0.383,19,47,0.404,12,34,0.353,22,33,0.667,96,39,91,0.429,31,67,0.463,8,24,0.333,24,32,0.75,110
1520,LAL,2/10/2015,96,,DEN,0,240,37,85,0.435,31,67,0.463,6,18,0.333,16,27,0.593,96,43,79,0.544,39,63,0.619,4,16,0.25,16,23,0.696,106
1521,NOP,2/9/2015,96,,UTA,0,240,33,79,0.418,20,57,0.351,13,22,0.591,17,20,0.85,96,39,93,0.419,30,72,0.417,9,21,0.429,13,19,0.684,100
1522,WAS,2/9/2015,96,,ORL,1,240,33,77,0.429,26,52,0.5,7,25,0.28,23,27,0.852,96,33,83,0.398,29,61,0.475,4,22,0.182,10,15,0.667,80
1523,MIL,2/7/2015,96,,BOS,1,240,37,75,0.493,29,55,0.527,8,20,0.4,14,19,0.737,96,36,86,0.419,29,57,0.509,7,29,0.241,14,20,0.7,93
1524,PHI,2/6/2015,96,@,BOS,0,240,35,79,0.443,24,54,0.444,11,25,0.44,15,31,0.484,96,39,86,0.453,29,59,0.492,10,27,0.37,19,25,0.76,107
1525,WAS,2/4/2015,96,@,ATL,0,240,34,77,0.442,30,61,0.492,4,16,0.25,24,30,0.8,96,38,80,0.475,27,55,0.491,11,25,0.44,18,27,0.667,105
1526,SAC,2/3/2015,96,,GSW,0,240,35,79,0.443,28,63,0.444,7,16,0.438,19,24,0.792,96,46,91,0.505,36,68,0.529,10,23,0.435,19,26,0.731,121
1527,MIA,1/25/2015,96,@,CHI,1,240,38,84,0.452,37,71,0.521,1,13,0.077,19,23,0.826,96,31,87,0.356,24,63,0.381,7,24,0.292,15,19,0.789,84
1528,WAS,1/24/2015,96,@,POR,0,240,40,82,0.488,35,67,0.522,5,15,0.333,11,14,0.786,96,35,87,0.402,22,56,0.393,13,31,0.419,20,20,1,103
1529,NOP,1/21/2015,96,,LAL,1,240,38,83,0.458,35,67,0.522,3,16,0.188,17,21,0.81,96,28,77,0.364,22,57,0.386,6,20,0.3,18,21,0.857,80
1530,PHI,1/16/2015,96,,NOP,1,240,36,80,0.45,29,58,0.5,7,22,0.318,17,27,0.63,96,29,75,0.387,25,58,0.431,4,17,0.235,19,29,0.655,81
1531,POR,1/16/2015,96,@,SAS,0,240,37,74,0.5,31,55,0.564,6,19,0.316,16,20,0.8,96,42,94,0.447,31,65,0.477,11,29,0.379,15,17,0.882,110
1532,IND,1/16/2015,96,,DET,0,240,40,89,0.449,34,71,0.479,6,18,0.333,10,12,0.833,96,32,85,0.376,19,54,0.352,13,31,0.419,21,24,0.875,98
1533,ORL,1/16/2015,96,,MEM,0,240,36,79,0.456,27,55,0.491,9,24,0.375,15,20,0.75,96,40,87,0.46,37,73,0.507,3,14,0.214,23,29,0.793,106
1534,BOS,1/10/2015,96,@,TOR,0,240,39,83,0.47,33,65,0.508,6,18,0.333,12,20,0.6,96,41,91,0.451,28,61,0.459,13,30,0.433,14,19,0.737,109
1535,NYK,1/8/2015,96,,HOU,0,240,37,80,0.463,26,54,0.481,11,26,0.423,11,21,0.524,96,41,77,0.532,25,41,0.61,16,36,0.444,22,32,0.688,120
1536,ATL,1/7/2015,96,,MEM,1,240,32,72,0.444,19,47,0.404,13,25,0.52,19,23,0.826,96,35,79,0.443,30,62,0.484,5,17,0.294,11,11,1,86
1537,MIL,1/6/2015,96,,PHO,0,240,37,88,0.42,34,68,0.5,3,20,0.15,19,22,0.864,96,37,81,0.457,30,56,0.536,7,25,0.28,21,27,0.778,102
1538,DAL,1/5/2015,96,@,BRK,1,265,37,94,0.394,27,67,0.403,10,27,0.37,12,19,0.632,96,33,84,0.393,30,59,0.508,3,25,0.12,19,23,0.826,88
1539,PHI,1/2/2015,96,@,PHO,0,240,37,87,0.425,30,61,0.492,7,26,0.269,15,25,0.6,96,42,84,0.5,28,52,0.538,14,32,0.438,14,16,0.875,112
1540,MIL,12/31/2014,96,@,CLE,1,240,40,90,0.444,29,65,0.446,11,25,0.44,5,10,0.5,96,29,85,0.341,21,54,0.389,8,31,0.258,14,16,0.875,80
1541,BRK,12/30/2014,96,@,CHI,1,240,36,83,0.434,30,69,0.435,6,14,0.429,18,21,0.857,96,33,86,0.384,25,61,0.41,8,25,0.32,8,15,0.533,82
1542,IND,12/23/2014,96,,NOP,1,240,39,78,0.5,34,63,0.54,5,15,0.333,13,18,0.722,96,33,83,0.398,29,63,0.46,4,20,0.2,14,19,0.737,84
1543,DEN,12/23/2014,96,@,BRK,0,240,36,82,0.439,29,57,0.509,7,25,0.28,17,22,0.773,96,43,91,0.473,37,68,0.544,6,23,0.261,10,14,0.714,102
1544,MIN,12/21/2014,96,,IND,0,240,36,77,0.468,31,66,0.47,5,11,0.455,19,24,0.792,96,42,84,0.5,36,65,0.554,6,19,0.316,10,14,0.714,100
1545,PHI,12/21/2014,96,@,ORL,1,240,35,82,0.427,29,59,0.492,6,23,0.261,20,25,0.8,96,35,84,0.417,28,61,0.459,7,23,0.304,11,20,0.55,88
1546,MIL,12/15/2014,96,@,PHO,1,240,35,73,0.479,27,57,0.474,8,16,0.5,18,22,0.818,96,30,75,0.4,18,37,0.486,12,38,0.316,22,27,0.815,94
1547,DEN,12/13/2014,96,@,HOU,0,240,36,96,0.375,29,68,0.426,7,28,0.25,17,26,0.654,96,39,88,0.443,29,54,0.537,10,34,0.294,20,34,0.588,108
1548,LAC,12/12/2014,96,@,WAS,0,240,32,75,0.427,26,55,0.473,6,20,0.3,26,31,0.839,96,39,80,0.488,30,64,0.469,9,16,0.563,17,21,0.81,104
1549,CHO,12/10/2014,96,,BOS,1,240,35,84,0.417,32,70,0.457,3,14,0.214,23,29,0.793,96,38,87,0.437,33,64,0.516,5,23,0.217,6,10,0.6,87
1550,IND,12/10/2014,96,,LAC,0,240,35,89,0.393,26,62,0.419,9,27,0.333,17,22,0.773,96,42,88,0.477,35,64,0.547,7,24,0.292,12,14,0.857,103
1551,SAS,12/9/2014,96,@,UTA,0,240,39,84,0.464,35,64,0.547,4,20,0.2,14,23,0.609,96,40,80,0.5,36,66,0.545,4,14,0.286,16,22,0.727,100
1552,OKC,12/7/2014,96,@,DET,1,240,39,87,0.448,33,66,0.5,6,21,0.286,12,17,0.706,96,34,76,0.447,27,53,0.509,7,23,0.304,19,28,0.679,94
1553,ATL,12/7/2014,96,,DEN,1,240,36,87,0.414,26,60,0.433,10,27,0.37,14,19,0.737,96,34,93,0.366,28,58,0.483,6,35,0.171,10,13,0.769,84
1554,SAC,12/6/2014,96,,ORL,0,240,35,79,0.443,31,64,0.484,4,15,0.267,22,28,0.786,96,42,83,0.506,33,57,0.579,9,26,0.346,12,14,0.857,105
1555,LAL,12/5/2014,96,@,BOS,0,240,38,92,0.413,32,76,0.421,6,16,0.375,14,19,0.737,96,46,90,0.511,38,70,0.543,8,20,0.4,13,22,0.591,113
1556,MEM,12/3/2014,96,@,HOU,0,240,39,76,0.513,37,63,0.587,2,13,0.154,16,27,0.593,96,41,93,0.441,31,65,0.477,10,28,0.357,13,20,0.65,105
1557,DET,12/2/2014,96,,LAL,0,240,33,90,0.367,27,69,0.391,6,21,0.286,24,31,0.774,96,39,81,0.481,29,64,0.453,10,17,0.588,18,24,0.75,106
1558,UTA,11/29/2014,96,,LAC,0,240,34,75,0.453,27,54,0.5,7,21,0.333,21,33,0.636,96,45,80,0.563,34,52,0.654,11,28,0.393,11,15,0.733,112
1559,ORL,11/26/2014,96,,GSW,0,240,36,87,0.414,30,67,0.448,6,20,0.3,18,24,0.75,96,44,85,0.518,32,59,0.542,12,26,0.462,11,19,0.579,111
1560,PHI,11/21/2014,96,,PHO,0,240,36,78,0.462,32,55,0.582,4,23,0.174,20,33,0.606,96,44,86,0.512,31,55,0.564,13,31,0.419,21,23,0.913,122
1561,TOR,11/19/2014,96,,MEM,1,240,38,83,0.458,29,57,0.509,9,26,0.346,11,13,0.846,96,35,80,0.438,32,70,0.457,3,10,0.3,19,26,0.731,92
1562,DET,11/14/2014,96,@,OKC,1,265,38,89,0.427,27,58,0.466,11,31,0.355,9,15,0.6,96,38,96,0.396,26,60,0.433,12,36,0.333,1,6,0.167,89
1563,ORL,11/9/2014,96,@,BRK,0,240,39,75,0.52,31,60,0.517,8,15,0.533,10,16,0.625,96,40,83,0.482,36,69,0.522,4,14,0.286,20,23,0.87,104
1564,DET,11/9/2014,96,,UTA,0,240,36,93,0.387,30,70,0.429,6,23,0.261,18,25,0.72,96,33,72,0.458,27,57,0.474,6,15,0.4,25,35,0.714,97
1565,DAL,11/9/2014,96,,MIA,0,240,35,83,0.422,26,54,0.481,9,29,0.31,17,24,0.708,96,42,76,0.553,33,53,0.623,9,23,0.391,12,20,0.6,105
1566,NYK,11/8/2014,96,@,ATL,0,240,40,84,0.476,32,63,0.508,8,21,0.381,8,11,0.727,96,33,81,0.407,24,59,0.407,9,22,0.409,28,36,0.778,103
1567,CHO,11/5/2014,96,,MIA,1,240,35,82,0.427,30,64,0.469,5,18,0.278,21,29,0.724,96,30,77,0.39,26,55,0.473,4,22,0.182,25,31,0.806,89
1568,WAS,11/5/2014,96,,IND,1,265,34,91,0.374,27,74,0.365,7,17,0.412,21,23,0.913,96,35,90,0.389,27,63,0.429,8,27,0.296,16,20,0.8,94
1569,NYK,11/2/2014,96,,CHO,1,240,39,78,0.5,31,62,0.5,8,16,0.5,10,17,0.588,96,33,70,0.471,27,55,0.491,6,15,0.4,21,29,0.724,93
1570,PHI,11/1/2014,96,,MIA,0,240,35,67,0.522,28,44,0.636,7,23,0.304,19,26,0.731,96,41,83,0.494,29,59,0.492,12,24,0.5,20,29,0.69,114
1571,MEM,4/15/2015,95,,IND,1,240,36,76,0.474,34,67,0.507,2,9,0.222,21,26,0.808,95,32,78,0.41,24,54,0.444,8,24,0.333,11,15,0.733,83
1572,WAS,4/14/2015,95,@,IND,0,290,37,104,0.356,30,80,0.375,7,24,0.292,14,17,0.824,95,40,105,0.381,31,75,0.413,9,30,0.3,10,17,0.588,99
1573,BOS,4/14/2015,95,,TOR,1,240,38,99,0.384,32,72,0.444,6,27,0.222,13,15,0.867,95,35,80,0.438,26,56,0.464,9,24,0.375,14,20,0.7,93
1574,SAC,4/5/2015,95,,UTA,0,240,38,79,0.481,33,64,0.516,5,15,0.333,14,24,0.583,95,40,87,0.46,32,63,0.508,8,24,0.333,13,18,0.722,101
1575,SAC,4/3/2015,95,,NOP,0,240,37,78,0.474,31,61,0.508,6,17,0.353,15,25,0.6,95,34,87,0.391,20,58,0.345,14,29,0.483,19,28,0.679,101
1576,MIL,4/1/2015,95,,CHI,1,240,37,89,0.416,29,68,0.426,8,21,0.381,13,18,0.722,95,31,74,0.419,26,48,0.542,5,26,0.192,24,37,0.649,91
1577,SAS,3/31/2015,95,@,MIA,1,240,37,74,0.5,29,56,0.518,8,18,0.444,13,17,0.765,95,32,79,0.405,27,64,0.422,5,15,0.333,12,12,1,81
1578,ATL,3/31/2015,95,@,DET,0,240,40,84,0.476,32,59,0.542,8,25,0.32,7,10,0.7,95,41,83,0.494,30,54,0.556,11,29,0.379,12,17,0.706,105
1579,MIL,3/28/2015,95,,GSW,0,240,33,87,0.379,31,72,0.431,2,15,0.133,27,32,0.844,95,42,82,0.512,30,57,0.526,12,25,0.48,12,14,0.857,108
1580,ATL,3/25/2015,95,@,ORL,1,240,39,90,0.433,29,59,0.492,10,31,0.323,7,10,0.7,95,32,78,0.41,29,62,0.468,3,16,0.188,16,20,0.8,83
1581,HOU,3/25/2015,95,@,NOP,1,240,40,81,0.494,34,59,0.576,6,22,0.273,9,12,0.75,95,34,75,0.453,29,60,0.483,5,15,0.333,20,32,0.625,93
1582,ATL,3/22/2015,95,,SAS,0,240,38,80,0.475,26,56,0.464,12,24,0.5,7,7,1,95,46,82,0.561,39,65,0.6,7,17,0.412,15,17,0.882,114
1583,CLE,3/20/2015,95,,IND,1,240,35,82,0.427,26,56,0.464,9,26,0.346,16,21,0.762,95,36,84,0.429,28,64,0.438,8,20,0.4,12,13,0.923,92
1584,MIN,3/19/2015,95,@,NYK,1,265,34,83,0.41,32,71,0.451,2,12,0.167,25,30,0.833,95,40,97,0.412,36,77,0.468,4,20,0.2,8,10,0.8,92
1585,ATL,3/18/2015,95,@,GSW,0,240,31,87,0.356,23,65,0.354,8,22,0.364,25,30,0.833,95,44,84,0.524,30,54,0.556,14,30,0.467,12,20,0.6,114
1586,MEM,3/17/2015,95,@,DET,0,240,35,80,0.438,25,62,0.403,10,18,0.556,15,17,0.882,95,39,83,0.47,27,50,0.54,12,33,0.364,15,22,0.682,105
1587,BOS,3/13/2015,95,,ORL,1,240,37,86,0.43,27,60,0.45,10,26,0.385,11,20,0.55,95,34,80,0.425,28,60,0.467,6,20,0.3,14,28,0.5,88
1588,PHI,3/11/2015,95,,CHI,0,265,36,104,0.346,25,63,0.397,11,41,0.268,12,25,0.48,95,40,87,0.46,30,63,0.476,10,24,0.417,14,20,0.7,104
1589,BOS,3/11/2015,95,,MEM,1,240,37,85,0.435,29,58,0.5,8,27,0.296,13,17,0.765,95,37,78,0.474,32,66,0.485,5,12,0.417,13,13,1,92
1590,WAS,3/9/2015,95,@,CHO,1,240,44,85,0.518,42,71,0.592,2,14,0.143,5,5,1,95,25,77,0.325,21,55,0.382,4,22,0.182,15,20,0.75,69
1591,UTA,3/8/2015,95,@,BRK,1,240,34,72,0.472,24,50,0.48,10,22,0.455,17,21,0.81,95,38,76,0.5,30,61,0.492,8,15,0.533,4,11,0.364,88
1592,NOP,3/7/2015,95,,MEM,1,240,38,80,0.475,30,57,0.526,8,23,0.348,11,13,0.846,95,32,74,0.432,26,58,0.448,6,16,0.375,19,29,0.655,89
1593,MIL,3/3/2015,95,@,DEN,0,240,35,86,0.407,25,62,0.403,10,24,0.417,15,22,0.682,95,39,86,0.453,27,52,0.519,12,34,0.353,16,20,0.8,106
1594,DET,2/28/2015,95,@,WAS,0,240,38,79,0.481,30,53,0.566,8,26,0.308,11,21,0.524,95,37,78,0.474,30,58,0.517,7,20,0.35,18,25,0.72,99
1595,ATL,2/27/2015,95,,ORL,1,240,36,81,0.444,22,50,0.44,14,31,0.452,9,12,0.75,95,36,80,0.45,27,54,0.5,9,26,0.346,7,13,0.538,88
1596,SAS,2/25/2015,95,@,POR,0,240,37,85,0.435,29,64,0.453,8,21,0.381,13,14,0.929,95,43,85,0.506,30,59,0.508,13,26,0.5,12,15,0.8,111
1597,ORL,2/20/2015,95,,NOP,1,240,44,88,0.5,40,70,0.571,4,18,0.222,3,6,0.5,95,29,69,0.42,24,50,0.48,5,19,0.263,21,28,0.75,84
1598,PHI,2/20/2015,95,,IND,0,240,34,84,0.405,26,59,0.441,8,25,0.32,19,29,0.655,95,40,83,0.482,32,61,0.525,8,22,0.364,18,22,0.818,106
1599,TOR,2/11/2015,95,,WAS,1,240,31,76,0.408,20,50,0.4,11,26,0.423,22,26,0.846,95,39,85,0.459,34,64,0.531,5,21,0.238,10,16,0.625,93
1600,HOU,2/11/2015,95,@,LAC,0,240,34,87,0.391,25,42,0.595,9,45,0.2,18,22,0.818,95,39,81,0.481,35,59,0.593,4,22,0.182,28,45,0.622,110
1601,MEM,2/10/2015,95,,BRK,1,240,36,81,0.444,30,62,0.484,6,19,0.316,17,25,0.68,95,35,81,0.432,32,69,0.464,3,12,0.25,13,17,0.765,86
1602,SAS,2/9/2015,95,@,IND,1,240,37,89,0.416,31,64,0.484,6,25,0.24,15,17,0.882,95,36,88,0.409,28,67,0.418,8,21,0.381,13,13,1,93
1603,NYK,2/9/2015,95,@,MIA,0,240,36,84,0.429,29,64,0.453,7,20,0.35,16,19,0.842,95,36,74,0.486,24,52,0.462,12,22,0.545,25,29,0.862,109
1604,MIL,1/31/2015,95,,POR,1,240,37,82,0.451,29,61,0.475,8,21,0.381,13,14,0.929,95,33,89,0.371,24,58,0.414,9,31,0.29,13,18,0.722,88
1605,SAS,1/28/2015,95,,CHO,1,240,35,83,0.422,25,54,0.463,10,29,0.345,15,18,0.833,95,34,83,0.41,28,65,0.431,6,18,0.333,12,14,0.857,86
1606,DET,1/27/2015,95,,CLE,0,240,35,83,0.422,27,59,0.458,8,24,0.333,17,23,0.739,95,39,93,0.419,30,59,0.508,9,34,0.265,16,17,0.941,103
1607,MIL,1/25/2015,95,@,SAS,0,240,39,82,0.476,31,65,0.477,8,17,0.471,9,13,0.692,95,35,83,0.422,30,61,0.492,5,22,0.227,26,30,0.867,101
1608,MEM,1/19/2015,95,,DAL,0,240,36,85,0.424,33,63,0.524,3,22,0.136,20,22,0.909,95,34,76,0.447,24,51,0.471,10,25,0.4,25,33,0.758,103
1609,NOP,1/18/2015,95,@,TOR,1,240,39,82,0.476,34,65,0.523,5,17,0.294,12,20,0.6,95,31,72,0.431,24,47,0.511,7,25,0.28,24,29,0.828,93
1610,MIA,1/16/2015,95,@,SAC,1,240,35,74,0.473,27,57,0.474,8,17,0.471,17,21,0.81,95,32,75,0.427,25,59,0.424,7,16,0.438,12,14,0.857,83
1611,MIL,1/15/2015,95,,NYK,1,240,28,72,0.389,20,54,0.37,8,18,0.444,31,42,0.738,95,28,68,0.412,20,46,0.435,8,22,0.364,15,20,0.75,79
1612,CHI,1/10/2015,95,,MIL,1,240,35,88,0.398,31,71,0.437,4,17,0.235,21,24,0.875,95,36,81,0.444,33,70,0.471,3,11,0.273,12,16,0.75,87
1613,MEM,1/9/2015,95,@,NOP,0,240,36,82,0.439,30,65,0.462,6,17,0.353,17,22,0.773,95,37,81,0.457,27,61,0.443,10,20,0.5,22,26,0.846,106
1614,PHO,1/9/2015,95,@,SAS,0,240,37,83,0.446,30,57,0.526,7,26,0.269,14,21,0.667,95,38,89,0.427,27,66,0.409,11,23,0.478,13,18,0.722,100
1615,TOR,1/8/2015,95,,CHO,0,240,33,83,0.398,23,52,0.442,10,31,0.323,19,25,0.76,95,42,88,0.477,38,72,0.528,4,16,0.25,15,22,0.682,103
1616,DAL,1/7/2015,95,,DET,0,240,38,87,0.437,32,65,0.492,6,22,0.273,13,18,0.722,95,43,97,0.443,33,76,0.434,10,21,0.476,12,14,0.857,108
1617,BOS,1/5/2015,95,,CHO,0,240,36,91,0.396,29,73,0.397,7,18,0.389,16,23,0.696,95,38,78,0.487,32,59,0.542,6,19,0.316,22,23,0.957,104
1618,PHI,1/5/2015,95,,CLE,1,240,38,79,0.481,31,56,0.554,7,23,0.304,12,15,0.8,95,33,85,0.388,22,55,0.4,11,30,0.367,15,22,0.682,92
1619,MIL,1/4/2015,95,@,NYK,1,240,35,77,0.455,31,61,0.508,4,16,0.25,21,27,0.778,95,31,76,0.408,22,51,0.431,9,25,0.36,11,14,0.786,82
1620,SAC,1/4/2015,95,@,DET,0,240,32,75,0.427,29,60,0.483,3,15,0.2,28,36,0.778,95,45,91,0.495,33,60,0.55,12,31,0.387,12,16,0.75,114
1621,MIA,12/31/2014,95,@,IND,0,240,38,77,0.494,33,61,0.541,5,16,0.313,14,18,0.778,95,35,79,0.443,25,61,0.41,10,18,0.556,26,30,0.867,106
1622,SAS,12/31/2014,95,,NOP,1,265,39,89,0.438,33,65,0.508,6,24,0.25,11,18,0.611,95,34,89,0.382,26,61,0.426,8,28,0.286,17,20,0.85,93
1623,MEM,12/30/2014,95,,SAS,1,240,35,72,0.486,28,57,0.491,7,15,0.467,18,22,0.818,95,35,78,0.449,30,56,0.536,5,22,0.227,12,17,0.706,87
1624,MIA,12/27/2014,95,,MEM,0,240,37,72,0.514,31,52,0.596,6,20,0.3,15,21,0.714,95,34,73,0.466,27,57,0.474,7,16,0.438,28,37,0.757,103
1625,BOS,12/23/2014,95,@,ORL,0,240,33,85,0.388,26,62,0.419,7,23,0.304,22,29,0.759,95,39,83,0.47,32,65,0.492,7,18,0.389,15,23,0.652,100
1626,POR,12/22/2014,95,@,HOU,0,240,34,76,0.447,24,49,0.49,10,27,0.37,17,18,0.944,95,41,87,0.471,28,51,0.549,13,36,0.361,15,20,0.75,110
1627,CLE,12/19/2014,95,,BRK,1,240,31,77,0.403,22,53,0.415,9,24,0.375,24,29,0.828,95,37,78,0.474,28,54,0.519,9,24,0.375,8,12,0.667,91
1628,MIN,12/16/2014,95,@,WAS,0,240,36,81,0.444,33,73,0.452,3,8,0.375,20,35,0.571,95,43,86,0.5,33,69,0.478,10,17,0.588,13,18,0.722,109
1629,MIA,12/16/2014,95,@,BRK,1,240,33,72,0.458,24,48,0.5,9,24,0.375,20,26,0.769,95,30,77,0.39,22,49,0.449,8,28,0.286,23,32,0.719,91
1630,SAS,12/15/2014,95,@,POR,0,240,38,78,0.487,34,67,0.507,4,11,0.364,15,22,0.682,95,41,89,0.461,34,71,0.479,7,18,0.389,19,22,0.864,108
1631,TOR,12/15/2014,95,,ORL,1,240,37,83,0.446,26,53,0.491,11,30,0.367,10,15,0.667,95,36,74,0.486,32,59,0.542,4,15,0.267,6,8,0.75,82
1632,TOR,12/14/2014,95,@,NYK,1,265,36,78,0.462,27,54,0.5,9,24,0.375,14,18,0.778,95,29,78,0.372,20,49,0.408,9,29,0.31,23,28,0.821,90
1633,POR,12/13/2014,95,@,IND,1,240,40,90,0.444,35,73,0.479,5,17,0.294,10,12,0.833,95,34,88,0.386,30,73,0.411,4,15,0.267,13,16,0.813,85
1634,DET,12/13/2014,95,@,SAC,1,240,35,79,0.443,29,59,0.492,6,20,0.3,19,23,0.826,95,33,93,0.355,22,64,0.344,11,29,0.379,13,19,0.684,90
1635,BOS,12/12/2014,95,,NYK,0,240,37,85,0.435,30,63,0.476,7,22,0.318,14,18,0.778,95,40,81,0.494,34,65,0.523,6,16,0.375,15,18,0.833,101
1636,UTA,12/12/2014,95,,MIA,0,240,34,77,0.442,26,49,0.531,8,28,0.286,19,22,0.864,95,36,72,0.5,29,52,0.558,7,20,0.35,21,31,0.677,100
1637,ATL,12/10/2014,95,,PHI,1,240,38,91,0.418,28,61,0.459,10,30,0.333,9,13,0.692,95,30,72,0.417,24,47,0.511,6,25,0.24,13,22,0.591,79
1638,NYK,12/10/2014,95,@,SAS,0,240,37,76,0.487,31,61,0.508,6,15,0.4,15,17,0.882,95,37,73,0.507,27,54,0.5,10,19,0.526,25,30,0.833,109
1639,SAC,12/9/2014,95,@,LAL,0,240,32,70,0.457,25,55,0.455,7,15,0.467,24,37,0.649,95,38,96,0.396,33,71,0.465,5,25,0.2,17,25,0.68,98
1640,PHO,12/6/2014,95,@,HOU,0,240,34,93,0.366,27,65,0.415,7,28,0.25,20,26,0.769,95,33,81,0.407,22,54,0.407,11,27,0.407,23,31,0.742,100
1641,LAL,12/3/2014,95,@,WAS,0,240,33,85,0.388,21,56,0.375,12,29,0.414,17,21,0.81,95,45,93,0.484,39,74,0.527,6,19,0.316,15,19,0.789,111
1642,CHO,12/3/2014,95,,CHI,0,240,36,90,0.4,34,75,0.453,2,15,0.133,21,23,0.913,95,37,80,0.463,25,52,0.481,12,28,0.429,16,21,0.762,102
1643,BRK,12/3/2014,95,,SAS,1,265,37,90,0.411,28,71,0.394,9,19,0.474,12,18,0.667,95,36,101,0.356,24,69,0.348,12,32,0.375,9,12,0.75,93
1644,UTA,11/24/2014,95,,CHI,0,240,42,86,0.488,39,77,0.506,3,9,0.333,8,10,0.8,95,36,72,0.5,27,52,0.519,9,20,0.45,16,23,0.696,97
1645,HOU,11/22/2014,95,,DAL,1,240,30,82,0.366,15,36,0.417,15,46,0.326,20,23,0.87,95,35,88,0.398,29,53,0.547,6,35,0.171,16,22,0.727,92
1646,MIA,11/17/2014,95,@,BRK,1,240,31,72,0.431,22,45,0.489,9,27,0.333,24,27,0.889,95,29,70,0.414,20,47,0.426,9,23,0.391,16,26,0.615,83
1647,MEM,11/15/2014,95,,DET,1,240,32,86,0.372,28,71,0.394,4,15,0.267,27,33,0.818,95,34,82,0.415,24,56,0.429,10,26,0.385,10,17,0.588,88
1648,PHO,11/14/2014,95,,CHO,0,240,37,86,0.43,29,57,0.509,8,29,0.276,13,14,0.929,95,39,91,0.429,32,75,0.427,7,16,0.438,18,19,0.947,103
1649,NYK,11/12/2014,95,,ORL,0,240,37,86,0.43,29,63,0.46,8,23,0.348,13,14,0.929,95,33,70,0.471,27,58,0.466,6,12,0.5,25,32,0.781,97
1650,GSW,11/9/2014,95,@,PHO,0,240,33,69,0.478,22,45,0.489,11,24,0.458,18,21,0.857,95,34,79,0.43,22,49,0.449,12,30,0.4,27,33,0.818,107
1651,MIL,11/7/2014,95,@,DET,0,240,36,77,0.468,31,57,0.544,5,20,0.25,18,23,0.783,95,37,75,0.493,26,52,0.5,11,23,0.478,13,24,0.542,98
1652,NYK,11/5/2014,95,@,DET,0,240,39,90,0.433,30,70,0.429,9,20,0.45,8,10,0.8,95,32,87,0.368,21,64,0.328,11,23,0.478,23,33,0.697,98
1653,CHI,11/5/2014,95,@,MIL,1,240,34,73,0.466,29,57,0.509,5,16,0.313,22,30,0.733,95,33,89,0.371,30,74,0.405,3,15,0.2,17,20,0.85,86
1654,GSW,11/2/2014,95,@,POR,1,240,36,81,0.444,30,62,0.484,6,19,0.316,17,21,0.81,95,37,92,0.402,30,65,0.462,7,27,0.259,9,14,0.643,90
1655,ORL,11/1/2014,95,,TOR,0,240,38,81,0.469,31,61,0.508,7,20,0.35,12,24,0.5,95,33,83,0.398,29,62,0.468,4,21,0.19,38,48,0.792,108
1656,NYK,10/30/2014,95,@,CLE,1,240,37,69,0.536,31,57,0.544,6,12,0.5,15,18,0.833,95,32,70,0.457,23,46,0.5,9,24,0.375,17,20,0.85,90
1657,GSW,10/29/2014,95,@,SAC,1,240,33,75,0.44,27,48,0.563,6,27,0.222,23,32,0.719,95,24,78,0.308,21,60,0.35,3,18,0.167,26,35,0.743,77
1658,WAS,10/29/2014,95,@,MIA,0,240,36,75,0.48,30,56,0.536,6,19,0.316,17,24,0.708,95,39,81,0.481,30,53,0.566,9,28,0.321,20,23,0.87,107
1659,LAC,4/11/2015,94,,MEM,1,240,35,88,0.398,29,61,0.475,6,27,0.222,18,22,0.818,94,34,77,0.442,32,68,0.471,2,9,0.222,16,24,0.667,86
1660,CHI,4/5/2015,94,@,CLE,0,240,34,76,0.447,23,49,0.469,11,27,0.407,15,21,0.714,94,35,83,0.422,19,46,0.413,16,37,0.432,13,22,0.591,99
1661,UTA,3/28/2015,94,,OKC,1,240,32,84,0.381,26,55,0.473,6,29,0.207,24,35,0.686,94,31,73,0.425,25,57,0.439,6,16,0.375,21,32,0.656,89
1662,TOR,3/27/2015,94,,LAL,1,240,36,75,0.48,29,57,0.509,7,18,0.389,15,21,0.714,94,29,84,0.345,25,67,0.373,4,17,0.235,21,29,0.724,83
1663,SAS,3/27/2015,94,,DAL,1,240,37,84,0.44,28,58,0.483,9,26,0.346,11,14,0.786,94,31,82,0.378,27,64,0.422,4,18,0.222,10,15,0.667,76
1664,SAS,3/24/2015,94,@,DAL,0,240,36,85,0.424,28,57,0.491,8,28,0.286,14,18,0.778,94,42,87,0.483,35,65,0.538,7,22,0.318,10,13,0.769,101
1665,PHI,3/18/2015,94,,DET,1,240,36,84,0.429,25,57,0.439,11,27,0.407,11,18,0.611,94,29,88,0.33,21,62,0.339,8,26,0.308,17,19,0.895,83
1666,ORL,3/17/2015,94,@,HOU,0,240,38,89,0.427,32,67,0.478,6,22,0.273,12,17,0.706,94,39,78,0.5,28,51,0.549,11,27,0.407,18,27,0.667,107
1667,UTA,3/16/2015,94,,CHO,1,240,33,78,0.423,18,54,0.333,15,24,0.625,13,19,0.684,94,23,78,0.295,18,59,0.305,5,19,0.263,15,18,0.833,66
1668,NYK,3/14/2015,94,@,GSW,0,240,38,96,0.396,29,71,0.408,9,25,0.36,9,16,0.563,94,45,90,0.5,26,56,0.464,19,34,0.559,16,17,0.941,125
1669,BRK,3/14/2015,94,@,PHI,1,240,37,84,0.44,35,67,0.522,2,17,0.118,18,26,0.692,94,35,94,0.372,27,57,0.474,8,37,0.216,9,14,0.643,87
1670,LAL,3/12/2015,94,,NYK,0,240,38,90,0.422,33,72,0.458,5,18,0.278,13,21,0.619,94,36,77,0.468,27,59,0.458,9,18,0.5,20,26,0.769,101
1671,DAL,3/10/2015,94,,CLE,0,240,33,81,0.407,28,61,0.459,5,20,0.25,23,33,0.697,94,44,87,0.506,29,55,0.527,15,32,0.469,24,29,0.828,127
1672,TOR,3/6/2015,94,@,CHO,0,240,37,91,0.407,30,69,0.435,7,22,0.318,13,15,0.867,94,40,85,0.471,35,65,0.538,5,20,0.25,18,20,0.9,103
1673,POR,3/5/2015,94,,DAL,1,240,34,82,0.415,27,60,0.45,7,22,0.318,19,21,0.905,94,33,88,0.375,31,72,0.431,2,16,0.125,7,8,0.875,75
1674,LAL,3/4/2015,94,@,MIA,0,240,38,88,0.432,31,70,0.443,7,18,0.389,11,17,0.647,94,32,79,0.405,29,63,0.46,3,16,0.188,33,43,0.767,100
1675,IND,3/1/2015,94,,PHI,1,240,36,88,0.409,33,70,0.471,3,18,0.167,19,25,0.76,94,29,84,0.345,24,60,0.4,5,24,0.208,11,17,0.647,74
1676,DAL,2/28/2015,94,,BRK,0,240,35,82,0.427,26,54,0.481,9,28,0.321,15,18,0.833,94,40,77,0.519,30,54,0.556,10,23,0.435,14,23,0.609,104
1677,NYK,2/25/2015,94,@,BOS,0,240,34,82,0.415,32,61,0.525,2,21,0.095,24,31,0.774,94,42,83,0.506,28,52,0.538,14,31,0.452,17,20,0.85,115
1678,DEN,2/22/2015,94,@,OKC,0,240,35,97,0.361,28,70,0.4,7,27,0.259,17,20,0.85,94,48,92,0.522,40,72,0.556,8,20,0.4,15,23,0.652,119
1679,GSW,2/11/2015,94,@,MIN,1,240,40,90,0.444,33,63,0.524,7,27,0.259,7,9,0.778,94,33,86,0.384,28,72,0.389,5,14,0.357,20,27,0.741,91
1680,MEM,2/8/2015,94,,ATL,1,240,36,92,0.391,33,79,0.418,3,13,0.231,19,21,0.905,94,33,80,0.413,21,50,0.42,12,30,0.4,10,11,0.909,88
1681,CHO,2/5/2015,94,,WAS,1,240,33,76,0.434,27,51,0.529,6,25,0.24,22,27,0.815,94,35,84,0.417,30,74,0.405,5,10,0.5,12,17,0.706,87
1682,LAC,2/5/2015,94,@,CLE,0,240,38,91,0.418,33,69,0.478,5,22,0.227,13,20,0.65,94,31,72,0.431,23,42,0.548,8,30,0.267,35,44,0.795,105
1683,MIN,2/2/2015,94,@,DAL,0,240,34,82,0.415,31,69,0.449,3,13,0.231,23,26,0.885,94,39,84,0.464,29,53,0.547,10,31,0.323,12,18,0.667,100
1684,IND,1/31/2015,94,,SAC,0,240,33,80,0.413,28,55,0.509,5,25,0.2,23,25,0.92,94,34,80,0.425,29,65,0.446,5,15,0.333,26,29,0.897,99
1685,MIN,1/30/2015,94,@,PHI,0,240,34,76,0.447,29,62,0.468,5,14,0.357,21,25,0.84,94,37,74,0.5,29,51,0.569,8,23,0.348,21,25,0.84,103
1686,LAC,1/28/2015,94,@,UTA,1,240,34,76,0.447,25,50,0.5,9,26,0.346,17,25,0.68,94,35,81,0.432,30,57,0.526,5,24,0.208,14,20,0.7,89
1687,POR,1/28/2015,94,@,CLE,0,240,35,80,0.438,25,49,0.51,10,31,0.323,14,17,0.824,94,34,85,0.4,19,48,0.396,15,37,0.405,16,18,0.889,99
1688,DAL,1/28/2015,94,@,HOU,0,240,35,82,0.427,25,57,0.439,10,25,0.4,14,16,0.875,94,36,88,0.409,22,53,0.415,14,35,0.4,13,15,0.867,99
1689,ORL,1/26/2015,94,@,MEM,0,240,37,78,0.474,33,66,0.5,4,12,0.333,16,25,0.64,94,36,76,0.474,29,58,0.5,7,18,0.389,24,26,0.923,103
1690,OKC,1/20/2015,94,@,MIA,1,240,41,92,0.446,35,66,0.53,6,26,0.231,6,10,0.6,94,32,68,0.471,24,46,0.522,8,22,0.364,14,19,0.737,86
1691,SAC,1/19/2015,94,@,POR,0,240,34,76,0.447,30,64,0.469,4,12,0.333,22,30,0.733,94,35,88,0.398,24,52,0.462,11,36,0.306,17,26,0.654,98
1692,CHI,1/19/2015,94,@,CLE,0,240,30,80,0.375,22,64,0.344,8,16,0.5,26,32,0.813,94,41,90,0.456,33,72,0.458,8,18,0.444,18,25,0.72,108
1693,UTA,1/16/2015,94,,LAL,1,240,36,85,0.424,24,54,0.444,12,31,0.387,10,10,1,94,31,65,0.477,28,58,0.483,3,7,0.429,20,27,0.741,85
1694,POR,1/14/2015,94,,LAC,0,240,35,87,0.402,29,61,0.475,6,26,0.231,18,20,0.9,94,37,88,0.42,29,65,0.446,8,23,0.348,18,19,0.947,100
1695,DET,1/14/2015,94,,NOP,0,240,34,73,0.466,26,51,0.51,8,22,0.364,18,23,0.783,94,39,80,0.488,31,59,0.525,8,21,0.381,19,23,0.826,105
1696,LAL,1/11/2015,94,,POR,0,240,36,81,0.444,29,59,0.492,7,22,0.318,15,19,0.789,94,41,86,0.477,28,55,0.509,13,31,0.419,11,17,0.647,106
1697,CLE,1/9/2015,94,@,GSW,0,240,35,86,0.407,28,63,0.444,7,23,0.304,17,23,0.739,94,43,86,0.5,33,56,0.589,10,30,0.333,16,17,0.941,112
1698,UTA,1/9/2015,94,@,OKC,0,240,36,74,0.486,29,53,0.547,7,21,0.333,15,22,0.682,94,42,91,0.462,35,70,0.5,7,21,0.333,8,9,0.889,99
1699,NOP,1/7/2015,94,@,CHO,0,240,36,80,0.45,30,62,0.484,6,18,0.333,16,24,0.667,94,37,86,0.43,33,72,0.458,4,14,0.286,20,26,0.769,98
1700,LAL,1/5/2015,94,@,POR,0,240,37,88,0.42,33,74,0.446,4,14,0.286,16,20,0.8,94,33,83,0.398,22,57,0.386,11,26,0.423,21,24,0.875,98
1701,IND,1/2/2015,94,@,MIL,1,240,35,81,0.432,27,61,0.443,8,20,0.4,16,20,0.8,94,38,89,0.427,31,65,0.477,7,24,0.292,8,10,0.8,91
1702,MIN,12/30/2014,94,@,UTA,0,240,38,82,0.463,30,65,0.462,8,17,0.471,10,14,0.714,94,38,79,0.481,31,60,0.517,7,19,0.368,17,22,0.773,100
1703,CHO,12/29/2014,94,,MIL,0,265,33,90,0.367,26,65,0.4,7,25,0.28,21,26,0.808,94,40,85,0.471,34,64,0.531,6,21,0.286,18,21,0.857,104
1704,CHO,12/27/2014,94,,ORL,0,240,36,86,0.419,28,62,0.452,8,24,0.333,14,18,0.778,94,38,83,0.458,30,63,0.476,8,20,0.4,18,24,0.75,102
1705,ORL,12/19/2014,94,,UTA,0,240,37,83,0.446,25,61,0.41,12,22,0.545,8,12,0.667,94,39,73,0.534,35,62,0.565,4,11,0.364,19,24,0.792,101
1706,PHO,12/15/2014,94,,MIL,0,240,30,75,0.4,18,37,0.486,12,38,0.316,22,27,0.815,94,35,73,0.479,27,57,0.474,8,16,0.5,18,22,0.818,96
1707,MIN,12/14/2014,94,,LAL,0,240,38,90,0.422,35,80,0.438,3,10,0.3,15,20,0.75,94,34,81,0.42,29,64,0.453,5,17,0.294,27,34,0.794,100
1708,IND,12/12/2014,94,@,TOR,0,240,33,80,0.413,25,58,0.431,8,22,0.364,20,23,0.87,94,38,91,0.418,28,65,0.431,10,26,0.385,20,22,0.909,106
1709,CLE,12/11/2014,94,@,OKC,0,240,31,85,0.365,22,57,0.386,9,28,0.321,23,30,0.767,94,38,87,0.437,31,61,0.508,7,26,0.269,20,22,0.909,103
1710,DET,12/7/2014,94,,OKC,0,240,34,76,0.447,27,53,0.509,7,23,0.304,19,28,0.679,94,39,87,0.448,33,66,0.5,6,21,0.286,12,17,0.706,96
1711,LAL,11/23/2014,94,,DEN,0,265,33,89,0.371,30,65,0.462,3,24,0.125,25,34,0.735,94,34,90,0.378,24,53,0.453,10,37,0.27,23,38,0.605,101
1712,MIA,11/23/2014,94,,CHO,1,240,33,66,0.5,22,43,0.512,11,23,0.478,17,19,0.895,94,37,79,0.468,30,58,0.517,7,21,0.333,12,16,0.75,93
1713,POR,11/23/2014,94,@,BOS,1,240,37,86,0.43,30,67,0.448,7,19,0.368,13,15,0.867,94,37,95,0.389,32,72,0.444,5,23,0.217,9,12,0.75,88
1714,UTA,11/22/2014,94,,NOP,0,240,33,71,0.465,28,57,0.491,5,14,0.357,23,29,0.793,94,42,93,0.452,38,76,0.5,4,17,0.235,18,22,0.818,106
1715,BRK,11/21/2014,94,@,OKC,1,240,31,67,0.463,26,52,0.5,5,15,0.333,27,30,0.9,94,38,85,0.447,34,65,0.523,4,20,0.2,12,19,0.632,92
1716,ATL,11/15/2014,94,@,CLE,0,240,40,90,0.444,37,68,0.544,3,22,0.136,11,13,0.846,94,49,90,0.544,30,59,0.508,19,31,0.613,10,13,0.769,127
1717,SAC,11/15/2014,94,,SAS,1,240,37,86,0.43,37,74,0.5,0,12,0,20,24,0.833,94,34,80,0.425,27,56,0.482,7,24,0.292,16,18,0.889,91
1718,BOS,11/12/2014,94,,OKC,0,240,37,83,0.446,28,50,0.56,9,33,0.273,11,13,0.846,94,40,82,0.488,30,58,0.517,10,24,0.417,19,22,0.864,109
1719,IND,11/5/2014,94,@,WAS,0,265,35,90,0.389,27,63,0.429,8,27,0.296,16,20,0.8,94,34,91,0.374,27,74,0.365,7,17,0.412,21,23,0.913,96
1720,SAS,11/5/2014,94,,ATL,1,240,31,69,0.449,26,52,0.5,5,17,0.294,27,38,0.711,94,38,92,0.413,30,67,0.448,8,25,0.32,8,11,0.727,92
1721,PHO,10/31/2014,94,,SAS,1,240,35,87,0.402,33,69,0.478,2,18,0.111,22,26,0.846,94,32,78,0.41,24,53,0.453,8,25,0.32,17,23,0.739,89
1722,POR,10/31/2014,94,@,SAC,0,240,34,83,0.41,25,57,0.439,9,26,0.346,17,19,0.895,94,34,81,0.42,30,71,0.423,4,10,0.4,31,35,0.886,103
1723,TOR,4/14/2015,93,@,BOS,0,240,35,80,0.438,26,56,0.464,9,24,0.375,14,20,0.7,93,38,99,0.384,32,72,0.444,6,27,0.222,13,15,0.867,95
1724,ORL,4/13/2015,93,@,MIA,0,240,35,85,0.412,29,64,0.453,6,21,0.286,17,28,0.607,93,39,83,0.47,36,73,0.493,3,10,0.3,19,23,0.826,100
1725,DEN,4/3/2015,93,@,SAS,0,240,40,87,0.46,34,70,0.486,6,17,0.353,7,11,0.636,93,47,85,0.553,33,51,0.647,14,34,0.412,15,17,0.882,123
1726,IND,4/3/2015,93,,CHO,1,240,36,83,0.434,28,67,0.418,8,16,0.5,13,18,0.722,93,28,80,0.35,24,62,0.387,4,18,0.222,14,20,0.7,74
1727,PHI,4/1/2015,93,@,WAS,0,240,36,91,0.396,26,57,0.456,10,34,0.294,11,17,0.647,93,44,76,0.579,40,64,0.625,4,12,0.333,14,22,0.636,106
1728,NOP,3/25/2015,93,,HOU,0,240,34,75,0.453,29,60,0.483,5,15,0.333,20,32,0.625,93,40,81,0.494,34,59,0.576,6,22,0.273,9,12,0.75,95
1729,MIA,3/25/2015,93,@,BOS,1,240,34,77,0.442,25,53,0.472,9,24,0.375,16,23,0.696,93,28,69,0.406,23,50,0.46,5,19,0.263,25,37,0.676,86
1730,OKC,3/22/2015,93,,MIA,1,240,40,90,0.444,34,72,0.472,6,18,0.333,7,13,0.538,93,32,81,0.395,29,63,0.46,3,18,0.167,8,15,0.533,75
1731,BOS,3/14/2015,93,@,IND,1,240,35,83,0.422,27,55,0.491,8,28,0.286,15,21,0.714,93,34,85,0.4,25,61,0.41,9,24,0.375,12,15,0.8,89
1732,LAL,3/10/2015,93,,DET,1,240,32,75,0.427,29,62,0.468,3,13,0.231,26,30,0.867,93,32,84,0.381,24,49,0.49,8,35,0.229,13,19,0.684,85
1733,LAL,3/8/2015,93,,DAL,0,240,38,82,0.463,36,68,0.529,2,14,0.143,15,21,0.714,93,38,78,0.487,29,52,0.558,9,26,0.346,15,22,0.682,100
1734,DET,3/6/2015,93,@,HOU,0,240,37,102,0.363,31,73,0.425,6,29,0.207,13,17,0.765,93,38,91,0.418,32,63,0.508,6,28,0.214,21,25,0.84,103
1735,LAC,3/4/2015,93,,POR,0,265,37,96,0.385,26,65,0.4,11,31,0.355,8,18,0.444,93,34,87,0.391,26,55,0.473,8,32,0.25,22,29,0.759,98
1736,MIL,3/4/2015,93,@,GSW,0,240,34,80,0.425,29,66,0.439,5,14,0.357,20,25,0.8,93,37,73,0.507,23,39,0.59,14,34,0.412,14,25,0.56,102
1737,UTA,3/3/2015,93,@,MEM,1,240,36,80,0.45,31,55,0.564,5,25,0.2,16,19,0.842,93,33,82,0.402,30,71,0.423,3,11,0.273,13,19,0.684,82
1738,NOP,3/2/2015,93,@,DAL,0,240,35,74,0.473,25,53,0.472,10,21,0.476,13,16,0.813,93,38,79,0.481,32,63,0.508,6,16,0.375,20,22,0.909,102
1739,ATL,2/28/2015,93,@,MIA,1,240,34,79,0.43,24,54,0.444,10,25,0.4,15,20,0.75,93,32,81,0.395,25,55,0.455,7,26,0.269,20,21,0.952,91
1740,IND,2/27/2015,93,,CLE,1,240,34,80,0.425,28,63,0.444,6,17,0.353,19,29,0.655,93,33,92,0.359,24,63,0.381,9,29,0.31,11,14,0.786,86
1741,MIL,2/27/2015,93,@,LAL,0,240,34,87,0.391,30,70,0.429,4,17,0.235,21,29,0.724,93,40,85,0.471,34,67,0.507,6,18,0.333,15,22,0.682,101
1742,MIA,2/25/2015,93,@,ORL,1,265,32,84,0.381,26,53,0.491,6,31,0.194,23,32,0.719,93,33,78,0.423,27,56,0.482,6,22,0.273,18,31,0.581,90
1743,DET,2/24/2015,93,,CLE,0,240,33,82,0.402,24,58,0.414,9,24,0.375,18,30,0.6,93,34,77,0.442,20,40,0.5,14,37,0.378,20,24,0.833,102
1744,MIA,2/11/2015,93,@,CLE,0,240,34,84,0.405,25,60,0.417,9,24,0.375,16,20,0.8,93,44,78,0.564,34,53,0.642,10,25,0.4,15,19,0.789,113
1745,WAS,2/11/2015,93,@,TOR,0,240,39,85,0.459,34,64,0.531,5,21,0.238,10,16,0.625,93,31,76,0.408,20,50,0.4,11,26,0.423,22,26,0.846,95
1746,NOP,2/11/2015,93,,IND,0,240,34,74,0.459,27,59,0.458,7,15,0.467,18,25,0.72,93,40,75,0.533,31,55,0.564,9,20,0.45,17,18,0.944,106
1747,IND,2/9/2015,93,,SAS,0,240,36,88,0.409,28,67,0.418,8,21,0.381,13,13,1,93,37,89,0.416,31,64,0.484,6,25,0.24,15,17,0.882,95
1748,BOS,2/7/2015,93,@,MIL,0,240,36,86,0.419,29,57,0.509,7,29,0.241,14,20,0.7,93,37,75,0.493,29,55,0.527,8,20,0.4,14,19,0.737,96
1749,UTA,2/6/2015,93,@,PHO,0,240,37,80,0.463,30,60,0.5,7,20,0.35,12,18,0.667,93,38,84,0.452,24,57,0.421,14,27,0.519,10,14,0.714,100
1750,TOR,2/4/2015,93,,BRK,0,240,35,79,0.443,25,46,0.543,10,33,0.303,13,18,0.722,93,40,81,0.494,31,62,0.5,9,19,0.474,20,23,0.87,109
1751,ORL,1/31/2015,93,,DAL,0,240,33,78,0.423,25,54,0.463,8,24,0.333,19,24,0.792,93,42,74,0.568,31,53,0.585,11,21,0.524,13,22,0.591,108
1752,HOU,1/30/2015,93,@,BOS,1,240,35,84,0.417,27,54,0.5,8,30,0.267,15,20,0.75,93,32,90,0.356,25,66,0.379,7,24,0.292,16,23,0.696,87
1753,DAL,1/30/2015,93,@,MIA,1,240,34,82,0.415,21,53,0.396,13,29,0.448,12,20,0.6,93,29,88,0.33,20,59,0.339,9,29,0.31,5,10,0.5,72
1754,CHI,1/30/2015,93,@,PHO,0,240,36,87,0.414,32,69,0.464,4,18,0.222,17,27,0.63,93,39,90,0.433,33,68,0.485,6,22,0.273,15,17,0.882,99
1755,DEN,1/28/2015,93,@,NOP,1,240,39,85,0.459,29,68,0.426,10,17,0.588,5,7,0.714,93,32,82,0.39,29,67,0.433,3,15,0.2,18,24,0.75,85
1756,OKC,1/23/2015,93,@,ATL,0,240,36,87,0.414,26,61,0.426,10,26,0.385,11,18,0.611,93,40,83,0.482,30,58,0.517,10,25,0.4,13,13,1,103
1757,BOS,1/19/2015,93,@,LAC,0,240,33,84,0.393,21,55,0.382,12,29,0.414,15,21,0.714,93,39,82,0.476,30,61,0.492,9,21,0.429,15,19,0.789,102
1758,ATL,1/19/2015,93,,DET,1,240,37,84,0.44,28,54,0.519,9,30,0.3,10,14,0.714,93,29,82,0.354,20,47,0.426,9,35,0.257,15,26,0.577,82
1759,TOR,1/18/2015,93,,NOP,0,240,31,72,0.431,24,47,0.511,7,25,0.28,24,29,0.828,93,39,82,0.476,34,65,0.523,5,17,0.294,12,20,0.6,95
1760,CHO,1/14/2015,93,,SAS,0,240,33,86,0.384,29,73,0.397,4,13,0.308,23,35,0.657,93,37,85,0.435,29,64,0.453,8,21,0.381,16,20,0.8,98
1761,SAS,1/13/2015,93,@,WAS,0,240,38,96,0.396,29,67,0.433,9,29,0.31,8,12,0.667,93,37,75,0.493,31,63,0.492,6,12,0.5,21,24,0.875,101
1762,MIN,1/10/2015,93,,SAS,0,240,32,81,0.395,29,66,0.439,3,15,0.2,26,26,1,93,41,84,0.488,32,60,0.533,9,24,0.375,17,20,0.85,108
1763,BRK,1/10/2015,93,@,DET,0,240,37,88,0.42,28,57,0.491,9,31,0.29,10,10,1,93,34,80,0.425,23,47,0.489,11,33,0.333,19,26,0.731,98
1764,PHI,1/10/2015,93,,IND,1,240,32,80,0.4,21,56,0.375,11,24,0.458,18,25,0.72,93,29,87,0.333,25,69,0.362,4,18,0.222,30,42,0.714,92
1765,DEN,1/7/2015,93,,ORL,1,240,33,74,0.446,26,57,0.456,7,17,0.412,20,26,0.769,93,35,88,0.398,27,66,0.409,8,22,0.364,12,16,0.75,90
1766,CLE,1/7/2015,93,,HOU,0,240,34,82,0.415,24,53,0.453,10,29,0.345,15,19,0.789,93,39,86,0.453,27,52,0.519,12,34,0.353,15,24,0.625,105
1767,NOP,12/31/2014,93,@,SAS,0,265,34,89,0.382,26,61,0.426,8,28,0.286,17,20,0.85,93,39,89,0.438,33,65,0.508,6,24,0.25,11,18,0.611,95
1768,PHI,12/26/2014,93,@,POR,0,240,36,81,0.444,33,67,0.493,3,14,0.214,18,33,0.545,93,42,88,0.477,24,45,0.533,18,43,0.419,12,14,0.857,114
1769,LAL,12/25/2014,93,@,CHI,0,240,36,92,0.391,31,76,0.408,5,16,0.313,16,21,0.762,93,42,86,0.488,32,62,0.516,10,24,0.417,19,25,0.76,113
1770,SAS,12/20/2014,93,@,DAL,0,240,32,77,0.416,29,64,0.453,3,13,0.231,26,26,1,93,37,86,0.43,28,60,0.467,9,26,0.346,16,20,0.8,99
1771,ATL,12/15/2014,93,,CHI,1,240,36,83,0.434,29,62,0.468,7,21,0.333,14,17,0.824,93,35,93,0.376,29,64,0.453,6,29,0.207,10,14,0.714,86
1772,CHI,12/14/2014,93,@,MIA,1,240,33,71,0.465,24,53,0.453,9,18,0.5,18,21,0.857,93,28,80,0.35,24,58,0.414,4,22,0.182,15,18,0.833,75
1773,WAS,12/14/2014,93,,UTA,1,240,41,84,0.488,37,71,0.521,4,13,0.308,7,12,0.583,93,30,78,0.385,25,61,0.41,5,17,0.294,19,28,0.679,84
1774,HOU,12/10/2014,93,@,GSW,0,240,37,90,0.411,28,55,0.509,9,35,0.257,10,15,0.667,93,40,81,0.494,32,58,0.552,8,23,0.348,17,20,0.85,105
1775,NYK,12/9/2014,93,@,NOP,0,240,37,78,0.474,28,59,0.475,9,19,0.474,10,13,0.769,93,40,80,0.5,36,65,0.554,4,15,0.267,20,26,0.769,104
1776,WAS,12/7/2014,93,@,BOS,0,240,34,93,0.366,23,66,0.348,11,27,0.407,14,21,0.667,93,36,88,0.409,28,71,0.394,8,17,0.471,21,26,0.808,101
1777,UTA,12/5/2014,93,,ORL,0,240,36,79,0.456,28,63,0.444,8,16,0.5,13,21,0.619,93,37,74,0.5,30,57,0.526,7,17,0.412,17,20,0.85,98
1778,SAS,12/3/2014,93,@,BRK,0,265,36,101,0.356,24,69,0.348,12,32,0.375,9,12,0.75,93,37,90,0.411,28,71,0.394,9,19,0.474,12,18,0.667,95
1779,NYK,12/2/2014,93,,BRK,0,240,35,81,0.432,24,53,0.453,11,28,0.393,12,14,0.857,93,39,89,0.438,33,72,0.458,6,17,0.353,14,20,0.7,98
1780,MIN,11/30/2014,93,@,POR,0,240,39,90,0.433,37,81,0.457,2,9,0.222,13,20,0.65,93,39,86,0.453,27,53,0.509,12,33,0.364,17,25,0.68,107
1781,DET,11/30/2014,93,,GSW,0,240,33,91,0.363,22,68,0.324,11,23,0.478,16,24,0.667,93,37,79,0.468,28,58,0.483,9,21,0.429,21,27,0.778,104
1782,ORL,11/30/2014,93,@,PHO,1,240,35,76,0.461,30,61,0.492,5,15,0.333,18,25,0.72,93,34,85,0.4,27,59,0.458,7,26,0.269,15,18,0.833,90
1783,LAL,11/26/2014,93,,MEM,0,240,33,81,0.407,25,62,0.403,8,19,0.421,19,24,0.792,93,36,80,0.45,31,58,0.534,5,22,0.227,22,25,0.88,99
1784,CHO,11/23/2014,93,@,MIA,0,240,37,79,0.468,30,58,0.517,7,21,0.333,12,16,0.75,93,33,66,0.5,22,43,0.512,11,23,0.478,17,19,0.895,94
1785,CLE,11/22/2014,93,,TOR,0,240,35,81,0.432,32,65,0.492,3,16,0.188,20,29,0.69,93,32,80,0.4,24,56,0.429,8,24,0.333,38,42,0.905,110
1786,MIA,11/20/2014,93,,LAC,0,240,30,67,0.448,24,41,0.585,6,26,0.231,27,31,0.871,93,43,77,0.558,30,46,0.652,13,31,0.419,11,17,0.647,110
1787,DET,11/17/2014,93,,ORL,0,240,32,80,0.4,21,56,0.375,11,24,0.458,18,24,0.75,93,41,79,0.519,28,53,0.528,13,26,0.5,12,15,0.8,107
1788,NOP,11/17/2014,93,@,POR,0,240,38,85,0.447,33,66,0.5,5,19,0.263,12,19,0.632,93,38,76,0.5,31,57,0.544,7,19,0.368,19,23,0.826,102
1789,HOU,11/17/2014,93,@,MEM,0,240,34,78,0.436,26,44,0.591,8,34,0.235,17,21,0.81,93,46,86,0.535,39,69,0.565,7,17,0.412,20,22,0.909,119
1790,DEN,11/16/2014,93,@,NYK,0,240,32,82,0.39,19,48,0.396,13,34,0.382,16,26,0.615,93,41,76,0.539,35,62,0.565,6,14,0.429,21,27,0.778,109
1791,ORL,11/15/2014,93,@,WAS,0,240,37,78,0.474,30,61,0.492,7,17,0.412,12,18,0.667,93,42,84,0.5,39,74,0.527,3,10,0.3,11,16,0.688,98
1792,UTA,11/15/2014,93,@,TOR,0,240,33,75,0.44,28,59,0.475,5,16,0.313,22,30,0.733,93,43,84,0.512,35,63,0.556,8,21,0.381,17,23,0.739,111
1793,SAS,11/14/2014,93,@,LAL,1,240,33,80,0.413,23,57,0.404,10,23,0.435,17,20,0.85,93,28,75,0.373,26,63,0.413,2,12,0.167,22,31,0.71,80
1794,TOR,11/13/2014,93,,CHI,0,240,35,89,0.393,27,64,0.422,8,25,0.32,15,21,0.714,93,37,77,0.481,33,62,0.532,4,15,0.267,22,32,0.688,100
1795,SAC,11/9/2014,93,@,OKC,0,240,36,80,0.45,30,56,0.536,6,24,0.25,15,22,0.682,93,36,78,0.462,30,60,0.5,6,18,0.333,23,27,0.852,101
1796,MIL,11/8/2014,93,,MEM,1,240,40,88,0.455,35,70,0.5,5,18,0.278,8,11,0.727,93,29,82,0.354,26,68,0.382,3,14,0.214,31,34,0.912,92
1797,PHI,11/3/2014,93,,HOU,0,240,33,74,0.446,22,52,0.423,11,22,0.5,16,23,0.696,93,32,75,0.427,16,41,0.39,16,34,0.471,24,30,0.8,104
1798,MEM,11/3/2014,93,,NOP,1,240,31,76,0.408,27,62,0.435,4,14,0.286,27,37,0.73,93,29,86,0.337,25,62,0.403,4,24,0.167,19,29,0.655,81
1799,CHO,11/2/2014,93,@,NYK,0,240,33,70,0.471,27,55,0.491,6,15,0.4,21,29,0.724,93,39,78,0.5,31,62,0.5,8,16,0.5,10,17,0.588,96
1800,MIL,10/31/2014,93,,PHI,1,240,36,88,0.409,27,64,0.422,9,24,0.375,12,21,0.571,93,32,86,0.372,27,63,0.429,5,23,0.217,12,22,0.545,81
1801,LAC,10/30/2014,93,,OKC,1,240,34,87,0.391,27,57,0.474,7,30,0.233,18,25,0.72,93,28,65,0.431,22,44,0.5,6,21,0.286,28,34,0.824,90
1802,UTA,10/29/2014,93,,HOU,0,240,38,81,0.469,35,63,0.556,3,18,0.167,14,17,0.824,93,40,77,0.519,26,50,0.52,14,27,0.519,10,14,0.714,104
1803,TOR,4/15/2015,92,,CHO,1,240,38,77,0.494,26,44,0.591,12,33,0.364,4,4,1,92,30,71,0.423,18,38,0.474,12,33,0.364,15,16,0.938,87
1804,LAL,4/13/2015,92,@,SAC,0,240,40,96,0.417,36,81,0.444,4,15,0.267,8,13,0.615,92,35,72,0.486,31,56,0.554,4,16,0.25,28,36,0.778,102
1805,DAL,4/13/2015,92,@,UTA,0,240,34,82,0.415,25,62,0.403,9,20,0.45,15,23,0.652,92,41,82,0.5,30,54,0.556,11,28,0.393,16,26,0.615,109
1806,TOR,4/8/2015,92,@,CHO,1,240,33,77,0.429,21,50,0.42,12,27,0.444,14,19,0.737,92,28,81,0.346,18,59,0.305,10,22,0.455,8,11,0.727,74
1807,GSW,4/5/2015,92,@,SAS,0,240,39,91,0.429,30,63,0.476,9,28,0.321,5,10,0.5,92,44,83,0.53,37,62,0.597,7,21,0.333,12,15,0.8,107
1808,DEN,4/4/2015,92,,LAC,0,240,32,85,0.376,26,63,0.413,6,22,0.273,22,31,0.71,92,34,79,0.43,21,45,0.467,13,34,0.382,26,42,0.619,107
1809,CHO,4/4/2015,92,,PHI,1,240,35,86,0.407,34,73,0.466,1,13,0.077,21,23,0.913,92,28,76,0.368,17,50,0.34,11,26,0.423,24,33,0.727,91
1810,WAS,4/4/2015,92,@,MEM,1,240,38,79,0.481,30,57,0.526,8,22,0.364,8,10,0.8,92,34,81,0.42,33,66,0.5,1,15,0.067,14,18,0.778,83
1811,OKC,4/3/2015,92,@,MEM,0,240,36,88,0.409,32,71,0.451,4,17,0.235,16,26,0.615,92,38,80,0.475,34,59,0.576,4,21,0.19,20,28,0.714,100
1812,LAL,4/1/2015,92,,NOP,0,240,37,83,0.446,32,67,0.478,5,16,0.313,13,21,0.619,92,44,78,0.564,35,62,0.565,9,16,0.563,16,21,0.762,113
1813,NYK,3/27/2015,92,,BOS,0,240,38,87,0.437,31,63,0.492,7,24,0.292,9,14,0.643,92,29,69,0.42,25,49,0.51,4,20,0.2,34,43,0.791,96
1814,POR,3/25/2015,92,@,UTA,1,240,34,81,0.42,27,54,0.5,7,27,0.259,17,20,0.85,92,35,80,0.438,31,64,0.484,4,16,0.25,15,23,0.652,89
1815,DAL,3/22/2015,92,@,PHO,0,240,37,96,0.385,32,77,0.416,5,19,0.263,13,22,0.591,92,39,76,0.513,33,55,0.6,6,21,0.286,14,23,0.609,98
1816,TOR,3/20/2015,92,@,CHI,0,240,30,79,0.38,20,54,0.37,10,25,0.4,22,26,0.846,92,42,79,0.532,33,51,0.647,9,28,0.321,15,17,0.882,108
1817,IND,3/20/2015,92,@,CLE,0,240,36,84,0.429,28,64,0.438,8,20,0.4,12,13,0.923,92,35,82,0.427,26,56,0.464,9,26,0.346,16,21,0.762,95
1818,NYK,3/19/2015,92,,MIN,0,265,40,97,0.412,36,77,0.468,4,20,0.2,8,10,0.8,92,34,83,0.41,32,71,0.451,2,12,0.167,25,30,0.833,95
1819,BRK,3/18/2015,92,@,CLE,0,240,36,80,0.45,31,60,0.517,5,20,0.25,15,21,0.714,92,45,82,0.549,30,53,0.566,15,29,0.517,12,20,0.6,117
1820,CHO,3/17/2015,92,@,LAC,0,240,32,79,0.405,27,65,0.415,5,14,0.357,23,29,0.793,92,35,77,0.455,26,53,0.491,9,24,0.375,20,28,0.714,99
1821,MEM,3/16/2015,92,,DEN,1,240,33,80,0.413,31,71,0.437,2,9,0.222,24,28,0.857,92,30,81,0.37,22,63,0.349,8,18,0.444,13,21,0.619,81
1822,CLE,3/16/2015,92,@,MIA,0,240,30,79,0.38,19,46,0.413,11,33,0.333,21,27,0.778,92,42,76,0.553,38,61,0.623,4,15,0.267,18,22,0.818,106
1823,MIA,3/13/2015,92,@,TOR,0,240,35,79,0.443,30,56,0.536,5,23,0.217,17,24,0.708,92,34,79,0.43,22,46,0.478,12,33,0.364,22,31,0.71,102
1824,MEM,3/11/2015,92,@,BOS,0,240,37,78,0.474,32,66,0.485,5,12,0.417,13,13,1,92,37,85,0.435,29,58,0.5,8,27,0.296,13,17,0.765,95
1825,PHI,3/7/2015,92,,ATL,1,240,35,95,0.368,22,58,0.379,13,37,0.351,9,17,0.529,92,30,77,0.39,19,52,0.365,11,25,0.44,13,16,0.813,84
1826,IND,3/7/2015,92,@,NYK,1,240,30,79,0.38,23,61,0.377,7,18,0.389,25,30,0.833,92,30,78,0.385,27,63,0.429,3,15,0.2,23,30,0.767,86
1827,WAS,3/3/2015,92,@,CHI,0,240,35,84,0.417,27,62,0.435,8,22,0.364,14,19,0.737,92,33,78,0.423,24,49,0.49,9,29,0.31,22,30,0.733,97
1828,DEN,3/1/2015,92,,NOP,0,240,37,92,0.402,28,59,0.475,9,33,0.273,9,17,0.529,92,36,74,0.486,31,52,0.596,5,22,0.227,22,30,0.733,99
1829,IND,2/24/2015,92,@,OKC,0,240,38,88,0.432,29,62,0.468,9,26,0.346,7,11,0.636,92,40,96,0.417,31,72,0.431,9,24,0.375,16,18,0.889,105
1830,TOR,2/24/2015,92,@,DAL,0,240,38,84,0.452,29,58,0.5,9,26,0.346,7,11,0.636,92,38,79,0.481,30,60,0.5,8,19,0.421,15,18,0.833,99
1831,DAL,2/22/2015,92,,CHO,1,240,36,78,0.462,31,60,0.517,5,18,0.278,15,19,0.789,92,33,90,0.367,27,71,0.38,6,19,0.316,9,13,0.692,81
1832,POR,2/22/2015,92,,MEM,0,240,33,82,0.402,20,49,0.408,13,33,0.394,13,16,0.813,92,42,89,0.472,39,80,0.488,3,9,0.333,11,13,0.846,98
1833,UTA,2/20/2015,92,,POR,1,240,37,83,0.446,27,58,0.466,10,25,0.4,8,17,0.471,92,26,72,0.361,22,50,0.44,4,22,0.182,20,22,0.909,76
1834,NYK,2/7/2015,92,,GSW,0,240,35,87,0.402,27,69,0.391,8,18,0.444,14,17,0.824,92,37,81,0.457,25,56,0.446,12,25,0.48,20,24,0.833,106
1835,BRK,2/6/2015,92,,NYK,1,240,37,74,0.5,34,63,0.54,3,11,0.273,15,22,0.682,92,34,89,0.382,28,65,0.431,6,24,0.25,14,17,0.824,88
1836,CHO,2/2/2015,92,@,WAS,1,240,37,79,0.468,33,64,0.516,4,15,0.267,14,19,0.737,92,33,81,0.407,27,66,0.409,6,15,0.4,16,19,0.842,88
1837,NYK,2/1/2015,92,,LAL,1,240,37,84,0.44,27,62,0.435,10,22,0.455,8,13,0.615,92,27,76,0.355,20,60,0.333,7,16,0.438,19,23,0.826,80
1838,OKC,1/28/2015,92,@,NYK,0,240,34,85,0.4,29,63,0.46,5,22,0.227,19,22,0.864,92,40,91,0.44,32,74,0.432,8,17,0.471,12,17,0.706,100
1839,LAL,1/27/2015,92,,WAS,0,240,37,87,0.425,32,67,0.478,5,20,0.25,13,16,0.813,92,38,78,0.487,34,62,0.548,4,16,0.25,18,27,0.667,98
1840,OKC,1/26/2015,92,,MIN,1,240,36,86,0.419,32,66,0.485,4,20,0.2,16,24,0.667,92,29,85,0.341,27,72,0.375,2,13,0.154,24,32,0.75,84
1841,NOP,1/23/2015,92,@,MIN,1,240,40,80,0.5,37,76,0.487,3,4,0.75,9,14,0.643,92,35,84,0.417,33,75,0.44,2,9,0.222,12,17,0.706,84
1842,UTA,1/21/2015,92,@,CLE,0,240,35,84,0.417,27,62,0.435,8,22,0.364,14,18,0.778,92,42,81,0.519,37,57,0.649,5,24,0.208,17,25,0.68,106
1843,MEM,1/21/2015,92,,TOR,1,240,34,74,0.459,33,67,0.493,1,7,0.143,23,29,0.793,92,27,85,0.318,22,57,0.386,5,28,0.179,27,32,0.844,86
1844,TOR,1/19/2015,92,@,MIL,1,240,36,90,0.4,30,66,0.455,6,24,0.25,14,24,0.583,92,34,76,0.447,29,58,0.5,5,18,0.278,16,25,0.64,89
1845,NOP,1/19/2015,92,@,NYK,0,240,35,84,0.417,27,57,0.474,8,27,0.296,14,20,0.7,92,38,78,0.487,28,55,0.509,10,23,0.435,13,17,0.765,99
1846,BRK,1/14/2015,92,,MEM,0,240,36,75,0.48,26,49,0.531,10,26,0.385,10,12,0.833,92,39,83,0.47,36,66,0.545,3,17,0.176,22,29,0.759,103
1847,IND,1/10/2015,92,@,PHI,0,240,29,87,0.333,25,69,0.362,4,18,0.222,30,42,0.714,92,32,80,0.4,21,56,0.375,11,24,0.458,18,25,0.72,93
1848,ORL,1/10/2015,92,@,POR,0,240,37,92,0.402,34,71,0.479,3,21,0.143,15,20,0.75,92,36,76,0.474,26,50,0.52,10,26,0.385,21,26,0.808,103
1849,CLE,1/5/2015,92,@,PHI,0,240,33,85,0.388,22,55,0.4,11,30,0.367,15,22,0.682,92,38,79,0.481,31,56,0.554,7,23,0.304,12,15,0.8,95
1850,WAS,1/5/2015,92,@,NOP,1,240,38,79,0.481,36,69,0.522,2,10,0.2,14,17,0.824,92,33,74,0.446,27,55,0.491,6,19,0.316,13,17,0.765,85
1851,WAS,1/3/2015,92,@,SAS,0,240,40,82,0.488,36,68,0.529,4,14,0.286,8,13,0.615,92,43,78,0.551,39,62,0.629,4,16,0.25,11,18,0.611,101
1852,UTA,1/2/2015,92,,ATL,0,240,32,86,0.372,22,55,0.4,10,31,0.323,18,24,0.75,92,33,81,0.407,27,58,0.466,6,23,0.261,26,30,0.867,98
1853,CHI,12/29/2014,92,@,IND,1,240,29,84,0.345,24,71,0.338,5,13,0.385,29,33,0.879,92,36,83,0.434,31,70,0.443,5,13,0.385,13,21,0.619,90
1854,WAS,12/21/2014,92,,PHO,0,240,34,83,0.41,31,69,0.449,3,14,0.214,21,29,0.724,92,40,78,0.513,34,61,0.557,6,17,0.353,18,25,0.72,104
1855,ORL,12/17/2014,92,@,BOS,0,240,37,85,0.435,32,66,0.485,5,19,0.263,13,15,0.867,92,44,80,0.55,37,61,0.607,7,19,0.368,14,18,0.778,109
1856,SAC,12/16/2014,92,,OKC,0,240,36,84,0.429,31,66,0.47,5,18,0.278,15,17,0.882,92,41,87,0.471,35,67,0.522,6,20,0.3,16,24,0.667,104
1857,MIN,12/12/2014,92,,OKC,0,240,36,78,0.462,35,71,0.493,1,7,0.143,19,29,0.655,92,45,88,0.511,39,64,0.609,6,24,0.25,15,20,0.75,111
1858,IND,12/8/2014,92,,ATL,0,240,37,84,0.44,28,57,0.491,9,27,0.333,9,17,0.529,92,40,77,0.519,31,56,0.554,9,21,0.429,19,27,0.704,108
1859,UTA,12/8/2014,92,@,SAC,0,240,32,79,0.405,29,62,0.468,3,17,0.176,25,37,0.676,92,35,74,0.473,32,66,0.485,3,8,0.375,28,36,0.778,101
1860,CHO,11/24/2014,92,,LAC,0,240,31,75,0.413,29,55,0.527,2,20,0.1,28,35,0.8,92,45,88,0.511,30,56,0.536,15,32,0.469,8,10,0.8,113
1861,DAL,11/22/2014,92,@,HOU,0,240,35,88,0.398,29,53,0.547,6,35,0.171,16,22,0.727,92,30,82,0.366,15,36,0.417,15,46,0.326,20,23,0.87,95
1862,ORL,11/22/2014,92,,MIA,0,240,35,78,0.449,32,62,0.516,3,16,0.188,19,27,0.704,92,37,71,0.521,25,45,0.556,12,26,0.462,13,18,0.722,99
1863,OKC,11/21/2014,92,,BRK,0,240,38,85,0.447,34,65,0.523,4,20,0.2,12,19,0.632,92,31,67,0.463,26,52,0.5,5,15,0.333,27,30,0.9,94
1864,MIN,11/21/2014,92,,SAS,0,240,37,90,0.411,33,77,0.429,4,13,0.308,14,22,0.636,92,46,84,0.548,33,63,0.524,13,21,0.619,16,18,0.889,121
1865,HOU,11/19/2014,92,,LAL,0,240,30,74,0.405,15,36,0.417,15,38,0.395,17,23,0.739,92,37,91,0.407,32,71,0.451,5,20,0.25,19,23,0.826,98
1866,SAS,11/19/2014,92,@,CLE,1,240,35,74,0.473,30,58,0.517,5,16,0.313,17,25,0.68,92,37,83,0.446,30,65,0.462,7,18,0.389,9,13,0.692,90
1867,MEM,11/19/2014,92,@,TOR,0,240,35,80,0.438,32,70,0.457,3,10,0.3,19,26,0.731,92,38,83,0.458,29,57,0.509,9,26,0.346,11,13,0.846,96
1868,CHO,11/9/2014,92,@,LAL,0,240,35,79,0.443,32,65,0.492,3,14,0.214,19,27,0.704,92,42,82,0.512,36,65,0.554,6,17,0.353,17,22,0.773,107
1869,MEM,11/8/2014,92,@,MIL,0,240,29,82,0.354,26,68,0.382,3,14,0.214,31,34,0.912,92,40,88,0.455,35,70,0.5,5,18,0.278,8,11,0.727,93
1870,MIN,11/8/2014,92,@,MIA,0,240,35,87,0.402,31,71,0.437,4,16,0.25,18,23,0.783,92,41,78,0.526,36,65,0.554,5,13,0.385,15,17,0.882,102
1871,ATL,11/5/2014,92,@,SAS,0,240,38,92,0.413,30,67,0.448,8,25,0.32,8,11,0.727,92,31,69,0.449,26,52,0.5,5,17,0.294,27,38,0.711,94
1872,LAC,11/2/2014,92,,SAC,0,240,33,88,0.375,24,57,0.421,9,31,0.29,17,21,0.81,92,34,68,0.5,31,58,0.534,3,10,0.3,27,33,0.818,98
1873,IND,11/1/2014,92,@,ATL,0,240,31,81,0.383,19,49,0.388,12,32,0.375,18,21,0.857,92,35,69,0.507,28,49,0.571,7,20,0.35,25,33,0.758,102
1874,UTA,4/15/2015,91,@,HOU,0,240,38,101,0.376,33,74,0.446,5,27,0.185,10,18,0.556,91,41,76,0.539,29,48,0.604,12,28,0.429,23,34,0.676,117
1875,CHI,4/15/2015,91,,ATL,1,240,31,77,0.403,24,53,0.453,7,24,0.292,22,26,0.846,91,36,92,0.391,28,63,0.444,8,29,0.276,5,7,0.714,85
1876,PHO,4/12/2015,91,@,SAS,0,240,35,85,0.412,31,69,0.449,4,16,0.25,17,23,0.739,91,35,69,0.507,27,50,0.54,8,19,0.421,29,34,0.853,107
1877,NYK,4/10/2015,91,,MIL,0,240,34,72,0.472,29,59,0.492,5,13,0.385,18,24,0.75,91,37,76,0.487,31,59,0.525,6,17,0.353,19,29,0.655,99
1878,SAC,4/8/2015,91,@,UTA,0,240,33,75,0.44,26,59,0.441,7,16,0.438,18,28,0.643,91,36,74,0.486,23,43,0.535,13,31,0.419,18,25,0.72,103
1879,MIN,4/8/2015,91,@,POR,0,240,32,85,0.376,29,74,0.392,3,11,0.273,24,29,0.828,91,42,85,0.494,30,52,0.577,12,33,0.364,20,23,0.87,116
1880,PHI,4/5/2015,91,@,NYK,0,240,38,99,0.384,28,67,0.418,10,32,0.313,5,8,0.625,91,37,72,0.514,34,59,0.576,3,13,0.231,24,29,0.828,101
1881,PHI,4/4/2015,91,@,CHO,0,240,28,76,0.368,17,50,0.34,11,26,0.423,24,33,0.727,91,35,86,0.407,34,73,0.466,1,13,0.077,21,23,0.913,92
1882,CHI,4/1/2015,91,@,MIL,0,240,31,74,0.419,26,48,0.542,5,26,0.192,24,37,0.649,91,37,89,0.416,29,68,0.426,8,21,0.381,13,18,0.722,95
1883,ORL,4/1/2015,91,,SAS,0,240,39,93,0.419,34,76,0.447,5,17,0.294,8,9,0.889,91,35,86,0.407,22,57,0.386,13,29,0.448,20,23,0.87,103
1884,WAS,3/29/2015,91,,HOU,0,240,29,75,0.387,25,60,0.417,4,15,0.267,29,37,0.784,91,34,80,0.425,25,51,0.49,9,29,0.31,22,33,0.667,99
1885,UTA,3/27/2015,91,@,DEN,0,240,32,81,0.395,27,54,0.5,5,27,0.185,22,31,0.71,91,39,76,0.513,26,52,0.5,13,24,0.542,16,23,0.696,107
1886,BRK,3/25/2015,91,@,CHO,1,240,39,91,0.429,36,77,0.468,3,14,0.214,10,11,0.909,91,36,91,0.396,33,79,0.418,3,12,0.25,13,20,0.65,88
1887,OKC,3/25/2015,91,@,SAS,0,240,36,90,0.4,30,72,0.417,6,18,0.333,13,14,0.929,91,51,88,0.58,38,67,0.567,13,21,0.619,15,19,0.789,130
1888,BRK,3/23/2015,91,,BOS,0,240,32,89,0.36,31,72,0.431,1,17,0.059,26,30,0.867,91,47,92,0.511,41,70,0.586,6,22,0.273,10,14,0.714,110
1889,CHI,3/21/2015,91,@,DET,0,240,33,77,0.429,27,56,0.482,6,21,0.286,19,24,0.792,91,44,90,0.489,33,64,0.516,11,26,0.423,8,10,0.8,107
1890,UTA,3/21/2015,91,@,GSW,0,240,32,73,0.438,22,51,0.431,10,22,0.455,17,21,0.81,91,38,78,0.487,30,60,0.5,8,18,0.444,22,26,0.846,106
1891,CHO,3/20/2015,91,@,SAC,0,240,36,91,0.396,30,73,0.411,6,18,0.333,13,16,0.813,91,37,78,0.474,28,57,0.491,9,21,0.429,18,25,0.72,101
1892,DEN,3/20/2015,91,@,MIA,0,240,37,79,0.468,30,52,0.577,7,27,0.259,10,19,0.526,91,43,81,0.531,36,65,0.554,7,16,0.438,15,19,0.789,108
1893,ATL,3/15/2015,91,@,LAL,1,240,34,76,0.447,29,53,0.547,5,23,0.217,18,27,0.667,91,34,85,0.4,27,67,0.403,7,18,0.389,11,15,0.733,86
1894,CHI,3/13/2015,91,@,CHO,0,240,31,82,0.378,16,50,0.32,15,32,0.469,14,19,0.737,91,33,89,0.371,26,70,0.371,7,19,0.368,28,33,0.848,101
1895,HOU,3/12/2015,91,@,UTA,0,240,34,79,0.43,27,47,0.574,7,32,0.219,16,24,0.667,91,44,92,0.478,33,59,0.559,11,33,0.333,10,17,0.588,109
1896,ORL,3/11/2015,91,@,MIL,0,240,34,85,0.4,24,67,0.358,10,18,0.556,13,13,1,91,39,79,0.494,31,61,0.508,8,18,0.444,11,16,0.688,97
1897,BRK,3/10/2015,91,,NOP,0,240,35,84,0.417,29,68,0.426,6,16,0.375,15,23,0.652,91,45,87,0.517,33,66,0.5,12,21,0.571,9,11,0.818,111
1898,CHI,3/9/2015,91,,MEM,0,240,35,80,0.438,25,58,0.431,10,22,0.455,11,14,0.786,91,42,84,0.5,37,70,0.529,5,14,0.357,12,17,0.706,101
1899,MIL,3/7/2015,91,,WAS,1,240,36,78,0.462,26,58,0.448,10,20,0.5,9,15,0.6,91,31,81,0.383,22,53,0.415,9,28,0.321,14,22,0.636,85
1900,BRK,3/4/2015,91,,CHO,0,240,35,88,0.398,32,72,0.444,3,16,0.188,18,24,0.75,91,42,85,0.494,34,66,0.515,8,19,0.421,23,28,0.821,115
1901,MIA,2/28/2015,91,,ATL,0,240,32,81,0.395,25,55,0.455,7,26,0.269,20,21,0.952,91,34,79,0.43,24,54,0.444,10,25,0.4,15,20,0.75,93
1902,MIA,2/21/2015,91,,NOP,0,240,33,79,0.418,28,62,0.452,5,17,0.294,20,27,0.741,91,35,83,0.422,27,62,0.435,8,21,0.381,27,31,0.871,105
1903,CHI,2/20/2015,91,@,DET,0,240,33,78,0.423,28,62,0.452,5,16,0.313,20,22,0.909,91,38,84,0.452,32,62,0.516,6,22,0.273,18,33,0.545,100
1904,MIN,2/11/2015,91,,GSW,0,240,33,86,0.384,28,72,0.389,5,14,0.357,20,27,0.741,91,40,90,0.444,33,63,0.524,7,27,0.259,7,9,0.778,94
1905,NOP,2/4/2015,91,,OKC,0,240,37,97,0.381,30,72,0.417,7,25,0.28,10,13,0.769,91,45,85,0.529,40,70,0.571,5,15,0.333,7,11,0.636,102
1906,MIA,2/3/2015,91,@,DET,0,240,35,74,0.473,29,60,0.483,6,14,0.429,15,23,0.652,91,42,88,0.477,33,68,0.485,9,20,0.45,15,18,0.833,108
1907,ATL,1/31/2015,91,,PHI,1,240,34,78,0.436,24,50,0.48,10,28,0.357,13,18,0.722,91,31,81,0.383,17,46,0.37,14,35,0.4,9,15,0.6,85
1908,IND,1/27/2015,91,,TOR,0,240,34,82,0.415,27,64,0.422,7,18,0.389,16,23,0.696,91,34,73,0.466,25,47,0.532,9,26,0.346,27,34,0.794,104
1909,TOR,1/23/2015,91,@,PHI,1,240,33,80,0.413,27,56,0.482,6,24,0.25,19,24,0.792,91,31,81,0.383,22,52,0.423,9,29,0.31,15,18,0.833,86
1910,PHI,1/21/2015,91,,NYK,0,240,29,79,0.367,21,56,0.375,8,23,0.348,25,32,0.781,91,37,91,0.407,30,71,0.423,7,20,0.35,17,20,0.85,98
1911,IND,1/21/2015,91,@,ATL,0,240,31,78,0.397,26,53,0.491,5,25,0.2,24,26,0.923,91,39,78,0.5,26,49,0.531,13,29,0.448,19,26,0.731,110
1912,BOS,1/14/2015,91,,ATL,0,240,34,83,0.41,23,50,0.46,11,33,0.333,12,14,0.857,91,36,73,0.493,26,44,0.591,10,29,0.345,23,27,0.852,105
1913,NYK,1/7/2015,91,@,WAS,0,240,34,82,0.415,23,56,0.411,11,26,0.423,12,16,0.75,91,39,76,0.513,31,60,0.517,8,16,0.5,15,21,0.714,101
1914,OKC,1/5/2015,91,@,GSW,0,240,30,98,0.306,25,70,0.357,5,28,0.179,26,34,0.765,91,41,88,0.466,26,60,0.433,15,28,0.536,20,32,0.625,117
1915,PHI,1/3/2015,91,@,LAC,0,240,32,79,0.405,23,54,0.426,9,25,0.36,18,26,0.692,91,46,85,0.541,31,48,0.646,15,37,0.405,20,26,0.769,127
1916,CLE,1/2/2015,91,@,CHO,1,240,33,87,0.379,29,72,0.403,4,15,0.267,21,30,0.7,91,32,87,0.368,26,59,0.441,6,28,0.214,17,26,0.654,87
1917,MIL,1/2/2015,91,,IND,0,240,38,89,0.427,31,65,0.477,7,24,0.292,8,10,0.8,91,35,81,0.432,27,61,0.443,8,20,0.4,16,20,0.8,94
1918,CLE,12/25/2014,91,@,MIA,0,240,32,72,0.444,26,46,0.565,6,26,0.231,21,33,0.636,91,40,84,0.476,33,63,0.524,7,21,0.333,14,17,0.824,101
1919,NYK,12/25/2014,91,,WAS,0,240,36,80,0.45,32,58,0.552,4,22,0.182,15,19,0.789,91,44,86,0.512,37,70,0.529,7,16,0.438,7,10,0.7,102
1920,WAS,12/23/2014,91,,CHI,0,240,38,89,0.427,33,80,0.413,5,9,0.556,10,16,0.625,91,39,85,0.459,34,68,0.5,5,17,0.294,16,24,0.667,99
1921,PHI,12/23/2014,91,@,MIA,1,240,33,77,0.429,28,58,0.483,5,19,0.263,20,27,0.741,91,33,80,0.413,25,54,0.463,8,26,0.308,13,18,0.722,87
1922,MEM,12/22/2014,91,,UTA,0,240,38,86,0.442,31,63,0.492,7,23,0.304,8,9,0.889,91,34,75,0.453,25,56,0.446,9,19,0.474,20,27,0.741,97
1923,MEM,12/21/2014,91,@,CLE,0,240,39,86,0.453,38,70,0.543,1,16,0.063,12,15,0.8,91,46,76,0.605,39,62,0.629,7,14,0.5,6,10,0.6,105
1924,PHI,12/19/2014,91,,CHO,0,240,32,71,0.451,20,45,0.444,12,26,0.462,15,17,0.882,91,43,98,0.439,33,74,0.446,10,24,0.417,13,17,0.765,109
1925,BRK,12/19/2014,91,@,CLE,0,240,37,78,0.474,28,54,0.519,9,24,0.375,8,12,0.667,91,31,77,0.403,22,53,0.415,9,24,0.375,24,29,0.828,95
1926,BRK,12/16/2014,91,,MIA,0,240,30,77,0.39,22,49,0.449,8,28,0.286,23,32,0.719,91,33,72,0.458,24,48,0.5,9,24,0.375,20,26,0.769,95
1927,LAL,12/15/2014,91,@,IND,0,240,29,88,0.33,19,62,0.306,10,26,0.385,23,29,0.793,91,40,83,0.482,33,66,0.5,7,17,0.412,23,27,0.852,110
1928,DET,12/15/2014,91,@,LAC,0,240,35,83,0.422,27,56,0.482,8,27,0.296,13,22,0.591,91,43,80,0.538,31,56,0.554,12,24,0.5,15,20,0.75,113
1929,DEN,12/14/2014,91,,SAS,0,240,34,83,0.41,26,67,0.388,8,16,0.5,15,21,0.714,91,34,74,0.459,29,58,0.5,5,16,0.313,26,35,0.743,99
1930,WAS,12/10/2014,91,@,ORL,1,240,41,81,0.506,36,69,0.522,5,12,0.417,4,9,0.444,91,38,84,0.452,31,69,0.449,7,15,0.467,6,9,0.667,89
1931,TOR,12/5/2014,91,,CLE,0,240,35,86,0.407,27,62,0.435,8,24,0.333,13,20,0.65,91,41,84,0.488,32,64,0.5,9,20,0.45,14,21,0.667,105
1932,PHI,12/5/2014,91,,OKC,0,240,32,84,0.381,24,56,0.429,8,28,0.286,19,30,0.633,91,35,71,0.493,26,48,0.542,9,23,0.391,24,31,0.774,103
1933,NOP,11/28/2014,91,@,ATL,0,240,36,89,0.404,29,65,0.446,7,24,0.292,12,16,0.75,91,38,76,0.5,33,59,0.559,5,17,0.294,19,22,0.864,100
1934,PHI,11/26/2014,91,,BRK,0,240,34,85,0.4,25,61,0.41,9,24,0.375,14,17,0.824,91,35,71,0.493,27,47,0.574,8,24,0.333,21,28,0.75,99
1935,HOU,11/24/2014,91,,NYK,1,240,32,76,0.421,18,40,0.45,14,36,0.389,13,19,0.684,91,35,76,0.461,29,54,0.537,6,22,0.273,10,15,0.667,86
1936,LAC,11/23/2014,91,@,MEM,0,240,32,77,0.416,25,52,0.481,7,25,0.28,20,28,0.714,91,42,85,0.494,35,64,0.547,7,21,0.333,16,23,0.696,107
1937,GSW,11/23/2014,91,@,OKC,1,240,33,93,0.355,26,68,0.382,7,25,0.28,18,24,0.75,91,32,90,0.356,29,73,0.397,3,17,0.176,19,27,0.704,86
1938,NYK,11/22/2014,91,,PHI,1,240,33,66,0.5,27,49,0.551,6,17,0.353,19,21,0.905,91,30,75,0.4,22,49,0.449,8,26,0.308,15,25,0.6,83
1939,WAS,11/21/2014,91,,CLE,1,240,41,84,0.488,37,74,0.5,4,10,0.4,5,9,0.556,91,27,75,0.36,21,48,0.438,6,27,0.222,18,23,0.783,78
1940,MIL,11/16/2014,91,@,MIA,1,240,35,74,0.473,30,56,0.536,5,18,0.278,16,26,0.615,91,30,73,0.411,19,48,0.396,11,25,0.44,13,22,0.591,84
1941,SAS,11/15/2014,91,@,SAC,0,240,34,80,0.425,27,56,0.482,7,24,0.292,16,18,0.889,91,37,86,0.43,37,74,0.5,0,12,0,20,24,0.833,94
1942,MIN,11/14/2014,91,@,NOP,0,240,29,72,0.403,26,58,0.448,3,14,0.214,30,41,0.732,91,56,84,0.667,41,64,0.641,15,20,0.75,12,16,0.75,139
1943,DET,11/10/2014,91,@,CHI,0,240,34,80,0.425,27,66,0.409,7,14,0.5,16,25,0.64,91,39,88,0.443,32,68,0.471,7,20,0.35,17,20,0.85,102
1944,ATL,11/10/2014,91,@,NYK,1,240,27,71,0.38,17,44,0.386,10,27,0.37,27,28,0.964,91,36,83,0.434,30,57,0.526,6,26,0.231,7,12,0.583,85
1945,MEM,11/7/2014,91,@,OKC,1,240,34,81,0.42,25,63,0.397,9,18,0.5,14,17,0.824,91,37,79,0.468,25,54,0.463,12,25,0.48,3,11,0.273,89
1946,BRK,11/5/2014,91,,MIN,0,240,36,82,0.439,28,61,0.459,8,21,0.381,11,17,0.647,91,37,90,0.411,30,73,0.411,7,17,0.412,17,22,0.773,98
1947,ORL,11/5/2014,91,@,PHI,1,240,39,88,0.443,36,68,0.529,3,20,0.15,10,12,0.833,91,33,77,0.429,25,52,0.481,8,25,0.32,15,23,0.652,89
1948,PHO,11/5/2014,91,,MEM,0,240,32,69,0.464,24,48,0.5,8,21,0.381,19,21,0.905,91,40,80,0.5,31,63,0.492,9,17,0.529,13,17,0.765,102
1949,CHO,11/4/2014,91,@,NOP,0,240,37,80,0.463,31,59,0.525,6,21,0.286,11,13,0.846,91,38,81,0.469,33,63,0.524,5,18,0.278,19,19,1,100
1950,MIA,11/4/2014,91,,HOU,0,240,31,74,0.419,19,46,0.413,12,28,0.429,17,27,0.63,91,35,68,0.515,18,31,0.581,17,37,0.459,21,27,0.778,108
1951,PHO,11/1/2014,91,@,UTA,0,240,36,87,0.414,29,56,0.518,7,31,0.226,12,15,0.8,91,42,88,0.477,35,62,0.565,7,26,0.269,27,33,0.818,118
1952,DEN,11/1/2014,91,@,OKC,0,240,35,80,0.438,28,54,0.519,7,26,0.269,14,20,0.7,91,37,80,0.463,31,60,0.517,6,20,0.3,22,31,0.71,102
1953,DET,10/30/2014,91,@,MIN,0,240,38,91,0.418,31,70,0.443,7,21,0.333,8,13,0.615,91,37,76,0.487,33,66,0.5,4,10,0.4,19,28,0.679,97
1954,PHI,10/29/2014,91,@,IND,0,240,34,89,0.382,28,68,0.412,6,21,0.286,17,30,0.567,91,38,81,0.469,30,56,0.536,8,25,0.32,19,28,0.679,103
1955,NYK,4/15/2015,90,,DET,0,240,33,77,0.429,26,58,0.448,7,19,0.368,17,27,0.63,90,41,81,0.506,31,55,0.564,10,26,0.385,20,27,0.741,112
1956,CHO,4/13/2015,90,,HOU,0,240,34,83,0.41,21,51,0.412,13,32,0.406,9,17,0.529,90,35,85,0.412,26,50,0.52,9,35,0.257,21,26,0.808,100
1957,POR,4/13/2015,90,@,OKC,0,240,38,83,0.458,30,60,0.5,8,23,0.348,6,9,0.667,90,39,96,0.406,35,75,0.467,4,21,0.19,19,27,0.704,101
1958,CLE,4/10/2015,90,,BOS,0,240,32,77,0.416,23,43,0.535,9,34,0.265,17,25,0.68,90,38,84,0.452,30,62,0.484,8,22,0.364,15,21,0.714,99
1959,NOP,4/10/2015,90,,PHO,1,240,37,84,0.44,32,65,0.492,5,19,0.263,11,19,0.579,90,30,85,0.353,23,60,0.383,7,25,0.28,8,10,0.8,75
1960,PHI,4/8/2015,90,,WAS,0,240,31,89,0.348,22,62,0.355,9,27,0.333,19,27,0.704,90,47,72,0.653,39,57,0.684,8,15,0.533,17,23,0.739,119
1961,MIL,4/4/2015,90,,ORL,0,240,39,89,0.438,34,73,0.466,5,16,0.313,7,13,0.538,90,40,86,0.465,32,65,0.492,8,21,0.381,9,13,0.692,97
1962,NOP,4/4/2015,90,@,POR,0,240,39,85,0.459,32,69,0.464,7,16,0.438,5,10,0.5,90,36,84,0.429,30,68,0.441,6,16,0.375,21,23,0.913,99
1963,MIL,3/22/2015,90,,CLE,0,240,38,70,0.543,35,58,0.603,3,12,0.25,11,14,0.786,90,42,84,0.5,29,53,0.547,13,31,0.419,11,16,0.688,108
1964,MIA,3/9/2015,90,,BOS,0,240,29,69,0.42,25,52,0.481,4,17,0.235,28,34,0.824,90,39,87,0.448,33,62,0.532,6,25,0.24,16,17,0.941,100
1965,LAL,3/6/2015,90,@,MEM,0,240,39,84,0.464,34,72,0.472,5,12,0.417,7,9,0.778,90,34,77,0.442,33,66,0.5,1,11,0.091,28,33,0.848,97
1966,MEM,2/25/2015,90,@,SAC,0,240,34,84,0.405,30,68,0.441,4,16,0.25,18,23,0.783,90,39,80,0.488,33,64,0.516,6,16,0.375,18,25,0.72,102
1967,ORL,2/25/2015,90,,MIA,0,265,33,78,0.423,27,56,0.482,6,22,0.273,18,31,0.581,90,32,84,0.381,26,53,0.491,6,31,0.194,23,32,0.719,93
1968,MEM,2/23/2015,90,@,LAC,1,240,33,81,0.407,28,66,0.424,5,15,0.333,19,26,0.731,90,35,79,0.443,26,52,0.5,9,27,0.333,8,12,0.667,87
1969,UTA,2/23/2015,90,,SAS,1,240,34,83,0.41,30,68,0.441,4,15,0.267,18,23,0.783,90,32,79,0.405,27,60,0.45,5,19,0.263,12,21,0.571,81
1970,SAC,2/7/2015,90,@,UTA,0,240,32,82,0.39,29,69,0.42,3,13,0.231,23,33,0.697,90,43,86,0.5,38,67,0.567,5,19,0.263,11,17,0.647,102
1971,MIN,2/6/2015,90,,MEM,1,240,35,81,0.432,30,64,0.469,5,17,0.294,15,17,0.882,90,36,69,0.522,34,57,0.596,2,12,0.167,15,20,0.75,89
1972,UTA,2/4/2015,90,,MEM,0,240,33,73,0.452,26,50,0.52,7,23,0.304,17,26,0.654,90,38,80,0.475,32,67,0.478,6,13,0.462,18,22,0.818,100
1973,CHI,2/4/2015,90,@,HOU,0,240,31,89,0.348,23,64,0.359,8,25,0.32,20,26,0.769,90,38,92,0.413,30,65,0.462,8,27,0.296,17,23,0.739,101
1974,MIN,1/31/2015,90,,CLE,0,240,34,82,0.415,28,69,0.406,6,13,0.462,16,21,0.762,90,42,87,0.483,32,55,0.582,10,32,0.313,12,19,0.632,106
1975,SAC,1/30/2015,90,@,CLE,0,240,30,84,0.357,27,66,0.409,3,18,0.167,27,32,0.844,90,38,80,0.475,27,49,0.551,11,31,0.355,14,22,0.636,101
1976,DAL,1/27/2015,90,,MEM,0,240,38,78,0.487,31,52,0.596,7,26,0.269,7,10,0.7,90,42,79,0.532,32,58,0.552,10,21,0.476,15,20,0.75,109
1977,UTA,1/26/2015,90,,BOS,0,240,35,82,0.427,26,58,0.448,9,24,0.375,11,19,0.579,90,35,74,0.473,27,55,0.491,8,19,0.421,21,23,0.913,99
1978,CHO,1/23/2015,90,@,CLE,0,240,36,89,0.404,34,73,0.466,2,16,0.125,16,24,0.667,90,46,89,0.517,31,61,0.508,15,28,0.536,22,28,0.786,129
1979,BOS,1/22/2015,90,@,POR,1,240,39,87,0.448,32,68,0.471,7,19,0.368,5,7,0.714,90,33,89,0.371,24,61,0.393,9,28,0.321,14,19,0.737,89
1980,BRK,1/17/2015,90,,WAS,0,240,36,82,0.439,32,65,0.492,4,17,0.235,14,18,0.778,90,40,77,0.519,35,61,0.574,5,16,0.313,14,27,0.519,99
1981,LAC,1/11/2015,90,,MIA,0,240,34,75,0.453,25,49,0.51,9,26,0.346,13,18,0.722,90,39,81,0.481,33,60,0.55,6,21,0.286,20,24,0.833,104
1982,PHI,1/9/2015,90,@,BRK,1,240,36,79,0.456,28,62,0.452,8,17,0.471,10,17,0.588,90,33,73,0.452,30,57,0.526,3,16,0.188,19,27,0.704,88
1983,ORL,1/7/2015,90,@,DEN,0,240,35,88,0.398,27,66,0.409,8,22,0.364,12,16,0.75,90,33,74,0.446,26,57,0.456,7,17,0.412,20,26,0.769,93
1984,CLE,1/4/2015,90,,DAL,0,240,35,86,0.407,27,61,0.443,8,25,0.32,12,17,0.706,90,44,78,0.564,32,52,0.615,12,26,0.462,9,11,0.818,109
1985,ORL,1/3/2015,90,,CHO,0,240,33,87,0.379,29,68,0.426,4,19,0.211,20,21,0.952,90,35,78,0.449,31,62,0.5,4,16,0.25,24,32,0.75,98
1986,IND,12/29/2014,90,,CHI,0,240,36,83,0.434,31,70,0.443,5,13,0.385,13,21,0.619,90,29,84,0.345,24,71,0.338,5,13,0.385,29,33,0.879,92
1987,ATL,12/27/2014,90,@,MIL,1,240,33,90,0.367,24,61,0.393,9,29,0.31,15,19,0.789,90,31,80,0.388,19,50,0.38,12,30,0.4,11,14,0.786,85
1988,SAS,12/26/2014,90,@,NOP,0,240,37,75,0.493,31,61,0.508,6,14,0.429,10,14,0.714,90,35,84,0.417,29,67,0.433,6,17,0.353,21,24,0.875,97
1989,NYK,12/20/2014,90,,PHO,0,240,35,88,0.398,28,66,0.424,7,22,0.318,13,16,0.813,90,35,78,0.449,25,53,0.472,10,25,0.4,19,23,0.826,99
1990,HOU,12/18/2014,90,,NOP,0,240,33,86,0.384,27,61,0.443,6,25,0.24,18,23,0.783,90,38,82,0.463,33,64,0.516,5,18,0.278,18,22,0.818,99
1991,NYK,12/14/2014,90,,TOR,0,265,29,78,0.372,20,49,0.408,9,29,0.31,23,28,0.821,90,36,78,0.462,27,54,0.5,9,24,0.375,14,18,0.778,95
1992,SAC,12/13/2014,90,,DET,0,240,33,93,0.355,22,64,0.344,11,29,0.379,13,19,0.684,90,35,79,0.443,29,59,0.492,6,20,0.3,19,23,0.826,95
1993,MIN,12/10/2014,90,,POR,1,240,32,81,0.395,31,69,0.449,1,12,0.083,25,33,0.758,90,31,80,0.388,21,45,0.467,10,35,0.286,10,12,0.833,82
1994,CLE,12/4/2014,90,@,NYK,1,240,32,70,0.457,27,52,0.519,5,18,0.278,21,26,0.808,90,37,88,0.42,29,62,0.468,8,26,0.308,5,6,0.833,87
1995,PHO,11/30/2014,90,,ORL,0,240,34,85,0.4,27,59,0.458,7,26,0.269,15,18,0.833,90,35,76,0.461,30,61,0.492,5,15,0.333,18,25,0.72,93
1996,PHI,11/19/2014,90,,BOS,0,240,34,86,0.395,27,65,0.415,7,21,0.333,15,21,0.714,90,41,83,0.494,35,63,0.556,6,20,0.3,13,21,0.619,101
1997,ORL,11/19/2014,90,,LAC,0,240,34,86,0.395,26,62,0.419,8,24,0.333,14,18,0.778,90,45,84,0.536,33,63,0.524,12,21,0.571,12,16,0.75,114
1998,CLE,11/19/2014,90,,SAS,0,240,37,83,0.446,30,65,0.462,7,18,0.389,9,13,0.692,90,35,74,0.473,30,58,0.517,5,16,0.313,17,25,0.68,92
1999,CHI,11/15/2014,90,,IND,0,240,35,83,0.422,31,66,0.47,4,17,0.235,16,23,0.696,90,37,77,0.481,30,59,0.508,7,18,0.389,18,25,0.72,99
2000,IND,11/8/2014,90,,WAS,0,240,33,77,0.429,25,53,0.472,8,24,0.333,16,25,0.64,90,39,81,0.481,37,70,0.529,2,11,0.182,17,23,0.739,97
2001,ORL,11/4/2014,90,@,CHI,0,240,38,88,0.432,32,74,0.432,6,14,0.429,8,14,0.571,90,35,75,0.467,28,60,0.467,7,15,0.467,21,27,0.778,98
2002,POR,11/2/2014,90,,GSW,0,240,37,92,0.402,30,65,0.462,7,27,0.259,9,14,0.643,90,36,81,0.444,30,62,0.484,6,19,0.316,17,21,0.81,95
2003,BOS,11/1/2014,90,@,HOU,0,240,37,98,0.378,36,73,0.493,1,25,0.04,15,18,0.833,90,32,76,0.421,20,42,0.476,12,34,0.353,28,40,0.7,104
2004,DET,11/1/2014,90,,BRK,0,240,32,76,0.421,31,59,0.525,1,17,0.059,25,35,0.714,90,42,87,0.483,35,61,0.574,7,26,0.269,11,13,0.846,102
2005,OKC,10/30/2014,90,@,LAC,0,240,28,65,0.431,22,44,0.5,6,21,0.286,28,34,0.824,90,34,87,0.391,27,57,0.474,7,30,0.233,18,25,0.72,93
2006,CLE,10/30/2014,90,,NYK,0,240,32,70,0.457,23,46,0.5,9,24,0.375,17,20,0.85,90,37,69,0.536,31,57,0.544,6,12,0.5,15,18,0.833,95
2007,LAL,10/28/2014,90,,HOU,0,240,28,79,0.354,25,69,0.362,3,10,0.3,31,39,0.795,90,31,73,0.425,19,44,0.432,12,29,0.414,34,50,0.68,108
2008,MEM,4/10/2015,89,@,UTA,1,240,36,76,0.474,31,61,0.508,5,15,0.333,12,19,0.632,89,31,71,0.437,20,48,0.417,11,23,0.478,15,22,0.682,88
2009,CHI,4/9/2015,89,@,MIA,1,240,35,91,0.385,29,68,0.426,6,23,0.261,13,17,0.765,89,34,88,0.386,29,70,0.414,5,18,0.278,5,7,0.714,78
2010,MIA,4/5/2015,89,@,IND,0,240,37,82,0.451,35,62,0.565,2,20,0.1,13,19,0.684,89,37,85,0.435,23,55,0.418,14,30,0.467,24,36,0.667,112
2011,MEM,3/29/2015,89,@,SAS,0,240,36,82,0.439,30,68,0.441,6,14,0.429,11,12,0.917,89,42,83,0.506,38,66,0.576,4,17,0.235,15,18,0.833,103
2012,OKC,3/28/2015,89,@,UTA,0,240,31,73,0.425,25,57,0.439,6,16,0.375,21,32,0.656,89,32,84,0.381,26,55,0.473,6,29,0.207,24,35,0.686,94
2013,UTA,3/25/2015,89,,POR,0,240,35,80,0.438,31,64,0.484,4,16,0.25,15,23,0.652,89,34,81,0.42,27,54,0.5,7,27,0.259,17,20,0.85,92
2014,MEM,3/25/2015,89,,CLE,0,240,37,85,0.435,33,68,0.485,4,17,0.235,11,16,0.688,89,43,84,0.512,29,50,0.58,14,34,0.412,11,13,0.846,111
2015,MIL,3/24/2015,89,,MIA,1,240,36,87,0.414,32,70,0.457,4,17,0.235,13,17,0.765,89,33,75,0.44,25,56,0.446,8,19,0.421,14,18,0.778,88
2016,NYK,3/22/2015,89,@,TOR,0,240,35,84,0.417,27,65,0.415,8,19,0.421,11,16,0.688,89,39,75,0.52,35,64,0.547,4,11,0.364,24,29,0.828,106
2017,BOS,3/20/2015,89,@,SAS,0,240,35,88,0.398,30,68,0.441,5,20,0.25,14,20,0.7,89,38,81,0.469,33,58,0.569,5,23,0.217,20,23,0.87,101
2018,PHI,3/16/2015,89,@,BOS,0,240,34,84,0.405,26,60,0.433,8,24,0.333,13,24,0.542,89,44,88,0.5,36,68,0.529,8,20,0.4,12,15,0.8,108
2019,NYK,3/15/2015,89,@,PHO,0,240,32,73,0.438,27,59,0.458,5,14,0.357,20,30,0.667,89,41,83,0.494,35,65,0.538,6,18,0.333,14,23,0.609,102
2020,IND,3/14/2015,89,,BOS,0,240,34,85,0.4,25,61,0.41,9,24,0.375,12,15,0.8,89,35,83,0.422,27,55,0.491,8,28,0.286,15,21,0.714,93
2021,LAC,3/9/2015,89,,MIN,1,240,35,79,0.443,24,48,0.5,11,31,0.355,8,15,0.533,89,31,83,0.373,29,75,0.387,2,8,0.25,12,21,0.571,76
2022,MEM,3/7/2015,89,@,NOP,0,240,32,74,0.432,26,58,0.448,6,16,0.375,19,29,0.655,89,38,80,0.475,30,57,0.526,8,23,0.348,11,13,0.846,95
2023,CLE,3/7/2015,89,,PHO,1,240,31,75,0.413,23,55,0.418,8,20,0.4,19,23,0.826,89,30,84,0.357,21,59,0.356,9,25,0.36,10,14,0.714,79
2024,DAL,3/6/2015,89,@,GSW,0,240,32,87,0.368,26,67,0.388,6,20,0.3,19,26,0.731,89,38,81,0.469,27,58,0.466,11,23,0.478,17,19,0.895,104
2025,UTA,3/6/2015,89,@,PHI,1,240,27,71,0.38,21,59,0.356,6,12,0.5,29,41,0.707,89,32,88,0.364,22,56,0.393,10,32,0.313,9,18,0.5,83
2026,MIN,2/27/2015,89,@,CHI,0,240,33,77,0.429,31,63,0.492,2,14,0.143,21,31,0.677,89,37,96,0.385,28,65,0.431,9,31,0.29,13,16,0.813,96
2027,TOR,2/27/2015,89,,GSW,0,240,31,77,0.403,27,55,0.491,4,22,0.182,23,28,0.821,89,42,87,0.483,29,59,0.492,13,28,0.464,16,19,0.842,113
2028,PHI,2/27/2015,89,,WAS,1,240,28,80,0.35,16,47,0.34,12,33,0.364,21,34,0.618,89,30,93,0.323,26,76,0.342,4,17,0.235,17,22,0.773,81
2029,WAS,2/22/2015,89,@,DET,0,240,37,85,0.435,31,68,0.456,6,17,0.353,9,14,0.643,89,37,89,0.416,24,57,0.421,13,32,0.406,19,25,0.76,106
2030,MIL,2/20/2015,89,,DEN,1,240,33,78,0.423,28,63,0.444,5,15,0.333,18,22,0.818,89,30,84,0.357,23,58,0.397,7,26,0.269,14,21,0.667,81
2031,WAS,2/20/2015,89,,CLE,0,240,38,86,0.442,37,70,0.529,1,16,0.063,12,16,0.75,89,46,90,0.511,32,57,0.561,14,33,0.424,21,28,0.75,127
2032,DAL,2/19/2015,89,@,OKC,0,240,33,91,0.363,24,64,0.375,9,27,0.333,14,17,0.824,89,38,91,0.418,31,69,0.449,7,22,0.318,21,26,0.808,104
2033,ORL,2/11/2015,89,,NYK,1,240,31,67,0.463,27,56,0.482,4,11,0.364,23,28,0.821,89,25,73,0.342,20,58,0.345,5,15,0.333,28,36,0.778,83
2034,MEM,2/11/2015,89,@,OKC,0,240,32,86,0.372,30,74,0.405,2,12,0.167,23,30,0.767,89,37,83,0.446,30,63,0.476,7,20,0.35,24,25,0.96,105
2035,BOS,2/11/2015,89,,ATL,1,240,30,93,0.323,20,62,0.323,10,31,0.323,19,20,0.95,89,33,78,0.423,26,49,0.531,7,29,0.241,15,23,0.652,88
2036,GSW,2/9/2015,89,@,PHI,1,240,34,85,0.4,27,56,0.482,7,29,0.241,14,19,0.737,89,33,79,0.418,26,55,0.473,7,24,0.292,11,14,0.786,84
2037,PHI,2/7/2015,89,,CHO,1,240,29,74,0.392,20,51,0.392,9,23,0.391,22,30,0.733,89,29,84,0.345,23,61,0.377,6,23,0.261,17,20,0.85,81
2038,MEM,2/6/2015,89,@,MIN,0,240,36,69,0.522,34,57,0.596,2,12,0.167,15,20,0.75,89,35,81,0.432,30,64,0.469,5,17,0.294,15,17,0.882,90
2039,PHI,1/28/2015,89,,DET,1,240,37,78,0.474,30,57,0.526,7,21,0.333,8,12,0.667,89,23,75,0.307,21,55,0.382,2,20,0.1,21,23,0.913,69
2040,UTA,1/28/2015,89,,LAC,0,240,35,81,0.432,30,57,0.526,5,24,0.208,14,20,0.7,89,34,76,0.447,25,50,0.5,9,26,0.346,17,25,0.68,94
2041,MIA,1/23/2015,89,,IND,1,240,36,75,0.48,32,58,0.552,4,17,0.235,13,15,0.867,89,32,78,0.41,29,63,0.46,3,15,0.2,20,23,0.87,87
2042,POR,1/22/2015,89,,BOS,0,240,33,89,0.371,24,61,0.393,9,28,0.321,14,19,0.737,89,39,87,0.448,32,68,0.471,7,19,0.368,5,7,0.714,90
2043,MIL,1/19/2015,89,,TOR,0,240,34,76,0.447,29,58,0.5,5,18,0.278,16,25,0.64,89,36,90,0.4,30,66,0.455,6,24,0.25,14,24,0.583,92
2044,SAS,1/18/2015,89,,UTA,1,240,31,80,0.388,23,63,0.365,8,17,0.471,19,23,0.826,89,28,84,0.333,25,74,0.338,3,10,0.3,10,16,0.625,69
2045,PHI,1/17/2015,89,@,DET,0,240,38,82,0.463,31,54,0.574,7,28,0.25,6,7,0.857,89,38,88,0.432,23,53,0.434,15,35,0.429,16,19,0.842,107
2046,TOR,1/16/2015,89,,ATL,0,240,35,82,0.427,29,57,0.509,6,25,0.24,13,17,0.765,89,42,69,0.609,30,46,0.652,12,23,0.522,14,16,0.875,110
2047,DEN,1/16/2015,89,@,DAL,0,240,34,83,0.41,25,58,0.431,9,25,0.36,12,25,0.48,89,33,79,0.418,25,54,0.463,8,25,0.32,23,29,0.793,97
2048,MIA,1/14/2015,89,@,GSW,0,240,30,71,0.423,24,53,0.453,6,18,0.333,23,27,0.852,89,38,81,0.469,25,52,0.481,13,29,0.448,15,19,0.789,104
2049,WAS,1/11/2015,89,@,ATL,0,240,36,76,0.474,31,56,0.554,5,20,0.25,12,15,0.8,89,42,89,0.472,26,58,0.448,16,31,0.516,20,24,0.833,120
2050,LAL,1/7/2015,89,@,LAC,0,240,37,85,0.435,32,65,0.492,5,20,0.25,10,17,0.588,89,40,85,0.471,28,52,0.538,12,33,0.364,22,30,0.733,114
2051,BOS,1/7/2015,89,@,BRK,1,240,35,88,0.398,30,70,0.429,5,18,0.278,14,17,0.824,89,30,74,0.405,27,60,0.45,3,14,0.214,18,26,0.692,81
2052,MIN,1/3/2015,89,,UTA,0,240,34,86,0.395,28,67,0.418,6,19,0.316,15,18,0.833,89,38,75,0.507,27,55,0.491,11,20,0.55,14,21,0.667,101
2053,ORL,12/26/2014,89,,CLE,0,240,36,73,0.493,27,52,0.519,9,21,0.429,8,12,0.667,89,33,80,0.413,25,50,0.5,8,30,0.267,24,26,0.923,98
2054,BRK,12/17/2014,89,@,TOR,0,240,35,81,0.432,26,54,0.481,9,27,0.333,10,22,0.455,89,41,80,0.513,31,60,0.517,10,20,0.5,13,19,0.684,105
2055,ORL,12/10/2014,89,,WAS,0,240,38,84,0.452,31,69,0.449,7,15,0.467,6,9,0.667,89,41,81,0.506,36,69,0.522,5,12,0.417,4,9,0.444,91
2056,DEN,12/5/2014,89,@,WAS,0,240,31,82,0.378,26,60,0.433,5,22,0.227,22,30,0.733,89,45,85,0.529,38,65,0.585,7,20,0.35,22,27,0.815,119
2057,BOS,11/30/2014,89,,SAS,0,240,36,87,0.414,30,69,0.435,6,18,0.333,11,15,0.733,89,41,85,0.482,30,59,0.508,11,26,0.423,18,20,0.9,111
2058,SAC,11/26/2014,89,@,HOU,0,240,31,71,0.437,26,55,0.473,5,16,0.313,22,28,0.786,89,42,94,0.447,30,59,0.508,12,35,0.343,6,15,0.4,102
2059,NOP,11/25/2014,89,,SAC,0,240,33,79,0.418,30,62,0.484,3,17,0.176,20,29,0.69,89,37,77,0.481,32,63,0.508,5,14,0.357,20,24,0.833,99
2060,DET,11/21/2014,89,@,ATL,0,240,31,83,0.373,27,62,0.435,4,21,0.19,23,24,0.958,89,38,80,0.475,33,56,0.589,5,24,0.208,18,26,0.692,99
2061,LAC,11/17/2014,89,,CHI,0,240,36,81,0.444,29,58,0.5,7,23,0.304,10,22,0.455,89,39,80,0.488,29,54,0.537,10,26,0.385,17,25,0.68,105
2062,OKC,11/14/2014,89,,DET,0,265,38,96,0.396,26,60,0.433,12,36,0.333,1,6,0.167,89,38,89,0.427,27,58,0.466,11,31,0.355,9,15,0.6,96
2063,SAS,11/10/2014,89,@,LAC,1,240,33,83,0.398,31,64,0.484,2,19,0.105,21,27,0.778,89,33,74,0.446,28,52,0.538,5,22,0.227,14,17,0.824,85
2064,OKC,11/7/2014,89,,MEM,0,240,37,79,0.468,25,54,0.463,12,25,0.48,3,11,0.273,89,34,81,0.42,25,63,0.397,9,18,0.5,14,17,0.824,91
2065,MIA,11/5/2014,89,@,CHO,0,240,30,77,0.39,26,55,0.473,4,22,0.182,25,31,0.806,89,35,82,0.427,30,64,0.469,5,18,0.278,21,29,0.724,96
2066,PHI,11/5/2014,89,,ORL,0,240,33,77,0.429,25,52,0.481,8,25,0.32,15,23,0.652,89,39,88,0.443,36,68,0.529,3,20,0.15,10,12,0.833,91
2067,SAS,10/31/2014,89,@,PHO,0,240,32,78,0.41,24,53,0.453,8,25,0.32,17,23,0.739,89,35,87,0.402,33,69,0.478,2,18,0.111,22,26,0.846,94
2068,IND,10/31/2014,89,,MEM,0,240,34,74,0.459,26,53,0.491,8,21,0.381,13,16,0.813,89,35,79,0.443,28,60,0.467,7,19,0.368,20,27,0.741,97
2069,OKC,10/29/2014,89,@,POR,0,240,33,81,0.407,31,65,0.477,2,16,0.125,21,26,0.808,89,39,87,0.448,28,58,0.483,11,29,0.379,17,22,0.773,106
2070,DEN,10/29/2014,89,,DET,1,240,30,85,0.353,24,61,0.393,6,24,0.25,23,31,0.742,89,31,84,0.369,25,58,0.431,6,26,0.231,11,19,0.579,79
2071,ORL,4/15/2015,88,@,BRK,0,240,38,79,0.481,31,59,0.525,7,20,0.35,5,13,0.385,88,39,80,0.488,30,56,0.536,9,24,0.375,14,23,0.609,101
2072,MIN,4/13/2015,88,,NOP,0,240,31,78,0.397,27,64,0.422,4,14,0.286,22,28,0.786,88,37,84,0.44,31,63,0.492,6,21,0.286,20,24,0.833,100
2073,UTA,4/10/2015,88,,MEM,0,240,31,71,0.437,20,48,0.417,11,23,0.478,15,22,0.682,88,36,76,0.474,31,61,0.508,5,15,0.333,12,19,0.632,89
2074,OKC,4/7/2015,88,,SAS,0,240,34,84,0.405,29,65,0.446,5,19,0.263,15,28,0.536,88,47,89,0.528,37,65,0.569,10,24,0.417,9,13,0.692,113
2075,CHI,4/3/2015,88,,DET,1,240,33,85,0.388,29,68,0.426,4,17,0.235,18,21,0.857,88,32,74,0.432,26,55,0.473,6,19,0.316,12,15,0.8,82
2076,MIA,4/2/2015,88,@,CLE,0,240,32,75,0.427,25,54,0.463,7,21,0.333,17,21,0.81,88,40,80,0.5,25,45,0.556,15,35,0.429,19,25,0.76,114
2077,MIL,3/30/2015,88,@,ATL,0,240,34,75,0.453,30,58,0.517,4,17,0.235,16,23,0.696,88,36,79,0.456,27,50,0.54,9,29,0.31,20,24,0.833,101
2078,MIN,3/29/2015,88,@,NOP,0,240,32,75,0.427,30,63,0.476,2,12,0.167,22,24,0.917,88,43,75,0.573,37,62,0.597,6,13,0.462,18,24,0.75,110
2079,SAC,3/27/2015,88,@,NOP,0,240,35,79,0.443,28,64,0.438,7,15,0.467,11,18,0.611,88,43,84,0.512,34,64,0.531,9,20,0.45,7,12,0.583,102
2080,CHO,3/25/2015,88,,BRK,0,240,36,91,0.396,33,79,0.418,3,12,0.25,13,20,0.65,88,39,91,0.429,36,77,0.468,3,14,0.214,10,11,0.909,91
2081,MIA,3/24/2015,88,@,MIL,0,240,33,75,0.44,25,56,0.446,8,19,0.421,14,18,0.778,88,36,87,0.414,32,70,0.457,4,17,0.235,13,17,0.765,89
2082,WAS,3/18/2015,88,@,UTA,1,240,33,63,0.524,27,52,0.519,6,11,0.545,16,23,0.696,88,34,82,0.415,30,60,0.5,4,22,0.182,12,24,0.5,84
2083,UTA,3/14/2015,88,,DET,1,240,33,69,0.478,27,55,0.491,6,14,0.429,16,24,0.667,88,32,84,0.381,24,61,0.393,8,23,0.348,13,22,0.591,85
2084,ORL,3/13/2015,88,@,BOS,0,240,34,80,0.425,28,60,0.467,6,20,0.3,14,28,0.5,88,37,86,0.43,27,60,0.45,10,26,0.385,11,20,0.55,95
2085,BRK,3/8/2015,88,,UTA,0,240,38,76,0.5,30,61,0.492,8,15,0.533,4,11,0.364,88,34,72,0.472,24,50,0.48,10,22,0.455,17,21,0.81,95
2086,NOP,3/4/2015,88,,DET,1,240,37,90,0.411,35,78,0.449,2,12,0.167,12,16,0.75,88,38,93,0.409,36,79,0.456,2,14,0.143,7,9,0.778,85
2087,ORL,2/27/2015,88,@,ATL,0,240,36,80,0.45,27,54,0.5,9,26,0.346,7,13,0.538,88,36,81,0.444,22,50,0.44,14,31,0.452,9,12,0.75,95
2088,PHI,2/25/2015,88,@,MIL,0,240,31,75,0.413,20,50,0.4,11,25,0.44,15,19,0.789,88,44,82,0.537,39,67,0.582,5,15,0.333,11,16,0.688,104
2089,ATL,2/11/2015,88,@,BOS,0,240,33,78,0.423,26,49,0.531,7,29,0.241,15,23,0.652,88,30,93,0.323,20,62,0.323,10,31,0.323,19,20,0.95,89
2090,ATL,2/8/2015,88,@,MEM,0,240,33,80,0.413,21,50,0.42,12,30,0.4,10,11,0.909,88,36,92,0.391,33,79,0.418,3,13,0.231,19,21,0.905,94
2091,NYK,2/6/2015,88,@,BRK,0,240,34,89,0.382,28,65,0.431,6,24,0.25,14,17,0.824,88,37,74,0.5,34,63,0.54,3,11,0.273,15,22,0.682,92
2092,DEN,2/6/2015,88,@,DET,0,240,33,85,0.388,28,63,0.444,5,22,0.227,17,22,0.773,88,37,82,0.451,33,58,0.569,4,24,0.167,20,26,0.769,98
2093,WAS,2/2/2015,88,,CHO,0,240,33,81,0.407,27,66,0.409,6,15,0.4,16,19,0.842,88,37,79,0.468,33,64,0.516,4,15,0.267,14,19,0.737,92
2094,POR,1/31/2015,88,@,MIL,0,240,33,89,0.371,24,58,0.414,9,31,0.29,13,18,0.722,88,37,82,0.451,29,61,0.475,8,21,0.381,13,14,0.929,95
2095,BRK,1/9/2015,88,,PHI,0,240,33,73,0.452,30,57,0.526,3,16,0.188,19,27,0.704,88,36,79,0.456,28,62,0.452,8,17,0.471,10,17,0.588,90
2096,BRK,1/5/2015,88,,DAL,0,265,33,84,0.393,30,59,0.508,3,25,0.12,19,23,0.826,88,37,94,0.394,27,67,0.403,10,27,0.37,12,19,0.632,96
2097,LAL,1/4/2015,88,,IND,1,240,27,71,0.38,21,53,0.396,6,18,0.333,28,30,0.933,88,33,90,0.367,25,62,0.403,8,28,0.286,13,18,0.722,87
2098,MIA,1/4/2015,88,,BRK,1,240,31,67,0.463,26,53,0.491,5,14,0.357,21,28,0.75,88,34,86,0.395,27,62,0.435,7,24,0.292,9,13,0.692,84
2099,BOS,12/27/2014,88,@,WAS,0,240,32,79,0.405,26,55,0.473,6,24,0.25,18,24,0.75,88,45,90,0.5,40,77,0.519,5,13,0.385,6,10,0.6,101
2100,UTA,12/27/2014,88,,PHI,1,240,30,84,0.357,26,61,0.426,4,23,0.174,24,28,0.857,88,24,74,0.324,19,48,0.396,5,26,0.192,18,28,0.643,71
2101,ORL,12/21/2014,88,,PHI,0,240,35,84,0.417,28,61,0.459,7,23,0.304,11,20,0.55,88,35,82,0.427,29,59,0.492,6,23,0.261,20,25,0.8,96
2102,NOP,12/20/2014,88,,POR,0,240,30,85,0.353,27,70,0.386,3,15,0.2,25,28,0.893,88,48,90,0.533,39,65,0.6,9,25,0.36,9,15,0.6,114
2103,CHO,12/15/2014,88,@,CLE,0,240,38,83,0.458,33,67,0.493,5,16,0.313,7,14,0.5,88,38,83,0.458,29,59,0.492,9,24,0.375,12,17,0.706,97
2104,PHO,12/14/2014,88,@,OKC,0,240,34,99,0.343,27,68,0.397,7,31,0.226,13,18,0.722,88,39,80,0.488,35,62,0.565,4,18,0.222,30,34,0.882,112
2105,BRK,12/12/2014,88,,PHI,1,240,36,81,0.444,31,61,0.508,5,20,0.25,11,17,0.647,88,22,69,0.319,11,41,0.268,11,28,0.393,15,20,0.75,70
2106,BRK,12/8/2014,88,,CLE,0,240,36,81,0.444,32,62,0.516,4,19,0.211,12,19,0.632,88,43,90,0.478,34,65,0.523,9,25,0.36,15,22,0.682,110
2107,POR,12/4/2014,88,,IND,1,240,33,83,0.398,29,62,0.468,4,21,0.19,18,23,0.783,88,36,91,0.396,31,73,0.425,5,18,0.278,5,8,0.625,82
2108,DET,11/28/2014,88,,MIL,0,240,34,83,0.41,28,60,0.467,6,23,0.261,14,25,0.56,88,39,77,0.506,26,48,0.542,13,29,0.448,13,16,0.813,104
2109,BOS,11/23/2014,88,,POR,0,240,37,95,0.389,32,72,0.444,5,23,0.217,9,12,0.75,88,37,86,0.43,30,67,0.448,7,19,0.368,13,15,0.867,94
2110,UTA,11/21/2014,88,@,GSW,0,240,35,82,0.427,29,65,0.446,6,17,0.353,12,19,0.632,88,41,82,0.5,35,59,0.593,6,23,0.261,13,19,0.684,101
2111,CHI,11/20/2014,88,@,SAC,0,240,36,84,0.429,31,65,0.477,5,19,0.263,11,16,0.688,88,38,74,0.514,34,68,0.5,4,6,0.667,23,27,0.852,103
2112,PHO,11/19/2014,88,@,DET,1,240,37,75,0.493,33,60,0.55,4,15,0.267,10,13,0.769,88,33,87,0.379,26,62,0.419,7,25,0.28,13,19,0.684,86
2113,IND,11/19/2014,88,,CHO,1,240,35,78,0.449,33,63,0.524,2,15,0.133,16,24,0.667,88,37,86,0.43,32,72,0.444,5,14,0.357,7,12,0.583,86
2114,DET,11/15/2014,88,@,MEM,0,240,34,82,0.415,24,56,0.429,10,26,0.385,10,17,0.588,88,32,86,0.372,28,71,0.394,4,15,0.267,27,33,0.818,95
2115,HOU,11/14/2014,88,,PHI,1,240,29,78,0.372,22,44,0.5,7,34,0.206,23,37,0.622,88,34,80,0.425,27,59,0.458,7,21,0.333,12,18,0.667,87
2116,PHI,11/9/2014,88,@,TOR,0,240,33,87,0.379,23,53,0.434,10,34,0.294,12,18,0.667,88,43,76,0.566,36,59,0.61,7,17,0.412,27,30,0.9,120
2117,OKC,11/4/2014,88,@,TOR,0,240,34,65,0.523,28,44,0.636,6,21,0.286,14,25,0.56,88,32,81,0.395,24,50,0.48,8,31,0.258,28,33,0.848,100
2118,CHO,4/15/2015,87,@,TOR,0,240,30,71,0.423,18,38,0.474,12,33,0.364,15,16,0.938,87,38,77,0.494,26,44,0.591,12,33,0.364,4,4,1,92
2119,PHO,4/4/2015,87,,UTA,1,240,30,69,0.435,25,55,0.455,5,14,0.357,22,29,0.759,87,29,74,0.392,22,53,0.415,7,21,0.333,20,24,0.833,85
2120,NYK,4/3/2015,87,@,WAS,0,240,31,84,0.369,24,63,0.381,7,21,0.333,18,20,0.9,87,43,93,0.462,36,77,0.468,7,16,0.438,8,12,0.667,101
2121,IND,4/1/2015,87,@,BOS,0,240,34,81,0.42,28,66,0.424,6,15,0.4,13,23,0.565,87,39,86,0.453,33,59,0.559,6,27,0.222,16,18,0.889,100
2122,CLE,3/29/2015,87,,PHI,1,240,33,85,0.388,24,62,0.387,9,23,0.391,12,18,0.667,87,34,84,0.405,24,54,0.444,10,30,0.333,8,15,0.533,86
2123,POR,3/27/2015,87,@,PHO,1,240,36,89,0.404,29,63,0.46,7,26,0.269,8,18,0.444,87,32,87,0.368,26,67,0.388,6,20,0.3,11,12,0.917,81
2124,PHI,3/22/2015,87,@,LAL,0,240,32,89,0.36,23,62,0.371,9,27,0.333,14,21,0.667,87,39,81,0.481,34,67,0.507,5,14,0.357,18,22,0.818,101
2125,PHI,3/14/2015,87,,BRK,0,240,35,94,0.372,27,57,0.474,8,37,0.216,9,14,0.643,87,37,84,0.44,35,67,0.522,2,17,0.118,18,26,0.692,94
2126,PHO,3/13/2015,87,,ATL,0,240,32,78,0.41,22,52,0.423,10,26,0.385,13,21,0.619,87,39,83,0.47,31,65,0.477,8,18,0.444,10,12,0.833,96
2127,MEM,3/12/2015,87,@,WAS,0,240,31,80,0.388,28,61,0.459,3,19,0.158,22,30,0.733,87,40,80,0.5,35,63,0.556,5,17,0.294,22,31,0.71,107
2128,UTA,3/10/2015,87,,NYK,1,240,30,70,0.429,24,52,0.462,6,18,0.333,21,29,0.724,87,31,79,0.392,26,66,0.394,5,13,0.385,15,17,0.882,82
2129,DAL,2/25/2015,87,@,ATL,0,240,34,80,0.425,29,49,0.592,5,31,0.161,14,18,0.778,87,39,85,0.459,26,50,0.52,13,35,0.371,13,16,0.813,104
2130,CHI,2/23/2015,87,,MIL,1,240,27,76,0.355,19,50,0.38,8,26,0.308,25,32,0.781,87,30,89,0.337,26,71,0.366,4,18,0.222,7,13,0.538,71
2131,LAC,2/23/2015,87,,MEM,0,240,35,79,0.443,26,52,0.5,9,27,0.333,8,12,0.667,87,33,81,0.407,28,66,0.424,5,15,0.333,19,26,0.731,90
2132,NYK,2/20/2015,87,,MIA,0,240,35,82,0.427,29,64,0.453,6,18,0.333,11,16,0.688,87,38,79,0.481,29,59,0.492,9,20,0.45,26,35,0.743,111
2133,DAL,2/11/2015,87,,UTA,1,240,28,75,0.373,18,47,0.383,10,28,0.357,21,26,0.808,87,30,80,0.375,19,51,0.373,11,29,0.379,11,21,0.524,82
2134,DET,2/11/2015,87,,SAS,0,240,33,81,0.407,24,60,0.4,9,21,0.429,12,17,0.706,87,42,88,0.477,32,61,0.525,10,27,0.37,10,11,0.909,104
2135,TOR,2/8/2015,87,,SAS,1,240,32,74,0.432,28,61,0.459,4,13,0.308,19,24,0.792,87,31,93,0.333,24,65,0.369,7,28,0.25,13,16,0.813,82
2136,PHO,2/5/2015,87,@,POR,0,240,34,88,0.386,28,65,0.431,6,23,0.261,13,17,0.765,87,40,90,0.444,32,59,0.542,8,31,0.258,20,23,0.87,108
2137,WAS,2/5/2015,87,@,CHO,0,240,35,84,0.417,30,74,0.405,5,10,0.5,12,17,0.706,87,33,76,0.434,27,51,0.529,6,25,0.24,22,27,0.815,94
2138,PHO,1/31/2015,87,@,GSW,0,240,33,91,0.363,24,65,0.369,9,26,0.346,12,17,0.706,87,40,87,0.46,28,55,0.509,12,32,0.375,14,18,0.778,106
2139,BOS,1/30/2015,87,,HOU,0,240,32,90,0.356,25,66,0.379,7,24,0.292,16,23,0.696,87,35,84,0.417,27,54,0.5,8,30,0.267,15,20,0.75,93
2140,LAL,1/25/2015,87,,HOU,0,240,34,79,0.43,33,66,0.5,1,13,0.077,18,25,0.72,87,35,87,0.402,22,43,0.512,13,44,0.295,16,21,0.762,99
2141,IND,1/23/2015,87,@,MIA,0,240,32,78,0.41,29,63,0.46,3,15,0.2,20,23,0.87,87,36,75,0.48,32,58,0.552,4,17,0.235,13,15,0.867,89
2142,PHI,1/13/2015,87,,ATL,0,240,31,76,0.408,22,51,0.431,9,25,0.36,16,25,0.64,87,42,87,0.483,30,64,0.469,12,23,0.522,9,16,0.563,105
2143,MIL,1/10/2015,87,@,CHI,0,240,36,81,0.444,33,70,0.471,3,11,0.273,12,16,0.75,87,35,88,0.398,31,71,0.437,4,17,0.235,21,24,0.875,95
2144,IND,1/4/2015,87,@,LAL,0,240,33,90,0.367,25,62,0.403,8,28,0.286,13,18,0.722,87,27,71,0.38,21,53,0.396,6,18,0.333,28,30,0.933,88
2145,CHO,1/2/2015,87,,CLE,0,240,32,87,0.368,26,59,0.441,6,28,0.214,17,26,0.654,87,33,87,0.379,29,72,0.403,4,15,0.267,21,30,0.7,91
2146,SAS,12/30/2014,87,@,MEM,0,240,35,78,0.449,30,56,0.536,5,22,0.227,12,17,0.706,87,35,72,0.486,28,57,0.491,7,15,0.467,18,22,0.818,95
2147,WAS,12/30/2014,87,@,DAL,0,240,33,74,0.446,29,62,0.468,4,12,0.333,17,27,0.63,87,43,82,0.524,35,67,0.522,8,15,0.533,20,29,0.69,114
2148,MIA,12/23/2014,87,,PHI,0,240,33,80,0.413,25,54,0.463,8,26,0.308,13,18,0.722,87,33,77,0.429,28,58,0.483,5,19,0.263,20,27,0.741,91
2149,MIA,12/17/2014,87,,UTA,0,240,27,70,0.386,23,53,0.434,4,17,0.235,29,40,0.725,87,35,66,0.53,21,41,0.512,14,25,0.56,21,24,0.875,105
2150,NYK,12/16/2014,87,,DAL,0,240,37,84,0.44,32,63,0.508,5,21,0.238,8,10,0.8,87,42,83,0.506,27,50,0.54,15,33,0.455,8,8,1,107
2151,PHI,12/15/2014,87,,BOS,0,240,33,93,0.355,29,65,0.446,4,28,0.143,17,21,0.81,87,38,86,0.442,32,61,0.525,6,25,0.24,23,35,0.657,105
2152,CHO,12/13/2014,87,,BRK,0,240,31,79,0.392,23,57,0.404,8,22,0.364,17,27,0.63,87,42,72,0.583,26,49,0.531,16,23,0.696,14,20,0.7,114
2153,ATL,12/12/2014,87,,ORL,1,240,29,78,0.372,20,49,0.408,9,29,0.31,20,27,0.741,87,30,77,0.39,21,51,0.412,9,26,0.346,12,16,0.75,81
2154,BOS,12/10/2014,87,@,CHO,0,240,38,87,0.437,33,64,0.516,5,23,0.217,6,10,0.6,87,35,84,0.417,32,70,0.457,3,14,0.214,23,29,0.793,96
2155,MIA,12/7/2014,87,@,MEM,0,240,39,80,0.488,34,64,0.531,5,16,0.313,4,8,0.5,87,43,73,0.589,35,60,0.583,8,13,0.615,9,11,0.818,103
2156,LAL,12/7/2014,87,,NOP,0,240,36,90,0.4,31,71,0.437,5,19,0.263,10,15,0.667,87,43,83,0.518,35,65,0.538,8,18,0.444,10,15,0.667,104
2157,NYK,12/4/2014,87,,CLE,0,240,37,88,0.42,29,62,0.468,8,26,0.308,5,6,0.833,87,32,70,0.457,27,52,0.519,5,18,0.278,21,26,0.808,90
2158,WAS,11/26/2014,87,@,CLE,0,240,33,71,0.465,28,58,0.483,5,13,0.385,16,22,0.727,87,38,74,0.514,32,54,0.593,6,20,0.3,31,38,0.816,113
2159,BRK,11/22/2014,87,@,SAS,0,240,34,91,0.374,25,64,0.391,9,27,0.333,10,10,1,87,41,79,0.519,33,58,0.569,8,21,0.381,9,11,0.818,99
2160,CHI,11/21/2014,87,@,POR,0,240,30,83,0.361,22,61,0.361,8,22,0.364,19,28,0.679,87,39,79,0.494,30,63,0.476,9,16,0.563,18,22,0.818,105
2161,BRK,11/15/2014,87,@,POR,0,240,35,89,0.393,34,70,0.486,1,19,0.053,16,17,0.941,87,33,78,0.423,22,52,0.423,11,26,0.423,20,27,0.741,97
2162,CHO,11/15/2014,87,@,GSW,0,240,32,84,0.381,25,67,0.373,7,17,0.412,16,28,0.571,87,45,87,0.517,34,61,0.557,11,26,0.423,11,14,0.786,112
2163,IND,11/14/2014,87,,DEN,0,240,34,84,0.405,26,62,0.419,8,22,0.364,11,22,0.5,87,43,87,0.494,35,64,0.547,8,23,0.348,14,25,0.56,108
2164,PHI,11/14/2014,87,@,HOU,0,240,34,80,0.425,27,59,0.458,7,21,0.333,12,18,0.667,87,29,78,0.372,22,44,0.5,7,34,0.206,23,37,0.622,88
2165,HOU,11/8/2014,87,,GSW,0,240,30,86,0.349,20,44,0.455,10,42,0.238,17,21,0.81,87,39,87,0.448,30,59,0.508,9,28,0.321,11,17,0.647,98
2166,DAL,11/6/2014,87,@,POR,0,240,33,90,0.367,28,67,0.418,5,23,0.217,16,16,1,87,40,77,0.519,28,47,0.596,12,30,0.4,16,19,0.842,108
2167,MIL,11/4/2014,87,@,IND,1,240,37,83,0.446,30,62,0.484,7,21,0.333,6,7,0.857,87,31,78,0.397,25,54,0.463,6,24,0.25,13,22,0.591,81
2168,BRK,4/13/2015,86,,CHI,0,240,32,87,0.368,29,75,0.387,3,12,0.25,19,22,0.864,86,44,88,0.5,32,58,0.552,12,30,0.4,13,17,0.765,113
2169,MEM,4/11/2015,86,@,LAC,0,240,34,77,0.442,32,68,0.471,2,9,0.222,16,24,0.667,86,35,88,0.398,29,61,0.475,6,27,0.222,18,22,0.818,94
2170,NYK,4/8/2015,86,,IND,0,240,29,84,0.345,22,67,0.328,7,17,0.412,21,26,0.808,86,38,77,0.494,34,55,0.618,4,22,0.182,22,27,0.815,102
2171,PHO,3/30/2015,86,@,POR,0,240,38,87,0.437,35,71,0.493,3,16,0.188,7,10,0.7,86,44,86,0.512,32,59,0.542,12,27,0.444,9,10,0.9,109
2172,PHI,3/29/2015,86,@,CLE,0,240,34,84,0.405,24,54,0.444,10,30,0.333,8,15,0.533,86,33,85,0.388,24,62,0.387,9,23,0.391,12,18,0.667,87
2173,MIA,3/27/2015,86,@,ATL,0,240,32,82,0.39,21,47,0.447,11,35,0.314,11,15,0.733,86,37,72,0.514,31,54,0.574,6,18,0.333,19,24,0.792,99
2174,BOS,3/25/2015,86,,MIA,0,240,28,69,0.406,23,50,0.46,5,19,0.263,25,37,0.676,86,34,77,0.442,25,53,0.472,9,24,0.375,16,23,0.696,93
2175,CHO,3/23/2015,86,@,CHI,0,240,28,81,0.346,20,61,0.328,8,20,0.4,22,28,0.786,86,37,82,0.451,34,66,0.515,3,16,0.188,21,29,0.724,98
2176,WAS,3/22/2015,86,@,SAC,0,240,35,87,0.402,32,70,0.457,3,17,0.176,13,18,0.722,86,40,79,0.506,32,62,0.516,8,17,0.471,21,23,0.913,109
2177,POR,3/21/2015,86,@,MEM,0,240,33,76,0.434,27,54,0.5,6,22,0.273,14,15,0.933,86,37,89,0.416,26,71,0.366,11,18,0.611,12,16,0.75,97
2178,IND,3/18/2015,86,@,CHI,0,240,32,81,0.395,26,62,0.419,6,19,0.316,16,21,0.762,86,34,82,0.415,24,58,0.414,10,24,0.417,25,28,0.893,103
2179,LAL,3/15/2015,86,,ATL,0,240,34,85,0.4,27,67,0.403,7,18,0.389,11,15,0.733,86,34,76,0.447,29,53,0.547,5,23,0.217,18,27,0.667,91
2180,ORL,3/10/2015,86,@,IND,0,240,34,92,0.37,30,75,0.4,4,17,0.235,14,20,0.7,86,45,85,0.529,28,51,0.549,17,34,0.5,11,12,0.917,118
2181,NYK,3/7/2015,86,,IND,0,240,30,78,0.385,27,63,0.429,3,15,0.2,23,30,0.767,86,30,79,0.38,23,61,0.377,7,18,0.389,25,30,0.833,92
2182,NYK,3/3/2015,86,,SAC,0,240,30,82,0.366,26,60,0.433,4,22,0.182,22,30,0.733,86,41,83,0.494,31,65,0.477,10,18,0.556,32,37,0.865,124
2183,CHI,3/1/2015,86,,LAC,0,240,27,87,0.31,17,61,0.279,10,26,0.385,22,30,0.733,86,38,87,0.437,31,60,0.517,7,27,0.259,13,24,0.542,96
2184,CLE,2/27/2015,86,@,IND,0,240,33,92,0.359,24,63,0.381,9,29,0.31,11,14,0.786,86,34,80,0.425,28,63,0.444,6,17,0.353,19,29,0.655,93
2185,CHI,2/25/2015,86,,CHO,0,240,34,77,0.442,31,60,0.517,3,17,0.176,15,23,0.652,86,39,84,0.464,35,70,0.5,4,14,0.286,16,21,0.762,98
2186,MIL,2/22/2015,86,,ATL,0,240,32,72,0.444,28,56,0.5,4,16,0.25,18,18,1,86,35,87,0.402,26,57,0.456,9,30,0.3,18,21,0.857,97
2187,LAL,2/11/2015,86,@,POR,0,240,34,93,0.366,27,77,0.351,7,16,0.438,11,11,1,86,35,86,0.407,25,56,0.446,10,30,0.333,22,23,0.957,102
2188,BRK,2/10/2015,86,@,MEM,0,240,35,81,0.432,32,69,0.464,3,12,0.25,13,17,0.765,86,36,81,0.444,30,62,0.484,6,19,0.316,17,25,0.68,95
2189,SAC,2/10/2015,86,@,CHI,0,240,35,75,0.467,33,63,0.524,2,12,0.167,14,27,0.519,86,42,80,0.525,35,60,0.583,7,20,0.35,13,15,0.867,104
2190,DEN,1/31/2015,86,,CHO,0,240,33,92,0.359,28,68,0.412,5,24,0.208,15,20,0.75,86,44,93,0.473,44,82,0.537,0,11,0,16,25,0.64,104
2191,CHO,1/28/2015,86,@,SAS,0,240,34,83,0.41,28,65,0.431,6,18,0.333,12,14,0.857,86,35,83,0.422,25,54,0.463,10,29,0.345,15,18,0.833,95
2192,DET,1/24/2015,86,@,MIL,0,240,31,86,0.36,25,61,0.41,6,25,0.24,18,25,0.72,86,41,81,0.506,30,64,0.469,11,17,0.647,8,10,0.8,101
2193,PHI,1/23/2015,86,,TOR,0,240,31,81,0.383,22,52,0.423,9,29,0.31,15,18,0.833,86,33,80,0.413,27,56,0.482,6,24,0.25,19,24,0.792,91
2194,TOR,1/21/2015,86,@,MEM,0,240,27,85,0.318,22,57,0.386,5,28,0.179,27,32,0.844,86,34,74,0.459,33,67,0.493,1,7,0.143,23,29,0.793,92
2195,MIA,1/20/2015,86,,OKC,0,240,32,68,0.471,24,46,0.522,8,22,0.364,14,19,0.737,86,41,92,0.446,35,66,0.53,6,26,0.231,6,10,0.6,94
2196,CHI,1/9/2015,86,@,WAS,0,240,32,83,0.386,22,57,0.386,10,26,0.385,12,19,0.632,86,41,86,0.477,33,71,0.465,8,15,0.533,12,19,0.632,102
2197,MEM,1/7/2015,86,@,ATL,0,240,35,79,0.443,30,62,0.484,5,17,0.294,11,11,1,86,32,72,0.444,19,47,0.404,13,25,0.52,19,23,0.826,96
2198,ORL,12/30/2014,86,,DET,0,240,38,85,0.447,34,65,0.523,4,20,0.2,6,10,0.6,86,40,86,0.465,26,53,0.491,14,33,0.424,15,29,0.517,109
2199,PHI,12/30/2014,86,@,GSW,0,240,33,86,0.384,27,66,0.409,6,20,0.3,14,23,0.609,86,46,82,0.561,34,54,0.63,12,28,0.429,22,27,0.815,126
2200,GSW,12/25/2014,86,@,LAC,0,240,34,80,0.425,28,52,0.538,6,28,0.214,12,22,0.545,86,34,87,0.391,25,55,0.455,9,32,0.281,23,31,0.742,100
2201,UTA,12/20/2014,86,@,CHO,0,240,33,85,0.388,25,54,0.463,8,31,0.258,12,15,0.8,86,42,87,0.483,33,65,0.508,9,22,0.409,11,16,0.688,104
2202,CHI,12/15/2014,86,@,ATL,0,240,35,93,0.376,29,64,0.453,6,29,0.207,10,14,0.714,86,36,83,0.434,29,62,0.468,7,21,0.333,14,17,0.824,93
2203,DET,12/9/2014,86,,POR,0,240,34,97,0.351,29,75,0.387,5,22,0.227,13,16,0.813,86,41,84,0.488,32,63,0.508,9,21,0.429,7,8,0.875,98
2204,MIN,12/8/2014,86,,GSW,0,240,32,88,0.364,30,77,0.39,2,11,0.182,20,29,0.69,86,42,91,0.462,37,69,0.536,5,22,0.227,13,14,0.929,102
2205,ORL,12/3/2014,86,@,LAC,0,240,33,79,0.418,26,59,0.441,7,20,0.35,13,25,0.52,86,42,78,0.538,30,47,0.638,12,31,0.387,18,25,0.72,114
2206,MIA,12/1/2014,86,@,WAS,0,240,33,72,0.458,31,50,0.62,2,22,0.091,18,30,0.6,86,39,72,0.542,29,53,0.547,10,19,0.526,19,24,0.792,107
2207,MIA,11/30/2014,86,@,NYK,1,240,30,72,0.417,23,49,0.469,7,23,0.304,19,31,0.613,86,31,88,0.352,28,64,0.438,3,24,0.125,14,20,0.7,79
2208,MIN,11/26/2014,86,,MIL,0,240,31,81,0.383,28,67,0.418,3,14,0.214,21,34,0.618,86,40,85,0.471,35,69,0.507,5,16,0.313,18,19,0.947,103
2209,DET,11/25/2014,86,@,MIL,0,240,36,78,0.462,29,58,0.5,7,20,0.35,7,17,0.412,86,39,90,0.433,29,68,0.426,10,22,0.455,10,13,0.769,98
2210,NYK,11/24/2014,86,@,HOU,0,240,35,76,0.461,29,54,0.537,6,22,0.273,10,15,0.667,86,32,76,0.421,18,40,0.45,14,36,0.389,13,19,0.684,91
2211,OKC,11/23/2014,86,,GSW,0,240,32,90,0.356,29,73,0.397,3,17,0.176,19,27,0.704,86,33,93,0.355,26,68,0.382,7,25,0.28,18,24,0.75,91
2212,DET,11/19/2014,86,,PHO,0,240,33,87,0.379,26,62,0.419,7,25,0.28,13,19,0.684,86,37,75,0.493,33,60,0.55,4,15,0.267,10,13,0.769,88
2213,CHO,11/19/2014,86,@,IND,0,240,37,86,0.43,32,72,0.444,5,14,0.357,7,12,0.583,86,35,78,0.449,33,63,0.524,2,15,0.133,16,24,0.667,88
2214,UTA,11/10/2014,86,@,IND,0,240,32,74,0.432,26,53,0.491,6,21,0.286,16,21,0.762,86,39,90,0.433,33,75,0.44,6,15,0.4,13,15,0.867,97
2215,MIL,11/5/2014,86,,CHI,0,240,33,89,0.371,30,74,0.405,3,15,0.2,17,20,0.85,86,34,73,0.466,29,57,0.509,5,16,0.313,22,30,0.733,95
2216,ATL,4/15/2015,85,@,CHI,0,240,36,92,0.391,28,63,0.444,8,29,0.276,5,7,0.714,85,31,77,0.403,24,53,0.453,7,24,0.292,22,26,0.846,91
2217,UTA,4/4/2015,85,@,PHO,0,240,29,74,0.392,22,53,0.415,7,21,0.333,20,24,0.833,85,30,69,0.435,25,55,0.455,5,14,0.357,22,29,0.759,87
2218,DEN,3/25/2015,85,,PHI,0,240,29,84,0.345,21,55,0.382,8,29,0.276,19,27,0.704,85,35,84,0.417,21,50,0.42,14,34,0.412,15,22,0.682,99
2219,NOP,3/17/2015,85,,MIL,1,240,29,83,0.349,21,58,0.362,8,25,0.32,19,26,0.731,85,32,86,0.372,28,66,0.424,4,20,0.2,16,21,0.762,84
2220,DET,3/14/2015,85,@,UTA,0,240,32,84,0.381,24,61,0.393,8,23,0.348,13,22,0.591,85,33,69,0.478,27,55,0.491,6,14,0.429,16,24,0.667,88
2221,DET,3/10/2015,85,@,LAL,0,240,32,84,0.381,24,49,0.49,8,35,0.229,13,19,0.684,85,32,75,0.427,29,62,0.468,3,13,0.231,26,30,0.867,93
2222,WAS,3/7/2015,85,@,MIL,0,240,31,81,0.383,22,53,0.415,9,28,0.321,14,22,0.636,85,36,78,0.462,26,58,0.448,10,20,0.5,9,15,0.6,91
2223,DET,3/4/2015,85,@,NOP,0,240,38,93,0.409,36,79,0.456,2,14,0.143,7,9,0.778,85,37,90,0.411,35,78,0.449,2,12,0.167,12,16,0.75,88
2224,SAC,3/4/2015,85,@,SAS,0,240,29,78,0.372,26,69,0.377,3,9,0.333,24,34,0.706,85,45,85,0.529,35,62,0.565,10,23,0.435,12,16,0.75,112
2225,MIN,3/4/2015,85,,DEN,0,240,32,82,0.39,29,64,0.453,3,18,0.167,18,25,0.72,85,42,92,0.457,34,72,0.472,8,20,0.4,8,10,0.8,100
2226,BOS,3/4/2015,85,,UTA,1,240,33,88,0.375,25,61,0.41,8,27,0.296,11,20,0.55,85,34,75,0.453,31,56,0.554,3,19,0.158,13,21,0.619,84
2227,SAC,2/8/2015,85,,PHO,1,240,34,75,0.453,30,63,0.476,4,12,0.333,13,21,0.619,85,33,91,0.363,28,63,0.444,5,28,0.179,12,17,0.706,83
2228,MIA,2/6/2015,85,@,SAS,0,240,36,80,0.45,31,64,0.484,5,16,0.313,8,9,0.889,85,40,83,0.482,29,54,0.537,11,29,0.379,7,9,0.778,98
2229,SAS,1/31/2015,85,,LAC,0,240,28,75,0.373,18,45,0.4,10,30,0.333,19,28,0.679,85,40,91,0.44,32,69,0.464,8,22,0.364,17,18,0.944,105
2230,PHI,1/31/2015,85,@,ATL,0,240,31,81,0.383,17,46,0.37,14,35,0.4,9,15,0.6,85,34,78,0.436,24,50,0.48,10,28,0.357,13,18,0.722,91
2231,MEM,1/31/2015,85,,OKC,1,240,34,91,0.374,31,80,0.388,3,11,0.273,14,17,0.824,85,27,78,0.346,21,58,0.362,6,20,0.3,14,18,0.778,74
2232,NOP,1/28/2015,85,,DEN,0,240,32,82,0.39,29,67,0.433,3,15,0.2,18,24,0.75,85,39,85,0.459,29,68,0.426,10,17,0.588,5,7,0.714,93
2233,LAL,1/23/2015,85,@,SAS,0,240,33,83,0.398,28,70,0.4,5,13,0.385,14,20,0.7,85,36,84,0.429,29,60,0.483,7,24,0.292,20,27,0.741,99
2234,LAL,1/16/2015,85,@,UTA,0,240,31,65,0.477,28,58,0.483,3,7,0.429,20,27,0.741,85,36,85,0.424,24,54,0.444,12,31,0.387,10,10,1,94
2235,NOP,1/5/2015,85,,WAS,0,240,33,74,0.446,27,55,0.491,6,19,0.316,13,17,0.765,85,38,79,0.481,36,69,0.522,2,10,0.2,14,17,0.824,92
2236,MEM,1/3/2015,85,@,DEN,0,240,37,86,0.43,35,72,0.486,2,14,0.143,9,13,0.692,85,41,79,0.519,34,64,0.531,7,15,0.467,25,31,0.806,114
2237,BRK,12/27/2014,85,,IND,0,240,28,77,0.364,21,52,0.404,7,25,0.28,22,27,0.815,85,44,86,0.512,35,68,0.515,9,18,0.5,13,18,0.722,110
2238,MIL,12/27/2014,85,,ATL,0,240,31,80,0.388,19,50,0.38,12,30,0.4,11,14,0.786,85,33,90,0.367,24,61,0.393,9,29,0.31,15,19,0.789,90
2239,IND,12/13/2014,85,,POR,0,240,34,88,0.386,30,73,0.411,4,15,0.267,13,16,0.813,85,40,90,0.444,35,73,0.479,5,17,0.294,10,12,0.833,95
2240,MIA,12/5/2014,85,@,MIL,0,240,30,68,0.441,23,50,0.46,7,18,0.389,18,27,0.667,85,39,69,0.565,30,53,0.566,9,16,0.563,22,26,0.846,109
2241,NOP,12/4/2014,85,@,GSW,0,240,37,89,0.416,34,74,0.459,3,15,0.2,8,13,0.615,85,47,100,0.47,37,78,0.474,10,22,0.455,8,17,0.471,112
2242,PHI,12/3/2014,85,@,MIN,1,240,32,82,0.39,27,58,0.466,5,24,0.208,16,25,0.64,85,30,84,0.357,27,67,0.403,3,17,0.176,14,17,0.824,77
2243,SAC,11/30/2014,85,,MEM,0,240,33,70,0.471,32,59,0.542,1,11,0.091,18,27,0.667,85,38,79,0.481,35,66,0.53,3,13,0.231,18,28,0.643,97
2244,HOU,11/28/2014,85,,LAC,0,240,32,82,0.39,22,45,0.489,10,37,0.27,11,15,0.733,85,38,81,0.469,29,56,0.518,9,25,0.36,17,22,0.773,102
2245,MIL,11/14/2014,85,@,ORL,0,240,36,80,0.45,34,61,0.557,2,19,0.105,11,14,0.786,85,35,80,0.438,25,56,0.446,10,24,0.417,21,27,0.778,101
2246,MIL,11/11/2014,85,,OKC,1,240,33,81,0.407,30,66,0.455,3,15,0.2,16,24,0.667,85,29,87,0.333,23,67,0.343,6,20,0.3,14,19,0.737,78
2247,LAC,11/10/2014,85,,SAS,0,240,33,74,0.446,28,52,0.538,5,22,0.227,14,17,0.824,85,33,83,0.398,31,64,0.484,2,19,0.105,21,27,0.778,89
2248,NYK,11/10/2014,85,,ATL,0,240,36,83,0.434,30,57,0.526,6,26,0.231,7,12,0.583,85,27,71,0.38,17,44,0.386,10,27,0.37,27,28,0.964,91
2249,OKC,11/3/2014,85,@,BRK,0,240,32,82,0.39,24,59,0.407,8,23,0.348,13,21,0.619,85,44,84,0.524,33,61,0.541,11,23,0.478,17,19,0.895,116
2250,MIN,4/3/2015,84,,ORL,0,240,29,64,0.453,28,53,0.528,1,11,0.091,25,32,0.781,84,40,92,0.435,34,71,0.479,6,21,0.286,11,17,0.647,97
2251,DEN,4/1/2015,84,@,UTA,0,240,33,95,0.347,26,62,0.419,7,33,0.212,11,12,0.917,84,37,77,0.481,28,54,0.519,9,23,0.391,15,24,0.625,98
2252,MIN,3/30/2015,84,,UTA,0,240,28,76,0.368,22,60,0.367,6,16,0.375,22,27,0.815,84,39,82,0.476,29,49,0.592,10,33,0.303,16,18,0.889,104
2253,MEM,3/27/2015,84,,GSW,0,240,34,76,0.447,29,63,0.46,5,13,0.385,11,15,0.733,84,39,90,0.433,23,59,0.39,16,31,0.516,13,17,0.765,107
2254,UTA,3/18/2015,84,,WAS,0,240,34,82,0.415,30,60,0.5,4,22,0.182,12,24,0.5,84,33,63,0.524,27,52,0.519,6,11,0.545,16,23,0.696,88
2255,MIL,3/17/2015,84,@,NOP,0,240,32,86,0.372,28,66,0.424,4,20,0.2,16,21,0.762,84,29,83,0.349,21,58,0.362,8,25,0.32,19,26,0.731,85
2256,ATL,3/7/2015,84,@,PHI,0,240,30,77,0.39,19,52,0.365,11,25,0.44,13,16,0.813,84,35,95,0.368,22,58,0.379,13,37,0.351,9,17,0.529,92
2257,CHI,3/6/2015,84,@,IND,0,240,31,86,0.36,26,63,0.413,5,23,0.217,17,19,0.895,84,34,80,0.425,28,60,0.467,6,20,0.3,24,33,0.727,98
2258,UTA,3/4/2015,84,@,BOS,0,240,34,75,0.453,31,56,0.554,3,19,0.158,13,21,0.619,84,33,88,0.375,25,61,0.41,8,27,0.296,11,20,0.55,85
2259,NOP,2/20/2015,84,@,ORL,0,240,29,69,0.42,24,50,0.48,5,19,0.263,21,28,0.75,84,44,88,0.5,40,70,0.571,4,18,0.222,3,6,0.5,95
2260,PHI,2/9/2015,84,,GSW,0,240,33,79,0.418,26,55,0.473,7,24,0.292,11,14,0.786,84,34,85,0.4,27,56,0.482,7,29,0.241,14,19,0.737,89
2261,PHI,2/2/2015,84,@,CLE,0,240,31,78,0.397,19,45,0.422,12,33,0.364,10,14,0.714,84,35,78,0.449,23,51,0.451,12,27,0.444,15,22,0.682,97
2262,MIN,1/26/2015,84,@,OKC,0,240,29,85,0.341,27,72,0.375,2,13,0.154,24,32,0.75,84,36,86,0.419,32,66,0.485,4,20,0.2,16,24,0.667,92
2263,CHI,1/25/2015,84,,MIA,0,240,31,87,0.356,24,63,0.381,7,24,0.292,15,19,0.789,84,38,84,0.452,37,71,0.521,1,13,0.077,19,23,0.826,96
2264,MIN,1/23/2015,84,,NOP,0,240,35,84,0.417,33,75,0.44,2,9,0.222,12,17,0.706,84,40,80,0.5,37,76,0.487,3,4,0.75,9,14,0.643,92
2265,BRK,1/22/2015,84,@,LAC,0,240,33,88,0.375,29,67,0.433,4,21,0.19,14,25,0.56,84,49,83,0.59,38,58,0.655,11,25,0.44,14,21,0.667,123
2266,PHI,1/14/2015,84,@,TOR,0,240,31,80,0.388,28,61,0.459,3,19,0.158,19,31,0.613,84,38,82,0.463,28,53,0.528,10,29,0.345,14,22,0.636,100
2267,CLE,1/11/2015,84,@,SAC,0,240,33,78,0.423,22,46,0.478,11,32,0.344,7,12,0.583,84,42,86,0.488,36,69,0.522,6,17,0.353,13,17,0.765,103
2268,ORL,1/9/2015,84,@,LAL,0,240,30,76,0.395,24,62,0.387,6,14,0.429,18,23,0.783,84,36,90,0.4,29,69,0.42,7,21,0.333,22,31,0.71,101
2269,MIN,1/9/2015,84,@,MIL,0,240,32,79,0.405,26,57,0.456,6,22,0.273,14,17,0.824,84,39,75,0.52,27,56,0.482,12,19,0.632,8,10,0.8,98
2270,BRK,1/4/2015,84,@,MIA,0,240,34,86,0.395,27,62,0.435,7,24,0.292,9,13,0.692,84,31,67,0.463,26,53,0.491,5,14,0.357,21,28,0.75,88
2271,SAC,12/31/2014,84,@,BOS,0,240,32,87,0.368,30,72,0.417,2,15,0.133,18,28,0.643,84,44,94,0.468,39,73,0.534,5,21,0.238,13,15,0.867,106
2272,NOP,12/23/2014,84,@,IND,0,240,33,83,0.398,29,63,0.46,4,20,0.2,14,19,0.737,84,39,78,0.5,34,63,0.54,5,15,0.333,13,18,0.722,96
2273,BOS,12/21/2014,84,@,MIA,0,240,33,83,0.398,27,60,0.45,6,23,0.261,12,15,0.8,84,37,78,0.474,31,57,0.544,6,21,0.286,20,26,0.769,100
2274,UTA,12/14/2014,84,@,WAS,0,240,30,78,0.385,25,61,0.41,5,17,0.294,19,28,0.679,84,41,84,0.488,37,71,0.521,4,13,0.308,7,12,0.583,93
2275,DEN,12/7/2014,84,@,ATL,0,240,34,93,0.366,28,58,0.483,6,35,0.171,10,13,0.769,84,36,87,0.414,26,60,0.433,10,27,0.37,14,19,0.737,96
2276,BRK,11/30/2014,84,,CHI,0,240,32,86,0.372,30,72,0.417,2,14,0.143,18,24,0.75,84,34,69,0.493,27,45,0.6,7,24,0.292,27,34,0.794,102
2277,MIA,11/16/2014,84,,MIL,0,240,30,73,0.411,19,48,0.396,11,25,0.44,13,22,0.591,84,35,74,0.473,30,56,0.536,5,18,0.278,16,26,0.615,91
2278,WAS,11/7/2014,84,@,TOR,0,240,30,83,0.361,27,64,0.422,3,19,0.158,21,32,0.656,84,35,80,0.438,26,58,0.448,9,22,0.409,24,31,0.774,103
2279,ORL,10/28/2014,84,@,NOP,0,240,32,84,0.381,28,73,0.384,4,11,0.364,16,21,0.762,84,41,101,0.406,37,84,0.44,4,17,0.235,15,31,0.484,101
2280,IND,4/15/2015,83,@,MEM,0,240,32,78,0.41,24,54,0.444,8,24,0.333,11,15,0.733,83,36,76,0.474,34,67,0.507,2,9,0.222,21,26,0.808,95
2281,MEM,4/4/2015,83,,WAS,0,240,34,81,0.42,33,66,0.5,1,15,0.067,14,18,0.778,83,38,79,0.481,30,57,0.526,8,22,0.364,8,10,0.8,92
2282,SAC,3/30/2015,83,@,MEM,0,240,33,81,0.407,28,65,0.431,5,16,0.313,12,20,0.6,83,38,83,0.458,30,60,0.5,8,23,0.348,13,17,0.765,97
2283,LAL,3/27/2015,83,@,TOR,0,240,29,84,0.345,25,67,0.373,4,17,0.235,21,29,0.724,83,36,75,0.48,29,57,0.509,7,18,0.389,15,21,0.714,94
2284,ORL,3/25/2015,83,,ATL,0,240,32,78,0.41,29,62,0.468,3,16,0.188,16,20,0.8,83,39,90,0.433,29,59,0.492,10,31,0.323,7,10,0.7,95
2285,DET,3/18/2015,83,@,PHI,0,240,29,88,0.33,21,62,0.339,8,26,0.308,17,19,0.895,83,36,84,0.429,25,57,0.439,11,27,0.407,11,18,0.611,94
2286,MIL,3/14/2015,83,@,MEM,0,240,30,72,0.417,25,53,0.472,5,19,0.263,18,27,0.667,83,37,78,0.474,29,64,0.453,8,14,0.571,14,16,0.875,96
2287,PHI,3/6/2015,83,,UTA,0,240,32,88,0.364,22,56,0.393,10,32,0.313,9,18,0.5,83,27,71,0.38,21,59,0.356,6,12,0.5,29,41,0.707,89
2288,ORL,3/1/2015,83,,CHO,0,240,31,85,0.365,25,70,0.357,6,15,0.4,15,20,0.75,83,40,80,0.5,32,62,0.516,8,18,0.444,10,14,0.714,98
2289,NYK,2/22/2015,83,,CLE,0,240,37,99,0.374,34,80,0.425,3,19,0.158,6,7,0.857,83,40,79,0.506,28,46,0.609,12,33,0.364,9,15,0.6,101
2290,NYK,2/11/2015,83,@,ORL,0,240,25,73,0.342,20,58,0.345,5,15,0.333,28,36,0.778,83,31,67,0.463,27,56,0.482,4,11,0.364,23,28,0.821,89
2291,PHO,2/8/2015,83,@,SAC,0,240,33,91,0.363,28,63,0.444,5,28,0.179,12,17,0.706,83,34,75,0.453,30,63,0.476,4,12,0.333,13,21,0.619,85
2292,MIA,2/1/2015,83,@,BOS,1,240,32,77,0.416,28,56,0.5,4,21,0.19,15,21,0.714,83,30,81,0.37,26,62,0.419,4,19,0.211,11,18,0.611,75
2293,PHI,1/24/2015,83,@,MEM,0,240,31,81,0.383,22,57,0.386,9,24,0.375,12,22,0.545,83,37,79,0.468,31,65,0.477,6,14,0.429,21,25,0.84,101
2294,SAC,1/16/2015,83,,MIA,0,240,32,75,0.427,25,59,0.424,7,16,0.438,12,14,0.857,83,35,74,0.473,27,57,0.474,8,17,0.471,17,21,0.81,95
2295,MIA,1/8/2015,83,@,POR,0,240,29,77,0.377,26,63,0.413,3,14,0.214,22,30,0.733,83,40,95,0.421,32,68,0.471,8,27,0.296,11,15,0.733,99
2296,OKC,1/7/2015,83,@,SAC,0,240,29,89,0.326,20,59,0.339,9,30,0.3,16,23,0.696,83,36,92,0.391,26,73,0.356,10,19,0.526,22,28,0.786,104
2297,NYK,1/5/2015,83,@,MEM,0,240,33,76,0.434,25,50,0.5,8,26,0.308,9,13,0.692,83,43,82,0.524,36,67,0.537,7,15,0.467,12,19,0.632,105
2298,HOU,1/2/2015,83,@,NOP,0,240,35,88,0.398,29,59,0.492,6,29,0.207,7,11,0.636,83,44,83,0.53,37,68,0.544,7,15,0.467,16,20,0.8,111
2299,CHO,12/31/2014,83,@,HOU,0,240,29,76,0.382,26,58,0.448,3,18,0.167,22,26,0.846,83,38,88,0.432,21,45,0.467,17,43,0.395,9,14,0.643,102
2300,WAS,11/29/2014,83,,NOP,1,240,35,76,0.461,30,64,0.469,5,12,0.417,8,12,0.667,83,30,81,0.37,24,64,0.375,6,17,0.353,14,21,0.667,80
2301,ORL,11/28/2014,83,@,IND,0,240,31,70,0.443,24,52,0.462,7,18,0.389,14,16,0.875,83,41,94,0.436,37,78,0.474,4,16,0.25,12,14,0.857,98
2302,PHI,11/22/2014,83,@,NYK,0,240,30,75,0.4,22,49,0.449,8,26,0.308,15,25,0.6,83,33,66,0.5,27,49,0.551,6,17,0.353,19,21,0.905,91
2303,IND,11/22/2014,83,,PHO,0,240,31,84,0.369,24,61,0.393,7,23,0.304,14,20,0.7,83,38,85,0.447,26,54,0.481,12,31,0.387,18,20,0.9,106
2304,BRK,11/17/2014,83,,MIA,0,240,29,70,0.414,20,47,0.426,9,23,0.391,16,26,0.615,83,31,72,0.431,22,45,0.489,9,27,0.333,24,27,0.889,95
2305,NYK,11/4/2014,83,,WAS,0,240,30,81,0.37,22,66,0.333,8,15,0.533,15,19,0.789,83,39,80,0.488,31,62,0.5,8,18,0.444,12,19,0.632,98
2306,DET,4/3/2015,82,@,CHI,0,240,32,74,0.432,26,55,0.473,6,19,0.316,12,15,0.8,82,33,85,0.388,29,68,0.426,4,17,0.235,18,21,0.857,88
2307,NYK,3/23/2015,82,,MEM,0,240,32,76,0.421,28,58,0.483,4,18,0.222,14,17,0.824,82,41,79,0.519,34,67,0.507,7,12,0.583,14,19,0.737,103
2308,NYK,3/10/2015,82,@,UTA,0,240,31,79,0.392,26,66,0.394,5,13,0.385,15,17,0.882,82,30,70,0.429,24,52,0.462,6,18,0.333,21,29,0.724,87
2309,NYK,3/4/2015,82,@,IND,0,240,30,76,0.395,24,60,0.4,6,16,0.375,16,23,0.696,82,38,80,0.475,28,58,0.483,10,22,0.455,19,24,0.792,105
2310,MEM,3/3/2015,82,,UTA,0,240,33,82,0.402,30,71,0.423,3,11,0.273,13,19,0.684,82,36,80,0.45,31,55,0.564,5,25,0.2,16,19,0.842,93
2311,UTA,2/28/2015,82,,MIL,1,240,29,76,0.382,23,54,0.426,6,22,0.273,18,23,0.783,82,29,74,0.392,24,59,0.407,5,15,0.333,12,14,0.857,75
2312,DEN,2/27/2015,82,,UTA,0,240,28,84,0.333,20,52,0.385,8,32,0.25,18,29,0.621,82,39,68,0.574,30,47,0.638,9,21,0.429,17,21,0.81,104
2313,DEN,2/23/2015,82,,BRK,0,240,31,94,0.33,24,67,0.358,7,27,0.259,13,22,0.591,82,43,92,0.467,39,71,0.549,4,21,0.19,20,23,0.87,110
2314,UTA,2/11/2015,82,@,DAL,0,240,30,80,0.375,19,51,0.373,11,29,0.379,11,21,0.524,82,28,75,0.373,18,47,0.383,10,28,0.357,21,26,0.808,87
2315,SAS,2/8/2015,82,@,TOR,0,240,31,93,0.333,24,65,0.369,7,28,0.25,13,16,0.813,82,32,74,0.432,28,61,0.459,4,13,0.308,19,24,0.792,87
2316,MIL,2/2/2015,82,@,TOR,1,240,33,80,0.413,26,64,0.406,7,16,0.438,9,17,0.529,82,25,78,0.321,18,51,0.353,7,27,0.259,18,22,0.818,75
2317,NYK,1/29/2015,82,@,IND,0,240,34,81,0.42,29,65,0.446,5,16,0.313,9,13,0.692,82,42,79,0.532,36,61,0.59,6,18,0.333,13,18,0.722,103
2318,DET,1/19/2015,82,@,ATL,0,240,29,82,0.354,20,47,0.426,9,35,0.257,15,26,0.577,82,37,84,0.44,28,54,0.519,9,30,0.3,10,14,0.714,93
2319,UTA,1/10/2015,82,@,HOU,0,240,29,70,0.414,24,53,0.453,5,17,0.294,19,21,0.905,82,33,77,0.429,20,43,0.465,13,34,0.382,18,21,0.857,97
2320,NYK,1/10/2015,82,,CHO,0,240,33,85,0.388,25,56,0.446,8,29,0.276,8,9,0.889,82,39,78,0.5,32,62,0.516,7,16,0.438,25,33,0.758,110
2321,NYK,1/4/2015,82,,MIL,0,240,31,76,0.408,22,51,0.431,9,25,0.36,11,14,0.786,82,35,77,0.455,31,61,0.508,4,16,0.25,21,27,0.778,95
2322,CHI,12/30/2014,82,,BRK,0,240,33,86,0.384,25,61,0.41,8,25,0.32,8,15,0.533,82,36,83,0.434,30,69,0.435,6,14,0.429,18,21,0.857,96
2323,DEN,12/22/2014,82,@,CHO,0,240,31,82,0.378,29,64,0.453,2,18,0.111,18,24,0.75,82,43,80,0.538,35,61,0.574,8,19,0.421,16,24,0.667,110
2324,ORL,12/15/2014,82,@,TOR,0,240,36,74,0.486,32,59,0.542,4,15,0.267,6,8,0.75,82,37,83,0.446,26,53,0.491,11,30,0.367,10,15,0.667,95
2325,MIA,12/10/2014,82,@,DEN,0,240,30,82,0.366,23,60,0.383,7,22,0.318,15,21,0.714,82,38,85,0.447,30,62,0.484,8,23,0.348,18,27,0.667,102
2326,POR,12/10/2014,82,@,MIN,0,240,31,80,0.388,21,45,0.467,10,35,0.286,10,12,0.833,82,32,81,0.395,31,69,0.449,1,12,0.083,25,33,0.758,90
2327,IND,12/4/2014,82,@,POR,0,240,36,91,0.396,31,73,0.425,5,18,0.278,5,8,0.625,82,33,83,0.398,29,62,0.468,4,21,0.19,18,23,0.783,88
2328,UTA,11/26/2014,82,@,OKC,0,240,31,70,0.443,28,54,0.519,3,16,0.188,17,28,0.607,82,40,83,0.482,28,57,0.491,12,26,0.462,5,10,0.5,97
2329,MIL,11/21/2014,82,@,TOR,0,240,27,74,0.365,21,54,0.389,6,20,0.3,22,32,0.688,82,45,86,0.523,30,61,0.492,15,25,0.6,19,24,0.792,124
2330,UTA,11/7/2014,82,,DAL,0,240,29,68,0.426,20,40,0.5,9,28,0.321,15,19,0.789,82,42,88,0.477,33,64,0.516,9,24,0.375,12,14,0.857,105
2331,CLE,11/4/2014,82,@,POR,0,240,31,85,0.365,22,64,0.344,9,21,0.429,11,14,0.786,82,37,75,0.493,29,50,0.58,8,25,0.32,19,25,0.76,101
2332,MIA,3/31/2015,81,,SAS,0,240,32,79,0.405,27,64,0.422,5,15,0.333,12,12,1,81,37,74,0.5,29,56,0.518,8,18,0.444,13,17,0.765,95
2333,PHO,3/27/2015,81,,POR,0,240,32,87,0.368,26,67,0.388,6,20,0.3,11,12,0.917,81,36,89,0.404,29,63,0.46,7,26,0.269,8,18,0.444,87
2334,NYK,3/20/2015,81,@,PHI,0,240,25,69,0.362,17,53,0.321,8,16,0.5,23,26,0.885,81,37,88,0.42,26,58,0.448,11,30,0.367,12,15,0.8,97
2335,DEN,3/16/2015,81,@,MEM,0,240,30,81,0.37,22,63,0.349,8,18,0.444,13,21,0.619,81,33,80,0.413,31,71,0.437,2,9,0.222,24,28,0.857,92
2336,WAS,2/27/2015,81,@,PHI,0,240,30,93,0.323,26,76,0.342,4,17,0.235,17,22,0.773,81,28,80,0.35,16,47,0.34,12,33,0.364,21,34,0.618,89
2337,SAS,2/23/2015,81,@,UTA,0,240,32,79,0.405,27,60,0.45,5,19,0.263,12,21,0.571,81,34,83,0.41,30,68,0.441,4,15,0.267,18,23,0.783,90
2338,CHO,2/22/2015,81,@,DAL,0,240,33,90,0.367,27,71,0.38,6,19,0.316,9,13,0.692,81,36,78,0.462,31,60,0.517,5,18,0.278,15,19,0.789,92
2339,DEN,2/20/2015,81,@,MIL,0,240,30,84,0.357,23,58,0.397,7,26,0.269,14,21,0.667,81,33,78,0.423,28,63,0.444,5,15,0.333,18,22,0.818,89
2340,CHO,2/7/2015,81,@,PHI,0,240,29,84,0.345,23,61,0.377,6,23,0.261,17,20,0.85,81,29,74,0.392,20,51,0.392,9,23,0.391,22,30,0.733,89
2341,SAS,1/22/2015,81,@,CHI,0,240,30,81,0.37,24,60,0.4,6,21,0.286,15,18,0.833,81,36,76,0.474,30,57,0.526,6,19,0.316,26,32,0.813,104
2342,NOP,1/16/2015,81,@,PHI,0,240,29,75,0.387,25,58,0.431,4,17,0.235,19,29,0.655,81,36,80,0.45,29,58,0.5,7,22,0.318,17,27,0.63,96
2343,BRK,1/7/2015,81,,BOS,0,240,30,74,0.405,27,60,0.45,3,14,0.214,18,26,0.692,81,35,88,0.398,30,70,0.429,5,18,0.278,14,17,0.824,89
2344,NYK,1/2/2015,81,,DET,0,240,32,91,0.352,22,67,0.328,10,24,0.417,7,14,0.5,81,38,76,0.5,25,43,0.581,13,33,0.394,8,14,0.571,97
2345,ORL,12/12/2014,81,@,ATL,0,240,30,77,0.39,21,51,0.412,9,26,0.346,12,16,0.75,81,29,78,0.372,20,49,0.408,9,29,0.31,20,27,0.741,87
2346,OKC,11/18/2014,81,@,UTA,0,240,30,84,0.357,22,61,0.361,8,23,0.348,13,19,0.684,81,35,81,0.432,25,57,0.439,10,24,0.417,18,26,0.692,98
2347,IND,11/12/2014,81,@,MIA,1,240,30,80,0.375,22,54,0.407,8,26,0.308,13,15,0.867,81,29,68,0.426,20,48,0.417,9,20,0.45,8,18,0.444,75
2348,SAS,11/6/2014,81,@,HOU,0,240,31,90,0.344,29,70,0.414,2,20,0.1,17,19,0.895,81,34,72,0.472,24,45,0.533,10,27,0.37,20,33,0.606,98
2349,IND,11/4/2014,81,,MIL,0,240,31,78,0.397,25,54,0.463,6,24,0.25,13,22,0.591,81,37,83,0.446,30,62,0.484,7,21,0.333,6,7,0.857,87
2350,NOP,11/3/2014,81,@,MEM,0,240,29,86,0.337,25,62,0.403,4,24,0.167,19,29,0.655,81,31,76,0.408,27,62,0.435,4,14,0.286,27,37,0.73,93
2351,PHI,10/31/2014,81,@,MIL,0,240,32,86,0.372,27,63,0.429,5,23,0.217,12,22,0.545,81,36,88,0.409,27,64,0.422,9,24,0.375,12,21,0.571,93
2352,NYK,4/11/2015,80,@,ORL,1,240,31,82,0.378,25,62,0.403,6,20,0.3,12,13,0.923,80,30,84,0.357,24,62,0.387,6,22,0.273,13,18,0.722,79
2353,CHO,4/10/2015,80,@,ATL,0,240,30,83,0.361,22,53,0.415,8,30,0.267,12,18,0.667,80,41,82,0.5,31,54,0.574,10,28,0.357,12,16,0.75,104
2354,WAS,4/10/2015,80,@,BRK,0,240,32,82,0.39,27,67,0.403,5,15,0.333,11,17,0.647,80,45,89,0.506,33,69,0.478,12,20,0.6,15,23,0.652,117
2355,NYK,3/28/2015,80,@,CHI,0,240,30,79,0.38,26,62,0.419,4,17,0.235,16,19,0.842,80,43,84,0.512,37,67,0.552,6,17,0.353,19,22,0.864,111
2356,NYK,3/25/2015,80,,LAC,0,240,29,82,0.354,24,59,0.407,5,23,0.217,17,19,0.895,80,44,78,0.564,33,50,0.66,11,28,0.393,12,18,0.667,111
2357,UTA,3/19/2015,80,@,LAL,1,240,25,62,0.403,16,37,0.432,9,25,0.36,21,31,0.677,80,31,77,0.403,28,66,0.424,3,11,0.273,8,17,0.471,73
2358,PHO,3/9/2015,80,,GSW,0,240,29,77,0.377,25,66,0.379,4,11,0.364,18,23,0.783,80,35,83,0.422,22,52,0.423,13,31,0.419,15,19,0.789,98
2359,ATL,2/20/2015,80,,TOR,0,240,29,88,0.33,21,50,0.42,8,38,0.211,14,21,0.667,80,43,96,0.448,30,66,0.455,13,30,0.433,6,8,0.75,105
2360,ORL,2/9/2015,80,@,WAS,0,240,33,83,0.398,29,61,0.475,4,22,0.182,10,15,0.667,80,33,77,0.429,26,52,0.5,7,25,0.28,23,27,0.852,96
2361,LAL,2/1/2015,80,@,NYK,0,240,27,76,0.355,20,60,0.333,7,16,0.438,19,23,0.826,80,37,84,0.44,27,62,0.435,10,22,0.455,8,13,0.615,92
2362,LAL,1/21/2015,80,@,NOP,0,240,28,77,0.364,22,57,0.386,6,20,0.3,18,21,0.857,80,38,83,0.458,35,67,0.522,3,16,0.188,17,21,0.81,96
2363,MIN,1/19/2015,80,@,CHO,0,240,29,80,0.363,23,61,0.377,6,19,0.316,16,20,0.8,80,40,89,0.449,28,67,0.418,12,22,0.545,13,19,0.684,105
2364,CHO,1/17/2015,80,,IND,1,265,31,101,0.307,29,86,0.337,2,15,0.133,16,25,0.64,80,30,84,0.357,28,63,0.444,2,21,0.095,9,13,0.692,71
2365,WAS,1/16/2015,80,,BRK,0,240,31,73,0.425,27,56,0.482,4,17,0.235,14,16,0.875,80,37,81,0.457,33,69,0.478,4,12,0.333,24,31,0.774,102
2366,CLE,12/31/2014,80,,MIL,0,240,29,85,0.341,21,54,0.389,8,31,0.258,14,16,0.875,80,40,90,0.444,29,65,0.446,11,25,0.44,5,10,0.5,96
2367,CLE,12/28/2014,80,,DET,0,240,31,82,0.378,26,53,0.491,5,29,0.172,13,17,0.765,80,41,91,0.451,24,60,0.4,17,31,0.548,4,9,0.444,103
2368,BRK,12/10/2014,80,@,CHI,0,240,29,88,0.33,26,74,0.351,3,14,0.214,19,24,0.792,80,37,79,0.468,29,57,0.509,8,22,0.364,23,32,0.719,105
2369,NOP,11/29/2014,80,@,WAS,0,240,30,81,0.37,24,64,0.375,6,17,0.353,14,21,0.667,80,35,76,0.461,30,64,0.469,5,12,0.417,8,12,0.667,83
2370,CHO,11/17/2014,80,,DAL,0,240,32,80,0.4,22,58,0.379,10,22,0.455,6,13,0.462,80,43,84,0.512,33,56,0.589,10,28,0.357,11,16,0.688,107
2371,LAL,11/14/2014,80,,SAS,0,240,28,75,0.373,26,63,0.413,2,12,0.167,22,31,0.71,80,33,80,0.413,23,57,0.404,10,23,0.435,17,20,0.85,93
2372,NYK,10/29/2014,80,,CHI,0,240,31,85,0.365,28,68,0.412,3,17,0.176,15,17,0.882,80,36,71,0.507,29,47,0.617,7,24,0.292,25,30,0.833,104
2373,ORL,4/11/2015,79,,NYK,0,240,30,84,0.357,24,62,0.387,6,22,0.273,13,18,0.722,79,31,82,0.378,25,62,0.403,6,20,0.3,12,13,0.923,80
2374,PHO,3/7/2015,79,@,CLE,0,240,30,84,0.357,21,59,0.356,9,25,0.36,10,14,0.714,79,31,75,0.413,23,55,0.418,8,20,0.4,19,23,0.826,89
2375,BOS,3/3/2015,79,@,CLE,0,240,31,88,0.352,24,60,0.4,7,28,0.25,10,13,0.769,79,43,89,0.483,33,61,0.541,10,28,0.357,14,14,1,110
2376,MEM,2/27/2015,79,,LAC,0,240,33,87,0.379,30,75,0.4,3,12,0.25,10,15,0.667,79,36,78,0.462,27,52,0.519,9,26,0.346,16,28,0.571,97
2377,DEN,1/19/2015,79,@,GSW,0,240,30,87,0.345,23,63,0.365,7,24,0.292,12,19,0.632,79,44,81,0.543,31,54,0.574,13,27,0.481,21,27,0.778,122
2378,NYK,1/15/2015,79,@,MIL,0,240,28,68,0.412,20,46,0.435,8,22,0.364,15,20,0.75,79,28,72,0.389,20,54,0.37,8,18,0.444,31,42,0.738,95
2379,MIA,1/3/2015,79,@,HOU,0,240,30,68,0.441,26,51,0.51,4,17,0.235,15,25,0.6,79,41,83,0.494,28,52,0.538,13,31,0.419,20,28,0.714,115
2380,NYK,12/28/2014,79,@,POR,0,240,31,93,0.333,24,66,0.364,7,27,0.259,10,15,0.667,79,38,81,0.469,22,45,0.489,16,36,0.444,9,12,0.75,101
2381,PHI,12/10/2014,79,@,ATL,0,240,30,72,0.417,24,47,0.511,6,25,0.24,13,22,0.591,79,38,91,0.418,28,61,0.459,10,30,0.333,9,13,0.692,95
2382,NYK,11/30/2014,79,,MIA,0,240,31,88,0.352,28,64,0.438,3,24,0.125,14,20,0.7,79,30,72,0.417,23,49,0.469,7,23,0.304,19,31,0.613,86
2383,DET,10/29/2014,79,@,DEN,0,240,31,84,0.369,25,58,0.431,6,26,0.231,11,19,0.579,79,30,85,0.353,24,61,0.393,6,24,0.25,23,31,0.742,89
2384,CLE,4/12/2015,78,@,BOS,0,240,31,79,0.392,28,57,0.491,3,22,0.136,13,19,0.684,78,46,84,0.548,36,60,0.6,10,24,0.417,15,22,0.682,117
2385,MIA,4/9/2015,78,,CHI,0,240,34,88,0.386,29,70,0.414,5,18,0.278,5,7,0.714,78,35,91,0.385,29,68,0.426,6,23,0.261,13,17,0.765,89
2386,LAL,4/5/2015,78,,LAC,0,240,29,75,0.387,22,58,0.379,7,17,0.412,13,22,0.591,78,40,75,0.533,25,48,0.521,15,27,0.556,11,18,0.611,106
2387,DET,4/1/2015,78,@,CHO,0,240,31,88,0.352,26,66,0.394,5,22,0.227,11,18,0.611,78,38,90,0.422,29,68,0.426,9,22,0.409,17,24,0.708,102
2388,NYK,3/9/2015,78,@,DEN,0,240,29,75,0.387,24,62,0.387,5,13,0.385,15,25,0.6,78,38,87,0.437,30,63,0.476,8,24,0.333,22,29,0.759,106
2389,CHO,2/10/2015,78,,DET,0,240,29,81,0.358,20,57,0.351,9,24,0.375,11,14,0.786,78,37,83,0.446,32,64,0.5,5,19,0.263,27,30,0.9,106
2390,SAC,2/5/2015,78,,DAL,0,240,29,79,0.367,26,58,0.448,3,21,0.143,17,22,0.773,78,41,96,0.427,29,62,0.468,12,34,0.353,7,10,0.7,101
2391,CHO,1/21/2015,78,,MIA,1,240,27,80,0.338,23,61,0.377,4,19,0.211,20,30,0.667,78,29,84,0.345,24,66,0.364,5,18,0.278,13,15,0.867,76
2392,MIA,1/13/2015,78,@,LAL,1,240,33,78,0.423,31,62,0.5,2,16,0.125,10,15,0.667,78,29,92,0.315,25,69,0.362,4,23,0.174,13,18,0.722,75
2393,NYK,12/31/2014,78,@,LAC,0,240,32,84,0.381,28,67,0.418,4,17,0.235,10,15,0.667,78,36,82,0.439,21,48,0.438,15,34,0.441,12,20,0.6,99
2394,NYK,11/28/2014,78,@,OKC,0,240,29,75,0.387,27,56,0.482,2,19,0.105,18,24,0.75,78,38,86,0.442,28,62,0.452,10,24,0.417,19,23,0.826,105
2395,CLE,11/21/2014,78,@,WAS,0,240,27,75,0.36,21,48,0.438,6,27,0.222,18,23,0.783,78,41,84,0.488,37,74,0.5,4,10,0.4,5,9,0.556,91
2396,OKC,11/11/2014,78,@,MIL,0,240,29,87,0.333,23,67,0.343,6,20,0.3,14,19,0.737,78,33,81,0.407,30,66,0.455,3,15,0.2,16,24,0.667,85
2397,CHO,4/12/2015,77,@,DET,0,240,27,79,0.342,23,64,0.359,4,15,0.267,19,29,0.655,77,41,81,0.506,25,53,0.472,16,28,0.571,18,23,0.783,116
2398,LAL,4/3/2015,77,,POR,0,240,31,82,0.378,26,68,0.382,5,14,0.357,10,17,0.588,77,43,88,0.489,33,62,0.532,10,26,0.385,11,11,1,107
2399,WAS,2/25/2015,77,@,MIN,0,240,33,87,0.379,29,69,0.42,4,18,0.222,7,8,0.875,77,35,81,0.432,31,68,0.456,4,13,0.308,23,28,0.821,97
2400,BRK,2/7/2015,77,@,WAS,0,240,26,77,0.338,22,59,0.373,4,18,0.222,21,31,0.677,77,44,87,0.506,35,67,0.522,9,20,0.45,17,23,0.739,114
2401,CHI,1/7/2015,77,,UTA,0,240,28,84,0.333,22,64,0.344,6,20,0.3,15,20,0.75,77,37,78,0.474,32,62,0.516,5,16,0.313,18,24,0.75,97
2402,PHI,1/7/2015,77,,MIL,0,240,25,83,0.301,23,58,0.397,2,25,0.08,25,29,0.862,77,41,76,0.539,33,59,0.559,8,17,0.471,7,11,0.636,97
2403,ATL,12/26/2014,77,,MIL,0,240,31,76,0.408,27,53,0.509,4,23,0.174,11,14,0.786,77,40,79,0.506,32,60,0.533,8,19,0.421,19,23,0.826,107
2404,MIN,12/3/2014,77,,PHI,0,240,30,84,0.357,27,67,0.403,3,17,0.176,14,17,0.824,77,32,82,0.39,27,58,0.466,5,24,0.208,16,25,0.64,85
2405,SAC,10/29/2014,77,,GSW,0,240,24,78,0.308,21,60,0.35,3,18,0.167,26,35,0.743,77,33,75,0.44,27,48,0.563,6,27,0.222,23,32,0.719,95
2406,DAL,3/27/2015,76,@,SAS,0,240,31,82,0.378,27,64,0.422,4,18,0.222,10,15,0.667,76,37,84,0.44,28,58,0.483,9,26,0.346,11,14,0.786,94
2407,WAS,3/23/2015,76,@,GSW,0,240,27,81,0.333,24,70,0.343,3,11,0.273,19,26,0.731,76,39,95,0.411,26,62,0.419,13,33,0.394,16,21,0.762,107
2408,MIN,3/9/2015,76,@,LAC,0,240,31,83,0.373,29,75,0.387,2,8,0.25,12,21,0.571,76,35,79,0.443,24,48,0.5,11,31,0.355,8,15,0.533,89
2409,TOR,2/21/2015,76,@,HOU,0,240,25,77,0.325,21,59,0.356,4,18,0.222,22,28,0.786,76,35,84,0.417,29,55,0.527,6,29,0.207,22,31,0.71,98
2410,POR,2/20/2015,76,@,UTA,0,240,26,72,0.361,22,50,0.44,4,22,0.182,20,22,0.909,76,37,83,0.446,27,58,0.466,10,25,0.4,8,17,0.471,92
2411,CHO,1/24/2015,76,,NYK,1,240,25,76,0.329,23,69,0.333,2,7,0.286,24,37,0.649,76,28,79,0.354,22,64,0.344,6,15,0.4,9,18,0.5,71
2412,MIA,1/21/2015,76,@,CHO,0,240,29,84,0.345,24,66,0.364,5,18,0.278,13,15,0.867,76,27,80,0.338,23,61,0.377,4,19,0.211,20,30,0.667,78
2413,PHI,1/19/2015,76,@,WAS,0,240,28,85,0.329,22,61,0.361,6,24,0.25,14,23,0.609,76,45,81,0.556,38,68,0.559,7,13,0.538,14,18,0.778,111
2414,DEN,12/20/2014,76,,IND,1,240,30,82,0.366,28,66,0.424,2,16,0.125,14,19,0.737,76,27,88,0.307,20,65,0.308,7,23,0.304,12,17,0.706,73
2415,PHO,4/10/2015,75,@,NOP,0,240,30,85,0.353,23,60,0.383,7,25,0.28,8,10,0.8,75,37,84,0.44,32,65,0.492,5,19,0.263,11,19,0.579,90
2416,MIA,3/22/2015,75,@,OKC,0,240,32,81,0.395,29,63,0.46,3,18,0.167,8,15,0.533,75,40,90,0.444,34,72,0.472,6,18,0.333,7,13,0.538,93
2417,DAL,3/5/2015,75,@,POR,0,240,33,88,0.375,31,72,0.431,2,16,0.125,7,8,0.875,75,34,82,0.415,27,60,0.45,7,22,0.318,19,21,0.905,94
2418,MIL,2/28/2015,75,@,UTA,0,240,29,74,0.392,24,59,0.407,5,15,0.333,12,14,0.857,75,29,76,0.382,23,54,0.426,6,22,0.273,18,23,0.783,82
2419,TOR,2/2/2015,75,,MIL,0,240,25,78,0.321,18,51,0.353,7,27,0.259,18,22,0.818,75,33,80,0.413,26,64,0.406,7,16,0.438,9,17,0.529,82
2420,BOS,2/1/2015,75,,MIA,0,240,30,81,0.37,26,62,0.419,4,19,0.211,11,18,0.611,75,32,77,0.416,28,56,0.5,4,21,0.19,15,21,0.714,83
2421,MIN,1/21/2015,75,,DAL,0,240,31,89,0.348,29,74,0.392,2,15,0.133,11,15,0.733,75,39,76,0.513,28,49,0.571,11,27,0.407,9,14,0.643,98
2422,LAL,1/13/2015,75,,MIA,0,240,29,92,0.315,25,69,0.362,4,23,0.174,13,18,0.722,75,33,78,0.423,31,62,0.5,2,16,0.125,10,15,0.667,78
2423,CHO,12/26/2014,75,@,OKC,0,240,25,87,0.287,20,63,0.317,5,24,0.208,20,26,0.769,75,36,88,0.409,28,61,0.459,8,27,0.296,18,21,0.857,98
2424,MIA,12/14/2014,75,,CHI,0,240,28,80,0.35,24,58,0.414,4,22,0.182,15,18,0.833,75,33,71,0.465,24,53,0.453,9,18,0.5,18,21,0.857,93
2425,BRK,12/5/2014,75,,ATL,0,240,30,80,0.375,27,62,0.435,3,18,0.167,12,19,0.632,75,35,81,0.432,22,47,0.468,13,34,0.382,15,24,0.625,98
2426,CHO,11/29/2014,75,@,ATL,0,240,29,88,0.33,24,65,0.369,5,23,0.217,12,16,0.75,75,40,75,0.533,28,52,0.538,12,23,0.522,13,16,0.813,105
2427,PHI,11/17/2014,75,@,SAS,0,240,27,83,0.325,23,57,0.404,4,26,0.154,17,24,0.708,75,36,81,0.444,26,55,0.473,10,26,0.385,18,21,0.857,100
2428,MIA,11/12/2014,75,,IND,0,240,29,68,0.426,20,48,0.417,9,20,0.45,8,18,0.444,75,30,80,0.375,22,54,0.407,8,26,0.308,13,15,0.867,81
2429,NOP,4/8/2015,74,@,MEM,0,240,28,80,0.35,22,59,0.373,6,21,0.286,12,18,0.667,74,45,88,0.511,37,71,0.521,8,17,0.471,12,14,0.857,110
2430,CHO,4/8/2015,74,,TOR,0,240,28,81,0.346,18,59,0.305,10,22,0.455,8,11,0.727,74,33,77,0.429,21,50,0.42,12,27,0.444,14,19,0.737,92
2431,CHO,4/3/2015,74,@,IND,0,240,28,80,0.35,24,62,0.387,4,18,0.222,14,20,0.7,74,36,83,0.434,28,67,0.418,8,16,0.5,13,18,0.722,93
2432,PHO,3/19/2015,74,,NOP,1,240,29,83,0.349,27,61,0.443,2,22,0.091,14,21,0.667,74,31,83,0.373,26,65,0.4,5,18,0.278,5,10,0.5,72
2433,PHI,3/1/2015,74,@,IND,0,240,29,84,0.345,24,60,0.4,5,24,0.208,11,17,0.647,74,36,88,0.409,33,70,0.471,3,18,0.167,19,25,0.76,94
2434,PHO,2/28/2015,74,,SAS,0,240,25,84,0.298,20,68,0.294,5,16,0.313,19,24,0.792,74,41,92,0.446,37,73,0.507,4,19,0.211,15,17,0.882,101
2435,OKC,1/31/2015,74,@,MEM,0,240,27,78,0.346,21,58,0.362,6,20,0.3,14,18,0.778,74,34,91,0.374,31,80,0.388,3,11,0.273,14,17,0.824,85
2436,PHI,1/26/2015,74,@,NOP,0,240,28,81,0.346,26,66,0.394,2,15,0.133,16,21,0.762,74,39,86,0.453,32,70,0.457,7,16,0.438,14,19,0.737,99
2437,ORL,11/24/2014,74,@,CLE,0,240,29,80,0.363,24,63,0.381,5,17,0.294,11,15,0.733,74,42,81,0.519,36,65,0.554,6,16,0.375,16,22,0.727,106
2438,BRK,4/12/2015,73,@,MIL,0,240,27,83,0.325,24,65,0.369,3,18,0.167,16,22,0.727,73,41,83,0.494,35,63,0.556,6,20,0.3,8,12,0.667,96
2439,LAL,3/19/2015,73,,UTA,0,240,31,77,0.403,28,66,0.424,3,11,0.273,8,17,0.471,73,25,62,0.403,16,37,0.432,9,25,0.36,21,31,0.677,80
2440,BRK,1/24/2015,73,@,UTA,0,240,29,75,0.387,24,60,0.4,5,15,0.333,10,16,0.625,73,42,79,0.532,29,50,0.58,13,29,0.448,11,14,0.786,108
2441,IND,12/20/2014,73,@,DEN,0,240,27,88,0.307,20,65,0.308,7,23,0.304,12,17,0.706,73,30,82,0.366,28,66,0.424,2,16,0.125,14,19,0.737,76
2442,NOP,3/19/2015,72,@,PHO,0,240,31,83,0.373,26,65,0.4,5,18,0.278,5,10,0.5,72,29,83,0.349,27,61,0.443,2,22,0.091,14,21,0.667,74
2443,NOP,2/7/2015,72,,CHI,0,240,32,86,0.372,28,69,0.406,4,17,0.235,4,7,0.571,72,43,84,0.512,33,62,0.532,10,22,0.455,11,13,0.846,107
2444,MIA,1/30/2015,72,,DAL,0,240,29,88,0.33,20,59,0.339,9,29,0.31,5,10,0.5,72,34,82,0.415,21,53,0.396,13,29,0.448,12,20,0.6,93
2445,MIL,2/23/2015,71,@,CHI,0,240,30,89,0.337,26,71,0.366,4,18,0.222,7,13,0.538,71,27,76,0.355,19,50,0.38,8,26,0.308,25,32,0.781,87
2446,NYK,1/24/2015,71,@,CHO,0,240,28,79,0.354,22,64,0.344,6,15,0.4,9,18,0.5,71,25,76,0.329,23,69,0.333,2,7,0.286,24,37,0.649,76
2447,IND,1/17/2015,71,@,CHO,0,265,30,84,0.357,28,63,0.444,2,21,0.095,9,13,0.692,71,31,101,0.307,29,86,0.337,2,15,0.133,16,25,0.64,80
2448,PHI,12/27/2014,71,@,UTA,0,240,24,74,0.324,19,48,0.396,5,26,0.192,18,28,0.643,71,30,84,0.357,26,61,0.426,4,23,0.174,24,28,0.857,88
2449,MEM,11/1/2014,71,@,CHO,1,240,29,80,0.363,26,69,0.377,3,11,0.273,10,13,0.769,71,26,72,0.361,22,58,0.379,4,14,0.286,13,18,0.722,69
2450,PHI,12/12/2014,70,@,BRK,0,240,22,69,0.319,11,41,0.268,11,28,0.393,15,20,0.75,70,36,81,0.444,31,61,0.508,5,20,0.25,11,17,0.647,88
2451,PHI,11/13/2014,70,@,DAL,0,240,23,77,0.299,16,50,0.32,7,27,0.259,17,33,0.515,70,41,80,0.513,30,48,0.625,11,32,0.344,30,36,0.833,123
2452,PHO,4/7/2015,69,@,ATL,0,240,26,83,0.313,22,63,0.349,4,20,0.2,13,18,0.722,69,41,83,0.494,37,58,0.638,4,25,0.16,10,14,0.714,96
2453,CHO,3/9/2015,69,,WAS,0,240,25,77,0.325,21,55,0.382,4,22,0.182,15,20,0.75,69,44,85,0.518,42,71,0.592,2,14,0.143,5,5,1,95
2454,DEN,1/29/2015,69,@,MEM,0,240,29,87,0.333,27,61,0.443,2,26,0.077,9,10,0.9,69,39,88,0.443,36,72,0.5,3,16,0.188,18,27,0.667,99
2455,DET,1/28/2015,69,@,PHI,0,240,23,75,0.307,21,55,0.382,2,20,0.1,21,23,0.913,69,37,78,0.474,30,57,0.526,7,21,0.333,8,12,0.667,89
2456,UTA,1/18/2015,69,@,SAS,0,240,28,84,0.333,25,74,0.338,3,10,0.3,10,16,0.625,69,31,80,0.388,23,63,0.365,8,17,0.471,19,23,0.826,89
2457,HOU,11/16/2014,69,@,OKC,1,240,23,80,0.288,16,45,0.356,7,35,0.2,16,30,0.533,69,20,68,0.294,17,49,0.347,3,19,0.158,22,28,0.786,65
2458,CHO,11/1/2014,69,,MEM,0,240,26,72,0.361,22,58,0.379,4,14,0.286,13,18,0.722,69,29,80,0.363,26,69,0.377,3,11,0.273,10,13,0.769,71
2459,CHO,3/16/2015,66,@,UTA,0,240,23,78,0.295,18,59,0.305,5,19,0.263,15,18,0.833,66,33,78,0.423,18,54,0.333,15,24,0.625,13,19,0.684,94
2460,OKC,11/16/2014,65,,HOU,0,240,20,68,0.294,17,49,0.347,3,19,0.158,22,28,0.786,65,23,80,0.288,16,45,0.356,7,35,0.2,16,30,0.533,69
