Rk,Team,Date,PTS,Unnamed: 4,Opp,Result,MP,FG,FGA,FG%,2P,2PA,2P%,3P,3PA,3P%,FT,FTA,FT%,PTS.1,FG.1,FGA.1,FG%.1,2P.1,2PA.1,2P%.1,3P.1,3PA.1,3P%.1,FT.1,FTA.1,FT%.1,PTS.2
1,IND,2023-11-21,157,@,ATL,1,240,57,94,0.606,35,49,0.714,22,45,0.489,21,28,0.75,157,57,95,0.6,42,64,0.656,15,31,0.484,23,28,0.821,152
2,BOS,2023-11-01,155,,IND,1,240,54,95,0.568,34,60,0.567,20,35,0.571,27,28,0.964,155,46,101,0.455,41,64,0.641,5,37,0.135,7,12,0.583,104
3,UTA,2024-01-03,154,,DET,1,265,53,103,0.515,37,71,0.521,16,32,0.5,32,35,0.914,154,56,105,0.533,37,64,0.578,19,41,0.463,17,22,0.773,148
4,NOP,2024-01-23,153,,UTA,1,240,60,104,0.577,37,58,0.638,23,46,0.5,10,15,0.667,153,43,92,0.467,31,56,0.554,12,36,0.333,26,32,0.813,124
5,ATL,2023-11-21,152,,IND,0,240,57,95,0.6,42,64,0.656,15,31,0.484,23,28,0.821,152,57,94,0.606,35,49,0.714,22,45,0.489,21,28,0.75,157
6,IND,2023-11-06,152,,SAS,1,240,55,95,0.579,35,57,0.614,20,38,0.526,22,23,0.957,152,40,94,0.426,32,68,0.471,8,26,0.308,23,30,0.767,111
7,LAC,2023-12-18,151,@,IND,1,240,56,98,0.571,37,60,0.617,19,38,0.5,20,23,0.87,151,49,95,0.516,37,62,0.597,12,33,0.364,17,21,0.81,127
8,IND,2024-01-05,150,,ATL,1,240,60,94,0.638,41,55,0.745,19,39,0.487,11,13,0.846,150,40,93,0.43,30,51,0.588,10,42,0.238,26,30,0.867,116
9,LAC,2024-02-05,149,@,ATL,1,240,52,89,0.584,31,54,0.574,21,35,0.6,24,31,0.774,149,51,95,0.537,31,56,0.554,20,39,0.513,22,27,0.815,144
10,DAL,2024-01-26,148,@,ATL,1,240,51,85,0.6,32,50,0.64,19,35,0.543,27,32,0.844,148,51,97,0.526,36,63,0.571,15,34,0.441,26,30,0.867,143
11,DET,2024-01-03,148,@,UTA,0,265,56,105,0.533,37,64,0.578,19,41,0.463,17,22,0.773,148,53,103,0.515,37,71,0.521,16,32,0.5,32,35,0.914,154
12,BRK,2024-01-29,147,,UTA,1,240,54,105,0.514,33,60,0.55,21,45,0.467,18,19,0.947,147,39,86,0.453,30,59,0.508,9,27,0.333,27,34,0.794,114
13,DAL,2023-12-06,147,,UTA,1,240,56,101,0.554,34,52,0.654,22,49,0.449,13,19,0.684,147,35,87,0.402,23,54,0.426,12,33,0.364,15,18,0.833,97
14,ATL,2023-11-22,147,,BRK,1,265,51,116,0.44,33,67,0.493,18,49,0.367,27,29,0.931,147,55,113,0.487,40,78,0.513,15,35,0.429,20,24,0.833,145
15,NOP,2023-12-17,146,@,SAS,1,240,55,98,0.561,33,56,0.589,22,42,0.524,14,22,0.636,146,40,94,0.426,25,52,0.481,15,42,0.357,15,21,0.714,110
16,MIL,2023-12-16,146,,DET,1,240,50,88,0.568,31,46,0.674,19,42,0.452,27,32,0.844,146,43,96,0.448,37,68,0.544,6,28,0.214,22,26,0.846,114
17,PHI,2023-12-11,146,,WAS,1,240,52,95,0.547,32,49,0.653,20,46,0.435,22,25,0.88,146,36,85,0.424,27,54,0.5,9,31,0.29,20,31,0.645,101
18,MIL,2023-12-05,146,,NYK,1,240,55,91,0.604,32,53,0.604,23,38,0.605,13,19,0.684,146,43,87,0.494,36,64,0.563,7,23,0.304,29,33,0.879,122
19,PHI,2023-11-06,146,,WAS,1,240,51,91,0.56,39,60,0.65,12,31,0.387,32,36,0.889,146,49,96,0.51,35,62,0.565,14,34,0.412,16,20,0.8,128
20,LAL,2024-01-27,145,@,GSW,1,290,49,101,0.485,40,74,0.541,9,27,0.333,38,43,0.884,145,55,119,0.462,32,61,0.525,23,58,0.397,11,16,0.688,144
21,BOS,2024-01-13,145,,HOU,1,240,51,95,0.537,27,48,0.563,24,47,0.511,19,25,0.76,145,40,99,0.404,33,69,0.478,7,30,0.233,26,30,0.867,113
22,UTA,2024-01-12,145,,TOR,1,240,52,93,0.559,31,50,0.62,21,43,0.488,20,26,0.769,145,35,81,0.432,18,47,0.383,17,34,0.5,26,37,0.703,113
23,BOS,2023-12-23,145,@,LAC,1,240,49,94,0.521,24,41,0.585,25,53,0.472,22,28,0.786,145,41,89,0.461,30,55,0.545,11,34,0.324,15,15,1.0,108
24,BRK,2023-11-22,145,@,ATL,0,265,55,113,0.487,40,78,0.513,15,35,0.429,20,24,0.833,145,51,116,0.44,33,67,0.493,18,49,0.367,27,29,0.931,147
25,ATL,2024-02-05,144,,LAC,0,240,51,95,0.537,31,56,0.554,20,39,0.513,22,27,0.815,144,52,89,0.584,31,54,0.574,21,35,0.6,24,31,0.774,149
26,GSW,2024-01-27,144,,LAL,0,290,55,119,0.462,32,61,0.525,23,58,0.397,11,16,0.688,144,49,101,0.485,40,74,0.541,9,27,0.333,38,43,0.884,145
27,MIL,2023-12-27,144,@,BRK,1,240,52,89,0.584,29,38,0.763,23,51,0.451,17,23,0.739,144,45,101,0.446,38,69,0.551,7,32,0.219,25,29,0.862,122
28,DAL,2023-12-23,144,,SAS,1,240,52,100,0.52,29,55,0.527,23,45,0.511,17,21,0.81,144,44,98,0.449,30,53,0.566,14,45,0.311,17,24,0.708,119
29,IND,2023-12-20,144,,CHO,1,240,49,80,0.613,31,41,0.756,18,39,0.462,28,30,0.933,144,45,95,0.474,37,64,0.578,8,31,0.258,15,19,0.789,113
30,BOS,2023-12-20,144,@,SAC,1,240,51,92,0.554,29,50,0.58,22,42,0.524,20,24,0.833,144,43,91,0.473,22,47,0.468,21,44,0.477,12,23,0.522,119
31,LAC,2023-12-16,144,,NYK,1,240,50,88,0.568,34,55,0.618,16,33,0.485,28,34,0.824,144,44,94,0.468,33,59,0.559,11,35,0.314,23,26,0.885,122
32,IND,2023-12-02,144,@,MIA,1,240,56,85,0.659,40,53,0.755,16,32,0.5,16,20,0.8,144,48,89,0.539,36,64,0.563,12,25,0.48,21,24,0.875,129
33,DAL,2023-11-10,144,,LAC,1,240,51,98,0.52,32,56,0.571,19,42,0.452,23,26,0.885,144,43,88,0.489,35,61,0.574,8,27,0.296,32,36,0.889,126
34,ATL,2024-01-26,143,,DAL,0,240,51,97,0.526,36,63,0.571,15,34,0.441,26,30,0.867,143,51,85,0.6,32,50,0.64,19,35,0.543,27,32,0.844,148
35,BOS,2024-01-25,143,@,MIA,1,240,51,80,0.638,29,40,0.725,22,40,0.55,19,20,0.95,143,42,94,0.447,26,52,0.5,16,42,0.381,10,13,0.769,110
36,MIL,2024-01-14,143,,SAC,1,265,48,92,0.522,28,49,0.571,20,43,0.465,27,32,0.844,143,55,105,0.524,38,64,0.594,17,41,0.415,15,20,0.75,142
37,SAC,2023-12-18,143,,WAS,1,240,53,100,0.53,36,57,0.632,17,43,0.395,20,26,0.769,143,44,85,0.518,26,47,0.553,18,38,0.474,25,30,0.833,131
38,IND,2023-10-25,143,,WAS,1,240,56,107,0.523,36,64,0.563,20,43,0.465,11,12,0.917,143,44,96,0.458,35,72,0.486,9,24,0.375,23,29,0.793,120
39,SAC,2024-01-14,142,@,MIL,0,265,55,105,0.524,38,64,0.594,17,41,0.415,15,20,0.75,142,48,92,0.522,28,49,0.571,20,43,0.465,27,32,0.844,143
40,IND,2024-01-03,142,,MIL,1,240,50,90,0.556,36,55,0.655,14,35,0.4,28,34,0.824,142,46,92,0.5,32,55,0.582,14,37,0.378,24,32,0.75,130
41,DEN,2023-12-28,142,,MEM,1,240,55,96,0.573,35,55,0.636,20,41,0.488,12,14,0.857,142,37,89,0.416,24,54,0.444,13,35,0.371,18,25,0.72,105
42,NOP,2023-12-13,142,@,WAS,1,240,50,96,0.521,34,62,0.548,16,34,0.471,26,30,0.867,142,42,82,0.512,23,38,0.605,19,44,0.432,19,24,0.792,122
43,MIA,2023-11-30,142,,IND,1,240,48,86,0.558,40,65,0.615,8,21,0.381,38,45,0.844,142,50,98,0.51,39,55,0.709,11,43,0.256,21,32,0.656,132
44,MIL,2023-11-20,142,@,WAS,1,240,55,94,0.585,44,65,0.677,11,29,0.379,21,28,0.75,142,55,99,0.556,45,70,0.643,10,29,0.345,9,11,0.818,129
45,TOR,2023-11-19,142,,DET,1,240,55,102,0.539,41,66,0.621,14,36,0.389,18,29,0.621,142,39,83,0.47,30,57,0.526,9,26,0.346,26,35,0.743,113
46,ATL,2024-02-03,141,,GSW,1,265,55,114,0.482,41,71,0.577,14,43,0.326,17,22,0.773,141,50,112,0.446,32,56,0.571,18,56,0.321,16,20,0.8,134
47,MIL,2024-01-27,141,,NOP,1,240,51,91,0.56,31,46,0.674,20,45,0.444,19,25,0.76,141,40,85,0.471,31,62,0.5,9,23,0.391,28,36,0.778,117
48,LAL,2024-01-25,141,,CHI,1,240,53,87,0.609,33,56,0.589,20,31,0.645,15,20,0.75,141,47,88,0.534,35,51,0.686,12,37,0.324,26,29,0.897,132
49,MIL,2024-01-20,141,@,DET,1,240,47,85,0.553,35,53,0.66,12,32,0.375,35,49,0.714,141,44,94,0.468,23,57,0.404,21,37,0.568,26,32,0.813,135
50,NOP,2024-01-10,141,@,GSW,1,240,54,94,0.574,35,54,0.648,19,40,0.475,14,19,0.737,141,39,89,0.438,27,50,0.54,12,39,0.308,15,18,0.833,105
51,ATL,2024-01-03,141,,OKC,1,240,48,95,0.505,34,56,0.607,14,39,0.359,31,33,0.939,141,50,91,0.549,32,55,0.582,18,36,0.5,20,26,0.769,138
52,GSW,2023-11-03,141,@,OKC,1,240,49,92,0.533,31,52,0.596,18,40,0.45,25,30,0.833,141,50,83,0.602,35,54,0.648,15,29,0.517,24,30,0.8,139
53,PHO,2024-02-04,140,@,WAS,1,240,54,88,0.614,43,63,0.683,11,25,0.44,21,26,0.808,140,47,96,0.49,40,64,0.625,7,32,0.219,11,17,0.647,112
54,OKC,2024-01-24,140,@,SAS,1,240,54,96,0.563,36,56,0.643,18,40,0.45,14,16,0.875,140,43,86,0.5,34,54,0.63,9,32,0.281,19,25,0.76,114
55,GSW,2024-01-12,140,@,CHI,1,240,49,94,0.521,29,47,0.617,20,47,0.426,22,30,0.733,140,50,86,0.581,32,46,0.696,18,40,0.45,13,16,0.813,131
56,CLE,2024-01-03,140,,WAS,1,240,54,101,0.535,34,59,0.576,20,42,0.476,12,16,0.75,140,42,101,0.416,30,66,0.455,12,35,0.343,5,11,0.455,101
57,IND,2023-12-30,140,,NYK,1,240,50,85,0.588,27,42,0.643,23,43,0.535,17,21,0.81,140,45,95,0.474,28,58,0.483,17,37,0.459,19,27,0.704,126
58,MIL,2023-12-13,140,,IND,1,240,48,89,0.539,41,62,0.661,7,27,0.259,37,48,0.771,140,45,100,0.45,34,64,0.531,11,36,0.306,25,32,0.781,126
59,PHO,2023-11-19,140,@,UTA,1,290,50,102,0.49,32,57,0.561,18,45,0.4,22,26,0.846,140,48,115,0.417,33,69,0.478,15,46,0.326,26,32,0.813,137
60,OKC,2024-01-11,139,,POR,1,240,53,93,0.57,39,58,0.672,14,35,0.4,19,22,0.864,139,28,101,0.277,17,52,0.327,11,49,0.224,10,16,0.625,77
61,ATL,2024-01-10,139,,PHI,1,265,48,102,0.471,36,68,0.529,12,34,0.353,31,42,0.738,139,46,102,0.451,34,68,0.5,12,34,0.353,28,33,0.848,132
62,DAL,2024-01-05,139,,POR,1,240,56,96,0.583,39,58,0.672,17,38,0.447,10,15,0.667,139,39,95,0.411,26,55,0.473,13,40,0.325,12,17,0.706,103
63,NYK,2023-12-15,139,@,PHO,1,240,49,82,0.598,32,53,0.604,17,29,0.586,24,28,0.857,139,47,90,0.522,36,62,0.581,11,28,0.393,17,21,0.81,122
64,ORL,2023-11-29,139,,WAS,1,240,51,84,0.607,34,57,0.596,17,27,0.63,20,24,0.833,139,41,87,0.471,30,58,0.517,11,29,0.379,27,35,0.771,120
65,OKC,2023-11-03,139,,GSW,0,240,50,83,0.602,35,54,0.648,15,29,0.517,24,30,0.8,139,49,92,0.533,31,52,0.596,18,40,0.45,25,30,0.833,141
66,NOP,2024-02-05,138,,TOR,1,240,53,104,0.51,34,59,0.576,19,45,0.422,13,13,1.0,138,40,84,0.476,30,53,0.566,10,31,0.323,10,15,0.667,100
67,ATL,2024-01-30,138,,LAL,1,240,53,101,0.525,37,63,0.587,16,38,0.421,16,18,0.889,138,48,90,0.533,36,57,0.632,12,33,0.364,14,25,0.56,122
68,HOU,2024-01-26,138,@,CHO,1,240,50,89,0.562,37,56,0.661,13,33,0.394,25,31,0.806,138,35,85,0.412,26,56,0.464,9,29,0.31,25,32,0.781,104
69,LAC,2024-01-08,138,,PHO,1,240,53,85,0.624,38,56,0.679,15,29,0.517,17,23,0.739,138,38,77,0.494,28,47,0.596,10,30,0.333,25,29,0.862,111
70,SAC,2024-01-03,138,,ORL,1,290,51,105,0.486,36,65,0.554,15,40,0.375,21,31,0.677,138,44,90,0.489,19,46,0.413,25,44,0.568,22,27,0.815,135
71,OKC,2024-01-03,138,@,ATL,0,240,50,91,0.549,32,55,0.582,18,36,0.5,20,26,0.769,138,48,95,0.505,34,56,0.607,14,39,0.359,31,33,0.939,141
72,OKC,2023-12-08,138,,GSW,1,265,51,98,0.52,46,69,0.667,5,29,0.172,31,36,0.861,138,49,104,0.471,30,56,0.536,19,48,0.396,19,23,0.826,136
73,PHI,2023-11-27,138,,LAL,1,240,47,93,0.505,25,47,0.532,22,46,0.478,22,26,0.846,138,39,83,0.47,32,55,0.582,7,28,0.25,9,13,0.692,94
74,POR,2024-01-24,137,@,HOU,1,265,50,98,0.51,35,63,0.556,15,35,0.429,22,24,0.917,137,50,94,0.532,38,58,0.655,12,36,0.333,19,22,0.864,131
75,WAS,2023-12-15,137,,IND,1,240,52,92,0.565,39,65,0.6,13,27,0.481,20,26,0.769,137,48,107,0.449,33,67,0.493,15,40,0.375,12,16,0.75,123
76,ATL,2023-11-30,137,@,SAS,1,240,49,96,0.51,35,63,0.556,14,33,0.424,25,29,0.862,137,48,89,0.539,30,48,0.625,18,41,0.439,21,23,0.913,135
77,UTA,2023-11-19,137,,PHO,0,290,48,115,0.417,33,69,0.478,15,46,0.326,26,32,0.813,137,50,102,0.49,32,57,0.561,18,45,0.4,22,26,0.846,140
78,PHI,2023-11-12,137,,IND,1,240,53,105,0.505,39,72,0.542,14,33,0.424,17,20,0.85,137,47,90,0.522,31,51,0.608,16,39,0.41,16,19,0.842,126
79,CLE,2024-02-05,136,,SAC,1,240,51,88,0.58,28,47,0.596,23,41,0.561,11,17,0.647,136,43,93,0.462,26,49,0.531,17,44,0.386,7,12,0.583,110
80,BRK,2024-02-03,136,@,PHI,1,240,49,95,0.516,29,44,0.659,20,51,0.392,18,23,0.783,136,44,96,0.458,32,67,0.478,12,29,0.414,21,27,0.778,121
81,LAC,2024-02-02,136,@,DET,1,240,53,89,0.596,39,60,0.65,14,29,0.483,16,19,0.842,136,45,89,0.506,28,49,0.571,17,40,0.425,18,24,0.75,125
82,PHO,2024-01-31,136,@,BRK,1,240,49,79,0.62,35,51,0.686,14,28,0.5,24,32,0.75,136,47,94,0.5,31,55,0.564,16,39,0.41,10,13,0.769,120
83,OKC,2024-01-08,136,@,WAS,1,240,52,88,0.591,38,60,0.633,14,28,0.5,18,24,0.75,136,44,89,0.494,29,57,0.509,15,32,0.469,25,29,0.862,128
84,HOU,2024-01-01,136,,DET,1,240,51,91,0.56,36,56,0.643,15,35,0.429,19,24,0.792,136,40,83,0.482,27,54,0.5,13,29,0.448,20,27,0.741,113
85,NYK,2023-12-11,136,,TOR,1,240,52,86,0.605,35,57,0.614,17,29,0.586,15,23,0.652,136,47,96,0.49,33,57,0.579,14,39,0.359,22,30,0.733,130
86,GSW,2023-12-08,136,@,OKC,0,265,49,104,0.471,30,56,0.536,19,48,0.396,19,23,0.826,136,51,98,0.52,46,69,0.667,5,29,0.172,31,36,0.861,138
87,ATL,2023-11-25,136,@,WAS,1,240,52,102,0.51,34,65,0.523,18,37,0.486,14,20,0.7,136,43,88,0.489,33,50,0.66,10,38,0.263,12,12,1.0,108
88,IND,2023-11-24,136,,DET,1,240,49,102,0.48,33,64,0.516,16,38,0.421,22,24,0.917,136,43,90,0.478,36,72,0.5,7,18,0.389,20,24,0.833,113
89,DAL,2023-11-12,136,@,NOP,1,240,50,102,0.49,30,49,0.612,20,53,0.377,16,21,0.762,136,47,92,0.511,30,56,0.536,17,36,0.472,13,22,0.591,124
90,OKC,2024-02-04,135,,TOR,1,290,52,110,0.473,29,47,0.617,23,63,0.365,8,8,1.0,135,48,101,0.475,34,66,0.515,14,35,0.4,17,21,0.81,127
91,HOU,2024-02-02,135,,TOR,1,240,55,93,0.591,44,62,0.71,11,31,0.355,14,17,0.824,135,40,91,0.44,29,58,0.5,11,33,0.333,15,20,0.75,106
92,HOU,2024-01-29,135,,LAL,1,240,52,98,0.531,40,62,0.645,12,36,0.333,19,25,0.76,135,45,91,0.495,32,56,0.571,13,35,0.371,16,26,0.615,119
93,DET,2024-01-20,135,,MIL,0,240,44,94,0.468,23,57,0.404,21,37,0.568,26,32,0.813,135,47,85,0.553,35,53,0.66,12,32,0.375,35,49,0.714,141
94,CLE,2024-01-17,135,,MIL,1,240,55,93,0.591,43,65,0.662,12,28,0.429,13,19,0.684,135,38,95,0.4,26,53,0.491,12,42,0.286,7,10,0.7,95
95,SAS,2024-01-12,135,,CHO,1,240,45,87,0.517,27,49,0.551,18,38,0.474,27,34,0.794,135,32,89,0.36,22,55,0.4,10,34,0.294,25,28,0.893,99
96,MIL,2024-01-11,135,,BOS,1,240,52,92,0.565,34,50,0.68,18,42,0.429,13,16,0.813,135,34,91,0.374,25,56,0.446,9,35,0.257,25,30,0.833,102
97,SAC,2024-01-05,135,,TOR,1,240,52,100,0.52,31,62,0.5,21,38,0.553,10,15,0.667,135,47,87,0.54,34,50,0.68,13,37,0.351,23,27,0.852,130
98,ORL,2024-01-03,135,@,SAC,0,290,44,90,0.489,19,46,0.413,25,44,0.568,22,27,0.815,135,51,105,0.486,36,65,0.554,15,40,0.375,21,31,0.677,138
99,CLE,2023-12-18,135,,HOU,1,265,47,97,0.485,28,49,0.571,19,48,0.396,22,34,0.647,135,47,102,0.461,35,69,0.507,12,33,0.364,24,27,0.889,130
100,PHI,2023-12-16,135,@,CHO,1,240,53,88,0.602,39,57,0.684,14,31,0.452,15,17,0.882,135,33,91,0.363,26,56,0.464,7,35,0.2,9,11,0.818,82
101,TOR,2023-12-13,135,,ATL,1,240,50,87,0.575,32,53,0.604,18,34,0.529,17,24,0.708,135,48,100,0.48,30,59,0.508,18,41,0.439,14,19,0.737,128
102,SAS,2023-11-30,135,,ATL,0,240,48,89,0.539,30,48,0.625,18,41,0.439,21,23,0.913,135,49,96,0.51,35,63,0.556,14,33,0.424,25,29,0.862,137
103,GSW,2024-02-03,134,@,ATL,0,265,50,112,0.446,32,56,0.571,18,56,0.321,16,20,0.8,134,55,114,0.482,41,71,0.577,14,43,0.326,17,22,0.773,141
104,UTA,2024-01-27,134,@,CHO,1,240,52,93,0.559,35,52,0.673,17,41,0.415,13,17,0.765,134,47,92,0.511,34,60,0.567,13,32,0.406,15,21,0.714,122
105,IND,2024-01-25,134,,PHI,1,240,53,93,0.57,41,65,0.631,12,28,0.429,16,21,0.762,134,42,87,0.483,35,58,0.603,7,29,0.241,31,43,0.721,122
106,SAC,2024-01-25,134,@,GSW,1,240,48,91,0.527,26,43,0.605,22,48,0.458,16,19,0.842,134,48,86,0.558,29,49,0.592,19,37,0.514,18,23,0.783,133
107,GSW,2024-01-24,134,,ATL,1,240,51,91,0.56,35,58,0.603,16,33,0.485,16,22,0.727,134,39,94,0.415,25,51,0.49,14,43,0.326,20,26,0.769,112
108,LAL,2024-01-21,134,,POR,1,240,47,86,0.547,34,53,0.642,13,33,0.394,27,29,0.931,134,42,90,0.467,33,61,0.541,9,29,0.31,17,20,0.85,110
109,OKC,2024-01-18,134,@,UTA,1,240,48,86,0.558,34,54,0.63,14,32,0.438,24,28,0.857,134,43,89,0.483,30,57,0.526,13,32,0.406,30,36,0.833,129
110,POR,2024-01-07,134,@,BRK,1,265,45,95,0.474,25,57,0.439,20,38,0.526,24,30,0.8,134,46,91,0.505,32,54,0.593,14,37,0.378,21,25,0.84,127
111,BOS,2023-12-31,134,@,SAS,1,240,51,95,0.537,36,53,0.679,15,42,0.357,17,22,0.773,134,40,94,0.426,28,49,0.571,12,45,0.267,9,12,0.75,101
112,POR,2023-12-29,134,,SAS,1,240,48,95,0.505,32,68,0.471,16,27,0.593,22,27,0.815,134,48,94,0.511,34,61,0.557,14,33,0.424,18,25,0.72,128
113,OKC,2023-12-21,134,,LAC,1,240,51,87,0.586,35,53,0.66,16,34,0.471,16,18,0.889,134,44,93,0.473,27,50,0.54,17,43,0.395,10,12,0.833,115
114,ATL,2023-12-20,134,@,HOU,1,240,47,91,0.516,30,51,0.588,17,40,0.425,23,28,0.821,134,44,89,0.494,28,55,0.509,16,34,0.471,23,23,1.0,127
115,OKC,2023-12-11,134,,UTA,1,240,50,96,0.521,32,58,0.552,18,38,0.474,16,17,0.941,134,44,92,0.478,32,54,0.593,12,38,0.316,20,21,0.952,120
116,DEN,2023-11-29,134,,HOU,1,240,48,95,0.505,29,52,0.558,19,43,0.442,19,26,0.731,134,47,86,0.547,31,45,0.689,16,41,0.39,14,19,0.737,124
117,OKC,2023-11-19,134,@,POR,1,240,49,81,0.605,27,45,0.6,22,36,0.611,14,14,1.0,134,34,85,0.4,25,51,0.49,9,34,0.265,14,21,0.667,91
118,LAL,2023-11-14,134,,MEM,1,240,47,81,0.58,25,46,0.543,22,35,0.629,18,24,0.75,134,39,106,0.368,19,53,0.358,20,53,0.377,9,12,0.75,107
119,IND,2023-11-08,134,,UTA,1,240,52,101,0.515,39,60,0.65,13,41,0.317,17,20,0.85,134,45,96,0.469,34,69,0.493,11,27,0.407,17,18,0.944,118
120,DEN,2023-11-06,134,,NOP,1,240,51,95,0.537,36,56,0.643,15,39,0.385,17,23,0.739,134,45,90,0.5,32,60,0.533,13,30,0.433,13,15,0.867,116
121,DET,2024-02-07,133,@,SAC,1,240,47,84,0.56,30,53,0.566,17,31,0.548,22,22,1.0,133,45,95,0.474,30,51,0.588,15,44,0.341,15,22,0.682,120
122,SAC,2024-02-02,133,@,IND,1,240,51,90,0.567,38,56,0.679,13,34,0.382,18,28,0.643,133,46,85,0.541,36,56,0.643,10,29,0.345,20,24,0.833,122
123,IND,2024-01-26,133,,PHO,1,240,58,109,0.532,50,83,0.602,8,26,0.308,9,15,0.6,133,51,89,0.573,38,59,0.644,13,30,0.433,16,18,0.889,131
124,GSW,2024-01-25,133,,SAC,0,240,48,86,0.558,29,49,0.592,19,37,0.514,18,23,0.783,133,48,91,0.527,26,43,0.605,22,48,0.458,16,19,0.842,134
125,PHI,2024-01-22,133,,SAS,1,240,48,97,0.495,43,77,0.558,5,20,0.25,32,40,0.8,133,43,93,0.462,30,52,0.577,13,41,0.317,24,27,0.889,123
126,IND,2024-01-08,133,,BOS,1,240,48,91,0.527,29,51,0.569,19,40,0.475,18,22,0.818,133,47,90,0.522,30,55,0.545,17,35,0.486,20,29,0.69,131
127,TOR,2024-01-07,133,@,GSW,1,240,55,94,0.585,40,61,0.656,15,33,0.455,8,14,0.571,133,45,100,0.45,31,54,0.574,14,46,0.304,14,15,0.933,118
128,NOP,2024-01-07,133,@,SAC,1,240,50,82,0.61,31,47,0.66,19,35,0.543,14,16,0.875,133,38,91,0.418,23,46,0.5,15,45,0.333,9,12,0.75,100
129,PHO,2023-12-29,133,,CHO,1,240,46,74,0.622,28,44,0.636,18,30,0.6,23,24,0.958,133,44,92,0.478,21,46,0.457,23,46,0.5,8,8,1.0,119
130,LAL,2023-12-28,133,,CHO,1,240,52,97,0.536,37,67,0.552,15,30,0.5,14,14,1.0,133,40,85,0.471,25,52,0.481,15,33,0.455,17,28,0.607,112
131,MIL,2023-12-11,133,,CHI,1,265,44,86,0.512,29,49,0.592,15,37,0.405,30,37,0.811,133,47,114,0.412,32,80,0.4,15,34,0.441,20,25,0.8,129
132,BOS,2023-12-08,133,,NYK,1,240,48,91,0.527,29,44,0.659,19,47,0.404,18,21,0.857,133,44,88,0.5,29,51,0.569,15,37,0.405,20,27,0.741,123
133,LAL,2023-12-07,133,,NOP,1,240,47,86,0.547,30,51,0.588,17,35,0.486,22,29,0.759,133,34,95,0.358,27,64,0.422,7,31,0.226,14,20,0.7,89
134,OKC,2023-11-30,133,,LAL,1,240,50,94,0.532,36,52,0.692,14,42,0.333,19,22,0.864,133,36,81,0.444,25,48,0.521,11,33,0.333,27,32,0.844,110
135,LAL,2023-11-29,133,@,DET,1,240,45,88,0.511,33,54,0.611,12,34,0.353,31,38,0.816,133,40,97,0.412,25,61,0.41,15,36,0.417,12,14,0.857,107
136,PHO,2023-11-15,133,,MIN,1,240,51,85,0.6,34,54,0.63,17,31,0.548,14,15,0.933,133,42,92,0.457,37,65,0.569,5,27,0.185,26,28,0.929,115
137,UTA,2023-11-01,133,,MEM,1,240,47,87,0.54,25,44,0.568,22,43,0.512,17,24,0.708,133,35,96,0.365,21,42,0.5,14,54,0.259,25,32,0.781,109
138,BRK,2023-10-30,133,@,CHO,1,240,49,87,0.563,37,54,0.685,12,33,0.364,23,32,0.719,133,47,96,0.49,39,65,0.6,8,31,0.258,19,20,0.95,121
139,IND,2024-02-06,132,,HOU,1,240,54,86,0.628,39,54,0.722,15,32,0.469,9,14,0.643,132,50,97,0.515,38,72,0.528,12,25,0.48,17,23,0.739,129
140,CHI,2024-01-25,132,@,LAL,0,240,47,88,0.534,35,51,0.686,12,37,0.324,26,29,0.897,132,53,87,0.609,33,56,0.589,20,31,0.645,15,20,0.75,141
141,PHO,2024-01-24,132,@,DAL,1,240,51,85,0.6,37,51,0.725,14,34,0.412,16,22,0.727,132,41,89,0.461,24,46,0.522,17,43,0.395,10,18,0.556,109
142,NOP,2024-01-17,132,,CHO,1,240,44,88,0.5,19,41,0.463,25,47,0.532,19,23,0.826,132,39,90,0.433,20,45,0.444,19,45,0.422,15,18,0.833,112
143,UTA,2024-01-15,132,,IND,1,240,45,81,0.556,34,56,0.607,11,25,0.44,31,35,0.886,132,38,95,0.4,29,64,0.453,9,31,0.29,20,25,0.8,105
144,UTA,2024-01-13,132,,LAL,1,240,42,93,0.452,30,56,0.536,12,37,0.324,36,39,0.923,132,46,92,0.5,33,63,0.524,13,29,0.448,20,24,0.833,125
145,PHI,2024-01-10,132,@,ATL,0,265,46,102,0.451,34,68,0.5,12,34,0.353,28,33,0.848,132,48,102,0.471,36,68,0.529,12,34,0.353,31,42,0.738,139
146,LAL,2024-01-09,132,,TOR,1,240,44,81,0.543,28,45,0.622,16,36,0.444,28,36,0.778,132,53,94,0.564,36,59,0.61,17,35,0.486,8,13,0.615,131
147,UTA,2024-01-08,132,@,MIL,1,240,47,90,0.522,27,46,0.587,20,44,0.455,18,22,0.818,132,42,94,0.447,25,58,0.431,17,36,0.472,15,19,0.789,116
148,DAL,2023-12-30,132,@,GSW,1,240,49,88,0.557,33,48,0.688,16,40,0.4,18,22,0.818,132,47,103,0.456,28,55,0.509,19,48,0.396,9,13,0.692,122
149,TOR,2023-12-27,132,@,WAS,1,240,52,91,0.571,37,53,0.698,15,38,0.395,13,19,0.684,132,42,90,0.467,34,57,0.596,8,33,0.242,10,15,0.667,102
150,MIL,2023-12-19,132,,SAS,1,240,50,106,0.472,32,57,0.561,18,49,0.367,14,18,0.778,132,46,96,0.479,37,66,0.561,9,30,0.3,18,21,0.857,119
151,GSW,2023-12-19,132,,BOS,1,265,50,109,0.459,30,59,0.508,20,50,0.4,12,14,0.857,132,47,114,0.412,30,56,0.536,17,58,0.293,15,17,0.882,126
152,LAC,2023-12-11,132,,POR,1,240,49,89,0.551,36,55,0.655,13,34,0.382,21,22,0.955,132,43,90,0.478,24,50,0.48,19,40,0.475,22,26,0.846,127
153,MIL,2023-12-02,132,,ATL,1,240,53,89,0.596,39,56,0.696,14,33,0.424,12,15,0.8,132,45,101,0.446,30,63,0.476,15,38,0.395,16,21,0.762,121
154,IND,2023-11-30,132,@,MIA,0,240,50,98,0.51,39,55,0.709,11,43,0.256,21,32,0.656,132,48,86,0.558,40,65,0.615,8,21,0.381,38,45,0.844,142
155,DEN,2023-11-26,132,,SAS,1,240,50,89,0.562,38,61,0.623,12,28,0.429,20,25,0.8,132,42,93,0.452,28,56,0.5,14,37,0.378,22,26,0.846,120
156,TOR,2023-11-22,132,@,IND,1,240,48,90,0.533,37,63,0.587,11,27,0.407,25,30,0.833,132,50,91,0.549,32,52,0.615,18,39,0.462,13,16,0.813,131
157,MIL,2023-11-18,132,,DAL,1,240,49,94,0.521,32,49,0.653,17,45,0.378,17,20,0.85,132,51,103,0.495,35,56,0.625,16,47,0.34,7,10,0.7,125
158,IND,2023-11-14,132,@,PHI,1,240,48,93,0.516,35,56,0.625,13,37,0.351,23,33,0.697,132,43,86,0.5,37,64,0.578,6,22,0.273,34,35,0.971,126
159,SAC,2023-11-13,132,,CLE,1,240,49,83,0.59,29,41,0.707,20,42,0.476,14,22,0.636,132,45,91,0.495,29,56,0.518,16,35,0.457,14,17,0.824,120
160,WAS,2023-11-08,132,@,CHO,1,240,47,97,0.485,29,54,0.537,18,43,0.419,20,25,0.8,132,41,79,0.519,33,54,0.611,8,25,0.32,26,35,0.743,116
161,SAS,2023-11-02,132,@,PHO,1,240,51,98,0.52,33,61,0.541,18,37,0.486,12,13,0.923,132,43,80,0.538,27,48,0.563,16,32,0.5,19,26,0.731,121
162,SAC,2023-10-29,132,,LAL,1,265,49,104,0.471,32,56,0.571,17,48,0.354,17,24,0.708,132,43,98,0.439,28,53,0.528,15,45,0.333,26,34,0.765,127
163,BOS,2024-02-04,131,,MEM,1,240,48,99,0.485,29,48,0.604,19,51,0.373,16,18,0.889,131,35,92,0.38,24,54,0.444,11,38,0.289,10,12,0.833,91
164,DAL,2024-01-29,131,,ORL,1,240,43,69,0.623,30,42,0.714,13,27,0.481,32,43,0.744,131,45,88,0.511,27,50,0.54,18,38,0.474,21,28,0.75,129
165,PHO,2024-01-26,131,@,IND,0,240,51,89,0.573,38,59,0.644,13,30,0.433,16,18,0.889,131,58,109,0.532,50,83,0.602,8,26,0.308,9,15,0.6,133
166,HOU,2024-01-24,131,,POR,0,265,50,94,0.532,38,58,0.655,12,36,0.333,19,22,0.864,131,50,98,0.51,35,63,0.556,15,35,0.429,22,24,0.917,137
167,SAS,2024-01-20,131,@,WAS,1,240,51,96,0.531,39,65,0.6,12,31,0.387,17,23,0.739,131,49,103,0.476,40,74,0.541,9,29,0.31,20,23,0.87,127
168,CHI,2024-01-12,131,,GSW,0,240,50,86,0.581,32,46,0.696,18,40,0.45,13,16,0.813,131,49,94,0.521,29,47,0.617,20,47,0.426,22,30,0.733,140
169,SAC,2024-01-09,131,@,DET,1,240,54,94,0.574,41,61,0.672,13,33,0.394,10,14,0.714,131,40,85,0.471,26,48,0.542,14,37,0.378,16,21,0.762,110
170,TOR,2024-01-09,131,@,LAL,0,240,53,94,0.564,36,59,0.61,17,35,0.486,8,13,0.615,131,44,81,0.543,28,45,0.622,16,36,0.444,28,36,0.778,132
171,BOS,2024-01-08,131,@,IND,0,240,47,90,0.522,30,55,0.545,17,35,0.486,20,29,0.69,131,48,91,0.527,29,51,0.569,19,40,0.475,18,22,0.818,133
172,DEN,2024-01-07,131,,DET,1,240,47,80,0.588,37,53,0.698,10,27,0.37,27,31,0.871,131,42,89,0.472,33,65,0.508,9,24,0.375,21,30,0.7,114
173,LAC,2024-01-03,131,@,PHO,1,240,42,76,0.553,24,42,0.571,18,34,0.529,29,32,0.906,131,42,79,0.532,27,44,0.614,15,35,0.429,23,26,0.885,122
174,PHI,2023-12-29,131,@,HOU,1,240,45,86,0.523,33,53,0.623,12,33,0.364,29,33,0.879,131,49,91,0.538,35,61,0.574,14,30,0.467,15,21,0.714,127
175,WAS,2023-12-18,131,@,SAC,0,240,44,85,0.518,26,47,0.553,18,38,0.474,25,30,0.833,131,53,100,0.53,36,57,0.632,17,43,0.395,20,26,0.769,143
176,DAL,2023-12-16,131,@,POR,1,240,48,97,0.495,32,50,0.64,16,47,0.34,19,21,0.905,131,47,94,0.5,40,62,0.645,7,32,0.219,19,22,0.864,120
177,IND,2023-12-11,131,@,DET,1,240,52,92,0.565,39,61,0.639,13,31,0.419,14,19,0.737,131,45,81,0.556,35,52,0.673,10,29,0.345,23,30,0.767,123
178,SAC,2023-12-11,131,,BRK,1,240,48,94,0.511,23,49,0.469,25,45,0.556,10,14,0.714,131,42,88,0.477,28,59,0.475,14,29,0.483,20,21,0.952,118
179,PHI,2023-12-06,131,@,WAS,1,240,47,92,0.511,39,65,0.6,8,27,0.296,29,34,0.853,131,52,92,0.565,38,57,0.667,14,35,0.4,8,8,1.0,126
180,LAC,2023-11-29,131,@,SAC,1,240,50,93,0.538,36,65,0.554,14,28,0.5,17,22,0.773,131,40,86,0.465,27,45,0.6,13,41,0.317,24,28,0.857,117
181,MIL,2023-11-28,131,@,MIA,1,240,47,88,0.534,34,53,0.642,13,35,0.371,24,27,0.889,131,48,94,0.511,34,64,0.531,14,30,0.467,14,21,0.667,124
182,MIL,2023-11-24,131,,WAS,1,240,48,92,0.522,39,61,0.639,9,31,0.29,26,33,0.788,131,48,100,0.48,33,63,0.524,15,37,0.405,17,21,0.81,128
183,IND,2023-11-22,131,,TOR,0,240,50,91,0.549,32,52,0.615,18,39,0.462,13,16,0.813,131,48,90,0.533,37,63,0.587,11,27,0.407,25,30,0.833,132
184,LAL,2023-11-21,131,,UTA,1,240,49,86,0.57,38,57,0.667,11,29,0.379,22,27,0.815,131,38,98,0.388,27,54,0.5,11,44,0.25,12,16,0.75,99
185,PHO,2023-11-17,131,@,UTA,1,240,45,86,0.523,27,53,0.509,18,33,0.545,23,26,0.885,131,43,85,0.506,27,49,0.551,16,36,0.444,26,31,0.839,128
186,NOP,2023-11-14,131,,DAL,1,240,49,94,0.521,35,56,0.625,14,38,0.368,19,26,0.731,131,38,90,0.422,24,48,0.5,14,42,0.333,20,26,0.769,110
187,POR,2024-01-29,130,,PHI,1,240,46,84,0.548,34,56,0.607,12,28,0.429,26,29,0.897,130,37,83,0.446,32,54,0.593,5,29,0.172,25,28,0.893,104
188,BRK,2024-01-19,130,@,LAL,1,240,50,95,0.526,31,48,0.646,19,47,0.404,11,14,0.786,130,40,90,0.444,28,57,0.491,12,33,0.364,20,24,0.833,112
189,SAS,2024-01-10,130,@,DET,1,240,49,94,0.521,40,67,0.597,9,27,0.333,23,27,0.852,130,44,96,0.458,34,64,0.531,10,32,0.313,10,13,0.769,108
190,TOR,2024-01-05,130,@,SAC,0,240,47,87,0.54,34,50,0.68,13,37,0.351,23,27,0.852,130,52,100,0.52,31,62,0.5,21,38,0.553,10,15,0.667,135
191,DEN,2024-01-04,130,@,GSW,1,240,48,85,0.565,39,59,0.661,9,26,0.346,25,29,0.862,130,49,90,0.544,34,54,0.63,15,36,0.417,14,16,0.875,127
192,MIL,2024-01-03,130,@,IND,0,240,46,92,0.5,32,55,0.582,14,37,0.378,24,32,0.75,130,50,90,0.556,36,55,0.655,14,35,0.4,28,34,0.824,142
193,ATL,2023-12-31,130,@,WAS,1,240,47,95,0.495,35,63,0.556,12,32,0.375,24,37,0.649,130,46,98,0.469,29,45,0.644,17,53,0.321,17,21,0.81,126
194,UTA,2023-12-26,130,@,SAS,1,240,47,95,0.495,31,52,0.596,16,43,0.372,20,22,0.909,130,44,98,0.449,28,63,0.444,16,35,0.457,14,21,0.667,118
195,POR,2023-12-26,130,,SAC,1,240,49,98,0.5,33,58,0.569,16,40,0.4,16,20,0.8,130,45,93,0.484,35,51,0.686,10,42,0.238,13,16,0.813,113
196,MIL,2023-12-23,130,@,NYK,1,240,48,91,0.527,32,59,0.542,16,32,0.5,18,23,0.783,130,41,93,0.441,32,64,0.5,9,29,0.31,20,21,0.952,111
197,HOU,2023-12-18,130,@,CLE,0,265,47,102,0.461,35,69,0.507,12,33,0.364,24,27,0.889,130,47,97,0.485,28,49,0.571,19,48,0.396,22,34,0.647,135
198,ATL,2023-12-18,130,,DET,1,240,46,85,0.541,30,49,0.612,16,36,0.444,22,27,0.815,130,48,94,0.511,39,72,0.542,9,22,0.409,19,27,0.704,124
199,DEN,2023-12-18,130,,DAL,1,240,49,87,0.563,35,61,0.574,14,26,0.538,18,22,0.818,130,41,92,0.446,28,54,0.519,13,38,0.342,9,19,0.474,104
200,TOR,2023-12-11,130,@,NYK,0,240,47,96,0.49,33,57,0.579,14,39,0.359,22,30,0.733,130,52,86,0.605,35,57,0.614,17,29,0.586,15,23,0.652,136
201,ORL,2023-12-01,130,,WAS,1,240,46,89,0.517,34,58,0.586,12,31,0.387,26,33,0.788,130,45,89,0.506,32,61,0.525,13,28,0.464,22,31,0.71,125
202,ORL,2023-11-26,130,,CHO,1,240,47,87,0.54,37,60,0.617,10,27,0.37,26,33,0.788,130,44,83,0.53,31,53,0.585,13,30,0.433,16,25,0.64,117
203,OKC,2023-11-18,130,@,GSW,1,265,52,100,0.52,44,77,0.571,8,23,0.348,18,20,0.9,130,44,97,0.454,26,51,0.51,18,46,0.391,17,21,0.81,123
204,MIL,2023-11-17,130,@,CHO,1,240,49,89,0.551,27,44,0.614,22,45,0.489,10,13,0.769,130,37,91,0.407,31,65,0.477,6,26,0.231,19,22,0.864,99
205,DAL,2023-11-15,130,@,WAS,1,240,48,92,0.522,31,50,0.62,17,42,0.405,17,29,0.586,130,43,89,0.483,31,53,0.585,12,36,0.333,19,23,0.826,117
206,CHI,2023-11-06,130,,UTA,1,240,48,93,0.516,30,59,0.508,18,34,0.529,16,19,0.842,130,41,86,0.477,25,43,0.581,16,43,0.372,15,17,0.882,113
207,LAL,2023-11-01,130,,LAC,1,265,46,90,0.511,35,58,0.603,11,32,0.344,27,36,0.75,130,47,99,0.475,33,65,0.508,14,34,0.412,17,27,0.63,125
208,TOR,2023-11-01,130,,MIL,1,240,51,91,0.56,36,53,0.679,15,38,0.395,13,14,0.929,130,35,76,0.461,22,42,0.524,13,34,0.382,28,38,0.737,111
209,ATL,2023-11-01,130,,WAS,1,240,46,92,0.5,37,60,0.617,9,32,0.281,29,32,0.906,130,51,101,0.505,41,61,0.672,10,40,0.25,9,14,0.643,121
210,GSW,2023-10-30,130,@,NOP,1,240,51,98,0.52,36,57,0.632,15,41,0.366,13,20,0.65,130,38,93,0.409,28,54,0.519,10,39,0.256,16,26,0.615,102
211,SAC,2023-10-25,130,@,UTA,1,240,47,102,0.461,28,51,0.549,19,51,0.373,17,20,0.85,130,41,91,0.451,32,63,0.508,9,28,0.321,23,31,0.742,114
212,HOU,2024-02-06,129,@,IND,0,240,50,97,0.515,38,72,0.528,12,25,0.48,17,23,0.739,129,54,86,0.628,39,54,0.722,15,32,0.469,9,14,0.643,132
213,CHI,2024-02-06,129,,MIN,1,265,45,93,0.484,33,63,0.524,12,30,0.4,27,32,0.844,129,42,92,0.457,22,47,0.468,20,45,0.444,19,26,0.731,123
214,MIL,2024-02-03,129,@,DAL,1,240,50,88,0.568,38,58,0.655,12,30,0.4,17,25,0.68,129,40,81,0.494,24,42,0.571,16,39,0.41,21,23,0.913,117
215,ATL,2024-02-02,129,,PHO,1,240,49,95,0.516,32,51,0.627,17,44,0.386,14,18,0.778,129,47,88,0.534,33,51,0.647,14,37,0.378,12,14,0.857,120
216,BOS,2024-01-30,129,,IND,1,240,47,87,0.54,30,51,0.588,17,36,0.472,18,22,0.818,129,50,108,0.463,38,69,0.551,12,39,0.308,12,15,0.8,124
217,ORL,2024-01-29,129,@,DAL,0,240,45,88,0.511,27,50,0.54,18,38,0.474,21,28,0.75,129,43,69,0.623,30,42,0.714,13,27,0.481,32,43,0.744,131
218,UTA,2024-01-18,129,,OKC,0,240,43,89,0.483,30,57,0.526,13,32,0.406,30,36,0.833,129,48,86,0.558,34,54,0.63,14,32,0.438,24,28,0.857,134
219,DET,2024-01-15,129,@,WAS,1,240,50,90,0.556,38,59,0.644,12,31,0.387,17,23,0.739,129,44,95,0.463,25,54,0.463,19,41,0.463,10,11,0.909,117
220,MIL,2024-01-13,129,,GSW,1,240,51,94,0.543,38,63,0.603,13,31,0.419,14,17,0.824,129,47,98,0.48,32,62,0.516,15,36,0.417,9,14,0.643,118
221,NOP,2023-12-31,129,,LAL,1,240,45,87,0.517,28,53,0.528,17,34,0.5,22,27,0.815,129,39,82,0.476,29,50,0.58,10,32,0.313,21,25,0.84,109
222,DET,2023-12-30,129,,TOR,1,240,41,82,0.5,29,54,0.537,12,28,0.429,35,40,0.875,129,46,91,0.505,34,67,0.507,12,24,0.5,23,28,0.821,127
223,OKC,2023-12-27,129,,NYK,1,240,49,90,0.544,35,58,0.603,14,32,0.438,17,22,0.773,129,41,82,0.5,27,48,0.563,14,34,0.412,24,30,0.8,120
224,PHO,2023-12-27,129,@,HOU,1,240,47,82,0.573,33,49,0.673,14,33,0.424,21,26,0.808,129,40,96,0.417,23,55,0.418,17,41,0.415,16,22,0.727,113
225,OKC,2023-12-26,129,,MIN,1,240,49,81,0.605,31,42,0.738,18,39,0.462,13,16,0.813,129,34,73,0.466,22,46,0.478,12,27,0.444,26,32,0.813,106
226,NYK,2023-12-25,129,,MIL,1,240,50,92,0.543,42,66,0.636,8,26,0.308,21,26,0.808,129,45,95,0.474,32,53,0.604,13,42,0.31,19,24,0.792,122
227,LAL,2023-12-23,129,@,OKC,1,240,47,90,0.522,31,58,0.534,16,32,0.5,19,23,0.826,129,46,95,0.484,33,54,0.611,13,41,0.317,15,19,0.789,120
228,GSW,2023-12-22,129,,WAS,1,240,47,97,0.485,29,52,0.558,18,45,0.4,17,20,0.85,129,44,97,0.454,33,62,0.532,11,35,0.314,19,24,0.792,118
229,SAS,2023-12-15,129,,LAL,1,240,47,95,0.495,29,53,0.547,18,42,0.429,17,19,0.895,129,43,89,0.483,32,53,0.604,11,36,0.306,18,28,0.643,115
230,PHI,2023-12-13,129,@,DET,1,240,45,87,0.517,34,57,0.596,11,30,0.367,28,34,0.824,129,39,88,0.443,29,55,0.527,10,33,0.303,23,30,0.767,111
231,CHI,2023-12-11,129,@,MIL,0,265,47,114,0.412,32,80,0.4,15,34,0.441,20,25,0.8,129,44,86,0.512,29,49,0.592,15,37,0.405,30,37,0.811,133
232,DEN,2023-12-11,129,@,ATL,1,240,47,88,0.534,35,59,0.593,12,29,0.414,23,29,0.793,129,44,96,0.458,27,52,0.519,17,44,0.386,17,18,0.944,122
233,BRK,2023-12-02,129,,ORL,1,240,46,91,0.505,32,57,0.561,14,34,0.412,23,31,0.742,129,35,88,0.398,26,59,0.441,9,29,0.31,22,27,0.815,101
234,MIA,2023-12-02,129,,IND,0,240,48,89,0.539,36,64,0.563,12,25,0.48,21,24,0.875,129,56,85,0.659,40,53,0.755,16,32,0.5,16,20,0.8,144
235,CHO,2023-11-30,129,@,BRK,1,240,46,91,0.505,25,55,0.455,21,36,0.583,16,16,1.0,129,52,105,0.495,38,69,0.551,14,36,0.389,10,15,0.667,128
236,MIA,2023-11-22,129,@,CLE,1,240,46,88,0.523,26,53,0.491,20,35,0.571,17,21,0.81,129,36,77,0.468,22,47,0.468,14,30,0.467,10,14,0.714,96
237,WAS,2023-11-20,129,,MIL,0,240,55,99,0.556,45,70,0.643,10,29,0.345,9,11,0.818,129,55,94,0.585,44,65,0.677,11,29,0.379,21,28,0.75,142
238,NOP,2023-11-20,129,,SAC,1,240,50,92,0.543,38,64,0.594,12,28,0.429,17,21,0.81,129,33,87,0.379,22,42,0.524,11,45,0.244,16,24,0.667,93
239,SAC,2023-11-19,129,@,DAL,1,240,48,90,0.533,31,50,0.62,17,40,0.425,16,21,0.762,129,41,88,0.466,29,54,0.537,12,34,0.353,19,26,0.731,113
240,SAC,2023-11-17,129,@,SAS,1,240,46,85,0.541,28,43,0.651,18,42,0.429,19,24,0.792,129,43,92,0.467,28,56,0.5,15,36,0.417,19,23,0.826,120
241,NYK,2023-11-12,129,,CHO,1,240,47,87,0.54,32,51,0.627,15,36,0.417,20,30,0.667,129,44,94,0.468,32,59,0.542,12,35,0.343,7,11,0.636,107
242,MIL,2023-11-06,129,@,BRK,1,240,46,96,0.479,30,48,0.625,16,48,0.333,21,24,0.875,129,49,101,0.485,33,56,0.589,16,45,0.356,11,13,0.846,125
243,CLE,2024-01-31,128,,DET,1,240,47,89,0.528,35,54,0.648,12,35,0.343,22,23,0.957,128,45,81,0.556,29,50,0.58,16,31,0.516,15,19,0.789,121
244,CHO,2024-01-22,128,@,MIN,1,240,50,88,0.568,36,51,0.706,14,37,0.378,14,18,0.778,128,44,84,0.524,26,43,0.605,18,41,0.439,19,25,0.76,125
245,LAC,2024-01-16,128,,OKC,1,240,47,87,0.54,27,44,0.614,20,43,0.465,14,23,0.609,128,42,83,0.506,26,49,0.531,16,34,0.471,17,20,0.85,117
246,LAC,2024-01-12,128,@,MEM,1,240,49,89,0.551,34,58,0.586,15,31,0.484,15,20,0.75,128,41,95,0.432,23,51,0.451,18,44,0.409,19,27,0.704,119
247,DAL,2024-01-11,128,,NYK,1,240,44,88,0.5,27,47,0.574,17,41,0.415,23,30,0.767,128,44,89,0.494,30,47,0.638,14,42,0.333,22,28,0.786,124
248,OKC,2024-01-10,128,@,MIA,1,240,51,86,0.593,37,53,0.698,14,33,0.424,12,16,0.75,128,41,89,0.461,26,53,0.491,15,36,0.417,23,28,0.821,120
249,WAS,2024-01-08,128,,OKC,0,240,44,89,0.494,29,57,0.509,15,32,0.469,25,29,0.862,128,52,88,0.591,38,60,0.633,14,28,0.5,18,24,0.75,136
250,NYK,2024-01-05,128,@,PHI,1,240,43,89,0.483,25,48,0.521,18,41,0.439,24,25,0.96,128,33,81,0.407,27,58,0.466,6,23,0.261,20,27,0.741,92
251,SAS,2023-12-29,128,@,POR,0,240,48,94,0.511,34,61,0.557,14,33,0.424,18,25,0.72,128,48,95,0.505,32,68,0.471,16,27,0.593,22,27,0.815,134
252,BOS,2023-12-28,128,,DET,1,265,48,99,0.485,37,60,0.617,11,39,0.282,21,25,0.84,128,48,101,0.475,34,58,0.586,14,43,0.326,12,19,0.632,122
253,DAL,2023-12-25,128,@,PHO,1,240,45,84,0.536,29,40,0.725,16,44,0.364,22,30,0.733,128,40,90,0.444,26,49,0.531,14,41,0.341,20,25,0.8,114
254,MIL,2023-12-17,128,,HOU,1,240,45,90,0.5,32,54,0.593,13,36,0.361,25,32,0.781,128,45,85,0.529,34,58,0.586,11,27,0.407,18,21,0.857,119
255,BOS,2023-12-15,128,,ORL,1,240,48,92,0.522,30,50,0.6,18,42,0.429,14,20,0.7,128,42,87,0.483,28,52,0.538,14,35,0.4,13,18,0.722,111
256,SAC,2023-12-14,128,,OKC,1,240,47,95,0.495,29,50,0.58,18,45,0.4,16,21,0.762,128,44,102,0.431,33,66,0.5,11,36,0.306,24,27,0.889,123
257,ATL,2023-12-13,128,@,TOR,0,240,48,100,0.48,30,59,0.508,18,41,0.439,14,19,0.737,128,50,87,0.575,32,53,0.604,18,34,0.529,17,24,0.708,135
258,IND,2023-12-07,128,@,MIL,1,240,50,102,0.49,43,69,0.623,7,33,0.212,21,25,0.84,128,43,96,0.448,31,63,0.492,12,33,0.364,21,28,0.75,119
259,BRK,2023-11-30,128,,CHO,0,240,52,105,0.495,38,69,0.551,14,36,0.389,10,15,0.667,128,46,91,0.505,25,55,0.455,21,36,0.583,16,16,1.0,129
260,CLE,2023-11-28,128,,ATL,1,240,50,93,0.538,37,57,0.649,13,36,0.361,15,17,0.882,128,35,101,0.347,22,57,0.386,13,44,0.295,22,24,0.917,105
261,WAS,2023-11-24,128,@,MIL,0,240,48,100,0.48,33,63,0.524,15,37,0.405,17,21,0.81,128,48,92,0.522,39,61,0.639,9,31,0.29,26,33,0.788,131
262,ORL,2023-11-19,128,@,IND,1,240,43,87,0.494,36,67,0.537,7,20,0.35,35,42,0.833,128,42,95,0.442,34,64,0.531,8,31,0.258,24,31,0.774,116
263,UTA,2023-11-17,128,,PHO,0,240,43,85,0.506,27,49,0.551,16,36,0.444,26,31,0.839,128,45,86,0.523,27,53,0.509,18,33,0.545,23,26,0.885,131
264,OKC,2023-11-16,128,@,GSW,1,240,44,87,0.506,25,55,0.455,19,32,0.594,21,23,0.913,128,40,98,0.408,26,57,0.456,14,41,0.341,15,19,0.789,109
265,MIL,2023-11-15,128,@,TOR,1,240,44,85,0.518,24,46,0.522,20,39,0.513,20,21,0.952,128,38,96,0.396,29,63,0.46,9,33,0.273,27,31,0.871,112
266,OKC,2023-11-08,128,,CLE,1,240,44,86,0.512,32,58,0.552,12,28,0.429,28,30,0.933,128,42,83,0.506,33,54,0.611,9,29,0.31,27,37,0.73,120
267,HOU,2023-11-08,128,,LAL,1,240,51,93,0.548,37,60,0.617,14,33,0.424,12,19,0.632,128,36,85,0.424,29,60,0.483,7,25,0.28,15,24,0.625,94
268,WAS,2023-11-06,128,@,PHI,0,240,49,96,0.51,35,62,0.565,14,34,0.412,16,20,0.8,128,51,91,0.56,39,60,0.65,12,31,0.387,32,36,0.889,146
269,HOU,2023-11-01,128,,CHO,1,240,44,84,0.524,23,47,0.489,21,37,0.568,19,23,0.826,128,45,90,0.5,34,63,0.54,11,27,0.407,18,25,0.72,119
270,DEN,2023-10-29,128,@,OKC,1,240,53,88,0.602,42,61,0.689,11,27,0.407,11,13,0.846,128,37,90,0.411,31,58,0.534,6,32,0.188,15,18,0.833,95
271,GSW,2024-02-07,127,@,PHI,1,240,47,94,0.5,31,56,0.554,16,38,0.421,17,22,0.773,127,41,98,0.418,33,66,0.5,8,32,0.25,14,14,1.0,104
272,TOR,2024-02-04,127,@,OKC,0,290,48,101,0.475,34,66,0.515,14,35,0.4,17,21,0.81,127,52,110,0.473,29,47,0.617,23,63,0.365,8,8,1.0,135
273,PHI,2024-02-01,127,@,UTA,1,240,47,94,0.5,33,62,0.532,14,32,0.438,19,21,0.905,127,45,87,0.517,33,51,0.647,12,36,0.333,22,25,0.88,124
274,LAC,2024-01-26,127,@,TOR,1,240,48,95,0.505,39,63,0.619,9,32,0.281,22,24,0.917,127,44,96,0.458,38,64,0.594,6,32,0.188,13,22,0.591,107
275,LAC,2024-01-23,127,,LAL,1,240,52,88,0.591,38,61,0.623,14,27,0.519,9,12,0.75,127,45,92,0.489,34,60,0.567,11,32,0.344,15,22,0.682,116
276,WAS,2024-01-20,127,,SAS,0,240,49,103,0.476,40,74,0.541,9,29,0.31,20,23,0.87,127,51,96,0.531,39,65,0.6,12,31,0.387,17,23,0.739,131
277,HOU,2024-01-20,127,,UTA,1,265,50,117,0.427,37,78,0.474,13,39,0.333,14,22,0.636,127,48,105,0.457,35,62,0.565,13,43,0.302,17,22,0.773,126
278,LAL,2024-01-17,127,,DAL,1,240,49,91,0.538,37,63,0.587,12,28,0.429,17,24,0.708,127,42,91,0.462,31,51,0.608,11,40,0.275,15,18,0.833,110
279,PHO,2024-01-14,127,@,POR,1,240,46,76,0.605,33,48,0.688,13,28,0.464,22,27,0.815,127,40,89,0.449,20,47,0.426,20,42,0.476,16,22,0.727,116
280,WAS,2024-01-13,127,@,ATL,1,240,47,97,0.485,35,65,0.538,12,32,0.375,21,26,0.808,127,32,93,0.344,21,53,0.396,11,40,0.275,24,33,0.727,99
281,PHO,2024-01-11,127,@,LAL,1,240,46,93,0.495,32,54,0.593,14,39,0.359,21,23,0.913,127,40,80,0.5,27,46,0.587,13,34,0.382,16,25,0.64,109
282,BOS,2024-01-10,127,,MIN,1,265,39,90,0.433,20,43,0.465,19,47,0.404,30,31,0.968,127,44,95,0.463,30,61,0.492,14,34,0.412,18,20,0.9,120
283,BRK,2024-01-07,127,,POR,0,265,46,91,0.505,32,54,0.593,14,37,0.378,21,25,0.84,127,45,95,0.474,25,57,0.439,20,38,0.526,24,30,0.8,134
284,MEM,2024-01-05,127,@,LAL,1,240,44,82,0.537,21,37,0.568,23,45,0.511,16,20,0.8,127,42,85,0.494,32,57,0.561,10,28,0.357,19,27,0.704,113
285,GSW,2024-01-04,127,,DEN,0,240,49,90,0.544,34,54,0.63,15,36,0.417,14,16,0.875,127,48,85,0.565,39,59,0.661,9,26,0.346,25,29,0.862,130
286,OKC,2024-01-02,127,,BOS,1,240,48,91,0.527,30,51,0.588,18,40,0.45,13,17,0.765,127,42,92,0.457,27,52,0.519,15,40,0.375,24,29,0.828,123
287,UTA,2024-01-01,127,,DAL,1,240,49,96,0.51,37,52,0.712,12,44,0.273,17,18,0.944,127,37,93,0.398,26,53,0.491,11,40,0.275,5,10,0.5,90
288,TOR,2023-12-30,127,@,DET,0,240,46,91,0.505,34,67,0.507,12,24,0.5,23,28,0.821,127,41,82,0.5,29,54,0.537,12,28,0.429,35,40,0.875,129
289,HOU,2023-12-29,127,,PHI,0,240,49,91,0.538,35,61,0.574,14,30,0.467,15,21,0.714,127,45,86,0.523,33,53,0.623,12,33,0.364,29,33,0.879,131
290,ORL,2023-12-26,127,@,WAS,1,240,49,93,0.527,37,67,0.552,12,26,0.462,17,25,0.68,127,43,87,0.494,27,45,0.6,16,42,0.381,17,21,0.81,119
291,PHI,2023-12-20,127,,MIN,1,240,45,84,0.536,37,62,0.597,8,22,0.364,29,32,0.906,127,42,82,0.512,33,57,0.579,9,25,0.36,20,24,0.833,113
292,HOU,2023-12-20,127,,ATL,0,240,44,89,0.494,28,55,0.509,16,34,0.471,23,23,1.0,127,47,91,0.516,30,51,0.588,17,40,0.425,23,28,0.821,134
293,IND,2023-12-18,127,,LAC,0,240,49,95,0.516,37,62,0.597,12,33,0.364,17,21,0.81,127,56,98,0.571,37,60,0.617,19,38,0.5,20,23,0.87,151
294,CLE,2023-12-16,127,,ATL,1,240,49,101,0.485,33,59,0.559,16,42,0.381,13,15,0.867,127,41,85,0.482,26,49,0.531,15,36,0.417,22,25,0.88,119
295,MIN,2023-12-16,127,,IND,1,240,48,86,0.558,30,56,0.536,18,30,0.6,13,16,0.813,127,45,90,0.5,39,69,0.565,6,21,0.286,13,16,0.813,109
296,DAL,2023-12-12,127,,LAL,1,240,44,89,0.494,23,46,0.5,21,43,0.488,18,21,0.857,127,49,91,0.538,34,62,0.548,15,29,0.517,12,18,0.667,125
297,POR,2023-12-11,127,@,LAC,0,240,43,90,0.478,24,50,0.48,19,40,0.475,22,26,0.846,127,49,89,0.551,36,55,0.655,13,34,0.382,21,22,0.955,132
298,MIN,2023-12-08,127,@,MEM,1,240,44,88,0.5,29,50,0.58,15,38,0.395,24,26,0.923,127,37,86,0.43,22,51,0.431,15,35,0.429,14,19,0.737,103
299,NOP,2023-12-04,127,@,SAC,1,240,47,87,0.54,33,56,0.589,14,31,0.452,19,23,0.826,127,38,85,0.447,24,44,0.545,14,41,0.341,27,33,0.818,117
300,PHI,2023-11-25,127,@,OKC,1,240,38,83,0.458,24,42,0.571,14,41,0.341,37,45,0.822,127,43,98,0.439,27,55,0.491,16,43,0.372,21,26,0.808,123
301,UTA,2023-11-10,127,@,MEM,1,240,41,76,0.539,23,39,0.59,18,37,0.486,27,29,0.931,127,46,101,0.455,27,53,0.509,19,48,0.396,10,13,0.769,121
302,TOR,2023-11-08,127,@,DAL,1,240,49,99,0.495,38,63,0.603,11,36,0.306,18,27,0.667,127,40,84,0.476,23,43,0.535,17,41,0.415,19,31,0.613,116
303,ATL,2023-10-30,127,,MIN,1,240,48,86,0.558,34,56,0.607,14,30,0.467,17,18,0.944,127,44,90,0.489,28,57,0.491,16,33,0.485,9,15,0.6,113
304,ATL,2023-10-29,127,@,MIL,1,240,47,93,0.505,32,56,0.571,15,37,0.405,18,22,0.818,127,39,86,0.453,23,42,0.548,16,44,0.364,16,20,0.8,110
305,LAL,2023-10-29,127,@,SAC,0,265,43,98,0.439,28,53,0.528,15,45,0.333,26,34,0.765,127,49,104,0.471,32,56,0.571,17,48,0.354,17,24,0.708,132
306,OKC,2024-02-02,126,,CHO,1,240,44,75,0.587,27,39,0.692,17,36,0.472,21,27,0.778,126,41,92,0.446,27,61,0.443,14,31,0.452,10,14,0.714,106
307,ATL,2024-01-28,126,,TOR,1,240,44,95,0.463,38,68,0.559,6,27,0.222,32,40,0.8,126,41,89,0.461,26,58,0.448,15,31,0.484,28,32,0.875,125
308,MIL,2024-01-24,126,,CLE,1,240,45,90,0.5,34,61,0.557,11,29,0.379,25,28,0.893,126,46,91,0.505,33,53,0.623,13,38,0.342,11,15,0.733,116
309,CLE,2024-01-22,126,@,ORL,1,240,45,80,0.563,25,42,0.595,20,38,0.526,16,22,0.727,126,34,74,0.459,23,45,0.511,11,29,0.379,20,30,0.667,99
310,UTA,2024-01-20,126,@,HOU,0,265,48,105,0.457,35,62,0.565,13,43,0.302,17,22,0.773,126,50,117,0.427,37,78,0.474,13,39,0.333,14,22,0.636,127
311,NYK,2024-01-20,126,,TOR,1,240,48,88,0.545,34,49,0.694,14,39,0.359,16,20,0.8,126,38,92,0.413,27,58,0.466,11,34,0.324,13,23,0.565,100
312,IND,2024-01-18,126,@,SAC,1,240,49,89,0.551,36,56,0.643,13,33,0.394,15,19,0.789,126,44,85,0.518,29,48,0.604,15,37,0.405,18,32,0.563,121
313,PHI,2024-01-16,126,,DEN,1,240,43,76,0.566,28,45,0.622,15,31,0.484,25,34,0.735,126,45,89,0.506,33,60,0.55,12,29,0.414,19,25,0.76,121
314,IND,2024-01-12,126,@,ATL,1,240,53,79,0.671,42,61,0.689,11,18,0.611,9,12,0.75,126,40,89,0.449,29,59,0.492,11,30,0.367,17,23,0.739,108
315,LAC,2024-01-10,126,,TOR,1,240,49,93,0.527,34,59,0.576,15,34,0.441,13,13,1.0,126,46,84,0.548,34,54,0.63,12,30,0.4,16,18,0.889,120
316,BOS,2024-01-05,126,,UTA,1,240,39,90,0.433,22,41,0.537,17,49,0.347,31,36,0.861,126,34,94,0.362,28,60,0.467,6,34,0.176,23,34,0.676,97
317,DAL,2024-01-03,126,,POR,1,240,42,84,0.5,29,54,0.537,13,30,0.433,29,41,0.707,126,34,87,0.391,21,47,0.447,13,40,0.325,16,22,0.727,97
318,WAS,2023-12-31,126,,ATL,0,240,46,98,0.469,29,45,0.644,17,53,0.321,17,21,0.81,126,47,95,0.495,35,63,0.556,12,32,0.375,24,37,0.649,130
319,NYK,2023-12-30,126,@,IND,0,240,45,95,0.474,28,58,0.483,17,37,0.459,19,27,0.704,126,50,85,0.588,27,42,0.643,23,43,0.535,17,21,0.81,140
320,BOS,2023-12-25,126,@,LAL,1,240,46,91,0.505,33,49,0.673,13,42,0.31,21,28,0.75,126,43,90,0.478,30,58,0.517,13,32,0.406,16,21,0.762,115
321,GSW,2023-12-23,126,,POR,1,240,48,83,0.578,38,50,0.76,10,33,0.303,20,24,0.833,126,38,84,0.452,25,49,0.51,13,35,0.371,17,25,0.68,106
322,BRK,2023-12-23,126,,DET,1,240,45,86,0.523,35,62,0.565,10,24,0.417,26,32,0.813,126,39,79,0.494,24,44,0.545,15,35,0.429,22,29,0.759,115
323,UTA,2023-12-23,126,@,TOR,1,240,48,91,0.527,31,53,0.585,17,38,0.447,13,14,0.929,126,45,94,0.479,32,62,0.516,13,32,0.406,16,19,0.842,119
324,BOS,2023-12-19,126,@,GSW,0,265,47,114,0.412,30,56,0.536,17,58,0.293,15,17,0.882,126,50,109,0.459,30,59,0.508,20,50,0.4,12,14,0.857,132
325,IND,2023-12-13,126,@,MIL,0,240,45,100,0.45,34,64,0.531,11,36,0.306,25,32,0.781,126,48,89,0.539,41,62,0.661,7,27,0.259,37,48,0.771,140
326,WAS,2023-12-06,126,,PHI,0,240,52,92,0.565,38,57,0.667,14,35,0.4,8,8,1.0,126,47,92,0.511,39,65,0.6,8,27,0.296,29,34,0.853,131
327,OKC,2023-12-02,126,@,DAL,1,240,44,100,0.44,24,56,0.429,20,44,0.455,18,22,0.818,126,39,87,0.448,20,35,0.571,19,52,0.365,23,35,0.657,120
328,WAS,2023-11-27,126,@,DET,1,240,45,89,0.506,35,60,0.583,10,29,0.345,26,28,0.929,126,43,102,0.422,35,64,0.547,8,38,0.211,13,19,0.684,107
329,ORL,2023-11-21,126,,TOR,1,240,50,100,0.5,38,69,0.551,12,31,0.387,14,20,0.7,126,38,75,0.507,24,47,0.511,14,28,0.5,17,22,0.773,107
330,PHI,2023-11-17,126,@,ATL,1,240,43,88,0.489,30,58,0.517,13,30,0.433,27,28,0.964,126,40,89,0.449,28,56,0.5,12,33,0.364,24,30,0.8,116
331,ATL,2023-11-14,126,@,DET,1,240,45,87,0.517,33,54,0.611,12,33,0.364,24,26,0.923,126,47,90,0.522,37,61,0.607,10,29,0.345,16,23,0.696,120
332,PHI,2023-11-14,126,,IND,0,240,43,86,0.5,37,64,0.578,6,22,0.273,34,35,0.971,126,48,93,0.516,35,56,0.625,13,37,0.351,23,33,0.697,132
333,IND,2023-11-12,126,@,PHI,0,240,47,90,0.522,31,51,0.608,16,39,0.41,16,19,0.842,126,53,105,0.505,39,72,0.542,14,33,0.424,17,20,0.85,137
334,LAC,2023-11-10,126,@,DAL,0,240,43,88,0.489,35,61,0.574,8,27,0.296,32,36,0.889,126,51,98,0.52,32,56,0.571,19,42,0.452,23,26,0.885,144
335,IND,2023-11-09,126,,MIL,1,240,44,92,0.478,24,44,0.545,20,48,0.417,18,20,0.9,126,46,87,0.529,37,60,0.617,9,27,0.333,23,26,0.885,124
336,NYK,2023-11-08,126,,SAS,1,240,46,100,0.46,27,58,0.466,19,42,0.452,15,22,0.682,126,44,90,0.489,35,56,0.625,9,34,0.265,8,13,0.615,105
337,OKC,2023-11-06,126,,ATL,1,240,45,94,0.479,31,59,0.525,14,35,0.4,22,23,0.957,126,38,102,0.373,24,60,0.4,14,42,0.333,27,32,0.844,117
338,BOS,2023-10-30,126,@,WAS,1,240,51,102,0.5,32,49,0.653,19,53,0.358,5,7,0.714,126,39,87,0.448,28,51,0.549,11,36,0.306,18,26,0.692,107
339,PHI,2023-10-29,126,,POR,1,240,40,82,0.488,29,54,0.537,11,28,0.393,35,40,0.875,126,36,94,0.383,29,63,0.46,7,31,0.226,19,22,0.864,98
340,PHO,2023-10-28,126,,UTA,1,240,45,85,0.529,35,48,0.729,10,37,0.27,26,28,0.929,126,40,91,0.44,28,54,0.519,12,37,0.324,12,14,0.857,104
341,SAS,2023-10-27,126,,HOU,1,265,46,94,0.489,33,52,0.635,13,42,0.31,21,28,0.75,126,52,100,0.52,44,68,0.647,8,32,0.25,10,20,0.5,122
342,NYK,2023-10-27,126,@,ATL,1,240,43,90,0.478,23,46,0.5,20,44,0.455,20,28,0.714,126,42,87,0.483,30,55,0.545,12,32,0.375,24,30,0.8,120
343,DAL,2023-10-25,126,@,SAS,1,240,47,99,0.475,32,52,0.615,15,47,0.319,17,23,0.739,126,46,89,0.517,35,54,0.648,11,35,0.314,16,22,0.727,119
344,BOS,2024-02-07,125,,ATL,1,240,49,93,0.527,32,44,0.727,17,49,0.347,10,11,0.909,125,43,102,0.422,30,61,0.492,13,41,0.317,18,20,0.9,117
345,DET,2024-02-02,125,,LAC,0,240,45,89,0.506,28,49,0.571,17,40,0.425,18,24,0.75,125,53,89,0.596,39,60,0.65,14,29,0.483,16,19,0.842,136
346,LAC,2024-01-31,125,@,WAS,1,240,47,100,0.47,35,70,0.5,12,30,0.4,19,22,0.864,125,45,97,0.464,36,68,0.529,9,29,0.31,10,15,0.667,109
347,TOR,2024-01-28,125,@,ATL,0,240,41,89,0.461,26,58,0.448,15,31,0.484,28,32,0.875,125,44,95,0.463,38,68,0.559,6,27,0.222,32,40,0.8,126
348,NYK,2024-01-27,125,,MIA,1,240,45,87,0.517,28,54,0.519,17,33,0.515,18,26,0.692,125,41,88,0.466,27,51,0.529,14,37,0.378,13,16,0.813,109
349,MIN,2024-01-22,125,,CHO,0,240,44,84,0.524,26,43,0.605,18,41,0.439,19,25,0.76,125,50,88,0.568,36,51,0.706,14,37,0.378,14,18,0.778,128
350,LAC,2024-01-21,125,,BRK,1,240,42,83,0.506,29,57,0.509,13,26,0.5,28,33,0.848,125,44,90,0.489,30,51,0.588,14,39,0.359,12,16,0.75,114
351,CHI,2024-01-20,125,,MEM,1,240,47,91,0.516,33,58,0.569,14,33,0.424,17,21,0.81,125,32,75,0.427,19,33,0.576,13,42,0.31,19,23,0.826,96
352,DAL,2024-01-15,125,,NOP,1,240,39,85,0.459,21,42,0.5,18,43,0.419,29,35,0.829,125,41,81,0.506,34,58,0.586,7,23,0.304,31,41,0.756,120
353,LAL,2024-01-13,125,@,UTA,0,240,46,92,0.5,33,63,0.524,13,29,0.448,20,24,0.833,125,42,93,0.452,30,56,0.536,12,37,0.324,36,39,0.923,132
354,DEN,2024-01-12,125,,NOP,1,240,50,90,0.556,36,57,0.632,14,33,0.424,11,15,0.733,125,42,89,0.472,29,56,0.518,13,33,0.394,16,22,0.727,113
355,MIL,2024-01-04,125,@,SAS,1,240,49,92,0.533,37,58,0.638,12,34,0.353,15,19,0.789,125,46,95,0.484,32,55,0.582,14,40,0.35,15,17,0.882,121
356,MEM,2023-12-23,125,@,ATL,1,240,50,97,0.515,39,64,0.609,11,33,0.333,14,22,0.636,125,45,96,0.469,32,53,0.604,13,43,0.302,16,20,0.8,119
357,UTA,2023-12-18,125,,BRK,1,240,45,91,0.495,31,57,0.544,14,34,0.412,21,24,0.875,125,39,90,0.433,23,51,0.451,16,39,0.41,14,20,0.7,108
358,SAC,2023-12-16,125,,UTA,1,240,46,85,0.541,24,40,0.6,22,45,0.489,11,15,0.733,125,38,86,0.442,26,49,0.531,12,37,0.324,16,21,0.762,104
359,ATL,2023-12-15,125,@,TOR,1,240,52,101,0.515,36,60,0.6,16,41,0.39,5,6,0.833,125,40,77,0.519,30,46,0.652,10,31,0.323,14,25,0.56,104
360,LAL,2023-12-12,125,@,DAL,0,240,49,91,0.538,34,62,0.548,15,29,0.517,12,18,0.667,125,44,89,0.494,23,46,0.5,21,43,0.488,18,21,0.857,127
361,PHI,2023-12-08,125,,ATL,1,240,42,87,0.483,31,57,0.544,11,30,0.367,30,37,0.811,125,41,104,0.394,28,65,0.431,13,39,0.333,19,21,0.905,114
362,DAL,2023-12-08,125,@,POR,1,240,47,91,0.516,35,52,0.673,12,39,0.308,19,22,0.864,125,39,105,0.371,21,52,0.404,18,53,0.34,16,18,0.889,112
363,WAS,2023-12-01,125,@,ORL,0,240,45,89,0.506,32,61,0.525,13,28,0.464,22,31,0.71,125,46,89,0.517,34,58,0.586,12,31,0.387,26,33,0.788,130
364,BOS,2023-12-01,125,,PHI,1,240,39,77,0.506,23,44,0.523,16,33,0.485,31,36,0.861,125,43,94,0.457,27,59,0.458,16,35,0.457,17,23,0.739,119
365,DAL,2023-11-18,125,@,MIL,0,240,51,103,0.495,35,56,0.625,16,47,0.34,7,10,0.7,125,49,94,0.521,32,49,0.653,17,45,0.378,17,20,0.85,132
366,SAC,2023-11-15,125,@,LAL,1,240,48,96,0.5,32,52,0.615,16,44,0.364,13,17,0.765,125,42,83,0.506,31,54,0.574,11,29,0.379,15,19,0.789,110
367,BRK,2023-11-06,125,,MIL,0,240,49,101,0.485,33,56,0.589,16,45,0.356,11,13,0.846,125,46,96,0.479,30,48,0.625,16,48,0.333,21,24,0.875,129
368,CHO,2023-11-04,125,@,IND,1,240,47,88,0.534,39,68,0.574,8,20,0.4,23,23,1.0,125,45,93,0.484,23,48,0.479,22,45,0.489,12,16,0.75,124
369,DEN,2023-11-03,125,,DAL,1,240,49,93,0.527,36,63,0.571,13,30,0.433,14,19,0.737,125,41,86,0.477,24,44,0.545,17,42,0.405,15,17,0.882,114
370,NOP,2023-11-02,125,,DET,1,240,39,80,0.488,25,48,0.521,14,32,0.438,33,35,0.943,125,41,94,0.436,28,56,0.5,13,38,0.342,21,26,0.808,116
371,LAC,2023-11-01,125,@,LAL,0,265,47,99,0.475,33,65,0.508,14,34,0.412,17,27,0.63,125,46,90,0.511,35,58,0.603,11,32,0.344,27,36,0.75,130
372,DAL,2023-10-30,125,@,MEM,1,240,42,84,0.5,19,37,0.514,23,47,0.489,18,24,0.75,125,42,92,0.457,28,55,0.509,14,37,0.378,12,20,0.6,110
373,IND,2023-10-28,125,@,CLE,1,240,48,98,0.49,33,60,0.55,15,38,0.395,14,17,0.824,125,43,99,0.434,31,68,0.456,12,31,0.387,15,24,0.625,113
374,DAL,2023-10-27,125,,BRK,1,240,44,91,0.484,29,55,0.527,15,36,0.417,22,28,0.786,125,45,92,0.489,24,49,0.49,21,43,0.488,9,10,0.9,120
375,UTA,2024-02-06,124,,OKC,1,240,46,89,0.517,32,54,0.593,14,35,0.4,18,20,0.9,124,43,90,0.478,24,53,0.453,19,37,0.514,12,18,0.667,117
376,LAL,2024-02-05,124,@,CHO,1,240,50,89,0.562,42,55,0.764,8,34,0.235,16,19,0.842,124,47,96,0.49,34,64,0.531,13,32,0.406,11,14,0.786,118
377,UTA,2024-02-01,124,,PHI,0,240,45,87,0.517,33,51,0.647,12,36,0.333,22,25,0.88,124,47,94,0.5,33,62,0.532,14,32,0.438,19,21,0.905,127
378,IND,2024-01-30,124,@,BOS,0,240,50,108,0.463,38,69,0.551,12,39,0.308,12,15,0.8,124,47,87,0.54,30,51,0.588,17,36,0.472,18,22,0.818,129
379,UTA,2024-01-23,124,@,NOP,0,240,43,92,0.467,31,56,0.554,12,36,0.333,26,32,0.813,124,60,104,0.577,37,58,0.638,23,46,0.5,10,15,0.667,153
380,PHI,2024-01-19,124,@,ORL,1,240,42,87,0.483,29,57,0.509,13,30,0.433,27,29,0.931,124,37,78,0.474,27,55,0.491,10,23,0.435,25,27,0.926,109
381,CHO,2024-01-19,124,,SAS,1,240,47,84,0.56,31,55,0.564,16,29,0.552,14,16,0.875,124,47,84,0.56,32,52,0.615,15,32,0.469,11,17,0.647,120
382,MIN,2024-01-17,124,@,DET,1,240,47,93,0.505,32,63,0.508,15,30,0.5,15,21,0.714,124,46,89,0.517,34,58,0.586,12,31,0.387,13,19,0.684,117
383,PHI,2024-01-15,124,,HOU,1,240,40,83,0.482,25,52,0.481,15,31,0.484,29,34,0.853,124,44,88,0.5,36,61,0.59,8,27,0.296,19,32,0.594,115
384,NYK,2024-01-11,124,@,DAL,0,240,44,89,0.494,30,47,0.638,14,42,0.333,22,28,0.786,124,44,88,0.5,27,47,0.574,17,41,0.415,23,30,0.767,128
385,CHI,2024-01-10,124,,HOU,1,265,42,95,0.442,23,48,0.479,19,47,0.404,21,25,0.84,124,48,101,0.475,37,56,0.661,11,45,0.244,12,20,0.6,119
386,UTA,2024-01-10,124,,DEN,1,240,46,83,0.554,33,50,0.66,13,33,0.394,19,23,0.826,124,37,81,0.457,24,48,0.5,13,33,0.394,24,28,0.857,111
387,BRK,2024-01-05,124,,OKC,1,240,41,91,0.451,27,52,0.519,14,39,0.359,28,33,0.848,124,45,84,0.536,36,53,0.679,9,31,0.29,16,24,0.667,115
388,TOR,2024-01-01,124,,CLE,1,240,42,87,0.483,31,57,0.544,11,30,0.367,29,40,0.725,124,43,89,0.483,31,53,0.585,12,36,0.333,23,26,0.885,121
389,OKC,2023-12-31,124,,BRK,1,240,45,83,0.542,27,50,0.54,18,33,0.545,16,20,0.8,124,38,100,0.38,26,54,0.481,12,46,0.261,20,31,0.645,108
390,CHI,2023-12-20,124,,LAL,1,240,48,88,0.545,30,54,0.556,18,34,0.529,10,11,0.909,124,42,94,0.447,30,57,0.526,12,37,0.324,12,15,0.8,108
391,CLE,2023-12-20,124,,UTA,1,240,45,96,0.469,22,45,0.489,23,51,0.451,11,16,0.688,124,40,78,0.513,27,48,0.563,13,30,0.433,23,28,0.821,116
392,DET,2023-12-18,124,@,ATL,0,240,48,94,0.511,39,72,0.542,9,22,0.409,19,27,0.704,124,46,85,0.541,30,49,0.612,16,36,0.444,22,27,0.815,130
393,GSW,2023-12-16,124,,BRK,1,240,44,91,0.484,27,59,0.458,17,32,0.531,19,20,0.95,124,45,93,0.484,28,50,0.56,17,43,0.395,13,15,0.867,120
394,PHI,2023-12-15,124,,DET,1,240,41,98,0.418,27,61,0.443,14,37,0.378,28,31,0.903,124,35,81,0.432,31,60,0.517,4,21,0.19,18,23,0.783,92
395,CHI,2023-12-14,124,@,MIA,1,240,45,93,0.484,31,57,0.544,14,36,0.389,20,30,0.667,124,37,80,0.463,22,46,0.478,15,34,0.441,27,35,0.771,116
396,DEN,2023-12-14,124,,BRK,1,240,47,99,0.475,35,63,0.556,12,36,0.333,18,21,0.857,124,39,95,0.411,31,65,0.477,8,30,0.267,15,20,0.75,101
397,BRK,2023-12-08,124,,WAS,1,240,50,104,0.481,40,71,0.563,10,33,0.303,14,18,0.778,124,38,91,0.418,32,58,0.552,6,33,0.182,15,21,0.714,97
398,CHI,2023-12-02,124,,NOP,1,240,48,88,0.545,31,48,0.646,17,40,0.425,11,15,0.733,124,41,82,0.5,33,57,0.579,8,25,0.32,28,35,0.8,118
399,NOP,2023-11-29,124,,PHI,1,240,42,78,0.538,32,48,0.667,10,30,0.333,30,34,0.882,124,42,81,0.519,28,47,0.596,14,34,0.412,16,18,0.889,114
400,HOU,2023-11-29,124,@,DEN,0,240,47,86,0.547,31,45,0.689,16,41,0.39,14,19,0.737,124,48,95,0.505,29,52,0.558,19,43,0.442,19,26,0.731,134
401,SAC,2023-11-28,124,,GSW,1,240,41,91,0.451,26,47,0.553,15,44,0.341,27,42,0.643,124,40,83,0.482,23,42,0.548,17,41,0.415,26,30,0.867,123
402,MIA,2023-11-28,124,,MIL,0,240,48,94,0.511,34,64,0.531,14,30,0.467,14,21,0.667,124,47,88,0.534,34,53,0.642,13,35,0.371,24,27,0.889,131
403,BOS,2023-11-28,124,,CHI,1,240,47,90,0.522,26,41,0.634,21,49,0.429,9,12,0.75,124,39,90,0.433,30,62,0.484,9,28,0.321,10,18,0.556,97
404,SAC,2023-11-24,124,@,MIN,1,240,49,100,0.49,32,65,0.492,17,35,0.486,9,11,0.818,124,36,82,0.439,24,49,0.49,12,33,0.364,27,29,0.931,111
405,ORL,2023-11-22,124,,DEN,1,240,44,81,0.543,34,52,0.654,10,29,0.345,26,30,0.867,124,44,93,0.473,29,58,0.5,15,35,0.429,16,21,0.762,119
406,LAC,2023-11-20,124,@,SAS,1,240,45,95,0.474,33,59,0.559,12,36,0.333,22,25,0.88,124,39,90,0.433,29,52,0.558,10,38,0.263,11,14,0.786,99
407,BRK,2023-11-14,124,,ORL,1,240,46,85,0.541,27,46,0.587,19,39,0.487,13,20,0.65,124,36,82,0.439,20,36,0.556,16,46,0.348,16,21,0.762,104
408,NOP,2023-11-12,124,,DAL,0,240,47,92,0.511,30,56,0.536,17,36,0.472,13,22,0.591,124,50,102,0.49,30,49,0.612,20,53,0.377,16,21,0.762,136
409,CHO,2023-11-10,124,@,WAS,1,240,50,110,0.455,44,82,0.537,6,28,0.214,18,28,0.643,124,43,88,0.489,29,50,0.58,14,38,0.368,17,20,0.85,117
410,MIL,2023-11-09,124,@,IND,0,240,46,87,0.529,37,60,0.617,9,27,0.333,23,26,0.885,124,44,92,0.478,24,44,0.545,20,48,0.417,18,20,0.9,126
411,DAL,2023-11-05,124,,CHO,1,240,43,91,0.473,29,49,0.592,14,42,0.333,24,32,0.75,124,49,99,0.495,41,69,0.594,8,30,0.267,12,21,0.571,118
412,IND,2023-11-04,124,,CHO,0,240,45,93,0.484,23,48,0.479,22,45,0.489,12,16,0.75,124,47,88,0.534,39,68,0.574,8,20,0.4,23,23,1.0,125
413,BOS,2023-11-04,124,@,BRK,1,240,43,90,0.478,28,45,0.622,15,45,0.333,23,27,0.852,124,43,100,0.43,26,48,0.542,17,52,0.327,11,17,0.647,114
414,OKC,2023-10-30,124,,DET,1,240,44,83,0.53,31,54,0.574,13,29,0.448,23,28,0.821,124,39,91,0.429,24,63,0.381,15,28,0.536,19,24,0.792,112
415,OKC,2023-10-25,124,@,CHI,1,240,45,82,0.549,26,43,0.605,19,39,0.487,15,18,0.833,124,39,94,0.415,27,52,0.519,12,42,0.286,14,18,0.778,104
416,TOR,2024-02-07,123,@,CHO,1,240,43,81,0.531,26,48,0.542,17,33,0.515,20,24,0.833,123,44,90,0.489,28,51,0.549,16,39,0.41,13,20,0.65,117
417,NYK,2024-02-06,123,,MEM,1,240,48,86,0.558,37,59,0.627,11,27,0.407,16,20,0.8,123,41,80,0.513,20,43,0.465,21,37,0.568,10,16,0.625,113
418,MIN,2024-02-06,123,@,CHI,0,265,42,92,0.457,22,47,0.468,20,45,0.444,19,26,0.731,123,45,93,0.484,33,63,0.524,12,30,0.4,27,32,0.844,129
419,UTA,2024-02-04,123,,MIL,1,240,43,89,0.483,26,45,0.578,17,44,0.386,20,24,0.833,123,39,84,0.464,24,43,0.558,15,41,0.366,15,25,0.6,108
420,SAC,2024-02-03,123,@,CHI,1,240,42,84,0.5,27,45,0.6,15,39,0.385,24,29,0.828,123,42,91,0.462,31,57,0.544,11,34,0.324,20,22,0.909,115
421,UTA,2024-01-25,123,@,WAS,1,240,50,97,0.515,37,66,0.561,13,31,0.419,10,12,0.833,123,43,88,0.489,36,58,0.621,7,30,0.233,15,20,0.75,108
422,SAS,2024-01-22,123,@,PHI,0,240,43,93,0.462,30,52,0.577,13,41,0.317,24,27,0.889,123,48,97,0.495,43,77,0.558,5,20,0.25,32,40,0.8,133
423,PHO,2024-01-19,123,@,NOP,1,240,46,93,0.495,31,52,0.596,15,41,0.366,16,21,0.762,123,41,93,0.441,31,51,0.608,10,42,0.238,17,23,0.739,109
424,SAC,2024-01-10,123,@,CHO,1,240,46,89,0.517,33,54,0.611,13,35,0.371,18,23,0.783,123,35,87,0.402,19,49,0.388,16,38,0.421,12,16,0.75,98
425,BOS,2024-01-02,123,@,OKC,0,240,42,92,0.457,27,52,0.519,15,40,0.375,24,29,0.828,123,48,91,0.527,30,51,0.588,18,40,0.45,13,17,0.765,127
426,SAC,2023-12-31,123,@,MEM,1,240,47,92,0.511,31,59,0.525,16,33,0.485,13,17,0.765,123,30,82,0.366,18,42,0.429,12,40,0.3,20,28,0.714,92
427,IND,2023-12-26,123,@,HOU,1,240,43,82,0.524,24,39,0.615,19,43,0.442,18,21,0.857,123,47,97,0.485,42,73,0.575,5,24,0.208,18,22,0.818,117
428,NOP,2023-12-21,123,@,CLE,1,240,47,86,0.547,32,51,0.627,15,35,0.429,14,16,0.875,123,41,87,0.471,24,43,0.558,17,44,0.386,5,8,0.625,104
429,IND,2023-12-15,123,@,WAS,0,240,48,107,0.449,33,67,0.493,15,40,0.375,12,16,0.75,123,52,92,0.565,39,65,0.6,13,27,0.481,20,26,0.769,137
430,OKC,2023-12-14,123,@,SAC,0,240,44,102,0.431,33,66,0.5,11,36,0.306,24,27,0.889,123,47,95,0.495,29,50,0.58,18,45,0.4,16,21,0.762,128
431,DET,2023-12-11,123,,IND,0,240,45,81,0.556,35,52,0.673,10,29,0.345,23,30,0.767,123,52,92,0.565,39,61,0.639,13,31,0.419,14,19,0.737,131
432,ORL,2023-12-08,123,,DET,1,240,49,89,0.551,39,63,0.619,10,26,0.385,15,19,0.789,123,34,81,0.42,28,51,0.549,6,30,0.2,17,24,0.708,91
433,NYK,2023-12-08,123,@,BOS,0,240,44,88,0.5,29,51,0.569,15,37,0.405,20,27,0.741,123,48,91,0.527,29,44,0.659,19,47,0.404,18,21,0.857,133
434,SAC,2023-12-02,123,,DEN,1,240,48,99,0.485,32,65,0.492,16,34,0.471,11,15,0.733,123,49,99,0.495,43,74,0.581,6,25,0.24,13,20,0.65,117
435,MIN,2023-12-02,123,@,CHO,1,240,43,84,0.512,32,53,0.604,11,31,0.355,26,30,0.867,123,44,91,0.484,32,66,0.485,12,25,0.48,17,19,0.895,117
436,GSW,2023-11-28,123,@,SAC,0,240,40,83,0.482,23,42,0.548,17,41,0.415,26,30,0.867,123,41,91,0.451,26,47,0.553,15,44,0.341,27,42,0.643,124
437,OKC,2023-11-25,123,,PHI,0,240,43,98,0.439,27,55,0.491,16,43,0.372,21,26,0.808,123,38,83,0.458,24,42,0.571,14,41,0.341,37,45,0.822,127
438,PHO,2023-11-22,123,,GSW,1,240,34,76,0.447,23,48,0.479,11,28,0.393,44,52,0.846,123,43,90,0.478,33,58,0.569,10,32,0.313,19,29,0.655,115
439,GSW,2023-11-18,123,,OKC,0,265,44,97,0.454,26,51,0.51,18,46,0.391,17,21,0.81,123,52,100,0.52,44,77,0.571,8,23,0.348,18,20,0.9,130
440,OKC,2023-11-14,123,,SAS,1,240,46,89,0.517,31,50,0.62,15,39,0.385,16,20,0.8,123,36,93,0.387,27,63,0.429,9,30,0.3,6,9,0.667,87
441,TOR,2023-11-05,123,@,SAS,1,265,44,97,0.454,25,49,0.51,19,48,0.396,16,26,0.615,123,48,96,0.5,38,64,0.594,10,32,0.313,10,13,0.769,116
442,ATL,2023-11-04,123,@,NOP,1,240,45,93,0.484,31,52,0.596,14,41,0.341,19,24,0.792,123,40,84,0.476,32,53,0.604,8,31,0.258,17,21,0.81,105
443,DEN,2023-11-04,123,,CHI,1,240,42,81,0.519,26,45,0.578,16,36,0.444,23,30,0.767,123,39,86,0.453,32,60,0.533,7,26,0.269,16,23,0.696,101
444,MIN,2023-11-04,123,,UTA,1,240,45,81,0.556,36,57,0.632,9,24,0.375,24,31,0.774,123,35,91,0.385,23,48,0.479,12,43,0.279,13,17,0.765,95
445,LAC,2023-10-29,123,,SAS,1,240,47,91,0.516,31,49,0.633,16,42,0.381,13,21,0.619,123,30,80,0.375,19,47,0.404,11,33,0.333,12,16,0.75,83
446,LAC,2023-10-25,123,,POR,1,240,47,90,0.522,31,56,0.554,16,34,0.471,13,16,0.813,123,44,93,0.473,34,61,0.557,10,32,0.313,13,17,0.765,111
447,IND,2024-02-02,122,,SAC,0,240,46,85,0.541,36,56,0.643,10,29,0.345,20,24,0.833,122,51,90,0.567,38,56,0.679,13,34,0.382,18,28,0.643,133
448,LAL,2024-01-30,122,@,ATL,0,240,48,90,0.533,36,57,0.632,12,33,0.364,14,25,0.56,122,53,101,0.525,37,63,0.587,16,38,0.421,16,18,0.889,138
449,CHO,2024-01-27,122,,UTA,0,240,47,92,0.511,34,60,0.567,13,32,0.406,15,21,0.714,122,52,93,0.559,35,52,0.673,17,41,0.415,13,17,0.765,134
450,NYK,2024-01-25,122,,DEN,1,240,45,85,0.529,30,47,0.638,15,38,0.395,17,20,0.85,122,34,84,0.405,29,58,0.5,5,26,0.192,11,13,0.846,84
451,PHI,2024-01-25,122,@,IND,0,240,42,87,0.483,35,58,0.603,7,29,0.241,31,43,0.721,122,53,93,0.57,41,65,0.631,12,28,0.429,16,21,0.762,134
452,SAC,2024-01-22,122,,ATL,1,240,43,93,0.462,31,55,0.564,12,38,0.316,24,27,0.889,122,36,93,0.387,22,53,0.415,14,40,0.35,21,27,0.778,107
453,MIL,2024-01-22,122,@,DET,1,240,42,94,0.447,32,55,0.582,10,39,0.256,28,34,0.824,122,40,89,0.449,30,59,0.508,10,30,0.333,23,29,0.793,113
454,CHI,2024-01-13,122,@,SAS,1,240,46,90,0.511,31,56,0.554,15,34,0.441,15,20,0.75,122,39,95,0.411,21,49,0.429,18,46,0.391,20,23,0.87,116
455,MIN,2024-01-05,122,@,HOU,1,240,46,88,0.523,32,55,0.582,14,33,0.424,16,20,0.8,122,36,90,0.4,24,58,0.414,12,32,0.375,11,15,0.733,95
456,ORL,2024-01-05,122,@,DEN,1,240,41,82,0.5,24,46,0.522,17,36,0.472,23,34,0.676,122,48,95,0.505,39,62,0.629,9,33,0.273,15,19,0.789,120
457,PHO,2024-01-03,122,,LAC,0,240,42,79,0.532,27,44,0.614,15,35,0.429,23,26,0.885,122,42,76,0.553,24,42,0.571,18,34,0.529,29,32,0.906,131
458,IND,2024-01-01,122,@,MIL,1,240,43,97,0.443,38,62,0.613,5,35,0.143,31,38,0.816,122,41,93,0.441,31,53,0.585,10,40,0.25,21,26,0.808,113
459,GSW,2023-12-30,122,,DAL,0,240,47,103,0.456,28,55,0.509,19,48,0.396,9,13,0.692,122,49,88,0.557,33,48,0.688,16,40,0.4,18,22,0.818,132
460,DET,2023-12-28,122,@,BOS,0,265,48,101,0.475,34,58,0.586,14,43,0.326,12,19,0.632,122,48,99,0.485,37,60,0.617,11,39,0.282,21,25,0.84,128
461,BRK,2023-12-27,122,,MIL,0,240,45,101,0.446,38,69,0.551,7,32,0.219,25,29,0.862,122,52,89,0.584,29,38,0.763,23,51,0.451,17,23,0.739,144
462,MIL,2023-12-25,122,@,NYK,0,240,45,95,0.474,32,53,0.604,13,42,0.31,19,24,0.792,122,50,92,0.543,42,66,0.636,8,26,0.308,21,26,0.808,129
463,MIA,2023-12-22,122,,ATL,1,240,40,86,0.465,23,47,0.489,17,39,0.436,25,30,0.833,122,42,96,0.438,23,42,0.548,19,54,0.352,10,14,0.714,113
464,HOU,2023-12-22,122,,DAL,1,240,46,95,0.484,35,57,0.614,11,38,0.289,19,23,0.826,122,35,101,0.347,28,61,0.459,7,40,0.175,19,26,0.731,96
465,DEN,2023-12-22,122,@,BRK,1,240,45,87,0.517,34,61,0.557,11,26,0.423,21,25,0.84,122,43,89,0.483,30,56,0.536,13,33,0.394,18,26,0.692,117
466,NYK,2023-12-16,122,@,LAC,0,240,44,94,0.468,33,59,0.559,11,35,0.314,23,26,0.885,122,50,88,0.568,34,55,0.618,16,33,0.485,28,34,0.824,144
467,PHO,2023-12-15,122,,NYK,0,240,47,90,0.522,36,62,0.581,11,28,0.393,17,21,0.81,122,49,82,0.598,32,53,0.604,17,29,0.586,24,28,0.857,139
468,UTA,2023-12-14,122,@,POR,1,240,49,92,0.533,38,59,0.644,11,33,0.333,13,14,0.929,122,43,103,0.417,27,58,0.466,16,45,0.356,12,18,0.667,114
469,WAS,2023-12-13,122,,NOP,0,240,42,82,0.512,23,38,0.605,19,44,0.432,19,24,0.792,122,50,96,0.521,34,62,0.548,16,34,0.471,26,30,0.867,142
470,LAL,2023-12-13,122,@,SAS,1,240,49,91,0.538,35,56,0.625,14,35,0.4,10,17,0.588,122,45,96,0.469,29,59,0.492,16,37,0.432,13,18,0.722,119
471,ATL,2023-12-11,122,,DEN,0,240,44,96,0.458,27,52,0.519,17,44,0.386,17,18,0.944,122,47,88,0.534,35,59,0.593,12,29,0.414,23,29,0.793,129
472,NYK,2023-12-05,122,@,MIL,0,240,43,87,0.494,36,64,0.563,7,23,0.304,29,33,0.879,122,55,91,0.604,32,53,0.604,23,38,0.605,13,19,0.684,146
473,IND,2023-12-04,122,,BOS,1,240,43,94,0.457,24,54,0.444,19,40,0.475,17,21,0.81,122,46,97,0.474,34,56,0.607,12,41,0.293,8,12,0.667,112
474,CLE,2023-11-21,122,@,PHI,1,265,46,94,0.489,37,69,0.536,9,25,0.36,21,25,0.84,122,40,96,0.417,29,61,0.475,11,35,0.314,28,34,0.824,119
475,NYK,2023-11-18,122,@,CHO,1,240,46,91,0.505,30,54,0.556,16,37,0.432,14,19,0.737,122,40,82,0.488,23,47,0.489,17,35,0.486,11,13,0.846,108
476,MIA,2023-11-16,122,,BRK,1,240,42,81,0.519,27,46,0.587,15,35,0.429,23,24,0.958,122,40,85,0.471,26,49,0.531,14,36,0.389,21,27,0.778,115
477,LAL,2023-11-10,122,@,PHO,1,240,42,84,0.5,30,57,0.526,12,27,0.444,26,34,0.765,122,42,94,0.447,27,57,0.474,15,37,0.405,20,27,0.741,119
478,MIN,2023-11-08,122,,NOP,1,240,45,82,0.549,30,45,0.667,15,37,0.405,17,24,0.708,122,36,93,0.387,28,65,0.431,8,28,0.286,21,22,0.955,101
479,HOU,2023-11-06,122,,SAC,1,240,43,75,0.573,28,44,0.636,15,31,0.484,21,27,0.778,122,36,81,0.444,22,41,0.537,14,40,0.35,11,20,0.55,97
480,MIL,2023-10-30,122,,MIA,1,240,44,87,0.506,32,50,0.64,12,37,0.324,22,30,0.733,122,41,86,0.477,28,52,0.538,13,34,0.382,19,20,0.95,114
481,GSW,2023-10-27,122,@,SAC,1,240,48,87,0.552,34,55,0.618,14,32,0.438,12,14,0.857,122,41,94,0.436,29,54,0.537,12,40,0.3,20,29,0.69,114
482,HOU,2023-10-27,122,@,SAS,0,265,52,100,0.52,44,68,0.647,8,32,0.25,10,20,0.5,122,46,94,0.489,33,52,0.635,13,42,0.31,21,28,0.75,126
483,MIA,2024-02-06,121,,ORL,1,240,47,87,0.54,34,51,0.667,13,36,0.361,14,18,0.778,121,35,80,0.438,25,45,0.556,10,35,0.286,15,21,0.714,95
484,PHI,2024-02-03,121,,BRK,0,240,44,96,0.458,32,67,0.478,12,29,0.414,21,27,0.778,121,49,95,0.516,29,44,0.659,20,51,0.392,18,23,0.783,136
485,GSW,2024-02-02,121,@,MEM,1,240,46,83,0.554,35,54,0.648,11,29,0.379,18,22,0.818,121,35,87,0.402,21,41,0.512,14,46,0.304,17,24,0.708,101
486,DET,2024-01-31,121,@,CLE,0,240,45,81,0.556,29,50,0.58,16,31,0.516,15,19,0.789,121,47,89,0.528,35,54,0.648,12,35,0.343,22,23,0.957,128
487,MIN,2024-01-31,121,,DAL,1,240,45,80,0.563,32,50,0.64,13,30,0.433,18,30,0.6,121,31,76,0.408,25,47,0.532,6,29,0.207,19,26,0.731,87
488,SAC,2024-01-18,121,,IND,0,240,44,85,0.518,29,48,0.604,15,37,0.405,18,32,0.563,121,49,89,0.551,36,56,0.643,13,33,0.394,15,19,0.789,126
489,TOR,2024-01-17,121,,MIA,1,240,45,88,0.511,25,50,0.5,20,38,0.526,11,18,0.611,121,41,90,0.456,35,62,0.565,6,28,0.214,9,12,0.75,97
490,DEN,2024-01-16,121,@,PHI,0,240,45,89,0.506,33,60,0.55,12,29,0.414,19,25,0.76,121,43,76,0.566,28,45,0.622,15,31,0.484,25,34,0.735,126
491,MEM,2024-01-07,121,@,PHO,1,240,43,97,0.443,26,48,0.542,17,49,0.347,18,24,0.75,121,46,102,0.451,38,74,0.514,8,28,0.286,15,22,0.682,115
492,NYK,2024-01-06,121,@,WAS,1,240,43,87,0.494,29,51,0.569,14,36,0.389,21,24,0.875,121,40,85,0.471,27,48,0.563,13,37,0.351,12,20,0.6,105
493,SAS,2024-01-04,121,,MIL,0,240,46,95,0.484,32,55,0.582,14,40,0.35,15,17,0.882,121,49,92,0.533,37,58,0.638,12,34,0.353,15,19,0.789,125
494,GSW,2024-01-02,121,,ORL,1,240,42,78,0.538,29,43,0.674,13,35,0.371,24,37,0.649,121,41,92,0.446,27,56,0.482,14,36,0.389,19,23,0.826,115
495,CLE,2024-01-01,121,@,TOR,0,240,43,89,0.483,31,53,0.585,12,36,0.333,23,26,0.885,121,42,87,0.483,31,57,0.544,11,30,0.367,29,40,0.725,124
496,LAC,2024-01-01,121,,MIA,1,240,47,80,0.588,33,51,0.647,14,29,0.483,13,14,0.929,121,35,83,0.422,24,49,0.49,11,34,0.324,23,29,0.793,104
497,PHI,2023-12-22,121,,TOR,1,240,44,83,0.53,30,52,0.577,14,31,0.452,19,21,0.905,121,39,87,0.448,30,54,0.556,9,33,0.273,24,28,0.857,111
498,NYK,2023-12-20,121,@,BRK,1,240,44,95,0.463,31,62,0.5,13,33,0.394,20,25,0.8,121,37,101,0.366,22,54,0.407,15,47,0.319,13,17,0.765,102
499,LAC,2023-12-14,121,,GSW,1,240,41,81,0.506,28,49,0.571,13,32,0.406,26,30,0.867,121,40,92,0.435,24,47,0.511,16,45,0.356,17,19,0.895,113
500,NOP,2023-12-11,121,,MIN,1,240,40,82,0.488,30,55,0.545,10,27,0.37,31,40,0.775,121,40,91,0.44,27,55,0.491,13,36,0.361,14,19,0.737,107
501,CHI,2023-12-08,121,@,SAS,1,240,47,102,0.461,34,74,0.459,13,28,0.464,14,24,0.583,121,39,83,0.47,22,41,0.537,17,42,0.405,17,20,0.85,112
502,CLE,2023-12-06,121,,ORL,1,240,46,86,0.535,32,52,0.615,14,34,0.412,15,20,0.75,121,41,84,0.488,39,61,0.639,2,23,0.087,27,37,0.73,111
503,ATL,2023-12-02,121,@,MIL,0,240,45,101,0.446,30,63,0.476,15,38,0.395,16,21,0.762,121,53,89,0.596,39,56,0.696,14,33,0.424,12,15,0.8,132
504,NOP,2023-12-01,121,,SAS,1,240,42,85,0.494,32,54,0.593,10,31,0.323,27,29,0.931,121,38,83,0.458,22,44,0.5,16,39,0.41,14,17,0.824,106
505,DAL,2023-11-28,121,,HOU,1,240,42,89,0.472,30,55,0.545,12,34,0.353,25,29,0.862,121,42,85,0.494,34,56,0.607,8,29,0.276,23,29,0.793,115
506,LAL,2023-11-25,121,@,CLE,1,240,47,90,0.522,38,63,0.603,9,27,0.333,18,21,0.857,121,43,91,0.473,34,63,0.54,9,28,0.321,20,23,0.87,115
507,TOR,2023-11-24,121,,CHI,1,240,44,83,0.53,31,44,0.705,13,39,0.333,20,27,0.741,121,42,82,0.512,30,55,0.545,12,27,0.444,12,19,0.632,108
508,POR,2023-11-22,121,,UTA,1,240,47,92,0.511,30,53,0.566,17,39,0.436,10,15,0.667,121,37,79,0.468,27,48,0.563,10,31,0.323,21,26,0.808,105
509,CHO,2023-11-20,121,,BOS,1,265,46,104,0.442,33,65,0.508,13,39,0.333,16,17,0.941,121,42,97,0.433,26,47,0.553,16,50,0.32,18,28,0.643,118
510,GSW,2023-11-20,121,,HOU,1,240,36,77,0.468,15,34,0.441,21,43,0.488,28,33,0.848,121,44,95,0.463,31,54,0.574,13,41,0.317,15,19,0.789,116
511,PHI,2023-11-19,121,@,BRK,1,240,44,94,0.468,28,59,0.475,16,35,0.457,17,18,0.944,121,38,81,0.469,27,53,0.509,11,28,0.393,12,16,0.75,99
512,CLE,2023-11-19,121,,DEN,1,240,45,82,0.549,34,55,0.618,11,27,0.407,20,26,0.769,121,39,82,0.476,25,53,0.472,14,29,0.483,17,23,0.739,109
513,MIN,2023-11-18,121,@,NOP,1,240,43,80,0.538,30,49,0.612,13,31,0.419,22,27,0.815,121,44,86,0.512,32,57,0.561,12,29,0.414,20,23,0.87,120
514,BOS,2023-11-10,121,,BRK,1,240,41,94,0.436,22,42,0.524,19,52,0.365,20,28,0.714,121,38,85,0.447,23,48,0.479,15,37,0.405,16,18,0.889,107
515,MEM,2023-11-10,121,,UTA,0,240,46,101,0.455,27,53,0.509,19,48,0.396,10,13,0.769,121,41,76,0.539,23,39,0.59,18,37,0.486,27,29,0.931,127
516,SAC,2023-11-08,121,,POR,1,265,41,89,0.461,30,52,0.577,11,37,0.297,28,38,0.737,121,44,87,0.506,36,65,0.554,8,22,0.364,22,29,0.759,118
517,MIA,2023-11-03,121,,WAS,1,240,48,80,0.6,35,53,0.66,13,27,0.481,12,14,0.857,121,46,81,0.568,33,53,0.623,13,28,0.464,9,17,0.529,114
518,IND,2023-11-03,121,,CLE,1,240,45,86,0.523,30,55,0.545,15,31,0.484,16,24,0.667,121,44,84,0.524,36,56,0.643,8,28,0.286,20,25,0.8,116
519,PHO,2023-11-02,121,,SAS,0,240,43,80,0.538,27,48,0.563,16,32,0.5,19,26,0.731,121,51,98,0.52,33,61,0.541,18,37,0.486,12,13,0.923,132
520,WAS,2023-11-01,121,@,ATL,0,240,51,101,0.505,41,61,0.672,10,40,0.25,9,14,0.643,121,46,92,0.5,37,60,0.617,9,32,0.281,29,32,0.906,130
521,CHO,2023-10-30,121,,BRK,0,240,47,96,0.49,39,65,0.6,8,31,0.258,19,20,0.95,121,49,87,0.563,37,54,0.685,12,33,0.364,23,32,0.719,133
522,SAC,2024-02-07,120,,DET,0,240,45,95,0.474,30,51,0.588,15,44,0.341,15,22,0.682,120,47,84,0.56,30,53,0.566,17,31,0.548,22,22,1.0,133
523,PHO,2024-02-02,120,@,ATL,0,240,47,88,0.534,33,51,0.647,14,37,0.378,12,14,0.857,120,49,95,0.516,32,51,0.627,17,44,0.386,14,18,0.778,129
524,DEN,2024-02-02,120,,POR,1,240,46,91,0.505,34,55,0.618,12,36,0.333,16,17,0.941,120,37,80,0.463,27,52,0.519,10,28,0.357,24,30,0.8,108
525,BRK,2024-01-31,120,,PHO,0,240,47,94,0.5,31,55,0.564,16,39,0.41,10,13,0.769,120,49,79,0.62,35,51,0.686,14,28,0.5,24,32,0.75,136
526,DET,2024-01-28,120,,OKC,1,240,47,95,0.495,36,69,0.522,11,26,0.423,15,19,0.789,120,44,92,0.478,36,64,0.563,8,28,0.286,8,12,0.667,104
527,SAC,2024-01-27,120,@,DAL,1,240,43,80,0.538,32,50,0.64,11,30,0.367,23,30,0.767,120,43,98,0.439,27,52,0.519,16,46,0.348,13,18,0.722,115
528,SAS,2024-01-19,120,@,CHO,0,240,47,84,0.56,32,52,0.615,15,32,0.469,11,17,0.647,120,47,84,0.56,31,55,0.564,16,29,0.552,14,16,0.875,124
529,NOP,2024-01-15,120,@,DAL,0,240,41,81,0.506,34,58,0.586,7,23,0.304,31,41,0.756,120,39,85,0.459,21,42,0.5,18,43,0.419,29,35,0.829,125
530,MIA,2024-01-10,120,,OKC,0,240,41,89,0.461,26,53,0.491,15,36,0.417,23,28,0.821,120,51,86,0.593,37,53,0.698,14,33,0.424,12,16,0.75,128
531,TOR,2024-01-10,120,@,LAC,0,240,46,84,0.548,34,54,0.63,12,30,0.4,16,18,0.889,120,49,93,0.527,34,59,0.576,15,34,0.441,13,13,1.0,126
532,MIN,2024-01-10,120,@,BOS,0,265,44,95,0.463,30,61,0.492,14,34,0.412,18,20,0.9,120,39,90,0.433,20,43,0.465,19,47,0.404,30,31,0.968,127
533,MEM,2024-01-09,120,@,DAL,1,240,44,91,0.484,30,54,0.556,14,37,0.378,18,21,0.857,120,36,82,0.439,27,55,0.491,9,27,0.333,22,27,0.815,103
534,MIA,2024-01-08,120,,HOU,1,240,41,82,0.5,26,46,0.565,15,36,0.417,23,32,0.719,120,37,88,0.42,23,47,0.489,14,41,0.341,25,28,0.893,113
535,UTA,2024-01-06,120,@,PHI,1,240,46,80,0.575,38,50,0.76,8,30,0.267,20,24,0.833,120,42,104,0.404,35,66,0.53,7,38,0.184,18,23,0.783,109
536,DEN,2024-01-05,120,,ORL,0,240,48,95,0.505,39,62,0.629,9,33,0.273,15,19,0.789,120,41,82,0.5,24,46,0.522,17,36,0.472,23,34,0.676,122
537,BOS,2023-12-29,120,,TOR,1,240,43,88,0.489,26,49,0.531,17,39,0.436,17,20,0.85,120,44,95,0.463,27,51,0.529,17,44,0.386,13,20,0.65,118
538,IND,2023-12-28,120,@,CHI,1,240,43,85,0.506,24,43,0.558,19,42,0.452,15,22,0.682,120,40,97,0.412,33,70,0.471,7,27,0.259,17,22,0.773,104
539,NYK,2023-12-27,120,@,OKC,0,240,41,82,0.5,27,48,0.563,14,34,0.412,24,30,0.8,120,49,90,0.544,35,58,0.603,14,32,0.438,17,22,0.773,129
540,DEN,2023-12-25,120,,GSW,1,240,40,82,0.488,26,48,0.542,14,34,0.412,26,32,0.813,120,40,87,0.46,26,47,0.553,14,40,0.35,20,23,0.87,114
541,OKC,2023-12-23,120,,LAL,0,240,46,95,0.484,33,54,0.611,13,41,0.317,15,19,0.789,120,47,90,0.522,31,58,0.534,16,32,0.5,19,23,0.826,129
542,SAC,2023-12-22,120,,PHO,1,240,44,83,0.53,32,45,0.711,12,38,0.316,20,26,0.769,120,39,88,0.443,34,63,0.54,5,25,0.2,22,28,0.786,105
543,LAC,2023-12-20,120,@,DAL,1,240,43,77,0.558,32,46,0.696,11,31,0.355,23,25,0.92,120,39,91,0.429,25,48,0.521,14,43,0.326,19,27,0.704,111
544,POR,2023-12-16,120,,DAL,0,240,47,94,0.5,40,62,0.645,7,32,0.219,19,22,0.864,120,48,97,0.495,32,50,0.64,16,47,0.34,19,21,0.905,131
545,BRK,2023-12-16,120,@,GSW,0,240,45,93,0.484,28,50,0.56,17,43,0.395,13,15,0.867,120,44,91,0.484,27,59,0.458,17,32,0.531,19,20,0.95,124
546,BOS,2023-12-12,120,,CLE,1,240,38,84,0.452,20,40,0.5,18,44,0.409,26,26,1.0,120,44,92,0.478,25,47,0.532,19,45,0.422,6,9,0.667,113
547,DAL,2023-12-11,120,@,MEM,1,240,43,86,0.5,26,46,0.565,17,40,0.425,17,19,0.895,120,41,89,0.461,23,45,0.511,18,44,0.409,13,16,0.813,113
548,UTA,2023-12-11,120,@,OKC,0,240,44,92,0.478,32,54,0.593,12,38,0.316,20,21,0.952,120,50,96,0.521,32,58,0.552,18,38,0.474,16,17,0.941,134
549,DAL,2023-12-02,120,,OKC,0,240,39,87,0.448,20,35,0.571,19,52,0.365,23,35,0.657,120,44,100,0.44,24,56,0.429,20,44,0.455,18,22,0.818,126
550,CHI,2023-11-30,120,,MIL,1,265,45,98,0.459,32,61,0.525,13,37,0.351,17,22,0.773,120,44,98,0.449,28,50,0.56,16,48,0.333,9,13,0.692,113
551,GSW,2023-11-30,120,,LAC,1,240,41,82,0.5,26,43,0.605,15,39,0.385,23,31,0.742,120,42,95,0.442,30,63,0.476,12,32,0.375,18,24,0.75,114
552,WAS,2023-11-29,120,@,ORL,0,240,41,87,0.471,30,58,0.517,11,29,0.379,27,35,0.771,120,51,84,0.607,34,57,0.596,17,27,0.63,20,24,0.833,139
553,SAS,2023-11-26,120,@,DEN,0,240,42,93,0.452,28,56,0.5,14,37,0.378,22,26,0.846,120,50,89,0.562,38,61,0.623,12,28,0.429,20,25,0.8,132
554,PHO,2023-11-21,120,,POR,1,240,43,76,0.566,36,59,0.61,7,17,0.412,27,28,0.964,120,38,87,0.437,24,56,0.429,14,31,0.452,17,20,0.85,107
555,MEM,2023-11-18,120,@,SAS,1,240,40,86,0.465,29,53,0.547,11,33,0.333,29,36,0.806,120,36,83,0.434,21,43,0.488,15,40,0.375,21,26,0.808,108
556,NOP,2023-11-18,120,,MIN,0,240,44,86,0.512,32,57,0.561,12,29,0.414,20,23,0.87,120,43,80,0.538,30,49,0.612,13,31,0.419,22,27,0.815,121
557,SAS,2023-11-17,120,,SAC,0,240,43,92,0.467,28,56,0.5,15,36,0.417,19,23,0.826,120,46,85,0.541,28,43,0.651,18,42,0.429,19,24,0.792,129
558,NYK,2023-11-17,120,@,WAS,1,240,45,91,0.495,29,53,0.547,16,38,0.421,14,20,0.7,120,37,82,0.451,27,50,0.54,10,32,0.313,15,16,0.938,99
559,DET,2023-11-14,120,,ATL,0,240,47,90,0.522,37,61,0.607,10,29,0.345,16,23,0.696,120,45,87,0.517,33,54,0.611,12,33,0.364,24,26,0.923,126
560,CLE,2023-11-13,120,@,SAC,0,240,45,91,0.495,29,56,0.518,16,35,0.457,14,17,0.824,120,49,83,0.59,29,41,0.707,20,42,0.476,14,22,0.636,132
561,ATL,2023-11-09,120,@,ORL,1,240,41,85,0.482,26,46,0.565,15,39,0.385,23,30,0.767,120,42,90,0.467,32,63,0.508,10,27,0.37,25,35,0.714,119
562,MIL,2023-11-08,120,,DET,1,240,41,90,0.456,30,53,0.566,11,37,0.297,27,32,0.844,120,48,98,0.49,41,69,0.594,7,29,0.241,15,16,0.938,118
563,CLE,2023-11-08,120,@,OKC,0,240,42,83,0.506,33,54,0.611,9,29,0.31,27,37,0.73,120,44,86,0.512,32,58,0.552,12,28,0.429,28,30,0.933,128
564,GSW,2023-11-06,120,@,DET,1,240,46,97,0.474,34,56,0.607,12,41,0.293,16,21,0.762,120,38,80,0.475,25,50,0.5,13,30,0.433,20,21,0.952,109
565,PHO,2023-11-05,120,@,DET,1,240,43,86,0.5,35,65,0.538,8,21,0.381,26,29,0.897,120,43,87,0.494,35,64,0.547,8,23,0.348,12,14,0.857,106
566,ORL,2023-11-04,120,,LAL,1,240,46,101,0.455,34,68,0.5,12,33,0.364,16,19,0.842,120,37,84,0.44,29,54,0.537,8,30,0.267,19,21,0.905,101
567,BRK,2023-10-27,120,@,DAL,0,240,45,92,0.489,24,49,0.49,21,43,0.488,9,10,0.9,120,44,91,0.484,29,55,0.527,15,36,0.417,22,28,0.786,125
568,UTA,2023-10-27,120,,LAC,1,240,42,96,0.438,26,55,0.473,16,41,0.39,20,22,0.909,120,41,77,0.532,27,42,0.643,14,35,0.4,22,28,0.786,118
569,ATL,2023-10-27,120,,NYK,0,240,42,87,0.483,30,55,0.545,12,32,0.375,24,30,0.8,120,43,90,0.478,23,46,0.5,20,44,0.455,20,28,0.714,126
570,WAS,2023-10-25,120,@,IND,0,240,44,96,0.458,35,72,0.486,9,24,0.375,23,29,0.793,120,56,107,0.523,36,64,0.563,20,43,0.465,11,12,0.917,143
571,DAL,2024-02-06,119,@,BRK,1,240,46,91,0.505,27,48,0.563,19,43,0.442,8,13,0.615,119,41,91,0.451,29,58,0.5,12,33,0.364,13,15,0.867,107
572,POR,2024-01-31,119,,MIL,1,240,49,92,0.533,37,64,0.578,12,28,0.429,9,9,1.0,119,45,92,0.489,32,47,0.681,13,45,0.289,13,18,0.722,116
573,GSW,2024-01-30,119,,PHI,1,240,44,79,0.557,30,47,0.638,14,32,0.438,17,19,0.895,119,39,85,0.459,26,55,0.473,13,30,0.433,16,21,0.762,107
574,LAL,2024-01-29,119,@,HOU,0,240,45,91,0.495,32,56,0.571,13,35,0.371,16,26,0.615,119,52,98,0.531,40,62,0.645,12,36,0.333,19,25,0.76,135
575,BOS,2024-01-22,119,@,DAL,1,240,41,88,0.466,26,42,0.619,15,46,0.326,22,30,0.733,119,43,97,0.443,29,57,0.509,14,40,0.35,10,14,0.714,110
576,PHO,2024-01-16,119,,SAC,1,240,42,85,0.494,25,48,0.521,17,37,0.459,18,20,0.9,119,46,92,0.5,28,52,0.538,18,40,0.45,7,12,0.583,117
577,MEM,2024-01-12,119,,LAC,0,240,41,95,0.432,23,51,0.451,18,44,0.409,19,27,0.704,119,49,89,0.551,34,58,0.586,15,31,0.484,15,20,0.75,128
578,HOU,2024-01-10,119,@,CHI,0,265,48,101,0.475,37,56,0.661,11,45,0.244,12,20,0.6,119,42,95,0.442,23,48,0.479,19,47,0.404,21,25,0.84,124
579,CHI,2024-01-08,119,@,CHO,1,265,45,92,0.489,36,66,0.545,9,26,0.346,20,24,0.833,119,40,94,0.426,23,52,0.442,17,42,0.405,15,17,0.882,112
580,CHO,2023-12-29,119,@,PHO,0,240,44,92,0.478,21,46,0.457,23,46,0.5,8,8,1.0,119,46,74,0.622,28,44,0.636,18,30,0.6,23,24,0.958,133
581,OKC,2023-12-29,119,@,DEN,1,240,46,91,0.505,34,56,0.607,12,35,0.343,15,16,0.938,119,36,85,0.424,26,48,0.542,10,37,0.27,11,15,0.733,93
582,MIL,2023-12-29,119,@,CLE,1,240,41,80,0.513,29,51,0.569,12,29,0.414,25,28,0.893,119,49,103,0.476,43,60,0.717,6,43,0.14,7,9,0.778,111
583,WAS,2023-12-26,119,,ORL,0,240,43,87,0.494,27,45,0.6,16,42,0.381,17,21,0.81,119,49,93,0.527,37,67,0.552,12,26,0.462,17,25,0.68,127
584,MIA,2023-12-25,119,,PHI,1,240,40,84,0.476,28,52,0.538,12,32,0.375,27,35,0.771,119,40,94,0.426,23,49,0.469,17,45,0.378,16,25,0.64,113
585,TOR,2023-12-23,119,,UTA,0,240,45,94,0.479,32,62,0.516,13,32,0.406,16,19,0.842,119,48,91,0.527,31,53,0.585,17,38,0.447,13,14,0.929,126
586,ATL,2023-12-23,119,,MEM,0,240,45,96,0.469,32,53,0.604,13,43,0.302,16,20,0.8,119,50,97,0.515,39,64,0.609,11,33,0.333,14,22,0.636,125
587,SAS,2023-12-23,119,@,DAL,0,240,44,98,0.449,30,53,0.566,14,45,0.311,17,24,0.708,119,52,100,0.52,29,55,0.527,23,45,0.511,17,21,0.81,144
588,UTA,2023-12-21,119,@,DET,1,240,43,94,0.457,32,64,0.5,11,30,0.367,22,24,0.917,119,43,86,0.5,34,55,0.618,9,31,0.29,16,19,0.842,111
589,SAC,2023-12-20,119,,BOS,0,240,43,91,0.473,22,47,0.468,21,44,0.477,12,23,0.522,119,51,92,0.554,29,50,0.58,22,42,0.524,20,24,0.833,144
590,SAS,2023-12-19,119,@,MIL,0,240,46,96,0.479,37,66,0.561,9,30,0.3,18,21,0.857,119,50,106,0.472,32,57,0.561,18,49,0.367,14,18,0.778,132
591,HOU,2023-12-17,119,@,MIL,0,240,45,85,0.529,34,58,0.586,11,27,0.407,18,21,0.857,119,45,90,0.5,32,54,0.593,13,36,0.361,25,32,0.781,128
592,ATL,2023-12-16,119,@,CLE,0,240,41,85,0.482,26,49,0.531,15,36,0.417,22,25,0.88,119,49,101,0.485,33,59,0.559,16,42,0.381,13,15,0.867,127
593,MIN,2023-12-14,119,@,DAL,1,240,44,88,0.5,30,57,0.526,14,31,0.452,17,25,0.68,119,39,83,0.47,32,51,0.627,7,32,0.219,16,18,0.889,101
594,SAS,2023-12-13,119,,LAL,0,240,45,96,0.469,29,59,0.492,16,37,0.432,13,18,0.722,119,49,91,0.538,35,56,0.625,14,35,0.4,10,17,0.588,122
595,PHO,2023-12-12,119,,GSW,1,240,38,84,0.452,24,45,0.533,14,39,0.359,29,34,0.853,119,41,92,0.446,25,46,0.543,16,46,0.348,18,27,0.667,116
596,LAC,2023-12-12,119,,SAC,1,240,44,84,0.524,33,55,0.6,11,29,0.379,20,21,0.952,119,36,86,0.419,26,49,0.531,10,37,0.27,17,24,0.708,99
597,CHO,2023-12-08,119,,TOR,1,240,44,79,0.557,31,54,0.574,13,25,0.52,18,20,0.9,119,47,93,0.505,41,61,0.672,6,32,0.188,16,21,0.762,116
598,MIL,2023-12-07,119,,IND,0,240,43,96,0.448,31,63,0.492,12,33,0.364,21,28,0.75,119,50,102,0.49,43,69,0.623,7,33,0.212,21,25,0.84,128
599,NYK,2023-12-01,119,@,TOR,1,240,45,90,0.5,29,54,0.537,16,36,0.444,13,16,0.813,119,44,100,0.44,38,68,0.559,6,32,0.188,12,17,0.706,106
600,DEN,2023-12-01,119,@,PHO,1,240,50,88,0.568,38,56,0.679,12,32,0.375,7,12,0.583,119,39,84,0.464,30,57,0.526,9,27,0.333,24,26,0.923,111
601,DEN,2023-12-01,119,@,PHO,1,240,50,88,0.568,38,56,0.679,12,32,0.375,7,12,0.583,119,39,84,0.464,30,57,0.526,9,27,0.333,24,26,0.923,111
602,MIN,2023-11-26,119,@,MEM,1,240,43,81,0.531,28,47,0.596,15,34,0.441,18,23,0.783,119,34,88,0.386,24,51,0.471,10,37,0.27,19,27,0.704,97
603,DEN,2023-11-22,119,@,ORL,0,240,44,93,0.473,29,58,0.5,15,35,0.429,16,21,0.762,119,44,81,0.543,34,52,0.654,10,29,0.345,26,30,0.867,124
604,BOS,2023-11-22,119,,MIL,1,240,44,84,0.524,27,42,0.643,17,42,0.405,14,17,0.824,119,45,101,0.446,32,67,0.478,13,34,0.382,13,17,0.765,116
605,PHI,2023-11-21,119,,CLE,0,265,40,96,0.417,29,61,0.475,11,35,0.314,28,34,0.824,119,46,94,0.489,37,69,0.536,9,25,0.36,21,25,0.84,122
606,CHI,2023-11-12,119,,DET,1,240,44,91,0.484,33,61,0.541,11,30,0.367,20,25,0.8,119,38,88,0.432,27,56,0.482,11,32,0.344,21,26,0.808,108
607,PHO,2023-11-10,119,,LAL,0,240,42,94,0.447,27,57,0.474,15,37,0.405,20,27,0.741,119,42,84,0.5,30,57,0.526,12,27,0.444,26,34,0.765,122
608,ORL,2023-11-09,119,,ATL,0,240,42,90,0.467,32,63,0.508,10,27,0.37,25,35,0.714,119,41,85,0.482,26,46,0.565,15,39,0.385,23,30,0.767,120
609,CHO,2023-11-01,119,@,HOU,0,240,45,90,0.5,34,63,0.54,11,27,0.407,18,25,0.72,119,44,84,0.524,23,47,0.489,21,37,0.568,19,23,0.826,128
610,BOS,2023-10-27,119,,MIA,1,240,45,95,0.474,29,56,0.518,16,39,0.41,13,19,0.684,119,38,89,0.427,22,56,0.393,16,33,0.485,19,23,0.826,111
611,SAS,2023-10-25,119,,DAL,0,240,46,89,0.517,35,54,0.648,11,35,0.314,16,22,0.727,119,47,99,0.475,32,52,0.615,15,47,0.319,17,23,0.739,126
612,DEN,2023-10-24,119,,LAL,1,240,48,91,0.527,34,57,0.596,14,34,0.412,9,12,0.75,119,41,90,0.456,31,61,0.508,10,29,0.345,15,20,0.75,107
613,CHO,2024-02-05,118,,LAL,0,240,47,96,0.49,34,64,0.531,13,32,0.406,11,14,0.786,118,50,89,0.562,42,55,0.764,8,34,0.235,16,19,0.842,124
614,DAL,2024-02-05,118,@,PHI,1,240,42,87,0.483,25,44,0.568,17,43,0.395,17,23,0.739,118,40,93,0.43,32,64,0.5,8,29,0.276,14,20,0.7,102
615,TOR,2024-01-30,118,@,CHI,1,240,43,83,0.518,29,54,0.537,14,29,0.483,18,20,0.9,118,38,75,0.507,27,43,0.628,11,32,0.344,20,27,0.741,107
616,NYK,2024-01-30,118,,UTA,1,240,44,94,0.468,31,60,0.517,13,34,0.382,17,18,0.944,118,39,86,0.453,27,50,0.54,12,36,0.333,13,17,0.765,103
617,WAS,2024-01-29,118,@,SAS,1,240,46,86,0.535,37,61,0.607,9,25,0.36,17,24,0.708,118,43,92,0.467,31,62,0.5,12,30,0.4,15,17,0.882,113
618,CLE,2024-01-29,118,,LAC,1,240,42,86,0.488,29,46,0.63,13,40,0.325,21,26,0.808,118,38,80,0.475,27,46,0.587,11,34,0.324,21,28,0.75,108
619,PHO,2024-01-29,118,@,MIA,1,240,46,94,0.489,32,54,0.593,14,40,0.35,12,17,0.706,118,33,84,0.393,19,48,0.396,14,36,0.389,25,25,1.0,105
620,BOS,2024-01-29,118,,NOP,1,240,43,85,0.506,26,39,0.667,17,46,0.37,15,20,0.75,118,46,91,0.505,36,56,0.643,10,35,0.286,10,13,0.769,112
621,WAS,2024-01-27,118,@,DET,1,240,45,100,0.45,34,66,0.515,11,34,0.324,17,21,0.81,118,37,85,0.435,28,53,0.528,9,32,0.281,21,27,0.778,104
622,MIN,2024-01-24,118,@,WAS,1,240,42,100,0.42,33,68,0.485,9,32,0.281,25,29,0.862,118,37,77,0.481,27,53,0.509,10,24,0.417,23,29,0.793,107
623,POR,2024-01-19,118,,IND,1,240,42,84,0.5,38,72,0.528,4,12,0.333,30,35,0.857,118,39,91,0.429,19,44,0.432,20,47,0.426,17,25,0.68,115
624,MIN,2024-01-18,118,,MEM,1,240,45,82,0.549,33,54,0.611,12,28,0.429,16,21,0.762,118,39,85,0.459,25,51,0.49,14,34,0.412,11,17,0.647,103
625,NOP,2024-01-13,118,@,DAL,1,240,39,79,0.494,27,49,0.551,12,30,0.4,28,37,0.757,118,37,82,0.451,22,41,0.537,15,41,0.366,19,20,0.95,108
626,GSW,2024-01-13,118,@,MIL,0,240,47,98,0.48,32,62,0.516,15,36,0.417,9,14,0.643,118,51,94,0.543,38,63,0.603,13,31,0.419,14,17,0.824,129
627,GSW,2024-01-07,118,,TOR,0,240,45,100,0.45,31,54,0.574,14,46,0.304,14,15,0.933,118,55,94,0.585,40,61,0.656,15,33,0.455,8,14,0.571,133
628,BOS,2024-01-06,118,@,IND,1,240,46,90,0.511,30,49,0.612,16,41,0.39,10,19,0.526,118,38,92,0.413,30,50,0.6,8,42,0.19,17,22,0.773,101
629,TOR,2023-12-29,118,@,BOS,0,240,44,95,0.463,27,51,0.529,17,44,0.386,13,20,0.65,118,43,88,0.489,26,49,0.531,17,39,0.436,17,20,0.85,120
630,MIN,2023-12-28,118,,DAL,1,240,38,74,0.514,21,41,0.512,17,33,0.515,25,34,0.735,118,40,90,0.444,26,57,0.456,14,33,0.424,16,19,0.842,110
631,SAS,2023-12-28,118,@,POR,1,240,41,85,0.482,31,49,0.633,10,36,0.278,26,28,0.929,118,35,101,0.347,24,65,0.369,11,36,0.306,24,32,0.75,105
632,SAS,2023-12-26,118,,UTA,0,240,44,98,0.449,28,63,0.444,16,35,0.457,14,21,0.667,118,47,95,0.495,31,52,0.596,16,43,0.372,20,22,0.909,130
633,CHI,2023-12-26,118,,ATL,1,240,42,92,0.457,35,67,0.522,7,25,0.28,27,31,0.871,118,41,89,0.461,28,44,0.636,13,45,0.289,18,21,0.857,113
634,BRK,2023-12-26,118,@,DET,1,240,41,82,0.5,32,60,0.533,9,22,0.409,27,43,0.628,118,40,90,0.444,31,65,0.477,9,25,0.36,23,32,0.719,112
635,WAS,2023-12-22,118,@,GSW,0,240,44,97,0.454,33,62,0.532,11,35,0.314,19,24,0.792,118,47,97,0.485,29,52,0.558,18,45,0.4,17,20,0.85,129
636,MIL,2023-12-21,118,,ORL,1,240,38,90,0.422,27,53,0.509,11,37,0.297,31,35,0.886,118,45,99,0.455,37,66,0.561,8,33,0.242,16,23,0.696,114
637,MIN,2023-12-21,118,,LAL,1,240,42,87,0.483,28,51,0.549,14,36,0.389,20,25,0.8,118,41,83,0.494,31,59,0.525,10,24,0.417,19,24,0.792,111
638,WAS,2023-12-21,118,@,POR,1,240,42,84,0.5,30,54,0.556,12,30,0.4,22,32,0.688,118,43,95,0.453,29,65,0.446,14,30,0.467,17,23,0.739,117
639,GSW,2023-12-17,118,@,POR,1,240,46,87,0.529,33,49,0.673,13,38,0.342,13,19,0.684,118,40,85,0.471,27,50,0.54,13,35,0.371,21,23,0.913,114
640,MIA,2023-12-16,118,,CHI,1,240,43,83,0.518,30,48,0.625,13,35,0.371,19,25,0.76,118,37,77,0.481,21,39,0.538,16,38,0.421,26,29,0.897,116
641,OKC,2023-12-16,118,@,DEN,1,240,43,84,0.512,36,63,0.571,7,21,0.333,25,30,0.833,118,42,93,0.452,30,61,0.492,12,32,0.375,21,24,0.875,117
642,BRK,2023-12-11,118,@,SAC,0,240,42,88,0.477,28,59,0.475,14,29,0.483,20,21,0.952,118,48,94,0.511,23,49,0.469,25,45,0.556,10,14,0.714,131
643,UTA,2023-12-02,118,,POR,1,265,46,94,0.489,39,60,0.65,7,34,0.206,19,24,0.792,118,38,95,0.4,25,55,0.455,13,40,0.325,24,27,0.889,113
644,NOP,2023-12-02,118,@,CHI,0,240,41,82,0.5,33,57,0.579,8,25,0.32,28,35,0.8,118,48,88,0.545,31,48,0.646,17,40,0.425,11,15,0.733,124
645,NYK,2023-11-30,118,,DET,1,240,41,88,0.466,25,47,0.532,16,41,0.39,20,28,0.714,118,43,81,0.531,28,46,0.609,15,35,0.429,11,17,0.647,112
646,BRK,2023-11-26,118,,CHI,1,240,41,83,0.494,16,30,0.533,25,53,0.472,11,15,0.733,118,40,83,0.482,28,51,0.549,12,32,0.375,17,22,0.773,109
647,GSW,2023-11-24,118,,SAS,1,240,40,81,0.494,21,39,0.538,19,42,0.452,19,24,0.792,118,45,100,0.45,33,53,0.623,12,47,0.255,10,12,0.833,112
648,BOS,2023-11-20,118,@,CHO,0,265,42,97,0.433,26,47,0.553,16,50,0.32,18,28,0.643,118,46,104,0.442,33,65,0.508,13,39,0.333,16,17,0.941,121
649,MIA,2023-11-20,118,@,CHI,1,240,42,84,0.5,25,49,0.51,17,35,0.486,17,20,0.85,118,37,81,0.457,26,44,0.591,11,37,0.297,15,16,0.938,100
650,MIL,2023-11-13,118,,CHI,1,240,42,89,0.472,27,42,0.643,15,47,0.319,19,27,0.704,118,38,100,0.38,24,58,0.414,14,42,0.333,19,21,0.905,109
651,MIA,2023-11-12,118,@,SAS,1,240,39,89,0.438,27,58,0.466,12,31,0.387,28,30,0.933,118,42,91,0.462,23,47,0.489,19,44,0.432,10,12,0.833,113
652,CLE,2023-11-11,118,@,GSW,1,240,37,86,0.43,26,56,0.464,11,30,0.367,33,43,0.767,118,37,90,0.411,24,52,0.462,13,38,0.342,23,30,0.767,110
653,UTA,2023-11-08,118,@,IND,0,240,45,96,0.469,34,69,0.493,11,27,0.407,17,18,0.944,118,52,101,0.515,39,60,0.65,13,41,0.317,17,20,0.85,134
654,DET,2023-11-08,118,@,MIL,0,240,48,98,0.49,41,69,0.594,7,29,0.241,15,16,0.938,118,41,90,0.456,30,53,0.566,11,37,0.297,27,32,0.844,120
655,POR,2023-11-08,118,@,SAC,0,265,44,87,0.506,36,65,0.554,8,22,0.364,22,29,0.759,118,41,89,0.461,30,52,0.577,11,37,0.297,28,38,0.737,121
656,CHO,2023-11-05,118,@,DAL,0,240,49,99,0.495,41,69,0.594,8,30,0.267,12,21,0.571,118,43,91,0.473,29,49,0.592,14,42,0.333,24,32,0.75,124
657,LAC,2023-10-31,118,,ORL,1,240,44,89,0.494,30,58,0.517,14,31,0.452,16,23,0.696,118,38,81,0.469,31,51,0.608,7,30,0.233,19,33,0.576,102
658,DET,2023-10-28,118,,CHI,1,240,45,86,0.523,33,58,0.569,12,28,0.429,16,20,0.8,118,39,93,0.419,28,65,0.431,11,28,0.393,13,16,0.813,102
659,LAC,2023-10-27,118,@,UTA,0,240,41,77,0.532,27,42,0.643,14,35,0.4,22,28,0.786,118,42,96,0.438,26,55,0.473,16,41,0.39,20,22,0.909,120
660,MIL,2023-10-26,118,,PHI,1,240,41,81,0.506,30,51,0.588,11,30,0.367,25,36,0.694,118,41,80,0.513,25,45,0.556,16,35,0.457,19,28,0.679,117
661,ATL,2024-02-07,117,@,BOS,0,240,43,102,0.422,30,61,0.492,13,41,0.317,18,20,0.9,117,49,93,0.527,32,44,0.727,17,49,0.347,10,11,0.909,125
662,NOP,2024-02-07,117,@,LAC,1,240,47,88,0.534,35,56,0.625,12,32,0.375,11,16,0.688,117,36,78,0.462,24,46,0.522,12,32,0.375,22,26,0.846,106
663,CHO,2024-02-07,117,,TOR,0,240,44,90,0.489,28,51,0.549,16,39,0.41,13,20,0.65,117,43,81,0.531,26,48,0.542,17,33,0.515,20,24,0.833,123
664,OKC,2024-02-06,117,@,UTA,0,240,43,90,0.478,24,53,0.453,19,37,0.514,12,18,0.667,117,46,89,0.517,32,54,0.593,14,35,0.4,18,20,0.9,124
665,CLE,2024-02-03,117,@,SAS,1,240,46,97,0.474,33,53,0.623,13,44,0.295,12,13,0.923,117,36,98,0.367,24,58,0.414,12,40,0.3,17,21,0.81,101
666,DAL,2024-02-03,117,,MIL,0,240,40,81,0.494,24,42,0.571,16,39,0.41,21,23,0.913,117,50,88,0.568,38,58,0.655,12,30,0.4,17,25,0.68,129
667,CHI,2024-01-31,117,@,CHO,1,240,45,87,0.517,34,58,0.586,11,29,0.379,16,22,0.727,117,40,90,0.444,24,44,0.545,16,46,0.348,14,17,0.824,110
668,NOP,2024-01-27,117,@,MIL,0,240,40,85,0.471,31,62,0.5,9,23,0.391,28,36,0.778,117,51,91,0.56,31,46,0.674,20,45,0.444,19,25,0.76,141
669,PHO,2024-01-21,117,,IND,1,240,47,82,0.573,39,57,0.684,8,25,0.32,15,18,0.833,117,41,94,0.436,27,63,0.429,14,31,0.452,14,23,0.609,110
670,DET,2024-01-17,117,,MIN,0,240,46,89,0.517,34,58,0.586,12,31,0.387,13,19,0.684,117,47,93,0.505,32,63,0.508,15,30,0.5,15,21,0.714,124
671,BOS,2024-01-17,117,,SAS,1,240,42,90,0.467,24,52,0.462,18,38,0.474,15,19,0.789,117,39,93,0.419,32,59,0.542,7,34,0.206,13,16,0.813,98
672,OKC,2024-01-16,117,@,LAC,0,240,42,83,0.506,26,49,0.531,16,34,0.471,17,20,0.85,117,47,87,0.54,27,44,0.614,20,43,0.465,14,23,0.609,128
673,SAC,2024-01-16,117,@,PHO,0,240,46,92,0.5,28,52,0.538,18,40,0.45,7,12,0.583,117,42,85,0.494,25,48,0.521,17,37,0.459,18,20,0.9,119
674,WAS,2024-01-15,117,,DET,0,240,44,95,0.463,25,54,0.463,19,41,0.463,10,11,0.909,117,50,90,0.556,38,59,0.644,12,31,0.387,17,23,0.739,129
675,DEN,2024-01-14,117,,IND,1,240,46,71,0.648,36,51,0.706,10,20,0.5,15,23,0.652,117,43,92,0.467,35,63,0.556,8,29,0.276,15,22,0.682,109
676,ORL,2024-01-07,117,,ATL,1,265,43,98,0.439,26,57,0.456,17,41,0.415,14,22,0.636,117,42,91,0.462,33,61,0.541,9,30,0.3,17,29,0.586,110
677,CLE,2024-01-07,117,,SAS,1,240,43,88,0.489,27,45,0.6,16,43,0.372,15,21,0.714,117,41,86,0.477,27,49,0.551,14,37,0.378,19,22,0.864,115
678,NOP,2024-01-03,117,@,MIN,1,240,45,81,0.556,33,55,0.6,12,26,0.462,15,17,0.882,117,37,82,0.451,27,51,0.529,10,31,0.323,22,27,0.815,106
679,UTA,2023-12-30,117,,MIA,1,240,43,93,0.462,32,52,0.615,11,41,0.268,20,28,0.714,117,34,78,0.436,25,47,0.532,9,31,0.29,32,40,0.8,109
680,SAC,2023-12-29,117,@,ATL,1,240,46,89,0.517,29,44,0.659,17,45,0.378,8,15,0.533,117,37,94,0.394,22,51,0.431,15,43,0.349,21,25,0.84,110
681,ORL,2023-12-29,117,,NYK,1,240,40,89,0.449,33,56,0.589,7,33,0.212,30,40,0.75,117,38,86,0.442,32,56,0.571,6,30,0.2,26,29,0.897,108
682,LAC,2023-12-29,117,,MEM,1,240,43,87,0.494,32,48,0.667,11,39,0.282,20,25,0.8,117,38,87,0.437,25,47,0.532,13,40,0.325,17,20,0.85,106
683,HOU,2023-12-26,117,,IND,0,240,47,97,0.485,42,73,0.575,5,24,0.208,18,22,0.818,117,43,82,0.524,24,39,0.615,19,43,0.442,18,21,0.857,123
684,ORL,2023-12-23,117,@,IND,1,240,39,73,0.534,33,55,0.6,6,18,0.333,33,41,0.805,117,43,82,0.524,28,48,0.583,15,34,0.441,9,13,0.692,110
685,BRK,2023-12-22,117,,DEN,0,240,43,89,0.483,30,56,0.536,13,33,0.394,18,26,0.692,117,45,87,0.517,34,61,0.557,11,26,0.423,21,25,0.84,122
686,POR,2023-12-21,117,,WAS,0,240,43,95,0.453,29,65,0.446,14,30,0.467,17,23,0.739,117,42,84,0.5,30,54,0.556,12,30,0.4,22,32,0.688,118
687,DEN,2023-12-16,117,,OKC,0,240,42,93,0.452,30,61,0.492,12,32,0.375,21,24,0.875,117,43,84,0.512,36,63,0.571,7,21,0.333,25,30,0.833,118
688,UTA,2023-12-13,117,,NYK,1,240,43,98,0.439,27,56,0.482,16,42,0.381,15,21,0.714,117,41,94,0.436,32,55,0.582,9,39,0.231,22,32,0.688,113
689,HOU,2023-12-13,117,,MEM,1,240,39,86,0.453,27,54,0.5,12,32,0.375,27,37,0.73,117,35,82,0.427,25,44,0.568,10,38,0.263,24,34,0.706,104
690,LAC,2023-12-08,117,@,UTA,1,240,43,88,0.489,28,54,0.519,15,34,0.441,16,21,0.762,117,38,84,0.452,29,53,0.547,9,31,0.29,18,24,0.75,103
691,SAC,2023-12-04,117,,NOP,0,240,38,85,0.447,24,44,0.545,14,41,0.341,27,33,0.818,117,47,87,0.54,33,56,0.589,14,31,0.452,19,23,0.826,127
692,CHO,2023-12-02,117,,MIN,0,240,44,91,0.484,32,66,0.485,12,25,0.48,17,19,0.895,117,43,84,0.512,32,53,0.604,11,31,0.355,26,30,0.867,123
693,DEN,2023-12-02,117,@,SAC,0,240,49,99,0.495,43,74,0.581,6,25,0.24,13,20,0.65,117,48,99,0.485,32,65,0.492,16,34,0.471,11,15,0.733,123
694,SAC,2023-11-29,117,,LAC,0,240,40,86,0.465,27,45,0.6,13,41,0.317,24,28,0.857,117,50,93,0.538,36,65,0.554,14,28,0.5,17,22,0.773,131
695,CHO,2023-11-26,117,@,ORL,0,240,44,83,0.53,31,53,0.585,13,30,0.433,16,25,0.64,117,47,87,0.54,37,60,0.617,10,27,0.37,26,33,0.788,130
696,CHO,2023-11-22,117,,WAS,1,240,43,91,0.473,27,54,0.5,16,37,0.432,15,21,0.714,117,44,97,0.454,33,65,0.508,11,32,0.344,15,18,0.833,114
697,NOP,2023-11-22,117,,SAC,1,240,41,87,0.471,34,57,0.596,7,30,0.233,28,37,0.757,117,34,76,0.447,19,32,0.594,15,44,0.341,29,35,0.829,112
698,MIN,2023-11-20,117,,NYK,1,240,41,80,0.513,30,46,0.652,11,34,0.324,24,32,0.75,117,32,92,0.348,23,54,0.426,9,38,0.237,27,34,0.794,100
699,BOS,2023-11-15,117,@,PHI,1,240,42,88,0.477,24,38,0.632,18,50,0.36,15,19,0.789,117,39,85,0.459,28,55,0.509,11,30,0.367,18,22,0.818,107
700,WAS,2023-11-15,117,,DAL,0,240,43,89,0.483,31,53,0.585,12,36,0.333,19,23,0.826,117,48,92,0.522,31,50,0.62,17,42,0.405,17,29,0.586,130
701,BOS,2023-11-11,117,,TOR,1,240,47,86,0.547,32,42,0.762,15,44,0.341,8,13,0.615,117,35,91,0.385,25,54,0.463,10,37,0.27,14,16,0.875,94
702,MIA,2023-11-11,117,@,ATL,1,240,41,84,0.488,29,46,0.63,12,38,0.316,23,25,0.92,117,38,87,0.437,20,41,0.488,18,46,0.391,15,18,0.833,109
703,WAS,2023-11-10,117,,CHO,0,240,43,88,0.489,29,50,0.58,14,38,0.368,17,20,0.85,117,50,110,0.455,44,82,0.537,6,28,0.214,18,28,0.643,124
704,MIN,2023-11-10,117,@,SAS,1,240,43,87,0.494,33,60,0.55,10,27,0.37,21,27,0.778,117,43,92,0.467,31,58,0.534,12,34,0.353,12,19,0.632,110
705,DAL,2023-11-06,117,@,ORL,1,240,41,82,0.5,26,42,0.619,15,40,0.375,20,28,0.714,117,40,85,0.471,32,58,0.552,8,27,0.296,14,18,0.778,102
706,ATL,2023-11-06,117,@,OKC,0,240,38,102,0.373,24,60,0.4,14,42,0.333,27,32,0.844,117,45,94,0.479,31,59,0.525,14,35,0.4,22,23,0.957,126
707,PHI,2023-10-26,117,@,MIL,0,240,41,80,0.513,25,45,0.556,16,35,0.457,19,28,0.679,117,41,81,0.506,30,51,0.588,11,30,0.367,25,36,0.694,118
708,MIA,2024-02-07,116,,SAS,1,240,43,87,0.494,31,49,0.633,12,38,0.316,18,23,0.783,116,41,90,0.456,29,53,0.547,12,37,0.324,10,17,0.588,104
709,MIL,2024-01-31,116,@,POR,0,240,45,92,0.489,32,47,0.681,13,45,0.289,13,18,0.722,116,49,92,0.533,37,64,0.578,12,28,0.429,9,9,1.0,119
710,IND,2024-01-28,116,,MEM,1,240,44,90,0.489,31,55,0.564,13,35,0.371,15,16,0.938,116,38,82,0.463,27,52,0.519,11,30,0.367,23,31,0.742,110
711,SAS,2024-01-26,116,,POR,1,240,42,92,0.457,32,58,0.552,10,34,0.294,22,26,0.846,116,38,90,0.422,28,53,0.528,10,37,0.27,14,19,0.737,100
712,CLE,2024-01-24,116,@,MIL,0,240,46,91,0.505,33,53,0.623,13,38,0.342,11,15,0.733,116,45,90,0.5,34,61,0.557,11,29,0.379,25,28,0.893,126
713,LAL,2024-01-23,116,@,LAC,0,240,45,92,0.489,34,60,0.567,11,32,0.344,15,22,0.682,116,52,88,0.591,38,61,0.623,14,27,0.519,9,12,0.75,127
714,BOS,2024-01-21,116,@,HOU,1,240,43,98,0.439,26,51,0.51,17,47,0.362,13,18,0.722,116,41,94,0.436,31,59,0.525,10,35,0.286,15,22,0.682,107
715,CLE,2024-01-20,116,@,ATL,1,240,43,85,0.506,27,42,0.643,16,43,0.372,14,16,0.875,116,37,93,0.398,26,55,0.473,11,38,0.289,10,15,0.667,95
716,CHI,2024-01-18,116,@,TOR,1,240,48,91,0.527,42,67,0.627,6,24,0.25,14,17,0.824,116,42,83,0.506,32,45,0.711,10,38,0.263,16,20,0.8,110
717,MEM,2024-01-15,116,,GSW,1,240,32,86,0.372,12,32,0.375,20,54,0.37,32,40,0.8,116,44,90,0.489,34,59,0.576,10,31,0.323,9,10,0.9,107
718,POR,2024-01-14,116,,PHO,0,240,40,89,0.449,20,47,0.426,20,42,0.476,16,22,0.727,116,46,76,0.605,33,48,0.688,13,28,0.464,22,27,0.815,127
719,SAS,2024-01-13,116,,CHI,0,240,39,95,0.411,21,49,0.429,18,46,0.391,20,23,0.87,116,46,90,0.511,31,56,0.554,15,34,0.441,15,20,0.75,122
720,MIN,2024-01-12,116,,POR,1,240,44,80,0.55,33,49,0.673,11,31,0.355,17,24,0.708,116,30,77,0.39,20,49,0.408,10,28,0.357,23,34,0.676,93
721,MIL,2024-01-08,116,,UTA,0,240,42,94,0.447,25,58,0.431,17,36,0.472,15,19,0.789,116,47,90,0.522,27,46,0.587,20,44,0.455,18,22,0.818,132
722,ATL,2024-01-05,116,@,IND,0,240,40,93,0.43,30,51,0.588,10,42,0.238,26,30,0.867,116,60,94,0.638,41,55,0.745,19,39,0.487,11,13,0.846,150
723,TOR,2024-01-03,116,@,MEM,1,240,41,85,0.482,29,59,0.492,12,26,0.462,22,27,0.815,116,40,94,0.426,25,52,0.481,15,42,0.357,16,19,0.842,111
724,NYK,2024-01-03,116,,CHI,1,240,46,89,0.517,31,51,0.608,15,38,0.395,9,11,0.818,116,37,89,0.416,24,57,0.421,13,32,0.406,13,16,0.813,100
725,MEM,2023-12-26,116,@,NOP,1,265,39,90,0.433,28,44,0.636,11,46,0.239,27,32,0.844,116,42,97,0.433,32,66,0.485,10,31,0.323,21,33,0.636,115
726,MEM,2023-12-21,116,,IND,1,240,43,84,0.512,27,49,0.551,16,35,0.457,14,21,0.667,116,38,90,0.422,20,38,0.526,18,52,0.346,9,11,0.818,103
727,UTA,2023-12-20,116,@,CLE,0,240,40,78,0.513,27,48,0.563,13,30,0.433,23,28,0.821,116,45,96,0.469,22,45,0.489,23,51,0.451,11,16,0.688,124
728,OKC,2023-12-18,116,,MEM,1,240,42,92,0.457,31,56,0.554,11,36,0.306,21,23,0.913,116,30,85,0.353,11,31,0.355,19,54,0.352,18,21,0.857,97
729,CHI,2023-12-16,116,@,MIA,0,240,37,77,0.481,21,39,0.538,16,38,0.421,26,29,0.897,116,43,83,0.518,30,48,0.625,13,35,0.371,19,25,0.76,118
730,BOS,2023-12-14,116,,CLE,1,240,43,85,0.506,30,49,0.612,13,36,0.361,17,20,0.85,116,40,83,0.482,29,50,0.58,11,33,0.333,16,17,0.941,107
731,MIA,2023-12-14,116,,CHI,0,240,37,80,0.463,22,46,0.478,15,34,0.441,27,35,0.771,116,45,93,0.484,31,57,0.544,14,36,0.389,20,30,0.667,124
732,BRK,2023-12-13,116,@,PHO,1,240,41,89,0.461,26,48,0.542,15,41,0.366,19,24,0.792,116,40,84,0.476,31,56,0.554,9,28,0.321,23,27,0.852,112
733,GSW,2023-12-12,116,@,PHO,0,240,41,92,0.446,25,46,0.543,16,46,0.348,18,27,0.667,116,38,84,0.452,24,45,0.533,14,39,0.359,29,34,0.853,119
734,MIA,2023-12-11,116,@,CHO,1,240,37,77,0.481,22,42,0.524,15,35,0.429,27,34,0.794,116,40,84,0.476,23,43,0.535,17,41,0.415,17,22,0.773,114
735,TOR,2023-12-08,116,@,CHO,0,240,47,93,0.505,41,61,0.672,6,32,0.188,16,21,0.762,116,44,79,0.557,31,54,0.574,13,25,0.52,18,20,0.9,119
736,MEM,2023-12-06,116,@,DET,1,240,47,91,0.516,36,65,0.554,11,26,0.423,11,14,0.786,116,41,91,0.451,30,56,0.536,11,35,0.314,9,9,1.0,102
737,PHO,2023-12-02,116,,MEM,1,240,36,83,0.434,27,57,0.474,9,26,0.346,35,43,0.814,116,39,86,0.453,30,55,0.545,9,31,0.29,22,24,0.917,109
738,PHO,2023-11-26,116,@,NYK,1,240,42,91,0.462,26,53,0.491,16,38,0.421,16,21,0.762,116,39,86,0.453,27,57,0.474,12,29,0.414,23,32,0.719,113
739,NOP,2023-11-24,116,@,LAC,1,240,43,88,0.489,33,64,0.516,10,24,0.417,20,27,0.741,116,42,92,0.457,31,55,0.564,11,37,0.297,11,17,0.647,106
740,OKC,2023-11-22,116,,CHI,1,240,37,75,0.493,26,46,0.565,11,29,0.379,31,38,0.816,116,34,88,0.386,17,44,0.386,17,44,0.386,17,17,1.0,102
741,MIL,2023-11-22,116,@,BOS,0,240,45,101,0.446,32,67,0.478,13,34,0.382,13,17,0.765,116,44,84,0.524,27,42,0.643,17,42,0.405,14,17,0.824,119
742,HOU,2023-11-20,116,@,GSW,0,240,44,95,0.463,31,54,0.574,13,41,0.317,15,19,0.789,116,36,77,0.468,15,34,0.441,21,43,0.488,28,33,0.848,121
743,IND,2023-11-19,116,,ORL,0,240,42,95,0.442,34,64,0.531,8,31,0.258,24,31,0.774,116,43,87,0.494,36,67,0.537,7,20,0.35,35,42,0.833,128
744,ATL,2023-11-17,116,,PHI,0,240,40,89,0.449,28,56,0.5,12,33,0.364,24,30,0.8,116,43,88,0.489,30,58,0.517,13,30,0.433,27,28,0.964,126
745,NYK,2023-11-15,116,@,ATL,1,240,45,94,0.479,29,60,0.483,16,34,0.471,10,11,0.909,116,41,75,0.547,29,44,0.659,12,31,0.387,20,26,0.769,114
746,MIN,2023-11-12,116,@,GSW,1,240,43,82,0.524,34,55,0.618,9,27,0.333,21,30,0.7,116,37,96,0.385,25,53,0.472,12,43,0.279,24,28,0.857,110
747,LAL,2023-11-12,116,,POR,1,240,41,84,0.488,37,65,0.569,4,19,0.211,30,37,0.811,116,45,90,0.5,32,53,0.604,13,37,0.351,7,9,0.778,110
748,DAL,2023-11-08,116,,TOR,0,240,40,84,0.476,23,43,0.535,17,41,0.415,19,31,0.613,116,49,99,0.495,38,63,0.603,11,36,0.306,18,27,0.667,127
749,PHO,2023-11-08,116,@,CHI,1,265,38,90,0.422,19,42,0.452,19,48,0.396,21,25,0.84,116,42,96,0.438,28,63,0.444,14,33,0.424,17,23,0.739,115
750,CHO,2023-11-08,116,,WAS,0,240,41,79,0.519,33,54,0.611,8,25,0.32,26,35,0.743,116,47,97,0.485,29,54,0.537,18,43,0.419,20,25,0.8,132
751,NOP,2023-11-06,116,@,DEN,0,240,45,90,0.5,32,60,0.533,13,30,0.433,13,15,0.867,116,51,95,0.537,36,56,0.643,15,39,0.385,17,23,0.739,134
752,SAS,2023-11-05,116,,TOR,0,265,48,96,0.5,38,64,0.594,10,32,0.313,10,13,0.769,116,44,97,0.454,25,49,0.51,19,48,0.396,16,26,0.615,123
753,CLE,2023-11-03,116,@,IND,0,240,44,84,0.524,36,56,0.643,8,28,0.286,20,25,0.8,116,45,86,0.523,30,55,0.545,15,31,0.484,16,24,0.667,121
754,DET,2023-11-02,116,@,NOP,0,240,41,94,0.436,28,56,0.5,13,38,0.342,21,26,0.808,116,39,80,0.488,25,48,0.521,14,32,0.438,33,35,0.943,125
755,CHO,2023-10-25,116,,ATL,1,240,43,86,0.5,32,49,0.653,11,37,0.297,19,26,0.731,116,39,93,0.419,34,64,0.531,5,29,0.172,27,33,0.818,110
756,ORL,2023-10-25,116,,HOU,1,240,42,87,0.483,33,53,0.623,9,34,0.265,23,26,0.885,116,32,79,0.405,20,45,0.444,12,34,0.353,10,16,0.625,86
757,IND,2024-02-04,115,@,CHO,1,240,45,92,0.489,34,59,0.576,11,33,0.333,14,18,0.778,115,35,88,0.398,27,59,0.458,8,29,0.276,21,25,0.84,99
758,CHI,2024-02-03,115,,SAC,0,240,42,91,0.462,31,57,0.544,11,34,0.324,20,22,0.909,115,42,84,0.5,27,45,0.6,15,39,0.385,24,29,0.828,123
759,MIA,2024-01-31,115,,SAC,1,240,42,84,0.5,29,56,0.518,13,28,0.464,18,23,0.783,115,41,93,0.441,29,53,0.547,12,40,0.3,12,18,0.667,106
760,DAL,2024-01-27,115,,SAC,0,240,43,98,0.439,27,52,0.519,16,46,0.348,13,18,0.722,115,43,80,0.538,32,50,0.64,11,30,0.367,23,30,0.767,120
761,LAC,2024-01-27,115,@,BOS,1,240,45,102,0.441,35,62,0.565,10,40,0.25,15,18,0.833,115,36,100,0.36,26,60,0.433,10,40,0.25,14,16,0.875,96
762,PHO,2024-01-22,115,,CHI,1,240,44,85,0.518,30,51,0.588,14,34,0.412,13,17,0.765,115,45,93,0.484,31,56,0.554,14,37,0.378,9,14,0.643,113
763,IND,2024-01-19,115,@,POR,0,240,39,91,0.429,19,44,0.432,20,47,0.426,17,25,0.68,115,42,84,0.5,38,72,0.528,4,12,0.333,30,35,0.857,118
764,HOU,2024-01-15,115,@,PHI,0,240,44,88,0.5,36,61,0.59,8,27,0.296,19,32,0.594,115,40,83,0.482,25,52,0.481,15,31,0.484,29,34,0.853,124
765,DAL,2024-01-07,115,,MIN,1,240,43,95,0.453,28,55,0.509,15,40,0.375,14,20,0.7,115,41,94,0.436,28,53,0.528,13,41,0.317,13,21,0.619,108
766,PHO,2024-01-07,115,,MEM,0,240,46,102,0.451,38,74,0.514,8,28,0.286,15,22,0.682,115,43,97,0.443,26,48,0.542,17,49,0.347,18,24,0.75,121
767,SAS,2024-01-07,115,@,CLE,0,240,41,86,0.477,27,49,0.551,14,37,0.378,19,22,0.864,115,43,88,0.489,27,45,0.6,16,43,0.372,15,21,0.714,117
768,OKC,2024-01-05,115,@,BRK,0,240,45,84,0.536,36,53,0.679,9,31,0.29,16,24,0.667,115,41,91,0.451,27,52,0.519,14,39,0.359,28,33,0.848,124
769,ORL,2024-01-02,115,@,GSW,0,240,41,92,0.446,27,56,0.482,14,36,0.389,19,23,0.826,115,42,78,0.538,29,43,0.674,13,35,0.371,24,37,0.649,121
770,NOP,2023-12-26,115,,MEM,0,265,42,97,0.433,32,66,0.485,10,31,0.323,21,33,0.636,115,39,90,0.433,28,44,0.636,11,46,0.239,27,32,0.844,116
771,LAL,2023-12-25,115,,BOS,0,240,43,90,0.478,30,58,0.517,13,32,0.406,16,21,0.762,115,46,91,0.505,33,49,0.673,13,42,0.31,21,28,0.75,126
772,DET,2023-12-23,115,@,BRK,0,240,39,79,0.494,24,44,0.545,15,35,0.429,22,29,0.759,115,45,86,0.523,35,62,0.565,10,24,0.417,26,32,0.813,126
773,LAC,2023-12-21,115,@,OKC,0,240,44,93,0.473,27,50,0.54,17,43,0.395,10,12,0.833,115,51,87,0.586,35,53,0.66,16,34,0.471,16,18,0.889,134
774,MIA,2023-12-20,115,@,ORL,1,240,40,83,0.482,25,54,0.463,15,29,0.517,20,24,0.833,115,41,89,0.461,32,53,0.604,9,36,0.25,15,19,0.789,106
775,MEM,2023-12-19,115,@,NOP,1,240,41,82,0.5,31,51,0.608,10,31,0.323,23,29,0.793,115,40,85,0.471,29,60,0.483,11,25,0.44,22,24,0.917,113
776,LAL,2023-12-15,115,@,SAS,0,240,43,89,0.483,32,53,0.604,11,36,0.306,18,28,0.643,115,47,95,0.495,29,53,0.547,18,42,0.429,17,19,0.895,129
777,MIA,2023-12-13,115,,CHO,1,240,41,86,0.477,26,56,0.464,15,30,0.5,18,19,0.947,115,41,77,0.532,29,46,0.63,12,31,0.387,10,11,0.909,104
778,NYK,2023-11-28,115,,CHO,1,240,41,88,0.466,26,50,0.52,15,38,0.395,18,20,0.9,115,37,89,0.416,24,58,0.414,13,31,0.419,4,7,0.571,91
779,HOU,2023-11-28,115,@,DAL,0,240,42,85,0.494,34,56,0.607,8,29,0.276,23,29,0.793,115,42,89,0.472,30,55,0.545,12,34,0.353,25,29,0.862,121
780,BRK,2023-11-28,115,,TOR,1,240,40,89,0.449,27,51,0.529,13,38,0.342,22,26,0.846,115,39,101,0.386,26,65,0.4,13,36,0.361,12,19,0.632,103
781,CLE,2023-11-25,115,,LAL,0,240,43,91,0.473,34,63,0.54,9,28,0.321,20,23,0.87,115,47,90,0.522,38,63,0.603,9,27,0.333,18,21,0.857,121
782,GSW,2023-11-22,115,@,PHO,0,240,43,90,0.478,33,58,0.569,10,32,0.313,19,29,0.655,115,34,76,0.447,23,48,0.479,11,28,0.393,44,52,0.846,123
783,NOP,2023-11-17,115,,DEN,1,240,46,88,0.523,34,65,0.523,12,23,0.522,11,21,0.524,115,47,96,0.49,37,56,0.661,10,40,0.25,6,12,0.5,110
784,BRK,2023-11-16,115,@,MIA,0,240,40,85,0.471,26,49,0.531,14,36,0.389,21,27,0.778,115,42,81,0.519,27,46,0.587,15,35,0.429,23,24,0.958,122
785,MIN,2023-11-15,115,@,PHO,0,240,42,92,0.457,37,65,0.569,5,27,0.185,26,28,0.929,115,51,85,0.6,34,54,0.63,17,31,0.548,14,15,0.933,133
786,UTA,2023-11-14,115,,POR,1,240,44,95,0.463,31,52,0.596,13,43,0.302,14,15,0.933,115,37,88,0.42,26,53,0.491,11,35,0.314,14,20,0.7,99
787,CHI,2023-11-08,115,,PHO,0,265,42,96,0.438,28,63,0.444,14,33,0.424,17,23,0.739,115,38,90,0.422,19,42,0.452,19,48,0.396,21,25,0.84,116
788,CLE,2023-11-05,115,,GSW,1,240,41,83,0.494,30,46,0.652,11,37,0.297,22,28,0.786,115,34,94,0.362,18,53,0.34,16,41,0.39,20,30,0.667,104
789,POR,2023-11-03,115,,MEM,1,265,39,96,0.406,30,64,0.469,9,32,0.281,28,36,0.778,115,47,96,0.49,37,61,0.607,10,35,0.286,9,13,0.692,113
790,ORL,2023-11-02,115,@,UTA,1,240,39,85,0.459,29,56,0.518,10,29,0.345,27,36,0.75,115,41,89,0.461,29,56,0.518,12,33,0.364,19,26,0.731,113
791,SAS,2023-10-31,115,@,PHO,1,240,43,92,0.467,29,55,0.527,14,37,0.378,15,20,0.75,115,42,83,0.506,24,44,0.545,18,39,0.462,12,15,0.8,114
792,CLE,2024-02-07,114,@,WAS,1,240,43,88,0.489,31,53,0.585,12,35,0.343,16,22,0.727,114,42,94,0.447,26,54,0.481,16,40,0.4,6,9,0.667,106
793,PHO,2024-02-06,114,,MIL,1,240,44,87,0.506,36,59,0.61,8,28,0.286,18,27,0.667,114,39,90,0.433,26,50,0.52,13,40,0.325,15,25,0.6,106
794,NOP,2024-02-02,114,@,SAS,1,240,46,95,0.484,39,69,0.565,7,26,0.269,15,21,0.714,114,46,96,0.479,36,57,0.632,10,39,0.256,11,18,0.611,113
795,LAL,2024-02-01,114,@,BOS,1,240,38,94,0.404,19,58,0.328,19,36,0.528,19,26,0.731,114,41,97,0.423,25,49,0.51,16,48,0.333,7,7,1.0,105
796,UTA,2024-01-29,114,@,BRK,0,240,39,86,0.453,30,59,0.508,9,27,0.333,27,34,0.794,114,54,105,0.514,33,60,0.55,21,45,0.467,18,19,0.947,147
797,SAS,2024-01-24,114,,OKC,0,240,43,86,0.5,34,54,0.63,9,32,0.281,19,25,0.76,114,54,96,0.563,36,56,0.643,18,40,0.45,14,16,0.875,140
798,DEN,2024-01-23,114,@,IND,1,240,44,88,0.5,33,55,0.6,11,33,0.333,15,17,0.882,114,43,87,0.494,38,66,0.576,5,21,0.238,18,21,0.857,109
799,BRK,2024-01-21,114,@,LAC,0,240,44,90,0.489,30,51,0.588,14,39,0.359,12,16,0.75,114,42,83,0.506,29,57,0.509,13,26,0.5,28,33,0.848,125
800,DET,2024-01-07,114,@,DEN,0,240,42,89,0.472,33,65,0.508,9,24,0.375,21,30,0.7,114,47,80,0.588,37,53,0.698,10,27,0.37,27,31,0.871,131
801,CLE,2024-01-05,114,,WAS,1,240,41,77,0.532,25,44,0.568,16,33,0.485,16,23,0.696,114,35,84,0.417,26,54,0.481,9,30,0.3,11,15,0.733,90
802,MIA,2023-12-28,114,@,GSW,1,240,44,91,0.484,34,60,0.567,10,31,0.323,16,22,0.727,114,37,88,0.42,29,55,0.527,8,33,0.242,20,25,0.8,102
803,GSW,2023-12-25,114,@,DEN,0,240,40,87,0.46,26,47,0.553,14,40,0.35,20,23,0.87,114,40,82,0.488,26,48,0.542,14,34,0.412,26,32,0.813,120
804,PHO,2023-12-25,114,,DAL,0,240,40,90,0.444,26,49,0.531,14,41,0.341,20,25,0.8,114,45,84,0.536,29,40,0.725,16,44,0.364,22,30,0.733,128
805,CHI,2023-12-21,114,,SAS,1,240,49,90,0.544,42,62,0.677,7,28,0.25,9,11,0.818,114,37,81,0.457,27,51,0.529,10,30,0.333,11,16,0.688,95
806,ORL,2023-12-21,114,@,MIL,0,240,45,99,0.455,37,66,0.561,8,33,0.242,16,23,0.696,114,38,90,0.422,27,53,0.509,11,37,0.297,31,35,0.886,118
807,TOR,2023-12-18,114,,CHO,1,240,44,86,0.512,36,57,0.632,8,29,0.276,18,22,0.818,114,39,89,0.438,31,57,0.544,8,32,0.25,13,13,1.0,99
808,NYK,2023-12-18,114,@,LAL,1,240,42,88,0.477,32,58,0.552,10,30,0.333,20,23,0.87,114,42,99,0.424,29,58,0.5,13,41,0.317,12,13,0.923,109
809,BOS,2023-12-17,114,,ORL,1,240,45,95,0.474,28,59,0.475,17,36,0.472,7,8,0.875,114,34,89,0.382,23,53,0.434,11,36,0.306,18,24,0.75,97
810,POR,2023-12-17,114,,GSW,0,240,40,85,0.471,27,50,0.54,13,35,0.371,21,23,0.913,114,46,87,0.529,33,49,0.673,13,38,0.342,13,19,0.684,118
811,DET,2023-12-16,114,@,MIL,0,240,43,96,0.448,37,68,0.544,6,28,0.214,22,26,0.846,114,50,88,0.568,31,46,0.674,19,42,0.452,27,32,0.844,146
812,POR,2023-12-14,114,,UTA,0,240,43,103,0.417,27,58,0.466,16,45,0.356,12,18,0.667,114,49,92,0.533,38,59,0.644,11,33,0.333,13,14,0.929,122
813,DEN,2023-12-12,114,@,CHI,1,240,39,83,0.47,25,53,0.472,14,30,0.467,22,32,0.688,114,36,86,0.419,23,46,0.5,13,40,0.325,21,23,0.913,106
814,CHO,2023-12-11,114,,MIA,0,240,40,84,0.476,23,43,0.535,17,41,0.415,17,22,0.773,114,37,77,0.481,22,42,0.524,15,35,0.429,27,34,0.794,116
815,ATL,2023-12-08,114,@,PHI,0,240,41,104,0.394,28,65,0.431,13,39,0.333,19,21,0.905,114,42,87,0.483,31,57,0.544,11,30,0.367,30,37,0.811,125
816,HOU,2023-12-08,114,@,DEN,1,240,35,82,0.427,22,43,0.512,13,39,0.333,31,42,0.738,114,38,90,0.422,28,62,0.452,10,28,0.357,20,27,0.741,106
817,SAC,2023-12-08,114,@,PHO,1,240,42,92,0.457,28,53,0.528,14,39,0.359,16,20,0.8,114,40,83,0.482,29,51,0.569,11,32,0.344,15,23,0.652,106
818,BRK,2023-12-06,114,@,ATL,1,240,43,94,0.457,32,67,0.478,11,27,0.407,17,24,0.708,114,42,94,0.447,30,59,0.508,12,35,0.343,17,18,0.944,113
819,LAC,2023-11-30,114,@,GSW,0,240,42,95,0.442,30,63,0.476,12,32,0.375,18,24,0.75,114,41,82,0.5,26,43,0.605,15,39,0.385,23,31,0.742,120
820,PHI,2023-11-29,114,@,NOP,0,240,42,81,0.519,28,47,0.596,14,34,0.412,16,18,0.889,114,42,78,0.538,32,48,0.667,10,30,0.333,30,34,0.882,124
821,UTA,2023-11-27,114,,NOP,1,240,37,88,0.42,20,40,0.5,17,48,0.354,23,28,0.821,114,44,88,0.5,37,66,0.561,7,22,0.318,17,25,0.68,112
822,POR,2023-11-27,114,@,IND,1,240,40,85,0.471,31,67,0.463,9,18,0.5,25,31,0.806,114,42,88,0.477,34,55,0.618,8,33,0.242,18,24,0.75,110
823,WAS,2023-11-22,114,@,CHO,0,240,44,97,0.454,33,65,0.508,11,32,0.344,15,18,0.833,114,43,91,0.473,27,54,0.5,16,37,0.432,15,21,0.714,117
824,ATL,2023-11-15,114,,NYK,0,240,41,75,0.547,29,44,0.659,12,31,0.387,20,26,0.769,114,45,94,0.479,29,60,0.483,16,34,0.471,10,11,0.909,116
825,BOS,2023-11-13,114,,NYK,1,240,40,79,0.506,21,36,0.583,19,43,0.442,15,16,0.938,114,33,79,0.418,18,44,0.409,15,35,0.429,17,24,0.708,98
826,PHI,2023-11-10,114,@,DET,1,240,35,83,0.422,26,55,0.473,9,28,0.321,35,41,0.854,114,40,86,0.465,32,58,0.552,8,28,0.286,18,22,0.818,106
827,MIN,2023-11-06,114,,BOS,1,265,44,85,0.518,31,48,0.646,13,37,0.351,13,25,0.52,114,36,92,0.391,25,53,0.472,11,39,0.282,26,34,0.765,109
828,BRK,2023-11-04,114,,BOS,0,240,43,100,0.43,26,48,0.542,17,52,0.327,11,17,0.647,114,43,90,0.478,28,45,0.622,15,45,0.333,23,27,0.852,124
829,DAL,2023-11-03,114,@,DEN,0,240,41,86,0.477,24,44,0.545,17,42,0.405,15,17,0.882,114,49,93,0.527,36,63,0.571,13,30,0.433,14,19,0.737,125
830,WAS,2023-11-03,114,@,MIA,0,240,46,81,0.568,33,53,0.623,13,28,0.464,9,17,0.529,114,48,80,0.6,35,53,0.66,13,27,0.481,12,14,0.857,121
831,PHI,2023-11-02,114,,TOR,1,240,42,92,0.457,33,67,0.493,9,25,0.36,21,25,0.84,114,38,79,0.481,28,51,0.549,10,28,0.357,13,19,0.684,99
832,DAL,2023-11-01,114,,CHI,1,240,37,81,0.457,17,33,0.515,20,48,0.417,20,28,0.714,114,42,89,0.472,31,56,0.554,11,33,0.333,10,11,0.909,105
833,PHO,2023-10-31,114,,SAS,0,240,42,83,0.506,24,44,0.545,18,39,0.462,12,15,0.8,114,43,92,0.467,29,55,0.527,14,37,0.378,15,20,0.75,115
834,MIA,2023-10-30,114,@,MIL,0,240,41,86,0.477,28,52,0.538,13,34,0.382,19,20,0.95,114,44,87,0.506,32,50,0.64,12,37,0.324,22,30,0.733,122
835,PHI,2023-10-28,114,@,TOR,1,240,43,86,0.5,33,58,0.569,10,28,0.357,18,21,0.857,114,38,87,0.437,21,55,0.382,17,32,0.531,14,19,0.737,107
836,SAC,2023-10-27,114,,GSW,0,240,41,94,0.436,29,54,0.537,12,40,0.3,20,29,0.69,114,48,87,0.552,34,55,0.618,14,32,0.438,12,14,0.857,122
837,CLE,2023-10-25,114,@,BRK,1,240,44,94,0.468,27,51,0.529,17,43,0.395,9,10,0.9,114,42,84,0.5,33,57,0.579,9,27,0.333,20,26,0.769,113
838,UTA,2023-10-25,114,,SAC,0,240,41,91,0.451,32,63,0.508,9,28,0.321,23,31,0.742,114,47,102,0.461,28,51,0.549,19,51,0.373,17,20,0.85,130
839,MEM,2024-02-06,113,@,NYK,0,240,41,80,0.513,20,43,0.465,21,37,0.568,10,16,0.625,113,48,86,0.558,37,59,0.627,11,27,0.407,16,20,0.8,123
840,LAL,2024-02-03,113,@,NYK,1,240,39,80,0.488,27,49,0.551,12,31,0.387,23,27,0.852,113,41,100,0.41,31,65,0.477,10,35,0.286,13,15,0.867,105
841,SAS,2024-02-02,113,,NOP,0,240,46,96,0.479,36,57,0.632,10,39,0.256,11,18,0.611,113,46,95,0.484,39,69,0.565,7,26,0.269,15,21,0.714,114
842,NYK,2024-01-29,113,@,CHO,1,240,44,84,0.524,32,47,0.681,12,37,0.324,13,16,0.813,113,37,81,0.457,26,49,0.531,11,32,0.344,7,14,0.5,92
843,DEN,2024-01-29,113,,MIL,1,240,44,91,0.484,40,73,0.548,4,18,0.222,21,24,0.875,113,36,84,0.429,20,44,0.455,16,40,0.4,19,25,0.76,107
844,SAS,2024-01-29,113,,WAS,0,240,43,92,0.467,31,62,0.5,12,30,0.4,15,17,0.882,113,46,86,0.535,37,61,0.607,9,25,0.36,17,24,0.708,118
845,ORL,2024-01-28,113,,PHO,1,240,41,92,0.446,29,56,0.518,12,36,0.333,19,26,0.731,113,41,73,0.562,37,59,0.627,4,14,0.286,12,21,0.571,98
846,SAS,2024-01-27,113,,MIN,1,240,46,84,0.548,33,54,0.611,13,30,0.433,8,15,0.533,113,45,79,0.57,31,53,0.585,14,26,0.538,8,15,0.533,112
847,DET,2024-01-24,113,,CHO,1,240,43,86,0.5,28,48,0.583,15,38,0.395,12,20,0.6,113,38,87,0.437,23,49,0.469,15,38,0.395,15,19,0.789,106
848,CHI,2024-01-22,113,@,PHO,0,240,45,93,0.484,31,56,0.554,14,37,0.378,9,14,0.643,113,44,85,0.518,30,51,0.588,14,34,0.412,13,17,0.765,115
849,DET,2024-01-22,113,,MIL,0,240,40,89,0.449,30,59,0.508,10,30,0.333,23,29,0.793,113,42,94,0.447,32,55,0.582,10,39,0.256,28,34,0.824,122
850,DEN,2024-01-21,113,@,WAS,1,240,43,88,0.489,35,66,0.53,8,22,0.364,19,28,0.679,113,39,91,0.429,31,64,0.484,8,27,0.296,18,22,0.818,104
851,NYK,2024-01-18,113,,WAS,1,240,39,86,0.453,26,48,0.542,13,38,0.342,22,26,0.846,113,41,90,0.456,31,59,0.525,10,31,0.323,17,22,0.773,109
852,HOU,2024-01-13,113,@,BOS,0,240,40,99,0.404,33,69,0.478,7,30,0.233,26,30,0.867,113,51,95,0.537,27,48,0.563,24,47,0.511,19,25,0.76,145
853,NOP,2024-01-12,113,@,DEN,0,240,42,89,0.472,29,56,0.518,13,33,0.394,16,22,0.727,113,50,90,0.556,36,57,0.632,14,33,0.424,11,15,0.733,125
854,TOR,2024-01-12,113,@,UTA,0,240,35,81,0.432,18,47,0.383,17,34,0.5,26,37,0.703,113,52,93,0.559,31,50,0.62,21,43,0.488,20,26,0.769,145
855,MIN,2024-01-09,113,@,ORL,1,240,43,80,0.538,31,50,0.62,12,30,0.4,15,19,0.789,113,34,94,0.362,21,52,0.404,13,42,0.31,11,18,0.611,92
856,HOU,2024-01-08,113,@,MIA,0,240,37,88,0.42,23,47,0.489,14,41,0.341,25,28,0.893,113,41,82,0.5,26,46,0.565,15,36,0.417,23,32,0.719,120
857,PHO,2024-01-05,113,,MIA,1,240,44,87,0.506,30,52,0.577,14,35,0.4,11,17,0.647,113,34,83,0.41,24,46,0.522,10,37,0.27,19,22,0.864,97
858,GSW,2024-01-05,113,,DET,1,240,38,82,0.463,22,44,0.5,16,38,0.421,21,25,0.84,113,44,98,0.449,31,54,0.574,13,44,0.295,8,10,0.8,109
859,LAL,2024-01-05,113,,MEM,0,240,42,85,0.494,32,57,0.561,10,28,0.357,19,27,0.704,113,44,82,0.537,21,37,0.568,23,45,0.511,16,20,0.8,127
860,MIL,2024-01-01,113,,IND,0,240,41,93,0.441,31,53,0.585,10,40,0.25,21,26,0.808,113,43,97,0.443,38,62,0.613,5,35,0.143,31,38,0.816,122
861,DET,2024-01-01,113,@,HOU,0,240,40,83,0.482,27,54,0.5,13,29,0.448,20,27,0.741,113,51,91,0.56,36,56,0.643,15,35,0.429,19,24,0.792,136
862,HOU,2023-12-27,113,,PHO,0,240,40,96,0.417,23,55,0.418,17,41,0.415,16,22,0.727,113,47,82,0.573,33,49,0.673,14,33,0.424,21,26,0.808,129
863,CLE,2023-12-27,113,@,DAL,1,240,40,92,0.435,23,49,0.469,17,43,0.395,16,23,0.696,113,39,88,0.443,29,51,0.569,10,37,0.27,22,26,0.846,110
864,LAC,2023-12-26,113,,CHO,1,240,40,85,0.471,26,51,0.51,14,34,0.412,19,25,0.76,113,43,93,0.462,37,64,0.578,6,29,0.207,12,16,0.75,104
865,SAC,2023-12-26,113,@,POR,0,240,45,93,0.484,35,51,0.686,10,42,0.238,13,16,0.813,113,49,98,0.5,33,58,0.569,16,40,0.4,16,20,0.8,130
866,ATL,2023-12-26,113,@,CHI,0,240,41,89,0.461,28,44,0.636,13,45,0.289,18,21,0.857,113,42,92,0.457,35,67,0.522,7,25,0.28,27,31,0.871,118
867,PHI,2023-12-25,113,@,MIA,0,240,40,94,0.426,23,49,0.469,17,45,0.378,16,25,0.64,113,40,84,0.476,28,52,0.538,12,32,0.375,27,35,0.771,119
868,ATL,2023-12-22,113,@,MIA,0,240,42,96,0.438,23,42,0.548,19,54,0.352,10,14,0.714,113,40,86,0.465,23,47,0.489,17,39,0.436,25,30,0.833,122
869,MIN,2023-12-20,113,@,PHI,0,240,42,82,0.512,33,57,0.579,9,25,0.36,20,24,0.833,113,45,84,0.536,37,62,0.597,8,22,0.364,29,32,0.906,127
870,CHO,2023-12-20,113,@,IND,0,240,45,95,0.474,37,64,0.578,8,31,0.258,15,19,0.789,113,49,80,0.613,31,41,0.756,18,39,0.462,28,30,0.933,144
871,DEN,2023-12-20,113,@,TOR,1,240,49,98,0.5,37,65,0.569,12,33,0.364,3,7,0.429,113,43,90,0.478,34,63,0.54,9,27,0.333,9,13,0.692,104
872,NOP,2023-12-19,113,,MEM,0,240,40,85,0.471,29,60,0.483,11,25,0.44,22,24,0.917,113,41,82,0.5,31,51,0.608,10,31,0.323,23,29,0.793,115
873,GSW,2023-12-14,113,@,LAC,0,240,40,92,0.435,24,47,0.511,16,45,0.356,17,19,0.895,113,41,81,0.506,28,49,0.571,13,32,0.406,26,30,0.867,121
874,NYK,2023-12-13,113,@,UTA,0,240,41,94,0.436,32,55,0.582,9,39,0.231,22,32,0.688,113,43,98,0.439,27,56,0.482,16,42,0.381,15,21,0.714,117
875,CLE,2023-12-12,113,@,BOS,0,240,44,92,0.478,25,47,0.532,19,45,0.422,6,9,0.667,113,38,84,0.452,20,40,0.5,18,44,0.409,26,26,1.0,120
876,MEM,2023-12-11,113,,DAL,0,240,41,89,0.461,23,45,0.511,18,44,0.409,13,16,0.813,113,43,86,0.5,26,46,0.565,17,40,0.425,17,19,0.895,120
877,ATL,2023-12-06,113,,BRK,0,240,42,94,0.447,30,59,0.508,12,35,0.343,17,18,0.944,113,43,94,0.457,32,67,0.478,11,27,0.407,17,24,0.708,114
878,POR,2023-12-02,113,@,UTA,0,265,38,95,0.4,25,55,0.455,13,40,0.325,24,27,0.889,113,46,94,0.489,39,60,0.65,7,34,0.206,19,24,0.792,118
879,LAC,2023-12-02,113,,GSW,1,240,44,90,0.489,31,51,0.608,13,39,0.333,12,14,0.857,113,38,86,0.442,21,43,0.488,17,43,0.395,19,24,0.792,112
880,MIL,2023-11-30,113,@,CHI,0,265,44,98,0.449,28,50,0.56,16,48,0.333,9,13,0.692,113,45,98,0.459,32,61,0.525,13,37,0.351,17,22,0.773,120
881,DEN,2023-11-27,113,@,LAC,1,240,44,92,0.478,34,70,0.486,10,22,0.455,15,28,0.536,113,35,85,0.412,29,65,0.446,6,20,0.3,28,34,0.824,104
882,NYK,2023-11-26,113,,PHO,0,240,39,86,0.453,27,57,0.474,12,29,0.414,23,32,0.719,113,42,91,0.462,26,53,0.491,16,38,0.421,16,21,0.762,116
883,BOS,2023-11-26,113,,ATL,1,240,42,95,0.442,29,48,0.604,13,47,0.277,16,20,0.8,113,36,88,0.409,17,35,0.486,19,53,0.358,12,19,0.632,103
884,DET,2023-11-24,113,@,IND,0,240,43,90,0.478,36,72,0.5,7,18,0.389,20,24,0.833,113,49,102,0.48,33,64,0.516,16,38,0.421,22,24,0.917,136
885,ORL,2023-11-24,113,,BOS,1,240,43,85,0.506,32,57,0.561,11,28,0.393,16,22,0.727,113,31,76,0.408,24,47,0.511,7,29,0.241,27,37,0.73,96
886,DET,2023-11-19,113,@,TOR,0,240,39,83,0.47,30,57,0.526,9,26,0.346,26,35,0.743,113,55,102,0.539,41,66,0.621,14,36,0.389,18,29,0.621,142
887,DAL,2023-11-19,113,,SAC,0,240,41,88,0.466,29,54,0.537,12,34,0.353,19,26,0.731,113,48,90,0.533,31,50,0.62,17,40,0.425,16,21,0.762,129
888,SAS,2023-11-12,113,,MIA,0,240,42,91,0.462,23,47,0.489,19,44,0.432,10,12,0.833,113,39,89,0.438,27,58,0.466,12,31,0.387,28,30,0.933,118
889,UTA,2023-11-06,113,@,CHI,0,240,41,86,0.477,25,43,0.581,16,43,0.372,15,17,0.882,113,48,93,0.516,30,59,0.508,18,34,0.529,16,19,0.842,130
890,MEM,2023-11-03,113,@,POR,0,265,47,96,0.49,37,61,0.607,10,35,0.286,9,13,0.692,113,39,96,0.406,30,64,0.469,9,32,0.281,28,36,0.778,115
891,UTA,2023-11-02,113,,ORL,0,240,41,89,0.461,29,56,0.518,12,33,0.364,19,26,0.731,113,39,85,0.459,29,56,0.518,10,29,0.345,27,36,0.75,115
892,MIN,2023-10-30,113,@,ATL,0,240,44,90,0.489,28,57,0.491,16,33,0.485,9,15,0.6,113,48,86,0.558,34,56,0.607,14,30,0.467,17,18,0.944,127
893,WAS,2023-10-28,113,,MEM,1,240,40,93,0.43,24,47,0.511,16,46,0.348,17,22,0.773,113,39,91,0.429,20,44,0.455,19,47,0.404,9,9,1.0,106
894,CLE,2023-10-28,113,,IND,0,240,43,99,0.434,31,68,0.456,12,31,0.387,15,24,0.625,113,48,98,0.49,33,60,0.55,15,38,0.395,14,17,0.824,125
895,BRK,2023-10-25,113,,CLE,0,240,42,84,0.5,33,57,0.579,9,27,0.333,20,26,0.769,113,44,94,0.468,27,51,0.529,17,43,0.395,9,10,0.9,114
896,DEN,2024-02-04,112,,POR,1,240,42,86,0.488,30,58,0.517,12,28,0.429,16,19,0.842,112,39,85,0.459,28,54,0.519,11,31,0.355,14,15,0.933,103
897,WAS,2024-02-04,112,,PHO,0,240,47,96,0.49,40,64,0.625,7,32,0.219,11,17,0.647,112,54,88,0.614,43,63,0.683,11,25,0.44,21,26,0.808,140
898,NOP,2024-01-29,112,@,BOS,0,240,46,91,0.505,36,56,0.643,10,35,0.286,10,13,0.769,112,43,85,0.506,26,39,0.667,17,46,0.37,15,20,0.75,118
899,MIN,2024-01-27,112,@,SAS,0,240,45,79,0.57,31,53,0.585,14,26,0.538,8,15,0.533,112,46,84,0.548,33,54,0.611,13,30,0.433,8,15,0.533,113
900,CLE,2024-01-26,112,@,MIL,1,240,38,92,0.413,24,56,0.429,14,36,0.389,22,31,0.71,112,35,87,0.402,22,53,0.415,13,34,0.382,17,24,0.708,100
901,ATL,2024-01-24,112,@,GSW,0,240,39,94,0.415,25,51,0.49,14,43,0.326,20,26,0.769,112,51,91,0.56,35,58,0.603,16,33,0.485,16,22,0.727,134
902,LAL,2024-01-19,112,,BRK,0,240,40,90,0.444,28,57,0.491,12,33,0.364,20,24,0.833,112,50,95,0.526,31,48,0.646,19,47,0.404,11,14,0.786,130
903,CHO,2024-01-17,112,@,NOP,0,240,39,90,0.433,20,45,0.444,19,45,0.422,15,18,0.833,112,44,88,0.5,19,41,0.463,25,47,0.532,19,23,0.826,132
904,LAL,2024-01-15,112,,OKC,1,240,44,84,0.524,36,60,0.6,8,24,0.333,16,18,0.889,112,40,96,0.417,25,47,0.532,15,49,0.306,10,11,0.909,105
905,OKC,2024-01-13,112,,ORL,1,240,43,94,0.457,35,58,0.603,8,36,0.222,18,21,0.857,112,39,84,0.464,32,49,0.653,7,35,0.2,15,24,0.625,100
906,HOU,2024-01-12,112,@,DET,1,240,41,90,0.456,33,60,0.55,8,30,0.267,22,25,0.88,112,44,88,0.5,32,53,0.604,12,35,0.343,10,16,0.625,110
907,PHI,2024-01-12,112,,SAC,1,240,40,93,0.43,25,58,0.431,15,35,0.429,17,18,0.944,112,32,95,0.337,24,57,0.421,8,38,0.211,21,26,0.808,93
908,IND,2024-01-10,112,,WAS,1,240,41,92,0.446,33,67,0.493,8,25,0.32,22,24,0.917,112,38,88,0.432,31,57,0.544,7,31,0.226,21,30,0.7,104
909,NYK,2024-01-09,112,,POR,1,240,37,89,0.416,19,41,0.463,18,48,0.375,20,23,0.87,112,33,86,0.384,27,57,0.474,6,29,0.207,12,18,0.667,84
910,CHO,2024-01-08,112,,CHI,0,265,40,94,0.426,23,52,0.442,17,42,0.405,15,17,0.882,112,45,92,0.489,36,66,0.545,9,26,0.346,20,24,0.833,119
911,HOU,2024-01-06,112,,MIL,1,240,36,83,0.434,23,49,0.469,13,34,0.382,27,32,0.844,112,35,76,0.461,26,42,0.619,9,34,0.265,29,42,0.69,108
912,HOU,2024-01-03,112,,BRK,1,240,37,76,0.487,18,37,0.486,19,39,0.487,19,27,0.704,112,36,93,0.387,23,49,0.469,13,44,0.295,16,26,0.615,101
913,NOP,2024-01-02,112,,BRK,1,240,41,88,0.466,25,49,0.51,16,39,0.41,14,18,0.778,112,35,98,0.357,24,55,0.436,11,43,0.256,4,8,0.5,85
914,NYK,2024-01-01,112,,MIN,1,240,39,89,0.438,27,55,0.491,12,34,0.353,22,28,0.786,112,36,76,0.474,25,48,0.521,11,28,0.393,23,29,0.793,106
915,PHO,2023-12-31,112,,ORL,1,240,44,88,0.5,36,61,0.59,8,27,0.296,16,19,0.842,112,42,90,0.467,30,53,0.566,12,37,0.324,11,12,0.917,107
916,CHO,2023-12-28,112,@,LAL,0,240,40,85,0.471,25,52,0.481,15,33,0.455,17,28,0.607,112,52,97,0.536,37,67,0.552,15,30,0.5,14,14,1.0,133
917,NOP,2023-12-28,112,,UTA,1,240,45,82,0.549,35,55,0.636,10,27,0.37,12,15,0.8,112,36,85,0.424,24,46,0.522,12,39,0.308,21,25,0.84,105
918,PHI,2023-12-27,112,@,ORL,1,240,45,96,0.469,35,68,0.515,10,28,0.357,12,17,0.706,112,31,79,0.392,22,46,0.478,9,33,0.273,21,24,0.875,92
919,DET,2023-12-26,112,,BRK,0,240,40,90,0.444,31,65,0.477,9,25,0.36,23,32,0.719,112,41,82,0.5,32,60,0.533,9,22,0.409,27,43,0.628,118
920,MIN,2023-12-18,112,@,MIA,1,240,42,85,0.494,31,56,0.554,11,29,0.379,17,19,0.895,112,41,87,0.471,30,57,0.526,11,30,0.367,15,18,0.833,108
921,PHO,2023-12-17,112,,WAS,1,240,41,90,0.456,34,59,0.576,7,31,0.226,23,30,0.767,112,39,95,0.411,25,49,0.51,14,46,0.304,16,20,0.8,108
922,NOP,2023-12-15,112,@,CHO,1,240,38,80,0.475,29,53,0.547,9,27,0.333,27,32,0.844,112,41,92,0.446,32,61,0.525,9,31,0.29,16,21,0.762,107
923,PHO,2023-12-13,112,,BRK,0,240,40,84,0.476,31,56,0.554,9,28,0.321,23,27,0.852,112,41,89,0.461,26,48,0.542,15,41,0.366,19,24,0.792,116
924,POR,2023-12-08,112,,DAL,0,240,39,105,0.371,21,52,0.404,18,53,0.34,16,18,0.889,112,47,91,0.516,35,52,0.673,12,39,0.308,19,22,0.864,125
925,SAS,2023-12-08,112,,CHI,0,240,39,83,0.47,22,41,0.537,17,42,0.405,17,20,0.85,112,47,102,0.461,34,74,0.459,13,28,0.464,14,24,0.583,121
926,MIA,2023-12-06,112,@,TOR,1,240,41,89,0.461,27,51,0.529,14,38,0.368,16,19,0.842,112,37,86,0.43,23,49,0.469,14,37,0.378,15,17,0.882,103
927,BOS,2023-12-04,112,@,IND,0,240,46,97,0.474,34,56,0.607,12,41,0.293,8,12,0.667,112,43,94,0.457,24,54,0.444,19,40,0.475,17,21,0.81,122
928,GSW,2023-12-02,112,@,LAC,0,240,38,86,0.442,21,43,0.488,17,43,0.395,19,24,0.792,112,44,90,0.489,31,51,0.608,13,39,0.333,12,14,0.857,113
929,DET,2023-11-30,112,@,NYK,0,240,43,81,0.531,28,46,0.609,15,35,0.429,11,17,0.647,112,41,88,0.466,25,47,0.532,16,41,0.39,20,28,0.714,118
930,TOR,2023-11-29,112,,PHO,1,240,42,93,0.452,32,66,0.485,10,27,0.37,18,21,0.857,112,38,94,0.404,31,68,0.456,7,26,0.269,22,23,0.957,105
931,NOP,2023-11-27,112,@,UTA,0,240,44,88,0.5,37,66,0.561,7,22,0.318,17,25,0.68,112,37,88,0.42,20,40,0.5,17,48,0.354,23,28,0.821,114
932,BRK,2023-11-25,112,,MIA,1,240,39,78,0.5,25,42,0.595,14,36,0.389,20,23,0.87,112,38,87,0.437,27,53,0.509,11,34,0.324,10,13,0.769,97
933,SAS,2023-11-24,112,@,GSW,0,240,45,100,0.45,33,53,0.623,12,47,0.255,10,12,0.833,112,40,81,0.494,21,39,0.538,19,42,0.452,19,24,0.792,118
934,SAC,2023-11-22,112,@,NOP,0,240,34,76,0.447,19,32,0.594,15,44,0.341,29,35,0.829,112,41,87,0.471,34,57,0.596,7,30,0.233,28,37,0.757,117
935,MIN,2023-11-22,112,,PHI,1,240,43,89,0.483,33,63,0.524,10,26,0.385,16,24,0.667,112,34,87,0.391,27,55,0.491,7,32,0.219,24,30,0.8,99
936,TOR,2023-11-15,112,,MIL,0,240,38,96,0.396,29,63,0.46,9,33,0.273,27,31,0.871,112,44,85,0.518,24,46,0.522,20,39,0.513,20,21,0.952,128
937,ORL,2023-11-11,112,,MIL,1,240,36,84,0.429,26,58,0.448,10,26,0.385,30,35,0.857,112,38,77,0.494,29,48,0.604,9,29,0.31,12,25,0.48,97
938,MEM,2023-11-05,112,@,POR,1,240,45,89,0.506,32,57,0.561,13,32,0.406,9,13,0.692,112,37,95,0.389,23,50,0.46,14,45,0.311,12,15,0.8,100
939,PHI,2023-11-04,112,,PHO,1,240,43,90,0.478,32,60,0.533,11,30,0.367,15,18,0.833,112,32,89,0.36,23,54,0.426,9,35,0.257,27,33,0.818,100
940,CHI,2023-10-30,112,@,IND,1,240,40,87,0.46,34,70,0.486,6,17,0.353,26,31,0.839,112,36,88,0.409,24,42,0.571,12,46,0.261,21,25,0.84,105
941,DET,2023-10-30,112,@,OKC,0,240,39,91,0.429,24,63,0.381,15,28,0.536,19,24,0.792,112,44,83,0.53,31,54,0.574,13,29,0.448,23,28,0.821,124
942,MIN,2024-02-04,111,,HOU,1,240,40,90,0.444,29,60,0.483,11,30,0.367,20,27,0.741,111,31,88,0.352,21,58,0.362,10,30,0.333,18,27,0.667,90
943,ORL,2024-02-04,111,@,DET,1,240,45,84,0.536,35,60,0.583,10,24,0.417,11,15,0.733,111,36,80,0.45,28,49,0.571,8,31,0.258,19,22,0.864,99
944,DEN,2024-01-27,111,,PHI,1,240,37,82,0.451,24,45,0.533,13,37,0.351,24,38,0.632,111,43,81,0.531,37,59,0.627,6,22,0.273,13,16,0.813,105
945,OKC,2024-01-23,111,,POR,1,240,43,89,0.483,36,66,0.545,7,23,0.304,18,28,0.643,111,37,86,0.43,19,47,0.404,18,39,0.462,17,21,0.81,109
946,CLE,2024-01-11,111,,BRK,1,240,32,82,0.39,19,38,0.5,13,44,0.295,34,43,0.791,111,37,82,0.451,29,55,0.527,8,27,0.296,20,28,0.714,102
947,DEN,2024-01-10,111,@,UTA,0,240,37,81,0.457,24,48,0.5,13,33,0.394,24,28,0.857,111,46,83,0.554,33,50,0.66,13,33,0.394,19,23,0.826,124
948,PHO,2024-01-08,111,@,LAC,0,240,38,77,0.494,28,47,0.596,10,30,0.333,25,29,0.862,111,53,85,0.624,38,56,0.679,15,29,0.517,17,23,0.739,138
949,LAC,2024-01-05,111,@,NOP,1,240,40,82,0.488,25,46,0.543,15,36,0.417,16,20,0.8,111,33,92,0.359,21,63,0.333,12,29,0.414,17,23,0.739,95
950,MEM,2024-01-03,111,,TOR,0,240,40,94,0.426,25,52,0.481,15,42,0.357,16,19,0.842,111,41,85,0.482,29,59,0.492,12,26,0.462,22,27,0.815,116
951,CHO,2024-01-02,111,@,SAC,1,240,42,82,0.512,30,48,0.625,12,34,0.353,15,19,0.789,111,40,92,0.435,26,56,0.464,14,36,0.389,10,17,0.588,104
952,DEN,2024-01-01,111,,CHO,1,240,41,83,0.494,26,45,0.578,15,38,0.395,14,18,0.778,111,36,86,0.419,26,60,0.433,10,26,0.385,11,16,0.688,93
953,CLE,2023-12-29,111,,MIL,0,240,49,103,0.476,43,60,0.717,6,43,0.14,7,9,0.778,111,41,80,0.513,29,51,0.569,12,29,0.414,25,28,0.893,119
954,NYK,2023-12-23,111,,MIL,0,240,41,93,0.441,32,64,0.5,9,29,0.31,20,21,0.952,111,48,91,0.527,32,59,0.542,16,32,0.5,18,23,0.783,130
955,TOR,2023-12-22,111,@,PHI,0,240,39,87,0.448,30,54,0.556,9,33,0.273,24,28,0.857,111,44,83,0.53,30,52,0.577,14,31,0.452,19,21,0.905,121
956,LAL,2023-12-21,111,@,MIN,0,240,41,83,0.494,31,59,0.525,10,24,0.417,19,24,0.792,111,42,87,0.483,28,51,0.549,14,36,0.389,20,25,0.8,118
957,DET,2023-12-21,111,,UTA,0,240,43,86,0.5,34,55,0.618,9,31,0.29,16,19,0.842,111,43,94,0.457,32,64,0.5,11,30,0.367,22,24,0.917,119
958,DAL,2023-12-20,111,,LAC,0,240,39,91,0.429,25,48,0.521,14,43,0.326,19,27,0.704,111,43,77,0.558,32,46,0.696,11,31,0.355,23,25,0.92,120
959,ORL,2023-12-15,111,@,BOS,0,240,42,87,0.483,28,52,0.538,14,35,0.4,13,18,0.722,111,48,92,0.522,30,50,0.6,18,42,0.429,14,20,0.7,128
960,DET,2023-12-13,111,,PHI,0,240,39,88,0.443,29,55,0.527,10,33,0.303,23,30,0.767,111,45,87,0.517,34,57,0.596,11,30,0.367,28,34,0.824,129
961,CLE,2023-12-08,111,@,MIA,1,240,40,87,0.46,26,49,0.531,14,38,0.368,17,26,0.654,111,37,86,0.43,22,44,0.5,15,42,0.357,10,15,0.667,99
962,LAC,2023-12-06,111,,DEN,1,240,40,87,0.46,28,60,0.467,12,27,0.444,19,25,0.76,111,41,98,0.418,29,67,0.433,12,31,0.387,8,9,0.889,102
963,CHI,2023-12-06,111,,CHO,1,240,38,90,0.422,26,65,0.4,12,25,0.48,23,29,0.793,111,39,90,0.433,29,53,0.547,10,37,0.27,12,12,1.0,100
964,ORL,2023-12-06,111,@,CLE,0,240,41,84,0.488,39,61,0.639,2,23,0.087,27,37,0.73,111,46,86,0.535,32,52,0.615,14,34,0.412,15,20,0.75,121
965,PHO,2023-12-01,111,,DEN,0,240,39,84,0.464,30,57,0.526,9,27,0.333,24,26,0.923,111,50,88,0.568,38,56,0.679,12,32,0.375,7,12,0.583,119
966,MIN,2023-11-24,111,,SAC,0,240,36,82,0.439,24,49,0.49,12,33,0.364,27,29,0.931,111,49,100,0.49,32,65,0.492,17,35,0.486,9,11,0.818,124
967,HOU,2023-11-22,111,,MEM,1,240,40,92,0.435,26,49,0.531,14,43,0.326,17,20,0.85,111,27,82,0.329,20,50,0.4,7,32,0.219,30,35,0.857,91
968,MIA,2023-11-14,111,@,CHO,1,240,40,83,0.482,32,52,0.615,8,31,0.258,23,28,0.821,111,36,81,0.444,21,49,0.429,15,32,0.469,18,22,0.818,105
969,DEN,2023-11-14,111,,LAC,1,240,39,73,0.534,31,50,0.62,8,23,0.348,25,32,0.781,111,37,86,0.43,24,57,0.421,13,29,0.448,21,24,0.875,108
970,TOR,2023-11-13,111,,WAS,1,240,45,90,0.5,41,70,0.586,4,20,0.2,17,25,0.68,111,43,84,0.512,31,58,0.534,12,26,0.462,9,12,0.75,107
971,OKC,2023-11-12,111,@,PHO,1,240,40,82,0.488,30,55,0.545,10,27,0.37,21,25,0.84,111,32,83,0.386,23,54,0.426,9,29,0.31,26,31,0.839,99
972,SAS,2023-11-06,111,@,IND,0,240,40,94,0.426,32,68,0.471,8,26,0.308,23,30,0.767,111,55,95,0.579,35,57,0.614,20,38,0.526,22,23,0.957,152
973,NYK,2023-11-06,111,,LAC,1,240,41,88,0.466,29,57,0.509,12,31,0.387,17,18,0.944,111,36,73,0.493,25,41,0.61,11,32,0.344,14,16,0.875,97
974,MIL,2023-11-01,111,@,TOR,0,240,35,76,0.461,22,42,0.524,13,34,0.382,28,38,0.737,111,51,91,0.56,36,53,0.679,15,38,0.395,13,14,0.929,130
975,DET,2023-10-27,111,@,CHO,1,240,40,88,0.455,30,58,0.517,10,30,0.333,21,25,0.84,111,33,88,0.375,26,60,0.433,7,28,0.25,26,34,0.765,99
976,MIA,2023-10-27,111,@,BOS,0,240,38,89,0.427,22,56,0.393,16,33,0.485,19,23,0.826,111,45,95,0.474,29,56,0.518,16,39,0.41,13,19,0.684,119
977,NOP,2023-10-25,111,@,MEM,1,240,40,85,0.471,26,53,0.491,14,32,0.438,17,22,0.773,111,38,91,0.418,26,48,0.542,12,43,0.279,16,20,0.8,104
978,POR,2023-10-25,111,@,LAC,0,240,44,93,0.473,34,61,0.557,10,32,0.313,13,17,0.765,111,47,90,0.522,31,56,0.554,16,34,0.471,13,16,0.813,123
979,SAC,2024-02-05,110,@,CLE,0,240,43,93,0.462,26,49,0.531,17,44,0.386,7,12,0.583,110,51,88,0.58,28,47,0.596,23,41,0.561,11,17,0.647,136
980,MIA,2024-02-02,110,@,WAS,1,240,38,88,0.432,31,57,0.544,7,31,0.226,27,35,0.771,110,37,90,0.411,26,48,0.542,11,42,0.262,17,21,0.81,102
981,NOP,2024-01-31,110,@,HOU,1,240,41,82,0.5,30,48,0.625,11,34,0.324,17,24,0.708,110,35,87,0.402,22,43,0.512,13,44,0.295,16,17,0.941,99
982,CHO,2024-01-31,110,,CHI,0,240,40,90,0.444,24,44,0.545,16,46,0.348,14,17,0.824,110,45,87,0.517,34,58,0.586,11,29,0.379,16,22,0.727,117
983,MEM,2024-01-28,110,@,IND,0,240,38,82,0.463,27,52,0.519,11,30,0.367,23,31,0.742,110,44,90,0.489,31,55,0.564,13,35,0.371,15,16,0.938,116
984,MIA,2024-01-25,110,,BOS,0,240,42,94,0.447,26,52,0.5,16,42,0.381,10,13,0.769,110,51,80,0.638,29,40,0.725,22,40,0.55,19,20,0.95,143
985,DAL,2024-01-22,110,,BOS,0,240,43,97,0.443,29,57,0.509,14,40,0.35,10,14,0.714,110,41,88,0.466,26,42,0.619,15,46,0.326,22,30,0.733,119
986,IND,2024-01-21,110,@,PHO,0,240,41,94,0.436,27,63,0.429,14,31,0.452,14,23,0.609,110,47,82,0.573,39,57,0.684,8,25,0.32,15,18,0.833,117
987,POR,2024-01-21,110,@,LAL,0,240,42,90,0.467,33,61,0.541,9,29,0.31,17,20,0.85,110,47,86,0.547,34,53,0.642,13,33,0.394,27,29,0.931,134
988,TOR,2024-01-18,110,,CHI,0,240,42,83,0.506,32,45,0.711,10,38,0.263,16,20,0.8,110,48,91,0.527,42,67,0.627,6,24,0.25,14,17,0.824,116
989,DAL,2024-01-17,110,@,LAL,0,240,42,91,0.462,31,51,0.608,11,40,0.275,15,18,0.833,110,49,91,0.538,37,63,0.587,12,28,0.429,17,24,0.708,127
990,DET,2024-01-12,110,,HOU,0,240,44,88,0.5,32,53,0.604,12,35,0.343,10,16,0.625,110,41,90,0.456,33,60,0.55,8,30,0.267,22,25,0.88,112
991,DET,2024-01-09,110,,SAC,0,240,40,85,0.471,26,48,0.542,14,37,0.378,16,21,0.762,110,54,94,0.574,41,61,0.672,13,33,0.394,10,14,0.714,131
992,ATL,2024-01-07,110,@,ORL,0,265,42,91,0.462,33,61,0.541,9,30,0.3,17,29,0.586,110,43,98,0.439,26,57,0.456,17,41,0.415,14,22,0.636,117
993,MIA,2024-01-03,110,@,LAL,1,240,41,93,0.441,25,51,0.49,16,42,0.381,12,17,0.706,110,35,83,0.422,31,53,0.585,4,30,0.133,22,24,0.917,96
994,PHI,2024-01-02,110,,CHI,1,240,38,80,0.475,26,50,0.52,12,30,0.4,22,30,0.733,110,37,96,0.385,30,59,0.508,7,37,0.189,16,23,0.696,97
995,WAS,2023-12-29,110,,BRK,1,240,46,91,0.505,31,53,0.585,15,38,0.395,3,7,0.429,110,39,91,0.429,30,63,0.476,9,28,0.321,17,27,0.63,104
996,ATL,2023-12-29,110,,SAC,0,240,37,94,0.394,22,51,0.431,15,43,0.349,21,25,0.84,110,46,89,0.517,29,44,0.659,17,45,0.378,8,15,0.533,117
997,DAL,2023-12-28,110,@,MIN,0,240,40,90,0.444,26,57,0.456,14,33,0.424,16,19,0.842,110,38,74,0.514,21,41,0.512,17,33,0.515,25,34,0.735,118
998,DAL,2023-12-27,110,,CLE,0,240,39,88,0.443,29,51,0.569,10,37,0.27,22,26,0.846,110,40,92,0.435,23,49,0.469,17,43,0.395,16,23,0.696,113
999,MIN,2023-12-23,110,@,SAC,1,240,44,87,0.506,34,54,0.63,10,33,0.303,12,14,0.857,110,37,85,0.435,29,52,0.558,8,33,0.242,16,21,0.762,98
1000,IND,2023-12-23,110,,ORL,0,240,43,82,0.524,28,48,0.583,15,34,0.441,9,13,0.692,110,39,73,0.534,33,55,0.6,6,18,0.333,33,41,0.805,117
1001,SAS,2023-12-17,110,,NOP,0,240,40,94,0.426,25,52,0.481,15,42,0.357,15,21,0.714,110,55,98,0.561,33,56,0.589,22,42,0.524,14,22,0.636,146
1002,HOU,2023-12-06,110,,OKC,1,240,40,83,0.482,25,50,0.5,15,33,0.455,15,22,0.682,110,37,87,0.425,29,58,0.5,8,29,0.276,19,24,0.792,101
1003,GSW,2023-12-06,110,,POR,1,240,36,86,0.419,26,52,0.5,10,34,0.294,28,33,0.848,110,39,95,0.411,23,49,0.469,16,46,0.348,12,16,0.75,106
1004,CLE,2023-12-02,110,@,DET,1,240,44,89,0.494,34,59,0.576,10,30,0.333,12,18,0.667,110,39,83,0.47,31,53,0.585,8,30,0.267,15,23,0.652,101
1005,LAL,2023-11-30,110,@,OKC,0,240,36,81,0.444,25,48,0.521,11,33,0.333,27,32,0.844,110,50,94,0.532,36,52,0.692,14,42,0.333,19,22,0.864,133
1006,IND,2023-11-27,110,,POR,0,240,42,88,0.477,34,55,0.618,8,33,0.242,18,24,0.75,110,40,85,0.471,31,67,0.463,9,18,0.5,25,31,0.806,114
1007,PHO,2023-11-24,110,@,MEM,1,240,39,76,0.513,28,45,0.622,11,31,0.355,21,28,0.75,110,37,80,0.463,28,47,0.596,9,33,0.273,6,10,0.6,89
1008,DEN,2023-11-17,110,@,NOP,0,240,47,96,0.49,37,56,0.661,10,40,0.25,6,12,0.5,110,46,88,0.523,34,65,0.523,12,23,0.522,11,21,0.524,115
1009,LAL,2023-11-15,110,,SAC,0,240,42,83,0.506,31,54,0.574,11,29,0.379,15,19,0.789,110,48,96,0.5,32,52,0.615,16,44,0.364,13,17,0.765,125
1010,DAL,2023-11-14,110,@,NOP,0,240,38,90,0.422,24,48,0.5,14,42,0.333,20,26,0.769,110,49,94,0.521,35,56,0.625,14,38,0.368,19,26,0.731,131
1011,GSW,2023-11-12,110,,MIN,0,240,37,96,0.385,25,53,0.472,12,43,0.279,24,28,0.857,110,43,82,0.524,34,55,0.618,9,27,0.333,21,30,0.7,116
1012,POR,2023-11-12,110,@,LAL,0,240,45,90,0.5,32,53,0.604,13,37,0.351,7,9,0.778,110,41,84,0.488,37,65,0.569,4,19,0.211,30,37,0.811,116
1013,GSW,2023-11-11,110,,CLE,0,240,37,90,0.411,24,52,0.462,13,38,0.342,23,30,0.767,110,37,86,0.43,26,56,0.464,11,30,0.367,33,43,0.767,118
1014,SAS,2023-11-10,110,,MIN,0,240,43,92,0.467,31,58,0.534,12,34,0.353,12,19,0.632,110,43,87,0.494,33,60,0.55,10,27,0.37,21,27,0.778,117
1015,MIL,2023-11-03,110,,NYK,1,240,35,82,0.427,15,43,0.349,20,39,0.513,20,28,0.714,110,38,96,0.396,28,57,0.491,10,39,0.256,19,25,0.76,105
1016,NOP,2023-11-01,110,@,OKC,1,240,40,102,0.392,27,60,0.45,13,42,0.31,17,29,0.586,110,38,88,0.432,31,54,0.574,7,34,0.206,23,25,0.92,106
1017,POR,2023-11-01,110,@,DET,1,240,38,81,0.469,31,61,0.508,7,20,0.35,27,33,0.818,110,40,90,0.444,29,61,0.475,11,29,0.379,10,11,0.909,101
1018,MIN,2023-11-01,110,,DEN,1,240,38,83,0.458,30,62,0.484,8,21,0.381,26,27,0.963,110,38,96,0.396,32,63,0.508,6,33,0.182,7,10,0.7,89
1019,DEN,2023-10-30,110,,UTA,1,240,47,84,0.56,38,56,0.679,9,28,0.321,7,17,0.412,110,42,98,0.429,31,61,0.508,11,37,0.297,7,15,0.467,102
1020,MEM,2023-10-30,110,,DAL,0,240,42,92,0.457,28,55,0.509,14,37,0.378,12,20,0.6,110,42,84,0.5,19,37,0.514,23,47,0.489,18,24,0.75,125
1021,MIL,2023-10-29,110,,ATL,0,240,39,86,0.453,23,42,0.548,16,44,0.364,16,20,0.8,110,47,93,0.505,32,56,0.571,15,37,0.405,18,22,0.818,127
1022,ATL,2023-10-25,110,@,CHO,0,240,39,93,0.419,34,64,0.531,5,29,0.172,27,33,0.818,110,43,86,0.5,32,49,0.653,11,37,0.297,19,26,0.731,116
1023,GSW,2024-02-05,109,@,BRK,1,240,43,93,0.462,39,71,0.549,4,22,0.182,19,23,0.826,109,34,89,0.382,21,47,0.447,13,42,0.31,17,22,0.773,98
1024,NYK,2024-02-01,109,,IND,1,240,41,103,0.398,33,65,0.508,8,38,0.211,19,25,0.76,109,42,93,0.452,29,60,0.483,13,33,0.394,8,13,0.615,105
1025,WAS,2024-01-31,109,,LAC,0,240,45,97,0.464,36,68,0.529,9,29,0.31,10,15,0.667,109,47,100,0.47,35,70,0.5,12,30,0.4,19,22,0.864,125
1026,MIA,2024-01-27,109,@,NYK,0,240,41,88,0.466,27,51,0.529,14,37,0.378,13,16,0.813,109,45,87,0.517,28,54,0.519,17,33,0.515,18,26,0.692,125
1027,DAL,2024-01-24,109,,PHO,0,240,41,89,0.461,24,46,0.522,17,43,0.395,10,18,0.556,109,51,85,0.6,37,51,0.725,14,34,0.412,16,22,0.727,132
1028,POR,2024-01-23,109,@,OKC,0,240,37,86,0.43,19,47,0.404,18,39,0.462,17,21,0.81,109,43,89,0.483,36,66,0.545,7,23,0.304,18,28,0.643,111
1029,IND,2024-01-23,109,,DEN,0,240,43,87,0.494,38,66,0.576,5,21,0.238,18,21,0.857,109,44,88,0.5,33,55,0.6,11,33,0.333,15,17,0.882,114
1030,ATL,2024-01-19,109,@,MIA,1,240,40,87,0.46,25,52,0.481,15,35,0.429,14,17,0.824,109,38,82,0.463,26,51,0.51,12,31,0.387,20,22,0.909,108
1031,NOP,2024-01-19,109,,PHO,0,240,41,93,0.441,31,51,0.608,10,42,0.238,17,23,0.739,109,46,93,0.495,31,52,0.596,15,41,0.366,16,21,0.762,123
1032,ORL,2024-01-19,109,,PHI,0,240,37,78,0.474,27,55,0.491,10,23,0.435,25,27,0.926,109,42,87,0.483,29,57,0.509,13,30,0.433,27,29,0.931,124
1033,WAS,2024-01-18,109,@,NYK,0,240,41,90,0.456,31,59,0.525,10,31,0.323,17,22,0.773,109,39,86,0.453,26,48,0.542,13,38,0.342,22,26,0.846,113
1034,NYK,2024-01-17,109,,HOU,1,240,39,87,0.448,26,50,0.52,13,37,0.351,18,22,0.818,109,35,84,0.417,27,54,0.5,8,30,0.267,16,19,0.842,94
1035,CLE,2024-01-15,109,,CHI,1,240,39,95,0.411,19,38,0.5,20,57,0.351,11,11,1.0,109,35,83,0.422,26,51,0.51,9,32,0.281,12,16,0.75,91
1036,ATL,2024-01-15,109,,SAS,1,240,40,93,0.43,27,55,0.491,13,38,0.342,16,21,0.762,109,38,95,0.4,27,53,0.509,11,42,0.262,12,17,0.706,99
1037,MIN,2024-01-14,109,,LAC,1,240,38,67,0.567,25,41,0.61,13,26,0.5,20,31,0.645,109,36,83,0.434,19,44,0.432,17,39,0.436,16,18,0.889,105
1038,IND,2024-01-14,109,@,DEN,0,240,43,92,0.467,35,63,0.556,8,29,0.276,15,22,0.682,109,46,71,0.648,36,51,0.706,10,20,0.5,15,23,0.652,117
1039,LAL,2024-01-11,109,,PHO,0,240,40,80,0.5,27,46,0.587,13,34,0.382,16,25,0.64,109,46,93,0.495,32,54,0.593,14,39,0.359,21,23,0.913,127
1040,PHI,2024-01-06,109,,UTA,0,240,42,104,0.404,35,66,0.53,7,38,0.184,18,23,0.783,109,46,80,0.575,38,50,0.76,8,30,0.267,20,24,0.833,120
1041,DET,2024-01-05,109,@,GSW,0,240,44,98,0.449,31,54,0.574,13,44,0.295,8,10,0.8,109,38,82,0.463,22,44,0.5,16,38,0.421,21,25,0.84,113
1042,PHO,2024-01-01,109,,POR,1,240,38,80,0.475,27,51,0.529,11,29,0.379,22,33,0.667,109,33,80,0.413,25,50,0.5,8,30,0.267,14,19,0.737,88
1043,LAL,2023-12-31,109,@,NOP,0,240,39,82,0.476,29,50,0.58,10,32,0.313,21,25,0.84,109,45,87,0.517,28,53,0.528,17,34,0.5,22,27,0.815,129
1044,MIA,2023-12-30,109,@,UTA,0,240,34,78,0.436,25,47,0.532,9,31,0.29,32,40,0.8,109,43,93,0.462,32,52,0.615,11,41,0.268,20,28,0.714,117
1045,CLE,2023-12-23,109,@,CHI,1,240,39,88,0.443,27,43,0.628,12,45,0.267,19,26,0.731,109,35,80,0.438,27,45,0.6,8,35,0.229,17,19,0.895,95
1046,POR,2023-12-19,109,,PHO,1,240,39,87,0.448,25,59,0.424,14,28,0.5,17,19,0.895,109,42,94,0.447,37,71,0.521,5,23,0.217,15,21,0.714,104
1047,LAL,2023-12-18,109,,NYK,0,240,42,99,0.424,29,58,0.5,13,41,0.317,12,13,0.923,109,42,88,0.477,32,58,0.552,10,30,0.333,20,23,0.87,114
1048,IND,2023-12-16,109,@,MIN,0,240,45,90,0.5,39,69,0.565,6,21,0.286,13,16,0.813,109,48,86,0.558,30,56,0.536,18,30,0.6,13,16,0.813,127
1049,MEM,2023-12-02,109,@,PHO,0,240,39,86,0.453,30,55,0.545,9,31,0.29,22,24,0.917,109,36,83,0.434,27,57,0.474,9,26,0.346,35,43,0.814,116
1050,CHI,2023-11-26,109,@,BRK,0,240,40,83,0.482,28,51,0.549,12,32,0.375,17,22,0.773,109,41,83,0.494,16,30,0.533,25,53,0.472,11,15,0.733,118
1051,LAC,2023-11-22,109,@,SAS,1,240,39,85,0.459,30,57,0.526,9,28,0.321,22,29,0.759,109,35,91,0.385,24,53,0.453,11,38,0.289,21,23,0.913,102
1052,DEN,2023-11-19,109,@,CLE,0,240,39,82,0.476,25,53,0.472,14,29,0.483,17,23,0.739,109,45,82,0.549,34,55,0.618,11,27,0.407,20,26,0.769,121
1053,GSW,2023-11-16,109,,OKC,0,240,40,98,0.408,26,57,0.456,14,41,0.341,15,19,0.789,109,44,87,0.506,25,55,0.455,19,32,0.594,21,23,0.913,128
1054,CLE,2023-11-15,109,@,POR,1,240,42,75,0.56,33,45,0.733,9,30,0.3,16,21,0.762,109,34,91,0.374,21,53,0.396,13,38,0.342,14,16,0.875,95
1055,CHI,2023-11-13,109,@,MIL,0,240,38,100,0.38,24,58,0.414,14,42,0.333,19,21,0.905,109,42,89,0.472,27,42,0.643,15,47,0.319,19,27,0.704,118
1056,ATL,2023-11-11,109,,MIA,0,240,38,87,0.437,20,41,0.488,18,46,0.391,15,18,0.833,109,41,84,0.488,29,46,0.63,12,38,0.316,23,25,0.92,117
1057,BOS,2023-11-06,109,@,MIN,0,265,36,92,0.391,25,53,0.472,11,39,0.282,26,34,0.765,109,44,85,0.518,31,48,0.646,13,37,0.351,13,25,0.52,114
1058,DET,2023-11-06,109,,GSW,0,240,38,80,0.475,25,50,0.5,13,30,0.433,20,21,0.952,109,46,97,0.474,34,56,0.607,12,41,0.293,16,21,0.762,120
1059,BRK,2023-11-03,109,@,CHI,1,240,44,96,0.458,26,51,0.51,18,45,0.4,3,5,0.6,109,43,89,0.483,32,61,0.525,11,28,0.393,10,14,0.714,107
1060,BRK,2023-11-01,109,@,MIA,1,240,37,82,0.451,21,46,0.457,16,36,0.444,19,26,0.731,109,39,91,0.429,26,53,0.491,13,38,0.342,14,18,0.778,105
1061,MEM,2023-11-01,109,@,UTA,0,240,35,96,0.365,21,42,0.5,14,54,0.259,25,32,0.781,109,47,87,0.54,25,44,0.568,22,43,0.512,17,24,0.708,133
1062,NYK,2023-10-31,109,@,CLE,1,240,38,86,0.442,25,52,0.481,13,34,0.382,20,25,0.8,109,36,92,0.391,26,54,0.481,10,38,0.263,9,12,0.75,91
1063,MIL,2024-02-04,108,@,UTA,0,240,39,84,0.464,24,43,0.558,15,41,0.366,15,25,0.6,108,43,89,0.483,26,45,0.578,17,44,0.386,20,24,0.833,123
1064,ORL,2024-02-02,108,@,MIN,1,240,39,85,0.459,30,60,0.5,9,25,0.36,21,26,0.808,108,38,82,0.463,26,44,0.591,12,38,0.316,18,20,0.9,106
1065,POR,2024-02-02,108,@,DEN,0,240,37,80,0.463,27,52,0.519,10,28,0.357,24,30,0.8,108,46,91,0.505,34,55,0.618,12,36,0.333,16,17,0.941,120
1066,CLE,2024-02-01,108,@,MEM,1,240,41,86,0.477,27,51,0.529,14,35,0.4,12,18,0.667,108,37,90,0.411,25,52,0.481,12,38,0.316,15,17,0.882,101
1067,ORL,2024-01-31,108,@,SAS,1,240,41,86,0.477,34,66,0.515,7,20,0.35,19,23,0.826,108,36,80,0.45,27,49,0.551,9,31,0.29,17,24,0.708,98
1068,LAC,2024-01-29,108,@,CLE,0,240,38,80,0.475,27,46,0.587,11,34,0.324,21,28,0.75,108,42,86,0.488,29,46,0.63,13,40,0.325,21,26,0.808,118
1069,WAS,2024-01-25,108,,UTA,0,240,43,88,0.489,36,58,0.621,7,30,0.233,15,20,0.75,108,50,97,0.515,37,66,0.561,13,31,0.419,10,12,0.833,123
1070,NYK,2024-01-23,108,@,BRK,1,240,40,86,0.465,30,57,0.526,10,29,0.345,18,19,0.947,108,42,95,0.442,27,53,0.509,15,42,0.357,4,5,0.8,103
1071,MEM,2024-01-22,108,@,TOR,1,240,44,95,0.463,31,61,0.508,13,34,0.382,7,12,0.583,108,35,79,0.443,27,56,0.482,8,23,0.348,22,23,0.957,100
1072,MIA,2024-01-19,108,,ATL,0,240,38,82,0.463,26,51,0.51,12,31,0.387,20,22,0.909,108,40,87,0.46,25,52,0.481,15,35,0.429,14,17,0.824,109
1073,DAL,2024-01-13,108,,NOP,0,240,37,82,0.451,22,41,0.537,15,41,0.366,19,20,0.95,108,39,79,0.494,27,49,0.551,12,30,0.4,28,37,0.757,118
1074,ATL,2024-01-12,108,,IND,0,240,40,89,0.449,29,59,0.492,11,30,0.367,17,23,0.739,108,53,79,0.671,42,61,0.689,11,18,0.611,9,12,0.75,126
1075,DET,2024-01-10,108,,SAS,0,240,44,96,0.458,34,64,0.531,10,32,0.313,10,13,0.769,108,49,94,0.521,40,67,0.597,9,27,0.333,23,27,0.852,130
1076,MIN,2024-01-07,108,@,DAL,0,240,41,94,0.436,28,53,0.528,13,41,0.317,13,21,0.619,108,43,95,0.453,28,55,0.509,15,40,0.375,14,20,0.7,115
1077,MIL,2024-01-06,108,@,HOU,0,240,35,76,0.461,26,42,0.619,9,34,0.265,29,42,0.69,108,36,83,0.434,23,49,0.469,13,34,0.382,27,32,0.844,112
1078,BRK,2023-12-31,108,@,OKC,0,240,38,100,0.38,26,54,0.481,12,46,0.261,20,31,0.645,108,45,83,0.542,27,50,0.54,18,33,0.545,16,20,0.8,124
1079,MIN,2023-12-30,108,,LAL,1,240,38,76,0.5,26,42,0.619,12,34,0.353,20,24,0.833,108,37,88,0.42,30,64,0.469,7,24,0.292,25,32,0.781,106
1080,NYK,2023-12-29,108,@,ORL,0,240,38,86,0.442,32,56,0.571,6,30,0.2,26,29,0.897,108,40,89,0.449,33,56,0.589,7,33,0.212,30,40,0.75,117
1081,LAC,2023-12-23,108,,BOS,0,240,41,89,0.461,30,55,0.545,11,34,0.324,15,15,1.0,108,49,94,0.521,24,41,0.585,25,53,0.472,22,28,0.786,145
1082,LAL,2023-12-20,108,@,CHI,0,240,42,94,0.447,30,57,0.526,12,37,0.324,12,15,0.8,108,48,88,0.545,30,54,0.556,18,34,0.529,10,11,0.909,124
1083,MIA,2023-12-18,108,,MIN,0,240,41,87,0.471,30,57,0.526,11,30,0.367,15,18,0.833,108,42,85,0.494,31,56,0.554,11,29,0.379,17,19,0.895,112
1084,BRK,2023-12-18,108,@,UTA,0,240,39,90,0.433,23,51,0.451,16,39,0.41,14,20,0.7,108,45,91,0.495,31,57,0.544,14,34,0.412,21,24,0.875,125
1085,CHI,2023-12-18,108,@,PHI,1,240,42,89,0.472,30,60,0.5,12,29,0.414,12,15,0.8,108,38,88,0.432,27,56,0.482,11,32,0.344,17,19,0.895,104
1086,WAS,2023-12-17,108,@,PHO,0,240,39,95,0.411,25,49,0.51,14,46,0.304,16,20,0.8,108,41,90,0.456,34,59,0.576,7,31,0.226,23,30,0.767,112
1087,MEM,2023-12-01,108,@,DAL,1,240,44,90,0.489,33,56,0.589,11,34,0.324,9,11,0.818,108,34,92,0.37,22,53,0.415,12,39,0.308,14,21,0.667,94
1088,MIL,2023-11-26,108,,POR,1,240,35,89,0.393,21,47,0.447,14,42,0.333,24,32,0.75,108,37,91,0.407,24,59,0.407,13,32,0.406,15,20,0.75,102
1089,WAS,2023-11-25,108,,ATL,0,240,43,88,0.489,33,50,0.66,10,38,0.263,12,12,1.0,108,52,102,0.51,34,65,0.523,18,37,0.486,14,20,0.7,136
1090,CHI,2023-11-24,108,@,TOR,0,240,42,82,0.512,30,55,0.545,12,27,0.444,12,19,0.632,108,44,83,0.53,31,44,0.705,13,39,0.333,20,27,0.741,121
1091,SAS,2023-11-18,108,,MEM,0,240,36,83,0.434,21,43,0.488,15,40,0.375,21,26,0.808,108,40,86,0.465,29,53,0.547,11,33,0.333,29,36,0.806,120
1092,CHO,2023-11-18,108,,NYK,0,240,40,82,0.488,23,47,0.489,17,35,0.486,11,13,0.846,108,46,91,0.505,30,54,0.556,16,37,0.432,14,19,0.737,122
1093,CLE,2023-11-17,108,,DET,1,240,42,82,0.512,33,61,0.541,9,21,0.429,15,21,0.714,108,39,91,0.429,30,56,0.536,9,35,0.257,13,15,0.867,100
1094,BOS,2023-11-17,108,@,TOR,1,240,42,92,0.457,26,46,0.565,16,46,0.348,8,9,0.889,108,42,87,0.483,30,54,0.556,12,33,0.364,9,14,0.643,105
1095,LAC,2023-11-14,108,@,DEN,0,240,37,86,0.43,24,57,0.421,13,29,0.448,21,24,0.875,108,39,73,0.534,31,50,0.62,8,23,0.348,25,32,0.781,111
1096,DET,2023-11-12,108,@,CHI,0,240,38,88,0.432,27,56,0.482,11,32,0.344,21,26,0.808,108,44,91,0.484,33,61,0.541,11,30,0.367,20,25,0.8,119
1097,DEN,2023-11-08,108,,GSW,1,240,41,92,0.446,30,57,0.526,11,35,0.314,15,22,0.682,108,37,86,0.43,26,51,0.51,11,35,0.314,20,26,0.769,105
1098,MIA,2023-11-08,108,@,MEM,1,240,35,77,0.455,24,49,0.49,11,28,0.393,27,32,0.844,108,35,90,0.389,24,53,0.453,11,37,0.297,21,28,0.75,102
1099,MIA,2023-11-06,108,,LAL,1,240,41,88,0.466,29,51,0.569,12,37,0.324,14,16,0.875,108,44,81,0.543,36,55,0.655,8,26,0.308,11,14,0.786,107
1100,DEN,2023-10-27,108,@,MEM,1,240,41,88,0.466,27,51,0.529,14,37,0.378,12,18,0.667,108,37,85,0.435,27,52,0.519,10,33,0.303,20,24,0.833,104
1101,OKC,2023-10-27,108,@,CLE,1,240,40,87,0.46,27,61,0.443,13,26,0.5,15,19,0.789,108,38,92,0.413,26,47,0.553,12,45,0.267,17,23,0.739,105
1102,BOS,2023-10-25,108,@,NYK,1,240,37,77,0.481,25,38,0.658,12,39,0.308,22,26,0.846,108,36,97,0.371,18,56,0.321,18,41,0.439,14,26,0.538,104
1103,PHO,2023-10-24,108,@,GSW,1,240,42,95,0.442,31,62,0.5,11,33,0.333,13,17,0.765,108,36,101,0.356,26,58,0.448,10,43,0.233,22,28,0.786,104
1104,BRK,2024-02-06,107,,DAL,0,240,41,91,0.451,29,58,0.5,12,33,0.364,13,15,0.867,107,46,91,0.505,27,48,0.563,19,43,0.442,8,13,0.615,119
1105,PHI,2024-01-30,107,@,GSW,0,240,39,85,0.459,26,55,0.473,13,30,0.433,16,21,0.762,107,44,79,0.557,30,47,0.638,14,32,0.438,17,19,0.895,119
1106,CHI,2024-01-30,107,,TOR,0,240,38,75,0.507,27,43,0.628,11,32,0.344,20,27,0.741,107,43,83,0.518,29,54,0.537,14,29,0.483,18,20,0.9,118
1107,MIN,2024-01-29,107,@,OKC,1,240,40,83,0.482,26,54,0.481,14,29,0.483,13,15,0.867,107,35,79,0.443,21,44,0.477,14,35,0.4,17,22,0.773,101
1108,MIL,2024-01-29,107,@,DEN,0,240,36,84,0.429,20,44,0.455,16,40,0.4,19,25,0.76,107,44,91,0.484,40,73,0.548,4,18,0.222,21,24,0.875,113
1109,TOR,2024-01-26,107,,LAC,0,240,44,96,0.458,38,64,0.594,6,32,0.188,13,22,0.591,107,48,95,0.505,39,63,0.619,9,32,0.281,22,24,0.917,127
1110,OKC,2024-01-26,107,@,NOP,1,240,42,88,0.477,32,55,0.582,10,33,0.303,13,14,0.929,107,32,82,0.39,23,46,0.5,9,36,0.25,10,14,0.714,83
1111,MEM,2024-01-26,107,,ORL,1,240,42,90,0.467,27,49,0.551,15,41,0.366,8,13,0.615,107,38,81,0.469,29,47,0.617,9,34,0.265,21,29,0.724,106
1112,WAS,2024-01-24,107,,MIN,0,240,37,77,0.481,27,53,0.509,10,24,0.417,23,29,0.793,107,42,100,0.42,33,68,0.485,9,32,0.281,25,29,0.862,118
1113,ATL,2024-01-22,107,@,SAC,0,240,36,93,0.387,22,53,0.415,14,40,0.35,21,27,0.778,107,43,93,0.462,31,55,0.564,12,38,0.316,24,27,0.889,122
1114,HOU,2024-01-21,107,,BOS,0,240,41,94,0.436,31,59,0.525,10,35,0.286,15,22,0.682,107,43,98,0.439,26,51,0.51,17,47,0.362,13,18,0.722,116
1115,GSW,2024-01-15,107,@,MEM,0,240,44,90,0.489,34,59,0.576,10,31,0.323,9,10,0.9,107,32,86,0.372,12,32,0.375,20,54,0.37,32,40,0.8,116
1116,ORL,2023-12-31,107,@,PHO,0,240,42,90,0.467,30,53,0.566,12,37,0.324,11,12,0.917,107,44,88,0.5,36,61,0.59,8,27,0.296,16,19,0.842,112
1117,CHO,2023-12-15,107,,NOP,0,240,41,92,0.446,32,61,0.525,9,31,0.29,16,21,0.762,107,38,80,0.475,29,53,0.547,9,27,0.333,27,32,0.844,112
1118,CLE,2023-12-14,107,@,BOS,0,240,40,83,0.482,29,50,0.58,11,33,0.333,16,17,0.941,107,43,85,0.506,30,49,0.612,13,36,0.361,17,20,0.85,116
1119,MIN,2023-12-11,107,@,NOP,0,240,40,91,0.44,27,55,0.491,13,36,0.361,14,19,0.737,107,40,82,0.488,30,55,0.545,10,27,0.37,31,40,0.775,121
1120,LAL,2023-12-02,107,,HOU,1,240,40,89,0.449,32,62,0.516,8,27,0.296,19,27,0.704,107,36,89,0.404,25,58,0.431,11,31,0.355,14,18,0.778,97
1121,DET,2023-11-29,107,,LAL,0,240,40,97,0.412,25,61,0.41,15,36,0.417,12,14,0.857,107,45,88,0.511,33,54,0.611,12,34,0.353,31,38,0.816,133
1122,DET,2023-11-27,107,,WAS,0,240,43,102,0.422,35,64,0.547,8,38,0.211,13,19,0.684,107,45,89,0.506,35,60,0.583,10,29,0.345,26,28,0.929,126
1123,LAC,2023-11-25,107,,DAL,1,240,38,88,0.432,30,59,0.508,8,29,0.276,23,31,0.742,107,34,91,0.374,25,53,0.472,9,38,0.237,11,14,0.786,88
1124,TOR,2023-11-21,107,@,ORL,0,240,38,75,0.507,24,47,0.511,14,28,0.5,17,22,0.773,107,50,100,0.5,38,69,0.551,12,31,0.387,14,20,0.7,126
1125,POR,2023-11-21,107,@,PHO,0,240,38,87,0.437,24,56,0.429,14,31,0.452,17,20,0.85,107,43,76,0.566,36,59,0.61,7,17,0.412,27,28,0.964,120
1126,DEN,2023-11-20,107,@,DET,1,240,40,87,0.46,29,59,0.492,11,28,0.393,16,21,0.762,107,36,81,0.444,29,60,0.483,7,21,0.333,24,26,0.923,103
1127,LAL,2023-11-17,107,@,POR,1,240,40,81,0.494,28,52,0.538,12,29,0.414,15,22,0.682,107,36,89,0.404,26,52,0.5,10,37,0.27,13,18,0.722,95
1128,PHI,2023-11-15,107,,BOS,0,240,39,85,0.459,28,55,0.509,11,30,0.367,18,22,0.818,107,42,88,0.477,24,38,0.632,18,50,0.36,15,19,0.789,117
1129,MEM,2023-11-14,107,@,LAL,0,240,39,106,0.368,19,53,0.358,20,53,0.377,9,12,0.75,107,47,81,0.58,25,46,0.543,22,35,0.629,18,24,0.75,134
1130,WAS,2023-11-13,107,@,TOR,0,240,43,84,0.512,31,58,0.534,12,26,0.462,9,12,0.75,107,45,90,0.5,41,70,0.586,4,20,0.2,17,25,0.68,111
1131,HOU,2023-11-12,107,,DEN,1,240,37,87,0.425,27,55,0.491,10,32,0.313,23,29,0.793,107,42,91,0.462,33,59,0.559,9,32,0.281,11,14,0.786,104
1132,CHO,2023-11-12,107,@,NYK,0,240,44,94,0.468,32,59,0.542,12,35,0.343,7,11,0.636,107,47,87,0.54,32,51,0.627,15,36,0.417,20,30,0.667,129
1133,BRK,2023-11-10,107,@,BOS,0,240,38,85,0.447,23,48,0.479,15,37,0.405,16,18,0.889,107,41,94,0.436,22,42,0.524,19,52,0.365,20,28,0.714,121
1134,LAL,2023-11-06,107,@,MIA,0,240,44,81,0.543,36,55,0.655,8,26,0.308,11,14,0.786,107,41,88,0.466,29,51,0.569,12,37,0.324,14,16,0.875,108
1135,HOU,2023-11-04,107,,SAC,1,240,40,87,0.46,27,51,0.529,13,36,0.361,14,20,0.7,107,32,84,0.381,21,43,0.488,11,41,0.268,14,19,0.737,89
1136,CHI,2023-11-03,107,,BRK,0,240,43,89,0.483,32,61,0.525,11,28,0.393,10,14,0.714,107,44,96,0.458,26,51,0.51,18,45,0.4,3,5,0.6,109
1137,WAS,2023-10-30,107,,BOS,0,240,39,87,0.448,28,51,0.549,11,36,0.306,18,26,0.692,107,51,102,0.5,32,49,0.653,19,53,0.358,5,7,0.714,126
1138,TOR,2023-10-28,107,,PHI,0,240,38,87,0.437,21,55,0.382,17,32,0.531,14,19,0.737,107,43,86,0.5,33,58,0.569,10,28,0.357,18,21,0.857,114
1139,LAL,2023-10-24,107,@,DEN,0,240,41,90,0.456,31,61,0.508,10,29,0.345,15,20,0.75,107,48,91,0.527,34,57,0.596,14,34,0.412,9,12,0.75,119
1140,LAC,2024-02-07,106,,NOP,0,240,36,78,0.462,24,46,0.522,12,32,0.375,22,26,0.846,106,47,88,0.534,35,56,0.625,12,32,0.375,11,16,0.688,117
1141,WAS,2024-02-07,106,,CLE,0,240,42,94,0.447,26,54,0.481,16,40,0.4,6,9,0.667,106,43,88,0.489,31,53,0.585,12,35,0.343,16,22,0.727,114
1142,MIL,2024-02-06,106,@,PHO,0,240,39,90,0.433,26,50,0.52,13,40,0.325,15,25,0.6,106,44,87,0.506,36,59,0.61,8,28,0.286,18,27,0.667,114
1143,TOR,2024-02-02,106,@,HOU,0,240,40,91,0.44,29,58,0.5,11,33,0.333,15,20,0.75,106,55,93,0.591,44,62,0.71,11,31,0.355,14,17,0.824,135
1144,CHO,2024-02-02,106,@,OKC,0,240,41,92,0.446,27,61,0.443,14,31,0.452,10,14,0.714,106,44,75,0.587,27,39,0.692,17,36,0.472,21,27,0.778,126
1145,MIN,2024-02-02,106,,ORL,0,240,38,82,0.463,26,44,0.591,12,38,0.316,18,20,0.9,106,39,85,0.459,30,60,0.5,9,25,0.36,21,26,0.808,108
1146,SAC,2024-01-31,106,@,MIA,0,240,41,93,0.441,29,53,0.547,12,40,0.3,12,18,0.667,106,42,84,0.5,29,56,0.518,13,28,0.464,18,23,0.783,115
1147,BRK,2024-01-27,106,,HOU,1,240,36,74,0.486,24,40,0.6,12,34,0.353,22,37,0.595,106,37,94,0.394,27,57,0.474,10,37,0.27,20,23,0.87,104
1148,ORL,2024-01-26,106,@,MEM,0,240,38,81,0.469,29,47,0.617,9,34,0.265,21,29,0.724,106,42,90,0.467,27,49,0.551,15,41,0.366,8,13,0.615,107
1149,CHO,2024-01-24,106,@,DET,0,240,38,87,0.437,23,49,0.469,15,38,0.395,15,19,0.789,106,43,86,0.5,28,48,0.583,15,38,0.395,12,20,0.6,113
1150,ATL,2024-01-17,106,,ORL,1,240,39,76,0.513,31,51,0.608,8,25,0.32,20,22,0.909,106,39,88,0.443,29,53,0.547,10,35,0.286,16,22,0.727,104
1151,NYK,2024-01-13,106,@,MEM,1,240,40,83,0.482,27,45,0.6,13,38,0.342,13,19,0.684,106,36,87,0.414,27,49,0.551,9,38,0.237,13,15,0.867,94
1152,LAL,2024-01-07,106,,LAC,1,240,42,82,0.512,31,53,0.585,11,29,0.379,11,16,0.688,106,36,91,0.396,22,54,0.407,14,37,0.378,17,19,0.895,103
1153,MIN,2024-01-03,106,,NOP,0,240,37,82,0.451,27,51,0.529,10,31,0.323,22,27,0.815,106,45,81,0.556,33,55,0.6,12,26,0.462,15,17,0.882,117
1154,MEM,2024-01-02,106,,SAS,1,240,37,80,0.463,25,42,0.595,12,38,0.316,20,25,0.8,106,36,85,0.424,26,54,0.481,10,31,0.323,16,23,0.696,98
1155,MIN,2024-01-01,106,@,NYK,0,240,36,76,0.474,25,48,0.521,11,28,0.393,23,29,0.793,106,39,89,0.438,27,55,0.491,12,34,0.353,22,28,0.786,112
1156,LAL,2023-12-30,106,@,MIN,0,240,37,88,0.42,30,64,0.469,7,24,0.292,25,32,0.781,106,38,76,0.5,26,42,0.619,12,34,0.353,20,24,0.833,108
1157,MEM,2023-12-29,106,@,LAC,0,240,38,87,0.437,25,47,0.532,13,40,0.325,17,20,0.85,106,43,87,0.494,32,48,0.667,11,39,0.282,20,25,0.8,117
1158,MIN,2023-12-26,106,@,OKC,0,240,34,73,0.466,22,46,0.478,12,27,0.444,26,32,0.813,106,49,81,0.605,31,42,0.738,18,39,0.462,13,16,0.813,129
1159,HOU,2023-12-23,106,@,NOP,1,240,35,82,0.427,26,53,0.491,9,29,0.31,27,35,0.771,106,38,82,0.463,30,51,0.588,8,31,0.258,20,29,0.69,104
1160,POR,2023-12-23,106,@,GSW,0,240,38,84,0.452,25,49,0.51,13,35,0.371,17,25,0.68,106,48,83,0.578,38,50,0.76,10,33,0.303,20,24,0.833,126
1161,ORL,2023-12-20,106,,MIA,0,240,41,89,0.461,32,53,0.604,9,36,0.25,15,19,0.789,106,40,83,0.482,25,54,0.463,15,29,0.517,20,24,0.833,115
1162,CHI,2023-12-12,106,,DEN,0,240,36,86,0.419,23,46,0.5,13,40,0.325,21,23,0.913,106,39,83,0.47,25,53,0.472,14,30,0.467,22,32,0.688,114
1163,DEN,2023-12-08,106,,HOU,0,240,38,90,0.422,28,62,0.452,10,28,0.357,20,27,0.741,106,35,82,0.427,22,43,0.512,13,39,0.333,31,42,0.738,114
1164,PHO,2023-12-08,106,,SAC,0,240,40,83,0.482,29,51,0.569,11,32,0.344,15,23,0.652,106,42,92,0.457,28,53,0.528,14,39,0.359,16,20,0.8,114
1165,POR,2023-12-06,106,@,GSW,0,240,39,95,0.411,23,49,0.469,16,46,0.348,12,16,0.75,106,36,86,0.419,26,52,0.5,10,34,0.294,28,33,0.848,110
1166,LAL,2023-12-05,106,,PHO,1,240,38,102,0.373,29,72,0.403,9,30,0.3,21,25,0.84,106,37,75,0.493,25,50,0.5,12,25,0.48,17,21,0.81,103
1167,SAS,2023-12-01,106,@,NOP,0,240,38,83,0.458,22,44,0.5,16,39,0.41,14,17,0.824,106,42,85,0.494,32,54,0.593,10,31,0.323,27,29,0.931,121
1168,TOR,2023-12-01,106,,NYK,0,240,44,100,0.44,38,68,0.559,6,32,0.188,12,17,0.706,106,45,90,0.5,29,54,0.537,16,36,0.444,13,16,0.813,119
1169,MIN,2023-11-28,106,,OKC,1,240,33,78,0.423,19,45,0.422,14,33,0.424,26,32,0.813,106,37,90,0.411,26,60,0.433,11,30,0.367,18,23,0.783,103
1170,LAC,2023-11-24,106,,NOP,0,240,42,92,0.457,31,55,0.564,11,37,0.297,11,17,0.647,106,43,88,0.489,33,64,0.516,10,24,0.417,20,27,0.741,116
1171,LAC,2023-11-17,106,,HOU,1,240,36,83,0.434,23,49,0.469,13,34,0.382,21,30,0.7,106,38,88,0.432,28,57,0.491,10,31,0.323,14,20,0.7,100
1172,DET,2023-11-10,106,,PHI,0,240,40,86,0.465,32,58,0.552,8,28,0.286,18,22,0.818,106,35,83,0.422,26,55,0.473,9,28,0.321,35,41,0.854,114
1173,PHI,2023-11-08,106,,BOS,1,240,42,95,0.442,33,61,0.541,9,34,0.265,13,15,0.867,106,36,91,0.396,21,44,0.477,15,47,0.319,16,19,0.842,103
1174,DET,2023-11-05,106,,PHO,0,240,43,87,0.494,35,64,0.547,8,23,0.348,12,14,0.857,106,43,86,0.5,35,65,0.538,8,21,0.381,26,29,0.897,120
1175,OKC,2023-11-01,106,,NOP,0,240,38,88,0.432,31,54,0.574,7,34,0.206,23,25,0.92,106,40,102,0.392,27,60,0.45,13,42,0.31,17,29,0.586,110
1176,LAL,2023-10-30,106,,ORL,1,240,42,79,0.532,34,52,0.654,8,27,0.296,14,18,0.778,106,38,95,0.4,24,60,0.4,14,35,0.4,13,18,0.722,103
1177,GSW,2023-10-29,106,@,HOU,1,240,35,81,0.432,17,36,0.472,18,45,0.4,18,23,0.783,106,34,90,0.378,25,57,0.439,9,33,0.273,18,19,0.947,95
1178,MEM,2023-10-28,106,@,WAS,0,240,39,91,0.429,20,44,0.455,19,47,0.404,9,9,1.0,106,40,93,0.43,24,47,0.511,16,46,0.348,17,22,0.773,113
1179,MIN,2023-10-28,106,,MIA,1,240,44,86,0.512,32,52,0.615,12,34,0.353,6,8,0.75,106,35,87,0.402,23,49,0.469,12,38,0.316,8,14,0.571,90
1180,NYK,2024-02-03,105,,LAL,0,240,41,100,0.41,31,65,0.477,10,35,0.286,13,15,0.867,105,39,80,0.488,27,49,0.551,12,31,0.387,23,27,0.852,113
1181,BOS,2024-02-01,105,,LAL,0,240,41,97,0.423,25,49,0.51,16,48,0.333,7,7,1.0,105,38,94,0.404,19,58,0.328,19,36,0.528,19,26,0.731,114
1182,IND,2024-02-01,105,@,NYK,0,240,42,93,0.452,29,60,0.483,13,33,0.394,8,13,0.615,105,41,103,0.398,33,65,0.508,8,38,0.211,19,25,0.76,109
1183,OKC,2024-01-31,105,,DEN,1,240,37,87,0.425,26,61,0.426,11,26,0.423,20,25,0.8,105,37,93,0.398,22,56,0.393,15,37,0.405,11,16,0.688,100
1184,MIA,2024-01-29,105,,PHO,0,240,33,84,0.393,19,48,0.396,14,36,0.389,25,25,1.0,105,46,94,0.489,32,54,0.593,14,40,0.35,12,17,0.706,118
1185,PHI,2024-01-27,105,@,DEN,0,240,43,81,0.531,37,59,0.627,6,22,0.273,13,16,0.813,105,37,82,0.451,24,45,0.533,13,37,0.351,24,38,0.632,111
1186,MEM,2024-01-24,105,@,MIA,1,240,36,80,0.45,19,44,0.432,17,36,0.472,16,19,0.842,105,33,82,0.402,22,48,0.458,11,34,0.324,19,25,0.76,96
1187,ORL,2024-01-21,105,,MIA,1,240,37,78,0.474,28,50,0.56,9,28,0.321,22,28,0.786,105,30,80,0.375,18,43,0.419,12,37,0.324,15,18,0.833,87
1188,POR,2024-01-17,105,,BRK,1,240,42,86,0.488,33,59,0.559,9,27,0.333,12,14,0.857,105,35,73,0.479,20,35,0.571,15,38,0.395,18,27,0.667,103
1189,BOS,2024-01-15,105,@,TOR,1,240,33,82,0.402,17,43,0.395,16,39,0.41,23,25,0.92,105,38,95,0.4,34,63,0.54,4,32,0.125,16,21,0.762,96
1190,IND,2024-01-15,105,@,UTA,0,240,38,95,0.4,29,64,0.453,9,31,0.29,20,25,0.8,105,45,81,0.556,34,56,0.607,11,25,0.44,31,35,0.886,132
1191,OKC,2024-01-15,105,@,LAL,0,240,40,96,0.417,25,47,0.532,15,49,0.306,10,11,0.909,105,44,84,0.524,36,60,0.6,8,24,0.333,16,18,0.889,112
1192,LAC,2024-01-14,105,@,MIN,0,240,36,83,0.434,19,44,0.432,17,39,0.436,16,18,0.889,105,38,67,0.567,25,41,0.61,13,26,0.5,20,31,0.645,109
1193,GSW,2024-01-10,105,,NOP,0,240,39,89,0.438,27,50,0.54,12,39,0.308,15,18,0.833,105,54,94,0.574,35,54,0.648,19,40,0.475,14,19,0.737,141
1194,WAS,2024-01-06,105,,NYK,0,240,40,85,0.471,27,48,0.563,13,37,0.351,12,20,0.6,105,43,87,0.494,29,51,0.569,14,36,0.389,21,24,0.875,121
1195,CHI,2023-12-30,105,,PHI,1,240,40,79,0.506,33,54,0.611,7,25,0.28,18,30,0.6,105,36,92,0.391,27,54,0.5,9,38,0.237,11,15,0.733,92
1196,UTA,2023-12-28,105,@,NOP,0,240,36,85,0.424,24,46,0.522,12,39,0.308,21,25,0.84,105,45,82,0.549,35,55,0.636,10,27,0.37,12,15,0.8,112
1197,POR,2023-12-28,105,,SAS,0,240,35,101,0.347,24,65,0.369,11,36,0.306,24,32,0.75,105,41,85,0.482,31,49,0.633,10,36,0.278,26,28,0.929,118
1198,MEM,2023-12-28,105,@,DEN,0,240,37,89,0.416,24,54,0.444,13,35,0.371,18,25,0.72,105,55,96,0.573,35,55,0.636,20,41,0.488,12,14,0.857,142
1199,PHO,2023-12-22,105,@,SAC,0,240,39,88,0.443,34,63,0.54,5,25,0.2,22,28,0.786,105,44,83,0.53,32,45,0.711,12,38,0.316,20,26,0.769,120
1200,MEM,2023-11-29,105,,UTA,1,240,43,87,0.494,30,48,0.625,13,39,0.333,6,8,0.75,105,34,90,0.378,18,51,0.353,16,39,0.41,7,12,0.583,91
1201,MEM,2023-11-29,105,,UTA,1,240,43,87,0.494,30,48,0.625,13,39,0.333,6,8,0.75,105,34,90,0.378,18,51,0.353,16,39,0.41,7,12,0.583,91
1202,ATL,2023-11-28,105,@,CLE,0,240,35,101,0.347,22,57,0.386,13,44,0.295,22,24,0.917,105,50,93,0.538,37,57,0.649,13,36,0.361,15,17,0.882,128
1203,CLE,2023-11-26,105,,TOR,1,240,45,97,0.464,35,66,0.53,10,31,0.323,5,6,0.833,105,37,89,0.416,29,57,0.509,8,32,0.25,20,29,0.69,102
1204,UTA,2023-11-25,105,,NOP,1,240,38,87,0.437,23,44,0.523,15,43,0.349,14,17,0.824,105,39,93,0.419,28,57,0.491,11,36,0.306,11,18,0.611,100
1205,HOU,2023-11-24,105,,DEN,1,240,40,82,0.488,28,53,0.528,12,29,0.414,13,15,0.867,105,32,94,0.34,25,64,0.391,7,30,0.233,15,21,0.714,86
1206,UTA,2023-11-22,105,@,POR,0,240,37,79,0.468,27,48,0.563,10,31,0.323,21,26,0.808,105,47,92,0.511,30,53,0.566,17,39,0.436,10,15,0.667,121
1207,LAL,2023-11-19,105,,HOU,1,240,39,83,0.47,33,54,0.611,6,29,0.207,21,29,0.724,105,41,84,0.488,27,47,0.574,14,37,0.378,8,10,0.8,104
1208,TOR,2023-11-17,105,,BOS,0,240,42,87,0.483,30,54,0.556,12,33,0.364,9,14,0.643,105,42,92,0.457,26,46,0.565,16,46,0.348,8,9,0.889,108
1209,CHO,2023-11-14,105,,MIA,0,240,36,81,0.444,21,49,0.429,15,32,0.469,18,22,0.818,105,40,83,0.482,32,52,0.615,8,31,0.258,23,28,0.821,111
1210,MEM,2023-11-12,105,@,LAC,1,240,37,88,0.42,24,47,0.511,13,41,0.317,18,24,0.75,105,37,85,0.435,25,51,0.49,12,34,0.353,15,23,0.652,101
1211,SAC,2023-11-10,105,,OKC,1,240,38,91,0.418,25,44,0.568,13,47,0.277,16,21,0.762,105,39,87,0.448,32,57,0.561,7,30,0.233,13,16,0.813,98
1212,SAS,2023-11-08,105,@,NYK,0,240,44,90,0.489,35,56,0.625,9,34,0.265,8,13,0.615,105,46,100,0.46,27,58,0.466,19,42,0.452,15,22,0.682,126
1213,GSW,2023-11-08,105,@,DEN,0,240,37,86,0.43,26,51,0.51,11,35,0.314,20,26,0.769,105,41,92,0.446,30,57,0.526,11,35,0.314,15,22,0.682,108
1214,NOP,2023-11-04,105,,ATL,0,240,40,84,0.476,32,53,0.604,8,31,0.258,17,21,0.81,105,45,93,0.484,31,52,0.596,14,41,0.341,19,24,0.792,123
1215,NYK,2023-11-03,105,@,MIL,0,240,38,96,0.396,28,57,0.491,10,39,0.256,19,25,0.76,105,35,82,0.427,15,43,0.349,20,39,0.513,20,28,0.714,110
1216,MIA,2023-11-01,105,,BRK,0,240,39,91,0.429,26,53,0.491,13,38,0.342,14,18,0.778,105,37,82,0.451,21,46,0.457,16,36,0.444,19,26,0.731,109
1217,CHI,2023-11-01,105,@,DAL,0,240,42,89,0.472,31,56,0.554,11,33,0.333,10,11,0.909,105,37,81,0.457,17,33,0.515,20,48,0.417,20,28,0.714,114
1218,IND,2023-10-30,105,,CHI,0,240,36,88,0.409,24,42,0.571,12,46,0.261,21,25,0.84,105,40,87,0.46,34,70,0.486,6,17,0.353,26,31,0.839,112
1219,CLE,2023-10-27,105,,OKC,0,240,38,92,0.413,26,47,0.553,12,45,0.267,17,23,0.739,105,40,87,0.46,27,61,0.443,13,26,0.5,15,19,0.789,108
1220,PHI,2024-02-07,104,,GSW,0,240,41,98,0.418,33,66,0.5,8,32,0.25,14,14,1.0,104,47,94,0.5,31,56,0.554,16,38,0.421,17,22,0.773,127
1221,SAS,2024-02-07,104,@,MIA,0,240,41,90,0.456,29,53,0.547,12,37,0.324,10,17,0.588,104,43,87,0.494,31,49,0.633,12,38,0.316,18,23,0.783,116
1222,PHI,2024-01-29,104,@,POR,0,240,37,83,0.446,32,54,0.593,5,29,0.172,25,28,0.893,104,46,84,0.548,34,56,0.607,12,28,0.429,26,29,0.897,130
1223,CHI,2024-01-28,104,@,POR,1,240,42,90,0.467,34,58,0.586,8,32,0.25,12,17,0.706,104,32,79,0.405,26,46,0.565,6,33,0.182,26,29,0.897,96
1224,OKC,2024-01-28,104,@,DET,0,240,44,92,0.478,36,64,0.563,8,28,0.286,8,12,0.667,104,47,95,0.495,36,69,0.522,11,26,0.423,15,19,0.789,120
1225,DET,2024-01-27,104,,WAS,0,240,37,85,0.435,28,53,0.528,9,32,0.281,21,27,0.778,104,45,100,0.45,34,66,0.515,11,34,0.324,17,21,0.81,118
1226,HOU,2024-01-27,104,@,BRK,0,240,37,94,0.394,27,57,0.474,10,37,0.27,20,23,0.87,104,36,74,0.486,24,40,0.6,12,34,0.353,22,37,0.595,106
1227,CHO,2024-01-26,104,,HOU,0,240,35,85,0.412,26,56,0.464,9,29,0.31,25,32,0.781,104,50,89,0.562,37,56,0.661,13,33,0.394,25,31,0.806,138
1228,WAS,2024-01-21,104,,DEN,0,240,39,91,0.429,31,64,0.484,8,27,0.296,18,22,0.818,104,43,88,0.489,35,66,0.53,8,22,0.364,19,28,0.679,113
1229,ORL,2024-01-17,104,@,ATL,0,240,39,88,0.443,29,53,0.547,10,35,0.286,16,22,0.727,104,39,76,0.513,31,51,0.608,8,25,0.32,20,22,0.909,106
1230,MIA,2024-01-14,104,,CHO,1,240,40,81,0.494,29,56,0.518,11,25,0.44,13,16,0.813,104,33,95,0.347,23,54,0.426,10,41,0.244,11,15,0.733,87
1231,WAS,2024-01-10,104,@,IND,0,240,38,88,0.432,31,57,0.544,7,31,0.226,21,30,0.7,104,41,92,0.446,33,67,0.493,8,25,0.32,22,24,0.917,112
1232,CHI,2024-01-05,104,,CHO,1,240,40,74,0.541,30,46,0.652,10,28,0.357,14,17,0.824,104,36,89,0.404,26,55,0.473,10,34,0.294,9,12,0.75,91
1233,SAC,2024-01-02,104,,CHO,0,240,40,92,0.435,26,56,0.464,14,36,0.389,10,17,0.588,104,42,82,0.512,30,48,0.625,12,34,0.353,15,19,0.789,111
1234,MIA,2024-01-01,104,@,LAC,0,240,35,83,0.422,24,49,0.49,11,34,0.324,23,29,0.793,104,47,80,0.588,33,51,0.647,14,29,0.483,13,14,0.929,121
1235,BRK,2023-12-29,104,@,WAS,0,240,39,91,0.429,30,63,0.476,9,28,0.321,17,27,0.63,104,46,91,0.505,31,53,0.585,15,38,0.395,3,7,0.429,110
1236,CHI,2023-12-28,104,,IND,0,240,40,97,0.412,33,70,0.471,7,27,0.259,17,22,0.773,104,43,85,0.506,24,43,0.558,19,42,0.452,15,22,0.682,120
1237,CHO,2023-12-26,104,@,LAC,0,240,43,93,0.462,37,64,0.578,6,29,0.207,12,16,0.75,104,40,85,0.471,26,51,0.51,14,34,0.412,19,25,0.76,113
1238,NOP,2023-12-23,104,,HOU,0,240,38,82,0.463,30,51,0.588,8,31,0.258,20,29,0.69,104,35,82,0.427,26,53,0.491,9,29,0.31,27,35,0.771,106
1239,CLE,2023-12-21,104,,NOP,0,240,41,87,0.471,24,43,0.558,17,44,0.386,5,8,0.625,104,47,86,0.547,32,51,0.627,15,35,0.429,14,16,0.875,123
1240,TOR,2023-12-20,104,,DEN,0,240,43,90,0.478,34,63,0.54,9,27,0.333,9,13,0.692,104,49,98,0.5,37,65,0.569,12,33,0.364,3,7,0.429,113
1241,PHO,2023-12-19,104,@,POR,0,240,42,94,0.447,37,71,0.521,5,23,0.217,15,21,0.714,104,39,87,0.448,25,59,0.424,14,28,0.5,17,19,0.895,109
1242,PHI,2023-12-18,104,,CHI,0,240,38,88,0.432,27,56,0.482,11,32,0.344,17,19,0.895,104,42,89,0.472,30,60,0.5,12,29,0.414,12,15,0.8,108
1243,DAL,2023-12-18,104,@,DEN,0,240,41,92,0.446,28,54,0.519,13,38,0.342,9,19,0.474,104,49,87,0.563,35,61,0.574,14,26,0.538,18,22,0.818,130
1244,UTA,2023-12-16,104,@,SAC,0,240,38,86,0.442,26,49,0.531,12,37,0.324,16,21,0.762,104,46,85,0.541,24,40,0.6,22,45,0.489,11,15,0.733,125
1245,TOR,2023-12-15,104,,ATL,0,240,40,77,0.519,30,46,0.652,10,31,0.323,14,25,0.56,104,52,101,0.515,36,60,0.6,16,41,0.39,5,6,0.833,125
1246,MEM,2023-12-13,104,@,HOU,0,240,35,82,0.427,25,44,0.568,10,38,0.263,24,34,0.706,104,39,86,0.453,27,54,0.5,12,32,0.375,27,37,0.73,117
1247,CHO,2023-12-13,104,@,MIA,0,240,41,77,0.532,29,46,0.63,12,31,0.387,10,11,0.909,104,41,86,0.477,26,56,0.464,15,30,0.5,18,19,0.947,115
1248,ORL,2023-12-11,104,,CLE,1,240,39,84,0.464,32,58,0.552,7,26,0.269,19,25,0.76,104,30,85,0.353,21,45,0.467,9,40,0.225,25,33,0.758,94
1249,LAC,2023-11-27,104,,DEN,0,240,35,85,0.412,29,65,0.446,6,20,0.3,28,34,0.824,104,44,92,0.478,34,70,0.486,10,22,0.455,15,28,0.536,113
1250,DAL,2023-11-22,104,@,LAL,1,240,38,96,0.396,22,46,0.478,16,50,0.32,12,16,0.75,104,39,84,0.464,28,55,0.509,11,29,0.379,12,19,0.632,101
1251,HOU,2023-11-19,104,@,LAL,0,240,41,84,0.488,27,47,0.574,14,37,0.378,8,10,0.8,104,39,83,0.47,33,54,0.611,6,29,0.207,21,29,0.724,105
1252,ORL,2023-11-14,104,@,BRK,0,240,36,82,0.439,20,36,0.556,16,46,0.348,16,21,0.762,104,46,85,0.541,27,46,0.587,19,39,0.487,13,20,0.65,124
1253,MIN,2023-11-14,104,@,GSW,1,240,36,81,0.444,22,47,0.468,14,34,0.412,18,21,0.857,104,37,88,0.42,24,49,0.49,13,39,0.333,14,16,0.875,101
1254,DEN,2023-11-12,104,@,HOU,0,240,42,91,0.462,33,59,0.559,9,32,0.281,11,14,0.786,104,37,87,0.425,27,55,0.491,10,32,0.313,23,29,0.793,107
1255,HOU,2023-11-10,104,,NOP,1,240,36,88,0.409,26,53,0.491,10,35,0.286,22,28,0.786,104,34,75,0.453,26,50,0.52,8,25,0.32,25,34,0.735,101
1256,GSW,2023-11-05,104,@,CLE,0,240,34,94,0.362,18,53,0.34,16,41,0.39,20,30,0.667,104,41,83,0.494,30,46,0.652,11,37,0.297,22,28,0.786,115
1257,IND,2023-11-01,104,@,BOS,0,240,46,101,0.455,41,64,0.641,5,37,0.135,7,12,0.583,104,54,95,0.568,34,60,0.567,20,35,0.571,27,28,0.964,155
1258,UTA,2023-10-28,104,@,PHO,0,240,40,91,0.44,28,54,0.519,12,37,0.324,12,14,0.857,104,45,85,0.529,35,48,0.729,10,37,0.27,26,28,0.929,126
1259,CHI,2023-10-27,104,,TOR,1,265,37,99,0.374,29,60,0.483,8,39,0.205,22,28,0.786,104,39,84,0.464,30,48,0.625,9,36,0.25,16,25,0.64,103
1260,MEM,2023-10-27,104,,DEN,0,240,37,85,0.435,27,52,0.519,10,33,0.303,20,24,0.833,104,41,88,0.466,27,51,0.529,14,37,0.378,12,18,0.667,108
1261,CHI,2023-10-25,104,,OKC,0,240,39,94,0.415,27,52,0.519,12,42,0.286,14,18,0.778,104,45,82,0.549,26,43,0.605,19,39,0.487,15,18,0.833,124
1262,MEM,2023-10-25,104,,NOP,0,240,38,91,0.418,26,48,0.542,12,43,0.279,16,20,0.8,104,40,85,0.471,26,53,0.491,14,32,0.438,17,22,0.773,111
1263,NYK,2023-10-25,104,,BOS,0,240,36,97,0.371,18,56,0.321,18,41,0.439,14,26,0.538,104,37,77,0.481,25,38,0.658,12,39,0.308,22,26,0.846,108
1264,GSW,2023-10-24,104,,PHO,0,240,36,101,0.356,26,58,0.448,10,43,0.233,22,28,0.786,104,42,95,0.442,31,62,0.5,11,33,0.333,13,17,0.765,108
1265,LAC,2024-02-04,103,@,MIA,1,240,34,77,0.442,18,38,0.474,16,39,0.41,19,22,0.864,103,38,91,0.418,30,61,0.492,8,30,0.267,11,12,0.917,95
1266,POR,2024-02-04,103,@,DEN,0,240,39,85,0.459,28,54,0.519,11,31,0.355,14,15,0.933,103,42,86,0.488,30,58,0.517,12,28,0.429,16,19,0.842,112
1267,UTA,2024-01-30,103,@,NYK,0,240,39,86,0.453,27,50,0.54,12,36,0.333,13,17,0.765,103,44,94,0.468,31,60,0.517,13,34,0.382,17,18,0.944,118
1268,SAC,2024-01-29,103,@,MEM,1,240,43,84,0.512,32,46,0.696,11,38,0.289,6,10,0.6,103,30,80,0.375,17,44,0.386,13,36,0.361,21,28,0.75,94
1269,BRK,2024-01-23,103,,NYK,0,240,42,95,0.442,27,53,0.509,15,42,0.357,4,5,0.8,103,40,86,0.465,30,57,0.526,10,29,0.345,18,19,0.947,108
1270,MEM,2024-01-18,103,@,MIN,0,240,39,85,0.459,25,51,0.49,14,34,0.412,11,17,0.647,103,45,82,0.549,33,54,0.611,12,28,0.429,16,21,0.762,118
1271,BRK,2024-01-17,103,@,POR,0,240,35,73,0.479,20,35,0.571,15,38,0.395,18,27,0.667,103,42,86,0.488,33,59,0.559,9,27,0.333,12,14,0.857,105
1272,DAL,2024-01-09,103,,MEM,0,240,36,82,0.439,27,55,0.491,9,27,0.333,22,27,0.815,103,44,91,0.484,30,54,0.556,14,37,0.378,18,21,0.857,120
1273,LAC,2024-01-07,103,@,LAL,0,240,36,91,0.396,22,54,0.407,14,37,0.378,17,19,0.895,103,42,82,0.512,31,53,0.585,11,29,0.379,11,16,0.688,106
1274,POR,2024-01-05,103,@,DAL,0,240,39,95,0.411,26,55,0.473,13,40,0.325,12,17,0.706,103,56,96,0.583,39,58,0.672,17,38,0.447,10,15,0.667,139
1275,IND,2023-12-21,103,@,MEM,0,240,38,90,0.422,20,38,0.526,18,52,0.346,9,11,0.818,103,43,84,0.512,27,49,0.551,16,35,0.457,14,21,0.667,116
1276,HOU,2023-12-15,103,@,MEM,1,240,32,88,0.364,21,59,0.356,11,29,0.379,28,32,0.875,103,37,92,0.402,26,52,0.5,11,40,0.275,11,15,0.733,96
1277,MEM,2023-12-08,103,,MIN,0,240,37,86,0.43,22,51,0.431,15,35,0.429,14,19,0.737,103,44,88,0.5,29,50,0.58,15,38,0.395,24,26,0.923,127
1278,UTA,2023-12-08,103,,LAC,0,240,38,84,0.452,29,53,0.547,9,31,0.29,18,24,0.75,103,43,88,0.489,28,54,0.519,15,34,0.441,16,21,0.762,117
1279,TOR,2023-12-06,103,,MIA,0,240,37,86,0.43,23,49,0.469,14,37,0.378,15,17,0.882,103,41,89,0.461,27,51,0.529,14,38,0.368,16,19,0.842,112
1280,PHO,2023-12-05,103,@,LAL,0,240,37,75,0.493,25,50,0.5,12,25,0.48,17,21,0.81,103,38,102,0.373,29,72,0.403,9,30,0.3,21,25,0.84,106
1281,POR,2023-11-30,103,@,CLE,1,240,39,77,0.506,25,42,0.595,14,35,0.4,11,11,1.0,103,38,89,0.427,31,57,0.544,7,32,0.219,12,12,1.0,95
1282,TOR,2023-11-28,103,@,BRK,0,240,39,101,0.386,26,65,0.4,13,36,0.361,12,19,0.632,103,40,89,0.449,27,51,0.529,13,38,0.342,22,26,0.846,115
1283,OKC,2023-11-28,103,@,MIN,0,240,37,90,0.411,26,60,0.433,11,30,0.367,18,23,0.783,103,33,78,0.423,19,45,0.422,14,33,0.424,26,32,0.813,106
1284,ATL,2023-11-26,103,@,BOS,0,240,36,88,0.409,17,35,0.486,19,53,0.358,12,19,0.632,103,42,95,0.442,29,48,0.604,13,47,0.277,16,20,0.8,113
1285,DET,2023-11-20,103,,DEN,0,240,36,81,0.444,29,60,0.483,7,21,0.333,24,26,0.923,103,40,87,0.46,29,59,0.492,11,28,0.393,16,21,0.762,107
1286,ORL,2023-11-17,103,@,CHI,1,240,38,79,0.481,27,45,0.6,11,34,0.324,16,23,0.696,103,35,79,0.443,25,50,0.5,10,29,0.345,17,22,0.773,97
1287,BOS,2023-11-08,103,@,PHI,0,240,36,91,0.396,21,44,0.477,15,47,0.319,16,19,0.842,103,42,95,0.442,33,61,0.541,9,34,0.265,13,15,0.867,106
1288,ORL,2023-10-30,103,@,LAL,0,240,38,95,0.4,24,60,0.4,14,35,0.4,13,18,0.722,103,42,79,0.532,34,52,0.654,8,27,0.296,14,18,0.778,106
1289,TOR,2023-10-27,103,@,CHI,0,265,39,84,0.464,30,48,0.625,9,36,0.25,16,25,0.64,103,37,99,0.374,29,60,0.483,8,39,0.205,22,28,0.786,104
1290,MIA,2023-10-25,103,,DET,1,240,37,92,0.402,29,70,0.414,8,22,0.364,21,26,0.808,103,41,92,0.446,30,60,0.5,11,32,0.344,9,15,0.6,102
1291,PHI,2024-02-05,102,,DAL,0,240,40,93,0.43,32,64,0.5,8,29,0.276,14,20,0.7,102,42,87,0.483,25,44,0.568,17,43,0.395,17,23,0.739,118
1292,WAS,2024-02-02,102,,MIA,0,240,37,90,0.411,26,48,0.542,11,42,0.262,17,21,0.81,102,38,88,0.432,31,57,0.544,7,31,0.226,27,35,0.771,110
1293,OKC,2024-01-20,102,@,MIN,1,240,32,81,0.395,24,57,0.421,8,24,0.333,30,35,0.857,102,31,75,0.413,17,38,0.447,14,37,0.378,21,29,0.724,97
1294,DEN,2024-01-19,102,@,BOS,1,240,42,81,0.519,34,50,0.68,8,31,0.258,10,13,0.769,102,38,89,0.427,24,45,0.533,14,44,0.318,10,14,0.714,100
1295,BRK,2024-01-11,102,@,CLE,0,240,37,82,0.451,29,55,0.527,8,27,0.296,20,28,0.714,102,32,82,0.39,19,38,0.5,13,44,0.295,34,43,0.791,111
1296,BOS,2024-01-11,102,@,MIL,0,240,34,91,0.374,25,56,0.446,9,35,0.257,25,30,0.833,102,52,92,0.565,34,50,0.68,18,42,0.429,13,16,0.813,135
1297,GSW,2023-12-28,102,,MIA,0,240,37,88,0.42,29,55,0.527,8,33,0.242,20,25,0.8,102,44,91,0.484,34,60,0.567,10,31,0.323,16,22,0.727,114
1298,WAS,2023-12-27,102,,TOR,0,240,42,90,0.467,34,57,0.596,8,33,0.242,10,15,0.667,102,52,91,0.571,37,53,0.698,15,38,0.395,13,19,0.684,132
1299,DEN,2023-12-23,102,@,CHO,1,240,39,90,0.433,27,60,0.45,12,30,0.4,12,14,0.857,102,34,88,0.386,26,60,0.433,8,28,0.286,19,23,0.826,95
1300,BRK,2023-12-20,102,,NYK,0,240,37,101,0.366,22,54,0.407,15,47,0.319,13,17,0.765,102,44,95,0.463,31,62,0.5,13,33,0.394,20,25,0.8,121
1301,DET,2023-12-06,102,,MEM,0,240,41,91,0.451,30,56,0.536,11,35,0.314,9,9,1.0,102,47,91,0.516,36,65,0.554,11,26,0.423,11,14,0.786,116
1302,MIN,2023-12-06,102,,SAS,1,240,36,87,0.414,24,47,0.511,12,40,0.3,18,21,0.857,102,38,101,0.376,30,65,0.462,8,36,0.222,10,15,0.667,94
1303,DEN,2023-12-06,102,@,LAC,0,240,41,98,0.418,29,67,0.433,12,31,0.387,8,9,0.889,102,40,87,0.46,28,60,0.467,12,27,0.444,19,25,0.76,111
1304,TOR,2023-11-26,102,@,CLE,0,240,37,89,0.416,29,57,0.509,8,32,0.25,20,29,0.69,102,45,97,0.464,35,66,0.53,10,31,0.323,5,6,0.833,105
1305,POR,2023-11-26,102,@,MIL,0,240,37,91,0.407,24,59,0.407,13,32,0.406,15,20,0.75,102,35,89,0.393,21,47,0.447,14,42,0.333,24,32,0.75,108
1306,SAS,2023-11-22,102,,LAC,0,240,35,91,0.385,24,53,0.453,11,38,0.289,21,23,0.913,102,39,85,0.459,30,57,0.526,9,28,0.321,22,29,0.759,109
1307,CHI,2023-11-22,102,@,OKC,0,240,34,88,0.386,17,44,0.386,17,44,0.386,17,17,1.0,102,37,75,0.493,26,46,0.565,11,29,0.379,31,38,0.816,116
1308,BOS,2023-11-19,102,@,MEM,1,240,35,77,0.455,23,46,0.5,12,31,0.387,20,25,0.8,102,37,95,0.389,20,51,0.392,17,44,0.386,9,10,0.9,100
1309,CHI,2023-11-18,102,,MIA,1,240,36,81,0.444,20,36,0.556,16,45,0.356,14,19,0.737,102,33,77,0.429,21,41,0.512,12,36,0.333,19,23,0.826,97
1310,BRK,2023-11-12,102,,WAS,1,240,37,98,0.378,25,49,0.51,12,49,0.245,16,20,0.8,102,33,88,0.375,23,47,0.489,10,41,0.244,18,25,0.72,94
1311,MEM,2023-11-08,102,,MIA,0,240,35,90,0.389,24,53,0.453,11,37,0.297,21,28,0.75,102,35,77,0.455,24,49,0.49,11,28,0.393,27,32,0.844,108
1312,ORL,2023-11-06,102,,DAL,0,240,40,85,0.471,32,58,0.552,8,27,0.296,14,18,0.778,102,41,82,0.5,26,42,0.619,15,40,0.375,20,28,0.714,117
1313,GSW,2023-11-01,102,,SAC,1,240,39,81,0.481,28,50,0.56,11,31,0.355,13,15,0.867,102,36,88,0.409,25,53,0.472,11,35,0.314,18,23,0.783,101
1314,ORL,2023-10-31,102,@,LAC,0,240,38,81,0.469,31,51,0.608,7,30,0.233,19,33,0.576,102,44,89,0.494,30,58,0.517,14,31,0.452,16,23,0.696,118
1315,NOP,2023-10-30,102,,GSW,0,240,38,93,0.409,28,54,0.519,10,39,0.256,16,26,0.615,102,51,98,0.52,36,57,0.632,15,41,0.366,13,20,0.65,130
1316,UTA,2023-10-30,102,@,DEN,0,240,42,98,0.429,31,61,0.508,11,37,0.297,7,15,0.467,102,47,84,0.56,38,56,0.679,9,28,0.321,7,17,0.412,110
1317,CHI,2023-10-28,102,@,DET,0,240,39,93,0.419,28,65,0.431,11,28,0.393,13,16,0.813,102,45,86,0.523,33,58,0.569,12,28,0.429,16,20,0.8,118
1318,ORL,2023-10-27,102,@,POR,1,240,36,79,0.456,27,51,0.529,9,28,0.321,21,32,0.656,102,35,88,0.398,26,56,0.464,9,32,0.281,18,21,0.857,97
1319,DET,2023-10-25,102,@,MIA,0,240,41,92,0.446,30,60,0.5,11,32,0.344,9,15,0.6,102,37,92,0.402,29,70,0.414,8,22,0.364,21,26,0.808,103
1320,SAS,2024-02-03,101,,CLE,0,240,36,98,0.367,24,58,0.414,12,40,0.3,17,21,0.81,101,46,97,0.474,33,53,0.623,13,44,0.295,12,13,0.923,117
1321,MEM,2024-02-02,101,,GSW,0,240,35,87,0.402,21,41,0.512,14,46,0.304,17,24,0.708,101,46,83,0.554,35,54,0.648,11,29,0.379,18,22,0.818,121
1322,MEM,2024-02-01,101,,CLE,0,240,37,90,0.411,25,52,0.481,12,38,0.316,15,17,0.882,101,41,86,0.477,27,51,0.529,14,35,0.4,12,18,0.667,108
1323,OKC,2024-01-29,101,,MIN,0,240,35,79,0.443,21,44,0.477,14,35,0.4,17,22,0.773,101,40,83,0.482,26,54,0.481,14,29,0.483,13,15,0.867,107
1324,IND,2024-01-06,101,,BOS,0,240,38,92,0.413,30,50,0.6,8,42,0.19,17,22,0.773,101,46,90,0.511,30,49,0.612,16,41,0.39,10,19,0.526,118
1325,WAS,2024-01-03,101,@,CLE,0,240,42,101,0.416,30,66,0.455,12,35,0.343,5,11,0.455,101,54,101,0.535,34,59,0.576,20,42,0.476,12,16,0.75,140
1326,BRK,2024-01-03,101,@,HOU,0,240,36,93,0.387,23,49,0.469,13,44,0.295,16,26,0.615,101,37,76,0.487,18,37,0.486,19,39,0.487,19,27,0.704,112
1327,SAS,2023-12-31,101,,BOS,0,240,40,94,0.426,28,49,0.571,12,45,0.267,9,12,0.75,101,51,95,0.537,36,53,0.679,15,42,0.357,17,22,0.773,134
1328,BRK,2023-12-14,101,@,DEN,0,240,39,95,0.411,31,65,0.477,8,30,0.267,15,20,0.75,101,47,99,0.475,35,63,0.556,12,36,0.333,18,21,0.857,124
1329,DAL,2023-12-14,101,,MIN,0,240,39,83,0.47,32,51,0.627,7,32,0.219,16,18,0.889,101,44,88,0.5,30,57,0.526,14,31,0.452,17,25,0.68,119
1330,WAS,2023-12-11,101,@,PHI,0,240,36,85,0.424,27,54,0.5,9,31,0.29,20,31,0.645,101,52,95,0.547,32,49,0.653,20,46,0.435,22,25,0.88,146
1331,OKC,2023-12-06,101,@,HOU,0,240,37,87,0.425,29,58,0.5,8,29,0.276,19,24,0.792,101,40,83,0.482,25,50,0.5,15,33,0.455,15,22,0.682,110
1332,DET,2023-12-02,101,,CLE,0,240,39,83,0.47,31,53,0.585,8,30,0.267,15,23,0.652,101,44,89,0.494,34,59,0.576,10,30,0.333,12,18,0.667,110
1333,ORL,2023-12-02,101,@,BRK,0,240,35,88,0.398,26,59,0.441,9,29,0.31,22,27,0.815,101,46,91,0.505,32,57,0.561,14,34,0.412,23,31,0.742,129
1334,MIN,2023-11-30,101,,UTA,1,240,39,89,0.438,26,54,0.481,13,35,0.371,10,13,0.769,101,33,87,0.379,22,53,0.415,11,34,0.324,13,14,0.929,90
1335,LAL,2023-11-22,101,,DAL,0,240,39,84,0.464,28,55,0.509,11,29,0.379,12,19,0.632,101,38,96,0.396,22,46,0.478,16,50,0.32,12,16,0.75,104
1336,GSW,2023-11-14,101,,MIN,0,240,37,88,0.42,24,49,0.49,13,39,0.333,14,16,0.875,101,36,81,0.444,22,47,0.468,14,34,0.412,18,21,0.857,104
1337,LAC,2023-11-12,101,,MEM,0,240,37,85,0.435,25,51,0.49,12,34,0.353,15,23,0.652,101,37,88,0.42,24,47,0.511,13,41,0.317,18,24,0.75,105
1338,NOP,2023-11-10,101,@,HOU,0,240,34,75,0.453,26,50,0.52,8,25,0.32,25,34,0.735,101,36,88,0.409,26,53,0.491,10,35,0.286,22,28,0.786,104
1339,NOP,2023-11-08,101,@,MIN,0,240,36,93,0.387,28,65,0.431,8,28,0.286,21,22,0.955,101,45,82,0.549,30,45,0.667,15,37,0.405,17,24,0.708,122
1340,CHI,2023-11-04,101,@,DEN,0,240,39,86,0.453,32,60,0.533,7,26,0.269,16,23,0.696,101,42,81,0.519,26,45,0.578,16,36,0.444,23,30,0.767,123
1341,LAL,2023-11-04,101,@,ORL,0,240,37,84,0.44,29,54,0.537,8,30,0.267,19,21,0.905,101,46,101,0.455,34,68,0.5,12,33,0.364,16,19,0.842,120
1342,DET,2023-11-01,101,,POR,0,240,40,90,0.444,29,61,0.475,11,29,0.379,10,11,0.909,101,38,81,0.469,31,61,0.508,7,20,0.35,27,33,0.818,110
1343,SAC,2023-11-01,101,@,GSW,0,240,36,88,0.409,25,53,0.472,11,35,0.314,18,23,0.783,101,39,81,0.481,28,50,0.56,11,31,0.355,13,15,0.867,102
1344,TOR,2024-02-05,100,@,NOP,0,240,40,84,0.476,30,53,0.566,10,31,0.323,10,15,0.667,100,53,104,0.51,34,59,0.576,19,45,0.422,13,13,1.0,138
1345,DEN,2024-01-31,100,@,OKC,0,240,37,93,0.398,22,56,0.393,15,37,0.405,11,16,0.688,100,37,87,0.425,26,61,0.426,11,26,0.423,20,25,0.8,105
1346,MIL,2024-01-26,100,,CLE,0,240,35,87,0.402,22,53,0.415,13,34,0.382,17,24,0.708,100,38,92,0.413,24,56,0.429,14,36,0.389,22,31,0.71,112
1347,POR,2024-01-26,100,@,SAS,0,240,38,90,0.422,28,53,0.528,10,37,0.27,14,19,0.737,100,42,92,0.457,32,58,0.552,10,34,0.294,22,26,0.846,116
1348,TOR,2024-01-22,100,,MEM,0,240,35,79,0.443,27,56,0.482,8,23,0.348,22,23,0.957,100,44,95,0.463,31,61,0.508,13,34,0.382,7,12,0.583,108
1349,TOR,2024-01-20,100,@,NYK,0,240,38,92,0.413,27,58,0.466,11,34,0.324,13,23,0.565,100,48,88,0.545,34,49,0.694,14,39,0.359,16,20,0.8,126
1350,BOS,2024-01-19,100,,DEN,0,240,38,89,0.427,24,45,0.533,14,44,0.318,10,14,0.714,100,42,81,0.519,34,50,0.68,8,31,0.258,10,13,0.769,102
1351,ORL,2024-01-13,100,@,OKC,0,240,39,84,0.464,32,49,0.653,7,35,0.2,15,24,0.625,100,43,94,0.457,35,58,0.603,8,36,0.222,18,21,0.857,112
1352,SAC,2024-01-07,100,,NOP,0,240,38,91,0.418,23,46,0.5,15,45,0.333,9,12,0.75,100,50,82,0.61,31,47,0.66,19,35,0.543,14,16,0.875,133
1353,CHI,2024-01-03,100,@,NYK,0,240,37,89,0.416,24,57,0.421,13,32,0.406,13,16,0.813,100,46,89,0.517,31,51,0.608,15,38,0.395,9,11,0.818,116
1354,CHO,2023-12-06,100,@,CHI,0,240,39,90,0.433,29,53,0.547,10,37,0.27,12,12,1.0,100,38,90,0.422,26,65,0.4,12,25,0.48,23,29,0.793,111
1355,NOP,2023-11-25,100,@,UTA,0,240,39,93,0.419,28,57,0.491,11,36,0.306,11,18,0.611,100,38,87,0.437,23,44,0.523,15,43,0.349,14,17,0.824,105
1356,NYK,2023-11-24,100,,MIA,1,240,39,81,0.481,29,52,0.558,10,29,0.345,12,18,0.667,100,34,87,0.391,24,50,0.48,10,37,0.27,20,21,0.952,98
1357,CHI,2023-11-20,100,,MIA,0,240,37,81,0.457,26,44,0.591,11,37,0.297,15,16,0.938,100,42,84,0.5,25,49,0.51,17,35,0.486,17,20,0.85,118
1358,NYK,2023-11-20,100,@,MIN,0,240,32,92,0.348,23,54,0.426,9,38,0.237,27,34,0.794,100,41,80,0.513,30,46,0.652,11,34,0.324,24,32,0.75,117
1359,MEM,2023-11-19,100,,BOS,0,240,37,95,0.389,20,51,0.392,17,44,0.386,9,10,0.9,100,35,77,0.455,23,46,0.5,12,31,0.387,20,25,0.8,102
1360,DET,2023-11-17,100,@,CLE,0,240,39,91,0.429,30,56,0.536,9,35,0.257,13,15,0.867,100,42,82,0.512,33,61,0.541,9,21,0.429,15,21,0.714,108
1361,HOU,2023-11-17,100,@,LAC,0,240,38,88,0.432,28,57,0.491,10,31,0.323,14,20,0.7,100,36,83,0.434,23,49,0.469,13,34,0.382,21,30,0.7,106
1362,BRK,2023-11-08,100,,LAC,1,240,37,92,0.402,22,51,0.431,15,41,0.366,11,13,0.846,100,36,91,0.396,28,55,0.509,8,36,0.222,13,13,1.0,93
1363,POR,2023-11-05,100,,MEM,0,240,37,95,0.389,23,50,0.46,14,45,0.311,12,15,0.8,100,45,89,0.506,32,57,0.561,13,32,0.406,9,13,0.692,112
1364,PHO,2023-11-04,100,@,PHI,0,240,32,89,0.36,23,54,0.426,9,35,0.257,27,33,0.818,100,43,90,0.478,32,60,0.533,11,30,0.367,15,18,0.833,112
1365,LAL,2023-10-26,100,,PHO,1,240,36,84,0.429,31,55,0.564,5,29,0.172,23,29,0.793,100,34,81,0.42,25,50,0.5,9,31,0.29,18,23,0.783,95
1366,DET,2024-02-04,99,,ORL,0,240,36,80,0.45,28,49,0.571,8,31,0.258,19,22,0.864,99,45,84,0.536,35,60,0.583,10,24,0.417,11,15,0.733,111
1367,CHO,2024-02-04,99,,IND,0,240,35,88,0.398,27,59,0.458,8,29,0.276,21,25,0.84,99,45,92,0.489,34,59,0.576,11,33,0.333,14,18,0.778,115
1368,HOU,2024-01-31,99,,NOP,0,240,35,87,0.402,22,43,0.512,13,44,0.295,16,17,0.941,99,41,82,0.5,30,48,0.625,11,34,0.324,17,24,0.708,110
1369,ORL,2024-01-22,99,,CLE,0,240,34,74,0.459,23,45,0.511,11,29,0.379,20,30,0.667,99,45,80,0.563,25,42,0.595,20,38,0.526,16,22,0.727,126
1370,SAS,2024-01-15,99,@,ATL,0,240,38,95,0.4,27,53,0.509,11,42,0.262,12,17,0.706,99,40,93,0.43,27,55,0.491,13,38,0.342,16,21,0.762,109
1371,ATL,2024-01-13,99,,WAS,0,240,32,93,0.344,21,53,0.396,11,40,0.275,24,33,0.727,99,47,97,0.485,35,65,0.538,12,32,0.375,21,26,0.808,127
1372,MIA,2024-01-12,99,,ORL,1,240,37,83,0.446,29,57,0.509,8,26,0.308,17,20,0.85,99,36,82,0.439,24,42,0.571,12,40,0.3,12,20,0.6,96
1373,CHO,2024-01-12,99,@,SAS,0,240,32,89,0.36,22,55,0.4,10,34,0.294,25,28,0.893,99,45,87,0.517,27,49,0.551,18,38,0.474,27,34,0.794,135
1374,CHO,2023-12-18,99,@,TOR,0,240,39,89,0.438,31,57,0.544,8,32,0.25,13,13,1.0,99,44,86,0.512,36,57,0.632,8,29,0.276,18,22,0.818,114
1375,SAC,2023-12-12,99,@,LAC,0,240,36,86,0.419,26,49,0.531,10,37,0.27,17,24,0.708,99,44,84,0.524,33,55,0.6,11,29,0.379,20,21,0.952,119
1376,MIA,2023-12-08,99,,CLE,0,240,37,86,0.43,22,44,0.5,15,42,0.357,10,15,0.667,99,40,87,0.46,26,49,0.531,14,38,0.368,17,26,0.654,111
1377,PHI,2023-11-22,99,@,MIN,0,240,34,87,0.391,27,55,0.491,7,32,0.219,24,30,0.8,99,43,89,0.483,33,63,0.524,10,26,0.385,16,24,0.667,112
1378,UTA,2023-11-21,99,@,LAL,0,240,38,98,0.388,27,54,0.5,11,44,0.25,12,16,0.75,99,49,86,0.57,38,57,0.667,11,29,0.379,22,27,0.815,131
1379,SAS,2023-11-20,99,,LAC,0,240,39,90,0.433,29,52,0.558,10,38,0.263,11,14,0.786,99,45,95,0.474,33,59,0.559,12,36,0.333,22,25,0.88,124
1380,BRK,2023-11-19,99,,PHI,0,240,38,81,0.469,27,53,0.509,11,28,0.393,12,16,0.75,99,44,94,0.468,28,59,0.475,16,35,0.457,17,18,0.944,121
1381,CHO,2023-11-17,99,,MIL,0,240,37,91,0.407,31,65,0.477,6,26,0.231,19,22,0.864,99,49,89,0.551,27,44,0.614,22,45,0.489,10,13,0.769,130
1382,WAS,2023-11-17,99,,NYK,0,240,37,82,0.451,27,50,0.54,10,32,0.313,15,16,0.938,99,45,91,0.495,29,53,0.547,16,38,0.421,14,20,0.7,120
1383,POR,2023-11-14,99,@,UTA,0,240,37,88,0.42,26,53,0.491,11,35,0.314,14,20,0.7,99,44,95,0.463,31,52,0.596,13,43,0.302,14,15,0.933,115
1384,PHO,2023-11-12,99,,OKC,0,240,32,83,0.386,23,54,0.426,9,29,0.31,26,31,0.839,99,40,82,0.488,30,55,0.545,10,27,0.37,21,25,0.84,111
1385,TOR,2023-11-02,99,@,PHI,0,240,38,79,0.481,28,51,0.549,10,28,0.357,13,19,0.684,99,42,92,0.457,33,67,0.493,9,25,0.36,21,25,0.84,114
1386,POR,2023-10-30,99,@,TOR,1,240,38,85,0.447,27,50,0.54,11,35,0.314,12,15,0.8,99,38,94,0.404,34,65,0.523,4,29,0.138,11,15,0.733,91
1387,CHO,2023-10-27,99,,DET,0,240,33,88,0.375,26,60,0.433,7,28,0.25,26,34,0.765,99,40,88,0.455,30,58,0.517,10,30,0.333,21,25,0.84,111
1388,BRK,2024-02-05,98,,GSW,0,240,34,89,0.382,21,47,0.447,13,42,0.31,17,22,0.773,98,43,93,0.462,39,71,0.549,4,22,0.182,19,23,0.826,109
1389,SAS,2024-01-31,98,,ORL,0,240,36,80,0.45,27,49,0.551,9,31,0.29,17,24,0.708,98,41,86,0.477,34,66,0.515,7,20,0.35,19,23,0.826,108
1390,PHO,2024-01-28,98,@,ORL,0,240,41,73,0.562,37,59,0.627,4,14,0.286,12,21,0.571,98,41,92,0.446,29,56,0.518,12,36,0.333,19,26,0.731,113
1391,SAS,2024-01-17,98,@,BOS,0,240,39,93,0.419,32,59,0.542,7,34,0.206,13,16,0.813,98,42,90,0.467,24,52,0.462,18,38,0.474,15,19,0.789,117
1392,ORL,2024-01-15,98,@,NYK,1,240,38,85,0.447,30,56,0.536,8,29,0.276,14,21,0.667,98,33,83,0.398,20,43,0.465,13,40,0.325,15,22,0.682,94
1393,CHO,2024-01-10,98,,SAC,0,240,35,87,0.402,19,49,0.388,16,38,0.421,12,16,0.75,98,46,89,0.517,33,54,0.611,13,35,0.371,18,23,0.783,123
1394,SAS,2024-01-02,98,@,MEM,0,240,36,85,0.424,26,54,0.481,10,31,0.323,16,23,0.696,98,37,80,0.463,25,42,0.595,12,38,0.316,20,25,0.8,106
1395,SAC,2023-12-23,98,,MIN,0,240,37,85,0.435,29,52,0.558,8,33,0.242,16,21,0.762,98,44,87,0.506,34,54,0.63,10,33,0.303,12,14,0.857,110
1396,MIA,2023-11-24,98,@,NYK,0,240,34,87,0.391,24,50,0.48,10,37,0.27,20,21,0.952,98,39,81,0.481,29,52,0.558,10,29,0.345,12,18,0.667,100
1397,NYK,2023-11-13,98,@,BOS,0,240,33,79,0.418,18,44,0.409,15,35,0.429,17,24,0.708,98,40,79,0.506,21,36,0.583,19,43,0.442,15,16,0.938,114
1398,OKC,2023-11-10,98,@,SAC,0,240,39,87,0.448,32,57,0.561,7,30,0.233,13,16,0.813,98,38,91,0.418,25,44,0.568,13,47,0.277,16,21,0.762,105
1399,POR,2023-10-29,98,@,PHI,0,240,36,94,0.383,29,63,0.46,7,31,0.226,19,22,0.864,98,40,82,0.488,29,54,0.537,11,28,0.393,35,40,0.875,126
1400,MIN,2024-01-20,97,,OKC,0,240,31,75,0.413,17,38,0.447,14,37,0.378,21,29,0.724,97,32,81,0.395,24,57,0.421,8,24,0.333,30,35,0.857,102
1401,PHI,2024-01-20,97,@,CHO,1,240,36,85,0.424,31,60,0.517,5,25,0.2,20,24,0.833,97,35,85,0.412,26,48,0.542,9,37,0.243,10,14,0.714,89
1402,MIA,2024-01-17,97,@,TOR,0,240,41,90,0.456,35,62,0.565,6,28,0.214,9,12,0.75,97,45,88,0.511,25,50,0.5,20,38,0.526,11,18,0.611,121
1403,UTA,2024-01-05,97,@,BOS,0,240,34,94,0.362,28,60,0.467,6,34,0.176,23,34,0.676,97,39,90,0.433,22,41,0.537,17,49,0.347,31,36,0.861,126
1404,MIA,2024-01-05,97,@,PHO,0,240,34,83,0.41,24,46,0.522,10,37,0.27,19,22,0.864,97,44,87,0.506,30,52,0.577,14,35,0.4,11,17,0.647,113
1405,POR,2024-01-03,97,@,DAL,0,240,34,87,0.391,21,47,0.447,13,40,0.325,16,22,0.727,97,42,84,0.5,29,54,0.537,13,30,0.433,29,41,0.707,126
1406,CHI,2024-01-02,97,@,PHI,0,240,37,96,0.385,30,59,0.508,7,37,0.189,16,23,0.696,97,38,80,0.475,26,50,0.52,12,30,0.4,22,30,0.733,110
1407,MEM,2023-12-18,97,@,OKC,0,240,30,85,0.353,11,31,0.355,19,54,0.352,18,21,0.857,97,42,92,0.457,31,56,0.554,11,36,0.306,21,23,0.913,116
1408,ORL,2023-12-17,97,@,BOS,0,240,34,89,0.382,23,53,0.434,11,36,0.306,18,24,0.75,97,45,95,0.474,28,59,0.475,17,36,0.472,7,8,0.875,114
1409,WAS,2023-12-08,97,@,BRK,0,240,38,91,0.418,32,58,0.552,6,33,0.182,15,21,0.714,97,50,104,0.481,40,71,0.563,10,33,0.303,14,18,0.778,124
1410,UTA,2023-12-06,97,@,DAL,0,240,35,87,0.402,23,54,0.426,12,33,0.364,15,18,0.833,97,56,101,0.554,34,52,0.654,22,49,0.449,13,19,0.684,147
1411,HOU,2023-12-02,97,@,LAL,0,240,36,89,0.404,25,58,0.431,11,31,0.355,14,18,0.778,97,40,89,0.449,32,62,0.516,8,27,0.296,19,27,0.704,107
1412,CHI,2023-11-28,97,@,BOS,0,240,39,90,0.433,30,62,0.484,9,28,0.321,10,18,0.556,97,47,90,0.522,26,41,0.634,21,49,0.429,9,12,0.75,124
1413,MEM,2023-11-26,97,,MIN,0,240,34,88,0.386,24,51,0.471,10,37,0.27,19,27,0.704,97,43,81,0.531,28,47,0.596,15,34,0.441,18,23,0.783,119
1414,MIA,2023-11-25,97,@,BRK,0,240,38,87,0.437,27,53,0.509,11,34,0.324,10,13,0.769,97,39,78,0.5,25,42,0.595,14,36,0.389,20,23,0.87,112
1415,MIA,2023-11-18,97,@,CHI,0,240,33,77,0.429,21,41,0.512,12,36,0.333,19,23,0.826,97,36,81,0.444,20,36,0.556,16,45,0.356,14,19,0.737,102
1416,CHI,2023-11-17,97,,ORL,0,240,35,79,0.443,25,50,0.5,10,29,0.345,17,22,0.773,97,38,79,0.481,27,45,0.6,11,34,0.324,16,23,0.696,103
1417,MIL,2023-11-11,97,@,ORL,0,240,38,77,0.494,29,48,0.604,9,29,0.31,12,25,0.48,97,36,84,0.429,26,58,0.448,10,26,0.385,30,35,0.857,112
1418,SAC,2023-11-06,97,@,HOU,0,240,36,81,0.444,22,41,0.537,14,40,0.35,11,20,0.55,97,43,75,0.573,28,44,0.636,15,31,0.484,21,27,0.778,122
1419,LAC,2023-11-06,97,@,NYK,0,240,36,73,0.493,25,41,0.61,11,32,0.344,14,16,0.875,97,41,88,0.466,29,57,0.509,12,31,0.387,17,18,0.944,111
1420,POR,2023-10-27,97,,ORL,0,240,35,88,0.398,26,56,0.464,9,32,0.281,18,21,0.857,97,36,79,0.456,27,51,0.529,9,28,0.321,21,32,0.656,102
1421,TOR,2023-10-25,97,,MIN,1,240,36,90,0.4,22,55,0.4,14,35,0.4,11,16,0.688,97,34,100,0.34,26,69,0.377,8,31,0.258,18,22,0.818,94
1422,POR,2024-01-28,96,,CHI,0,240,32,79,0.405,26,46,0.565,6,33,0.182,26,29,0.897,96,42,90,0.467,34,58,0.586,8,32,0.25,12,17,0.706,104
1423,BOS,2024-01-27,96,,LAC,0,240,36,100,0.36,26,60,0.433,10,40,0.25,14,16,0.875,96,45,102,0.441,35,62,0.565,10,40,0.25,15,18,0.833,115
1424,MIN,2024-01-25,96,@,BRK,1,240,37,75,0.493,27,54,0.5,10,21,0.476,12,16,0.75,96,35,77,0.455,25,44,0.568,10,33,0.303,14,16,0.875,94
1425,MIA,2024-01-24,96,,MEM,0,240,33,82,0.402,22,48,0.458,11,34,0.324,19,25,0.76,96,36,80,0.45,19,44,0.432,17,36,0.472,16,19,0.842,105
1426,MEM,2024-01-20,96,@,CHI,0,240,32,75,0.427,19,33,0.576,13,42,0.31,19,23,0.826,96,47,91,0.516,33,58,0.569,14,33,0.424,17,21,0.81,125
1427,MIA,2024-01-15,96,@,BRK,1,265,33,87,0.379,25,56,0.446,8,31,0.258,22,25,0.88,96,34,99,0.343,22,44,0.5,12,55,0.218,15,16,0.938,95
1428,TOR,2024-01-15,96,,BOS,0,240,38,95,0.4,34,63,0.54,4,32,0.125,16,21,0.762,96,33,82,0.402,17,43,0.395,16,39,0.41,23,25,0.92,105
1429,ORL,2024-01-12,96,@,MIA,0,240,36,82,0.439,24,42,0.571,12,40,0.3,12,20,0.6,96,37,83,0.446,29,57,0.509,8,26,0.308,17,20,0.85,99
1430,LAL,2024-01-03,96,,MIA,0,240,35,83,0.422,31,53,0.585,4,30,0.133,22,24,0.917,96,41,93,0.441,25,51,0.49,16,42,0.381,12,17,0.706,110
1431,DAL,2023-12-22,96,@,HOU,0,240,35,101,0.347,28,61,0.459,7,40,0.175,19,26,0.731,96,46,95,0.484,35,57,0.614,11,38,0.289,19,23,0.826,122
1432,MEM,2023-12-15,96,,HOU,0,240,37,92,0.402,26,52,0.5,11,40,0.275,11,15,0.733,96,32,88,0.364,21,59,0.356,11,29,0.379,28,32,0.875,103
1433,BOS,2023-11-24,96,@,ORL,0,240,31,76,0.408,24,47,0.511,7,29,0.241,27,37,0.73,96,43,85,0.506,32,57,0.561,11,28,0.393,16,22,0.727,113
1434,CLE,2023-11-22,96,,MIA,0,240,36,77,0.468,22,47,0.468,14,30,0.467,10,14,0.714,96,46,88,0.523,26,53,0.491,20,35,0.571,17,21,0.81,129
1435,ORL,2023-11-15,96,@,CHI,1,240,32,82,0.39,24,54,0.444,8,28,0.286,24,30,0.8,96,33,83,0.398,24,50,0.48,9,33,0.273,19,22,0.864,94
1436,NOP,2023-10-28,96,,NYK,1,240,40,87,0.46,31,54,0.574,9,33,0.273,7,16,0.438,96,33,90,0.367,26,53,0.491,7,37,0.189,14,18,0.778,87
1437,ORL,2024-02-06,95,@,MIA,0,240,35,80,0.438,25,45,0.556,10,35,0.286,15,21,0.714,95,47,87,0.54,34,51,0.667,13,36,0.361,14,18,0.778,121
1438,MIA,2024-02-04,95,,LAC,0,240,38,91,0.418,30,61,0.492,8,30,0.267,11,12,0.917,95,34,77,0.442,18,38,0.474,16,39,0.41,19,22,0.864,103
1439,ATL,2024-01-20,95,,CLE,0,240,37,93,0.398,26,55,0.473,11,38,0.289,10,15,0.667,95,43,85,0.506,27,42,0.643,16,43,0.372,14,16,0.875,116
1440,MIL,2024-01-17,95,@,CLE,0,240,38,95,0.4,26,53,0.491,12,42,0.286,7,10,0.7,95,55,93,0.591,43,65,0.662,12,28,0.429,13,19,0.684,135
1441,BRK,2024-01-15,95,,MIA,0,265,34,99,0.343,22,44,0.5,12,55,0.218,15,16,0.938,95,33,87,0.379,25,56,0.446,8,31,0.258,22,25,0.88,96
1442,NOP,2024-01-05,95,,LAC,0,240,33,92,0.359,21,63,0.333,12,29,0.414,17,23,0.739,95,40,82,0.488,25,46,0.543,15,36,0.417,16,20,0.8,111
1443,HOU,2024-01-05,95,,MIN,0,240,36,90,0.4,24,58,0.414,12,32,0.375,11,15,0.733,95,46,88,0.523,32,55,0.582,14,33,0.424,16,20,0.8,122
1444,CHO,2023-12-23,95,,DEN,0,240,34,88,0.386,26,60,0.433,8,28,0.286,19,23,0.826,95,39,90,0.433,27,60,0.45,12,30,0.4,12,14,0.857,102
1445,CHI,2023-12-23,95,,CLE,0,240,35,80,0.438,27,45,0.6,8,35,0.229,17,19,0.895,95,39,88,0.443,27,43,0.628,12,45,0.267,19,26,0.731,109
1446,SAS,2023-12-21,95,@,CHI,0,240,37,81,0.457,27,51,0.529,10,30,0.333,11,16,0.688,95,49,90,0.544,42,62,0.677,7,28,0.25,9,11,0.818,114
1447,CLE,2023-11-30,95,,POR,0,240,38,89,0.427,31,57,0.544,7,32,0.219,12,12,1.0,95,39,77,0.506,25,42,0.595,14,35,0.4,11,11,1.0,103
1448,POR,2023-11-17,95,,LAL,0,240,36,89,0.404,26,52,0.5,10,37,0.27,13,18,0.722,95,40,81,0.494,28,52,0.538,12,29,0.414,15,22,0.682,107
1449,POR,2023-11-15,95,,CLE,0,240,34,91,0.374,21,53,0.396,13,38,0.342,14,16,0.875,95,42,75,0.56,33,45,0.733,9,30,0.3,16,21,0.762,109
1450,UTA,2023-11-04,95,@,MIN,0,240,35,91,0.385,23,48,0.479,12,43,0.279,13,17,0.765,95,45,81,0.556,36,57,0.632,9,24,0.375,24,31,0.774,123
1451,CLE,2023-11-01,95,@,NYK,1,240,32,74,0.432,20,42,0.476,12,32,0.375,19,20,0.95,95,32,92,0.348,27,62,0.435,5,30,0.167,20,30,0.667,89
1452,HOU,2023-10-29,95,,GSW,0,240,34,90,0.378,25,57,0.439,9,33,0.273,18,19,0.947,95,35,81,0.432,17,36,0.472,18,45,0.4,18,23,0.783,106
1453,OKC,2023-10-29,95,,DEN,0,240,37,90,0.411,31,58,0.534,6,32,0.188,15,18,0.833,95,53,88,0.602,42,61,0.689,11,27,0.407,11,13,0.846,128
1454,PHO,2023-10-26,95,@,LAL,0,240,34,81,0.42,25,50,0.5,9,31,0.29,18,23,0.783,95,36,84,0.429,31,55,0.564,5,29,0.172,23,29,0.793,100
1455,MEM,2024-01-29,94,,SAC,0,240,30,80,0.375,17,44,0.386,13,36,0.361,21,28,0.75,94,43,84,0.512,32,46,0.696,11,38,0.289,6,10,0.6,103
1456,BRK,2024-01-25,94,,MIN,0,240,35,77,0.455,25,44,0.568,10,33,0.303,14,16,0.875,94,37,75,0.493,27,54,0.5,10,21,0.476,12,16,0.75,96
1457,HOU,2024-01-17,94,@,NYK,0,240,35,84,0.417,27,54,0.5,8,30,0.267,16,19,0.842,94,39,87,0.448,26,50,0.52,13,37,0.351,18,22,0.818,109
1458,NYK,2024-01-15,94,,ORL,0,240,33,83,0.398,20,43,0.465,13,40,0.325,15,22,0.682,94,38,85,0.447,30,56,0.536,8,29,0.276,14,21,0.667,98
1459,MEM,2024-01-13,94,,NYK,0,240,36,87,0.414,27,49,0.551,9,38,0.237,13,15,0.867,94,40,83,0.482,27,45,0.6,13,38,0.342,13,19,0.684,106
1460,CLE,2023-12-11,94,@,ORL,0,240,30,85,0.353,21,45,0.467,9,40,0.225,25,33,0.758,94,39,84,0.464,32,58,0.552,7,26,0.269,19,25,0.76,104
1461,SAS,2023-12-06,94,@,MIN,0,240,38,101,0.376,30,65,0.462,8,36,0.222,10,15,0.667,94,36,87,0.414,24,47,0.511,12,40,0.3,18,21,0.857,102
1462,DAL,2023-12-01,94,,MEM,0,240,34,92,0.37,22,53,0.415,12,39,0.308,14,21,0.667,94,44,90,0.489,33,56,0.589,11,34,0.324,9,11,0.818,108
1463,LAL,2023-11-27,94,@,PHI,0,240,39,83,0.47,32,55,0.582,7,28,0.25,9,13,0.692,94,47,93,0.505,25,47,0.532,22,46,0.478,22,26,0.846,138
1464,CHI,2023-11-15,94,,ORL,0,240,33,83,0.398,24,50,0.48,9,33,0.273,19,22,0.864,94,32,82,0.39,24,54,0.444,8,28,0.286,24,30,0.8,96
1465,WAS,2023-11-12,94,@,BRK,0,240,33,88,0.375,23,47,0.489,10,41,0.244,18,25,0.72,94,37,98,0.378,25,49,0.51,12,49,0.245,16,20,0.8,102
1466,TOR,2023-11-11,94,@,BOS,0,240,35,91,0.385,25,54,0.463,10,37,0.27,14,16,0.875,94,47,86,0.547,32,42,0.762,15,44,0.341,8,13,0.615,117
1467,LAL,2023-11-08,94,@,HOU,0,240,36,85,0.424,29,60,0.483,7,25,0.28,15,24,0.625,94,51,93,0.548,37,60,0.617,14,33,0.424,12,19,0.632,128
1468,MIN,2023-10-25,94,@,TOR,0,240,34,100,0.34,26,69,0.377,8,31,0.258,18,22,0.818,94,36,90,0.4,22,55,0.4,14,35,0.4,11,16,0.688,97
1469,SAC,2024-01-12,93,@,PHI,0,240,32,95,0.337,24,57,0.421,8,38,0.211,21,26,0.808,93,40,93,0.43,25,58,0.431,15,35,0.429,17,18,0.944,112
1470,POR,2024-01-12,93,@,MIN,0,240,30,77,0.39,20,49,0.408,10,28,0.357,23,34,0.676,93,44,80,0.55,33,49,0.673,11,31,0.355,17,24,0.708,116
1471,CHO,2024-01-01,93,@,DEN,0,240,36,86,0.419,26,60,0.433,10,26,0.385,11,16,0.688,93,41,83,0.494,26,45,0.578,15,38,0.395,14,18,0.778,111
1472,DEN,2023-12-29,93,,OKC,0,240,36,85,0.424,26,48,0.542,10,37,0.27,11,15,0.733,93,46,91,0.505,34,56,0.607,12,35,0.343,15,16,0.938,119
1473,HOU,2023-12-11,93,,SAS,1,240,32,93,0.344,20,54,0.37,12,39,0.308,17,20,0.85,93,31,87,0.356,26,46,0.565,5,41,0.122,15,22,0.682,82
1474,SAC,2023-11-20,93,@,NOP,0,240,33,87,0.379,22,42,0.524,11,45,0.244,16,24,0.667,93,50,92,0.543,38,64,0.594,12,28,0.429,17,21,0.81,129
1475,LAC,2023-11-08,93,@,BRK,0,240,36,91,0.396,28,55,0.509,8,36,0.222,13,13,1.0,93,37,92,0.402,22,51,0.431,15,41,0.366,11,13,0.846,100
1476,CHO,2024-01-29,92,,NYK,0,240,37,81,0.457,26,49,0.531,11,32,0.344,7,14,0.5,92,44,84,0.524,32,47,0.681,12,37,0.324,13,16,0.813,113
1477,ORL,2024-01-09,92,,MIN,0,240,34,94,0.362,21,52,0.404,13,42,0.31,11,18,0.611,92,43,80,0.538,31,50,0.62,12,30,0.4,15,19,0.789,113
1478,PHI,2024-01-05,92,,NYK,0,240,33,81,0.407,27,58,0.466,6,23,0.261,20,27,0.741,92,43,89,0.483,25,48,0.521,18,41,0.439,24,25,0.96,128
1479,MEM,2023-12-31,92,,SAC,0,240,30,82,0.366,18,42,0.429,12,40,0.3,20,28,0.714,92,47,92,0.511,31,59,0.525,16,33,0.485,13,17,0.765,123
1480,PHI,2023-12-30,92,@,CHI,0,240,36,92,0.391,27,54,0.5,9,38,0.237,11,15,0.733,92,40,79,0.506,33,54,0.611,7,25,0.28,18,30,0.6,105
1481,ORL,2023-12-27,92,,PHI,0,240,31,79,0.392,22,46,0.478,9,33,0.273,21,24,0.875,92,45,96,0.469,35,68,0.515,10,28,0.357,12,17,0.706,112
1482,DET,2023-12-15,92,@,PHI,0,240,35,81,0.432,31,60,0.517,4,21,0.19,18,23,0.783,92,41,98,0.418,27,61,0.443,14,37,0.378,28,31,0.903,124
1483,MEM,2024-02-04,91,@,BOS,0,240,35,92,0.38,24,54,0.444,11,38,0.289,10,12,0.833,91,48,99,0.485,29,48,0.604,19,51,0.373,16,18,0.889,131
1484,CHI,2024-01-15,91,@,CLE,0,240,35,83,0.422,26,51,0.51,9,32,0.281,12,16,0.75,91,39,95,0.411,19,38,0.5,20,57,0.351,11,11,1.0,109
1485,CHO,2024-01-05,91,@,CHI,0,240,36,89,0.404,26,55,0.473,10,34,0.294,9,12,0.75,91,40,74,0.541,30,46,0.652,10,28,0.357,14,17,0.824,104
1486,DET,2023-12-08,91,@,ORL,0,240,34,81,0.42,28,51,0.549,6,30,0.2,17,24,0.708,91,49,89,0.551,39,63,0.619,10,26,0.385,15,19,0.789,123
1487,UTA,2023-11-29,91,@,MEM,0,240,34,90,0.378,18,51,0.353,16,39,0.41,7,12,0.583,91,43,87,0.494,30,48,0.625,13,39,0.333,6,8,0.75,105
1488,CHO,2023-11-28,91,@,NYK,0,240,37,89,0.416,24,58,0.414,13,31,0.419,4,7,0.571,91,41,88,0.466,26,50,0.52,15,38,0.395,18,20,0.9,115
1489,MEM,2023-11-22,91,@,HOU,0,240,27,82,0.329,20,50,0.4,7,32,0.219,30,35,0.857,91,40,92,0.435,26,49,0.531,14,43,0.326,17,20,0.85,111
1490,POR,2023-11-19,91,,OKC,0,240,34,85,0.4,25,51,0.49,9,34,0.265,14,21,0.667,91,49,81,0.605,27,45,0.6,22,36,0.611,14,14,1.0,134
1491,CLE,2023-10-31,91,,NYK,0,240,36,92,0.391,26,54,0.481,10,38,0.263,9,12,0.75,91,38,86,0.442,25,52,0.481,13,34,0.382,20,25,0.8,109
1492,TOR,2023-10-30,91,,POR,0,240,38,94,0.404,34,65,0.523,4,29,0.138,11,15,0.733,91,38,85,0.447,27,50,0.54,11,35,0.314,12,15,0.8,99
1493,HOU,2024-02-04,90,@,MIN,0,240,31,88,0.352,21,58,0.362,10,30,0.333,18,27,0.667,90,40,90,0.444,29,60,0.483,11,30,0.367,20,27,0.741,111
1494,WAS,2024-01-05,90,@,CLE,0,240,35,84,0.417,26,54,0.481,9,30,0.3,11,15,0.733,90,41,77,0.532,25,44,0.568,16,33,0.485,16,23,0.696,114
1495,DAL,2024-01-01,90,@,UTA,0,240,37,93,0.398,26,53,0.491,11,40,0.275,5,10,0.5,90,49,96,0.51,37,52,0.712,12,44,0.273,17,18,0.944,127
1496,UTA,2023-11-30,90,@,MIN,0,240,33,87,0.379,22,53,0.415,11,34,0.324,13,14,0.929,90,39,89,0.438,26,54,0.481,13,35,0.371,10,13,0.769,101
1497,MIA,2023-10-28,90,@,MIN,0,240,35,87,0.402,23,49,0.469,12,38,0.316,8,14,0.571,90,44,86,0.512,32,52,0.615,12,34,0.353,6,8,0.75,106
1498,CHO,2024-01-20,89,,PHI,0,240,35,85,0.412,26,48,0.542,9,37,0.243,10,14,0.714,89,36,85,0.424,31,60,0.517,5,25,0.2,20,24,0.833,97
1499,NOP,2023-12-07,89,@,LAL,0,240,34,95,0.358,27,64,0.422,7,31,0.226,14,20,0.7,89,47,86,0.547,30,51,0.588,17,35,0.486,22,29,0.759,133
1500,MEM,2023-11-24,89,,PHO,0,240,37,80,0.463,28,47,0.596,9,33,0.273,6,10,0.6,89,39,76,0.513,28,45,0.622,11,31,0.355,21,28,0.75,110
1501,SAC,2023-11-04,89,@,HOU,0,240,32,84,0.381,21,43,0.488,11,41,0.268,14,19,0.737,89,40,87,0.46,27,51,0.529,13,36,0.361,14,20,0.7,107
1502,DEN,2023-11-01,89,@,MIN,0,240,38,96,0.396,32,63,0.508,6,33,0.182,7,10,0.7,89,38,83,0.458,30,62,0.484,8,21,0.381,26,27,0.963,110
1503,NYK,2023-11-01,89,,CLE,0,240,32,92,0.348,27,62,0.435,5,30,0.167,20,30,0.667,89,32,74,0.432,20,42,0.476,12,32,0.375,19,20,0.95,95
1504,POR,2024-01-01,88,@,PHO,0,240,33,80,0.413,25,50,0.5,8,30,0.267,14,19,0.737,88,38,80,0.475,27,51,0.529,11,29,0.379,22,33,0.667,109
1505,DAL,2023-11-25,88,@,LAC,0,240,34,91,0.374,25,53,0.472,9,38,0.237,11,14,0.786,88,38,88,0.432,30,59,0.508,8,29,0.276,23,31,0.742,107
1506,DAL,2024-01-31,87,@,MIN,0,240,31,76,0.408,25,47,0.532,6,29,0.207,19,26,0.731,87,45,80,0.563,32,50,0.64,13,30,0.433,18,30,0.6,121
1507,MIA,2024-01-21,87,@,ORL,0,240,30,80,0.375,18,43,0.419,12,37,0.324,15,18,0.833,87,37,78,0.474,28,50,0.56,9,28,0.321,22,28,0.786,105
1508,CHO,2024-01-14,87,@,MIA,0,240,33,95,0.347,23,54,0.426,10,41,0.244,11,15,0.733,87,40,81,0.494,29,56,0.518,11,25,0.44,13,16,0.813,104
1509,SAS,2023-11-14,87,@,OKC,0,240,36,93,0.387,27,63,0.429,9,30,0.3,6,9,0.667,87,46,89,0.517,31,50,0.62,15,39,0.385,16,20,0.8,123
1510,NYK,2023-10-28,87,@,NOP,0,240,33,90,0.367,26,53,0.491,7,37,0.189,14,18,0.778,87,40,87,0.46,31,54,0.574,9,33,0.273,7,16,0.438,96
1511,DEN,2023-11-24,86,@,HOU,0,240,32,94,0.34,25,64,0.391,7,30,0.233,15,21,0.714,86,40,82,0.488,28,53,0.528,12,29,0.414,13,15,0.867,105
1512,HOU,2023-10-25,86,@,ORL,0,240,32,79,0.405,20,45,0.444,12,34,0.353,10,16,0.625,86,42,87,0.483,33,53,0.623,9,34,0.265,23,26,0.885,116
1513,BRK,2024-01-02,85,@,NOP,0,240,35,98,0.357,24,55,0.436,11,43,0.256,4,8,0.5,85,41,88,0.466,25,49,0.51,16,39,0.41,14,18,0.778,112
1514,DEN,2024-01-25,84,@,NYK,0,240,34,84,0.405,29,58,0.5,5,26,0.192,11,13,0.846,84,45,85,0.529,30,47,0.638,15,38,0.395,17,20,0.85,122
1515,POR,2024-01-09,84,@,NYK,0,240,33,86,0.384,27,57,0.474,6,29,0.207,12,18,0.667,84,37,89,0.416,19,41,0.463,18,48,0.375,20,23,0.87,112
1516,NOP,2024-01-26,83,,OKC,0,240,32,82,0.39,23,46,0.5,9,36,0.25,10,14,0.714,83,42,88,0.477,32,55,0.582,10,33,0.303,13,14,0.929,107
1517,SAS,2023-10-29,83,@,LAC,0,240,30,80,0.375,19,47,0.404,11,33,0.333,12,16,0.75,83,47,91,0.516,31,49,0.633,16,42,0.381,13,21,0.619,123
1518,CHO,2023-12-16,82,,PHI,0,240,33,91,0.363,26,56,0.464,7,35,0.2,9,11,0.818,82,53,88,0.602,39,57,0.684,14,31,0.452,15,17,0.882,135
1519,SAS,2023-12-11,82,@,HOU,0,240,31,87,0.356,26,46,0.565,5,41,0.122,15,22,0.682,82,32,93,0.344,20,54,0.37,12,39,0.308,17,20,0.85,93
1520,POR,2024-01-11,77,@,OKC,0,240,28,101,0.277,17,52,0.327,11,49,0.224,10,16,0.625,77,53,93,0.57,39,58,0.672,14,35,0.4,19,22,0.864,139
