Rk,Team,Date,PTS,Unnamed: 4,Opp,Result,MP,FG,FGA,FG%,2P,2PA,2P%,3P,3PA,3P%,FT,FTA,FT%,PTS.1,FG.1,FGA.1,FG%.1,2P.1,2PA.1,2P%.1,3P.1,3PA.1,3P%.1,FT.1,FTA.1,FT%.1,PTS.2
1,SAC,2023-02-24,176,@,LAC,1,290,65,111,0.586,47,70,0.671,18,41,0.439,28,35,0.8,176,59,98,0.602,33,53,0.623,26,45,0.578,31,36,0.861,175
2,LAC,2023-02-24,175,,SAC,0,290,59,98,0.602,33,53,0.623,26,45,0.578,31,36,0.861,175,65,111,0.586,47,70,0.671,18,41,0.439,28,35,0.8,176
3,GSW,2023-04-09,157,@,POR,1,240,58,96,0.604,31,47,0.66,27,49,0.551,14,16,0.875,157,38,95,0.4,29,60,0.483,9,35,0.257,16,24,0.667,101
4,OKC,2023-02-04,153,,HOU,1,240,56,97,0.577,35,51,0.686,21,46,0.457,20,23,0.87,153,45,89,0.506,35,59,0.593,10,30,0.333,21,27,0.778,121
5,SAC,2022-11-15,153,,BRK,1,240,56,94,0.596,36,53,0.679,20,41,0.488,21,25,0.84,153,40,81,0.494,29,53,0.547,11,28,0.393,30,33,0.909,121
6,MIN,2023-04-08,151,@,SAS,1,240,56,101,0.554,32,58,0.552,24,43,0.558,15,21,0.714,151,50,95,0.526,37,66,0.561,13,29,0.448,18,24,0.75,131
7,MEM,2023-03-24,151,,HOU,1,240,57,93,0.613,32,51,0.627,25,42,0.595,12,14,0.857,151,47,87,0.54,40,64,0.625,7,23,0.304,13,21,0.619,114
8,MIL,2023-01-23,150,@,DET,1,240,55,98,0.561,32,46,0.696,23,52,0.442,17,24,0.708,150,43,87,0.494,30,55,0.545,13,32,0.406,31,40,0.775,130
9,OKC,2023-01-03,150,,BOS,1,240,58,98,0.592,38,58,0.655,20,40,0.5,14,22,0.636,150,40,88,0.455,28,48,0.583,12,40,0.3,25,31,0.806,117
10,MIN,2022-12-18,150,,CHI,1,240,57,87,0.655,34,44,0.773,23,43,0.535,13,16,0.813,150,46,88,0.523,30,50,0.6,16,38,0.421,18,24,0.75,126
11,MIL,2023-03-29,149,@,IND,1,240,58,93,0.624,48,68,0.706,10,25,0.4,23,30,0.767,149,53,101,0.525,39,71,0.549,14,30,0.467,16,22,0.727,136
12,PHI,2023-03-06,147,@,IND,1,240,48,82,0.585,32,48,0.667,16,34,0.471,35,38,0.921,147,53,90,0.589,38,53,0.717,15,37,0.405,22,31,0.71,143
13,POR,2023-01-23,147,,SAS,1,240,55,92,0.598,35,59,0.593,20,33,0.606,17,22,0.773,147,47,90,0.522,34,63,0.54,13,27,0.481,20,26,0.769,127
14,PHI,2023-01-10,147,,DET,1,240,54,89,0.607,43,58,0.741,11,31,0.355,28,30,0.933,147,36,89,0.404,22,50,0.44,14,39,0.359,30,36,0.833,116
15,DEN,2023-02-07,146,,MIN,1,240,58,93,0.624,45,66,0.682,13,27,0.481,17,22,0.773,146,40,85,0.471,30,50,0.6,10,35,0.286,22,26,0.846,112
16,CLE,2023-01-02,145,,CHI,1,265,48,92,0.522,32,46,0.696,16,46,0.348,33,45,0.733,145,47,95,0.495,37,62,0.597,10,33,0.303,30,34,0.882,134
17,OKC,2022-11-13,145,@,NYK,1,240,55,88,0.625,38,57,0.667,17,31,0.548,18,20,0.9,145,48,97,0.495,38,66,0.576,10,31,0.323,29,33,0.879,135
18,MIL,2023-03-24,144,@,UTA,1,240,55,99,0.556,33,49,0.673,22,50,0.44,12,16,0.75,144,40,104,0.385,29,64,0.453,11,40,0.275,25,34,0.735,116
19,CHO,2023-02-13,144,,ATL,1,240,53,84,0.631,33,47,0.702,20,37,0.541,18,23,0.783,144,53,108,0.491,42,80,0.525,11,28,0.393,21,21,1.0,138
20,GSW,2023-01-13,144,@,SAS,1,240,55,101,0.545,37,53,0.698,18,48,0.375,16,20,0.8,144,40,88,0.455,32,66,0.485,8,22,0.364,25,34,0.735,113
21,CHI,2022-12-10,144,,DAL,1,240,54,85,0.635,35,51,0.686,19,34,0.559,17,24,0.708,144,41,90,0.456,30,46,0.652,11,44,0.25,22,26,0.846,115
22,ATL,2023-03-25,143,,IND,1,240,53,96,0.552,38,66,0.576,15,30,0.5,22,25,0.88,143,52,96,0.542,38,59,0.644,14,37,0.378,12,12,1.0,130
23,IND,2023-03-06,143,,PHI,0,240,53,90,0.589,38,53,0.717,15,37,0.405,22,31,0.71,143,48,82,0.585,32,48,0.667,16,34,0.471,35,38,0.921,147
24,MIN,2023-02-08,143,@,UTA,1,240,56,98,0.571,33,55,0.6,23,43,0.535,8,8,1.0,143,44,105,0.419,32,71,0.451,12,34,0.353,18,21,0.857,118
25,GSW,2023-01-02,143,,ATL,1,290,54,121,0.446,35,62,0.565,19,59,0.322,16,24,0.667,143,53,109,0.486,42,74,0.568,11,35,0.314,24,29,0.828,141
26,BRK,2022-12-21,143,,GSW,1,240,54,84,0.643,33,51,0.647,21,33,0.636,14,16,0.875,143,41,83,0.494,29,50,0.58,12,33,0.364,19,25,0.76,113
27,LAL,2022-11-26,143,@,SAS,1,240,47,81,0.58,30,48,0.625,17,33,0.515,32,37,0.865,143,53,105,0.505,35,68,0.515,18,37,0.486,14,20,0.7,138
28,TOR,2022-11-02,143,@,SAS,1,240,57,106,0.538,43,73,0.589,14,33,0.424,15,16,0.938,143,37,94,0.394,23,51,0.451,14,43,0.326,12,14,0.857,100
29,SAS,2023-04-02,142,@,SAC,1,265,52,98,0.531,39,64,0.609,13,34,0.382,25,29,0.862,142,49,103,0.476,38,59,0.644,11,44,0.25,25,32,0.781,134
30,HOU,2023-03-05,142,,SAS,1,240,52,85,0.612,39,61,0.639,13,24,0.542,25,29,0.862,142,43,93,0.462,32,59,0.542,11,34,0.324,13,21,0.619,110
31,NYK,2023-03-01,142,,BRK,1,240,54,89,0.607,34,54,0.63,20,35,0.571,14,21,0.667,142,42,90,0.467,27,51,0.529,15,39,0.385,19,20,0.95,118
32,DAL,2023-02-23,142,,SAS,1,240,46,82,0.561,24,40,0.6,22,42,0.524,28,36,0.778,142,45,86,0.523,35,61,0.574,10,25,0.4,16,23,0.696,116
33,BOS,2023-02-23,142,@,IND,1,265,51,99,0.515,33,60,0.55,18,39,0.462,22,26,0.846,142,49,94,0.521,27,45,0.6,22,49,0.449,18,22,0.818,138
34,LAC,2022-12-26,142,@,DET,1,265,49,91,0.538,30,47,0.638,19,44,0.432,25,29,0.862,142,44,100,0.44,28,66,0.424,16,34,0.471,27,34,0.794,131
35,MEM,2022-12-15,142,,MIL,1,240,56,102,0.549,44,70,0.629,12,32,0.375,18,23,0.783,142,35,94,0.372,22,44,0.5,13,50,0.26,18,27,0.667,101
36,WAS,2022-11-28,142,,MIN,1,240,52,91,0.571,37,60,0.617,15,31,0.484,23,27,0.852,142,42,84,0.5,35,57,0.614,7,27,0.259,36,42,0.857,127
37,IND,2023-04-09,141,@,NYK,1,240,46,89,0.517,27,55,0.491,19,34,0.559,30,38,0.789,141,52,108,0.481,37,68,0.544,15,40,0.375,17,22,0.773,136
38,LAC,2023-03-29,141,@,MEM,1,240,48,78,0.615,26,41,0.634,22,37,0.595,23,31,0.742,141,49,95,0.516,38,63,0.603,11,32,0.344,23,28,0.821,132
39,PHI,2023-03-18,141,@,IND,1,240,54,88,0.614,39,53,0.736,15,35,0.429,18,22,0.818,141,45,87,0.517,33,56,0.589,12,31,0.387,19,20,0.95,121
40,GSW,2023-02-06,141,,OKC,1,240,56,97,0.577,30,47,0.638,26,50,0.52,3,7,0.429,141,44,91,0.484,33,59,0.559,11,32,0.344,15,21,0.714,114
41,MIL,2023-01-27,141,@,IND,1,240,52,98,0.531,34,55,0.618,18,43,0.419,19,31,0.613,141,49,89,0.551,36,56,0.643,13,33,0.394,20,28,0.714,131
42,ATL,2023-01-02,141,@,GSW,0,290,53,109,0.486,42,74,0.568,11,35,0.314,24,29,0.828,141,54,121,0.446,35,62,0.565,19,59,0.322,16,24,0.667,143
43,DET,2022-12-14,141,@,CHO,1,265,48,93,0.516,30,53,0.566,18,40,0.45,27,36,0.75,141,47,114,0.412,30,63,0.476,17,51,0.333,23,29,0.793,134
44,DEN,2022-12-14,141,,WAS,1,240,54,83,0.651,50,67,0.746,4,16,0.25,29,35,0.829,141,48,91,0.527,29,52,0.558,19,39,0.487,13,23,0.565,128
45,MIL,2023-04-04,140,@,WAS,1,240,50,92,0.543,27,50,0.54,23,42,0.548,17,29,0.586,140,50,99,0.505,37,72,0.514,13,27,0.481,15,21,0.714,128
46,BOS,2023-03-30,140,@,MIL,1,240,51,91,0.56,29,48,0.604,22,43,0.512,16,20,0.8,140,38,101,0.376,24,58,0.414,14,43,0.326,9,13,0.692,99
47,MIN,2023-03-20,140,@,NYK,1,240,51,83,0.614,37,59,0.627,14,24,0.583,24,32,0.75,140,48,85,0.565,34,57,0.596,14,28,0.5,24,28,0.857,134
48,SAC,2023-02-06,140,@,HOU,1,240,52,89,0.584,31,48,0.646,21,41,0.512,15,18,0.833,140,44,88,0.5,31,56,0.554,13,32,0.406,19,24,0.792,120
49,LAL,2023-01-16,140,,HOU,1,240,49,91,0.538,37,58,0.638,12,33,0.364,30,35,0.857,140,49,100,0.49,38,70,0.543,11,30,0.367,23,31,0.742,132
50,POR,2023-01-15,140,,DAL,1,240,43,85,0.506,26,41,0.634,17,44,0.386,37,42,0.881,140,41,89,0.461,27,47,0.574,14,42,0.333,27,33,0.818,123
51,NYK,2022-11-29,140,@,DET,1,240,54,96,0.563,38,61,0.623,16,35,0.457,16,21,0.762,140,42,83,0.506,29,44,0.659,13,39,0.333,13,20,0.65,110
52,BOS,2022-11-28,140,,CHO,1,240,55,93,0.591,31,41,0.756,24,52,0.462,6,7,0.857,140,42,86,0.488,31,57,0.544,11,29,0.379,10,15,0.667,105
53,CHI,2023-03-17,139,,MIN,1,290,51,94,0.543,40,70,0.571,11,24,0.458,26,30,0.867,139,46,100,0.46,28,58,0.483,18,42,0.429,21,31,0.677,131
54,IND,2023-03-16,139,@,MIL,1,240,54,97,0.557,32,51,0.627,22,46,0.478,9,15,0.6,139,47,89,0.528,36,57,0.632,11,32,0.344,18,26,0.692,123
55,MIL,2023-03-01,139,,ORL,1,240,49,94,0.521,23,38,0.605,26,56,0.464,15,19,0.789,139,43,94,0.457,34,61,0.557,9,33,0.273,22,29,0.759,117
56,BOS,2023-02-01,139,,BRK,1,240,53,92,0.576,27,38,0.711,26,54,0.481,7,10,0.7,139,36,88,0.409,27,49,0.551,9,39,0.231,15,18,0.833,96
57,ATL,2023-01-20,139,,NYK,1,240,56,100,0.56,43,66,0.652,13,34,0.382,14,16,0.875,139,49,83,0.59,36,53,0.679,13,30,0.433,13,17,0.765,124
58,SAC,2023-01-13,139,,HOU,1,240,47,86,0.547,27,46,0.587,20,40,0.5,25,29,0.862,139,43,91,0.473,31,54,0.574,12,37,0.324,16,25,0.64,114
59,BRK,2023-01-02,139,,SAS,1,240,58,93,0.624,47,73,0.644,11,20,0.55,12,15,0.8,139,42,97,0.433,34,66,0.515,8,31,0.258,11,18,0.611,103
60,BOS,2022-12-25,139,,MIL,1,240,50,85,0.588,31,46,0.674,19,39,0.487,20,25,0.8,139,42,84,0.5,29,48,0.604,13,36,0.361,21,27,0.778,118
61,UTA,2022-12-02,139,,IND,1,240,46,83,0.554,31,49,0.633,15,34,0.441,32,37,0.865,139,40,92,0.435,28,58,0.483,12,34,0.353,27,33,0.818,119
62,UTA,2022-11-07,139,,LAL,1,240,53,95,0.558,37,57,0.649,16,38,0.421,17,22,0.773,139,40,82,0.488,31,58,0.534,9,24,0.375,27,30,0.9,116
63,TOR,2022-10-31,139,,ATL,1,240,46,92,0.5,32,58,0.552,14,34,0.412,33,40,0.825,139,39,84,0.464,28,55,0.509,11,29,0.379,20,25,0.8,109
64,SAS,2023-04-09,138,@,DAL,1,240,51,104,0.49,36,66,0.545,15,38,0.395,21,30,0.7,138,46,108,0.426,29,55,0.527,17,53,0.321,8,16,0.5,117
65,NYK,2023-04-05,138,@,IND,1,240,52,100,0.52,34,54,0.63,18,46,0.391,16,25,0.64,138,45,87,0.517,30,57,0.526,15,30,0.5,24,30,0.8,129
66,NOP,2023-04-05,138,,MEM,1,265,44,88,0.5,23,49,0.469,21,39,0.538,29,39,0.744,138,50,104,0.481,38,68,0.559,12,36,0.333,19,25,0.76,131
67,SAC,2023-03-31,138,@,POR,1,240,54,88,0.614,35,49,0.714,19,39,0.487,11,15,0.733,138,40,85,0.471,21,47,0.447,19,38,0.5,15,23,0.652,114
68,MIA,2023-03-15,138,,MEM,1,240,49,82,0.598,36,53,0.679,13,29,0.448,27,33,0.818,138,46,91,0.505,28,45,0.622,18,46,0.391,9,14,0.643,119
69,MIN,2023-03-04,138,@,SAC,1,240,48,80,0.6,28,41,0.683,20,39,0.513,22,31,0.71,138,49,89,0.551,35,62,0.565,14,27,0.519,22,30,0.733,134
70,IND,2023-02-23,138,,BOS,0,265,49,94,0.521,27,45,0.6,22,49,0.449,18,22,0.818,138,51,99,0.515,33,60,0.55,18,39,0.462,22,26,0.846,142
71,ATL,2023-02-13,138,@,CHO,0,240,53,108,0.491,42,80,0.525,11,28,0.393,21,21,1.0,138,53,84,0.631,33,47,0.702,20,37,0.541,18,23,0.783,144
72,OKC,2023-02-10,138,@,POR,1,240,47,83,0.566,35,59,0.593,12,24,0.5,32,35,0.914,138,42,76,0.553,26,36,0.722,16,40,0.4,29,31,0.935,129
73,DET,2023-02-10,138,,SAS,1,290,46,107,0.43,39,70,0.557,7,37,0.189,39,49,0.796,138,45,107,0.421,31,65,0.477,14,42,0.333,27,34,0.794,131
74,LAC,2023-01-26,138,,SAS,1,240,52,89,0.584,34,51,0.667,18,38,0.474,16,21,0.762,138,37,82,0.451,29,58,0.5,8,24,0.333,18,28,0.643,100
75,WAS,2023-01-21,138,,ORL,1,240,51,95,0.537,33,61,0.541,18,34,0.529,18,25,0.72,138,42,90,0.467,28,56,0.5,14,34,0.412,20,24,0.833,118
76,CHO,2023-01-06,138,@,MIL,1,240,53,102,0.52,33,54,0.611,20,48,0.417,12,19,0.632,138,37,84,0.44,17,36,0.472,20,48,0.417,15,24,0.625,109
77,SAS,2022-11-26,138,,LAL,0,240,53,105,0.505,35,68,0.515,18,37,0.486,14,20,0.7,138,47,81,0.58,30,48,0.625,17,33,0.515,32,37,0.865,143
78,MEM,2023-04-07,137,@,MIL,1,240,53,93,0.57,33,51,0.647,20,42,0.476,11,15,0.733,137,42,92,0.457,21,43,0.488,21,49,0.429,9,11,0.818,114
79,CHO,2023-03-28,137,@,OKC,1,240,52,94,0.553,38,59,0.644,14,35,0.4,19,30,0.633,137,50,96,0.521,39,66,0.591,11,30,0.367,23,29,0.793,134
80,NYK,2023-03-27,137,,HOU,1,240,50,86,0.581,33,47,0.702,17,39,0.436,20,28,0.714,137,42,87,0.483,35,61,0.574,7,26,0.269,24,29,0.828,115
81,BOS,2023-03-26,137,,SAS,1,240,52,91,0.571,34,47,0.723,18,44,0.409,15,21,0.714,137,36,97,0.371,28,61,0.459,8,36,0.222,13,18,0.722,93
82,DAL,2023-03-15,137,@,SAS,1,265,44,86,0.512,27,53,0.509,17,33,0.515,32,37,0.865,137,49,107,0.458,34,73,0.466,15,34,0.441,15,26,0.577,128
83,OKC,2023-03-07,137,,GSW,1,240,50,94,0.532,33,57,0.579,17,37,0.459,20,24,0.833,137,47,89,0.528,27,38,0.711,20,51,0.392,14,16,0.875,128
84,PHI,2023-02-03,137,@,SAS,1,240,46,87,0.529,33,60,0.55,13,27,0.481,32,41,0.78,137,52,89,0.584,45,68,0.662,7,21,0.333,14,15,0.933,125
85,ATL,2023-01-25,137,@,OKC,1,240,50,84,0.595,39,55,0.709,11,29,0.379,26,33,0.788,137,53,102,0.52,38,68,0.559,15,34,0.441,11,16,0.688,132
86,PHI,2023-01-25,137,,BRK,1,240,42,82,0.512,24,44,0.545,18,38,0.474,35,36,0.972,137,49,76,0.645,35,50,0.7,14,26,0.538,21,27,0.778,133
87,SAC,2022-11-30,137,,IND,1,240,48,95,0.505,32,52,0.615,16,43,0.372,25,29,0.862,137,40,100,0.4,28,63,0.444,12,37,0.324,22,30,0.733,114
88,GSW,2022-11-27,137,@,MIN,1,240,50,87,0.575,30,40,0.75,20,47,0.426,17,20,0.85,137,39,88,0.443,25,53,0.472,14,35,0.4,22,29,0.759,114
89,SAC,2022-11-20,137,,DET,1,240,47,85,0.553,35,50,0.7,12,35,0.343,31,35,0.886,137,47,89,0.528,32,60,0.533,15,29,0.517,20,23,0.87,129
90,DAL,2022-10-22,137,,MEM,1,240,45,90,0.5,28,51,0.549,17,39,0.436,30,36,0.833,137,34,79,0.43,25,46,0.543,9,33,0.273,19,24,0.792,96
91,SAS,2022-10-21,137,@,IND,1,240,44,81,0.543,27,50,0.54,17,31,0.548,32,44,0.727,137,51,104,0.49,40,69,0.58,11,35,0.314,21,22,0.955,134
92,NYK,2023-04-09,136,,IND,0,240,52,108,0.481,37,68,0.544,15,40,0.375,17,22,0.773,136,46,89,0.517,27,55,0.491,19,34,0.559,30,38,0.789,141
93,LAC,2023-04-08,136,,POR,1,240,49,93,0.527,37,58,0.638,12,35,0.343,26,30,0.867,136,47,89,0.528,33,57,0.579,14,32,0.438,17,23,0.739,125
94,PHI,2023-04-07,136,@,ATL,1,265,51,102,0.5,40,80,0.5,11,22,0.5,23,29,0.793,136,51,92,0.554,41,59,0.695,10,33,0.303,19,28,0.679,131
95,GSW,2023-04-04,136,,OKC,1,240,47,95,0.495,27,48,0.563,20,47,0.426,22,30,0.733,136,44,93,0.473,33,61,0.541,11,32,0.344,26,35,0.743,125
96,IND,2023-03-29,136,,MIL,0,240,53,101,0.525,39,71,0.549,14,30,0.467,16,22,0.727,136,58,93,0.624,48,68,0.706,10,25,0.4,23,30,0.767,149
97,WAS,2023-03-24,136,,SAS,1,240,51,85,0.6,36,55,0.655,15,30,0.5,19,26,0.731,136,51,101,0.505,38,63,0.603,13,38,0.342,9,15,0.6,124
98,MIN,2023-03-13,136,@,ATL,1,240,54,92,0.587,42,64,0.656,12,28,0.429,16,23,0.696,136,44,97,0.454,40,75,0.533,4,22,0.182,23,28,0.821,115
99,ATL,2023-02-24,136,,CLE,1,240,50,85,0.588,35,57,0.614,15,28,0.536,21,23,0.913,136,40,88,0.455,27,53,0.509,13,35,0.371,26,29,0.897,119
100,NOP,2023-02-05,136,,SAC,1,240,48,85,0.565,34,59,0.576,14,26,0.538,26,34,0.765,136,35,82,0.427,24,40,0.6,11,42,0.262,23,27,0.852,104
101,MEM,2023-01-16,136,,PHO,1,240,52,98,0.531,36,61,0.59,16,37,0.432,16,20,0.8,136,39,89,0.438,29,56,0.518,10,33,0.303,18,19,0.947,106
102,POR,2023-01-14,136,,DAL,1,240,49,88,0.557,32,47,0.681,17,41,0.415,21,22,0.955,136,43,82,0.524,21,36,0.583,22,46,0.478,11,19,0.579,119
103,SAC,2023-01-09,136,,ORL,1,240,52,97,0.536,29,51,0.569,23,46,0.5,9,12,0.75,136,41,90,0.456,27,46,0.587,14,44,0.318,15,20,0.75,111
104,LAL,2023-01-07,136,@,SAC,1,240,50,82,0.61,41,61,0.672,9,21,0.429,27,33,0.818,136,45,86,0.523,31,54,0.574,14,32,0.438,30,37,0.811,134
105,BRK,2022-12-10,136,@,IND,1,240,52,100,0.52,43,72,0.597,9,28,0.321,23,32,0.719,136,47,85,0.553,26,41,0.634,21,44,0.477,18,24,0.75,133
106,MIL,2022-11-09,136,@,OKC,1,290,50,106,0.472,33,70,0.471,17,36,0.472,19,22,0.864,136,50,111,0.45,32,66,0.485,18,45,0.4,14,19,0.737,132
107,ATL,2022-10-28,136,@,DET,1,240,55,97,0.567,43,68,0.632,12,29,0.414,14,18,0.778,136,37,86,0.43,30,54,0.556,7,32,0.219,31,38,0.816,112
108,LAL,2023-04-04,135,@,UTA,1,265,48,96,0.5,36,62,0.581,12,34,0.353,27,35,0.771,135,47,90,0.522,32,57,0.561,15,33,0.455,24,31,0.774,133
109,SAC,2023-03-24,135,,PHO,1,240,47,89,0.528,34,50,0.68,13,39,0.333,28,32,0.875,135,48,89,0.539,39,60,0.65,9,29,0.31,22,29,0.759,127
110,LAC,2023-03-05,135,,MEM,1,240,45,85,0.529,33,56,0.589,12,29,0.414,33,35,0.943,135,50,92,0.543,32,58,0.552,18,34,0.529,11,15,0.733,129
111,GSW,2023-02-13,135,,WAS,1,240,52,89,0.584,32,49,0.653,20,40,0.5,11,15,0.733,135,48,80,0.6,36,52,0.692,12,28,0.429,18,21,0.857,126
112,MIL,2023-01-29,135,,NOP,1,240,53,96,0.552,36,53,0.679,17,43,0.395,12,20,0.6,135,41,93,0.441,28,59,0.475,13,34,0.382,15,21,0.714,110
113,SAC,2023-01-11,135,,HOU,1,240,45,94,0.479,26,46,0.565,19,48,0.396,26,31,0.839,135,44,96,0.458,28,55,0.509,16,41,0.39,11,17,0.647,115
114,MEM,2023-01-11,135,,SAS,1,240,52,101,0.515,38,79,0.481,14,22,0.636,17,25,0.68,135,50,107,0.467,39,73,0.534,11,34,0.324,18,23,0.783,129
115,DET,2023-01-11,135,,MIN,1,240,48,80,0.6,31,48,0.646,17,32,0.531,22,28,0.786,135,43,88,0.489,27,55,0.491,16,33,0.485,16,21,0.762,118
116,POR,2023-01-02,135,,DET,1,240,48,84,0.571,34,53,0.642,14,31,0.452,25,35,0.714,135,34,82,0.415,28,64,0.438,6,18,0.333,32,41,0.78,106
117,IND,2022-12-29,135,,CLE,1,240,48,85,0.565,29,54,0.537,19,31,0.613,20,21,0.952,135,50,96,0.521,38,68,0.559,12,28,0.429,14,20,0.7,126
118,ORL,2022-12-14,135,,ATL,1,240,47,93,0.505,31,57,0.544,16,36,0.444,25,30,0.833,135,44,88,0.5,32,53,0.604,12,35,0.343,24,27,0.889,124
119,OKC,2022-12-03,135,@,MIN,1,240,48,93,0.516,37,67,0.552,11,26,0.423,28,35,0.8,135,47,89,0.528,37,59,0.627,10,30,0.333,24,30,0.8,128
120,NYK,2022-11-13,135,,OKC,0,240,48,97,0.495,38,66,0.576,10,31,0.323,29,33,0.879,135,55,88,0.625,38,57,0.667,17,31,0.548,18,20,0.9,145
121,POR,2022-10-24,135,,DEN,1,240,48,83,0.578,32,48,0.667,16,35,0.457,23,31,0.742,135,45,91,0.495,33,60,0.55,12,31,0.387,8,14,0.571,110
122,PHI,2023-04-09,134,@,BRK,1,240,53,101,0.525,39,69,0.565,14,32,0.438,14,19,0.737,134,35,83,0.422,23,51,0.451,12,32,0.375,23,28,0.821,105
123,ATL,2023-04-05,134,,WAS,1,240,43,84,0.512,30,54,0.556,13,30,0.433,35,40,0.875,134,45,94,0.479,39,66,0.591,6,28,0.214,20,26,0.769,116
124,LAL,2023-04-02,134,@,HOU,1,240,52,93,0.559,43,63,0.683,9,30,0.3,21,28,0.75,134,44,102,0.431,31,68,0.456,13,34,0.382,8,10,0.8,109
125,SAC,2023-04-02,134,,SAS,0,265,49,103,0.476,38,59,0.644,11,44,0.25,25,32,0.781,134,52,98,0.531,39,64,0.609,13,34,0.382,25,29,0.862,142
126,OKC,2023-03-28,134,,CHO,0,240,50,96,0.521,39,66,0.591,11,30,0.367,23,29,0.793,134,52,94,0.553,38,59,0.644,14,35,0.4,19,30,0.633,137
127,NYK,2023-03-20,134,,MIN,0,240,48,85,0.565,34,57,0.596,14,28,0.5,24,28,0.857,134,51,83,0.614,37,59,0.627,14,24,0.583,24,32,0.75,140
128,LAC,2023-03-15,134,,GSW,1,240,46,96,0.479,30,62,0.484,16,34,0.471,26,32,0.813,134,49,88,0.557,32,52,0.615,17,36,0.472,11,15,0.733,126
129,BOS,2023-03-11,134,@,ATL,1,240,52,95,0.547,32,53,0.604,20,42,0.476,10,12,0.833,134,50,100,0.5,40,66,0.606,10,34,0.294,15,16,0.938,125
130,IND,2023-03-09,134,,HOU,1,265,48,100,0.48,30,55,0.545,18,45,0.4,20,21,0.952,134,49,107,0.458,43,90,0.478,6,17,0.353,21,29,0.724,125
131,MIL,2023-03-07,134,@,ORL,1,240,46,78,0.59,36,50,0.72,10,28,0.357,32,34,0.941,134,50,100,0.5,41,70,0.586,9,30,0.3,14,19,0.737,123
132,SAC,2023-03-04,134,,MIN,0,240,49,89,0.551,35,62,0.565,14,27,0.519,22,30,0.733,134,48,80,0.6,28,41,0.683,20,39,0.513,22,31,0.71,138
133,DEN,2023-02-26,134,,LAC,1,265,49,96,0.51,36,57,0.632,13,39,0.333,23,31,0.742,134,44,90,0.489,33,56,0.589,11,34,0.324,25,30,0.833,124
134,LAC,2023-02-14,134,,GSW,1,240,49,92,0.533,32,56,0.571,17,36,0.472,19,22,0.864,134,45,83,0.542,30,49,0.612,15,34,0.441,19,27,0.704,124
135,LAC,2023-02-04,134,@,NYK,1,265,44,92,0.478,28,55,0.509,16,37,0.432,30,35,0.857,134,45,94,0.479,27,54,0.5,18,40,0.45,20,26,0.769,128
136,DEN,2023-02-02,134,,GSW,1,240,51,90,0.567,35,55,0.636,16,35,0.457,16,21,0.762,134,43,85,0.506,24,47,0.511,19,38,0.5,12,19,0.632,117
137,POR,2023-01-25,134,,UTA,1,240,51,89,0.573,34,53,0.642,17,36,0.472,15,18,0.833,134,47,90,0.522,27,49,0.551,20,41,0.488,10,15,0.667,124
138,DEN,2023-01-20,134,,IND,1,240,51,83,0.614,37,55,0.673,14,28,0.5,18,26,0.692,134,37,84,0.44,29,52,0.558,8,32,0.25,29,37,0.784,111
139,SAC,2023-01-07,134,,LAL,0,240,45,86,0.523,31,54,0.574,14,32,0.438,30,37,0.811,134,50,82,0.61,41,61,0.672,9,21,0.429,27,33,0.818,136
140,CHI,2023-01-02,134,@,CLE,0,265,47,95,0.495,37,62,0.597,10,33,0.303,30,34,0.882,134,48,92,0.522,32,46,0.696,16,46,0.348,33,45,0.733,145
141,CHO,2022-12-23,134,@,LAL,1,240,52,94,0.553,36,53,0.679,16,41,0.39,14,18,0.778,134,48,92,0.522,29,48,0.604,19,44,0.432,15,22,0.682,130
142,SAC,2022-12-21,134,,LAL,1,240,48,95,0.505,31,48,0.646,17,47,0.362,21,28,0.75,134,42,84,0.5,31,60,0.517,11,24,0.458,25,30,0.833,120
143,CHO,2022-12-14,134,,DET,0,265,47,114,0.412,30,63,0.476,17,51,0.333,23,29,0.793,134,48,93,0.516,30,53,0.566,18,40,0.45,27,36,0.75,141
144,BOS,2022-11-30,134,,MIA,1,240,46,83,0.554,24,38,0.632,22,45,0.489,20,23,0.87,134,47,90,0.522,29,50,0.58,18,40,0.45,9,9,1.0,121
145,UTA,2022-11-18,134,,PHO,1,240,51,91,0.56,35,60,0.583,16,31,0.516,16,24,0.667,134,49,94,0.521,40,64,0.625,9,30,0.3,26,28,0.929,133
146,HOU,2022-11-07,134,@,ORL,1,240,46,87,0.529,22,39,0.564,24,48,0.5,18,25,0.72,134,45,82,0.549,33,57,0.579,12,25,0.48,25,31,0.806,127
147,NYK,2022-10-26,134,,CHO,1,265,52,97,0.536,41,67,0.612,11,30,0.367,19,22,0.864,134,49,99,0.495,36,68,0.529,13,31,0.419,20,30,0.667,131
148,MIN,2022-10-26,134,,SAS,1,240,52,80,0.65,32,46,0.696,20,34,0.588,10,16,0.625,134,43,95,0.453,27,59,0.458,16,36,0.444,20,22,0.909,122
149,PHO,2022-10-25,134,,GSW,1,240,47,92,0.511,35,63,0.556,12,29,0.414,28,34,0.824,134,41,91,0.451,31,56,0.554,10,35,0.286,13,17,0.765,105
150,MEM,2022-10-24,134,,BRK,1,240,47,94,0.5,31,60,0.517,16,34,0.471,24,31,0.774,134,47,87,0.54,38,58,0.655,9,29,0.31,21,26,0.808,124
151,IND,2022-10-21,134,,SAS,0,240,51,104,0.49,40,69,0.58,11,35,0.314,21,22,0.955,134,44,81,0.543,27,50,0.54,17,31,0.548,32,44,0.727,137
152,UTA,2023-04-04,133,,LAL,0,265,47,90,0.522,32,57,0.561,15,33,0.455,24,31,0.774,133,48,96,0.5,36,62,0.581,12,34,0.353,27,35,0.771,135
153,MEM,2023-03-18,133,,GSW,1,240,52,95,0.547,34,57,0.596,18,38,0.474,11,17,0.647,133,39,91,0.429,26,56,0.464,13,35,0.371,28,34,0.824,119
154,MIL,2023-03-13,133,@,SAC,1,240,50,86,0.581,35,53,0.66,15,33,0.455,18,22,0.818,133,46,104,0.442,25,54,0.463,21,50,0.42,11,15,0.733,124
155,PHI,2023-03-04,133,@,MIL,1,240,42,84,0.5,24,47,0.511,18,37,0.486,31,37,0.838,133,44,83,0.53,27,49,0.551,17,34,0.5,25,28,0.893,130
156,DAL,2023-03-02,133,,PHI,1,240,45,82,0.549,20,34,0.588,25,48,0.521,18,27,0.667,133,45,78,0.577,33,51,0.647,12,27,0.444,24,29,0.828,126
157,DEN,2023-02-28,133,@,HOU,1,240,53,92,0.576,37,55,0.673,16,37,0.432,11,16,0.688,133,48,97,0.495,39,66,0.591,9,31,0.29,7,10,0.7,112
158,SAC,2023-02-23,133,,POR,1,240,47,85,0.553,33,51,0.647,14,34,0.412,25,31,0.806,133,43,93,0.462,27,55,0.491,16,38,0.421,14,17,0.824,116
159,OKC,2023-02-15,133,,HOU,1,240,42,87,0.483,33,53,0.623,9,34,0.265,40,47,0.851,133,30,89,0.337,20,52,0.385,10,37,0.27,26,38,0.684,96
160,SAC,2023-02-11,133,,DAL,1,265,51,100,0.51,43,68,0.632,8,32,0.25,23,25,0.92,133,47,91,0.516,27,40,0.675,20,51,0.392,14,19,0.737,128
161,OKC,2023-02-07,133,@,LAL,1,240,49,94,0.521,32,60,0.533,17,34,0.5,18,20,0.9,133,49,85,0.576,35,54,0.648,14,31,0.452,18,26,0.692,130
162,BRK,2023-01-25,133,@,PHI,0,240,49,76,0.645,35,50,0.7,14,26,0.538,21,27,0.778,133,42,82,0.512,24,44,0.545,18,38,0.474,35,36,0.972,137
163,LAC,2023-01-24,133,@,LAL,1,240,51,84,0.607,32,46,0.696,19,38,0.5,12,15,0.8,133,42,95,0.442,26,55,0.473,16,40,0.4,15,24,0.625,115
164,SAC,2023-01-23,133,,MEM,1,240,49,88,0.557,27,48,0.563,22,40,0.55,13,14,0.929,133,40,98,0.408,28,62,0.452,12,36,0.333,8,10,0.8,100
165,OKC,2023-01-12,133,@,PHI,1,240,44,86,0.512,30,53,0.566,14,33,0.424,31,33,0.939,133,39,88,0.443,28,52,0.538,11,36,0.306,25,27,0.926,114
166,HOU,2022-12-26,133,@,CHI,1,240,50,90,0.556,33,46,0.717,17,44,0.386,16,22,0.727,133,45,92,0.489,32,57,0.561,13,35,0.371,15,21,0.714,118
167,ORL,2022-12-23,133,,SAS,1,240,50,87,0.575,33,55,0.6,17,32,0.531,16,20,0.8,133,44,97,0.454,32,59,0.542,12,38,0.316,13,18,0.722,113
168,POR,2022-12-12,133,,MIN,1,240,48,89,0.539,27,43,0.628,21,46,0.457,16,21,0.762,133,46,93,0.495,36,66,0.545,10,27,0.37,10,19,0.526,112
169,IND,2022-12-10,133,,BRK,0,240,47,85,0.553,26,41,0.634,21,44,0.477,18,24,0.75,133,52,100,0.52,43,72,0.597,9,28,0.321,23,32,0.719,136
170,PHI,2022-12-09,133,,LAL,1,265,48,90,0.533,30,50,0.6,18,40,0.45,19,22,0.864,133,44,88,0.5,33,57,0.579,11,31,0.355,23,30,0.767,122
171,PHO,2022-12-04,133,@,SAS,1,240,49,94,0.521,30,57,0.526,19,37,0.514,16,20,0.8,133,38,87,0.437,32,56,0.571,6,31,0.194,13,18,0.722,95
172,LAL,2022-12-02,133,@,MIL,1,240,52,96,0.542,41,70,0.586,11,26,0.423,18,24,0.75,133,50,94,0.532,33,51,0.647,17,43,0.395,12,15,0.8,129
173,PHI,2022-11-27,133,@,ORL,1,240,50,77,0.649,39,50,0.78,11,27,0.407,22,27,0.815,133,36,79,0.456,24,39,0.615,12,40,0.3,19,25,0.76,103
174,PHO,2022-11-18,133,@,UTA,0,240,49,94,0.521,40,64,0.625,9,30,0.3,26,28,0.929,133,51,91,0.56,35,60,0.583,16,31,0.516,16,24,0.667,134
175,BOS,2022-11-05,133,@,NYK,1,240,47,88,0.534,20,37,0.541,27,51,0.529,12,12,1.0,133,46,90,0.511,35,63,0.556,11,27,0.407,15,16,0.938,118
176,ATL,2023-04-02,132,,DAL,1,265,51,108,0.472,39,73,0.534,12,35,0.343,18,22,0.818,132,49,95,0.516,39,57,0.684,10,38,0.263,22,32,0.688,130
177,MEM,2023-03-29,132,,LAC,0,240,49,95,0.516,38,63,0.603,11,32,0.344,23,28,0.821,132,48,78,0.615,26,41,0.634,22,37,0.595,23,31,0.742,141
178,BOS,2023-03-21,132,@,SAC,1,240,49,92,0.533,31,48,0.646,18,44,0.409,16,23,0.696,132,39,81,0.481,22,37,0.595,17,44,0.386,14,21,0.667,109
179,SAC,2023-03-18,132,@,WAS,1,240,48,86,0.558,26,49,0.531,22,37,0.595,14,23,0.609,132,41,91,0.451,28,55,0.509,13,36,0.361,23,27,0.852,118
180,SAS,2023-03-14,132,,ORL,1,240,48,85,0.565,26,44,0.591,22,41,0.537,14,18,0.778,132,44,97,0.454,34,68,0.5,10,29,0.345,16,21,0.762,114
181,PHO,2023-03-08,132,,OKC,1,240,49,94,0.521,29,51,0.569,20,43,0.465,14,16,0.875,132,33,88,0.375,18,45,0.4,15,43,0.349,20,21,0.952,101
182,ATL,2023-02-01,132,@,PHO,1,240,52,91,0.571,33,58,0.569,19,33,0.576,9,11,0.818,132,35,86,0.407,31,58,0.534,4,28,0.143,26,31,0.839,100
183,OKC,2023-01-25,132,,ATL,0,240,53,102,0.52,38,68,0.559,15,34,0.441,11,16,0.688,132,50,84,0.595,39,55,0.709,11,29,0.379,26,33,0.788,137
184,HOU,2023-01-16,132,@,LAL,0,240,49,100,0.49,38,70,0.543,11,30,0.367,23,31,0.742,132,49,91,0.538,37,58,0.638,12,33,0.364,30,35,0.857,140
185,MIL,2023-01-16,132,,IND,1,240,48,91,0.527,25,45,0.556,23,46,0.5,13,15,0.867,132,43,84,0.512,24,44,0.545,19,40,0.475,14,15,0.933,119
186,SAC,2023-01-15,132,@,SAS,1,240,49,89,0.551,35,59,0.593,14,30,0.467,20,25,0.8,132,48,93,0.516,38,67,0.567,10,26,0.385,13,20,0.65,119
187,CHI,2023-01-15,132,,GSW,1,240,48,95,0.505,33,56,0.589,15,39,0.385,21,24,0.875,132,41,83,0.494,20,32,0.625,21,51,0.412,15,22,0.682,118
188,TOR,2023-01-10,132,,CHO,1,240,45,91,0.495,25,47,0.532,20,44,0.455,22,27,0.815,132,47,86,0.547,32,51,0.627,15,35,0.429,11,15,0.733,120
189,NOP,2023-01-09,132,@,WAS,1,240,49,93,0.527,39,67,0.582,10,26,0.385,24,31,0.774,132,42,82,0.512,28,48,0.583,14,34,0.412,14,18,0.778,112
190,CHI,2022-12-30,132,,DET,1,240,53,92,0.576,41,65,0.631,12,27,0.444,14,15,0.933,132,41,86,0.477,24,47,0.511,17,39,0.436,19,24,0.792,118
191,NYK,2022-12-20,132,,GSW,1,240,45,87,0.517,28,47,0.596,17,40,0.425,25,32,0.781,132,35,74,0.473,23,39,0.59,12,35,0.343,12,13,0.923,94
192,UTA,2022-12-15,132,,NOP,1,265,42,92,0.457,24,45,0.533,18,47,0.383,30,37,0.811,132,47,99,0.475,35,69,0.507,12,30,0.4,23,28,0.821,129
193,HOU,2022-12-05,132,,PHI,1,290,42,94,0.447,28,55,0.509,14,39,0.359,34,44,0.773,132,39,87,0.448,22,51,0.431,17,36,0.472,28,36,0.778,123
194,PHO,2022-11-30,132,,CHI,1,240,49,93,0.527,34,60,0.567,15,33,0.455,19,21,0.905,132,41,82,0.5,37,57,0.649,4,25,0.16,27,33,0.818,113
195,MEM,2022-11-25,132,,NOP,1,240,47,91,0.516,29,53,0.547,18,38,0.474,20,27,0.741,132,37,86,0.43,27,55,0.491,10,31,0.323,27,31,0.871,111
196,POR,2022-11-25,132,@,NYK,1,265,42,85,0.494,32,53,0.604,10,32,0.313,38,51,0.745,132,46,105,0.438,33,64,0.516,13,41,0.317,24,28,0.857,129
197,CLE,2022-11-18,132,,CHO,1,290,49,92,0.533,41,64,0.641,8,28,0.286,26,32,0.813,132,44,110,0.4,30,66,0.455,14,44,0.318,20,24,0.833,122
198,GSW,2022-11-14,132,,SAS,1,240,47,88,0.534,24,43,0.558,23,45,0.511,15,16,0.938,132,36,100,0.36,26,60,0.433,10,40,0.25,13,19,0.684,95
199,MIA,2022-11-12,132,,CHO,1,240,49,93,0.527,33,52,0.635,16,41,0.39,18,21,0.857,132,46,90,0.511,37,59,0.627,9,31,0.29,14,16,0.875,115
200,OKC,2022-11-11,132,,TOR,1,240,52,93,0.559,37,57,0.649,15,36,0.417,13,17,0.765,132,38,88,0.432,27,58,0.466,11,30,0.367,26,36,0.722,113
201,OKC,2022-11-09,132,,MIL,0,290,50,111,0.45,32,66,0.485,18,45,0.4,14,19,0.737,132,50,106,0.472,33,70,0.471,17,36,0.472,19,22,0.864,136
202,CLE,2022-10-28,132,@,BOS,1,265,45,87,0.517,29,52,0.558,16,35,0.457,26,34,0.765,132,42,82,0.512,29,49,0.592,13,33,0.394,26,32,0.813,123
203,UTA,2022-10-21,132,@,MIN,1,265,49,111,0.441,29,61,0.475,20,50,0.4,14,21,0.667,132,49,107,0.458,38,74,0.514,11,33,0.333,17,23,0.739,126
204,SAS,2023-04-08,131,,MIN,0,240,50,95,0.526,37,66,0.561,13,29,0.448,18,24,0.75,131,56,101,0.554,32,58,0.552,24,43,0.558,15,21,0.714,151
205,ATL,2023-04-07,131,,PHI,0,265,51,92,0.554,41,59,0.695,10,33,0.303,19,28,0.679,131,51,102,0.5,40,80,0.5,11,22,0.5,23,29,0.793,136
206,MEM,2023-04-05,131,@,NOP,0,265,50,104,0.481,38,68,0.559,12,36,0.333,19,25,0.76,131,44,88,0.5,23,49,0.469,21,39,0.538,29,39,0.744,138
207,NOP,2023-03-25,131,@,LAC,1,240,51,96,0.531,30,62,0.484,21,34,0.618,8,9,0.889,131,39,75,0.52,24,42,0.571,15,33,0.455,17,21,0.81,110
208,MIN,2023-03-17,131,@,CHI,0,290,46,100,0.46,28,58,0.483,18,42,0.429,21,31,0.677,131,51,94,0.543,40,70,0.571,11,24,0.458,26,30,0.867,139
209,MEM,2023-03-09,131,,GSW,1,240,50,93,0.538,32,53,0.604,18,40,0.45,13,18,0.722,131,36,82,0.439,21,37,0.568,15,45,0.333,23,24,0.958,110
210,UTA,2023-03-09,131,@,ORL,1,240,49,88,0.557,36,54,0.667,13,34,0.382,20,21,0.952,131,44,94,0.468,28,60,0.467,16,34,0.471,20,31,0.645,124
211,NYK,2023-03-05,131,@,BOS,1,290,47,95,0.495,32,54,0.593,15,41,0.366,22,32,0.688,131,43,109,0.394,22,50,0.44,21,59,0.356,22,25,0.88,129
212,POR,2023-02-26,131,,HOU,1,240,42,77,0.545,22,38,0.579,20,39,0.513,27,35,0.771,131,45,100,0.45,38,74,0.514,7,26,0.269,17,25,0.68,114
213,CHI,2023-02-24,131,,BRK,1,240,50,88,0.568,38,62,0.613,12,26,0.462,19,28,0.679,131,30,81,0.37,18,37,0.486,12,44,0.273,15,19,0.789,87
214,MIL,2023-02-14,131,,BOS,1,265,43,90,0.478,25,48,0.521,18,42,0.429,27,35,0.771,131,46,99,0.465,29,49,0.592,17,50,0.34,16,20,0.8,125
215,SAS,2023-02-10,131,@,DET,0,290,45,107,0.421,31,65,0.477,14,42,0.333,27,34,0.794,131,46,107,0.43,39,70,0.557,7,37,0.189,39,49,0.796,138
216,NOP,2023-02-04,131,,LAL,1,240,52,100,0.52,43,70,0.614,9,30,0.3,18,20,0.9,131,45,94,0.479,34,62,0.548,11,32,0.344,25,33,0.758,126
217,UTA,2023-02-01,131,,TOR,1,240,44,83,0.53,27,36,0.75,17,47,0.362,26,30,0.867,131,50,110,0.455,40,87,0.46,10,23,0.435,18,26,0.692,128
218,IND,2023-01-27,131,,MIL,0,240,49,89,0.551,36,56,0.643,13,33,0.394,20,28,0.714,131,52,98,0.531,34,55,0.618,18,43,0.419,19,31,0.613,141
219,LAC,2023-01-20,131,@,SAS,1,240,51,81,0.63,36,53,0.679,15,28,0.536,14,20,0.7,131,51,89,0.573,37,63,0.587,14,26,0.538,10,14,0.714,126
220,UTA,2023-01-05,131,@,HOU,1,240,46,93,0.495,27,45,0.6,19,48,0.396,20,21,0.952,131,38,92,0.413,23,50,0.46,15,42,0.357,23,26,0.885,114
221,MEM,2023-01-04,131,@,CHO,1,240,47,94,0.5,38,64,0.594,9,30,0.3,28,37,0.757,131,38,94,0.404,27,56,0.482,11,38,0.289,20,24,0.833,107
222,IND,2022-12-31,131,,LAC,1,240,46,88,0.523,32,50,0.64,14,38,0.368,25,29,0.862,131,43,80,0.538,27,46,0.587,16,34,0.471,28,29,0.966,130
223,DET,2022-12-26,131,,LAC,0,265,44,100,0.44,28,66,0.424,16,34,0.471,27,34,0.794,131,49,91,0.538,30,47,0.638,19,44,0.432,25,29,0.862,142
224,PHI,2022-12-11,131,,CHO,1,240,46,83,0.554,33,56,0.589,13,27,0.481,26,32,0.813,131,38,93,0.409,27,63,0.429,11,30,0.367,26,30,0.867,113
225,DET,2022-12-01,131,,DAL,1,265,51,94,0.543,36,59,0.61,15,35,0.429,14,24,0.583,131,46,86,0.535,27,40,0.675,19,46,0.413,14,29,0.483,125
226,DEN,2022-11-23,131,@,OKC,1,265,42,88,0.477,28,50,0.56,14,38,0.368,33,41,0.805,131,42,97,0.433,24,57,0.421,18,40,0.45,24,28,0.857,126
227,BOS,2022-11-11,131,,DEN,1,240,50,90,0.556,34,53,0.642,16,37,0.432,15,20,0.75,131,42,92,0.457,30,63,0.476,12,29,0.414,16,20,0.8,112
228,CHO,2022-10-26,131,@,NYK,0,265,49,99,0.495,36,68,0.529,13,31,0.419,20,30,0.667,131,52,97,0.536,41,67,0.612,11,30,0.367,19,22,0.864,134
229,DAL,2023-04-02,130,@,ATL,0,265,49,95,0.516,39,57,0.684,10,38,0.263,22,32,0.688,130,51,108,0.472,39,73,0.534,12,35,0.343,18,22,0.818,132
230,NYK,2023-03-31,130,@,CLE,1,240,49,93,0.527,32,57,0.561,17,36,0.472,15,24,0.625,130,44,86,0.512,27,49,0.551,17,37,0.459,11,13,0.846,116
231,GSW,2023-03-31,130,,SAS,1,240,47,93,0.505,26,44,0.591,21,49,0.429,15,21,0.714,130,42,91,0.462,27,53,0.509,15,38,0.395,16,23,0.696,115
232,WAS,2023-03-28,130,,BOS,1,240,54,99,0.545,41,62,0.661,13,37,0.351,9,13,0.692,130,45,93,0.484,34,49,0.694,11,44,0.25,10,11,0.909,111
233,IND,2023-03-25,130,@,ATL,0,240,52,96,0.542,38,59,0.644,14,37,0.378,12,12,1.0,130,53,96,0.552,38,66,0.576,15,30,0.5,22,25,0.88,143
234,MEM,2023-03-22,130,,HOU,1,240,45,87,0.517,33,51,0.647,12,36,0.333,28,33,0.848,130,48,93,0.516,36,60,0.6,12,33,0.364,17,23,0.739,125
235,MIL,2023-03-22,130,,SAS,1,240,51,98,0.52,36,55,0.655,15,43,0.349,13,24,0.542,130,36,93,0.387,27,54,0.5,9,39,0.231,13,20,0.65,94
236,MIA,2023-03-06,130,,ATL,1,240,41,77,0.532,25,48,0.521,16,29,0.552,32,37,0.865,130,51,92,0.554,42,63,0.667,9,29,0.31,17,23,0.739,128
237,PHO,2023-03-05,130,@,DAL,1,240,49,89,0.551,37,55,0.673,12,34,0.353,20,25,0.8,130,38,77,0.494,23,39,0.59,15,38,0.395,35,38,0.921,126
238,MIL,2023-03-04,130,,PHI,0,240,44,83,0.53,27,49,0.551,17,34,0.5,25,28,0.893,130,42,84,0.5,24,47,0.511,18,37,0.486,31,37,0.838,133
239,OKC,2023-03-03,130,,UTA,1,240,52,104,0.5,35,61,0.574,17,43,0.395,9,14,0.643,130,38,78,0.487,29,49,0.592,9,29,0.31,18,23,0.783,103
240,SAC,2023-02-08,130,@,HOU,1,240,46,92,0.5,36,62,0.581,10,30,0.333,28,30,0.933,130,47,86,0.547,37,64,0.578,10,22,0.455,24,28,0.857,128
241,LAL,2023-02-07,130,,OKC,0,240,49,85,0.576,35,54,0.648,14,31,0.452,18,26,0.692,130,49,94,0.521,32,60,0.533,17,34,0.5,18,20,0.9,133
242,DET,2023-01-26,130,@,BRK,1,240,48,95,0.505,37,68,0.544,11,27,0.407,23,26,0.885,130,43,94,0.457,30,56,0.536,13,38,0.342,23,27,0.852,122
243,DET,2023-01-23,130,,MIL,0,240,43,87,0.494,30,55,0.545,13,32,0.406,31,40,0.775,130,55,98,0.561,32,46,0.696,23,52,0.442,17,24,0.708,150
244,ATL,2023-01-18,130,@,DAL,1,240,49,86,0.57,36,60,0.6,13,26,0.5,19,20,0.95,130,44,84,0.524,28,42,0.667,16,42,0.381,18,24,0.75,122
245,MIL,2023-01-17,130,,TOR,1,240,46,86,0.535,27,47,0.574,19,39,0.487,19,21,0.905,130,46,101,0.455,33,66,0.5,13,35,0.371,17,27,0.63,122
246,BOS,2023-01-16,130,@,CHO,1,240,43,87,0.494,23,44,0.523,20,43,0.465,24,25,0.96,130,41,90,0.456,28,59,0.475,13,31,0.419,23,30,0.767,118
247,MEM,2023-01-14,130,@,IND,1,240,48,87,0.552,36,55,0.655,12,32,0.375,22,28,0.786,130,38,103,0.369,27,56,0.482,11,47,0.234,25,28,0.893,112
248,LAL,2023-01-06,130,,ATL,1,240,51,93,0.548,35,58,0.603,16,35,0.457,12,16,0.75,130,44,96,0.458,35,65,0.538,9,31,0.29,17,22,0.773,114
249,LAC,2022-12-31,130,@,IND,0,240,43,80,0.538,27,46,0.587,16,34,0.471,28,29,0.966,130,46,88,0.523,32,50,0.64,14,38,0.368,25,29,0.862,131
250,LAL,2022-12-30,130,@,ATL,1,240,52,96,0.542,42,64,0.656,10,32,0.313,16,18,0.889,130,48,101,0.475,37,63,0.587,11,38,0.289,14,20,0.7,121
251,OKC,2022-12-27,130,,SAS,1,240,46,86,0.535,33,62,0.532,13,24,0.542,25,31,0.806,130,46,99,0.465,36,70,0.514,10,29,0.345,12,14,0.857,114
252,ATL,2022-12-23,130,,DET,1,240,49,92,0.533,37,58,0.638,12,34,0.353,20,24,0.833,130,37,90,0.411,28,57,0.491,9,33,0.273,22,29,0.759,105
253,LAL,2022-12-23,130,,CHO,0,240,48,92,0.522,29,48,0.604,19,44,0.432,15,22,0.682,130,52,94,0.553,36,53,0.679,16,41,0.39,14,18,0.778,134
254,PHO,2022-12-19,130,,LAL,1,240,46,93,0.495,26,54,0.481,20,39,0.513,18,24,0.75,130,39,87,0.448,27,59,0.458,12,28,0.429,14,17,0.824,104
255,DAL,2022-12-16,130,,POR,1,240,45,81,0.556,27,38,0.711,18,43,0.419,22,26,0.846,130,39,89,0.438,26,52,0.5,13,37,0.351,19,25,0.76,110
256,DAL,2022-12-05,130,,PHO,1,240,44,84,0.524,24,43,0.558,20,41,0.488,22,26,0.846,130,40,91,0.44,27,54,0.5,13,37,0.351,18,26,0.692,111
257,LAL,2022-12-04,130,@,WAS,1,240,52,96,0.542,42,70,0.6,10,26,0.385,16,22,0.727,130,49,105,0.467,39,66,0.591,10,39,0.256,11,15,0.733,119
258,BOS,2022-11-27,130,,WAS,1,240,44,80,0.55,28,46,0.609,16,34,0.471,26,26,1.0,130,44,82,0.537,37,54,0.685,7,28,0.25,26,33,0.788,121
259,SAC,2022-11-17,130,,SAS,1,240,48,83,0.578,36,53,0.679,12,30,0.4,22,24,0.917,130,46,84,0.548,35,58,0.603,11,26,0.423,9,12,0.75,112
260,PHO,2022-11-16,130,,GSW,1,240,44,86,0.512,23,46,0.5,21,40,0.525,21,25,0.84,130,42,92,0.457,24,50,0.48,18,42,0.429,17,17,1.0,119
261,UTA,2022-11-04,130,@,LAL,1,240,52,103,0.505,35,63,0.556,17,40,0.425,9,10,0.9,130,40,83,0.482,29,57,0.509,11,26,0.423,25,28,0.893,116
262,MEM,2022-11-04,130,,CHO,1,240,50,98,0.51,34,62,0.548,16,36,0.444,14,18,0.778,130,33,86,0.384,25,59,0.424,8,27,0.296,25,31,0.806,99
263,ORL,2022-11-03,130,,GSW,1,240,42,78,0.538,29,48,0.604,13,30,0.433,33,46,0.717,130,50,97,0.515,31,54,0.574,19,43,0.442,10,15,0.667,129
264,GSW,2022-10-23,130,,SAC,1,240,45,87,0.517,31,54,0.574,14,33,0.424,26,36,0.722,130,47,100,0.47,36,57,0.632,11,43,0.256,20,25,0.8,125
265,NYK,2022-10-21,130,,DET,1,240,50,95,0.526,34,57,0.596,16,38,0.421,14,22,0.636,130,39,90,0.433,30,54,0.556,9,36,0.25,19,32,0.594,106
266,NOP,2022-10-19,130,@,BRK,1,240,50,102,0.49,38,76,0.5,12,26,0.462,18,25,0.72,130,40,89,0.449,30,56,0.536,10,33,0.303,18,24,0.75,108
267,SAS,2023-04-06,129,,POR,1,240,47,106,0.443,37,71,0.521,10,35,0.286,25,28,0.893,129,51,96,0.531,41,68,0.603,10,28,0.357,15,18,0.833,127
268,MIA,2023-04-06,129,@,PHI,1,240,49,88,0.557,31,49,0.633,18,39,0.462,13,15,0.867,129,39,76,0.513,29,40,0.725,10,36,0.278,13,15,0.867,101
269,IND,2023-04-05,129,,NYK,0,240,45,87,0.517,30,57,0.526,15,30,0.5,24,30,0.8,129,52,100,0.52,34,54,0.63,18,46,0.391,16,25,0.64,138
270,MIA,2023-04-01,129,,DAL,1,240,45,86,0.523,32,49,0.653,13,37,0.351,26,29,0.897,129,47,77,0.61,33,43,0.767,14,34,0.412,14,16,0.875,122
271,DEN,2023-03-25,129,,MIL,1,240,47,89,0.528,32,53,0.604,15,36,0.417,20,28,0.714,129,39,88,0.443,30,52,0.577,9,36,0.25,19,21,0.905,106
272,BRK,2023-03-25,129,@,MIA,1,240,44,89,0.494,26,49,0.531,18,40,0.45,23,25,0.92,129,38,80,0.475,26,50,0.52,12,30,0.4,12,14,0.857,100
273,ATL,2023-03-21,129,,DET,1,240,44,95,0.463,30,57,0.526,14,38,0.368,27,36,0.75,129,37,91,0.407,24,51,0.471,13,40,0.325,20,24,0.833,107
274,OKC,2023-03-05,129,,UTA,1,240,44,87,0.506,30,50,0.6,14,37,0.378,27,33,0.818,129,43,88,0.489,32,51,0.627,11,37,0.297,22,27,0.815,119
275,BOS,2023-03-05,129,,NYK,0,290,43,109,0.394,22,50,0.44,21,59,0.356,22,25,0.88,129,47,95,0.495,32,54,0.593,15,41,0.366,22,32,0.688,131
276,MEM,2023-03-05,129,@,LAC,0,240,50,92,0.543,32,58,0.552,18,34,0.529,11,15,0.733,129,45,85,0.529,33,56,0.589,12,29,0.414,33,35,0.943,135
277,ATL,2023-03-03,129,,POR,1,240,52,91,0.571,40,65,0.615,12,26,0.462,13,16,0.813,129,41,87,0.471,28,48,0.583,13,39,0.333,16,20,0.8,111
278,ATL,2023-02-26,129,,BRK,1,240,45,90,0.5,29,60,0.483,16,30,0.533,23,28,0.821,129,43,87,0.494,29,48,0.604,14,39,0.359,27,29,0.931,127
279,POR,2023-02-10,129,,OKC,0,240,42,76,0.553,26,36,0.722,16,40,0.4,29,31,0.935,129,47,83,0.566,35,59,0.593,12,24,0.5,32,35,0.914,138
280,CHI,2023-02-04,129,,POR,1,240,48,80,0.6,36,54,0.667,12,26,0.462,21,25,0.84,129,44,87,0.506,30,44,0.682,14,43,0.326,19,21,0.905,121
281,LAL,2023-01-31,129,@,NYK,1,265,48,93,0.516,37,60,0.617,11,33,0.333,22,31,0.71,129,44,98,0.449,37,64,0.578,7,34,0.206,28,32,0.875,123
282,POR,2023-01-30,129,,ATL,1,240,43,79,0.544,24,39,0.615,19,40,0.475,24,27,0.889,129,44,94,0.468,31,64,0.484,13,30,0.433,24,30,0.8,125
283,GSW,2023-01-27,129,,TOR,1,240,50,90,0.556,32,47,0.681,18,43,0.419,11,15,0.733,129,46,101,0.455,34,68,0.5,12,33,0.364,13,21,0.619,117
284,PHI,2023-01-21,129,@,SAC,1,240,49,93,0.527,37,65,0.569,12,28,0.429,19,23,0.826,129,46,84,0.548,33,51,0.647,13,33,0.394,22,29,0.759,127
285,SAS,2023-01-11,129,@,MEM,0,240,50,107,0.467,39,73,0.534,11,34,0.324,18,23,0.783,129,52,101,0.515,38,79,0.481,14,22,0.636,17,25,0.68,135
286,PHI,2023-01-04,129,,IND,1,265,48,98,0.49,34,62,0.548,14,36,0.389,19,22,0.864,129,45,95,0.474,32,59,0.542,13,36,0.361,23,26,0.885,126
287,DAL,2022-12-29,129,,HOU,1,240,47,91,0.516,29,46,0.63,18,45,0.4,17,25,0.68,129,38,86,0.442,26,52,0.5,12,34,0.353,26,37,0.703,114
288,IND,2022-12-27,129,,ATL,1,240,47,92,0.511,34,57,0.596,13,35,0.371,22,27,0.815,129,40,89,0.449,28,59,0.475,12,30,0.4,22,29,0.759,114
289,LAL,2022-12-27,129,@,ORL,1,240,49,90,0.544,32,47,0.681,17,43,0.395,14,17,0.824,129,42,84,0.5,32,56,0.571,10,28,0.357,16,25,0.64,110
290,NOP,2022-12-15,129,@,UTA,0,265,47,99,0.475,35,69,0.507,12,30,0.4,23,28,0.821,129,42,92,0.457,24,45,0.533,18,47,0.383,30,37,0.811,132
291,NOP,2022-12-11,129,,PHO,1,265,50,86,0.581,42,61,0.689,8,25,0.32,21,28,0.75,129,49,105,0.467,36,67,0.537,13,38,0.342,13,17,0.765,124
292,MIL,2022-12-02,129,,LAL,0,240,50,94,0.532,33,51,0.647,17,43,0.395,12,15,0.8,129,52,96,0.542,41,70,0.586,11,26,0.423,18,24,0.75,133
293,DEN,2022-11-28,129,,HOU,1,240,50,88,0.568,38,58,0.655,12,30,0.4,17,20,0.85,129,39,85,0.459,23,41,0.561,16,44,0.364,19,25,0.76,113
294,NYK,2022-11-25,129,,POR,0,265,46,105,0.438,33,64,0.516,13,41,0.317,24,28,0.857,129,42,85,0.494,32,53,0.604,10,32,0.313,38,51,0.745,132
295,GSW,2022-11-25,129,,UTA,1,240,52,101,0.515,32,56,0.571,20,45,0.444,5,6,0.833,129,46,97,0.474,35,52,0.673,11,45,0.244,15,17,0.882,118
296,NOP,2022-11-23,129,@,SAS,1,240,47,82,0.573,33,49,0.673,14,33,0.424,21,30,0.7,129,41,85,0.482,31,51,0.608,10,34,0.294,18,28,0.643,110
297,NYK,2022-11-21,129,@,OKC,1,240,51,97,0.526,40,63,0.635,11,34,0.324,16,20,0.8,129,43,88,0.489,35,64,0.547,8,24,0.333,25,32,0.781,119
298,DET,2022-11-20,129,@,SAC,0,240,47,89,0.528,32,60,0.533,15,29,0.517,20,23,0.87,129,47,85,0.553,35,50,0.7,12,35,0.343,31,35,0.886,137
299,MIN,2022-11-13,129,@,CLE,1,240,46,82,0.561,34,58,0.586,12,24,0.5,25,34,0.735,129,40,89,0.449,23,55,0.418,17,34,0.5,27,39,0.692,124
300,PHO,2022-11-09,129,@,MIN,1,240,47,97,0.485,31,62,0.5,16,35,0.457,19,20,0.95,129,41,78,0.526,32,51,0.627,9,27,0.333,26,32,0.813,117
301,IND,2022-11-07,129,,NOP,1,240,43,86,0.5,21,38,0.553,22,48,0.458,21,23,0.913,129,48,97,0.495,34,63,0.54,14,34,0.412,12,17,0.706,122
302,MIN,2022-11-05,129,,HOU,1,240,49,80,0.613,34,47,0.723,15,33,0.455,16,20,0.8,129,40,84,0.476,24,46,0.522,16,38,0.421,21,31,0.677,117
303,GSW,2022-11-03,129,@,ORL,0,240,50,97,0.515,31,54,0.574,19,43,0.442,10,15,0.667,129,42,78,0.538,29,48,0.604,13,30,0.433,33,46,0.717,130
304,SAS,2022-10-28,129,,CHI,1,240,46,86,0.535,30,48,0.625,16,38,0.421,21,26,0.808,129,47,99,0.475,38,72,0.528,9,27,0.333,21,26,0.808,124
305,DAL,2022-10-27,129,@,BRK,1,265,41,81,0.506,21,41,0.512,20,40,0.5,27,35,0.771,129,43,93,0.462,31,58,0.534,12,35,0.343,27,30,0.9,125
306,MEM,2022-10-21,129,@,HOU,1,240,45,98,0.459,26,56,0.464,19,42,0.452,20,29,0.69,129,44,93,0.473,28,58,0.483,16,35,0.457,18,30,0.6,122
307,CHO,2022-10-19,129,@,SAS,1,240,48,94,0.511,35,65,0.538,13,29,0.448,20,23,0.87,129,40,99,0.404,33,65,0.508,7,34,0.206,15,21,0.714,102
308,LAL,2023-04-09,128,,UTA,1,240,47,97,0.485,29,52,0.558,18,45,0.4,16,21,0.762,128,51,101,0.505,41,66,0.621,10,35,0.286,5,6,0.833,117
309,WAS,2023-04-04,128,,MIL,0,240,50,99,0.505,37,72,0.514,13,27,0.481,15,21,0.714,128,50,92,0.543,27,50,0.54,23,42,0.548,17,29,0.586,140
310,PHO,2023-04-02,128,@,OKC,1,240,46,81,0.568,33,47,0.702,13,34,0.382,23,28,0.821,128,36,88,0.409,25,56,0.446,11,32,0.344,35,41,0.854,118
311,TOR,2023-04-02,128,@,CHO,1,240,56,104,0.538,48,76,0.632,8,28,0.286,8,8,1.0,128,42,85,0.494,27,54,0.5,15,31,0.484,9,13,0.692,108
312,CHI,2023-04-02,128,,MEM,1,240,50,94,0.532,41,63,0.651,9,31,0.29,19,22,0.864,128,39,84,0.464,20,41,0.488,19,43,0.442,10,12,0.833,107
313,ORL,2023-04-02,128,,DET,1,240,43,75,0.573,26,42,0.619,17,33,0.515,25,40,0.625,128,32,78,0.41,23,45,0.511,9,33,0.273,29,36,0.806,102
314,UTA,2023-03-29,128,@,SAS,1,240,49,90,0.544,37,59,0.627,12,31,0.387,18,20,0.9,128,45,95,0.474,35,60,0.583,10,35,0.286,17,21,0.81,117
315,UTA,2023-03-20,128,,SAC,1,240,46,88,0.523,30,52,0.577,16,36,0.444,20,23,0.87,128,41,97,0.423,22,45,0.489,19,52,0.365,19,25,0.76,120
316,TOR,2023-03-16,128,,OKC,1,240,47,97,0.485,33,65,0.508,14,32,0.438,20,28,0.714,128,40,94,0.426,27,63,0.429,13,31,0.419,18,20,0.9,111
317,SAS,2023-03-15,128,,DAL,0,265,49,107,0.458,34,73,0.466,15,34,0.441,15,26,0.577,128,44,86,0.512,27,53,0.509,17,33,0.515,32,37,0.865,137
318,SAC,2023-03-11,128,@,PHO,1,240,41,85,0.482,26,50,0.52,15,35,0.429,31,37,0.838,128,44,89,0.494,31,45,0.689,13,44,0.295,18,22,0.818,119
319,SAS,2023-03-10,128,,DEN,1,240,51,94,0.543,38,61,0.623,13,33,0.394,13,17,0.765,128,44,90,0.489,31,55,0.564,13,35,0.371,19,20,0.95,120
320,GSW,2023-03-07,128,@,OKC,0,240,47,89,0.528,27,38,0.711,20,51,0.392,14,16,0.875,128,50,94,0.532,33,57,0.579,17,37,0.459,20,24,0.833,137
321,ATL,2023-03-06,128,@,MIA,0,240,51,92,0.554,42,63,0.667,9,29,0.31,17,23,0.739,128,41,77,0.532,25,48,0.521,16,29,0.552,32,37,0.865,130
322,SAC,2023-03-03,128,,LAC,1,240,46,87,0.529,36,54,0.667,10,33,0.303,26,26,1.0,128,47,87,0.54,33,46,0.717,14,41,0.341,19,27,0.704,127
323,NYK,2023-02-25,128,,NOP,1,240,45,88,0.511,26,40,0.65,19,48,0.396,19,23,0.826,128,40,102,0.392,32,64,0.5,8,38,0.211,18,21,0.857,106
324,MIL,2023-02-24,128,,MIA,1,240,47,98,0.48,28,52,0.538,19,46,0.413,15,19,0.789,128,36,92,0.391,27,52,0.519,9,40,0.225,18,25,0.72,99
325,DAL,2023-02-11,128,@,SAC,0,265,47,91,0.516,27,40,0.675,20,51,0.392,14,19,0.737,128,51,100,0.51,43,68,0.632,8,32,0.25,23,25,0.92,133
326,MEM,2023-02-10,128,,MIN,1,240,49,84,0.583,39,59,0.661,10,25,0.4,20,27,0.741,128,41,88,0.466,26,51,0.51,15,37,0.405,10,12,0.833,107
327,HOU,2023-02-08,128,,SAC,0,240,47,86,0.547,37,64,0.578,10,22,0.455,24,28,0.857,128,46,92,0.5,36,62,0.581,10,30,0.333,28,30,0.933,130
328,CHI,2023-02-06,128,,SAS,1,240,50,89,0.562,44,67,0.657,6,22,0.273,22,25,0.88,128,40,90,0.444,32,64,0.5,8,26,0.308,16,17,0.941,104
329,MIN,2023-02-05,128,,DEN,1,240,48,87,0.552,38,60,0.633,10,27,0.37,22,30,0.733,128,34,71,0.479,28,46,0.609,6,25,0.24,24,31,0.774,98
330,DEN,2023-02-04,128,,ATL,1,240,48,95,0.505,33,57,0.579,15,38,0.395,17,20,0.85,128,44,91,0.484,38,71,0.535,6,20,0.3,14,17,0.824,108
331,NYK,2023-02-04,128,,LAC,0,265,45,94,0.479,27,54,0.5,18,40,0.45,20,26,0.769,128,44,92,0.478,28,55,0.509,16,37,0.432,30,35,0.857,134
332,CLE,2023-02-02,128,,MEM,1,240,49,91,0.538,35,62,0.565,14,29,0.483,16,22,0.727,128,41,87,0.471,31,64,0.484,10,23,0.435,21,22,0.955,113
333,TOR,2023-02-01,128,@,UTA,0,240,50,110,0.455,40,87,0.46,10,23,0.435,18,26,0.692,128,44,83,0.53,27,36,0.75,17,47,0.362,26,30,0.867,131
334,GSW,2023-01-30,128,@,OKC,1,240,46,90,0.511,26,43,0.605,20,47,0.426,16,20,0.8,128,46,93,0.495,35,69,0.507,11,24,0.458,17,20,0.85,120
335,CHI,2023-01-28,128,@,ORL,1,240,48,81,0.593,32,46,0.696,16,35,0.457,16,19,0.842,128,41,83,0.494,31,55,0.564,10,28,0.357,17,24,0.708,109
336,PHO,2023-01-28,128,@,SAS,1,265,50,103,0.485,42,79,0.532,8,24,0.333,20,26,0.769,128,48,109,0.44,38,80,0.475,10,29,0.345,12,17,0.706,118
337,PHO,2023-01-24,128,,CHO,1,240,47,94,0.5,25,55,0.455,22,39,0.564,12,13,0.923,128,39,96,0.406,33,71,0.465,6,25,0.24,13,18,0.722,97
338,MIN,2023-01-19,128,,TOR,1,240,45,89,0.506,28,49,0.571,17,40,0.425,21,23,0.913,128,46,87,0.529,32,59,0.542,14,28,0.5,20,27,0.741,126
339,MIN,2023-01-06,128,,LAC,1,240,46,81,0.568,33,46,0.717,13,35,0.371,23,29,0.793,128,44,100,0.44,35,75,0.467,9,25,0.36,18,27,0.667,115
340,DEN,2022-12-25,128,,PHO,1,265,45,94,0.479,32,58,0.552,13,36,0.361,25,34,0.735,128,45,94,0.479,28,59,0.475,17,35,0.486,18,26,0.692,125
341,NOP,2022-12-23,128,@,OKC,1,265,41,94,0.436,28,57,0.491,13,37,0.351,33,40,0.825,128,47,102,0.461,34,67,0.507,13,35,0.371,18,25,0.72,125
342,MIL,2022-12-19,128,@,NOP,1,240,45,81,0.556,32,41,0.78,13,40,0.325,25,31,0.806,128,42,99,0.424,24,54,0.444,18,45,0.4,17,24,0.708,119
343,POR,2022-12-14,128,@,SAS,1,240,49,81,0.605,31,41,0.756,18,40,0.45,12,17,0.706,128,45,97,0.464,34,68,0.5,11,29,0.379,11,19,0.579,112
344,NYK,2022-12-14,128,@,CHI,1,265,45,91,0.495,27,57,0.474,18,34,0.529,20,25,0.8,128,46,84,0.548,37,56,0.661,9,28,0.321,19,22,0.864,120
345,WAS,2022-12-14,128,@,DEN,0,240,48,91,0.527,29,52,0.558,19,39,0.487,13,23,0.565,128,54,83,0.651,50,67,0.746,4,16,0.25,29,35,0.829,141
346,MIL,2022-12-13,128,,GSW,1,240,45,82,0.549,33,53,0.623,12,29,0.414,26,32,0.813,128,38,95,0.4,18,45,0.4,20,50,0.4,15,19,0.789,111
347,MEM,2022-12-12,128,,ATL,1,240,50,83,0.602,37,51,0.725,13,32,0.406,15,18,0.833,128,37,104,0.356,25,67,0.373,12,37,0.324,17,22,0.773,103
348,NOP,2022-12-09,128,,PHO,1,240,46,90,0.511,38,63,0.603,8,27,0.296,28,35,0.8,128,43,86,0.5,21,42,0.5,22,44,0.5,9,13,0.692,117
349,MIN,2022-12-03,128,,OKC,0,240,47,89,0.528,37,59,0.627,10,30,0.333,24,30,0.8,128,48,93,0.516,37,67,0.552,11,26,0.423,28,35,0.8,135
350,LAL,2022-11-30,128,,POR,1,240,48,97,0.495,34,60,0.567,14,37,0.378,18,26,0.692,128,42,90,0.467,34,66,0.515,8,24,0.333,17,21,0.81,109
351,IND,2022-11-25,128,,BRK,1,240,43,86,0.5,31,52,0.596,12,34,0.353,30,38,0.789,128,47,88,0.534,32,47,0.681,15,41,0.366,8,10,0.8,117
352,HOU,2022-11-25,128,,ATL,1,240,41,87,0.471,29,52,0.558,12,35,0.343,34,41,0.829,128,39,82,0.476,24,43,0.558,15,39,0.385,29,36,0.806,122
353,NOP,2022-11-21,128,,GSW,1,240,49,91,0.538,34,49,0.694,15,42,0.357,15,21,0.714,128,28,74,0.378,18,31,0.581,10,43,0.233,17,19,0.895,83
354,LAL,2022-11-18,128,,DET,1,240,43,78,0.551,36,58,0.621,7,20,0.35,35,40,0.875,128,43,92,0.467,32,58,0.552,11,34,0.324,24,32,0.75,121
355,BOS,2022-11-09,128,,DET,1,240,47,88,0.534,29,42,0.69,18,46,0.391,16,21,0.762,128,37,89,0.416,30,56,0.536,7,33,0.212,31,40,0.775,112
356,BRK,2022-11-04,128,@,WAS,1,240,50,90,0.556,36,62,0.581,14,28,0.5,14,14,1.0,128,30,83,0.361,22,49,0.449,8,34,0.235,18,22,0.818,86
357,DET,2022-10-30,128,,GSW,1,240,40,83,0.482,26,50,0.52,14,33,0.424,34,38,0.895,128,39,92,0.424,27,53,0.509,12,39,0.308,24,25,0.96,114
358,CLE,2022-10-22,128,@,CHI,1,240,48,85,0.565,32,58,0.552,16,27,0.593,16,18,0.889,128,34,84,0.405,27,55,0.491,7,29,0.241,21,25,0.84,96
359,DEN,2022-10-21,128,@,GSW,1,240,46,86,0.535,31,52,0.596,15,34,0.441,21,25,0.84,128,42,88,0.477,27,44,0.614,15,44,0.341,24,27,0.889,123
360,POR,2023-04-06,127,@,SAS,0,240,51,96,0.531,41,68,0.603,10,28,0.357,15,18,0.833,127,47,106,0.443,37,71,0.521,10,35,0.286,25,28,0.893,129
361,DAL,2023-03-27,127,@,IND,1,240,47,83,0.566,29,46,0.63,18,37,0.486,15,17,0.882,127,39,93,0.419,31,65,0.477,8,28,0.286,18,23,0.783,104
362,PHO,2023-03-24,127,@,SAC,0,240,48,89,0.539,39,60,0.65,9,29,0.31,22,29,0.759,127,47,89,0.528,34,50,0.68,13,39,0.333,28,32,0.875,135
363,LAC,2023-03-23,127,,OKC,1,240,47,84,0.56,29,47,0.617,18,37,0.486,15,20,0.75,127,41,93,0.441,28,54,0.519,13,39,0.333,10,11,0.909,105
364,GSW,2023-03-22,127,@,DAL,1,240,50,90,0.556,38,51,0.745,12,39,0.308,15,18,0.833,127,44,89,0.494,27,49,0.551,17,40,0.425,20,28,0.714,125
365,MIA,2023-03-22,127,,NYK,1,240,45,79,0.57,29,51,0.569,16,28,0.571,21,26,0.808,127,42,82,0.512,26,42,0.619,16,40,0.4,20,25,0.8,120
366,POR,2023-03-22,127,@,UTA,1,240,45,93,0.484,32,52,0.615,13,41,0.317,24,30,0.8,127,39,82,0.476,28,47,0.596,11,35,0.314,26,36,0.722,115
367,ATL,2023-03-17,127,,GSW,1,240,47,100,0.47,31,59,0.525,16,41,0.39,17,25,0.68,127,47,98,0.48,36,58,0.621,11,40,0.275,14,20,0.7,119
368,NOP,2023-03-12,127,,POR,1,240,43,86,0.5,24,46,0.522,19,40,0.475,22,29,0.759,127,43,88,0.489,33,55,0.6,10,33,0.303,14,20,0.7,110
369,LAC,2023-03-03,127,@,SAC,0,240,47,87,0.54,33,46,0.717,14,41,0.341,19,27,0.704,127,46,87,0.529,36,54,0.667,10,33,0.303,26,26,1.0,128
370,BRK,2023-02-26,127,@,ATL,0,240,43,87,0.494,29,48,0.604,14,39,0.359,27,29,0.931,127,45,90,0.5,29,60,0.483,16,30,0.533,23,28,0.821,129
371,BOS,2023-02-15,127,,DET,1,240,49,92,0.533,28,47,0.596,21,45,0.467,8,10,0.8,127,43,84,0.512,32,55,0.582,11,29,0.379,12,16,0.75,109
372,POR,2023-02-13,127,,LAL,1,240,46,97,0.474,23,50,0.46,23,47,0.489,12,13,0.923,127,42,95,0.442,30,58,0.517,12,37,0.324,19,21,0.905,115
373,WAS,2023-02-11,127,,IND,1,240,48,75,0.64,36,49,0.735,12,26,0.462,19,22,0.864,127,43,95,0.453,29,55,0.527,14,40,0.35,13,17,0.765,113
374,BOS,2023-02-10,127,,CHO,1,240,44,89,0.494,19,34,0.559,25,55,0.455,14,17,0.824,127,45,93,0.484,37,70,0.529,8,23,0.348,18,26,0.692,116
375,MIL,2023-02-06,127,@,POR,1,240,47,87,0.54,31,45,0.689,16,42,0.381,17,21,0.81,127,37,91,0.407,28,55,0.509,9,36,0.25,25,29,0.862,108
376,ORL,2023-02-03,127,@,MIN,1,240,45,85,0.529,33,62,0.532,12,23,0.522,25,38,0.658,127,40,87,0.46,24,43,0.558,16,44,0.364,24,28,0.857,120
377,WAS,2023-01-30,127,@,SAS,1,240,48,86,0.558,32,56,0.571,16,30,0.533,15,17,0.882,127,42,97,0.433,35,68,0.515,7,29,0.241,15,23,0.652,106
378,WAS,2023-01-24,127,@,DAL,1,240,42,83,0.506,31,53,0.585,11,30,0.367,32,41,0.78,127,47,89,0.528,37,59,0.627,10,30,0.333,22,26,0.846,126
379,SAS,2023-01-23,127,@,POR,0,240,47,90,0.522,34,63,0.54,13,27,0.481,20,26,0.769,127,55,92,0.598,35,59,0.593,20,33,0.606,17,22,0.773,147
380,SAC,2023-01-21,127,,PHI,0,240,46,84,0.548,33,51,0.647,13,33,0.394,22,29,0.759,127,49,93,0.527,37,65,0.569,12,28,0.429,19,23,0.826,129
381,GSW,2023-01-16,127,@,WAS,1,240,45,91,0.495,27,47,0.574,18,44,0.409,19,21,0.905,127,42,86,0.488,28,51,0.549,14,35,0.4,20,23,0.87,118
382,DAL,2023-01-07,127,,NOP,1,240,42,74,0.568,29,45,0.644,13,29,0.448,30,38,0.789,127,45,94,0.479,40,65,0.615,5,29,0.172,22,35,0.629,117
383,OKC,2023-01-06,127,,WAS,1,240,50,98,0.51,33,61,0.541,17,37,0.459,10,14,0.714,127,38,79,0.481,31,55,0.564,7,24,0.292,27,36,0.75,110
384,NOP,2022-12-30,127,,PHI,1,240,43,80,0.538,28,49,0.571,15,31,0.484,26,36,0.722,127,42,75,0.56,28,41,0.683,14,34,0.412,18,22,0.818,116
385,SAC,2022-12-28,127,,DEN,1,240,47,89,0.528,33,58,0.569,14,31,0.452,19,25,0.76,127,49,85,0.576,37,58,0.638,12,27,0.444,16,18,0.889,126
386,WAS,2022-12-28,127,,PHO,1,240,47,82,0.573,39,56,0.696,8,26,0.308,25,28,0.893,127,39,87,0.448,26,56,0.464,13,31,0.419,11,16,0.688,102
387,MIN,2022-11-28,127,@,WAS,0,240,42,84,0.5,35,57,0.614,7,27,0.259,36,42,0.857,127,52,91,0.571,37,60,0.617,15,31,0.484,23,27,0.852,142
388,MEM,2022-11-27,127,@,NYK,1,240,46,95,0.484,34,63,0.54,12,32,0.375,23,31,0.742,127,44,87,0.506,34,57,0.596,10,30,0.333,25,30,0.833,123
389,BRK,2022-11-20,127,,MEM,1,240,50,83,0.602,34,49,0.694,16,34,0.471,11,15,0.733,127,43,99,0.434,31,62,0.5,12,37,0.324,17,31,0.548,115
390,GSW,2022-11-20,127,@,HOU,1,240,46,86,0.535,22,39,0.564,24,47,0.511,11,15,0.733,127,41,90,0.456,26,45,0.578,15,45,0.333,23,27,0.852,120
391,DAL,2022-11-18,127,,DEN,1,240,46,77,0.597,33,45,0.733,13,32,0.406,22,28,0.786,127,38,90,0.422,28,60,0.467,10,30,0.333,13,18,0.722,99
392,SAC,2022-11-09,127,,CLE,1,240,40,76,0.526,23,37,0.622,17,39,0.436,30,35,0.857,127,46,86,0.535,35,60,0.583,11,26,0.423,17,20,0.85,120
393,ORL,2022-11-07,127,,HOU,0,240,45,82,0.549,33,57,0.579,12,25,0.48,25,31,0.806,127,46,87,0.529,22,39,0.564,24,48,0.5,18,25,0.72,134
394,IND,2022-10-28,127,@,WAS,1,240,41,81,0.506,26,52,0.5,15,29,0.517,30,33,0.909,127,41,86,0.477,29,56,0.518,12,30,0.4,23,28,0.821,117
395,MIL,2023-03-27,126,@,DET,1,240,45,95,0.474,31,50,0.62,14,45,0.311,22,26,0.846,126,41,92,0.446,34,68,0.5,7,24,0.292,28,36,0.778,117
396,SAS,2023-03-19,126,,ATL,1,240,51,94,0.543,37,66,0.561,14,28,0.5,10,16,0.625,126,48,101,0.475,43,79,0.544,5,22,0.227,17,20,0.85,118
397,MEM,2023-03-17,126,@,SAS,1,265,49,101,0.485,35,63,0.556,14,38,0.368,14,21,0.667,126,39,98,0.398,19,46,0.413,20,52,0.385,22,29,0.759,120
398,BOS,2023-03-17,126,@,POR,1,240,41,87,0.471,26,45,0.578,15,42,0.357,29,35,0.829,126,38,79,0.481,24,41,0.585,14,38,0.368,22,31,0.71,112
399,GSW,2023-03-15,126,@,LAC,0,240,49,88,0.557,32,52,0.615,17,36,0.472,11,15,0.733,126,46,96,0.479,30,62,0.484,16,34,0.471,26,32,0.813,134
400,ORL,2023-03-11,126,,MIA,1,265,48,99,0.485,35,62,0.565,13,37,0.351,17,20,0.85,126,42,94,0.447,31,57,0.544,11,37,0.297,19,20,0.95,114
401,DAL,2023-03-05,126,,PHO,0,240,38,77,0.494,23,39,0.59,15,38,0.395,35,38,0.921,126,49,89,0.551,37,55,0.673,12,34,0.353,20,25,0.8,130
402,PHI,2023-03-02,126,@,DAL,0,240,45,78,0.577,33,51,0.647,12,27,0.444,24,29,0.828,126,45,82,0.549,20,34,0.588,25,48,0.521,18,27,0.667,133
403,WAS,2023-02-14,126,@,POR,1,240,45,79,0.57,28,46,0.609,17,33,0.515,19,22,0.864,126,36,86,0.419,24,44,0.545,12,42,0.286,17,24,0.708,101
404,WAS,2023-02-13,126,@,GSW,0,240,48,80,0.6,36,52,0.692,12,28,0.429,18,21,0.857,126,52,89,0.584,32,49,0.653,20,40,0.5,11,15,0.733,135
405,NYK,2023-02-11,126,,UTA,1,240,43,95,0.453,31,59,0.525,12,36,0.333,28,38,0.737,126,45,88,0.511,36,56,0.643,9,32,0.281,21,28,0.75,120
406,LAL,2023-02-04,126,@,NOP,0,240,45,94,0.479,34,62,0.548,11,32,0.344,25,33,0.758,126,52,100,0.52,43,70,0.614,9,30,0.3,18,20,0.9,131
407,PHI,2023-01-28,126,,DEN,1,240,46,89,0.517,28,54,0.519,18,35,0.514,16,24,0.667,126,44,81,0.543,30,47,0.638,14,34,0.412,17,20,0.85,119
408,ORL,2023-01-25,126,,IND,1,240,46,82,0.561,31,54,0.574,15,28,0.536,19,25,0.76,126,41,85,0.482,26,50,0.52,15,35,0.429,23,29,0.793,120
409,DAL,2023-01-24,126,,WAS,0,240,47,89,0.528,37,59,0.627,10,30,0.333,22,26,0.846,126,42,83,0.506,31,53,0.585,11,30,0.367,32,41,0.78,127
410,SAS,2023-01-20,126,,LAC,0,240,51,89,0.573,37,63,0.587,14,26,0.538,10,14,0.714,126,51,81,0.63,36,53,0.679,15,28,0.536,14,20,0.7,131
411,CHI,2023-01-19,126,@,DET,1,240,50,92,0.543,43,69,0.623,7,23,0.304,19,21,0.905,126,39,97,0.402,31,63,0.492,8,34,0.235,22,27,0.815,108
412,TOR,2023-01-19,126,@,MIN,0,240,46,87,0.529,32,59,0.542,14,28,0.5,20,27,0.741,126,45,89,0.506,28,49,0.571,17,40,0.425,21,23,0.913,128
413,OKC,2023-01-18,126,,IND,1,240,47,93,0.505,31,55,0.564,16,38,0.421,16,21,0.762,126,39,94,0.415,27,61,0.443,12,33,0.364,16,24,0.667,106
414,UTA,2023-01-18,126,,LAC,1,240,45,87,0.517,26,55,0.473,19,32,0.594,17,22,0.773,126,37,92,0.402,22,58,0.379,15,34,0.441,14,21,0.667,103
415,UTA,2023-01-16,126,@,MIN,1,240,45,84,0.536,32,50,0.64,13,34,0.382,23,28,0.821,126,46,101,0.455,28,60,0.467,18,41,0.439,15,18,0.833,125
416,DEN,2023-01-11,126,,PHO,1,240,48,85,0.565,33,51,0.647,15,34,0.441,15,21,0.714,126,39,90,0.433,30,58,0.517,9,32,0.281,10,14,0.714,97
417,CHI,2023-01-07,126,,UTA,1,240,44,83,0.53,31,55,0.564,13,28,0.464,25,32,0.781,126,46,93,0.495,34,52,0.654,12,41,0.293,14,18,0.778,118
418,CHI,2023-01-06,126,@,PHI,1,240,48,84,0.571,28,50,0.56,20,34,0.588,10,17,0.588,126,40,92,0.435,22,51,0.431,18,41,0.439,14,18,0.778,112
419,IND,2023-01-04,126,@,PHI,0,265,45,95,0.474,32,59,0.542,13,36,0.361,23,26,0.885,126,48,98,0.49,34,62,0.548,14,36,0.389,19,22,0.864,129
420,ORL,2023-01-04,126,,OKC,1,240,42,81,0.519,29,48,0.604,13,33,0.394,29,36,0.806,126,36,89,0.404,21,52,0.404,15,37,0.405,28,31,0.903,115
421,DAL,2022-12-31,126,@,SAS,1,240,50,86,0.581,36,52,0.692,14,34,0.412,12,21,0.571,126,47,85,0.553,39,66,0.591,8,19,0.421,23,32,0.719,125
422,MIA,2022-12-31,126,@,UTA,1,240,45,89,0.506,32,50,0.64,13,39,0.333,23,30,0.767,126,35,81,0.432,18,41,0.439,17,40,0.425,36,44,0.818,123
423,SAC,2022-12-30,126,,UTA,1,240,50,90,0.556,38,60,0.633,12,30,0.4,14,19,0.737,126,46,84,0.548,38,52,0.731,8,32,0.25,25,30,0.833,125
424,CLE,2022-12-29,126,@,IND,0,240,50,96,0.521,38,68,0.559,12,28,0.429,14,20,0.7,126,48,85,0.565,29,54,0.537,19,31,0.613,20,21,0.952,135
425,DEN,2022-12-28,126,@,SAC,0,240,49,85,0.576,37,58,0.638,12,27,0.444,16,18,0.889,126,47,89,0.528,33,58,0.569,14,31,0.452,19,25,0.76,127
426,DAL,2022-12-27,126,,NYK,1,265,44,90,0.489,31,44,0.705,13,46,0.283,25,33,0.758,126,45,103,0.437,29,53,0.547,16,50,0.32,15,24,0.625,121
427,BOS,2022-12-27,126,,HOU,1,240,43,91,0.473,23,35,0.657,20,56,0.357,20,23,0.87,126,38,95,0.4,24,50,0.48,14,45,0.311,12,14,0.857,102
428,SAS,2022-12-26,126,,UTA,1,240,48,87,0.552,42,69,0.609,6,18,0.333,24,34,0.706,126,39,97,0.402,26,54,0.481,13,43,0.302,31,37,0.838,122
429,NOP,2022-12-22,126,,SAS,1,240,44,91,0.484,31,57,0.544,13,34,0.382,25,27,0.926,126,43,90,0.478,34,62,0.548,9,28,0.321,22,27,0.815,117
430,LAC,2022-12-21,126,,CHO,1,240,41,81,0.506,18,32,0.563,23,49,0.469,21,23,0.913,126,37,92,0.402,28,61,0.459,9,31,0.29,22,29,0.759,105
431,UTA,2022-12-20,126,@,DET,1,240,47,93,0.505,27,47,0.574,20,46,0.435,12,19,0.632,126,41,81,0.506,32,56,0.571,9,25,0.36,20,27,0.741,111
432,ATL,2022-12-19,126,,ORL,1,240,48,94,0.511,36,62,0.581,12,32,0.375,18,20,0.9,126,45,95,0.474,33,61,0.541,12,34,0.353,23,25,0.92,125
433,CHI,2022-12-18,126,@,MIN,0,240,46,88,0.523,30,50,0.6,16,38,0.421,18,24,0.75,126,57,87,0.655,34,44,0.773,23,43,0.535,13,16,0.813,150
434,GSW,2022-12-18,126,@,TOR,1,240,43,81,0.531,25,42,0.595,18,39,0.462,22,26,0.846,126,40,95,0.421,27,62,0.435,13,33,0.394,17,22,0.773,110
435,LAL,2022-12-16,126,,DEN,1,240,48,91,0.527,36,58,0.621,12,33,0.364,18,24,0.75,126,39,81,0.481,30,54,0.556,9,27,0.333,21,28,0.75,108
436,MIL,2022-12-07,126,,SAC,1,240,46,96,0.479,32,63,0.508,14,33,0.424,20,24,0.833,126,43,91,0.473,31,53,0.585,12,38,0.316,15,16,0.938,113
437,TOR,2022-12-07,126,,LAL,1,240,47,106,0.443,35,63,0.556,12,43,0.279,20,24,0.833,126,37,87,0.425,30,54,0.556,7,33,0.212,32,35,0.914,113
438,NOP,2022-11-30,126,,TOR,1,240,45,86,0.523,31,53,0.585,14,33,0.424,22,26,0.846,126,42,88,0.477,31,50,0.62,11,38,0.289,13,19,0.684,108
439,OKC,2022-11-23,126,,DEN,0,265,42,97,0.433,24,57,0.421,18,40,0.45,24,28,0.857,126,42,88,0.477,28,50,0.56,14,38,0.368,33,41,0.805,131
440,BOS,2022-11-16,126,@,ATL,1,240,48,88,0.545,27,42,0.643,21,46,0.457,9,10,0.9,126,42,101,0.416,35,69,0.507,7,32,0.219,10,13,0.769,101
441,MIN,2022-11-16,126,@,ORL,1,240,46,88,0.523,34,52,0.654,12,36,0.333,22,28,0.786,126,42,93,0.452,33,58,0.569,9,35,0.257,15,17,0.882,108
442,BOS,2022-11-14,126,,OKC,1,240,46,96,0.479,36,59,0.61,10,37,0.27,24,29,0.828,126,47,98,0.48,36,68,0.529,11,30,0.367,17,21,0.81,122
443,DEN,2022-11-13,126,@,CHI,1,240,48,80,0.6,35,53,0.66,13,27,0.481,17,21,0.81,126,40,81,0.494,34,59,0.576,6,22,0.273,17,21,0.81,103
444,SAC,2022-11-05,126,@,ORL,1,265,47,93,0.505,32,53,0.604,15,40,0.375,17,26,0.654,126,50,92,0.543,46,69,0.667,4,23,0.174,19,20,0.95,123
445,DEN,2022-11-05,126,,SAS,1,240,53,87,0.609,38,58,0.655,15,29,0.517,5,10,0.5,126,39,80,0.488,27,50,0.54,12,30,0.4,11,19,0.579,101
446,CHO,2022-10-23,126,@,ATL,1,240,47,90,0.522,36,64,0.563,11,26,0.423,21,30,0.7,126,39,95,0.411,31,60,0.517,8,35,0.229,23,28,0.821,109
447,BOS,2022-10-22,126,@,ORL,1,240,42,87,0.483,23,40,0.575,19,47,0.404,23,28,0.821,126,45,95,0.474,30,61,0.492,15,34,0.441,15,23,0.652,120
448,MIN,2022-10-21,126,,UTA,0,265,49,107,0.458,38,74,0.514,11,33,0.333,17,23,0.739,126,49,111,0.441,29,61,0.475,20,50,0.4,14,21,0.667,132
449,BOS,2022-10-18,126,,PHI,1,240,46,82,0.561,34,47,0.723,12,35,0.343,22,28,0.786,126,40,80,0.5,27,46,0.587,13,34,0.382,24,28,0.857,117
450,POR,2023-04-08,125,@,LAC,0,240,47,89,0.528,33,57,0.579,14,32,0.438,17,23,0.739,125,49,93,0.527,37,58,0.638,12,35,0.343,26,30,0.867,136
451,LAC,2023-04-05,125,,LAL,1,240,43,82,0.524,27,46,0.587,16,36,0.444,23,27,0.852,125,45,89,0.506,33,60,0.55,12,29,0.414,16,24,0.667,118
452,OKC,2023-04-04,125,@,GSW,0,240,44,93,0.473,33,61,0.541,11,32,0.344,26,35,0.743,125,47,95,0.495,27,48,0.563,20,47,0.426,22,30,0.733,136
453,PHO,2023-03-25,125,,PHI,1,240,47,93,0.505,32,61,0.525,15,32,0.469,16,19,0.842,125,34,78,0.436,21,47,0.447,13,31,0.419,24,27,0.889,105
454,MIN,2023-03-22,125,,ATL,1,240,45,92,0.489,34,66,0.515,11,26,0.423,24,29,0.828,125,45,85,0.529,33,59,0.559,12,26,0.462,22,25,0.88,124
455,DAL,2023-03-22,125,,GSW,0,240,44,89,0.494,27,49,0.551,17,40,0.425,20,28,0.714,125,50,90,0.556,38,51,0.745,12,39,0.308,15,18,0.833,127
456,HOU,2023-03-22,125,@,MEM,0,240,48,93,0.516,36,60,0.6,12,33,0.364,17,23,0.739,125,45,87,0.517,33,51,0.647,12,36,0.333,28,33,0.848,130
457,TOR,2023-03-14,125,,DEN,1,240,49,93,0.527,37,63,0.587,12,30,0.4,15,17,0.882,125,42,76,0.553,36,51,0.706,6,25,0.24,20,25,0.8,110
458,GSW,2023-03-11,125,,MIL,1,265,46,112,0.411,23,57,0.404,23,55,0.418,10,11,0.909,125,43,100,0.43,22,49,0.449,21,51,0.412,9,11,0.818,116
459,ATL,2023-03-11,125,,BOS,0,240,50,100,0.5,40,66,0.606,10,34,0.294,15,16,0.938,125,52,95,0.547,32,53,0.604,20,42,0.476,10,12,0.833,134
460,HOU,2023-03-09,125,@,IND,0,265,49,107,0.458,43,90,0.478,6,17,0.353,21,29,0.724,125,48,100,0.48,30,55,0.545,18,45,0.4,20,21,0.952,134
461,IND,2023-03-05,125,@,CHI,1,240,48,94,0.511,32,50,0.64,16,44,0.364,13,16,0.813,125,45,74,0.608,35,52,0.673,10,22,0.455,22,25,0.88,122
462,PHO,2023-03-03,125,@,CHI,1,240,42,84,0.5,22,37,0.595,20,47,0.426,21,25,0.84,125,39,83,0.47,32,60,0.533,7,23,0.304,19,25,0.76,104
463,BOS,2023-02-14,125,@,MIL,0,265,46,99,0.465,29,49,0.592,17,50,0.34,16,20,0.8,125,43,90,0.478,25,48,0.521,18,42,0.429,27,35,0.771,131
464,ATL,2023-02-11,125,,SAS,1,240,50,103,0.485,40,77,0.519,10,26,0.385,15,19,0.789,125,40,94,0.426,29,57,0.509,11,37,0.297,15,17,0.882,106
465,POR,2023-02-08,125,,GSW,1,240,43,78,0.551,35,51,0.686,8,27,0.296,31,32,0.969,125,46,97,0.474,25,48,0.521,21,49,0.429,9,10,0.9,122
466,BRK,2023-02-04,125,,WAS,1,240,43,86,0.5,29,53,0.547,14,33,0.424,25,28,0.893,125,39,81,0.481,26,53,0.491,13,28,0.464,32,41,0.78,123
467,SAS,2023-02-03,125,,PHI,0,240,52,89,0.584,45,68,0.662,7,21,0.333,14,15,0.933,125,46,87,0.529,33,60,0.55,13,27,0.481,32,41,0.78,137
468,ATL,2023-01-30,125,@,POR,0,240,44,94,0.468,31,64,0.484,13,30,0.433,24,30,0.8,125,43,79,0.544,24,39,0.615,19,40,0.475,24,27,0.889,129
469,BOS,2023-01-28,125,,LAL,1,265,39,84,0.464,26,44,0.591,13,40,0.325,34,39,0.872,125,47,105,0.448,35,63,0.556,12,42,0.286,15,20,0.75,121
470,TOR,2023-01-22,125,,NYK,1,240,41,90,0.456,26,56,0.464,15,34,0.441,28,35,0.8,125,40,82,0.488,22,41,0.537,18,41,0.439,18,26,0.692,116
471,MIN,2023-01-16,125,,UTA,0,240,46,101,0.455,28,60,0.467,18,41,0.439,15,18,0.833,125,45,84,0.536,32,50,0.64,13,34,0.382,23,28,0.821,126
472,BOS,2023-01-11,125,,NOP,1,240,44,91,0.484,29,47,0.617,15,44,0.341,22,25,0.88,125,45,87,0.517,34,57,0.596,11,30,0.367,13,17,0.765,114
473,PHO,2023-01-10,125,@,GSW,1,240,41,90,0.456,27,59,0.458,14,31,0.452,29,31,0.935,125,37,96,0.385,19,48,0.396,18,48,0.375,21,27,0.778,113
474,SAS,2022-12-31,125,,DAL,0,240,47,85,0.553,39,66,0.591,8,19,0.421,23,32,0.719,125,50,86,0.581,36,52,0.692,14,34,0.412,12,21,0.571,126
475,UTA,2022-12-30,125,@,SAC,0,240,46,84,0.548,38,52,0.731,8,32,0.25,25,30,0.833,125,50,90,0.556,38,60,0.633,12,30,0.4,14,19,0.737,126
476,PHO,2022-12-27,125,@,MEM,1,240,43,87,0.494,26,56,0.464,17,31,0.548,22,25,0.88,125,36,91,0.396,28,61,0.459,8,30,0.267,28,34,0.824,108
477,BRK,2022-12-26,125,@,CLE,1,240,47,82,0.573,29,52,0.558,18,30,0.6,13,17,0.765,125,39,82,0.476,26,46,0.565,13,36,0.361,26,30,0.867,117
478,PHO,2022-12-25,125,@,DEN,0,265,45,94,0.479,28,59,0.475,17,35,0.486,18,26,0.692,125,45,94,0.479,32,58,0.552,13,36,0.361,25,34,0.735,128
479,MEM,2022-12-23,125,@,PHO,1,240,45,91,0.495,38,68,0.559,7,23,0.304,28,38,0.737,125,38,87,0.437,29,52,0.558,9,35,0.257,15,26,0.577,100
480,WAS,2022-12-23,125,@,SAC,1,240,49,88,0.557,39,56,0.696,10,32,0.313,17,24,0.708,125,37,84,0.44,27,52,0.519,10,32,0.313,27,35,0.771,111
481,OKC,2022-12-23,125,,NOP,0,265,47,102,0.461,34,67,0.507,13,35,0.371,18,25,0.72,125,41,94,0.436,28,57,0.491,13,37,0.351,33,40,0.825,128
482,ORL,2022-12-19,125,@,ATL,0,240,45,95,0.474,33,61,0.541,12,34,0.353,23,25,0.92,125,48,94,0.511,36,62,0.581,12,32,0.375,18,20,0.9,126
483,CHO,2022-12-19,125,@,SAC,1,240,49,95,0.516,39,64,0.609,10,31,0.323,17,23,0.739,125,45,95,0.474,33,62,0.532,12,33,0.364,17,31,0.548,119
484,ATL,2022-12-16,125,@,CHO,1,240,41,75,0.547,26,46,0.565,15,29,0.517,28,34,0.824,125,39,98,0.398,24,55,0.436,15,43,0.349,13,19,0.684,106
485,IND,2022-12-14,125,,GSW,1,240,44,87,0.506,28,48,0.583,16,39,0.41,21,25,0.84,125,40,86,0.465,26,53,0.491,14,33,0.424,25,29,0.862,119
486,BOS,2022-12-07,125,@,PHO,1,240,49,101,0.485,33,56,0.589,16,45,0.356,11,13,0.846,125,37,93,0.398,29,61,0.475,8,32,0.25,16,19,0.842,98
487,DAL,2022-12-01,125,@,DET,0,265,46,86,0.535,27,40,0.675,19,46,0.413,14,29,0.483,125,51,94,0.543,36,59,0.61,15,35,0.429,14,24,0.583,131
488,ATL,2022-11-30,125,@,ORL,1,240,51,94,0.543,43,62,0.694,8,32,0.25,15,19,0.789,125,39,79,0.494,31,52,0.596,8,27,0.296,22,25,0.88,108
489,UTA,2022-11-30,125,,LAC,1,240,45,81,0.556,31,49,0.633,14,32,0.438,21,28,0.75,125,37,93,0.398,27,63,0.429,10,30,0.333,28,36,0.778,112
490,DET,2022-11-23,125,@,UTA,1,240,44,89,0.494,32,65,0.492,12,24,0.5,25,27,0.926,125,41,83,0.494,23,42,0.548,18,41,0.439,16,19,0.842,116
491,BOS,2022-11-23,125,,DAL,1,240,45,84,0.536,28,50,0.56,17,34,0.5,18,21,0.857,125,44,82,0.537,33,51,0.647,11,31,0.355,13,21,0.619,112
492,IND,2022-11-16,125,@,CHO,1,240,44,82,0.537,33,54,0.611,11,28,0.393,26,31,0.839,125,43,94,0.457,31,61,0.508,12,33,0.364,15,18,0.833,113
493,UTA,2022-11-09,125,@,ATL,1,240,44,94,0.468,27,55,0.491,17,39,0.436,20,24,0.833,125,51,109,0.468,43,81,0.531,8,28,0.286,9,11,0.818,119
494,IND,2022-10-29,125,@,BRK,1,240,40,94,0.426,17,48,0.354,23,46,0.5,22,26,0.846,125,41,82,0.5,27,43,0.628,14,39,0.359,20,26,0.769,116
495,POR,2022-10-28,125,,HOU,1,240,48,90,0.533,35,55,0.636,13,35,0.371,16,20,0.8,125,40,94,0.426,26,56,0.464,14,38,0.368,17,21,0.81,111
496,MEM,2022-10-27,125,@,SAC,1,240,49,92,0.533,35,59,0.593,14,33,0.424,13,18,0.722,125,40,83,0.482,28,45,0.622,12,38,0.316,18,22,0.818,110
497,BRK,2022-10-27,125,,DAL,0,265,43,93,0.462,31,58,0.534,12,35,0.343,27,30,0.9,125,41,81,0.506,21,41,0.512,20,40,0.5,27,35,0.771,129
498,SAC,2022-10-23,125,@,GSW,0,240,47,100,0.47,36,57,0.632,11,43,0.256,20,25,0.8,125,45,87,0.517,31,54,0.574,14,33,0.424,26,36,0.722,130
499,MIL,2022-10-22,125,,HOU,1,240,48,85,0.565,32,54,0.593,16,31,0.516,13,21,0.619,125,36,93,0.387,20,56,0.357,16,37,0.432,17,22,0.773,105
500,HOU,2023-04-04,124,,DEN,1,240,47,102,0.461,35,71,0.493,12,31,0.387,18,24,0.75,124,41,87,0.471,30,51,0.588,11,36,0.306,10,18,0.556,103
501,BRK,2023-03-31,124,,ATL,1,240,49,88,0.557,34,55,0.618,15,33,0.455,11,13,0.846,124,39,91,0.429,31,54,0.574,8,37,0.216,21,23,0.913,107
502,LAC,2023-03-27,124,,CHI,1,240,48,81,0.593,28,41,0.683,20,40,0.5,8,16,0.5,124,44,82,0.537,35,59,0.593,9,23,0.391,15,21,0.714,112
503,NOP,2023-03-27,124,@,POR,1,240,49,86,0.57,37,58,0.638,12,28,0.429,14,17,0.824,124,35,90,0.389,28,57,0.491,7,33,0.212,13,15,0.867,90
504,CHI,2023-03-24,124,@,POR,1,240,48,84,0.571,31,56,0.554,17,28,0.607,11,14,0.786,124,37,86,0.43,31,55,0.564,6,31,0.194,16,18,0.889,96
505,SAS,2023-03-24,124,@,WAS,0,240,51,101,0.505,38,63,0.603,13,38,0.342,9,15,0.6,124,51,85,0.6,36,55,0.655,15,30,0.5,19,26,0.731,136
506,ATL,2023-03-22,124,@,MIN,0,240,45,85,0.529,33,59,0.559,12,26,0.462,22,25,0.88,124,45,92,0.489,34,66,0.515,11,26,0.423,24,29,0.828,125
507,OKC,2023-03-19,124,,PHO,1,240,42,84,0.5,31,56,0.554,11,28,0.393,29,36,0.806,124,44,92,0.478,29,56,0.518,15,36,0.417,17,24,0.708,120
508,SAC,2023-03-13,124,,MIL,0,240,46,104,0.442,25,54,0.463,21,50,0.42,11,15,0.733,124,50,86,0.581,35,53,0.66,15,33,0.455,18,22,0.818,133
509,BRK,2023-03-10,124,@,MIN,1,265,42,91,0.462,26,57,0.456,16,34,0.471,24,33,0.727,124,48,98,0.49,39,68,0.574,9,30,0.3,18,29,0.621,123
510,ORL,2023-03-09,124,,UTA,0,240,44,94,0.468,28,60,0.467,16,34,0.471,20,31,0.645,124,49,88,0.557,36,54,0.667,13,34,0.382,20,21,0.952,131
511,IND,2023-02-28,124,@,DAL,1,240,41,78,0.526,30,50,0.6,11,28,0.393,31,40,0.775,124,46,91,0.505,34,54,0.63,12,37,0.324,18,28,0.643,122
512,LAC,2023-02-26,124,@,DEN,0,265,44,90,0.489,33,56,0.589,11,34,0.324,25,30,0.833,124,49,96,0.51,36,57,0.632,13,39,0.333,23,31,0.742,134
513,SAC,2023-02-26,124,@,OKC,1,240,45,85,0.529,27,42,0.643,18,43,0.419,16,24,0.667,124,41,86,0.477,25,46,0.543,16,40,0.4,17,23,0.739,115
514,PHO,2023-02-24,124,,OKC,1,240,42,90,0.467,28,52,0.538,14,38,0.368,26,32,0.813,124,41,95,0.432,26,57,0.456,15,38,0.395,18,24,0.75,115
515,LAL,2023-02-23,124,,GSW,1,240,42,86,0.488,26,56,0.464,16,30,0.533,24,34,0.706,124,40,105,0.381,26,56,0.464,14,49,0.286,17,21,0.81,111
516,GSW,2023-02-14,124,@,LAC,0,240,45,83,0.542,30,49,0.612,15,34,0.441,19,27,0.704,124,49,92,0.533,32,56,0.571,17,36,0.472,19,22,0.864,134
517,NYK,2023-02-13,124,,BRK,1,240,45,82,0.549,30,48,0.625,15,34,0.441,19,26,0.731,124,35,78,0.449,23,49,0.469,12,29,0.414,24,33,0.727,106
518,MIN,2023-02-13,124,@,DAL,1,240,48,83,0.578,39,54,0.722,9,29,0.31,19,26,0.731,124,43,84,0.512,30,45,0.667,13,39,0.333,22,29,0.759,121
519,DAL,2023-02-06,124,@,UTA,1,240,41,88,0.466,26,49,0.531,15,39,0.385,27,31,0.871,124,41,87,0.471,35,56,0.625,6,31,0.194,23,26,0.885,111
520,LAC,2023-02-06,124,@,BRK,1,240,44,92,0.478,32,62,0.516,12,30,0.4,24,30,0.8,124,41,84,0.488,25,53,0.472,16,31,0.516,18,22,0.818,116
521,POR,2023-02-03,124,@,WAS,1,240,43,88,0.489,26,47,0.553,17,41,0.415,21,23,0.913,124,42,84,0.5,30,51,0.588,12,33,0.364,20,22,0.909,116
522,MIL,2023-01-31,124,,CHO,1,240,43,105,0.41,28,61,0.459,15,44,0.341,23,27,0.852,124,42,111,0.378,31,72,0.431,11,39,0.282,20,26,0.769,115
523,UTA,2023-01-25,124,@,POR,0,240,47,90,0.522,27,49,0.551,20,41,0.488,10,15,0.667,124,51,89,0.573,34,53,0.642,17,36,0.472,15,18,0.833,134
524,NYK,2023-01-20,124,@,ATL,0,240,49,83,0.59,36,53,0.679,13,30,0.433,13,17,0.765,124,56,100,0.56,43,66,0.652,13,34,0.382,14,16,0.875,139
525,MIA,2023-01-18,124,@,NOP,1,240,50,94,0.532,38,59,0.644,12,35,0.343,12,16,0.75,124,37,80,0.463,24,50,0.48,13,30,0.433,11,18,0.611,98
526,OKC,2023-01-13,124,@,CHI,1,240,47,92,0.511,36,59,0.61,11,33,0.333,19,22,0.864,124,38,85,0.447,26,47,0.553,12,38,0.316,22,24,0.917,110
527,TOR,2023-01-12,124,,CHO,1,240,43,83,0.518,33,55,0.6,10,28,0.357,28,36,0.778,124,41,77,0.532,28,44,0.636,13,33,0.394,19,27,0.704,114
528,BOS,2023-01-05,124,@,DAL,1,240,41,84,0.488,25,41,0.61,16,43,0.372,26,31,0.839,124,34,90,0.378,27,58,0.466,7,32,0.219,20,25,0.8,95
529,MIN,2023-01-02,124,,DEN,1,240,45,87,0.517,32,51,0.627,13,36,0.361,21,27,0.778,124,42,91,0.462,31,62,0.5,11,29,0.379,16,20,0.8,111
530,DEN,2022-12-30,124,,MIA,1,240,45,76,0.592,28,48,0.583,17,28,0.607,17,22,0.773,124,39,87,0.448,25,52,0.481,14,35,0.4,27,30,0.9,119
531,LAC,2022-12-27,124,@,TOR,1,240,45,93,0.484,30,55,0.545,15,38,0.395,19,23,0.826,124,43,84,0.512,37,61,0.607,6,23,0.261,21,26,0.808,113
532,POR,2022-12-26,124,,CHO,1,240,43,86,0.5,29,48,0.604,14,38,0.368,24,28,0.857,124,41,103,0.398,29,67,0.433,12,36,0.333,19,25,0.76,113
533,DAL,2022-12-25,124,,LAL,1,240,44,84,0.524,26,40,0.65,18,44,0.409,18,25,0.72,124,39,80,0.488,30,52,0.577,9,28,0.321,28,32,0.875,115
534,SAS,2022-12-19,124,@,HOU,1,240,46,83,0.554,29,49,0.592,17,34,0.5,15,19,0.789,124,40,94,0.426,35,70,0.5,5,24,0.208,20,31,0.645,105
535,BRK,2022-12-18,124,@,DET,1,240,44,80,0.55,29,51,0.569,15,29,0.517,21,23,0.913,124,42,88,0.477,34,58,0.586,8,30,0.267,29,34,0.853,121
536,SAC,2022-12-14,124,@,TOR,1,240,45,93,0.484,28,47,0.596,17,46,0.37,17,20,0.85,124,47,94,0.5,41,73,0.562,6,21,0.286,23,27,0.852,123
537,ATL,2022-12-14,124,@,ORL,0,240,44,88,0.5,32,53,0.604,12,35,0.343,24,27,0.889,124,47,93,0.505,31,57,0.544,16,36,0.444,25,30,0.833,135
538,LAL,2022-12-11,124,@,DET,1,240,46,84,0.548,35,58,0.603,11,26,0.423,21,27,0.778,124,43,93,0.462,26,48,0.542,17,45,0.378,14,17,0.824,117
539,PHO,2022-12-11,124,@,NOP,0,265,49,105,0.467,36,67,0.537,13,38,0.342,13,17,0.765,124,50,86,0.581,42,61,0.689,8,25,0.32,21,28,0.75,129
540,POR,2022-12-10,124,,MIN,1,240,43,83,0.518,30,49,0.612,13,34,0.382,25,28,0.893,124,45,83,0.542,35,60,0.583,10,23,0.435,18,24,0.75,118
541,UTA,2022-12-07,124,,GSW,1,240,46,86,0.535,31,51,0.608,15,35,0.429,17,21,0.81,124,45,98,0.459,31,56,0.554,14,42,0.333,19,25,0.76,123
542,MIL,2022-11-27,124,,DAL,1,240,48,86,0.558,31,49,0.633,17,37,0.459,11,15,0.733,124,41,80,0.513,24,39,0.615,17,41,0.415,16,25,0.64,115
543,GSW,2022-11-23,124,,LAC,1,240,48,97,0.495,29,46,0.63,19,51,0.373,9,13,0.692,124,39,86,0.453,28,57,0.491,11,29,0.379,18,27,0.667,107
544,ATL,2022-11-19,124,,TOR,1,265,46,92,0.5,39,67,0.582,7,25,0.28,25,32,0.781,124,48,108,0.444,40,71,0.563,8,37,0.216,18,22,0.818,122
545,NOP,2022-11-16,124,,CHI,1,240,43,85,0.506,26,52,0.5,17,33,0.515,21,24,0.875,124,44,89,0.494,33,57,0.579,11,32,0.344,11,17,0.647,110
546,CLE,2022-11-13,124,,MIN,0,240,40,89,0.449,23,55,0.418,17,34,0.5,27,39,0.692,124,46,82,0.561,34,58,0.586,12,24,0.5,25,34,0.735,129
547,MEM,2022-11-09,124,@,SAS,1,265,50,98,0.51,36,66,0.545,14,32,0.438,10,13,0.769,124,47,98,0.48,35,61,0.574,12,37,0.324,16,23,0.696,122
548,ATL,2022-11-05,124,,NOP,1,265,47,103,0.456,38,67,0.567,9,36,0.25,21,25,0.84,124,47,108,0.435,40,85,0.471,7,23,0.304,20,28,0.714,121
549,PHO,2022-10-30,124,,HOU,1,240,45,84,0.536,33,44,0.75,12,40,0.3,22,30,0.733,124,38,87,0.437,27,53,0.509,11,34,0.324,22,26,0.846,109
550,UTA,2022-10-29,124,,MEM,1,240,45,87,0.517,26,43,0.605,19,44,0.432,15,20,0.75,124,50,88,0.568,38,61,0.623,12,27,0.444,11,15,0.733,123
551,PHO,2022-10-28,124,,NOP,1,240,48,92,0.522,38,59,0.644,10,33,0.303,18,20,0.9,124,38,86,0.442,23,49,0.469,15,37,0.405,20,22,0.909,111
552,CHI,2022-10-28,124,@,SAS,0,240,47,99,0.475,38,72,0.528,9,27,0.333,21,26,0.808,124,46,86,0.535,30,48,0.625,16,38,0.421,21,26,0.808,129
553,CHI,2022-10-26,124,,IND,1,240,43,87,0.494,27,57,0.474,16,30,0.533,22,24,0.917,124,37,86,0.43,21,46,0.457,16,40,0.4,19,24,0.792,109
554,BRK,2022-10-24,124,@,MEM,0,240,47,87,0.54,38,58,0.655,9,29,0.31,21,26,0.808,124,47,94,0.5,31,60,0.517,16,34,0.471,24,31,0.774,134
555,IND,2022-10-22,124,,DET,1,240,45,103,0.437,29,61,0.475,16,42,0.381,18,24,0.75,124,37,95,0.389,19,53,0.358,18,42,0.429,23,30,0.767,115
556,NOP,2022-10-21,124,@,CHO,1,240,42,89,0.472,34,67,0.507,8,22,0.364,32,37,0.865,124,44,97,0.454,31,63,0.492,13,34,0.382,11,14,0.786,112
557,MIA,2023-04-09,123,,ORL,1,240,45,83,0.542,27,39,0.692,18,44,0.409,15,20,0.75,123,38,90,0.422,21,43,0.488,17,47,0.362,17,24,0.708,110
558,BRK,2023-04-05,123,@,DET,1,240,45,86,0.523,28,43,0.651,17,43,0.395,16,23,0.696,123,41,84,0.488,28,56,0.5,13,28,0.464,13,14,0.929,108
559,DAL,2023-04-05,123,,SAC,1,240,44,89,0.494,24,45,0.533,20,44,0.455,15,18,0.833,123,46,106,0.434,34,69,0.493,12,37,0.324,15,19,0.789,119
560,ATL,2023-04-04,123,@,CHI,1,240,48,86,0.558,38,58,0.655,10,28,0.357,17,19,0.895,123,41,89,0.461,34,58,0.586,7,31,0.226,16,20,0.8,105
561,LAL,2023-03-31,123,@,MIN,1,240,45,90,0.5,36,68,0.529,9,22,0.409,24,30,0.8,123,41,95,0.432,28,56,0.5,13,39,0.333,16,19,0.842,111
562,BRK,2023-03-29,123,,HOU,1,240,44,82,0.537,27,47,0.574,17,35,0.486,18,27,0.667,123,46,98,0.469,37,68,0.544,9,30,0.3,13,21,0.619,114
563,MEM,2023-03-26,123,@,ATL,1,240,48,89,0.539,35,56,0.625,13,33,0.394,14,19,0.737,123,45,98,0.459,38,67,0.567,7,31,0.226,22,26,0.846,119
564,MIL,2023-03-16,123,,IND,0,240,47,89,0.528,36,57,0.632,11,32,0.344,18,26,0.692,123,54,97,0.557,32,51,0.627,22,46,0.478,9,15,0.6,139
565,LAL,2023-03-14,123,@,NOP,1,240,40,82,0.488,22,43,0.512,18,39,0.462,25,28,0.893,123,42,98,0.429,31,55,0.564,11,43,0.256,13,20,0.65,108
566,NYK,2023-03-14,123,@,POR,1,240,42,81,0.519,27,46,0.587,15,35,0.429,24,34,0.706,123,38,99,0.384,21,54,0.389,17,45,0.378,14,18,0.778,107
567,GSW,2023-03-13,123,,PHO,1,240,45,83,0.542,26,44,0.591,19,39,0.487,14,24,0.583,123,46,95,0.484,42,74,0.568,4,21,0.19,16,22,0.727,112
568,MIN,2023-03-10,123,,BRK,0,265,48,98,0.49,39,68,0.574,9,30,0.3,18,29,0.621,123,42,91,0.462,26,57,0.456,16,34,0.471,24,33,0.727,124
569,ORL,2023-03-07,123,,MIL,0,240,50,100,0.5,41,70,0.586,9,30,0.3,14,19,0.737,123,46,78,0.59,36,50,0.72,10,28,0.357,32,34,0.941,134
570,SAC,2023-03-06,123,,NOP,1,240,47,83,0.566,31,45,0.689,16,38,0.421,13,20,0.65,123,43,80,0.538,32,51,0.627,11,29,0.379,11,14,0.786,108
571,LAL,2023-03-01,123,@,OKC,1,240,38,80,0.475,22,45,0.489,16,35,0.457,31,39,0.795,123,44,91,0.484,33,51,0.647,11,40,0.275,18,24,0.75,117
572,SAC,2023-02-28,123,@,OKC,1,240,43,82,0.524,28,40,0.7,15,42,0.357,22,30,0.733,123,43,98,0.439,32,63,0.508,11,35,0.314,20,24,0.833,117
573,GSW,2023-02-28,123,,POR,1,240,49,91,0.538,37,61,0.607,12,30,0.4,13,16,0.813,123,37,86,0.43,25,47,0.532,12,39,0.308,19,22,0.864,105
574,TOR,2023-02-14,123,,ORL,1,240,50,83,0.602,42,59,0.712,8,24,0.333,15,20,0.75,123,43,84,0.512,30,53,0.566,13,31,0.419,14,18,0.778,113
575,UTA,2023-02-13,123,@,IND,1,240,43,85,0.506,28,52,0.538,15,33,0.455,22,25,0.88,123,46,91,0.505,35,57,0.614,11,34,0.324,14,20,0.7,117
576,PHI,2023-02-13,123,,HOU,1,240,46,82,0.561,31,48,0.646,15,34,0.441,16,17,0.941,123,35,86,0.407,29,62,0.468,6,24,0.25,28,31,0.903,104
577,WAS,2023-02-04,123,@,BRK,0,240,39,81,0.481,26,53,0.491,13,28,0.464,32,41,0.78,123,43,86,0.5,29,53,0.547,14,33,0.424,25,28,0.893,125
578,MIL,2023-02-04,123,,MIA,1,240,46,88,0.523,32,48,0.667,14,40,0.35,17,28,0.607,123,45,101,0.446,37,70,0.529,8,31,0.258,17,21,0.81,115
579,NYK,2023-01-31,123,,LAL,0,265,44,98,0.449,37,64,0.578,7,34,0.206,28,32,0.875,123,48,93,0.516,37,60,0.617,11,33,0.333,22,31,0.71,129
580,TOR,2023-01-28,123,@,POR,1,240,48,92,0.522,38,62,0.613,10,30,0.333,17,18,0.944,123,40,76,0.526,33,52,0.635,7,24,0.292,18,23,0.783,105
581,ORL,2023-01-20,123,,NOP,1,240,39,75,0.52,24,45,0.533,15,30,0.5,30,34,0.882,123,41,91,0.451,31,56,0.554,10,35,0.286,18,24,0.75,110
582,TOR,2023-01-16,123,@,NYK,1,265,38,96,0.396,25,52,0.481,13,44,0.295,34,41,0.829,123,42,99,0.424,33,68,0.485,9,31,0.29,28,35,0.8,121
583,DAL,2023-01-15,123,@,POR,0,240,41,89,0.461,27,47,0.574,14,42,0.333,27,33,0.818,123,43,85,0.506,26,41,0.634,17,44,0.386,37,42,0.881,140
584,PHI,2023-01-08,123,@,DET,1,240,46,94,0.489,35,57,0.614,11,37,0.297,20,23,0.87,123,44,87,0.506,36,64,0.563,8,23,0.348,15,18,0.833,111
585,MEM,2023-01-08,123,,UTA,1,240,46,102,0.451,31,64,0.484,15,38,0.395,16,22,0.727,123,45,88,0.511,35,56,0.625,10,32,0.313,18,22,0.818,118
586,MEM,2023-01-05,123,@,ORL,1,240,48,92,0.522,36,56,0.643,12,36,0.333,15,23,0.652,123,39,84,0.464,28,48,0.583,11,36,0.306,26,30,0.867,115
587,MIL,2023-01-03,123,,WAS,1,240,48,100,0.48,37,60,0.617,11,40,0.275,16,17,0.941,123,42,97,0.433,34,70,0.486,8,27,0.296,21,23,0.913,113
588,DEN,2023-01-01,123,,BOS,1,240,45,79,0.57,28,49,0.571,17,30,0.567,16,18,0.889,123,40,87,0.46,31,54,0.574,9,33,0.273,22,27,0.815,111
589,BRK,2022-12-31,123,@,CHO,1,240,48,80,0.6,35,46,0.761,13,34,0.382,14,19,0.737,123,38,96,0.396,27,55,0.491,11,41,0.268,19,21,0.905,106
590,UTA,2022-12-31,123,,MIA,0,240,35,81,0.432,18,41,0.439,17,40,0.425,36,44,0.818,123,45,89,0.506,32,50,0.64,13,39,0.333,23,30,0.767,126
591,MIL,2022-12-30,123,,MIN,1,240,43,93,0.462,29,54,0.537,14,39,0.359,23,33,0.697,123,40,92,0.435,32,62,0.516,8,30,0.267,26,34,0.765,114
592,GSW,2022-12-25,123,,MEM,1,240,43,91,0.473,25,47,0.532,18,44,0.409,19,26,0.731,123,39,94,0.415,30,55,0.545,9,39,0.231,22,30,0.733,109
593,OKC,2022-12-19,123,,POR,1,240,40,88,0.455,29,57,0.509,11,31,0.355,32,37,0.865,123,44,88,0.5,28,51,0.549,16,37,0.432,17,21,0.81,121
594,MIL,2022-12-17,123,,UTA,1,240,48,90,0.533,30,52,0.577,18,38,0.474,9,11,0.818,123,39,86,0.453,23,39,0.59,16,47,0.34,3,6,0.5,97
595,TOR,2022-12-14,123,,SAC,0,240,47,94,0.5,41,73,0.562,6,21,0.286,23,27,0.852,123,45,93,0.484,28,47,0.596,17,46,0.37,17,20,0.85,124
596,PHI,2022-12-13,123,,SAC,1,240,43,84,0.512,27,49,0.551,16,35,0.457,21,27,0.778,123,38,92,0.413,28,50,0.56,10,42,0.238,17,20,0.85,103
597,ATL,2022-12-11,123,,CHI,1,265,47,98,0.48,34,59,0.576,13,39,0.333,16,21,0.762,123,48,100,0.48,41,73,0.562,7,27,0.259,19,23,0.826,122
598,GSW,2022-12-10,123,,BOS,1,240,47,92,0.511,34,53,0.642,13,39,0.333,16,20,0.8,123,38,87,0.437,26,47,0.553,12,40,0.3,19,26,0.731,107
599,MEM,2022-12-07,123,,OKC,1,240,48,94,0.511,34,56,0.607,14,38,0.368,13,16,0.813,123,34,92,0.37,20,54,0.37,14,38,0.368,20,23,0.87,102
600,GSW,2022-12-07,123,@,UTA,0,240,45,98,0.459,31,56,0.554,14,42,0.333,19,25,0.76,123,46,86,0.535,31,51,0.608,15,35,0.429,17,21,0.81,124
601,PHI,2022-12-05,123,@,HOU,0,290,39,87,0.448,22,51,0.431,17,36,0.472,28,36,0.778,123,42,94,0.447,28,55,0.509,14,39,0.359,34,44,0.773,132
602,SAC,2022-12-03,123,@,LAC,1,240,46,89,0.517,35,57,0.614,11,32,0.344,20,30,0.667,123,33,93,0.355,24,60,0.4,9,33,0.273,21,26,0.808,96
603,NYK,2022-11-27,123,,MEM,0,240,44,87,0.506,34,57,0.596,10,30,0.333,25,30,0.833,123,46,95,0.484,34,63,0.54,12,32,0.375,23,31,0.742,127
604,OKC,2022-11-25,123,,CHI,1,265,44,95,0.463,37,66,0.561,7,29,0.241,28,32,0.875,123,44,101,0.436,32,68,0.471,12,33,0.364,19,23,0.826,119
605,IND,2022-11-21,123,,ORL,1,240,43,86,0.5,30,40,0.75,13,46,0.283,24,27,0.889,123,36,85,0.424,25,50,0.5,11,35,0.314,19,25,0.76,102
606,LAL,2022-11-20,123,,SAS,1,240,45,85,0.529,33,51,0.647,12,34,0.353,21,24,0.875,123,41,105,0.39,34,71,0.479,7,34,0.206,3,10,0.3,92
607,ORL,2022-11-05,123,,SAC,0,265,50,92,0.543,46,69,0.667,4,23,0.174,19,20,0.95,123,47,93,0.505,32,53,0.604,15,40,0.375,17,26,0.654,126
608,BOS,2022-11-04,123,,CHI,1,240,41,83,0.494,32,52,0.615,9,31,0.29,32,39,0.821,123,43,83,0.518,32,55,0.582,11,28,0.393,22,25,0.88,119
609,MEM,2022-10-29,123,@,UTA,0,240,50,88,0.568,38,61,0.623,12,27,0.444,11,15,0.733,123,45,87,0.517,26,43,0.605,19,44,0.432,15,20,0.75,124
610,MIL,2022-10-29,123,,ATL,1,240,45,92,0.489,31,56,0.554,14,36,0.389,19,29,0.655,123,45,94,0.479,32,65,0.492,13,29,0.448,12,15,0.8,115
611,BOS,2022-10-28,123,,CLE,0,265,42,82,0.512,29,49,0.592,13,33,0.394,26,32,0.813,123,45,87,0.517,29,52,0.558,16,35,0.457,26,34,0.765,132
612,GSW,2022-10-27,123,,MIA,1,240,46,92,0.5,28,46,0.609,18,46,0.391,13,15,0.867,123,39,88,0.443,25,45,0.556,14,43,0.326,18,22,0.818,110
613,GSW,2022-10-21,123,,DEN,0,240,42,88,0.477,27,44,0.614,15,44,0.341,24,27,0.889,123,46,86,0.535,31,52,0.596,15,34,0.441,21,25,0.84,128
614,UTA,2022-10-19,123,,DEN,1,240,42,83,0.506,26,45,0.578,16,38,0.421,23,31,0.742,123,40,83,0.482,35,61,0.574,5,22,0.227,17,18,0.944,102
615,GSW,2022-10-18,123,,LAL,1,240,45,99,0.455,29,54,0.537,16,45,0.356,17,23,0.739,123,40,94,0.426,30,54,0.556,10,40,0.25,19,25,0.76,109
616,DET,2023-04-07,122,@,IND,1,240,44,90,0.489,31,59,0.525,13,31,0.419,21,26,0.808,122,41,83,0.494,30,52,0.577,11,31,0.355,22,28,0.786,115
617,DAL,2023-04-01,122,@,MIA,0,240,47,77,0.61,33,43,0.767,14,34,0.412,14,16,0.875,122,45,86,0.523,32,49,0.653,13,37,0.351,26,29,0.897,129
618,NOP,2023-04-01,122,,LAC,1,240,42,86,0.488,35,69,0.507,7,17,0.412,31,35,0.886,122,42,85,0.494,31,56,0.554,11,29,0.379,19,23,0.826,114
619,BOS,2023-03-31,122,,UTA,1,240,42,96,0.438,25,45,0.556,17,51,0.333,21,22,0.955,122,46,96,0.479,37,67,0.552,9,29,0.31,13,14,0.929,114
620,LAL,2023-03-22,122,,PHO,1,240,39,70,0.557,31,53,0.585,8,17,0.471,36,46,0.783,122,42,90,0.467,30,59,0.508,12,31,0.387,15,20,0.75,111
621,ORL,2023-03-21,122,,WAS,1,240,43,80,0.538,31,53,0.585,12,27,0.444,24,25,0.96,122,42,83,0.506,32,51,0.627,10,32,0.313,18,23,0.783,112
622,TOR,2023-03-18,122,,MIN,1,240,48,90,0.533,39,63,0.619,9,27,0.333,17,21,0.81,122,39,85,0.459,34,62,0.548,5,23,0.217,24,28,0.857,107
623,BRK,2023-03-12,122,@,DEN,1,240,42,84,0.5,25,40,0.625,17,44,0.386,21,24,0.875,122,45,90,0.5,33,59,0.559,12,31,0.387,18,24,0.75,120
624,LAL,2023-03-10,122,,TOR,1,240,45,80,0.563,32,50,0.64,13,30,0.433,19,19,1.0,122,46,92,0.5,36,64,0.563,10,28,0.357,10,13,0.769,112
625,SAC,2023-03-09,122,,NYK,1,240,44,84,0.524,34,52,0.654,10,32,0.313,24,32,0.75,122,42,101,0.416,29,51,0.569,13,50,0.26,20,31,0.645,117
626,ATL,2023-03-08,122,@,WAS,1,240,45,85,0.529,33,56,0.589,12,29,0.414,20,26,0.769,122,47,83,0.566,35,54,0.648,12,29,0.414,14,17,0.824,120
627,CHI,2023-03-05,122,,IND,0,240,45,74,0.608,35,52,0.673,10,22,0.455,22,25,0.88,122,48,94,0.511,32,50,0.64,16,44,0.364,13,16,0.813,125
628,POR,2023-03-05,122,@,ORL,1,240,39,83,0.47,23,36,0.639,16,47,0.34,28,32,0.875,122,42,84,0.5,31,53,0.585,11,31,0.355,24,31,0.774,119
629,HOU,2023-03-04,122,@,SAS,1,240,49,87,0.563,41,64,0.641,8,23,0.348,16,22,0.727,122,38,86,0.442,23,49,0.469,15,37,0.405,19,20,0.95,110
630,NYK,2023-03-03,122,@,MIA,1,240,47,81,0.58,30,40,0.75,17,41,0.415,11,17,0.647,122,39,81,0.481,27,56,0.482,12,25,0.48,30,32,0.938,120
631,DAL,2023-02-28,122,,IND,0,240,46,91,0.505,34,54,0.63,12,37,0.324,18,28,0.643,122,41,78,0.526,30,50,0.6,11,28,0.393,31,40,0.775,124
632,NYK,2023-02-15,122,@,ATL,1,240,45,96,0.469,31,53,0.585,14,43,0.326,18,22,0.818,122,40,97,0.412,35,71,0.493,5,26,0.192,16,21,0.762,101
633,DAL,2023-02-10,122,@,SAC,1,240,43,88,0.489,25,45,0.556,18,43,0.419,18,19,0.947,122,39,72,0.542,30,45,0.667,9,27,0.333,27,32,0.844,114
634,UTA,2023-02-10,122,@,TOR,1,240,47,87,0.54,41,63,0.651,6,24,0.25,22,29,0.759,122,41,91,0.451,29,57,0.509,12,34,0.353,22,30,0.733,116
635,GSW,2023-02-08,122,@,POR,0,240,46,97,0.474,25,48,0.521,21,49,0.429,9,10,0.9,122,43,78,0.551,35,51,0.686,8,27,0.296,31,32,0.969,125
636,CLE,2023-02-05,122,@,IND,1,240,46,88,0.523,31,51,0.608,15,37,0.405,15,16,0.938,122,40,92,0.435,32,60,0.533,8,32,0.25,15,22,0.682,103
637,POR,2023-02-01,122,@,MEM,1,240,41,87,0.471,27,51,0.529,14,36,0.389,26,27,0.963,122,41,87,0.471,32,50,0.64,9,37,0.243,21,28,0.75,112
638,DEN,2023-01-31,122,,NOP,1,240,43,87,0.494,27,51,0.529,16,36,0.444,20,24,0.833,122,42,85,0.494,34,58,0.586,8,27,0.296,21,25,0.84,113
639,CLE,2023-01-29,122,,LAC,1,240,44,78,0.564,24,45,0.533,20,33,0.606,14,19,0.737,122,37,89,0.416,35,70,0.5,2,19,0.105,23,27,0.852,99
640,CHO,2023-01-29,122,,MIA,1,240,45,83,0.542,30,43,0.698,15,40,0.375,17,22,0.773,122,45,93,0.484,35,62,0.565,10,31,0.323,17,23,0.739,117
641,BRK,2023-01-28,122,,NYK,1,240,46,87,0.529,24,47,0.511,22,40,0.55,8,14,0.571,122,45,88,0.511,35,60,0.583,10,28,0.357,15,19,0.789,115
642,BRK,2023-01-26,122,,DET,0,240,43,94,0.457,30,56,0.536,13,38,0.342,23,27,0.852,122,48,95,0.505,37,68,0.544,11,27,0.407,23,26,0.885,130
643,GSW,2023-01-25,122,,MEM,1,240,43,85,0.506,29,53,0.547,14,32,0.438,22,28,0.786,122,42,88,0.477,32,57,0.561,10,31,0.323,26,37,0.703,120
644,CHO,2023-01-21,122,@,ATL,1,240,45,89,0.506,32,55,0.582,13,34,0.382,19,22,0.864,122,45,83,0.542,34,58,0.586,11,25,0.44,17,20,0.85,118
645,LAL,2023-01-20,122,,MEM,1,240,38,93,0.409,25,52,0.481,13,41,0.317,33,41,0.805,122,43,102,0.422,34,73,0.466,9,29,0.31,26,40,0.65,121
646,DEN,2023-01-18,122,,MIN,1,240,45,85,0.529,37,64,0.578,8,21,0.381,24,32,0.75,122,42,81,0.519,30,49,0.612,12,32,0.375,22,28,0.786,118
647,CHO,2023-01-18,122,@,HOU,1,240,48,96,0.5,39,60,0.65,9,36,0.25,17,25,0.68,122,46,91,0.505,36,59,0.61,10,32,0.313,15,20,0.75,117
648,DAL,2023-01-18,122,,ATL,0,240,44,84,0.524,28,42,0.667,16,42,0.381,18,24,0.75,122,49,86,0.57,36,60,0.6,13,26,0.5,19,20,0.95,130
649,DEN,2023-01-17,122,,POR,1,240,44,88,0.5,33,56,0.589,11,32,0.344,23,28,0.821,122,38,83,0.458,25,43,0.581,13,40,0.325,24,25,0.96,113
650,TOR,2023-01-17,122,@,MIL,0,240,46,101,0.455,33,66,0.5,13,35,0.371,17,27,0.63,122,46,86,0.535,27,47,0.574,19,39,0.487,19,21,0.905,130
651,BOS,2023-01-14,122,@,CHO,1,240,47,99,0.475,28,46,0.609,19,53,0.358,9,10,0.9,122,41,88,0.466,33,61,0.541,8,27,0.296,16,19,0.842,106
652,DEN,2023-01-09,122,,LAL,1,240,46,99,0.465,31,57,0.544,15,42,0.357,15,17,0.882,122,41,93,0.441,33,65,0.508,8,28,0.286,19,25,0.76,109
653,DEN,2023-01-05,122,,LAC,1,240,45,89,0.506,31,53,0.585,14,36,0.389,18,21,0.857,122,34,91,0.374,29,54,0.537,5,37,0.135,18,25,0.72,91
654,DET,2023-01-04,122,@,GSW,1,240,45,92,0.489,29,56,0.518,16,36,0.444,16,23,0.696,122,45,87,0.517,30,47,0.638,15,40,0.375,14,15,0.933,119
655,IND,2023-01-02,122,,TOR,1,240,45,93,0.484,35,66,0.53,10,27,0.37,22,26,0.846,122,41,91,0.451,27,49,0.551,14,42,0.333,18,23,0.783,114
656,SAS,2022-12-29,122,,NYK,1,240,45,88,0.511,34,60,0.567,11,28,0.393,21,29,0.724,122,38,90,0.422,23,49,0.469,15,41,0.366,24,31,0.774,115
657,UTA,2022-12-26,122,@,SAS,0,240,39,97,0.402,26,54,0.481,13,43,0.302,31,37,0.838,122,48,87,0.552,42,69,0.609,6,18,0.333,24,34,0.706,126
658,CLE,2022-12-19,122,,UTA,1,240,43,70,0.614,28,44,0.636,15,26,0.577,21,26,0.808,122,36,93,0.387,26,59,0.441,10,34,0.294,17,23,0.739,99
659,SAC,2022-12-16,122,@,DET,1,240,43,82,0.524,31,51,0.608,12,31,0.387,24,29,0.828,122,39,85,0.459,29,56,0.518,10,29,0.345,25,31,0.806,113
660,BOS,2022-12-13,122,@,LAL,1,265,46,104,0.442,27,56,0.482,19,48,0.396,11,16,0.688,122,44,93,0.473,36,64,0.563,8,29,0.276,22,30,0.733,118
661,CHI,2022-12-11,122,@,ATL,0,265,48,100,0.48,41,73,0.562,7,27,0.259,19,23,0.826,122,47,98,0.48,34,59,0.576,13,39,0.333,16,21,0.762,123
662,LAL,2022-12-09,122,@,PHI,0,265,44,88,0.5,33,57,0.579,11,31,0.355,23,30,0.767,122,48,90,0.533,30,50,0.6,18,40,0.45,19,22,0.864,133
663,BRK,2022-12-07,122,,CHO,1,240,49,86,0.57,37,55,0.673,12,31,0.387,12,16,0.75,122,47,88,0.534,37,64,0.578,10,24,0.417,12,23,0.522,116
664,MEM,2022-12-04,122,@,DET,1,240,43,92,0.467,28,57,0.491,15,35,0.429,21,29,0.724,122,37,84,0.44,24,49,0.49,13,35,0.371,25,30,0.833,112
665,HOU,2022-12-02,122,@,PHO,1,240,40,81,0.494,32,57,0.561,8,24,0.333,34,43,0.791,122,45,85,0.529,28,48,0.583,17,37,0.459,14,19,0.737,121
666,PHO,2022-11-28,122,@,SAC,1,240,50,94,0.532,40,62,0.645,10,32,0.313,12,14,0.857,122,46,88,0.523,37,63,0.587,9,25,0.36,16,18,0.889,117
667,ATL,2022-11-25,122,@,HOU,0,240,39,82,0.476,24,43,0.558,15,39,0.385,29,36,0.806,122,41,87,0.471,29,52,0.558,12,35,0.343,34,41,0.829,128
668,BOS,2022-11-25,122,,SAC,1,240,41,83,0.494,25,46,0.543,16,37,0.432,24,27,0.889,122,36,87,0.414,27,51,0.529,9,36,0.25,23,26,0.885,104
669,TOR,2022-11-19,122,@,ATL,0,265,48,108,0.444,40,71,0.563,8,37,0.216,18,22,0.818,122,46,92,0.5,39,67,0.582,7,25,0.28,25,32,0.781,124
670,CHO,2022-11-18,122,@,CLE,0,290,44,110,0.4,30,66,0.455,14,44,0.318,20,24,0.833,122,49,92,0.533,41,64,0.641,8,28,0.286,26,32,0.813,132
671,OKC,2022-11-14,122,@,BOS,0,240,47,98,0.48,36,68,0.529,11,30,0.367,17,21,0.81,122,46,96,0.479,36,59,0.61,10,37,0.27,24,29,0.828,126
672,LAC,2022-11-14,122,@,HOU,1,240,41,81,0.506,27,43,0.628,14,38,0.368,26,33,0.788,122,39,86,0.453,30,56,0.536,9,30,0.3,19,31,0.613,106
673,SAC,2022-11-13,122,,GSW,1,240,47,91,0.516,31,54,0.574,16,37,0.432,12,19,0.632,122,42,90,0.467,26,43,0.605,16,47,0.34,15,16,0.938,115
674,DEN,2022-11-09,122,@,IND,1,240,43,88,0.489,31,60,0.517,12,28,0.429,24,26,0.923,122,45,96,0.469,31,54,0.574,14,42,0.333,15,19,0.789,119
675,SAS,2022-11-09,122,,MEM,0,265,47,98,0.48,35,61,0.574,12,37,0.324,16,23,0.696,122,50,98,0.51,36,66,0.545,14,32,0.438,10,13,0.769,124
676,NOP,2022-11-07,122,@,IND,0,240,48,97,0.495,34,63,0.54,14,34,0.412,12,17,0.706,122,43,86,0.5,21,38,0.553,22,48,0.458,21,23,0.913,129
677,DEN,2022-11-03,122,@,OKC,1,240,45,84,0.536,27,53,0.509,18,31,0.581,14,16,0.875,122,45,93,0.484,39,64,0.609,6,29,0.207,14,19,0.737,110
678,SAS,2022-10-26,122,@,MIN,0,240,43,95,0.453,27,59,0.458,16,36,0.444,20,22,0.909,122,52,80,0.65,32,46,0.696,20,34,0.588,10,16,0.625,134
679,UTA,2022-10-23,122,@,NOP,1,265,43,98,0.439,30,60,0.5,13,38,0.342,23,28,0.821,122,48,102,0.471,40,75,0.533,8,27,0.296,17,22,0.773,121
680,DEN,2022-10-22,122,,OKC,1,240,42,85,0.494,22,47,0.468,20,38,0.526,18,31,0.581,122,42,94,0.447,27,56,0.482,15,38,0.395,18,23,0.783,117
681,HOU,2022-10-21,122,,MEM,0,240,44,93,0.473,28,58,0.483,16,35,0.457,18,30,0.6,122,45,98,0.459,26,56,0.464,19,42,0.452,20,29,0.69,129
682,TOR,2023-04-09,121,,MIL,1,240,48,95,0.505,37,62,0.597,11,33,0.333,14,16,0.875,121,38,82,0.463,26,48,0.542,12,34,0.353,17,21,0.81,105
683,BOS,2023-04-07,121,,TOR,1,240,45,81,0.556,30,37,0.811,15,44,0.341,16,21,0.762,121,40,93,0.43,31,62,0.5,9,31,0.29,13,17,0.765,102
684,LAL,2023-04-07,121,,PHO,1,240,45,92,0.489,27,56,0.482,18,36,0.5,13,17,0.765,121,43,104,0.413,34,68,0.5,9,36,0.25,12,14,0.857,107
685,SAC,2023-04-04,121,@,NOP,1,240,46,91,0.505,29,49,0.592,17,42,0.405,12,15,0.8,121,37,84,0.44,30,64,0.469,7,20,0.35,22,27,0.815,103
686,HOU,2023-03-31,121,,DET,1,240,38,83,0.458,27,52,0.519,11,31,0.355,34,45,0.756,121,43,89,0.483,32,54,0.593,11,35,0.314,18,27,0.667,115
687,CHI,2023-03-31,121,@,CHO,1,240,45,88,0.511,32,57,0.561,13,31,0.419,18,22,0.818,121,35,77,0.455,21,40,0.525,14,37,0.378,7,10,0.7,91
688,IND,2023-03-31,121,,OKC,1,240,45,98,0.459,33,57,0.579,12,41,0.293,19,28,0.679,121,42,88,0.477,38,58,0.655,4,30,0.133,29,34,0.853,117
689,LAL,2023-03-29,121,@,CHI,1,240,45,86,0.523,38,66,0.576,7,20,0.35,24,30,0.8,121,45,88,0.511,36,55,0.655,9,33,0.273,11,13,0.846,110
690,SAC,2023-03-25,121,,UTA,1,240,44,95,0.463,28,52,0.538,16,43,0.372,17,21,0.81,121,47,91,0.516,38,63,0.603,9,28,0.321,10,16,0.625,113
691,GSW,2023-03-20,121,@,HOU,1,240,44,88,0.5,27,40,0.675,17,48,0.354,16,19,0.842,121,39,93,0.419,29,57,0.509,10,36,0.278,20,24,0.833,108
692,IND,2023-03-18,121,,PHI,0,240,45,87,0.517,33,56,0.589,12,31,0.387,19,20,0.95,121,54,88,0.614,39,53,0.736,15,35,0.429,18,22,0.818,141
693,PHI,2023-03-17,121,@,CHO,1,240,46,92,0.5,36,60,0.6,10,32,0.313,19,25,0.76,121,29,86,0.337,24,51,0.471,5,35,0.143,19,26,0.731,82
694,OKC,2023-03-14,121,,BRK,1,240,45,99,0.455,34,66,0.515,11,33,0.333,20,23,0.87,121,35,82,0.427,23,41,0.561,12,41,0.293,25,34,0.735,107
695,IND,2023-03-11,121,@,DET,1,240,43,93,0.462,34,58,0.586,9,35,0.257,26,34,0.765,121,43,94,0.457,32,60,0.533,11,34,0.324,18,27,0.667,115
696,NOP,2023-03-01,121,@,POR,1,240,46,89,0.517,37,64,0.578,9,25,0.36,20,23,0.87,121,36,81,0.444,25,43,0.581,11,38,0.289,27,29,0.931,110
697,MEM,2023-02-28,121,,LAL,1,240,51,112,0.455,45,81,0.556,6,31,0.194,13,17,0.765,121,38,86,0.442,25,52,0.481,13,34,0.382,20,23,0.87,109
698,IND,2023-02-25,121,@,ORL,1,240,48,99,0.485,33,59,0.559,15,40,0.375,10,14,0.714,121,35,90,0.389,29,61,0.475,6,29,0.207,32,38,0.842,108
699,CHO,2023-02-24,121,@,MIN,1,240,43,92,0.467,33,64,0.516,10,28,0.357,25,28,0.893,121,46,93,0.495,35,60,0.583,11,33,0.333,10,16,0.625,113
700,DAL,2023-02-13,121,,MIN,0,240,43,84,0.512,30,45,0.667,13,39,0.333,22,29,0.759,121,48,83,0.578,39,54,0.722,9,29,0.31,19,26,0.731,124
701,HOU,2023-02-04,121,@,OKC,0,240,45,89,0.506,35,59,0.593,10,30,0.333,21,27,0.778,121,56,97,0.577,35,51,0.686,21,46,0.457,20,23,0.87,153
702,POR,2023-02-04,121,@,CHI,0,240,44,87,0.506,30,44,0.682,14,43,0.326,19,21,0.905,121,48,80,0.6,36,54,0.667,12,26,0.462,21,25,0.84,129
703,BRK,2023-01-30,121,,LAL,1,240,45,95,0.474,29,54,0.537,16,41,0.39,15,19,0.789,121,35,89,0.393,24,60,0.4,11,29,0.379,23,37,0.622,104
704,LAL,2023-01-28,121,@,BOS,0,265,47,105,0.448,35,63,0.556,12,42,0.286,15,20,0.75,121,39,84,0.464,26,44,0.591,13,40,0.325,34,39,0.872,125
705,LAL,2023-01-22,121,@,POR,1,240,45,86,0.523,35,56,0.625,10,30,0.333,21,27,0.778,121,37,86,0.43,20,40,0.5,17,46,0.37,21,25,0.84,112
706,MEM,2023-01-20,121,@,LAL,0,240,43,102,0.422,34,73,0.466,9,29,0.31,26,40,0.65,121,38,93,0.409,25,52,0.481,13,41,0.317,33,41,0.805,122
707,BOS,2023-01-19,121,,GSW,1,265,43,108,0.398,30,67,0.448,13,41,0.317,22,30,0.733,121,40,100,0.4,22,48,0.458,18,52,0.346,20,23,0.87,118
708,ATL,2023-01-16,121,,MIA,1,240,45,76,0.592,32,49,0.653,13,27,0.481,18,22,0.818,121,43,89,0.483,35,58,0.603,8,31,0.258,19,20,0.95,113
709,NYK,2023-01-16,121,,TOR,0,265,42,99,0.424,33,68,0.485,9,31,0.29,28,35,0.8,121,38,96,0.396,25,52,0.481,13,44,0.295,34,41,0.829,123
710,LAC,2023-01-15,121,,HOU,1,240,46,88,0.523,32,56,0.571,14,32,0.438,15,21,0.714,121,38,84,0.452,31,53,0.585,7,31,0.226,17,23,0.739,100
711,MIN,2023-01-13,121,,PHO,1,240,47,90,0.522,37,62,0.597,10,28,0.357,17,20,0.85,121,41,86,0.477,27,63,0.429,14,23,0.609,20,24,0.833,116
712,MEM,2023-01-09,121,,SAS,1,240,45,91,0.495,34,65,0.523,11,26,0.423,20,35,0.571,121,44,97,0.454,33,65,0.508,11,32,0.344,14,16,0.875,113
713,BOS,2023-01-07,121,@,SAS,1,240,47,95,0.495,32,61,0.525,15,34,0.441,12,18,0.667,121,49,100,0.49,42,75,0.56,7,25,0.28,11,14,0.786,116
714,DEN,2023-01-06,121,,CLE,1,240,43,81,0.531,26,46,0.565,17,35,0.486,18,23,0.783,121,40,88,0.455,30,62,0.484,10,26,0.385,18,32,0.563,108
715,SAS,2023-01-06,121,,DET,1,240,45,81,0.556,36,57,0.632,9,24,0.375,22,26,0.846,121,44,93,0.473,33,62,0.532,11,31,0.355,10,17,0.588,109
716,CHI,2023-01-04,121,,BRK,1,240,43,81,0.531,35,61,0.574,8,20,0.4,27,29,0.931,121,42,91,0.462,30,54,0.556,12,37,0.324,16,21,0.762,112
717,LAL,2023-01-02,121,@,CHO,1,240,45,93,0.484,35,63,0.556,10,30,0.333,21,30,0.7,121,42,93,0.452,31,61,0.508,11,32,0.344,20,29,0.69,115
718,ATL,2022-12-30,121,,LAL,0,240,48,101,0.475,37,63,0.587,11,38,0.289,14,20,0.7,121,52,96,0.542,42,64,0.656,10,32,0.313,16,18,0.889,130
719,CHO,2022-12-29,121,,OKC,1,240,46,84,0.548,36,52,0.692,10,32,0.313,19,29,0.655,121,42,99,0.424,31,63,0.492,11,36,0.306,18,21,0.857,113
720,DET,2022-12-28,121,,ORL,1,240,36,80,0.45,18,38,0.474,18,42,0.429,31,40,0.775,121,35,85,0.412,30,63,0.476,5,22,0.227,26,34,0.765,101
721,NYK,2022-12-27,121,@,DAL,0,265,45,103,0.437,29,53,0.547,16,50,0.32,15,24,0.625,121,44,90,0.489,31,44,0.705,13,46,0.283,25,33,0.758,126
722,BOS,2022-12-23,121,,MIN,1,240,44,100,0.44,31,54,0.574,13,46,0.283,20,26,0.769,121,44,91,0.484,34,59,0.576,10,32,0.313,11,15,0.733,109
723,POR,2022-12-19,121,@,OKC,0,240,44,88,0.5,28,51,0.549,16,37,0.432,17,21,0.81,121,40,88,0.455,29,57,0.509,11,31,0.355,32,37,0.865,123
724,DET,2022-12-18,121,,BRK,0,240,42,88,0.477,34,58,0.586,8,30,0.267,29,34,0.853,121,44,80,0.55,29,51,0.569,15,29,0.517,21,23,0.913,124
725,UTA,2022-12-13,121,,NOP,1,240,49,103,0.476,34,56,0.607,15,47,0.319,8,12,0.667,121,37,93,0.398,33,66,0.5,4,27,0.148,22,33,0.667,100
726,DAL,2022-12-12,121,,OKC,1,240,39,93,0.419,17,39,0.436,22,54,0.407,21,25,0.84,121,42,88,0.477,32,57,0.561,10,31,0.323,20,21,0.952,114
727,NYK,2022-12-09,121,@,CHO,1,240,41,93,0.441,28,59,0.475,13,34,0.382,26,30,0.867,121,37,84,0.44,31,58,0.534,6,26,0.231,22,28,0.786,102
728,IND,2022-12-09,121,,WAS,1,240,43,85,0.506,25,44,0.568,18,41,0.439,17,20,0.85,121,41,77,0.532,31,48,0.646,10,29,0.345,19,25,0.76,111
729,DEN,2022-12-08,121,@,POR,1,240,47,91,0.516,35,61,0.574,12,30,0.4,15,22,0.682,121,44,91,0.484,28,51,0.549,16,40,0.4,16,16,1.0,120
730,MIN,2022-12-07,121,,IND,1,240,44,93,0.473,36,70,0.514,8,23,0.348,25,27,0.926,121,39,81,0.481,20,39,0.513,19,42,0.452,18,24,0.75,115
731,OKC,2022-12-05,121,@,ATL,1,240,43,95,0.453,31,61,0.508,12,34,0.353,23,24,0.958,121,44,102,0.431,31,64,0.484,13,38,0.342,13,17,0.765,114
732,NOP,2022-12-04,121,,DEN,1,240,41,81,0.506,30,55,0.545,11,26,0.423,28,36,0.778,121,41,81,0.506,33,50,0.66,8,31,0.258,16,24,0.667,106
733,TOR,2022-12-03,121,,ORL,1,240,47,84,0.56,38,55,0.691,9,29,0.31,18,25,0.72,121,38,78,0.487,27,50,0.54,11,28,0.393,21,26,0.808,108
734,DAL,2022-12-03,121,@,NYK,1,240,43,100,0.43,19,39,0.487,24,61,0.393,11,14,0.786,121,35,77,0.455,25,46,0.543,10,31,0.323,20,28,0.714,100
735,PHO,2022-12-02,121,,HOU,0,240,45,85,0.529,28,48,0.583,17,37,0.459,14,19,0.737,121,40,81,0.494,32,57,0.561,8,24,0.333,34,43,0.791,122
736,MIA,2022-11-30,121,@,BOS,0,240,47,90,0.522,29,50,0.58,18,40,0.45,9,9,1.0,121,46,83,0.554,24,38,0.632,22,45,0.489,20,23,0.87,134
737,WAS,2022-11-27,121,@,BOS,0,240,44,82,0.537,37,54,0.685,7,28,0.25,26,33,0.788,121,44,80,0.55,28,46,0.609,16,34,0.471,26,26,1.0,130
738,CHI,2022-11-21,121,,BOS,1,240,46,89,0.517,32,60,0.533,14,29,0.483,15,20,0.75,121,38,87,0.437,19,37,0.514,19,50,0.38,12,17,0.706,107
739,LAC,2022-11-21,121,,UTA,1,240,47,91,0.516,38,67,0.567,9,24,0.375,18,19,0.947,121,40,89,0.449,28,51,0.549,12,38,0.316,22,24,0.917,114
740,MEM,2022-11-18,121,,OKC,1,240,39,93,0.419,25,54,0.463,14,39,0.359,29,40,0.725,121,45,96,0.469,34,62,0.548,11,34,0.324,9,11,0.818,110
741,DET,2022-11-18,121,@,LAL,0,240,43,92,0.467,32,58,0.552,11,34,0.324,24,32,0.75,121,43,78,0.551,36,58,0.621,7,20,0.35,35,40,0.875,128
742,OKC,2022-11-16,121,@,WAS,1,240,44,81,0.543,28,50,0.56,16,31,0.516,17,26,0.654,121,44,86,0.512,27,52,0.519,17,34,0.5,15,17,0.882,120
743,BRK,2022-11-15,121,@,SAC,0,240,40,81,0.494,29,53,0.547,11,28,0.393,30,33,0.909,121,56,94,0.596,36,53,0.679,20,41,0.488,21,25,0.84,153
744,ATL,2022-11-14,121,@,MIL,1,240,44,92,0.478,37,72,0.514,7,20,0.35,26,30,0.867,121,34,82,0.415,28,53,0.528,6,29,0.207,32,41,0.78,106
745,WAS,2022-11-12,121,,UTA,1,240,44,88,0.5,28,52,0.538,16,36,0.444,17,20,0.85,121,44,94,0.468,30,54,0.556,14,40,0.35,10,11,0.909,112
746,PHI,2022-11-12,121,,ATL,1,240,44,80,0.55,36,56,0.643,8,24,0.333,25,31,0.806,121,40,89,0.449,34,65,0.523,6,24,0.25,23,27,0.852,109
747,NYK,2022-11-11,121,,DET,1,240,42,94,0.447,32,54,0.593,10,40,0.25,27,29,0.931,121,37,80,0.463,30,49,0.612,7,31,0.226,31,41,0.756,112
748,NOP,2022-11-05,121,@,ATL,0,265,47,108,0.435,40,85,0.471,7,23,0.304,20,28,0.714,121,47,103,0.456,38,67,0.567,9,36,0.25,21,25,0.84,124
749,WAS,2022-11-02,121,@,PHI,1,240,45,78,0.577,40,57,0.702,5,21,0.238,26,32,0.813,121,39,84,0.464,20,48,0.417,19,36,0.528,14,20,0.7,111
750,UTA,2022-10-31,121,,MEM,1,240,42,89,0.472,23,42,0.548,19,47,0.404,18,22,0.818,121,38,92,0.413,32,66,0.485,6,26,0.231,23,42,0.548,105
751,LAL,2022-10-30,121,,DEN,1,240,46,96,0.479,33,66,0.5,13,30,0.433,16,20,0.8,121,41,96,0.427,26,56,0.464,15,40,0.375,13,18,0.722,110
752,CLE,2022-10-30,121,,NYK,1,240,41,89,0.461,18,39,0.462,23,50,0.46,16,19,0.842,121,45,92,0.489,35,65,0.538,10,27,0.37,8,16,0.5,108
753,NOP,2022-10-23,121,,UTA,0,265,48,102,0.471,40,75,0.533,8,27,0.296,17,22,0.773,121,43,98,0.439,30,60,0.5,13,38,0.342,23,28,0.821,122
754,BOS,2023-04-09,120,,ATL,1,240,42,89,0.472,17,35,0.486,25,54,0.463,11,14,0.786,120,44,97,0.454,33,58,0.569,11,39,0.282,15,19,0.789,114
755,TOR,2023-04-04,120,@,CHO,1,240,42,88,0.477,27,55,0.491,15,33,0.455,21,28,0.75,120,36,77,0.468,24,46,0.522,12,31,0.387,16,19,0.842,100
756,SAC,2023-03-29,120,@,POR,1,240,42,92,0.457,24,44,0.545,18,48,0.375,18,24,0.75,120,30,93,0.323,21,54,0.389,9,39,0.231,11,12,0.917,80
757,GSW,2023-03-28,120,,NOP,1,240,43,82,0.524,25,42,0.595,18,40,0.45,16,22,0.727,120,42,90,0.467,30,63,0.476,12,27,0.444,13,14,0.929,109
758,ATL,2023-03-28,120,,CLE,1,240,41,89,0.461,29,62,0.468,12,27,0.444,26,33,0.788,120,47,93,0.505,38,68,0.559,9,25,0.36,15,22,0.682,118
759,GSW,2023-03-24,120,,PHI,1,240,42,88,0.477,24,38,0.632,18,50,0.36,18,24,0.75,120,38,78,0.487,30,49,0.612,8,29,0.276,28,34,0.824,112
760,BOS,2023-03-24,120,,IND,1,240,44,93,0.473,26,51,0.51,18,42,0.429,14,19,0.737,120,39,84,0.464,35,58,0.603,4,26,0.154,13,22,0.591,95
761,NYK,2023-03-22,120,@,MIA,0,240,42,82,0.512,26,42,0.619,16,40,0.4,20,25,0.8,120,45,79,0.57,29,51,0.569,16,28,0.571,21,26,0.808,127
762,SAC,2023-03-20,120,@,UTA,0,240,41,97,0.423,22,45,0.489,19,52,0.365,19,25,0.76,120,46,88,0.523,30,52,0.577,16,36,0.444,20,23,0.87,128
763,PHO,2023-03-19,120,@,OKC,0,240,44,92,0.478,29,56,0.518,15,36,0.417,17,24,0.708,120,42,84,0.5,31,56,0.554,11,28,0.393,29,36,0.806,124
764,SAS,2023-03-17,120,,MEM,0,265,39,98,0.398,19,46,0.413,20,52,0.385,22,29,0.759,120,49,101,0.485,35,63,0.556,14,38,0.368,14,21,0.667,126
765,CLE,2023-03-14,120,@,CHO,1,240,45,88,0.511,31,58,0.534,14,30,0.467,16,19,0.842,120,43,76,0.566,37,53,0.698,6,23,0.261,12,15,0.8,104
766,DEN,2023-03-12,120,,BRK,0,240,45,90,0.5,33,59,0.559,12,31,0.387,18,24,0.75,120,42,84,0.5,25,40,0.625,17,44,0.386,21,24,0.875,122
767,DEN,2023-03-10,120,@,SAS,0,240,44,90,0.489,31,55,0.564,13,35,0.371,19,20,0.95,120,51,94,0.543,38,61,0.623,13,33,0.394,13,17,0.765,128
768,PHI,2023-03-10,120,,POR,1,240,43,83,0.518,32,53,0.604,11,30,0.367,23,29,0.793,120,42,80,0.525,27,44,0.614,15,36,0.417,20,30,0.667,119
769,WAS,2023-03-08,120,,ATL,0,240,47,83,0.566,35,54,0.648,12,29,0.414,14,17,0.824,120,45,85,0.529,33,56,0.589,12,29,0.414,20,26,0.769,122
770,DAL,2023-03-07,120,,UTA,1,240,42,89,0.472,23,44,0.523,19,45,0.422,17,22,0.773,120,41,92,0.446,26,48,0.542,15,44,0.341,19,25,0.76,116
771,MIA,2023-03-03,120,,NYK,0,240,39,81,0.481,27,56,0.482,12,25,0.48,30,32,0.938,120,47,81,0.58,30,40,0.75,17,41,0.415,11,17,0.647,122
772,UTA,2023-02-23,120,,OKC,1,265,42,100,0.42,29,52,0.558,13,48,0.271,23,27,0.852,120,45,112,0.402,37,75,0.493,8,37,0.216,21,27,0.778,119
773,LAL,2023-02-15,120,,NOP,1,240,44,83,0.53,34,46,0.739,10,37,0.27,22,36,0.611,120,39,89,0.438,32,64,0.5,7,25,0.28,17,24,0.708,102
774,CHO,2023-02-15,120,,SAS,1,240,43,96,0.448,29,61,0.475,14,35,0.4,20,29,0.69,120,41,107,0.383,28,69,0.406,13,38,0.342,15,20,0.75,110
775,PHO,2023-02-14,120,,SAC,1,240,50,88,0.568,43,66,0.652,7,22,0.318,13,16,0.813,120,37,83,0.446,23,45,0.511,14,38,0.368,21,24,0.875,109
776,UTA,2023-02-11,120,@,NYK,0,240,45,88,0.511,36,56,0.643,9,32,0.281,21,28,0.75,120,43,95,0.453,31,59,0.525,12,36,0.333,28,38,0.737,126
777,HOU,2023-02-06,120,,SAC,0,240,44,88,0.5,31,56,0.554,13,32,0.406,19,24,0.792,120,52,89,0.584,31,48,0.646,21,41,0.512,15,18,0.833,140
778,MIN,2023-02-03,120,,ORL,0,240,40,87,0.46,24,43,0.558,16,44,0.364,24,28,0.857,120,45,85,0.529,33,62,0.532,12,23,0.522,25,38,0.658,127
779,OKC,2023-01-30,120,,GSW,0,240,46,93,0.495,35,69,0.507,11,24,0.458,17,20,0.85,120,46,90,0.511,26,43,0.605,20,47,0.426,16,20,0.8,128
780,LAC,2023-01-28,120,@,ATL,1,240,42,80,0.525,23,41,0.561,19,39,0.487,17,19,0.895,120,45,95,0.474,38,68,0.559,7,27,0.259,16,20,0.8,113
781,NYK,2023-01-26,120,@,BOS,1,265,44,96,0.458,31,58,0.534,13,38,0.342,19,23,0.826,120,41,100,0.41,25,54,0.463,16,46,0.348,19,23,0.826,117
782,IND,2023-01-25,120,@,ORL,0,240,41,85,0.482,26,50,0.52,15,35,0.429,23,29,0.793,120,46,82,0.561,31,54,0.574,15,28,0.536,19,25,0.76,126
783,MEM,2023-01-25,120,@,GSW,0,240,42,88,0.477,32,57,0.561,10,31,0.323,26,37,0.703,120,43,85,0.506,29,53,0.547,14,32,0.438,22,28,0.786,122
784,UTA,2023-01-23,120,,CHO,1,240,41,86,0.477,25,46,0.543,16,40,0.4,22,26,0.846,120,38,85,0.447,36,69,0.522,2,16,0.125,24,34,0.706,102
785,BRK,2023-01-22,120,@,GSW,1,240,43,79,0.544,29,52,0.558,14,27,0.519,20,31,0.645,120,41,90,0.456,28,58,0.483,13,32,0.406,21,27,0.778,116
786,GSW,2023-01-20,120,@,CLE,1,240,42,86,0.488,19,43,0.442,23,43,0.535,13,19,0.684,120,42,84,0.5,28,51,0.549,14,33,0.424,16,19,0.842,114
787,PHI,2023-01-17,120,@,LAC,1,240,39,73,0.534,26,42,0.619,13,31,0.419,29,34,0.853,120,41,82,0.5,29,48,0.604,12,34,0.353,16,20,0.8,110
788,CHO,2023-01-10,120,@,TOR,0,240,47,86,0.547,32,51,0.627,15,35,0.429,11,15,0.733,120,45,91,0.495,25,47,0.532,20,44,0.455,22,27,0.815,132
789,OKC,2023-01-08,120,,DAL,1,240,46,95,0.484,34,67,0.507,12,28,0.429,16,20,0.8,120,31,73,0.425,17,34,0.5,14,39,0.359,33,42,0.786,109
790,ATL,2023-01-04,120,@,SAC,1,240,45,84,0.536,35,54,0.648,10,30,0.333,20,22,0.909,120,41,88,0.466,31,63,0.492,10,25,0.4,25,27,0.926,117
791,PHI,2023-01-02,120,,NOP,1,240,41,86,0.477,26,51,0.51,15,35,0.429,23,28,0.821,120,42,84,0.5,31,55,0.564,11,29,0.379,16,20,0.8,111
792,DEN,2022-12-23,120,,POR,1,240,47,81,0.58,37,60,0.617,10,21,0.476,16,26,0.615,120,39,87,0.448,30,52,0.577,9,35,0.257,20,26,0.769,107
793,UTA,2022-12-22,120,,WAS,1,240,42,86,0.488,26,51,0.51,16,35,0.457,20,21,0.952,120,46,82,0.561,39,61,0.639,7,21,0.333,13,17,0.765,112
794,LAL,2022-12-21,120,@,SAC,0,240,42,84,0.5,31,60,0.517,11,24,0.458,25,30,0.833,120,48,95,0.505,31,48,0.646,17,47,0.362,21,28,0.75,134
795,CHI,2022-12-14,120,,NYK,0,265,46,84,0.548,37,56,0.661,9,28,0.321,19,22,0.864,120,45,91,0.495,27,57,0.474,18,34,0.529,20,25,0.8,128
796,BRK,2022-12-09,120,,ATL,1,240,45,83,0.542,32,53,0.604,13,30,0.433,17,21,0.81,120,46,93,0.495,36,64,0.563,10,29,0.345,14,16,0.875,116
797,POR,2022-12-08,120,,DEN,0,240,44,91,0.484,28,51,0.549,16,40,0.4,16,16,1.0,120,47,91,0.516,35,61,0.574,12,30,0.4,15,22,0.682,121
798,GSW,2022-12-03,120,,HOU,1,240,45,85,0.529,20,33,0.606,25,52,0.481,5,10,0.5,120,40,91,0.44,37,63,0.587,3,28,0.107,18,20,0.9,101
799,MIA,2022-12-02,120,@,BOS,1,265,48,101,0.475,37,66,0.561,11,35,0.314,13,18,0.722,120,40,87,0.46,25,42,0.595,15,45,0.333,21,28,0.75,116
800,DEN,2022-11-30,120,,HOU,1,240,44,83,0.53,27,51,0.529,17,32,0.531,15,20,0.75,120,37,88,0.42,25,47,0.532,12,41,0.293,14,18,0.778,100
801,HOU,2022-11-20,120,,GSW,0,240,41,90,0.456,26,45,0.578,15,45,0.333,23,27,0.852,120,46,86,0.535,22,39,0.564,24,47,0.511,11,15,0.733,127
802,WAS,2022-11-16,120,,OKC,0,240,44,86,0.512,27,52,0.519,17,34,0.5,15,17,0.882,120,44,81,0.543,28,50,0.56,16,31,0.516,17,26,0.654,121
803,SAC,2022-11-11,120,@,LAL,1,240,45,87,0.517,33,51,0.647,12,36,0.333,18,21,0.857,120,42,88,0.477,32,63,0.508,10,25,0.4,20,26,0.769,114
804,CLE,2022-11-09,120,@,SAC,0,240,46,86,0.535,35,60,0.583,11,26,0.423,17,20,0.85,120,40,76,0.526,23,37,0.622,17,39,0.436,30,35,0.857,127
805,NYK,2022-11-07,120,@,MIN,1,240,39,89,0.438,20,41,0.488,19,48,0.396,23,25,0.92,120,38,81,0.469,27,40,0.675,11,41,0.268,20,24,0.833,107
806,LAL,2022-11-02,120,,NOP,1,265,45,98,0.459,35,62,0.565,10,36,0.278,20,23,0.87,120,47,102,0.461,39,77,0.506,8,25,0.32,15,21,0.714,117
807,CHO,2022-10-29,120,,GSW,1,265,43,102,0.422,33,71,0.465,10,31,0.323,24,31,0.774,120,44,100,0.44,31,56,0.554,13,44,0.295,12,16,0.75,113
808,WAS,2022-10-25,120,,DET,1,240,44,85,0.518,34,52,0.654,10,33,0.303,22,26,0.846,120,36,88,0.409,28,60,0.467,8,28,0.286,19,25,0.76,99
809,PHI,2022-10-24,120,,IND,1,240,38,80,0.475,19,37,0.514,19,43,0.442,25,28,0.893,120,38,90,0.422,26,46,0.565,12,44,0.273,18,23,0.783,106
810,CHI,2022-10-24,120,,BOS,1,240,42,87,0.483,32,66,0.485,10,21,0.476,26,29,0.897,120,37,100,0.37,19,52,0.365,18,48,0.375,10,12,0.833,102
811,ORL,2022-10-22,120,,BOS,0,240,45,95,0.474,30,61,0.492,15,34,0.441,15,23,0.652,120,42,87,0.483,23,40,0.575,19,47,0.404,23,28,0.821,126
812,LAC,2023-04-09,119,@,PHO,1,240,49,100,0.49,44,77,0.571,5,23,0.217,16,24,0.667,119,42,99,0.424,28,62,0.452,14,37,0.378,16,22,0.727,114
813,GSW,2023-04-07,119,@,SAC,1,240,41,78,0.526,25,42,0.595,16,36,0.444,21,24,0.875,119,38,98,0.388,27,59,0.458,11,39,0.282,10,18,0.556,97
814,PHO,2023-04-06,119,,DEN,1,240,41,79,0.519,24,43,0.558,17,36,0.472,20,25,0.8,119,44,83,0.53,36,60,0.6,8,23,0.348,19,23,0.826,115
815,SAC,2023-04-05,119,@,DAL,0,240,46,106,0.434,34,69,0.493,12,37,0.324,15,19,0.789,119,44,89,0.494,24,45,0.533,20,44,0.455,15,18,0.833,123
816,MEM,2023-04-04,119,,POR,1,240,42,87,0.483,24,39,0.615,18,48,0.375,17,22,0.773,119,42,97,0.433,28,55,0.509,14,42,0.333,11,17,0.647,109
817,MIN,2023-03-27,119,@,SAC,1,240,44,86,0.512,35,62,0.565,9,24,0.375,22,34,0.647,119,39,84,0.464,34,57,0.596,5,27,0.185,32,40,0.8,115
818,ORL,2023-03-26,119,,BRK,1,240,45,85,0.529,38,63,0.603,7,22,0.318,22,28,0.786,119,37,91,0.407,29,56,0.518,8,35,0.229,24,28,0.857,106
819,ATL,2023-03-26,119,,MEM,0,240,45,98,0.459,38,67,0.567,7,31,0.226,22,26,0.846,119,48,89,0.539,35,56,0.625,13,33,0.394,14,19,0.737,123
820,NOP,2023-03-21,119,,SAS,1,240,45,81,0.556,35,57,0.614,10,24,0.417,19,23,0.826,119,30,87,0.345,17,46,0.37,13,41,0.317,11,19,0.579,84
821,GSW,2023-03-18,119,@,MEM,0,240,39,91,0.429,26,56,0.464,13,35,0.371,28,34,0.824,119,52,95,0.547,34,57,0.596,18,38,0.474,11,17,0.647,133
822,GSW,2023-03-17,119,@,ATL,0,240,47,98,0.48,36,58,0.621,11,40,0.275,14,20,0.7,119,47,100,0.47,31,59,0.525,16,41,0.39,17,25,0.68,127
823,DEN,2023-03-16,119,@,DET,1,240,47,89,0.528,39,65,0.6,8,24,0.333,17,25,0.68,119,39,85,0.459,27,58,0.466,12,27,0.444,10,18,0.556,100
824,MEM,2023-03-15,119,@,MIA,0,240,46,91,0.505,28,45,0.622,18,46,0.391,9,14,0.643,119,49,82,0.598,36,53,0.679,13,29,0.448,27,33,0.818,138
825,MIA,2023-03-13,119,,UTA,1,240,37,79,0.468,23,45,0.511,14,34,0.412,31,36,0.861,119,43,90,0.478,27,52,0.519,16,38,0.421,13,18,0.722,115
826,PHO,2023-03-11,119,,SAC,0,240,44,89,0.494,31,45,0.689,13,44,0.295,18,22,0.818,119,41,85,0.482,26,50,0.52,15,35,0.429,31,37,0.838,128
827,CHI,2023-03-11,119,@,HOU,1,240,44,86,0.512,29,54,0.537,15,32,0.469,16,22,0.727,119,41,85,0.482,25,51,0.49,16,34,0.471,13,17,0.765,111
828,UTA,2023-03-11,119,@,CHO,1,240,46,103,0.447,37,71,0.521,9,32,0.281,18,20,0.9,119,40,98,0.408,23,58,0.397,17,40,0.425,14,15,0.933,111
829,MIA,2023-03-10,119,,CLE,1,240,42,82,0.512,28,53,0.528,14,29,0.483,21,23,0.913,119,40,86,0.465,22,43,0.512,18,43,0.419,17,21,0.81,115
830,POR,2023-03-10,119,@,PHI,0,240,42,80,0.525,27,44,0.614,15,36,0.417,20,30,0.667,119,43,83,0.518,32,53,0.604,11,30,0.367,23,29,0.793,120
831,WAS,2023-03-07,119,@,DET,1,240,47,81,0.58,35,56,0.625,12,25,0.48,13,17,0.765,119,43,84,0.512,30,54,0.556,13,30,0.433,18,22,0.818,117
832,UTA,2023-03-05,119,@,OKC,0,240,43,88,0.489,32,51,0.627,11,37,0.297,22,27,0.815,119,44,87,0.506,30,50,0.6,14,37,0.378,27,33,0.818,129
833,ORL,2023-03-05,119,,POR,0,240,42,84,0.5,31,53,0.585,11,31,0.355,24,31,0.774,119,39,83,0.47,23,36,0.639,16,47,0.34,28,32,0.875,122
834,WAS,2023-03-02,119,,TOR,1,240,43,84,0.512,29,54,0.537,14,30,0.467,19,24,0.792,119,41,92,0.446,32,59,0.542,9,33,0.273,17,17,1.0,108
835,PHI,2023-03-01,119,@,MIA,1,240,41,83,0.494,26,44,0.591,15,39,0.385,22,22,1.0,119,34,78,0.436,27,49,0.551,7,29,0.241,21,23,0.913,96
836,WAS,2023-02-28,119,@,ATL,1,240,48,97,0.495,42,76,0.553,6,21,0.286,17,20,0.85,119,43,93,0.462,30,58,0.517,13,35,0.371,17,19,0.895,116
837,CLE,2023-02-24,119,@,ATL,0,240,40,88,0.455,27,53,0.509,13,35,0.371,26,29,0.897,119,50,85,0.588,35,57,0.614,15,28,0.536,21,23,0.913,136
838,OKC,2023-02-23,119,@,UTA,0,265,45,112,0.402,37,75,0.493,8,37,0.216,21,27,0.778,119,42,100,0.42,29,52,0.558,13,48,0.271,23,27,0.852,120
839,TOR,2023-02-12,119,,DET,1,240,42,87,0.483,31,57,0.544,11,30,0.367,24,36,0.667,119,40,79,0.506,27,45,0.6,13,34,0.382,25,32,0.781,118
840,BOS,2023-02-12,119,,MEM,1,240,39,88,0.443,18,37,0.486,21,51,0.412,20,26,0.769,119,42,84,0.5,30,50,0.6,12,34,0.353,13,21,0.619,109
841,DEN,2023-02-11,119,@,CHO,1,240,50,99,0.505,45,76,0.592,5,23,0.217,14,17,0.824,119,40,85,0.471,32,53,0.604,8,32,0.25,17,29,0.586,105
842,MIL,2023-02-10,119,@,LAC,1,240,45,90,0.5,28,51,0.549,17,39,0.436,12,16,0.75,119,42,85,0.494,31,52,0.596,11,33,0.333,11,14,0.786,106
843,PHI,2023-02-10,119,,NYK,1,240,44,84,0.524,30,46,0.652,14,38,0.368,17,22,0.773,119,43,81,0.531,32,49,0.653,11,32,0.344,11,16,0.688,108
844,ORL,2023-02-05,119,@,CHO,1,240,42,91,0.462,34,68,0.5,8,23,0.348,27,30,0.9,119,45,83,0.542,33,50,0.66,12,33,0.364,11,23,0.478,113
845,GSW,2023-02-04,119,,DAL,1,240,45,82,0.549,31,47,0.66,14,35,0.4,15,19,0.789,119,39,85,0.459,25,45,0.556,14,40,0.35,21,27,0.778,113
846,SAC,2023-02-01,119,@,SAS,1,240,48,90,0.533,40,63,0.635,8,27,0.296,15,19,0.789,119,48,88,0.545,40,64,0.625,8,24,0.333,5,7,0.714,109
847,MIN,2023-02-01,119,,GSW,1,265,46,106,0.434,32,56,0.571,14,50,0.28,13,24,0.542,119,38,91,0.418,27,56,0.482,11,35,0.314,27,34,0.794,114
848,ORL,2023-01-30,119,@,PHI,1,240,42,99,0.424,31,70,0.443,11,29,0.379,24,30,0.8,119,40,85,0.471,29,55,0.527,11,30,0.367,18,23,0.783,109
849,DEN,2023-01-28,119,@,PHI,0,240,44,81,0.543,30,47,0.638,14,34,0.412,17,20,0.85,119,46,89,0.517,28,54,0.519,18,35,0.514,16,24,0.667,126
850,HOU,2023-01-23,119,,MIN,1,240,44,88,0.5,33,58,0.569,11,30,0.367,20,30,0.667,119,41,91,0.451,25,49,0.51,16,42,0.381,16,22,0.727,114
851,IND,2023-01-16,119,@,MIL,0,240,43,84,0.512,24,44,0.545,19,40,0.475,14,15,0.933,119,48,91,0.527,25,45,0.556,23,46,0.5,13,15,0.867,132
852,SAS,2023-01-15,119,,SAC,0,240,48,93,0.516,38,67,0.567,10,26,0.385,13,20,0.65,119,49,89,0.551,35,59,0.593,14,30,0.467,20,25,0.8,132
853,DEN,2023-01-15,119,,ORL,1,240,48,89,0.539,35,50,0.7,13,39,0.333,10,19,0.526,119,41,84,0.488,34,55,0.618,7,29,0.241,27,34,0.794,116
854,DAL,2023-01-14,119,@,POR,0,240,43,82,0.524,21,36,0.583,22,46,0.478,11,19,0.579,119,49,88,0.557,32,47,0.681,17,41,0.415,21,22,0.955,136
855,CLE,2023-01-12,119,@,POR,1,240,44,89,0.494,37,67,0.552,7,22,0.318,24,31,0.774,119,40,78,0.513,29,45,0.644,11,33,0.333,22,29,0.759,113
856,DAL,2023-01-12,119,@,LAL,1,290,48,96,0.5,34,54,0.63,14,42,0.333,9,17,0.529,119,44,112,0.393,34,71,0.479,10,41,0.244,17,27,0.63,115
857,NYK,2023-01-11,119,,IND,1,240,38,84,0.452,23,42,0.548,15,42,0.357,28,33,0.848,119,43,90,0.478,31,51,0.608,12,39,0.308,15,21,0.714,113
858,NOP,2023-01-04,119,,HOU,1,240,41,89,0.461,27,51,0.529,14,38,0.368,23,26,0.885,119,39,88,0.443,27,50,0.54,12,38,0.316,18,27,0.667,108
859,GSW,2023-01-04,119,,DET,0,240,45,87,0.517,30,47,0.638,15,40,0.375,14,15,0.933,119,45,92,0.489,29,56,0.518,16,36,0.444,16,23,0.696,122
860,MIA,2022-12-30,119,@,DEN,0,240,39,87,0.448,25,52,0.481,14,35,0.4,27,30,0.9,119,45,76,0.592,28,48,0.583,17,28,0.607,17,22,0.773,124
861,WAS,2022-12-30,119,@,ORL,1,240,42,75,0.56,27,40,0.675,15,35,0.429,20,25,0.8,119,42,100,0.42,37,73,0.507,5,27,0.185,11,16,0.688,100
862,MEM,2022-12-29,119,@,TOR,1,240,48,95,0.505,35,66,0.53,13,29,0.448,10,14,0.714,119,39,96,0.406,29,68,0.426,10,28,0.357,18,24,0.75,106
863,CHI,2022-12-28,119,,MIL,1,265,42,92,0.457,33,69,0.478,9,23,0.391,26,30,0.867,119,41,110,0.373,32,66,0.485,9,44,0.205,22,32,0.688,113
864,NOP,2022-12-28,119,,MIN,1,240,39,81,0.481,28,58,0.483,11,23,0.478,30,43,0.698,119,42,83,0.506,32,54,0.593,10,29,0.345,24,32,0.75,118
865,PHI,2022-12-25,119,@,NYK,1,240,39,77,0.506,21,38,0.553,18,39,0.462,23,29,0.793,119,43,90,0.478,31,58,0.534,12,32,0.375,14,17,0.824,112
866,PHI,2022-12-23,119,,LAC,1,240,47,88,0.534,35,59,0.593,12,29,0.414,13,14,0.929,119,41,81,0.506,27,43,0.628,14,38,0.368,18,23,0.783,114
867,NOP,2022-12-19,119,,MIL,0,240,42,99,0.424,24,54,0.444,18,45,0.4,17,24,0.708,119,45,81,0.556,32,41,0.78,13,40,0.325,25,31,0.806,128
868,SAC,2022-12-19,119,,CHO,0,240,45,95,0.474,33,62,0.532,12,33,0.364,17,31,0.548,119,49,95,0.516,39,64,0.609,10,31,0.323,17,23,0.739,125
869,LAL,2022-12-18,119,,WAS,1,240,46,92,0.5,35,65,0.538,11,27,0.407,16,22,0.727,119,44,95,0.463,34,56,0.607,10,39,0.256,19,24,0.792,117
870,DEN,2022-12-18,119,,CHO,1,240,43,94,0.457,32,61,0.525,11,33,0.333,22,34,0.647,119,41,96,0.427,29,58,0.5,12,38,0.316,21,23,0.913,115
871,BRK,2022-12-16,119,@,TOR,1,240,46,76,0.605,37,50,0.74,9,26,0.346,18,23,0.783,119,41,84,0.488,32,60,0.533,9,24,0.375,25,29,0.862,116
872,GSW,2022-12-14,119,@,IND,0,240,40,86,0.465,26,53,0.491,14,33,0.424,25,29,0.862,119,44,87,0.506,28,48,0.583,16,39,0.41,21,25,0.84,125
873,LAC,2022-12-05,119,@,CHO,1,240,45,93,0.484,30,57,0.526,15,36,0.417,14,21,0.667,119,47,98,0.48,35,64,0.547,12,34,0.353,11,17,0.647,117
874,WAS,2022-12-04,119,,LAL,0,240,49,105,0.467,39,66,0.591,10,39,0.256,11,15,0.733,119,52,96,0.542,42,70,0.6,10,26,0.385,16,22,0.727,130
875,IND,2022-12-02,119,@,UTA,0,240,40,92,0.435,28,58,0.483,12,34,0.353,27,33,0.818,119,46,83,0.554,31,49,0.633,15,34,0.441,32,37,0.865,139
876,GSW,2022-12-02,119,,CHI,1,240,42,87,0.483,22,37,0.595,20,50,0.4,15,23,0.652,119,43,93,0.462,34,66,0.515,9,27,0.333,16,24,0.667,111
877,OKC,2022-11-30,119,,SAS,1,240,48,94,0.511,39,67,0.582,9,27,0.333,14,21,0.667,119,41,92,0.446,31,55,0.564,10,37,0.27,19,25,0.76,111
878,CHI,2022-11-25,119,@,OKC,0,265,44,101,0.436,32,68,0.471,12,33,0.364,19,23,0.826,119,44,95,0.463,37,66,0.561,7,29,0.241,28,32,0.875,123
879,OKC,2022-11-21,119,,NYK,0,240,43,88,0.489,35,64,0.547,8,24,0.333,25,32,0.781,119,51,97,0.526,40,63,0.635,11,34,0.324,16,20,0.8,129
880,MIL,2022-11-21,119,,POR,1,240,47,86,0.547,38,58,0.655,9,28,0.321,16,25,0.64,119,44,93,0.473,36,64,0.563,8,29,0.276,15,19,0.789,111
881,LAC,2022-11-19,119,,SAS,1,240,44,81,0.543,23,41,0.561,21,40,0.525,10,19,0.526,119,36,87,0.414,29,61,0.475,7,26,0.269,18,21,0.857,97
882,GSW,2022-11-16,119,@,PHO,0,240,42,92,0.457,24,50,0.48,18,42,0.429,17,17,1.0,119,44,86,0.512,23,46,0.5,21,40,0.525,21,25,0.84,130
883,NOP,2022-11-12,119,,HOU,1,240,42,86,0.488,34,57,0.596,8,29,0.276,27,31,0.871,119,40,79,0.506,28,43,0.651,12,36,0.333,14,18,0.778,106
884,ATL,2022-11-09,119,,UTA,0,240,51,109,0.468,43,81,0.531,8,28,0.286,9,11,0.818,119,44,94,0.468,27,55,0.491,17,39,0.436,20,24,0.833,125
885,IND,2022-11-09,119,,DEN,0,240,45,96,0.469,31,54,0.574,14,42,0.333,15,19,0.789,119,43,88,0.489,31,60,0.517,12,28,0.429,24,26,0.923,122
886,LAC,2022-11-07,119,,CLE,1,240,40,79,0.506,23,41,0.561,17,38,0.447,22,28,0.786,119,43,83,0.518,27,50,0.54,16,33,0.485,15,21,0.714,117
887,CHI,2022-11-04,119,@,BOS,0,240,43,83,0.518,32,55,0.582,11,28,0.393,22,25,0.88,119,41,83,0.494,32,52,0.615,9,31,0.29,32,39,0.821,123
888,SAC,2022-10-29,119,,MIA,1,240,42,76,0.553,28,45,0.622,14,31,0.452,21,29,0.724,119,38,89,0.427,27,61,0.443,11,28,0.393,26,31,0.839,113
889,MIL,2022-10-28,119,,NYK,1,240,42,109,0.385,29,64,0.453,13,45,0.289,22,27,0.815,119,37,93,0.398,25,58,0.431,12,35,0.343,22,32,0.688,108
890,TOR,2022-10-26,119,,PHI,1,240,46,84,0.548,30,47,0.638,16,37,0.432,11,14,0.786,119,40,79,0.506,24,43,0.558,16,36,0.444,13,19,0.684,109
891,MIA,2022-10-26,119,@,POR,1,240,44,87,0.506,29,49,0.592,15,38,0.395,16,19,0.842,119,34,78,0.436,22,41,0.537,12,37,0.324,18,26,0.692,98
892,UTA,2023-04-08,118,,DEN,1,240,44,100,0.44,33,65,0.508,11,35,0.314,19,23,0.826,118,41,90,0.456,26,44,0.591,15,46,0.326,17,24,0.708,114
893,CLE,2023-04-06,118,@,ORL,1,240,46,88,0.523,28,50,0.56,18,38,0.474,8,9,0.889,118,33,83,0.398,20,44,0.455,13,39,0.333,15,19,0.789,94
894,LAL,2023-04-05,118,@,LAC,0,240,45,89,0.506,33,60,0.55,12,29,0.414,16,24,0.667,118,43,82,0.524,27,46,0.587,16,36,0.444,23,27,0.852,125
895,MIA,2023-04-04,118,@,DET,1,240,41,80,0.513,28,44,0.636,13,36,0.361,23,26,0.885,118,36,73,0.493,25,45,0.556,11,28,0.393,22,27,0.815,105
896,NYK,2023-04-02,118,,WAS,1,240,46,88,0.523,33,56,0.589,13,32,0.406,13,18,0.722,118,39,79,0.494,23,42,0.548,16,37,0.432,15,18,0.833,109
897,OKC,2023-04-02,118,,PHO,0,240,36,88,0.409,25,56,0.446,11,32,0.344,35,41,0.854,118,46,81,0.568,33,47,0.702,13,34,0.382,23,28,0.821,128
898,CLE,2023-03-28,118,@,ATL,0,240,47,93,0.505,38,68,0.559,9,25,0.36,15,22,0.682,118,41,89,0.461,29,62,0.468,12,27,0.444,26,33,0.788,120
899,OKC,2023-03-26,118,@,POR,1,240,41,94,0.436,29,59,0.492,12,35,0.343,24,28,0.857,118,39,82,0.476,25,50,0.5,14,32,0.438,20,27,0.741,112
900,CHI,2023-03-26,118,@,LAL,1,240,47,87,0.54,33,56,0.589,14,31,0.452,10,13,0.769,118,38,75,0.507,25,39,0.641,13,36,0.361,19,28,0.679,108
901,TOR,2023-03-24,118,,DET,1,240,41,92,0.446,28,55,0.509,13,37,0.351,23,29,0.793,118,34,73,0.466,28,48,0.583,6,25,0.24,23,30,0.767,97
902,DEN,2023-03-22,118,@,WAS,1,240,42,83,0.506,27,51,0.529,15,32,0.469,19,21,0.905,118,44,87,0.506,40,61,0.656,4,26,0.154,12,16,0.75,104
903,IND,2023-03-22,118,@,TOR,1,240,43,77,0.558,32,56,0.571,11,21,0.524,21,25,0.84,118,39,89,0.438,32,55,0.582,7,34,0.206,29,39,0.744,114
904,ATL,2023-03-19,118,@,SAS,0,240,48,101,0.475,43,79,0.544,5,22,0.227,17,20,0.85,118,51,94,0.543,37,66,0.561,14,28,0.5,10,16,0.625,126
905,MIL,2023-03-19,118,,TOR,1,240,43,82,0.524,27,37,0.73,16,45,0.356,16,21,0.762,118,44,99,0.444,30,65,0.462,14,34,0.412,9,12,0.75,111
906,UTA,2023-03-18,118,,BOS,1,240,42,97,0.433,25,56,0.446,17,41,0.415,17,22,0.773,118,42,88,0.477,20,37,0.541,22,51,0.431,11,16,0.688,117
907,WAS,2023-03-18,118,,SAC,0,240,41,91,0.451,28,55,0.509,13,36,0.361,23,27,0.852,118,48,86,0.558,26,49,0.531,22,37,0.595,14,23,0.609,132
908,PHI,2023-03-15,118,@,CLE,1,240,39,75,0.52,22,39,0.564,17,36,0.472,23,27,0.852,118,40,85,0.471,26,44,0.591,14,41,0.341,15,22,0.682,109
909,MIL,2023-03-09,118,,BRK,1,240,44,104,0.423,25,54,0.463,19,50,0.38,11,14,0.786,118,41,104,0.394,27,68,0.397,14,36,0.389,17,17,1.0,113
910,BRK,2023-03-07,118,@,HOU,1,240,40,81,0.494,25,41,0.61,15,40,0.375,23,29,0.793,118,36,83,0.434,29,57,0.509,7,26,0.269,17,24,0.708,96
911,DEN,2023-03-06,118,,TOR,1,240,43,86,0.5,30,53,0.566,13,33,0.394,19,23,0.826,118,43,86,0.5,33,59,0.559,10,27,0.37,17,20,0.85,113
912,CLE,2023-03-06,118,,BOS,1,265,43,96,0.448,31,62,0.5,12,34,0.353,20,25,0.8,118,42,101,0.416,26,53,0.491,16,48,0.333,14,21,0.667,114
913,BRK,2023-03-01,118,@,NYK,0,240,42,90,0.467,27,51,0.529,15,39,0.385,19,20,0.95,118,54,89,0.607,34,54,0.63,20,35,0.571,14,21,0.667,142
914,MIL,2023-02-28,118,@,BRK,1,240,50,102,0.49,36,65,0.554,14,37,0.378,4,12,0.333,118,36,83,0.434,24,47,0.511,12,36,0.333,20,25,0.8,104
915,CLE,2023-02-26,118,,TOR,1,240,44,84,0.524,26,48,0.542,18,36,0.5,12,14,0.857,118,36,93,0.387,27,68,0.397,9,25,0.36,12,15,0.8,93
916,UTA,2023-02-25,118,,SAS,1,240,43,92,0.467,33,64,0.516,10,28,0.357,22,28,0.786,118,38,97,0.392,29,63,0.46,9,34,0.265,17,21,0.81,102
917,PHI,2023-02-15,118,,CLE,1,240,39,78,0.5,26,51,0.51,13,27,0.481,27,29,0.931,118,41,82,0.5,31,52,0.596,10,30,0.333,20,25,0.8,112
918,DEN,2023-02-15,118,,DAL,1,240,48,84,0.571,37,53,0.698,11,31,0.355,11,15,0.733,118,39,84,0.464,25,45,0.556,14,39,0.359,17,20,0.85,109
919,DET,2023-02-12,118,@,TOR,0,240,40,79,0.506,27,45,0.6,13,34,0.382,25,32,0.781,118,42,87,0.483,31,57,0.544,11,30,0.367,24,36,0.667,119
920,CLE,2023-02-10,118,@,NOP,1,240,48,85,0.565,38,57,0.667,10,28,0.357,12,15,0.8,118,39,82,0.476,30,58,0.517,9,24,0.375,20,25,0.8,107
921,UTA,2023-02-08,118,,MIN,0,240,44,105,0.419,32,71,0.451,12,34,0.353,18,21,0.857,118,56,98,0.571,33,55,0.6,23,43,0.535,8,8,1.0,143
922,WAS,2023-02-08,118,,CHO,1,240,44,87,0.506,29,50,0.58,15,37,0.405,15,17,0.882,118,39,93,0.419,30,62,0.484,9,31,0.29,17,21,0.81,104
923,DET,2023-02-03,118,,CHO,1,240,44,86,0.512,30,54,0.556,14,32,0.438,16,23,0.696,118,40,90,0.444,31,56,0.554,9,34,0.265,23,30,0.767,112
924,SAC,2023-01-30,118,@,MIN,1,265,47,99,0.475,38,69,0.551,9,30,0.3,15,22,0.682,118,43,92,0.467,31,53,0.585,12,39,0.308,13,25,0.52,111
925,SAS,2023-01-28,118,,PHO,0,265,48,109,0.44,38,80,0.475,10,29,0.345,12,17,0.706,118,50,103,0.485,42,79,0.532,8,24,0.333,20,26,0.769,128
926,ATL,2023-01-21,118,,CHO,0,240,45,83,0.542,34,58,0.586,11,25,0.44,17,20,0.85,118,45,89,0.506,32,55,0.582,13,34,0.382,19,22,0.864,122
927,ORL,2023-01-21,118,@,WAS,0,240,42,90,0.467,28,56,0.5,14,34,0.412,20,24,0.833,118,51,95,0.537,33,61,0.541,18,34,0.529,18,25,0.72,138
928,SAC,2023-01-20,118,,OKC,1,240,41,87,0.471,29,49,0.592,12,38,0.316,24,28,0.857,118,45,93,0.484,29,53,0.547,16,40,0.4,7,11,0.636,113
929,GSW,2023-01-19,118,@,BOS,0,265,40,100,0.4,22,48,0.458,18,52,0.346,20,23,0.87,118,43,108,0.398,30,67,0.448,13,41,0.317,22,30,0.733,121
930,MIN,2023-01-18,118,@,DEN,0,240,42,81,0.519,30,49,0.612,12,32,0.375,22,28,0.786,118,45,85,0.529,37,64,0.578,8,21,0.381,24,32,0.75,122
931,WAS,2023-01-16,118,,GSW,0,240,42,86,0.488,28,51,0.549,14,35,0.4,20,23,0.87,118,45,91,0.495,27,47,0.574,18,44,0.409,19,21,0.905,127
932,CHO,2023-01-16,118,,BOS,0,240,41,90,0.456,28,59,0.475,13,31,0.419,23,30,0.767,118,43,87,0.494,23,44,0.523,20,43,0.465,24,25,0.96,130
933,GSW,2023-01-15,118,@,CHI,0,240,41,83,0.494,20,32,0.625,21,51,0.412,15,22,0.682,118,48,95,0.505,33,56,0.589,15,39,0.385,21,24,0.875,132
934,PHI,2023-01-14,118,@,UTA,1,240,40,89,0.449,23,50,0.46,17,39,0.436,21,26,0.808,118,43,90,0.478,31,50,0.62,12,40,0.3,19,23,0.826,117
935,MIN,2023-01-11,118,@,DET,0,240,43,88,0.489,27,55,0.491,16,33,0.485,16,21,0.762,118,48,80,0.6,31,48,0.646,17,32,0.531,22,28,0.786,135
936,UTA,2023-01-08,118,@,MEM,0,240,45,88,0.511,35,56,0.625,10,32,0.313,18,22,0.818,118,46,102,0.451,31,64,0.484,15,38,0.395,16,22,0.727,123
937,UTA,2023-01-07,118,@,CHI,0,240,46,93,0.495,34,52,0.654,12,41,0.293,14,18,0.778,118,44,83,0.53,31,55,0.564,13,28,0.464,25,32,0.781,126
938,MEM,2023-01-01,118,,SAC,1,240,46,100,0.46,36,68,0.529,10,32,0.313,16,24,0.667,118,39,96,0.406,24,53,0.453,15,43,0.349,15,15,1.0,108
939,WAS,2023-01-01,118,@,MIL,1,240,50,94,0.532,43,67,0.642,7,27,0.259,11,16,0.688,118,34,96,0.354,21,47,0.447,13,49,0.265,14,15,0.933,95
940,GSW,2022-12-30,118,,POR,1,240,42,91,0.462,25,48,0.521,17,43,0.395,17,21,0.81,118,42,91,0.462,30,52,0.577,12,39,0.308,16,23,0.696,112
941,DET,2022-12-30,118,@,CHI,0,240,41,86,0.477,24,47,0.511,17,39,0.436,19,24,0.792,118,53,92,0.576,41,65,0.631,12,27,0.444,14,15,0.933,132
942,MIN,2022-12-28,118,@,NOP,0,240,42,83,0.506,32,54,0.593,10,29,0.345,24,32,0.75,118,39,81,0.481,28,58,0.483,11,23,0.478,30,43,0.698,119
943,CHI,2022-12-26,118,,HOU,0,240,45,92,0.489,32,57,0.561,13,35,0.371,15,21,0.714,118,50,90,0.556,33,46,0.717,17,44,0.386,16,22,0.727,133
944,MIL,2022-12-25,118,@,BOS,0,240,42,84,0.5,29,48,0.604,13,36,0.361,21,27,0.778,118,50,85,0.588,31,46,0.674,19,39,0.487,20,25,0.8,139
945,TOR,2022-12-23,118,@,CLE,1,240,42,84,0.5,23,47,0.489,19,37,0.514,15,18,0.833,118,39,76,0.513,28,43,0.651,11,33,0.333,18,30,0.6,107
946,CHI,2022-12-23,118,@,NYK,1,240,45,93,0.484,31,62,0.5,14,31,0.452,14,18,0.778,118,43,86,0.5,27,51,0.529,16,35,0.457,15,26,0.577,117
947,BRK,2022-12-23,118,,MIL,1,240,46,93,0.495,32,61,0.525,14,32,0.438,12,13,0.923,118,37,84,0.44,28,47,0.596,9,37,0.243,17,22,0.773,100
948,PHO,2022-12-17,118,,NOP,1,240,39,83,0.47,24,42,0.571,15,41,0.366,25,35,0.714,118,45,77,0.584,31,47,0.66,14,30,0.467,10,13,0.769,114
949,PHI,2022-12-16,118,,GSW,1,240,39,85,0.459,24,47,0.511,15,38,0.395,25,31,0.806,118,39,94,0.415,22,51,0.431,17,43,0.395,11,13,0.846,106
950,CLE,2022-12-16,118,,IND,1,240,38,76,0.5,24,45,0.533,14,31,0.452,28,32,0.875,118,42,80,0.525,31,44,0.705,11,36,0.306,17,19,0.895,112
951,LAL,2022-12-13,118,,BOS,0,265,44,93,0.473,36,64,0.563,8,29,0.276,22,30,0.733,118,46,104,0.442,27,56,0.482,19,48,0.396,11,16,0.688,122
952,MIN,2022-12-10,118,@,POR,0,240,45,83,0.542,35,60,0.583,10,23,0.435,18,24,0.75,118,43,83,0.518,30,49,0.612,13,34,0.382,25,28,0.893,124
953,MIN,2022-12-09,118,@,UTA,1,240,42,79,0.532,28,44,0.636,14,35,0.4,20,26,0.769,118,39,90,0.433,26,46,0.565,13,44,0.295,17,24,0.708,108
954,SAS,2022-12-08,118,,HOU,1,240,46,83,0.554,33,47,0.702,13,36,0.361,13,15,0.867,118,44,98,0.449,34,69,0.493,10,29,0.345,11,15,0.733,109
955,LAC,2022-11-29,118,@,POR,1,240,41,89,0.461,28,58,0.483,13,31,0.419,23,28,0.821,118,42,90,0.467,25,55,0.455,17,35,0.486,11,15,0.733,112
956,HOU,2022-11-26,118,,OKC,1,240,45,86,0.523,27,50,0.54,18,36,0.5,10,14,0.714,118,38,97,0.392,28,53,0.528,10,44,0.227,19,23,0.826,105
957,UTA,2022-11-25,118,@,GSW,0,240,46,97,0.474,35,52,0.673,11,45,0.244,15,17,0.882,118,52,101,0.515,32,56,0.571,20,45,0.444,5,6,0.833,129
958,CHI,2022-11-23,118,@,MIL,1,240,43,87,0.494,25,45,0.556,18,42,0.429,14,18,0.778,118,41,90,0.456,29,52,0.558,12,38,0.316,19,25,0.76,113
959,UTA,2022-11-19,118,@,POR,1,240,42,91,0.462,28,52,0.538,14,39,0.359,20,23,0.87,118,39,83,0.47,26,41,0.634,13,42,0.31,22,27,0.815,113
960,NYK,2022-11-15,118,@,UTA,1,240,44,93,0.473,33,61,0.541,11,32,0.344,19,25,0.76,118,36,83,0.434,22,40,0.55,14,43,0.326,25,30,0.833,111
961,IND,2022-11-12,118,,TOR,1,240,41,82,0.5,22,39,0.564,19,43,0.442,17,23,0.739,118,37,94,0.394,30,59,0.508,7,35,0.2,23,29,0.793,104
962,NYK,2022-11-05,118,,BOS,0,240,46,90,0.511,35,63,0.556,11,27,0.407,15,16,0.938,118,47,88,0.534,20,37,0.541,27,51,0.529,12,12,1.0,133
963,PHI,2022-10-31,118,@,WAS,1,240,46,83,0.554,34,53,0.642,12,30,0.4,14,20,0.7,118,38,81,0.469,28,56,0.5,10,25,0.4,25,26,0.962,111
964,OKC,2022-10-27,118,,LAC,1,240,47,95,0.495,30,57,0.526,17,38,0.447,7,8,0.875,118,44,82,0.537,35,54,0.648,9,28,0.321,13,18,0.722,110
965,ATL,2022-10-26,118,@,DET,1,240,45,91,0.495,37,69,0.536,8,22,0.364,20,25,0.8,118,42,91,0.462,28,59,0.475,14,32,0.438,15,22,0.682,113
966,DAL,2023-04-09,117,,SAS,0,240,46,108,0.426,29,55,0.527,17,53,0.321,8,16,0.5,117,51,104,0.49,36,66,0.545,15,38,0.395,21,30,0.7,138
967,UTA,2023-04-09,117,@,LAL,0,240,51,101,0.505,41,66,0.621,10,35,0.286,5,6,0.833,117,47,97,0.485,29,52,0.558,18,45,0.4,16,21,0.762,128
968,CLE,2023-04-04,117,@,ORL,1,240,42,84,0.5,27,53,0.509,15,31,0.484,18,20,0.9,117,45,89,0.506,35,66,0.53,10,23,0.435,13,17,0.765,113
969,MIL,2023-04-02,117,,PHI,1,240,46,80,0.575,36,52,0.692,10,28,0.357,15,21,0.714,117,40,87,0.46,28,51,0.549,12,36,0.333,12,13,0.923,104
970,OKC,2023-03-31,117,@,IND,0,240,42,88,0.477,38,58,0.655,4,30,0.133,29,34,0.853,117,45,98,0.459,33,57,0.579,12,41,0.293,19,28,0.679,121
971,PHI,2023-03-31,117,,TOR,1,240,41,73,0.562,29,42,0.69,12,31,0.387,23,25,0.92,117,42,84,0.5,34,58,0.586,8,26,0.308,18,23,0.783,110
972,SAS,2023-03-29,117,,UTA,0,240,45,95,0.474,35,60,0.583,10,35,0.286,17,21,0.81,117,49,90,0.544,37,59,0.627,12,31,0.387,18,20,0.9,128
973,PHO,2023-03-27,117,@,UTA,1,240,43,101,0.426,32,65,0.492,11,36,0.306,20,22,0.909,117,38,86,0.442,29,50,0.58,9,36,0.25,18,27,0.667,103
974,DET,2023-03-27,117,,MIL,0,240,41,92,0.446,34,68,0.5,7,24,0.292,28,36,0.778,117,45,95,0.474,31,50,0.62,14,45,0.311,22,26,0.846,126
975,CHO,2023-03-24,117,@,DAL,1,240,43,89,0.483,32,61,0.525,11,28,0.393,20,27,0.741,117,41,84,0.488,32,48,0.667,9,36,0.25,18,24,0.75,109
976,NOP,2023-03-19,117,@,HOU,1,240,42,85,0.494,29,54,0.537,13,31,0.419,20,24,0.833,117,31,76,0.408,22,43,0.512,9,33,0.273,36,38,0.947,107
977,LAC,2023-03-19,117,@,POR,1,240,43,94,0.457,31,66,0.47,12,28,0.429,19,23,0.826,117,37,82,0.451,31,53,0.585,6,29,0.207,22,24,0.917,102
978,BOS,2023-03-18,117,@,UTA,0,240,42,88,0.477,20,37,0.541,22,51,0.431,11,16,0.688,117,42,97,0.433,25,56,0.446,17,41,0.415,17,22,0.773,118
979,CLE,2023-03-17,117,,WAS,1,240,48,87,0.552,44,68,0.647,4,19,0.211,17,22,0.773,117,35,76,0.461,27,53,0.509,8,23,0.348,16,20,0.8,94
980,SAC,2023-03-15,117,@,CHI,1,240,38,78,0.487,20,36,0.556,18,42,0.429,23,29,0.793,117,38,97,0.392,22,55,0.4,16,42,0.381,22,25,0.88,114
981,WAS,2023-03-14,117,,DET,1,240,44,85,0.518,37,53,0.698,7,32,0.219,22,22,1.0,117,38,99,0.384,28,65,0.431,10,34,0.294,11,12,0.917,97
982,DET,2023-03-13,117,,IND,1,240,48,100,0.48,34,64,0.531,14,36,0.389,7,10,0.7,117,36,86,0.419,26,52,0.5,10,34,0.294,15,24,0.625,97
983,NYK,2023-03-09,117,@,SAC,0,240,42,101,0.416,29,51,0.569,13,50,0.26,20,31,0.645,117,44,84,0.524,34,52,0.654,10,32,0.313,24,32,0.75,122
984,CHI,2023-03-08,117,@,DEN,1,240,46,89,0.517,38,65,0.585,8,24,0.333,17,18,0.944,117,37,88,0.42,22,48,0.458,15,40,0.375,7,15,0.467,96
985,PHI,2023-03-07,117,@,MIN,1,240,40,81,0.494,25,56,0.446,15,25,0.6,22,23,0.957,117,34,86,0.395,23,50,0.46,11,36,0.306,15,21,0.714,94
986,DET,2023-03-07,117,,WAS,0,240,43,84,0.512,30,54,0.556,13,30,0.433,18,22,0.818,117,47,81,0.58,35,56,0.625,12,25,0.48,13,17,0.765,119
987,MIL,2023-03-05,117,@,WAS,1,240,39,83,0.47,17,34,0.5,22,49,0.449,17,22,0.773,117,46,108,0.426,38,77,0.494,8,31,0.258,11,12,0.917,111
988,MIA,2023-03-04,117,,ATL,1,240,42,83,0.506,29,48,0.604,13,35,0.371,20,23,0.87,117,37,79,0.468,28,49,0.571,9,30,0.3,26,30,0.867,109
989,ORL,2023-03-03,117,@,CHO,1,240,46,86,0.535,36,60,0.6,10,26,0.385,15,19,0.789,117,38,78,0.487,29,54,0.537,9,24,0.375,21,25,0.84,106
990,BOS,2023-03-01,117,,CLE,1,240,39,78,0.5,23,46,0.5,16,32,0.5,23,28,0.821,117,45,92,0.489,35,60,0.583,10,32,0.313,13,21,0.619,113
991,OKC,2023-03-01,117,,LAL,0,240,44,91,0.484,33,51,0.647,11,40,0.275,18,24,0.75,117,38,80,0.475,22,45,0.489,16,35,0.457,31,39,0.795,123
992,ORL,2023-03-01,117,@,MIL,0,240,43,94,0.457,34,61,0.557,9,33,0.273,22,29,0.759,117,49,94,0.521,23,38,0.605,26,56,0.464,15,19,0.789,139
993,CHI,2023-03-01,117,@,DET,1,240,41,85,0.482,29,58,0.5,12,27,0.444,23,31,0.742,117,39,78,0.5,25,43,0.581,14,35,0.4,23,28,0.821,115
994,OKC,2023-02-28,117,,SAC,0,240,43,98,0.439,32,63,0.508,11,35,0.314,20,24,0.833,117,43,82,0.524,28,40,0.7,15,42,0.357,22,30,0.733,123
995,CHO,2023-02-27,117,,DET,1,240,43,83,0.518,30,57,0.526,13,26,0.5,18,22,0.818,117,42,92,0.457,39,66,0.591,3,26,0.115,19,27,0.704,106
996,IND,2023-02-15,117,,CHI,1,240,39,82,0.476,21,39,0.538,18,43,0.419,21,22,0.955,117,41,84,0.488,26,49,0.531,15,35,0.429,16,21,0.762,113
997,MEM,2023-02-15,117,,UTA,1,240,43,107,0.402,29,67,0.433,14,40,0.35,17,25,0.68,117,42,91,0.462,30,55,0.545,12,36,0.333,15,19,0.789,111
998,IND,2023-02-13,117,,UTA,0,240,46,91,0.505,35,57,0.614,11,34,0.324,14,20,0.7,117,43,85,0.506,28,52,0.538,15,33,0.455,22,25,0.88,123
999,CLE,2023-02-13,117,,SAS,1,240,44,78,0.564,35,50,0.7,9,28,0.321,20,25,0.8,117,43,85,0.506,35,64,0.547,8,21,0.381,15,20,0.75,109
1000,PHO,2023-02-10,117,@,IND,1,240,43,93,0.462,33,60,0.55,10,33,0.303,21,24,0.875,117,36,85,0.424,25,46,0.543,11,39,0.282,21,28,0.75,104
1001,TOR,2023-02-03,117,@,HOU,1,240,41,90,0.456,26,51,0.51,15,39,0.385,20,27,0.741,117,40,80,0.5,33,59,0.559,7,21,0.333,24,33,0.727,111
1002,GSW,2023-02-02,117,@,DEN,0,240,43,85,0.506,24,47,0.511,19,38,0.5,12,19,0.632,117,51,90,0.567,35,55,0.636,16,35,0.457,16,21,0.762,134
1003,MIA,2023-01-29,117,@,CHO,0,240,45,93,0.484,35,62,0.565,10,31,0.323,17,23,0.739,117,45,83,0.542,30,43,0.698,15,40,0.375,17,22,0.773,122
1004,MIN,2023-01-28,117,,SAC,1,240,42,80,0.525,25,43,0.581,17,37,0.459,16,21,0.762,117,37,82,0.451,28,49,0.571,9,33,0.273,27,36,0.75,110
1005,HOU,2023-01-28,117,@,DET,1,240,44,92,0.478,36,65,0.554,8,27,0.296,21,27,0.778,117,38,83,0.458,24,45,0.533,14,38,0.368,24,31,0.774,114
1006,TOR,2023-01-27,117,@,GSW,0,240,46,101,0.455,34,68,0.5,12,33,0.364,13,21,0.619,117,50,90,0.556,32,47,0.681,18,43,0.419,11,15,0.733,129
1007,BOS,2023-01-26,117,,NYK,0,265,41,100,0.41,25,54,0.463,16,46,0.348,19,23,0.826,117,44,96,0.458,31,58,0.534,13,38,0.342,19,23,0.826,120
1008,BRK,2023-01-20,117,@,UTA,1,240,43,80,0.538,25,39,0.641,18,41,0.439,13,20,0.65,117,37,88,0.42,21,49,0.429,16,39,0.41,16,23,0.696,106
1009,PHO,2023-01-19,117,,BRK,1,240,39,85,0.459,28,57,0.491,11,28,0.393,28,41,0.683,117,43,82,0.524,32,56,0.571,11,26,0.423,15,25,0.6,112
1010,HOU,2023-01-18,117,,CHO,0,240,46,91,0.505,36,59,0.61,10,32,0.313,15,20,0.75,117,48,96,0.5,39,60,0.65,9,36,0.25,17,25,0.68,122
1011,NYK,2023-01-15,117,@,DET,1,240,40,88,0.455,28,58,0.483,12,30,0.4,25,31,0.806,117,37,83,0.446,19,39,0.487,18,44,0.409,12,15,0.8,104
1012,UTA,2023-01-14,117,,PHI,0,240,43,90,0.478,31,50,0.62,12,40,0.3,19,23,0.826,117,40,89,0.449,23,50,0.46,17,39,0.436,21,26,0.808,118
1013,TOR,2023-01-08,117,,POR,1,240,40,91,0.44,28,60,0.467,12,31,0.387,25,29,0.862,117,34,76,0.447,25,46,0.543,9,30,0.3,28,37,0.757,105
1014,NOP,2023-01-07,117,@,DAL,0,240,45,94,0.479,40,65,0.615,5,29,0.172,22,35,0.629,117,42,74,0.568,29,45,0.644,13,29,0.448,30,38,0.789,127
1015,SAC,2023-01-04,117,,ATL,0,240,41,88,0.466,31,63,0.492,10,25,0.4,25,27,0.926,117,45,84,0.536,35,54,0.648,10,30,0.333,20,22,0.909,120
1016,NYK,2023-01-04,117,,SAS,1,240,45,94,0.479,35,63,0.556,10,31,0.323,17,26,0.654,117,41,82,0.5,30,54,0.556,11,28,0.393,21,26,0.808,114
1017,SAC,2023-01-03,117,@,UTA,1,240,46,86,0.535,37,54,0.685,9,32,0.281,16,18,0.889,117,38,88,0.432,25,44,0.568,13,44,0.295,26,29,0.897,115
1018,BOS,2023-01-03,117,@,OKC,0,240,40,88,0.455,28,48,0.583,12,40,0.3,25,31,0.806,117,58,98,0.592,38,58,0.655,20,40,0.5,14,22,0.636,150
1019,CLE,2022-12-26,117,,BRK,0,240,39,82,0.476,26,46,0.565,13,36,0.361,26,30,0.867,117,47,82,0.573,29,52,0.558,18,30,0.6,13,17,0.765,125
1020,NYK,2022-12-23,117,,CHI,0,240,43,86,0.5,27,51,0.529,16,35,0.457,15,26,0.577,117,45,93,0.484,31,62,0.5,14,31,0.452,14,18,0.778,118
1021,SAS,2022-12-22,117,@,NOP,0,240,43,90,0.478,34,62,0.548,9,28,0.321,22,27,0.815,117,44,91,0.484,31,57,0.544,13,34,0.382,25,27,0.926,126
1022,IND,2022-12-21,117,@,BOS,1,240,46,98,0.469,28,59,0.475,18,39,0.462,7,9,0.778,117,39,101,0.386,26,60,0.433,13,41,0.317,21,25,0.84,112
1023,WAS,2022-12-18,117,@,LAL,0,240,44,95,0.463,34,56,0.607,10,39,0.256,19,24,0.792,117,46,92,0.5,35,65,0.538,11,27,0.407,16,22,0.727,119
1024,ORL,2022-12-16,117,@,BOS,1,240,42,91,0.462,33,58,0.569,9,33,0.273,24,28,0.857,117,35,84,0.417,24,38,0.632,11,46,0.239,28,34,0.824,109
1025,DET,2022-12-11,117,,LAL,0,240,43,93,0.462,26,48,0.542,17,45,0.378,14,17,0.824,117,46,84,0.548,35,58,0.603,11,26,0.423,21,27,0.778,124
1026,PHO,2022-12-09,117,@,NOP,0,240,43,86,0.5,21,42,0.5,22,44,0.5,9,13,0.692,117,46,90,0.511,38,63,0.603,8,27,0.296,28,35,0.8,128
1027,CHO,2022-12-05,117,,LAC,0,240,47,98,0.48,35,64,0.547,12,34,0.353,11,17,0.647,117,45,93,0.484,30,57,0.526,15,36,0.417,14,21,0.667,119
1028,MEM,2022-12-02,117,,PHI,1,240,42,97,0.433,31,67,0.463,11,30,0.367,22,28,0.786,117,40,91,0.44,26,58,0.448,14,33,0.424,15,17,0.882,109
1029,CHO,2022-12-02,117,,WAS,1,240,40,95,0.421,28,66,0.424,12,29,0.414,25,31,0.806,117,39,86,0.453,27,53,0.509,12,33,0.364,26,35,0.743,116
1030,ATL,2022-12-02,117,,DEN,1,240,49,88,0.557,39,60,0.65,10,28,0.357,9,14,0.643,117,45,85,0.529,33,53,0.623,12,32,0.375,7,13,0.538,109
1031,NOP,2022-12-02,117,@,SAS,1,240,40,92,0.435,28,50,0.56,12,42,0.286,25,26,0.962,117,38,98,0.388,27,59,0.458,11,39,0.282,12,16,0.75,99
1032,SAC,2022-11-28,117,,PHO,0,240,46,88,0.523,37,63,0.587,9,25,0.36,16,18,0.889,117,50,94,0.532,40,62,0.645,10,32,0.313,12,14,0.857,122
1033,MIL,2022-11-25,117,,CLE,1,240,42,83,0.506,27,51,0.529,15,32,0.469,18,25,0.72,117,34,87,0.391,22,54,0.407,12,33,0.364,22,26,0.846,102
1034,BRK,2022-11-25,117,@,IND,0,240,47,88,0.534,32,47,0.681,15,41,0.366,8,10,0.8,117,43,86,0.5,31,52,0.596,12,34,0.353,30,38,0.789,128
1035,BOS,2022-11-18,117,@,NOP,1,240,41,85,0.482,21,39,0.538,20,46,0.435,15,17,0.882,117,43,87,0.494,30,52,0.577,13,35,0.371,10,13,0.769,109
1036,POR,2022-11-15,117,,SAS,1,240,41,79,0.519,26,47,0.553,15,32,0.469,20,26,0.769,117,44,85,0.518,35,56,0.625,9,29,0.31,13,17,0.765,110
1037,DAL,2022-11-12,117,,POR,1,240,41,81,0.506,27,38,0.711,14,43,0.326,21,26,0.808,117,36,80,0.45,23,49,0.469,13,31,0.419,27,35,0.771,112
1038,BOS,2022-11-12,117,@,DET,1,240,39,91,0.429,21,43,0.488,18,48,0.375,21,24,0.875,117,37,89,0.416,21,51,0.412,16,38,0.421,18,21,0.857,108
1039,MIA,2022-11-10,117,,CHO,1,265,39,90,0.433,29,54,0.537,10,36,0.278,29,36,0.806,117,43,88,0.489,29,49,0.592,14,39,0.359,12,20,0.6,112
1040,MIN,2022-11-09,117,,PHO,0,240,41,78,0.526,32,51,0.627,9,27,0.333,26,32,0.813,117,47,97,0.485,31,62,0.5,16,35,0.457,19,20,0.95,129
1041,ATL,2022-11-07,117,,MIL,1,240,46,99,0.465,35,70,0.5,11,29,0.379,14,17,0.824,117,36,87,0.414,23,47,0.489,13,40,0.325,13,16,0.813,98
1042,CLE,2022-11-07,117,@,LAC,0,240,43,83,0.518,27,50,0.54,16,33,0.485,15,21,0.714,117,40,79,0.506,23,41,0.561,17,38,0.447,22,28,0.786,119
1043,HOU,2022-11-05,117,@,MIN,0,240,40,84,0.476,24,46,0.522,16,38,0.421,21,31,0.677,117,49,80,0.613,34,47,0.723,15,33,0.455,16,20,0.8,129
1044,NOP,2022-11-02,117,@,LAL,0,265,47,102,0.461,39,77,0.506,8,25,0.32,15,21,0.714,117,45,98,0.459,35,62,0.565,10,36,0.278,20,23,0.87,120
1045,OKC,2022-10-29,117,@,DAL,1,265,44,89,0.494,39,64,0.609,5,25,0.2,24,31,0.774,117,38,95,0.4,30,55,0.545,8,40,0.2,27,34,0.794,111
1046,DEN,2022-10-28,117,,UTA,1,240,39,85,0.459,22,48,0.458,17,37,0.459,22,34,0.647,117,38,91,0.418,28,52,0.538,10,39,0.256,15,19,0.789,101
1047,WAS,2022-10-28,117,,IND,0,240,41,86,0.477,29,56,0.518,12,30,0.4,23,28,0.821,117,41,81,0.506,26,52,0.5,15,29,0.517,30,33,0.909,127
1048,CLE,2022-10-23,117,,WAS,1,265,41,96,0.427,28,63,0.444,13,33,0.394,22,25,0.88,117,43,87,0.494,31,59,0.525,12,28,0.429,9,15,0.6,107
1049,OKC,2022-10-22,117,@,DEN,0,240,42,94,0.447,27,56,0.482,15,38,0.395,18,23,0.783,117,42,85,0.494,22,47,0.468,20,38,0.526,18,31,0.581,122
1050,ATL,2022-10-19,117,,HOU,1,240,45,90,0.5,38,65,0.585,7,25,0.28,20,24,0.833,117,42,98,0.429,33,63,0.524,9,35,0.257,14,15,0.933,107
1051,PHI,2022-10-18,117,@,BOS,0,240,40,80,0.5,27,46,0.587,13,34,0.382,24,28,0.857,117,46,82,0.561,34,47,0.723,12,35,0.343,22,28,0.786,126
1052,WAS,2023-04-05,116,@,ATL,0,240,45,94,0.479,39,66,0.591,6,28,0.214,20,26,0.769,116,43,84,0.512,30,54,0.556,13,30,0.433,35,40,0.875,134
1053,CLE,2023-03-31,116,,NYK,0,240,44,86,0.512,27,49,0.551,17,37,0.459,11,13,0.846,116,49,93,0.527,32,57,0.561,17,36,0.472,15,24,0.625,130
1054,ORL,2023-03-31,116,@,WAS,1,240,44,88,0.5,36,64,0.563,8,24,0.333,20,26,0.769,116,41,105,0.39,24,55,0.436,17,50,0.34,10,12,0.833,109
1055,PHI,2023-03-29,116,,DAL,1,240,37,80,0.463,20,44,0.455,17,36,0.472,25,30,0.833,116,38,83,0.458,20,37,0.541,18,46,0.391,14,18,0.778,108
1056,DEN,2023-03-27,116,,PHI,1,240,43,85,0.506,32,53,0.604,11,32,0.344,19,22,0.864,116,43,89,0.483,35,59,0.593,8,30,0.267,17,22,0.773,111
1057,UTA,2023-03-24,116,,MIL,0,240,40,104,0.385,29,64,0.453,11,40,0.275,25,34,0.735,116,55,99,0.556,33,49,0.673,22,50,0.44,12,16,0.75,144
1058,LAL,2023-03-24,116,,OKC,1,240,42,91,0.462,30,57,0.526,12,34,0.353,20,28,0.714,116,40,92,0.435,26,56,0.464,14,36,0.389,17,19,0.895,111
1059,CLE,2023-03-23,116,@,BRK,1,240,42,89,0.472,30,57,0.526,12,32,0.375,20,26,0.769,116,39,81,0.481,27,47,0.574,12,34,0.353,24,27,0.889,114
1060,PHI,2023-03-22,116,@,CHI,1,240,39,82,0.476,23,45,0.511,16,37,0.432,22,26,0.846,116,34,83,0.41,28,58,0.483,6,25,0.24,17,22,0.773,91
1061,NYK,2023-03-18,116,,DEN,1,240,41,83,0.494,32,51,0.627,9,32,0.281,25,28,0.893,116,43,84,0.512,31,51,0.608,12,33,0.364,12,15,0.8,110
1062,PHO,2023-03-16,116,,ORL,1,240,43,90,0.478,30,55,0.545,13,35,0.371,17,17,1.0,116,43,86,0.5,35,58,0.603,8,28,0.286,19,23,0.826,113
1063,MIL,2023-03-14,116,@,PHO,1,240,40,85,0.471,28,46,0.609,12,39,0.308,24,37,0.649,116,41,95,0.432,33,72,0.458,8,23,0.348,14,16,0.875,104
1064,MIL,2023-03-11,116,@,GSW,0,265,43,100,0.43,22,49,0.449,21,51,0.412,9,11,0.818,116,46,112,0.411,23,57,0.404,23,55,0.418,10,11,0.909,125
1065,UTA,2023-03-07,116,@,DAL,0,240,41,92,0.446,26,48,0.542,15,44,0.341,19,25,0.76,116,42,89,0.472,23,44,0.523,19,45,0.422,17,22,0.773,120
1066,TOR,2023-03-04,116,@,WAS,1,265,47,90,0.522,35,60,0.583,12,30,0.4,10,14,0.714,116,38,75,0.507,24,51,0.471,14,24,0.583,19,22,0.864,109
1067,ATL,2023-02-28,116,,WAS,0,240,43,93,0.462,30,58,0.517,13,35,0.371,17,19,0.895,116,48,97,0.495,42,76,0.553,6,21,0.286,17,20,0.85,119
1068,GSW,2023-02-24,116,,HOU,1,240,37,78,0.474,11,24,0.458,26,54,0.481,16,18,0.889,116,36,92,0.391,25,57,0.439,11,35,0.314,18,22,0.818,101
1069,SAS,2023-02-23,116,@,DAL,0,240,45,86,0.523,35,61,0.574,10,25,0.4,16,23,0.696,116,46,82,0.561,24,40,0.6,22,42,0.524,28,36,0.778,142
1070,POR,2023-02-23,116,@,SAC,0,240,43,93,0.462,27,55,0.491,16,38,0.421,14,17,0.824,116,47,85,0.553,33,51,0.647,14,34,0.412,25,31,0.806,133
1071,LAC,2023-02-16,116,@,PHO,1,240,40,82,0.488,29,48,0.604,11,34,0.324,25,27,0.926,116,42,89,0.472,31,58,0.534,11,31,0.355,12,16,0.75,107
1072,BRK,2023-02-15,116,,MIA,1,240,41,77,0.532,24,38,0.632,17,39,0.436,17,20,0.85,116,38,83,0.458,30,55,0.545,8,28,0.286,21,29,0.724,105
1073,CHO,2023-02-10,116,@,BOS,0,240,45,93,0.484,37,70,0.529,8,23,0.348,18,26,0.692,116,44,89,0.494,19,34,0.559,25,55,0.455,14,17,0.824,127
1074,TOR,2023-02-10,116,,UTA,0,240,41,91,0.451,29,57,0.509,12,34,0.353,22,30,0.733,116,47,87,0.54,41,63,0.651,6,24,0.25,22,29,0.759,122
1075,ATL,2023-02-09,116,,PHO,1,240,43,95,0.453,33,66,0.5,10,29,0.345,20,27,0.741,116,39,86,0.453,32,56,0.571,7,30,0.233,22,29,0.759,107
1076,BRK,2023-02-09,116,,CHI,1,240,39,91,0.429,22,47,0.468,17,44,0.386,21,25,0.84,116,42,91,0.462,37,65,0.569,5,26,0.192,16,21,0.762,105
1077,MIA,2023-02-08,116,,IND,1,240,37,79,0.468,31,60,0.517,6,19,0.316,36,39,0.923,116,38,78,0.487,23,45,0.511,15,33,0.455,20,28,0.714,111
1078,PHO,2023-02-07,116,@,BRK,1,240,43,92,0.467,34,61,0.557,9,31,0.29,21,28,0.75,116,38,79,0.481,29,51,0.569,9,28,0.321,27,31,0.871,112
1079,NOP,2023-02-07,116,,ATL,1,240,45,91,0.495,33,59,0.559,12,32,0.375,14,21,0.667,116,38,85,0.447,26,49,0.531,12,36,0.333,19,25,0.76,107
1080,BRK,2023-02-06,116,,LAC,0,240,41,84,0.488,25,53,0.472,16,31,0.516,18,22,0.818,116,44,92,0.478,32,62,0.516,12,30,0.4,24,30,0.8,124
1081,PHO,2023-02-04,116,@,DET,1,240,42,75,0.56,31,52,0.596,11,23,0.478,21,31,0.677,116,35,81,0.432,19,39,0.487,16,42,0.381,14,22,0.636,100
1082,WAS,2023-02-03,116,,POR,0,240,42,84,0.5,30,51,0.588,12,33,0.364,20,22,0.909,116,43,88,0.489,26,47,0.553,17,41,0.415,21,23,0.913,124
1083,IND,2023-01-24,116,,CHI,1,240,42,99,0.424,32,62,0.516,10,37,0.27,22,28,0.786,116,43,88,0.489,38,64,0.594,5,24,0.208,19,25,0.76,110
1084,NYK,2023-01-22,116,@,TOR,0,240,40,82,0.488,22,41,0.537,18,41,0.439,18,26,0.692,116,41,90,0.456,26,56,0.464,15,34,0.441,28,35,0.8,125
1085,GSW,2023-01-22,116,,BRK,0,240,41,90,0.456,28,58,0.483,13,32,0.406,21,27,0.778,116,43,79,0.544,29,52,0.558,14,27,0.519,20,31,0.645,120
1086,WAS,2023-01-18,116,@,NYK,1,240,42,95,0.442,26,53,0.491,16,42,0.381,16,19,0.842,116,40,96,0.417,33,70,0.471,7,26,0.269,18,27,0.667,105
1087,SAC,2023-01-18,116,@,LAL,1,240,43,87,0.494,34,57,0.596,9,30,0.3,21,27,0.778,116,43,89,0.483,32,55,0.582,11,34,0.324,14,18,0.778,111
1088,ORL,2023-01-15,116,@,DEN,0,240,41,84,0.488,34,55,0.618,7,29,0.241,27,34,0.794,116,48,89,0.539,35,50,0.7,13,39,0.333,10,19,0.526,119
1089,PHO,2023-01-13,116,@,MIN,0,240,41,86,0.477,27,63,0.429,14,23,0.609,20,24,0.833,116,47,90,0.522,37,62,0.597,10,28,0.357,17,20,0.85,121
1090,NOP,2023-01-13,116,@,DET,1,240,42,86,0.488,31,55,0.564,11,31,0.355,21,30,0.7,116,43,90,0.478,36,60,0.6,7,30,0.233,17,24,0.708,110
1091,UTA,2023-01-10,116,,CLE,1,240,38,87,0.437,28,51,0.549,10,36,0.278,30,37,0.811,116,42,90,0.467,32,53,0.604,10,37,0.27,20,24,0.833,114
1092,DET,2023-01-10,116,@,PHI,0,240,36,89,0.404,22,50,0.44,14,39,0.359,30,36,0.833,116,54,89,0.607,43,58,0.741,11,31,0.355,28,30,0.933,147
1093,IND,2023-01-08,116,,CHO,1,240,38,87,0.437,25,49,0.51,13,38,0.342,27,33,0.818,116,38,88,0.432,27,55,0.491,11,33,0.333,24,27,0.889,111
1094,SAS,2023-01-07,116,,BOS,0,240,49,100,0.49,42,75,0.56,7,25,0.28,11,14,0.786,116,47,95,0.495,32,61,0.525,15,34,0.441,12,18,0.667,121
1095,MEM,2022-12-31,116,,NOP,1,240,47,92,0.511,42,63,0.667,5,29,0.172,17,22,0.773,116,32,91,0.352,24,61,0.393,8,30,0.267,29,36,0.806,101
1096,DET,2022-12-31,116,@,MIN,1,240,43,89,0.483,33,62,0.532,10,27,0.37,20,28,0.714,116,36,83,0.434,26,49,0.531,10,34,0.294,22,26,0.846,104
1097,PHI,2022-12-30,116,@,NOP,0,240,42,75,0.56,28,41,0.683,14,34,0.412,18,22,0.818,116,43,80,0.538,28,49,0.571,15,31,0.484,26,36,0.722,127
1098,BOS,2022-12-29,116,,LAC,1,240,44,91,0.484,33,52,0.635,11,39,0.282,17,22,0.773,116,43,89,0.483,28,50,0.56,15,39,0.385,9,14,0.643,110
1099,WAS,2022-12-27,116,,PHI,1,240,39,85,0.459,28,52,0.538,11,33,0.333,27,31,0.871,116,39,84,0.464,33,53,0.623,6,31,0.194,27,31,0.871,111
1100,ORL,2022-12-21,116,@,HOU,1,240,41,91,0.451,30,54,0.556,11,37,0.297,23,33,0.697,116,41,88,0.466,24,45,0.533,17,43,0.395,11,17,0.647,110
1101,MIN,2022-12-19,116,,DAL,1,240,42,89,0.472,30,58,0.517,12,31,0.387,20,24,0.833,116,31,76,0.408,12,31,0.387,19,45,0.422,25,31,0.806,106
1102,TOR,2022-12-16,116,,BRK,0,240,41,84,0.488,32,60,0.533,9,24,0.375,25,29,0.862,116,46,76,0.605,37,50,0.74,9,26,0.346,18,23,0.783,119
1103,ATL,2022-12-09,116,@,BRK,0,240,46,93,0.495,36,64,0.563,10,29,0.345,14,16,0.875,116,45,83,0.542,32,53,0.604,13,30,0.433,17,21,0.81,120
1104,CHO,2022-12-07,116,@,BRK,0,240,47,88,0.534,37,64,0.578,10,24,0.417,12,23,0.522,116,49,86,0.57,37,55,0.673,12,31,0.387,12,16,0.75,122
1105,ORL,2022-12-07,116,,LAC,1,265,40,95,0.421,32,67,0.478,8,28,0.286,28,31,0.903,116,39,95,0.411,24,54,0.444,15,41,0.366,18,26,0.692,111
1106,CLE,2022-12-06,116,,LAL,1,240,48,93,0.516,41,66,0.621,7,27,0.259,13,17,0.765,116,38,89,0.427,32,53,0.604,6,36,0.167,20,24,0.833,102
1107,DET,2022-12-06,116,@,MIA,1,240,43,87,0.494,24,46,0.522,19,41,0.463,11,15,0.733,116,33,77,0.429,23,45,0.511,10,32,0.313,20,26,0.769,96
1108,DAL,2022-12-06,116,@,DEN,1,240,36,72,0.5,19,36,0.528,17,36,0.472,27,31,0.871,116,40,78,0.513,27,46,0.587,13,32,0.406,22,28,0.786,115
1109,BOS,2022-12-05,116,@,TOR,1,240,44,90,0.489,31,54,0.574,13,36,0.361,15,21,0.714,116,39,85,0.459,29,57,0.509,10,28,0.357,22,30,0.733,110
1110,POR,2022-12-04,116,,IND,1,240,42,86,0.488,25,46,0.543,17,40,0.425,15,22,0.682,116,40,91,0.44,30,58,0.517,10,33,0.303,10,12,0.833,100
1111,POR,2022-12-03,116,@,UTA,1,240,41,85,0.482,31,60,0.517,10,25,0.4,24,31,0.774,116,38,84,0.452,25,48,0.521,13,36,0.361,22,28,0.786,111
1112,WAS,2022-12-02,116,@,CHO,0,240,39,86,0.453,27,53,0.509,12,33,0.364,26,35,0.743,116,40,95,0.421,28,66,0.424,12,29,0.414,25,31,0.806,117
1113,BOS,2022-12-02,116,,MIA,0,265,40,87,0.46,25,42,0.595,15,45,0.333,21,28,0.75,116,48,101,0.475,37,66,0.561,11,35,0.314,13,18,0.722,120
1114,DAL,2022-11-29,116,,GSW,1,240,42,91,0.462,27,47,0.574,15,44,0.341,17,27,0.63,116,42,88,0.477,31,45,0.689,11,43,0.256,18,23,0.783,113
1115,IND,2022-11-28,116,@,LAL,1,240,43,105,0.41,26,56,0.464,17,49,0.347,13,16,0.813,116,40,93,0.43,29,62,0.468,11,31,0.355,24,31,0.774,115
1116,UTA,2022-11-23,116,,DET,0,240,41,83,0.494,23,42,0.548,18,41,0.439,16,19,0.842,116,44,89,0.494,32,65,0.492,12,24,0.5,25,27,0.926,125
1117,PHO,2022-11-20,116,,NYK,1,240,43,101,0.426,26,62,0.419,17,39,0.436,13,18,0.722,116,34,85,0.4,27,60,0.45,7,25,0.28,20,25,0.8,95
1118,LAL,2022-11-13,116,,BRK,1,240,44,91,0.484,33,64,0.516,11,27,0.407,17,20,0.85,116,36,80,0.45,29,53,0.547,7,27,0.259,24,31,0.774,103
1119,TOR,2022-11-09,116,,HOU,1,240,42,102,0.412,27,58,0.466,15,44,0.341,17,20,0.85,116,37,84,0.44,28,49,0.571,9,35,0.257,26,31,0.839,109
1120,GSW,2022-11-07,116,,SAC,1,240,44,88,0.5,30,50,0.6,14,38,0.368,14,21,0.667,116,37,91,0.407,23,51,0.451,14,40,0.35,25,29,0.862,113
1121,LAL,2022-11-07,116,@,UTA,0,240,40,82,0.488,31,58,0.534,9,24,0.375,27,30,0.9,116,53,95,0.558,37,57,0.649,16,38,0.421,17,22,0.773,139
1122,LAL,2022-11-04,116,,UTA,0,240,40,83,0.482,29,57,0.509,11,26,0.423,25,28,0.893,116,52,103,0.505,35,63,0.556,17,40,0.425,9,10,0.9,130
1123,MIL,2022-11-02,116,,DET,1,240,43,92,0.467,33,54,0.611,10,38,0.263,20,24,0.833,116,33,79,0.418,22,48,0.458,11,31,0.355,14,15,0.933,91
1124,PHO,2022-11-01,116,,MIN,1,240,41,89,0.461,24,46,0.522,17,43,0.395,17,22,0.773,116,37,87,0.425,24,53,0.453,13,34,0.382,20,24,0.833,107
1125,MIA,2022-11-01,116,,GSW,1,240,40,88,0.455,24,46,0.522,16,42,0.381,20,20,1.0,116,39,84,0.464,21,35,0.6,18,49,0.367,13,17,0.765,109
1126,OKC,2022-11-01,116,,ORL,1,240,45,95,0.474,35,61,0.574,10,34,0.294,16,20,0.8,116,39,87,0.448,29,58,0.5,10,29,0.345,20,20,1.0,108
1127,BRK,2022-10-31,116,,IND,1,240,43,80,0.538,32,50,0.64,11,30,0.367,19,20,0.95,116,41,87,0.471,30,48,0.625,11,39,0.282,16,23,0.696,109
1128,BRK,2022-10-29,116,,IND,0,240,41,82,0.5,27,43,0.628,14,39,0.359,20,26,0.769,116,40,94,0.426,17,48,0.354,23,46,0.5,22,26,0.846,125
1129,MIN,2022-10-23,116,@,OKC,1,240,46,88,0.523,36,54,0.667,10,34,0.294,14,22,0.636,116,41,94,0.436,32,53,0.604,9,41,0.22,15,21,0.714,106
1130,CHI,2022-10-19,116,@,MIA,1,240,41,93,0.441,28,57,0.491,13,36,0.361,21,28,0.75,116,37,80,0.463,25,52,0.481,12,28,0.429,22,28,0.786,108
1131,OKC,2023-04-09,115,,MEM,1,240,45,90,0.5,33,54,0.611,12,36,0.333,13,16,0.813,115,40,92,0.435,33,55,0.6,7,37,0.189,13,18,0.722,100
1132,IND,2023-04-07,115,,DET,0,240,41,83,0.494,30,52,0.577,11,31,0.355,22,28,0.786,115,44,90,0.489,31,59,0.525,13,31,0.419,21,26,0.808,122
1133,CHI,2023-04-07,115,@,DAL,1,240,46,88,0.523,35,57,0.614,11,31,0.355,12,18,0.667,115,42,93,0.452,24,38,0.632,18,55,0.327,10,13,0.769,112
1134,DEN,2023-04-06,115,@,PHO,0,240,44,83,0.53,36,60,0.6,8,23,0.348,19,23,0.826,115,41,79,0.519,24,43,0.558,17,36,0.472,20,25,0.8,119
1135,PHO,2023-04-04,115,,SAS,1,240,43,89,0.483,33,56,0.589,10,33,0.303,19,26,0.731,115,35,90,0.389,22,50,0.44,13,40,0.325,11,14,0.786,94
1136,CLE,2023-04-02,115,,IND,1,240,44,90,0.489,35,66,0.53,9,24,0.375,18,26,0.692,115,36,83,0.434,27,59,0.458,9,24,0.375,24,29,0.828,105
1137,DET,2023-03-31,115,@,HOU,0,240,43,89,0.483,32,54,0.593,11,35,0.314,18,27,0.667,115,38,83,0.458,27,52,0.519,11,31,0.355,34,45,0.756,121
1138,SAS,2023-03-31,115,@,GSW,0,240,42,91,0.462,27,53,0.509,15,38,0.395,16,23,0.696,115,47,93,0.505,26,44,0.591,21,49,0.429,15,21,0.714,130
1139,HOU,2023-03-27,115,@,NYK,0,240,42,87,0.483,35,61,0.574,7,26,0.269,24,29,0.828,115,50,86,0.581,33,47,0.702,17,39,0.436,20,28,0.714,137
1140,SAC,2023-03-27,115,,MIN,0,240,39,84,0.464,34,57,0.596,5,27,0.185,32,40,0.8,115,44,86,0.512,35,62,0.565,9,24,0.375,22,34,0.647,119
1141,NOP,2023-03-23,115,,CHO,1,240,45,98,0.459,34,64,0.531,11,34,0.324,14,15,0.933,115,38,83,0.458,29,46,0.63,9,37,0.243,11,16,0.688,96
1142,UTA,2023-03-22,115,,POR,0,240,39,82,0.476,28,47,0.596,11,35,0.314,26,36,0.722,115,45,93,0.484,32,52,0.615,13,41,0.317,24,30,0.8,127
1143,CLE,2023-03-21,115,@,BRK,1,240,42,83,0.506,28,54,0.519,14,29,0.483,17,21,0.81,115,41,92,0.446,32,59,0.542,9,33,0.273,18,23,0.783,109
1144,CHO,2023-03-20,115,,IND,1,240,41,90,0.456,31,59,0.525,10,31,0.323,23,32,0.719,115,37,82,0.451,28,56,0.5,9,26,0.346,26,34,0.765,109
1145,UTA,2023-03-13,115,@,MIA,0,240,43,90,0.478,27,52,0.519,16,38,0.421,13,18,0.722,115,37,79,0.468,23,45,0.511,14,34,0.412,31,36,0.861,119
1146,ATL,2023-03-13,115,,MIN,0,240,44,97,0.454,40,75,0.533,4,22,0.182,23,28,0.821,115,54,92,0.587,42,64,0.656,12,28,0.429,16,23,0.696,136
1147,DET,2023-03-11,115,,IND,0,240,43,94,0.457,32,60,0.533,11,34,0.324,18,27,0.667,115,43,93,0.462,34,58,0.586,9,35,0.257,26,34,0.765,121
1148,CLE,2023-03-10,115,@,MIA,0,240,40,86,0.465,22,43,0.512,18,43,0.419,17,21,0.81,115,42,82,0.512,28,53,0.528,14,29,0.483,21,23,0.913,119
1149,BOS,2023-03-08,115,,POR,1,240,42,88,0.477,24,39,0.615,18,49,0.367,13,20,0.65,115,30,82,0.366,19,43,0.442,11,39,0.282,22,27,0.815,93
1150,BRK,2023-03-03,115,@,BOS,1,240,40,95,0.421,26,51,0.51,14,44,0.318,21,26,0.808,115,41,84,0.488,32,55,0.582,9,29,0.31,14,20,0.7,105
1151,GSW,2023-03-02,115,,LAC,1,240,39,93,0.419,25,47,0.532,14,46,0.304,23,27,0.852,115,32,89,0.36,23,46,0.5,9,43,0.209,18,21,0.857,91
1152,DET,2023-03-01,115,,CHI,0,240,39,78,0.5,25,43,0.581,14,35,0.4,23,28,0.821,115,41,85,0.482,29,58,0.5,12,27,0.444,23,31,0.742,117
1153,OKC,2023-02-26,115,,SAC,0,240,41,86,0.477,25,46,0.543,16,40,0.4,17,23,0.739,115,45,85,0.529,27,42,0.643,18,43,0.419,16,24,0.667,124
1154,OKC,2023-02-24,115,@,PHO,0,240,41,95,0.432,26,57,0.456,15,38,0.395,18,24,0.75,115,42,90,0.467,28,52,0.538,14,38,0.368,26,32,0.813,124
1155,NYK,2023-02-24,115,@,WAS,1,240,45,92,0.489,33,63,0.524,12,29,0.414,13,16,0.813,115,39,79,0.494,20,35,0.571,19,44,0.432,12,12,1.0,109
1156,TOR,2023-02-23,115,,NOP,1,240,43,92,0.467,34,61,0.557,9,31,0.29,20,25,0.8,115,39,84,0.464,26,54,0.481,13,30,0.433,19,25,0.76,110
1157,DEN,2023-02-23,115,@,CLE,1,240,39,84,0.464,22,48,0.458,17,36,0.472,20,23,0.87,115,43,90,0.478,37,64,0.578,6,26,0.231,17,20,0.85,109
1158,LAL,2023-02-13,115,@,POR,0,240,42,95,0.442,30,58,0.517,12,37,0.324,19,21,0.905,115,46,97,0.474,23,50,0.46,23,47,0.489,12,13,0.923,127
1159,ORL,2023-02-09,115,,DEN,1,240,47,97,0.485,38,70,0.543,9,27,0.333,12,19,0.632,115,39,84,0.464,29,51,0.569,10,33,0.303,16,24,0.667,104
1160,MIL,2023-02-09,115,@,LAL,1,240,45,99,0.455,33,52,0.635,12,47,0.255,13,18,0.722,115,42,89,0.472,35,71,0.493,7,18,0.389,15,21,0.714,106
1161,MIA,2023-02-04,115,@,MIL,0,240,45,101,0.446,37,70,0.529,8,31,0.258,17,21,0.81,115,46,88,0.523,32,48,0.667,14,40,0.35,17,28,0.607,123
1162,ATL,2023-02-03,115,@,UTA,1,240,44,95,0.463,34,58,0.586,10,37,0.27,17,23,0.739,115,41,91,0.451,28,47,0.596,13,44,0.295,13,18,0.722,108
1163,CHO,2023-01-31,115,@,MIL,0,240,42,111,0.378,31,72,0.431,11,39,0.282,20,26,0.769,115,43,105,0.41,28,61,0.459,15,44,0.341,23,27,0.852,124
1164,NYK,2023-01-28,115,@,BRK,0,240,45,88,0.511,35,60,0.583,10,28,0.357,15,19,0.789,115,46,87,0.529,24,47,0.511,22,40,0.55,8,14,0.571,122
1165,LAL,2023-01-24,115,,LAC,0,240,42,95,0.442,26,55,0.473,16,40,0.4,15,24,0.625,115,51,84,0.607,32,46,0.696,19,38,0.5,12,15,0.8,133
1166,DAL,2023-01-20,115,,MIA,1,240,37,80,0.463,19,42,0.452,18,38,0.474,23,28,0.821,115,33,69,0.478,29,49,0.592,4,20,0.2,20,27,0.741,90
1167,MEM,2023-01-18,115,,CLE,1,240,44,97,0.454,33,63,0.524,11,34,0.324,16,22,0.727,115,42,82,0.512,26,47,0.553,16,35,0.457,14,21,0.667,114
1168,DEN,2023-01-13,115,@,LAC,1,240,41,82,0.5,27,49,0.551,14,33,0.424,19,25,0.76,115,41,87,0.471,31,58,0.534,10,29,0.345,11,14,0.786,103
1169,LAL,2023-01-12,115,,DAL,0,290,44,112,0.393,34,71,0.479,10,41,0.244,17,27,0.63,115,48,96,0.5,34,54,0.63,14,42,0.333,9,17,0.529,119
1170,HOU,2023-01-11,115,@,SAC,0,240,44,96,0.458,28,55,0.509,16,41,0.39,11,17,0.647,115,45,94,0.479,26,46,0.565,19,48,0.396,26,31,0.839,135
1171,ORL,2023-01-07,115,@,GSW,1,240,44,87,0.506,31,55,0.564,13,32,0.406,14,24,0.583,115,33,88,0.375,15,30,0.5,18,58,0.31,17,21,0.81,101
1172,LAC,2023-01-06,115,@,MIN,0,240,44,100,0.44,35,75,0.467,9,25,0.36,18,27,0.667,115,46,81,0.568,33,46,0.717,13,35,0.371,23,29,0.793,128
1173,ORL,2023-01-05,115,,MEM,0,240,39,84,0.464,28,48,0.583,11,36,0.306,26,30,0.867,115,48,92,0.522,36,56,0.643,12,36,0.333,15,23,0.652,123
1174,OKC,2023-01-04,115,@,ORL,0,240,36,89,0.404,21,52,0.404,15,37,0.405,28,31,0.903,115,42,81,0.519,29,48,0.604,13,33,0.394,29,36,0.806,126
1175,UTA,2023-01-03,115,,SAC,0,240,38,88,0.432,25,44,0.568,13,44,0.295,26,29,0.897,115,46,86,0.535,37,54,0.685,9,32,0.281,16,18,0.889,117
1176,CHO,2023-01-02,115,,LAL,0,240,42,93,0.452,31,61,0.508,11,32,0.344,20,29,0.69,115,45,93,0.484,35,63,0.556,10,30,0.333,21,30,0.7,121
1177,PHI,2022-12-31,115,@,OKC,1,240,46,99,0.465,35,65,0.538,11,34,0.324,12,17,0.706,115,35,92,0.38,23,56,0.411,12,36,0.333,14,22,0.636,96
1178,NYK,2022-12-29,115,@,SAS,0,240,38,90,0.422,23,49,0.469,15,41,0.366,24,31,0.774,115,45,88,0.511,34,60,0.567,11,28,0.393,21,29,0.724,122
1179,LAL,2022-12-25,115,@,DAL,0,240,39,80,0.488,30,52,0.577,9,28,0.321,28,32,0.875,115,44,84,0.524,26,40,0.65,18,44,0.409,18,25,0.72,124
1180,CHO,2022-12-18,115,@,DEN,0,240,41,96,0.427,29,58,0.5,12,38,0.316,21,23,0.913,115,43,94,0.457,32,61,0.525,11,33,0.333,22,34,0.647,119
1181,OKC,2022-12-17,115,,MEM,1,240,38,92,0.413,19,47,0.404,19,45,0.422,20,31,0.645,115,34,90,0.378,22,45,0.489,12,45,0.267,29,37,0.784,109
1182,DEN,2022-12-10,115,,UTA,1,240,47,86,0.547,39,60,0.65,8,26,0.308,13,16,0.813,115,39,85,0.459,24,44,0.545,15,41,0.366,17,21,0.81,110
1183,DAL,2022-12-10,115,@,CHI,0,240,41,90,0.456,30,46,0.652,11,44,0.25,22,26,0.846,115,54,85,0.635,35,51,0.686,19,34,0.559,17,24,0.708,144
1184,SAS,2022-12-10,115,@,MIA,1,240,42,78,0.538,35,57,0.614,7,21,0.333,24,31,0.774,115,39,81,0.481,26,47,0.553,13,34,0.382,20,28,0.714,111
1185,MIA,2022-12-08,115,,LAC,1,240,46,90,0.511,34,58,0.586,12,32,0.375,11,14,0.786,115,37,80,0.463,20,44,0.455,17,36,0.472,19,21,0.905,110
1186,IND,2022-12-07,115,@,MIN,0,240,39,81,0.481,20,39,0.513,19,42,0.452,18,24,0.75,115,44,93,0.473,36,70,0.514,8,23,0.348,25,27,0.926,121
1187,CHI,2022-12-07,115,,WAS,1,240,45,90,0.5,35,67,0.522,10,23,0.435,15,17,0.882,115,41,84,0.488,32,53,0.604,9,31,0.29,20,29,0.69,111
1188,DEN,2022-12-06,115,,DAL,0,240,40,78,0.513,27,46,0.587,13,32,0.406,22,28,0.786,115,36,72,0.5,19,36,0.528,17,36,0.472,27,31,0.871,116
1189,LAL,2022-11-28,115,,IND,0,240,40,93,0.43,29,62,0.468,11,31,0.355,24,31,0.774,115,43,105,0.41,26,56,0.464,17,49,0.347,13,16,0.813,116
1190,DAL,2022-11-27,115,@,MIL,0,240,41,80,0.513,24,39,0.615,17,41,0.415,16,25,0.64,115,48,86,0.558,31,49,0.633,17,37,0.459,11,15,0.733,124
1191,ATL,2022-11-23,115,,SAC,1,240,41,92,0.446,30,62,0.484,11,30,0.367,22,23,0.957,115,41,89,0.461,32,58,0.552,9,31,0.29,15,21,0.714,106
1192,MIN,2022-11-23,115,@,IND,1,240,47,77,0.61,39,55,0.709,8,22,0.364,13,17,0.765,115,37,96,0.385,21,52,0.404,16,44,0.364,11,16,0.688,101
1193,PHI,2022-11-22,115,,BRK,1,240,43,99,0.434,27,67,0.403,16,32,0.5,13,16,0.813,115,44,80,0.55,35,52,0.673,9,28,0.321,9,13,0.692,106
1194,PHO,2022-11-22,115,,LAL,1,240,48,102,0.471,32,68,0.471,16,34,0.471,3,5,0.6,115,36,85,0.424,32,63,0.508,4,22,0.182,29,35,0.829,105
1195,MEM,2022-11-20,115,@,BRK,0,240,43,99,0.434,31,62,0.5,12,37,0.324,17,31,0.548,115,50,83,0.602,34,49,0.694,16,34,0.471,11,15,0.733,127
1196,TOR,2022-11-14,115,@,DET,1,240,40,82,0.488,32,55,0.582,8,27,0.296,27,28,0.964,115,35,77,0.455,25,46,0.543,10,31,0.323,31,43,0.721,111
1197,GSW,2022-11-13,115,@,SAC,0,240,42,90,0.467,26,43,0.605,16,47,0.34,15,16,0.938,115,47,91,0.516,31,54,0.574,16,37,0.432,12,19,0.632,122
1198,CHO,2022-11-12,115,@,MIA,0,240,46,90,0.511,37,59,0.627,9,31,0.29,14,16,0.875,115,49,93,0.527,33,52,0.635,16,41,0.39,18,21,0.857,132
1199,NOP,2022-11-09,115,@,CHI,1,240,42,84,0.5,39,65,0.6,3,19,0.158,28,36,0.778,115,44,87,0.506,37,60,0.617,7,27,0.259,16,18,0.889,111
1200,DEN,2022-11-07,115,@,SAS,1,240,47,88,0.534,39,64,0.609,8,24,0.333,13,20,0.65,115,43,82,0.524,31,49,0.633,12,33,0.364,11,18,0.611,109
1201,MIL,2022-11-04,115,@,MIN,1,240,41,85,0.482,24,47,0.511,17,38,0.447,16,28,0.571,115,39,92,0.424,28,51,0.549,11,41,0.268,13,17,0.765,102
1202,SAC,2022-10-31,115,@,CHO,1,240,37,85,0.435,20,41,0.488,17,44,0.386,24,28,0.857,115,43,84,0.512,29,55,0.527,14,29,0.483,8,14,0.571,108
1203,ATL,2022-10-29,115,@,MIL,0,240,45,94,0.479,32,65,0.492,13,29,0.448,12,15,0.8,115,45,92,0.489,31,56,0.554,14,36,0.389,19,29,0.655,123
1204,NYK,2022-10-24,115,,ORL,1,240,43,93,0.462,32,56,0.571,11,37,0.297,18,25,0.72,115,36,86,0.419,29,51,0.569,7,35,0.2,23,27,0.852,102
1205,SAS,2022-10-24,115,@,MIN,1,240,48,105,0.457,36,68,0.529,12,37,0.324,7,13,0.538,115,38,86,0.442,30,55,0.545,8,31,0.258,22,24,0.917,106
1206,DET,2022-10-22,115,@,IND,0,240,37,95,0.389,19,53,0.358,18,42,0.429,23,30,0.767,115,45,103,0.437,29,61,0.475,16,42,0.381,18,24,0.75,124
1207,MEM,2022-10-19,115,,NYK,1,265,42,108,0.389,25,58,0.431,17,50,0.34,14,23,0.609,115,44,109,0.404,35,72,0.486,9,37,0.243,15,18,0.833,112
1208,MIN,2022-10-19,115,,OKC,1,240,39,94,0.415,29,56,0.518,10,38,0.263,27,33,0.818,115,38,99,0.384,24,54,0.444,14,45,0.311,18,22,0.818,108
1209,POR,2022-10-19,115,@,SAC,1,240,39,88,0.443,28,60,0.467,11,28,0.393,26,33,0.788,115,39,85,0.459,22,41,0.537,17,44,0.386,13,19,0.684,108
1210,ATL,2023-04-09,114,@,BOS,0,240,44,97,0.454,33,58,0.569,11,39,0.282,15,19,0.789,114,42,89,0.472,17,35,0.486,25,54,0.463,11,14,0.786,120
1211,PHO,2023-04-09,114,,LAC,0,240,42,99,0.424,28,62,0.452,14,37,0.378,16,22,0.727,114,49,100,0.49,44,77,0.571,5,23,0.217,16,24,0.667,119
1212,HOU,2023-04-09,114,@,WAS,1,240,44,90,0.489,38,69,0.551,6,21,0.286,20,28,0.714,114,41,97,0.423,27,52,0.519,14,45,0.311,13,21,0.619,109
1213,DEN,2023-04-08,114,@,UTA,0,240,41,90,0.456,26,44,0.591,15,46,0.326,17,24,0.708,114,44,100,0.44,33,65,0.508,11,35,0.314,19,23,0.826,118
1214,MIL,2023-04-07,114,,MEM,0,240,42,92,0.457,21,43,0.488,21,49,0.429,9,11,0.818,114,53,93,0.57,33,51,0.647,20,42,0.476,11,15,0.733,137
1215,WAS,2023-04-07,114,,MIA,1,240,39,84,0.464,32,51,0.627,7,33,0.212,29,37,0.784,114,43,98,0.439,28,51,0.549,15,47,0.319,7,12,0.583,108
1216,OKC,2023-04-06,114,@,UTA,1,240,39,97,0.402,24,52,0.462,15,45,0.333,21,26,0.808,114,41,83,0.494,36,52,0.692,5,31,0.161,11,16,0.688,98
1217,LAC,2023-04-01,114,@,NOP,0,240,42,85,0.494,31,56,0.554,11,29,0.379,19,23,0.826,114,42,86,0.488,35,69,0.507,7,17,0.412,31,35,0.886,122
1218,UTA,2023-03-31,114,@,BOS,0,240,46,96,0.479,37,67,0.552,9,29,0.31,13,14,0.929,114,42,96,0.438,25,45,0.556,17,51,0.333,21,22,0.955,122
1219,POR,2023-03-31,114,,SAC,0,240,40,85,0.471,21,47,0.447,19,38,0.5,15,23,0.652,114,54,88,0.614,35,49,0.714,19,39,0.487,11,15,0.733,138
1220,HOU,2023-03-29,114,@,BRK,0,240,46,98,0.469,37,68,0.544,9,30,0.3,13,21,0.619,114,44,82,0.537,27,47,0.574,17,35,0.486,18,27,0.667,123
1221,TOR,2023-03-26,114,,WAS,1,240,45,98,0.459,34,67,0.507,11,31,0.355,13,16,0.813,114,38,86,0.442,22,50,0.44,16,36,0.444,12,20,0.6,104
1222,HOU,2023-03-24,114,@,MEM,0,240,47,87,0.54,40,64,0.625,7,23,0.304,13,21,0.619,114,57,93,0.613,32,51,0.627,25,42,0.595,12,14,0.857,151
1223,BRK,2023-03-23,114,,CLE,0,240,39,81,0.481,27,47,0.574,12,34,0.353,24,27,0.889,114,42,89,0.472,30,57,0.526,12,32,0.375,20,26,0.769,116
1224,TOR,2023-03-22,114,,IND,0,240,39,89,0.438,32,55,0.582,7,34,0.206,29,39,0.744,114,43,77,0.558,32,56,0.571,11,21,0.524,21,25,0.84,118
1225,HOU,2023-03-17,114,,NOP,1,240,43,88,0.489,32,56,0.571,11,32,0.344,17,24,0.708,114,39,82,0.476,27,54,0.5,12,28,0.429,22,25,0.88,112
1226,HOU,2023-03-15,114,,LAL,1,240,47,89,0.528,39,60,0.65,8,29,0.276,12,19,0.632,114,34,90,0.378,23,46,0.5,11,44,0.25,31,37,0.838,110
1227,CHI,2023-03-15,114,,SAC,0,240,38,97,0.392,22,55,0.4,16,42,0.381,22,25,0.88,114,38,78,0.487,20,36,0.556,18,42,0.429,23,29,0.793,117
1228,ORL,2023-03-14,114,@,SAS,0,240,44,97,0.454,34,68,0.5,10,29,0.345,16,21,0.762,114,48,85,0.565,26,44,0.591,22,41,0.537,14,18,0.778,132
1229,CLE,2023-03-12,114,@,CHO,1,240,41,87,0.471,34,60,0.567,7,27,0.259,25,34,0.735,114,41,80,0.513,31,59,0.525,10,21,0.476,16,22,0.727,108
1230,MIA,2023-03-11,114,@,ORL,0,265,42,94,0.447,31,57,0.544,11,37,0.297,19,20,0.95,114,48,99,0.485,35,62,0.565,13,37,0.351,17,20,0.85,126
1231,ATL,2023-03-10,114,@,WAS,1,240,42,95,0.442,27,64,0.422,15,31,0.484,15,19,0.789,114,43,88,0.489,36,61,0.59,7,27,0.259,14,18,0.778,107
1232,BOS,2023-03-06,114,@,CLE,0,265,42,101,0.416,26,53,0.491,16,48,0.333,14,21,0.667,114,43,96,0.448,31,62,0.5,12,34,0.353,20,25,0.8,118
1233,CLE,2023-03-04,114,,DET,1,240,45,91,0.495,31,57,0.544,14,34,0.412,10,18,0.556,114,33,81,0.407,27,57,0.474,6,24,0.25,18,25,0.72,90
1234,HOU,2023-02-26,114,@,POR,0,240,45,100,0.45,38,74,0.514,7,26,0.269,17,25,0.68,114,42,77,0.545,22,38,0.579,20,39,0.513,27,35,0.771,131
1235,WAS,2023-02-16,114,@,MIN,1,240,43,95,0.453,29,60,0.483,14,35,0.4,14,17,0.824,114,39,95,0.411,31,66,0.47,8,29,0.276,20,22,0.909,106
1236,SAC,2023-02-10,114,,DAL,0,240,39,72,0.542,30,45,0.667,9,27,0.333,27,32,0.844,114,43,88,0.489,25,45,0.556,18,43,0.419,18,19,0.947,122
1237,CLE,2023-02-06,114,@,WAS,1,240,44,78,0.564,32,49,0.653,12,29,0.414,14,20,0.7,114,35,82,0.427,29,54,0.537,6,28,0.214,15,19,0.789,91
1238,OKC,2023-02-06,114,@,GSW,0,240,44,91,0.484,33,59,0.559,11,32,0.344,15,21,0.714,114,56,97,0.577,30,47,0.638,26,50,0.52,3,7,0.429,141
1239,CHI,2023-02-02,114,,CHO,1,240,41,79,0.519,30,51,0.588,11,28,0.393,21,26,0.808,114,39,93,0.419,32,58,0.552,7,35,0.2,13,15,0.867,98
1240,GSW,2023-02-01,114,@,MIN,0,265,38,91,0.418,27,56,0.482,11,35,0.314,27,34,0.794,114,46,106,0.434,32,56,0.571,14,50,0.28,13,24,0.542,119
1241,PHO,2023-01-30,114,,TOR,1,240,43,87,0.494,32,59,0.542,11,28,0.393,17,21,0.81,114,40,89,0.449,31,56,0.554,9,33,0.273,17,19,0.895,106
1242,DET,2023-01-28,114,,HOU,0,240,38,83,0.458,24,45,0.533,14,38,0.368,24,31,0.774,114,44,92,0.478,36,65,0.554,8,27,0.296,21,27,0.778,117
1243,MIN,2023-01-23,114,@,HOU,0,240,41,91,0.451,25,49,0.51,16,42,0.381,16,22,0.727,114,44,88,0.5,33,58,0.569,11,30,0.367,20,30,0.667,119
1244,CLE,2023-01-21,114,,MIL,1,240,48,86,0.558,41,64,0.641,7,22,0.318,11,17,0.647,114,39,86,0.453,25,47,0.532,14,39,0.359,10,11,0.909,102
1245,CLE,2023-01-20,114,,GSW,0,240,42,84,0.5,28,51,0.549,14,33,0.424,16,19,0.842,114,42,86,0.488,19,43,0.442,23,43,0.535,13,19,0.684,120
1246,CLE,2023-01-18,114,@,MEM,0,240,42,82,0.512,26,47,0.553,16,35,0.457,14,21,0.667,114,44,97,0.454,33,63,0.524,11,34,0.324,16,22,0.727,115
1247,ATL,2023-01-14,114,@,TOR,1,240,43,84,0.512,32,57,0.561,11,27,0.407,17,18,0.944,114,36,87,0.414,29,58,0.5,7,29,0.241,24,30,0.8,103
1248,HOU,2023-01-13,114,@,SAC,0,240,43,91,0.473,31,54,0.574,12,37,0.324,16,25,0.64,114,47,86,0.547,27,46,0.587,20,40,0.5,25,29,0.862,139
1249,CHO,2023-01-12,114,@,TOR,0,240,41,77,0.532,28,44,0.636,13,33,0.394,19,27,0.704,114,43,83,0.518,33,55,0.6,10,28,0.357,28,36,0.778,124
1250,PHI,2023-01-12,114,,OKC,0,240,39,88,0.443,28,52,0.538,11,36,0.306,25,27,0.926,114,44,86,0.512,30,53,0.566,14,33,0.424,31,33,0.939,133
1251,MIL,2023-01-11,114,@,ATL,1,240,45,98,0.459,27,50,0.54,18,48,0.375,6,11,0.545,114,39,87,0.448,28,57,0.491,11,30,0.367,16,18,0.889,105
1252,NOP,2023-01-11,114,@,BOS,0,240,45,87,0.517,34,57,0.596,11,30,0.367,13,17,0.765,114,44,91,0.484,29,47,0.617,15,44,0.341,22,25,0.88,125
1253,CLE,2023-01-10,114,@,UTA,0,240,42,90,0.467,32,53,0.604,10,37,0.27,20,24,0.833,114,38,87,0.437,28,51,0.549,10,36,0.278,30,37,0.811,116
1254,ATL,2023-01-06,114,@,LAL,0,240,44,96,0.458,35,65,0.538,9,31,0.29,17,22,0.773,114,51,93,0.548,35,58,0.603,16,35,0.457,12,16,0.75,130
1255,HOU,2023-01-05,114,,UTA,0,240,38,92,0.413,23,50,0.46,15,42,0.357,23,26,0.885,114,46,93,0.495,27,45,0.6,19,48,0.396,20,21,0.952,131
1256,SAS,2023-01-04,114,@,NYK,0,240,41,82,0.5,30,54,0.556,11,28,0.393,21,26,0.808,114,45,94,0.479,35,63,0.556,10,31,0.323,17,26,0.654,117
1257,TOR,2023-01-02,114,@,IND,0,240,41,91,0.451,27,49,0.551,14,42,0.333,18,23,0.783,114,45,93,0.484,35,66,0.53,10,27,0.37,22,26,0.846,122
1258,MIN,2022-12-30,114,@,MIL,0,240,40,92,0.435,32,62,0.516,8,30,0.267,26,34,0.765,114,43,93,0.462,29,54,0.537,14,39,0.359,23,33,0.697,123
1259,HOU,2022-12-29,114,@,DAL,0,240,38,86,0.442,26,52,0.5,12,34,0.353,26,37,0.703,114,47,91,0.516,29,46,0.63,18,45,0.4,17,25,0.68,129
1260,ATL,2022-12-27,114,@,IND,0,240,40,89,0.449,28,59,0.475,12,30,0.4,22,29,0.759,114,47,92,0.511,34,57,0.596,13,35,0.371,22,27,0.815,129
1261,SAS,2022-12-27,114,@,OKC,0,240,46,99,0.465,36,70,0.514,10,29,0.345,12,14,0.857,114,46,86,0.535,33,62,0.532,13,24,0.542,25,31,0.806,130
1262,LAC,2022-12-23,114,@,PHI,0,240,41,81,0.506,27,43,0.628,14,38,0.368,18,23,0.783,114,47,88,0.534,35,59,0.593,12,29,0.414,13,14,0.929,119
1263,CLE,2022-12-21,114,,MIL,1,240,41,85,0.482,31,53,0.585,10,32,0.313,22,28,0.786,114,39,83,0.47,26,53,0.491,13,30,0.433,15,22,0.682,106
1264,NOP,2022-12-17,114,@,PHO,0,240,45,77,0.584,31,47,0.66,14,30,0.467,10,13,0.769,114,39,83,0.47,24,42,0.571,15,41,0.366,25,35,0.714,118
1265,NYK,2022-12-16,114,@,CHI,1,240,37,92,0.402,20,48,0.417,17,44,0.386,23,32,0.719,114,36,77,0.468,24,47,0.511,12,30,0.4,7,8,0.875,91
1266,OKC,2022-12-12,114,@,DAL,0,240,42,88,0.477,32,57,0.561,10,31,0.323,20,21,0.952,114,39,93,0.419,17,39,0.436,22,54,0.407,21,25,0.84,121
1267,LAC,2022-12-10,114,@,WAS,1,240,40,94,0.426,21,46,0.457,19,48,0.396,15,16,0.938,114,37,85,0.435,21,51,0.412,16,34,0.471,17,19,0.895,107
1268,MEM,2022-12-09,114,,DET,1,240,44,91,0.484,35,59,0.593,9,32,0.281,17,32,0.531,114,36,90,0.4,25,55,0.455,11,35,0.314,20,27,0.741,103
1269,ATL,2022-12-05,114,,OKC,0,240,44,102,0.431,31,64,0.484,13,38,0.342,13,17,0.765,114,43,95,0.453,31,61,0.508,12,34,0.353,23,24,0.958,121
1270,BRK,2022-12-02,114,,TOR,1,240,44,82,0.537,33,50,0.66,11,32,0.344,15,22,0.682,114,38,87,0.437,31,63,0.492,7,24,0.292,22,30,0.733,105
1271,IND,2022-11-30,114,@,SAC,0,240,40,100,0.4,28,63,0.444,12,37,0.324,22,30,0.733,114,48,95,0.505,32,52,0.615,16,43,0.372,25,29,0.862,137
1272,CHI,2022-11-28,114,@,UTA,1,240,43,93,0.462,37,71,0.521,6,22,0.273,22,25,0.88,114,41,85,0.482,22,36,0.611,19,49,0.388,6,15,0.4,107
1273,MIN,2022-11-27,114,,GSW,0,240,39,88,0.443,25,53,0.472,14,35,0.4,22,29,0.759,114,50,87,0.575,30,40,0.75,20,47,0.426,17,20,0.85,137
1274,LAC,2022-11-27,114,,IND,1,240,42,94,0.447,36,62,0.581,6,32,0.188,24,32,0.75,114,36,94,0.383,27,52,0.519,9,42,0.214,19,23,0.826,100
1275,DEN,2022-11-25,114,@,LAC,1,240,44,89,0.494,34,59,0.576,10,30,0.333,16,23,0.696,114,37,68,0.544,26,46,0.565,11,22,0.5,19,34,0.559,104
1276,CLE,2022-11-23,114,,POR,1,240,41,74,0.554,29,47,0.617,12,27,0.444,20,23,0.87,114,35,78,0.449,22,47,0.468,13,31,0.419,13,13,1.0,96
1277,UTA,2022-11-21,114,@,LAC,0,240,40,89,0.449,28,51,0.549,12,38,0.316,22,24,0.917,114,47,91,0.516,38,67,0.567,9,24,0.375,18,19,0.947,121
1278,CLE,2022-11-21,114,,ATL,1,240,42,70,0.6,32,51,0.627,10,19,0.526,20,23,0.87,114,38,87,0.437,27,53,0.509,11,34,0.324,15,17,0.882,102
1279,IND,2022-11-19,114,,ORL,1,240,41,90,0.456,23,44,0.523,18,46,0.391,14,19,0.737,114,39,91,0.429,23,49,0.469,16,42,0.381,19,26,0.731,113
1280,ORL,2022-11-11,114,,PHO,1,240,43,82,0.524,28,49,0.571,15,33,0.455,13,15,0.867,114,38,95,0.4,25,53,0.472,13,42,0.31,8,9,0.889,97
1281,LAL,2022-11-11,114,,SAC,0,240,42,88,0.477,32,63,0.508,10,25,0.4,20,26,0.769,114,45,87,0.517,33,51,0.647,12,36,0.333,18,21,0.857,120
1282,MEM,2022-11-11,114,,MIN,1,240,44,88,0.5,37,55,0.673,7,33,0.212,19,27,0.704,114,37,79,0.468,27,49,0.551,10,30,0.333,19,22,0.864,103
1283,LAC,2022-11-09,114,,LAL,1,240,41,81,0.506,29,48,0.604,12,33,0.364,20,26,0.769,114,40,88,0.455,30,56,0.536,10,32,0.313,11,17,0.647,101
1284,CLE,2022-11-06,114,@,LAL,1,240,37,84,0.44,29,52,0.558,8,32,0.25,32,36,0.889,114,40,87,0.46,32,60,0.533,8,27,0.296,12,21,0.571,100
1285,NOP,2022-11-04,114,,GSW,1,240,41,81,0.506,29,52,0.558,12,29,0.414,20,29,0.69,114,35,71,0.493,23,39,0.59,12,32,0.375,23,25,0.92,105
1286,CLE,2022-11-02,114,,BOS,1,265,42,100,0.42,31,61,0.508,11,39,0.282,19,24,0.792,114,38,93,0.409,27,52,0.519,11,41,0.268,26,27,0.963,113
1287,DAL,2022-10-30,114,,ORL,1,240,41,83,0.494,30,48,0.625,11,35,0.314,21,28,0.75,114,37,81,0.457,26,52,0.5,11,29,0.379,20,27,0.741,105
1288,GSW,2022-10-30,114,@,DET,0,240,39,92,0.424,27,53,0.509,12,39,0.308,24,25,0.96,114,40,83,0.482,26,50,0.52,14,33,0.424,34,38,0.895,128
1289,PHI,2022-10-29,114,@,CHI,1,240,39,79,0.494,25,50,0.5,14,29,0.483,22,27,0.815,114,36,80,0.45,25,49,0.51,11,31,0.355,26,29,0.897,109
1290,HOU,2022-10-24,114,,UTA,1,240,38,90,0.422,27,55,0.491,11,35,0.314,27,32,0.844,114,44,93,0.473,33,61,0.541,11,32,0.344,9,16,0.563,108
1291,SAS,2022-10-22,114,@,PHI,1,240,43,89,0.483,27,51,0.529,16,38,0.421,12,15,0.8,114,37,84,0.44,27,53,0.509,10,31,0.323,21,28,0.75,105
1292,WAS,2022-10-19,114,@,IND,1,240,42,92,0.457,31,61,0.508,11,31,0.355,19,24,0.792,114,39,97,0.402,24,55,0.436,15,42,0.357,14,21,0.667,107
1293,MIN,2023-04-09,113,,NOP,1,240,39,82,0.476,26,46,0.565,13,36,0.361,22,31,0.71,113,40,90,0.444,37,69,0.536,3,21,0.143,25,29,0.862,108
1294,NOP,2023-04-07,113,,NYK,1,240,42,79,0.532,32,51,0.627,10,28,0.357,19,20,0.95,113,38,88,0.432,24,45,0.533,14,43,0.326,15,20,0.75,105
1295,ORL,2023-04-04,113,,CLE,0,240,45,89,0.506,35,66,0.53,10,23,0.435,13,17,0.765,113,42,84,0.5,27,53,0.509,15,31,0.484,18,20,0.9,117
1296,MEM,2023-03-28,113,,ORL,1,240,42,88,0.477,30,54,0.556,12,34,0.353,17,23,0.739,113,41,100,0.41,27,51,0.529,14,49,0.286,12,15,0.8,108
1297,UTA,2023-03-25,113,@,SAC,0,240,47,91,0.516,38,63,0.603,9,28,0.321,10,16,0.625,113,44,95,0.463,28,52,0.538,16,43,0.372,17,21,0.81,121
1298,ORL,2023-03-18,113,@,LAC,1,240,42,84,0.5,32,53,0.604,10,31,0.323,19,25,0.76,113,42,90,0.467,36,68,0.529,6,22,0.273,18,24,0.75,108
1299,CHI,2023-03-18,113,,MIA,1,240,45,80,0.563,28,46,0.609,17,34,0.5,6,6,1.0,113,35,82,0.427,25,45,0.556,10,37,0.27,19,24,0.792,99
1300,ORL,2023-03-16,113,@,PHO,0,240,43,86,0.5,35,58,0.603,8,28,0.286,19,23,0.826,113,43,90,0.478,30,55,0.545,13,35,0.371,17,17,1.0,116
1301,BRK,2023-03-09,113,@,MIL,0,240,41,104,0.394,27,68,0.397,14,36,0.389,17,17,1.0,113,44,104,0.423,25,54,0.463,19,50,0.38,11,14,0.786,118
1302,CHO,2023-03-09,113,@,DET,1,240,43,86,0.5,35,62,0.565,8,24,0.333,19,32,0.594,113,40,89,0.449,33,68,0.485,7,21,0.333,16,20,0.8,103
1303,NOP,2023-03-08,113,,DAL,1,240,42,83,0.506,29,56,0.518,13,27,0.481,16,18,0.889,113,38,88,0.432,22,42,0.524,16,46,0.348,14,19,0.737,106
1304,TOR,2023-03-06,113,@,DEN,0,240,43,86,0.5,33,59,0.559,10,27,0.37,17,20,0.85,113,43,86,0.5,30,53,0.566,13,33,0.394,19,23,0.826,118
1305,LAL,2023-03-05,113,,GSW,1,240,42,95,0.442,31,62,0.5,11,33,0.333,18,22,0.818,113,36,91,0.396,18,39,0.462,18,52,0.346,15,18,0.833,105
1306,DEN,2023-03-03,113,,MEM,1,240,40,87,0.46,32,56,0.571,8,31,0.258,25,31,0.806,113,31,84,0.369,20,52,0.385,11,32,0.344,24,31,0.774,97
1307,MEM,2023-03-01,113,@,HOU,1,240,40,83,0.482,23,42,0.548,17,41,0.415,16,19,0.842,113,36,90,0.4,25,56,0.446,11,34,0.324,16,25,0.64,99
1308,CLE,2023-03-01,113,@,BOS,0,240,45,92,0.489,35,60,0.583,10,32,0.313,13,21,0.619,113,39,78,0.5,23,46,0.5,16,32,0.5,23,28,0.821,117
1309,MIN,2023-02-24,113,,CHO,0,240,46,93,0.495,35,60,0.583,11,33,0.333,10,16,0.625,113,43,92,0.467,33,64,0.516,10,28,0.357,25,28,0.893,121
1310,CHI,2023-02-15,113,@,IND,0,240,41,84,0.488,26,49,0.531,15,35,0.429,16,21,0.762,113,39,82,0.476,21,39,0.538,18,43,0.419,21,22,0.955,117
1311,ORL,2023-02-14,113,@,TOR,0,240,43,84,0.512,30,53,0.566,13,31,0.419,14,18,0.778,113,50,83,0.602,42,59,0.712,8,24,0.333,15,20,0.75,123
1312,IND,2023-02-11,113,@,WAS,0,240,43,95,0.453,29,55,0.527,14,40,0.35,13,17,0.765,113,48,75,0.64,36,49,0.735,12,26,0.462,19,22,0.864,127
1313,CLE,2023-02-08,113,,DET,1,240,43,87,0.494,37,61,0.607,6,26,0.231,21,25,0.84,113,30,81,0.37,22,49,0.449,8,32,0.25,17,18,0.944,85
1314,CHO,2023-02-05,113,,ORL,0,240,45,83,0.542,33,50,0.66,12,33,0.364,11,23,0.478,113,42,91,0.462,34,68,0.5,8,23,0.348,27,30,0.9,119
1315,DAL,2023-02-04,113,@,GSW,0,240,39,85,0.459,25,45,0.556,14,40,0.35,21,27,0.778,113,45,82,0.549,31,47,0.66,14,35,0.4,15,19,0.789,119
1316,MEM,2023-02-02,113,@,CLE,0,240,41,87,0.471,31,64,0.484,10,23,0.435,21,22,0.955,113,49,91,0.538,35,62,0.565,14,29,0.483,16,22,0.727,128
1317,NOP,2023-01-31,113,@,DEN,0,240,42,85,0.494,34,58,0.586,8,27,0.296,21,25,0.84,113,43,87,0.494,27,51,0.529,16,36,0.444,20,24,0.833,122
1318,ATL,2023-01-28,113,,LAC,0,240,45,95,0.474,38,68,0.559,7,27,0.259,16,20,0.8,113,42,80,0.525,23,41,0.561,19,39,0.487,17,19,0.895,120
1319,WAS,2023-01-28,113,@,NOP,1,240,40,88,0.455,29,52,0.558,11,36,0.306,22,29,0.759,113,39,92,0.424,31,63,0.492,8,29,0.276,17,19,0.895,103
1320,CLE,2023-01-26,113,@,HOU,1,240,40,87,0.46,25,51,0.49,15,36,0.417,18,22,0.818,113,39,76,0.513,34,55,0.618,5,21,0.238,12,20,0.6,95
1321,LAL,2023-01-25,113,,SAS,1,240,40,90,0.444,30,57,0.526,10,33,0.303,23,30,0.767,113,40,106,0.377,32,72,0.444,8,34,0.235,16,18,0.889,104
1322,TOR,2023-01-25,113,@,SAC,1,240,48,97,0.495,36,57,0.632,12,40,0.3,5,7,0.714,113,35,73,0.479,22,41,0.537,13,32,0.406,12,13,0.923,95
1323,ORL,2023-01-23,113,,BOS,1,240,43,84,0.512,32,57,0.561,11,27,0.407,16,24,0.667,113,36,83,0.434,18,37,0.486,18,46,0.391,8,11,0.727,98
1324,MIN,2023-01-21,113,,HOU,1,240,38,83,0.458,21,42,0.5,17,41,0.415,20,24,0.833,113,38,79,0.481,29,55,0.527,9,24,0.375,19,33,0.576,104
1325,OKC,2023-01-20,113,@,SAC,0,240,45,93,0.484,29,53,0.547,16,40,0.4,7,11,0.636,113,41,87,0.471,29,49,0.592,12,38,0.316,24,28,0.857,118
1326,POR,2023-01-17,113,@,DEN,0,240,38,83,0.458,25,43,0.581,13,40,0.325,24,25,0.96,113,44,88,0.5,33,56,0.589,11,32,0.344,23,28,0.821,122
1327,MIA,2023-01-16,113,@,ATL,0,240,43,89,0.483,35,58,0.603,8,31,0.258,19,20,0.95,113,45,76,0.592,32,49,0.653,13,27,0.481,18,22,0.818,121
1328,CLE,2023-01-16,113,,NOP,1,240,39,80,0.488,30,52,0.577,9,28,0.321,26,33,0.788,113,38,75,0.507,28,48,0.583,10,27,0.37,17,22,0.773,103
1329,PHI,2023-01-15,113,@,LAL,1,240,43,85,0.506,31,51,0.608,12,34,0.353,15,19,0.789,113,48,87,0.552,42,67,0.627,6,20,0.3,10,13,0.769,112
1330,ATL,2023-01-13,113,@,IND,1,240,41,94,0.436,25,61,0.41,16,33,0.485,15,21,0.714,113,40,101,0.396,33,71,0.465,7,30,0.233,24,29,0.828,111
1331,SAS,2023-01-13,113,,GSW,0,240,40,88,0.455,32,66,0.485,8,22,0.364,25,34,0.735,113,55,101,0.545,37,53,0.698,18,48,0.375,16,20,0.8,144
1332,POR,2023-01-12,113,,CLE,0,240,40,78,0.513,29,45,0.644,11,33,0.333,22,29,0.759,113,44,89,0.494,37,67,0.552,7,22,0.318,24,31,0.774,119
1333,IND,2023-01-11,113,@,NYK,0,240,43,90,0.478,31,51,0.608,12,39,0.308,15,21,0.714,113,38,84,0.452,23,42,0.548,15,42,0.357,28,33,0.848,119
1334,GSW,2023-01-10,113,,PHO,0,240,37,96,0.385,19,48,0.396,18,48,0.375,21,27,0.778,113,41,90,0.456,27,59,0.458,14,31,0.452,29,31,0.935,125
1335,LAC,2023-01-10,113,,DAL,1,240,39,86,0.453,27,55,0.491,12,31,0.387,23,30,0.767,113,30,69,0.435,18,31,0.581,12,38,0.316,29,36,0.806,101
1336,SAS,2023-01-09,113,@,MEM,0,240,44,97,0.454,33,65,0.508,11,32,0.344,14,16,0.875,113,45,91,0.495,34,65,0.523,11,26,0.423,20,35,0.571,121
1337,MIN,2023-01-04,113,,POR,1,240,39,76,0.513,30,52,0.577,9,24,0.375,26,36,0.722,113,33,75,0.44,24,46,0.522,9,29,0.31,31,42,0.738,106
1338,WAS,2023-01-03,113,@,MIL,0,240,42,97,0.433,34,70,0.486,8,27,0.296,21,23,0.913,113,48,100,0.48,37,60,0.617,11,40,0.275,16,17,0.941,123
1339,TOR,2022-12-30,113,,PHO,1,240,40,81,0.494,29,48,0.604,11,33,0.333,22,26,0.846,113,35,71,0.493,21,41,0.512,14,30,0.467,20,23,0.87,104
1340,OKC,2022-12-29,113,@,CHO,0,240,42,99,0.424,31,63,0.492,11,36,0.306,18,21,0.857,113,46,84,0.548,36,52,0.692,10,32,0.313,19,29,0.655,121
1341,MIL,2022-12-28,113,@,CHI,0,265,41,110,0.373,32,66,0.485,9,44,0.205,22,32,0.688,113,42,92,0.457,33,69,0.478,9,23,0.391,26,30,0.867,119
1342,DEN,2022-12-27,113,@,SAC,1,240,41,86,0.477,28,49,0.571,13,37,0.351,18,21,0.857,113,40,82,0.488,30,47,0.638,10,35,0.286,16,19,0.842,106
1343,TOR,2022-12-27,113,,LAC,0,240,43,84,0.512,37,61,0.607,6,23,0.261,21,26,0.808,113,45,93,0.484,30,55,0.545,15,38,0.395,19,23,0.826,124
1344,NOP,2022-12-26,113,,IND,1,240,41,90,0.456,29,50,0.58,12,40,0.3,19,24,0.792,113,35,83,0.422,26,48,0.542,9,35,0.257,14,20,0.7,93
1345,CHO,2022-12-26,113,@,POR,0,240,41,103,0.398,29,67,0.433,12,36,0.333,19,25,0.76,113,43,86,0.5,29,48,0.604,14,38,0.368,24,28,0.857,124
1346,MIA,2022-12-26,113,,MIN,1,240,47,102,0.461,34,53,0.642,13,49,0.265,6,8,0.75,113,43,79,0.544,28,45,0.622,15,34,0.441,9,14,0.643,110
1347,SAS,2022-12-23,113,@,ORL,0,240,44,97,0.454,32,59,0.542,12,38,0.316,13,18,0.722,113,50,87,0.575,33,55,0.6,17,32,0.531,16,20,0.8,133
1348,TOR,2022-12-21,113,@,NYK,1,240,42,94,0.447,33,60,0.55,9,34,0.265,20,22,0.909,113,42,76,0.553,31,50,0.62,11,26,0.423,11,18,0.611,106
1349,PHI,2022-12-21,113,,DET,1,240,41,93,0.441,30,56,0.536,11,37,0.297,20,22,0.909,113,31,79,0.392,25,56,0.446,6,23,0.261,25,34,0.735,93
1350,GSW,2022-12-21,113,@,BRK,0,240,41,83,0.494,29,50,0.58,12,33,0.364,19,25,0.76,113,54,84,0.643,33,51,0.647,21,33,0.636,14,16,0.875,143
1351,WAS,2022-12-20,113,@,PHO,1,240,38,80,0.475,27,53,0.509,11,27,0.407,26,37,0.703,113,41,89,0.461,28,57,0.491,13,32,0.406,15,19,0.789,110
1352,CHI,2022-12-20,113,@,MIA,1,240,40,73,0.548,27,42,0.643,13,31,0.419,20,24,0.833,113,38,81,0.469,23,37,0.622,15,44,0.341,12,17,0.706,103
1353,DET,2022-12-16,113,,SAC,0,240,39,85,0.459,29,56,0.518,10,29,0.345,25,31,0.806,113,43,82,0.524,31,51,0.608,12,31,0.387,24,29,0.828,122
1354,LAC,2022-12-12,113,,BOS,1,240,44,90,0.489,34,65,0.523,10,25,0.4,15,21,0.714,113,33,76,0.434,24,37,0.649,9,39,0.231,18,26,0.692,93
1355,CHO,2022-12-11,113,@,PHI,0,240,38,93,0.409,27,63,0.429,11,30,0.367,26,30,0.867,113,46,83,0.554,33,56,0.589,13,27,0.481,26,32,0.813,131
1356,ORL,2022-12-09,113,,TOR,1,240,42,71,0.592,32,45,0.711,10,26,0.385,19,21,0.905,113,36,85,0.424,26,50,0.52,10,35,0.286,27,33,0.818,109
1357,LAL,2022-12-07,113,@,TOR,0,240,37,87,0.425,30,54,0.556,7,33,0.212,32,35,0.914,113,47,106,0.443,35,63,0.556,12,43,0.279,20,24,0.833,126
1358,SAC,2022-12-07,113,@,MIL,0,240,43,91,0.473,31,53,0.585,12,38,0.316,15,16,0.938,113,46,96,0.479,32,63,0.508,14,33,0.424,20,24,0.833,126
1359,NYK,2022-12-07,113,,ATL,1,240,37,83,0.446,20,47,0.426,17,36,0.472,22,24,0.917,113,32,85,0.376,26,49,0.531,6,36,0.167,19,24,0.792,89
1360,BRK,2022-11-30,113,,WAS,1,240,39,84,0.464,28,58,0.483,11,26,0.423,24,26,0.923,113,39,89,0.438,33,65,0.508,6,24,0.25,23,34,0.676,107
1361,CHI,2022-11-30,113,@,PHO,0,240,41,82,0.5,37,57,0.649,4,25,0.16,27,33,0.818,113,49,93,0.527,34,60,0.567,15,33,0.455,19,21,0.905,132
1362,CLE,2022-11-30,113,,PHI,1,240,45,74,0.608,30,45,0.667,15,29,0.517,8,10,0.8,113,32,77,0.416,26,51,0.51,6,26,0.231,15,18,0.833,85
1363,GSW,2022-11-29,113,@,DAL,0,240,42,88,0.477,31,45,0.689,11,43,0.256,18,23,0.783,113,42,91,0.462,27,47,0.574,15,44,0.341,17,27,0.63,116
1364,HOU,2022-11-28,113,@,DEN,0,240,39,85,0.459,23,41,0.561,16,44,0.364,19,25,0.76,113,50,88,0.568,38,58,0.655,12,30,0.4,17,20,0.85,129
1365,PHO,2022-11-26,113,,UTA,1,240,42,92,0.457,36,70,0.514,6,22,0.273,23,30,0.767,113,40,79,0.506,27,47,0.574,13,32,0.406,19,25,0.76,112
1366,MIL,2022-11-23,113,,CHI,0,240,41,90,0.456,29,52,0.558,12,38,0.316,19,25,0.76,113,43,87,0.494,25,45,0.556,18,42,0.429,14,18,0.778,118
1367,MIA,2022-11-23,113,,WAS,1,240,39,93,0.419,23,52,0.442,16,41,0.39,19,22,0.864,113,42,89,0.472,32,51,0.627,10,38,0.263,11,19,0.579,105
1368,SAC,2022-11-22,113,@,MEM,1,240,39,90,0.433,24,45,0.533,15,45,0.333,20,27,0.741,113,41,91,0.451,33,61,0.541,8,30,0.267,19,30,0.633,109
1369,CLE,2022-11-20,113,,MIA,1,240,44,83,0.53,31,46,0.674,13,37,0.351,12,16,0.75,113,31,80,0.388,25,49,0.51,6,31,0.194,19,22,0.864,87
1370,ORL,2022-11-19,113,@,IND,0,240,39,91,0.429,23,49,0.469,16,42,0.381,19,26,0.731,113,41,90,0.456,23,44,0.523,18,46,0.391,14,19,0.737,114
1371,POR,2022-11-19,113,,UTA,0,240,39,83,0.47,26,41,0.634,13,42,0.31,22,27,0.815,113,42,91,0.462,28,52,0.538,14,39,0.359,20,23,0.87,118
1372,MIL,2022-11-16,113,,CLE,1,240,41,86,0.477,25,47,0.532,16,39,0.41,15,27,0.556,113,36,84,0.429,24,56,0.429,12,28,0.429,14,17,0.824,98
1373,CHO,2022-11-16,113,,IND,0,240,43,94,0.457,31,61,0.508,12,33,0.364,15,18,0.833,113,44,82,0.537,33,54,0.611,11,28,0.393,26,31,0.839,125
1374,NOP,2022-11-15,113,,MEM,1,240,43,91,0.473,25,53,0.472,18,38,0.474,9,12,0.75,113,38,92,0.413,29,57,0.509,9,35,0.257,17,25,0.68,102
1375,MIA,2022-11-14,113,,PHO,1,240,38,83,0.458,23,50,0.46,15,33,0.455,22,25,0.88,113,48,99,0.485,34,63,0.54,14,36,0.389,2,4,0.5,112
1376,TOR,2022-11-11,113,@,OKC,0,240,38,88,0.432,27,58,0.466,11,30,0.367,26,36,0.722,113,52,93,0.559,37,57,0.649,15,36,0.417,13,17,0.765,132
1377,WAS,2022-11-10,113,,DAL,1,240,41,84,0.488,29,54,0.537,12,30,0.4,19,20,0.95,113,37,86,0.43,19,39,0.487,18,47,0.383,13,21,0.619,105
1378,SAC,2022-11-07,113,@,GSW,0,240,37,91,0.407,23,51,0.451,14,40,0.35,25,29,0.862,113,44,88,0.5,30,50,0.6,14,38,0.368,14,21,0.667,116
1379,TOR,2022-11-06,113,,CHI,1,240,44,103,0.427,34,66,0.515,10,37,0.27,15,20,0.75,113,40,88,0.455,27,52,0.519,13,36,0.361,11,13,0.846,104
1380,LAC,2022-11-04,113,@,SAS,1,240,42,80,0.525,27,47,0.574,15,33,0.455,14,19,0.737,113,42,88,0.477,30,57,0.526,12,31,0.387,10,18,0.556,106
1381,BOS,2022-11-02,113,@,CLE,0,265,38,93,0.409,27,52,0.519,11,41,0.268,26,27,0.963,113,42,100,0.42,31,61,0.508,11,39,0.282,19,24,0.792,114
1382,MIA,2022-10-29,113,@,SAC,0,240,38,89,0.427,27,61,0.443,11,28,0.393,26,31,0.839,113,42,76,0.553,28,45,0.622,14,31,0.452,21,29,0.724,119
1383,GSW,2022-10-29,113,@,CHO,0,265,44,100,0.44,31,56,0.554,13,44,0.295,12,16,0.75,113,43,102,0.422,33,71,0.465,10,31,0.323,24,31,0.774,120
1384,ORL,2022-10-28,113,,CHO,1,240,42,85,0.494,32,48,0.667,10,37,0.27,19,26,0.731,113,33,86,0.384,22,48,0.458,11,38,0.289,16,24,0.667,93
1385,DET,2022-10-26,113,,ATL,0,240,42,91,0.462,28,59,0.475,14,32,0.438,15,22,0.682,113,45,91,0.495,37,69,0.536,8,22,0.364,20,25,0.8,118
1386,NOP,2022-10-25,113,,DAL,1,240,44,76,0.579,32,49,0.653,12,27,0.444,13,18,0.722,113,41,82,0.5,29,43,0.674,12,39,0.308,17,24,0.708,111
1387,POR,2022-10-21,113,,PHO,1,265,36,82,0.439,26,53,0.491,10,29,0.345,31,36,0.861,113,43,94,0.457,33,67,0.493,10,27,0.37,15,21,0.714,111
1388,DET,2022-10-19,113,,ORL,1,240,40,94,0.426,26,56,0.464,14,38,0.368,19,24,0.792,113,42,86,0.488,31,56,0.554,11,30,0.367,14,19,0.737,109
1389,DAL,2023-04-07,112,,CHI,0,240,42,93,0.452,24,38,0.632,18,55,0.327,10,13,0.769,112,46,88,0.523,35,57,0.614,11,31,0.355,12,18,0.667,115
1390,HOU,2023-04-07,112,@,CHO,1,240,42,89,0.472,35,68,0.515,7,21,0.333,21,28,0.75,112,38,88,0.432,25,47,0.532,13,41,0.317,20,27,0.741,109
1391,DEN,2023-04-02,112,,GSW,1,240,44,100,0.44,35,67,0.522,9,33,0.273,15,18,0.833,112,42,105,0.4,33,63,0.524,9,42,0.214,17,17,1.0,110
1392,CHI,2023-03-27,112,@,LAC,0,240,44,82,0.537,35,59,0.593,9,23,0.391,15,21,0.714,112,48,81,0.593,28,41,0.683,20,40,0.5,8,16,0.5,124
1393,POR,2023-03-26,112,,OKC,0,240,39,82,0.476,25,50,0.5,14,32,0.438,20,27,0.741,112,41,94,0.436,29,59,0.492,12,35,0.343,24,28,0.857,118
1394,PHI,2023-03-24,112,@,GSW,0,240,38,78,0.487,30,49,0.612,8,29,0.276,28,34,0.824,112,42,88,0.477,24,38,0.632,18,50,0.36,18,24,0.75,120
1395,WAS,2023-03-21,112,@,ORL,0,240,42,83,0.506,32,51,0.627,10,32,0.313,18,23,0.783,112,43,80,0.538,31,53,0.585,12,27,0.444,24,25,0.96,122
1396,MEM,2023-03-20,112,,DAL,1,240,41,89,0.461,31,54,0.574,10,35,0.286,20,26,0.769,112,39,84,0.464,28,48,0.583,11,36,0.306,19,20,0.95,108
1397,MIA,2023-03-19,112,@,DET,1,240,38,79,0.481,25,40,0.625,13,39,0.333,23,25,0.92,112,38,82,0.463,28,50,0.56,10,32,0.313,14,17,0.824,100
1398,NOP,2023-03-17,112,@,HOU,0,240,39,82,0.476,27,54,0.5,12,28,0.429,22,25,0.88,112,43,88,0.489,32,56,0.571,11,32,0.344,17,24,0.708,114
1399,POR,2023-03-17,112,,BOS,0,240,38,79,0.481,24,41,0.585,14,38,0.368,22,31,0.71,112,41,87,0.471,26,45,0.578,15,42,0.357,29,35,0.829,126
1400,PHO,2023-03-13,112,@,GSW,0,240,46,95,0.484,42,74,0.568,4,21,0.19,16,22,0.727,112,45,83,0.542,26,44,0.591,19,39,0.487,14,24,0.583,123
1401,PHI,2023-03-12,112,,WAS,1,240,41,80,0.513,30,51,0.588,11,29,0.379,19,23,0.826,112,34,84,0.405,28,58,0.483,6,26,0.231,19,23,0.826,93
1402,NYK,2023-03-12,112,@,LAL,1,240,42,88,0.477,31,51,0.608,11,37,0.297,17,21,0.81,112,43,89,0.483,31,53,0.585,12,36,0.333,10,17,0.588,108
1403,MEM,2023-03-11,112,,DAL,1,240,41,86,0.477,31,48,0.646,10,38,0.263,20,24,0.833,112,39,85,0.459,24,42,0.571,15,43,0.349,15,23,0.652,108
1404,TOR,2023-03-10,112,@,LAL,0,240,46,92,0.5,36,64,0.563,10,28,0.357,10,13,0.769,112,45,80,0.563,32,50,0.64,13,30,0.433,19,19,1.0,122
1405,CHO,2023-03-07,112,@,NYK,1,240,42,85,0.494,30,53,0.566,12,32,0.375,16,21,0.762,112,38,89,0.427,27,49,0.551,11,40,0.275,18,24,0.75,105
1406,LAL,2023-03-07,112,,MEM,1,240,41,90,0.456,34,62,0.548,7,28,0.25,23,29,0.793,112,36,93,0.387,27,56,0.482,9,37,0.243,22,29,0.759,103
1407,HOU,2023-02-28,112,,DEN,0,240,48,97,0.495,39,66,0.591,9,31,0.29,7,10,0.7,112,53,92,0.576,37,55,0.673,16,37,0.432,11,16,0.688,133
1408,MEM,2023-02-25,112,,DEN,1,240,45,95,0.474,30,51,0.588,15,44,0.341,7,8,0.875,112,36,89,0.404,25,52,0.481,11,37,0.297,11,14,0.786,94
1409,MIL,2023-02-16,112,@,CHI,1,240,40,88,0.455,22,41,0.537,18,47,0.383,14,18,0.778,112,37,97,0.381,27,65,0.415,10,32,0.313,16,21,0.762,100
1410,CLE,2023-02-15,112,@,PHI,0,240,41,82,0.5,31,52,0.596,10,30,0.333,20,25,0.8,112,39,78,0.5,26,51,0.51,13,27,0.481,27,29,0.931,118
1411,DEN,2023-02-13,112,@,MIA,1,240,44,76,0.579,33,48,0.688,11,28,0.393,13,15,0.867,112,39,89,0.438,27,54,0.5,12,35,0.343,18,20,0.9,108
1412,TOR,2023-02-08,112,,SAS,1,240,43,88,0.489,33,60,0.55,10,28,0.357,16,21,0.762,112,35,87,0.402,26,55,0.473,9,32,0.281,19,27,0.704,98
1413,BRK,2023-02-07,112,,PHO,0,240,38,79,0.481,29,51,0.569,9,28,0.321,27,31,0.871,112,43,92,0.467,34,61,0.557,9,31,0.29,21,28,0.75,116
1414,MIN,2023-02-07,112,@,DEN,0,240,40,85,0.471,30,50,0.6,10,35,0.286,22,26,0.846,112,58,93,0.624,45,66,0.682,13,27,0.481,17,22,0.773,146
1415,CHO,2023-02-03,112,@,DET,0,240,40,90,0.444,31,56,0.554,9,34,0.265,23,30,0.767,112,44,86,0.512,30,54,0.556,14,32,0.438,16,23,0.696,118
1416,LAL,2023-02-02,112,@,IND,1,240,42,92,0.457,36,70,0.514,6,22,0.273,22,31,0.71,112,45,93,0.484,29,52,0.558,16,41,0.39,5,6,0.833,111
1417,HOU,2023-02-01,112,,OKC,1,240,41,94,0.436,34,71,0.479,7,23,0.304,23,31,0.742,112,38,103,0.369,26,60,0.433,12,43,0.279,18,22,0.818,106
1418,MEM,2023-02-01,112,,POR,0,240,41,87,0.471,32,50,0.64,9,37,0.243,21,28,0.75,112,41,87,0.471,27,51,0.529,14,36,0.389,26,27,0.963,122
1419,MEM,2023-01-29,112,,IND,1,240,43,89,0.483,34,52,0.654,9,37,0.243,17,22,0.773,112,36,79,0.456,27,47,0.574,9,32,0.281,19,21,0.905,100
1420,OKC,2023-01-27,112,,CLE,1,240,40,76,0.526,30,58,0.517,10,18,0.556,22,25,0.88,112,39,88,0.443,31,59,0.525,8,29,0.276,14,18,0.778,100
1421,PHO,2023-01-22,112,,MEM,1,240,39,88,0.443,26,53,0.491,13,35,0.371,21,25,0.84,112,40,92,0.435,29,60,0.483,11,32,0.344,19,27,0.704,110
1422,POR,2023-01-22,112,,LAL,0,240,37,86,0.43,20,40,0.5,17,46,0.37,21,25,0.84,112,45,86,0.523,35,56,0.625,10,30,0.333,21,27,0.778,121
1423,LAC,2023-01-22,112,@,DAL,1,240,35,77,0.455,23,49,0.469,12,28,0.429,30,31,0.968,112,35,80,0.438,22,45,0.489,13,35,0.371,15,26,0.577,98
1424,PHO,2023-01-21,112,,IND,1,240,38,91,0.418,26,60,0.433,12,31,0.387,24,35,0.686,112,36,96,0.375,23,59,0.39,13,37,0.351,22,26,0.846,107
1425,BRK,2023-01-19,112,@,PHO,0,240,43,82,0.524,32,56,0.571,11,26,0.423,15,25,0.6,112,39,85,0.459,28,57,0.491,11,28,0.393,28,41,0.683,117
1426,LAL,2023-01-15,112,,PHI,0,240,48,87,0.552,42,67,0.627,6,20,0.3,10,13,0.769,112,43,85,0.506,31,51,0.608,12,34,0.353,15,19,0.789,113
1427,OKC,2023-01-15,112,@,BRK,1,240,40,90,0.444,28,59,0.475,12,31,0.387,20,26,0.769,112,39,91,0.429,27,50,0.54,12,41,0.293,12,19,0.632,102
1428,IND,2023-01-14,112,,MEM,0,240,38,103,0.369,27,56,0.482,11,47,0.234,25,28,0.893,112,48,87,0.552,36,55,0.655,12,32,0.375,22,28,0.786,130
1429,NYK,2023-01-13,112,@,WAS,1,240,41,92,0.446,33,63,0.524,8,29,0.276,22,31,0.71,112,36,93,0.387,23,51,0.451,13,42,0.31,23,26,0.885,108
1430,UTA,2023-01-13,112,,ORL,1,240,36,83,0.434,25,48,0.521,11,35,0.314,29,40,0.725,112,42,96,0.438,28,60,0.467,14,36,0.389,10,16,0.625,108
1431,MIA,2023-01-10,112,,OKC,1,240,31,79,0.392,21,46,0.457,10,33,0.303,40,40,1.0,112,44,91,0.484,35,56,0.625,9,35,0.257,14,21,0.667,111
1432,WAS,2023-01-09,112,,NOP,0,240,42,82,0.512,28,48,0.583,14,34,0.412,14,18,0.778,112,49,93,0.527,39,67,0.582,10,26,0.385,24,31,0.774,132
1433,ATL,2023-01-08,112,@,LAC,1,240,44,89,0.494,36,63,0.571,8,26,0.308,16,20,0.8,112,37,95,0.389,27,65,0.415,10,30,0.333,24,31,0.774,108
1434,CLE,2023-01-08,112,@,PHO,1,240,45,78,0.577,34,49,0.694,11,29,0.379,11,17,0.647,112,37,84,0.44,23,58,0.397,14,26,0.538,10,11,0.909,98
1435,NYK,2023-01-06,112,@,TOR,1,240,39,83,0.47,23,46,0.5,16,37,0.432,18,26,0.692,112,35,83,0.422,25,54,0.463,10,29,0.345,28,35,0.8,108
1436,PHI,2023-01-06,112,,CHI,0,240,40,92,0.435,22,51,0.431,18,41,0.439,14,18,0.778,112,48,84,0.571,28,50,0.56,20,34,0.588,10,17,0.588,126
1437,BRK,2023-01-04,112,@,CHI,0,240,42,91,0.462,30,54,0.556,12,37,0.324,16,21,0.762,112,43,81,0.531,35,61,0.574,8,20,0.4,27,29,0.931,121
1438,LAL,2023-01-04,112,,MIA,1,240,40,81,0.494,32,54,0.593,8,27,0.296,24,30,0.8,112,43,95,0.453,35,66,0.53,8,29,0.276,15,21,0.714,109
1439,POR,2022-12-30,112,@,GSW,0,240,42,91,0.462,30,52,0.577,12,39,0.308,16,23,0.696,112,42,91,0.462,25,48,0.521,17,43,0.395,17,21,0.81,118
1440,GSW,2022-12-28,112,,UTA,1,240,37,87,0.425,21,42,0.5,16,45,0.356,22,27,0.815,112,37,91,0.407,22,45,0.489,15,46,0.326,18,26,0.692,107
1441,MIA,2022-12-28,112,,LAL,1,240,44,92,0.478,33,57,0.579,11,35,0.314,13,16,0.813,112,37,77,0.481,24,41,0.585,13,36,0.361,11,15,0.733,98
1442,NYK,2022-12-25,112,,PHI,0,240,43,90,0.478,31,58,0.534,12,32,0.375,14,17,0.824,112,39,77,0.506,21,38,0.553,18,39,0.462,23,29,0.793,119
1443,DAL,2022-12-23,112,@,HOU,1,240,36,80,0.45,20,36,0.556,16,44,0.364,24,27,0.889,112,37,81,0.457,29,55,0.527,8,26,0.308,24,28,0.857,106
1444,WAS,2022-12-22,112,@,UTA,0,240,46,82,0.561,39,61,0.639,7,21,0.333,13,17,0.765,112,42,86,0.488,26,51,0.51,16,35,0.457,20,21,0.952,120
1445,BOS,2022-12-21,112,,IND,0,240,39,101,0.386,26,60,0.433,13,41,0.317,21,25,0.84,112,46,98,0.469,28,59,0.475,18,39,0.462,7,9,0.778,117
1446,MIN,2022-12-16,112,@,OKC,1,240,43,87,0.494,31,62,0.5,12,25,0.48,14,25,0.56,112,41,88,0.466,30,51,0.588,11,37,0.297,17,21,0.81,110
1447,IND,2022-12-16,112,@,CLE,0,240,42,80,0.525,31,44,0.705,11,36,0.306,17,19,0.895,112,38,76,0.5,24,45,0.533,14,31,0.452,28,32,0.875,118
1448,SAS,2022-12-14,112,,POR,0,240,45,97,0.464,34,68,0.5,11,29,0.379,11,19,0.579,112,49,81,0.605,31,41,0.756,18,40,0.45,12,17,0.706,128
1449,MIN,2022-12-12,112,@,POR,0,240,46,93,0.495,36,66,0.545,10,27,0.37,10,19,0.526,112,48,89,0.539,27,43,0.628,21,46,0.457,16,21,0.762,133
1450,BRK,2022-12-12,112,@,WAS,1,240,44,89,0.494,36,62,0.581,8,27,0.296,16,18,0.889,112,37,79,0.468,26,48,0.542,11,31,0.355,15,22,0.682,100
1451,SAS,2022-12-12,112,,CLE,1,240,46,97,0.474,37,70,0.529,9,27,0.333,11,16,0.688,112,45,92,0.489,40,69,0.58,5,23,0.217,16,17,0.941,111
1452,NYK,2022-12-11,112,,SAC,1,240,40,89,0.449,32,54,0.593,8,35,0.229,24,27,0.889,112,33,83,0.398,23,44,0.523,10,39,0.256,23,35,0.657,99
1453,IND,2022-12-05,112,@,GSW,1,240,43,90,0.478,28,51,0.549,15,39,0.385,11,18,0.611,112,38,94,0.404,25,50,0.5,13,44,0.295,15,19,0.789,104
1454,DET,2022-12-04,112,,MEM,0,240,37,84,0.44,24,49,0.49,13,35,0.371,25,30,0.833,112,43,92,0.467,28,57,0.491,15,35,0.429,21,29,0.724,122
1455,LAC,2022-11-30,112,@,UTA,0,240,37,93,0.398,27,63,0.429,10,30,0.333,28,36,0.778,112,45,81,0.556,31,49,0.633,14,32,0.438,21,28,0.75,125
1456,POR,2022-11-29,112,,LAC,0,240,42,90,0.467,25,55,0.455,17,35,0.486,11,15,0.733,112,41,89,0.461,28,58,0.483,13,31,0.419,23,28,0.821,118
1457,UTA,2022-11-26,112,@,PHO,0,240,40,79,0.506,27,47,0.574,13,32,0.406,19,25,0.76,112,42,92,0.457,36,70,0.514,6,22,0.273,23,30,0.767,113
1458,BRK,2022-11-23,112,@,TOR,1,240,45,82,0.549,28,44,0.636,17,38,0.447,5,7,0.714,112,36,101,0.356,29,72,0.403,7,29,0.241,19,25,0.76,98
1459,DAL,2022-11-23,112,@,BOS,0,240,44,82,0.537,33,51,0.647,11,31,0.355,13,21,0.619,112,45,84,0.536,28,50,0.56,17,34,0.5,18,21,0.857,125
1460,MIN,2022-11-19,112,@,PHI,1,240,40,85,0.471,28,49,0.571,12,36,0.333,20,24,0.833,112,34,71,0.479,20,39,0.513,14,32,0.438,27,32,0.844,109
1461,SAS,2022-11-17,112,@,SAC,0,240,46,84,0.548,35,58,0.603,11,26,0.423,9,12,0.75,112,48,83,0.578,36,53,0.679,12,30,0.4,22,24,0.917,130
1462,TOR,2022-11-16,112,,MIA,1,240,44,86,0.512,37,60,0.617,7,26,0.269,17,22,0.773,112,36,66,0.545,23,31,0.742,13,35,0.371,19,22,0.864,104
1463,PHO,2022-11-14,112,@,MIA,0,240,48,99,0.485,34,63,0.54,14,36,0.389,2,4,0.5,112,38,83,0.458,23,50,0.46,15,33,0.455,22,25,0.88,113
1464,CHO,2022-11-14,112,@,ORL,1,240,42,88,0.477,35,53,0.66,7,35,0.2,21,24,0.875,112,36,88,0.409,22,52,0.423,14,36,0.389,19,23,0.826,105
1465,POR,2022-11-12,112,@,DAL,0,240,36,80,0.45,23,49,0.469,13,31,0.419,27,35,0.771,112,41,81,0.506,27,38,0.711,14,43,0.326,21,26,0.808,117
1466,UTA,2022-11-12,112,@,WAS,0,240,44,94,0.468,30,54,0.556,14,40,0.35,10,11,0.909,112,44,88,0.5,28,52,0.538,16,36,0.444,17,20,0.85,121
1467,DEN,2022-11-11,112,@,BOS,0,240,42,92,0.457,30,63,0.476,12,29,0.414,16,20,0.8,112,50,90,0.556,34,53,0.642,16,37,0.432,15,20,0.75,131
1468,DET,2022-11-11,112,@,NYK,0,240,37,80,0.463,30,49,0.612,7,31,0.226,31,41,0.756,112,42,94,0.447,32,54,0.593,10,40,0.25,27,29,0.931,121
1469,CHO,2022-11-10,112,@,MIA,0,265,43,88,0.489,29,49,0.592,14,39,0.359,12,20,0.6,112,39,90,0.433,29,54,0.537,10,36,0.278,29,36,0.806,117
1470,BRK,2022-11-09,112,,NYK,1,240,42,87,0.483,28,53,0.528,14,34,0.412,14,20,0.7,112,28,87,0.322,16,44,0.364,12,43,0.279,17,26,0.654,85
1471,DET,2022-11-09,112,@,BOS,0,240,37,89,0.416,30,56,0.536,7,33,0.212,31,40,0.775,112,47,88,0.534,29,42,0.69,18,46,0.391,16,21,0.762,128
1472,DET,2022-11-07,112,,OKC,1,240,39,93,0.419,30,60,0.5,9,33,0.273,25,33,0.758,112,41,102,0.402,31,69,0.449,10,33,0.303,11,17,0.647,103
1473,CLE,2022-11-04,112,@,DET,1,240,44,81,0.543,33,55,0.6,11,26,0.423,13,16,0.813,112,31,83,0.373,18,46,0.391,13,37,0.351,13,15,0.867,88
1474,ATL,2022-11-02,112,@,NYK,1,240,44,107,0.411,32,73,0.438,12,34,0.353,12,16,0.75,112,37,90,0.411,27,54,0.5,10,36,0.278,15,20,0.75,99
1475,BOS,2022-10-30,112,,WAS,1,240,36,79,0.456,15,32,0.469,21,47,0.447,19,20,0.95,112,38,98,0.388,31,66,0.47,7,32,0.219,11,16,0.688,94
1476,NOP,2022-10-30,112,@,LAC,1,240,46,93,0.495,31,57,0.544,15,36,0.417,5,8,0.625,112,36,86,0.419,25,47,0.532,11,39,0.282,8,13,0.615,91
1477,PHI,2022-10-28,112,@,TOR,1,240,43,82,0.524,27,44,0.614,16,38,0.421,10,11,0.909,112,33,86,0.384,24,47,0.511,9,39,0.231,15,24,0.625,90
1478,DET,2022-10-28,112,,ATL,0,240,37,86,0.43,30,54,0.556,7,32,0.219,31,38,0.816,112,55,97,0.567,43,68,0.632,12,29,0.414,14,18,0.778,136
1479,PHO,2022-10-23,112,@,LAC,1,240,43,93,0.462,28,51,0.549,15,42,0.357,11,12,0.917,112,36,82,0.439,27,50,0.54,9,32,0.281,14,20,0.7,95
1480,MIA,2022-10-22,112,,TOR,1,240,38,76,0.5,27,46,0.587,11,30,0.367,25,27,0.926,112,37,87,0.425,23,48,0.479,14,39,0.359,21,28,0.75,109
1481,CHO,2022-10-21,112,,NOP,0,240,44,97,0.454,31,63,0.492,13,34,0.382,11,14,0.786,112,42,89,0.472,34,67,0.507,8,22,0.364,32,37,0.865,124
1482,NYK,2022-10-19,112,@,MEM,0,265,44,109,0.404,35,72,0.486,9,37,0.243,15,18,0.833,112,42,108,0.389,25,58,0.431,17,50,0.34,14,23,0.609,115
1483,BRK,2023-04-02,111,,UTA,1,240,38,86,0.442,29,54,0.537,9,32,0.281,26,34,0.765,111,40,91,0.44,32,59,0.542,8,32,0.25,22,30,0.733,110
1484,MIN,2023-03-31,111,,LAL,0,240,41,95,0.432,28,56,0.5,13,39,0.333,16,19,0.842,111,45,90,0.5,36,68,0.529,9,22,0.409,24,30,0.8,123
1485,BOS,2023-03-28,111,@,WAS,0,240,45,93,0.484,34,49,0.694,11,44,0.25,10,11,0.909,111,54,99,0.545,41,62,0.661,13,37,0.351,9,13,0.692,130
1486,PHI,2023-03-27,111,@,DEN,0,240,43,89,0.483,35,59,0.593,8,30,0.267,17,22,0.773,111,43,85,0.506,32,53,0.604,11,32,0.344,19,22,0.864,116
1487,OKC,2023-03-24,111,@,LAL,0,240,40,92,0.435,26,56,0.464,14,36,0.389,17,19,0.895,111,42,91,0.462,30,57,0.526,12,34,0.353,20,28,0.714,116
1488,ORL,2023-03-23,111,,NYK,1,240,40,87,0.46,27,55,0.491,13,32,0.406,18,21,0.857,111,37,88,0.42,25,48,0.521,12,40,0.3,20,26,0.769,106
1489,PHO,2023-03-22,111,@,LAL,0,240,42,90,0.467,30,59,0.508,12,31,0.387,15,20,0.75,111,39,70,0.557,31,53,0.585,8,17,0.471,36,46,0.783,122
1490,TOR,2023-03-19,111,@,MIL,0,240,44,99,0.444,30,65,0.462,14,34,0.412,9,12,0.75,111,43,82,0.524,27,37,0.73,16,45,0.356,16,21,0.762,118
1491,LAL,2023-03-19,111,,ORL,1,240,36,78,0.462,23,46,0.5,13,32,0.406,26,32,0.813,111,41,102,0.402,31,64,0.484,10,38,0.263,13,17,0.765,105
1492,DAL,2023-03-17,111,@,LAL,1,240,40,79,0.506,24,45,0.533,16,34,0.471,15,19,0.789,111,43,84,0.512,38,64,0.594,5,20,0.25,19,31,0.613,110
1493,OKC,2023-03-16,111,@,TOR,0,240,40,94,0.426,27,63,0.429,13,31,0.419,18,20,0.9,111,47,97,0.485,33,65,0.508,14,32,0.438,20,28,0.714,128
1494,HOU,2023-03-13,111,,BOS,1,240,40,90,0.444,29,55,0.527,11,35,0.314,20,27,0.741,111,39,87,0.448,27,45,0.6,12,42,0.286,19,21,0.905,109
1495,HOU,2023-03-11,111,,CHI,0,240,41,85,0.482,25,51,0.49,16,34,0.471,13,17,0.765,111,44,86,0.512,29,54,0.537,15,32,0.469,16,22,0.727,119
1496,CHO,2023-03-11,111,,UTA,0,240,40,98,0.408,23,58,0.397,17,40,0.425,14,15,0.933,111,46,103,0.447,37,71,0.521,9,32,0.281,18,20,0.9,119
1497,WAS,2023-03-05,111,,MIL,0,240,46,108,0.426,38,77,0.494,8,31,0.258,11,12,0.917,111,39,83,0.47,17,34,0.5,22,49,0.449,17,22,0.773,117
1498,POR,2023-03-03,111,@,ATL,0,240,41,87,0.471,28,48,0.583,13,39,0.333,16,20,0.8,111,52,91,0.571,40,65,0.615,12,26,0.462,13,16,0.813,129
1499,LAL,2023-02-26,111,@,DAL,1,240,42,97,0.433,36,63,0.571,6,34,0.176,21,28,0.75,111,39,93,0.419,19,44,0.432,20,49,0.408,10,14,0.714,108
1500,GSW,2023-02-23,111,@,LAL,0,240,40,105,0.381,26,56,0.464,14,49,0.286,17,21,0.81,111,42,86,0.488,26,56,0.464,16,30,0.533,24,34,0.706,124
1501,UTA,2023-02-15,111,@,MEM,0,240,42,91,0.462,30,55,0.545,12,36,0.333,15,19,0.789,111,43,107,0.402,29,67,0.433,14,40,0.35,17,25,0.68,117
1502,IND,2023-02-08,111,@,MIA,0,240,38,78,0.487,23,45,0.511,15,33,0.455,20,28,0.714,111,37,79,0.468,31,60,0.517,6,19,0.316,36,39,0.923,116
1503,BOS,2023-02-06,111,@,DET,1,240,39,83,0.47,23,46,0.5,16,37,0.432,17,21,0.81,111,37,87,0.425,28,54,0.519,9,33,0.273,16,21,0.762,99
1504,UTA,2023-02-06,111,,DAL,0,240,41,87,0.471,35,56,0.625,6,31,0.194,23,26,0.885,111,41,88,0.466,26,49,0.531,15,39,0.385,27,31,0.871,124
1505,HOU,2023-02-03,111,,TOR,0,240,40,80,0.5,33,59,0.559,7,21,0.333,24,33,0.727,111,41,90,0.456,26,51,0.51,15,39,0.385,20,27,0.741,117
1506,DAL,2023-02-02,111,,NOP,1,240,37,85,0.435,23,44,0.523,14,41,0.341,23,29,0.793,111,42,84,0.5,37,64,0.578,5,20,0.25,17,21,0.81,106
1507,IND,2023-02-02,111,,LAL,0,240,45,93,0.484,29,52,0.558,16,41,0.39,5,6,0.833,111,42,92,0.457,36,70,0.514,6,22,0.273,22,31,0.71,112
1508,MIN,2023-01-30,111,,SAC,0,265,43,92,0.467,31,53,0.585,12,39,0.308,13,25,0.52,111,47,99,0.475,38,69,0.551,9,30,0.3,15,22,0.682,118
1509,DAL,2023-01-30,111,,DET,1,240,39,79,0.494,29,45,0.644,10,34,0.294,23,33,0.697,111,36,79,0.456,22,40,0.55,14,39,0.359,19,27,0.704,105
1510,MIN,2023-01-27,111,,MEM,1,240,44,86,0.512,31,51,0.608,13,35,0.371,10,15,0.667,111,38,93,0.409,30,60,0.5,8,33,0.242,16,19,0.842,100
1511,CHO,2023-01-26,111,,CHI,1,240,39,84,0.464,32,52,0.615,7,32,0.219,26,31,0.839,111,37,91,0.407,33,66,0.5,4,25,0.16,18,22,0.818,96
1512,MIN,2023-01-25,111,@,NOP,1,240,40,82,0.488,29,53,0.547,11,29,0.379,20,28,0.714,111,37,85,0.435,25,47,0.532,12,38,0.316,16,21,0.762,102
1513,CHI,2023-01-23,111,,ATL,1,240,44,95,0.463,33,61,0.541,11,34,0.324,12,18,0.667,111,39,85,0.459,29,52,0.558,10,33,0.303,12,19,0.632,100
1514,IND,2023-01-20,111,@,DEN,0,240,37,84,0.44,29,52,0.558,8,32,0.25,29,37,0.784,111,51,83,0.614,37,55,0.673,14,28,0.5,18,26,0.692,134
1515,LAL,2023-01-18,111,,SAC,0,240,43,89,0.483,32,55,0.582,11,34,0.324,14,18,0.778,111,43,87,0.494,34,57,0.596,9,30,0.3,21,27,0.778,116
1516,MIA,2023-01-14,111,,MIL,1,240,45,87,0.517,34,65,0.523,11,22,0.5,10,12,0.833,111,34,84,0.405,15,36,0.417,19,48,0.396,8,12,0.667,95
1517,IND,2023-01-13,111,,ATL,0,240,40,101,0.396,33,71,0.465,7,30,0.233,24,29,0.828,111,41,94,0.436,25,61,0.41,16,33,0.485,15,21,0.714,113
1518,OKC,2023-01-10,111,@,MIA,0,240,44,91,0.484,35,56,0.625,9,35,0.257,14,21,0.667,111,31,79,0.392,21,46,0.457,10,33,0.303,40,40,1.0,112
1519,ORL,2023-01-09,111,@,SAC,0,240,41,90,0.456,27,46,0.587,14,44,0.318,15,20,0.75,111,52,97,0.536,29,51,0.569,23,46,0.5,9,12,0.75,136
1520,MIL,2023-01-09,111,@,NYK,1,240,39,89,0.438,20,40,0.5,19,49,0.388,14,18,0.778,111,38,100,0.38,27,59,0.458,11,41,0.268,20,22,0.909,107
1521,DET,2023-01-08,111,,PHI,0,240,44,87,0.506,36,64,0.563,8,23,0.348,15,18,0.833,111,46,94,0.489,35,57,0.614,11,37,0.297,20,23,0.87,123
1522,CHO,2023-01-08,111,@,IND,0,240,38,88,0.432,27,55,0.491,11,33,0.333,24,27,0.889,111,38,87,0.437,25,49,0.51,13,38,0.342,27,33,0.818,116
1523,DEN,2023-01-02,111,@,MIN,0,240,42,91,0.462,31,62,0.5,11,29,0.379,16,20,0.8,111,45,87,0.517,32,51,0.627,13,36,0.361,21,27,0.778,124
1524,NOP,2023-01-02,111,@,PHI,0,240,42,84,0.5,31,55,0.564,11,29,0.379,16,20,0.8,111,41,86,0.477,26,51,0.51,15,35,0.429,23,28,0.821,120
1525,DAL,2023-01-02,111,@,HOU,1,240,34,81,0.42,21,38,0.553,13,43,0.302,30,34,0.882,111,38,82,0.463,29,53,0.547,9,29,0.31,21,29,0.724,106
1526,BOS,2023-01-01,111,@,DEN,0,240,40,87,0.46,31,54,0.574,9,33,0.273,22,27,0.815,111,45,79,0.57,28,49,0.571,17,30,0.567,16,18,0.889,123
1527,PHI,2022-12-27,111,@,WAS,0,240,39,84,0.464,33,53,0.623,6,31,0.194,27,31,0.871,111,39,85,0.459,28,52,0.538,11,33,0.333,27,31,0.871,116
1528,SAC,2022-12-23,111,,WAS,0,240,37,84,0.44,27,52,0.519,10,32,0.313,27,35,0.771,111,49,88,0.557,39,56,0.696,10,32,0.313,17,24,0.708,125
1529,IND,2022-12-23,111,@,MIA,1,240,40,83,0.482,19,36,0.528,21,47,0.447,10,14,0.714,111,41,95,0.432,28,62,0.452,13,33,0.394,13,14,0.929,108
1530,DET,2022-12-20,111,,UTA,0,240,41,81,0.506,32,56,0.571,9,25,0.36,20,27,0.741,111,47,93,0.505,27,47,0.574,20,46,0.435,12,19,0.632,126
1531,MIA,2022-12-17,111,@,SAS,1,240,42,82,0.512,31,52,0.596,11,30,0.367,16,23,0.696,111,33,77,0.429,23,50,0.46,10,27,0.37,25,33,0.758,101
1532,PHO,2022-12-15,111,@,LAC,1,240,44,95,0.463,35,63,0.556,9,32,0.281,14,18,0.778,111,34,90,0.378,22,57,0.386,12,33,0.364,15,21,0.714,95
1533,MIA,2022-12-15,111,@,HOU,1,240,39,88,0.443,23,41,0.561,16,47,0.34,17,23,0.739,111,44,94,0.468,35,61,0.574,9,33,0.273,11,17,0.647,108
1534,GSW,2022-12-13,111,@,MIL,0,240,38,95,0.4,18,45,0.4,20,50,0.4,15,19,0.789,111,45,82,0.549,33,53,0.623,12,29,0.414,26,32,0.813,128
1535,HOU,2022-12-13,111,,PHO,1,240,34,81,0.42,22,46,0.478,12,35,0.343,31,34,0.912,111,33,103,0.32,20,52,0.385,13,51,0.255,18,19,0.947,97
1536,CLE,2022-12-12,111,@,SAS,0,240,45,92,0.489,40,69,0.58,5,23,0.217,16,17,0.941,111,46,97,0.474,37,70,0.529,9,27,0.333,11,16,0.688,112
1537,ORL,2022-12-11,111,,TOR,1,240,36,77,0.468,22,46,0.478,14,31,0.452,25,31,0.806,111,30,75,0.4,24,50,0.48,6,25,0.24,33,38,0.868,99
1538,MIA,2022-12-10,111,,SAS,0,240,39,81,0.481,26,47,0.553,13,34,0.382,20,28,0.714,111,42,78,0.538,35,57,0.614,7,21,0.333,24,31,0.774,115
1539,WAS,2022-12-09,111,@,IND,0,240,41,77,0.532,31,48,0.646,10,29,0.345,19,25,0.76,111,43,85,0.506,25,44,0.568,18,41,0.439,17,20,0.85,121
1540,WAS,2022-12-07,111,@,CHI,0,240,41,84,0.488,32,53,0.604,9,31,0.29,20,29,0.69,111,45,90,0.5,35,67,0.522,10,23,0.435,15,17,0.882,115
1541,LAC,2022-12-07,111,@,ORL,0,265,39,95,0.411,24,54,0.444,15,41,0.366,18,26,0.692,111,40,95,0.421,32,67,0.478,8,28,0.286,28,31,0.903,116
1542,PHO,2022-12-05,111,@,DAL,0,240,40,91,0.44,27,54,0.5,13,37,0.351,18,26,0.692,111,44,84,0.524,24,43,0.558,20,41,0.488,22,26,0.846,130
1543,UTA,2022-12-03,111,,POR,0,240,38,84,0.452,25,48,0.521,13,36,0.361,22,28,0.786,111,41,85,0.482,31,60,0.517,10,25,0.4,24,31,0.774,116
1544,CHI,2022-12-02,111,@,GSW,0,240,43,93,0.462,34,66,0.515,9,27,0.333,16,24,0.667,111,42,87,0.483,22,37,0.595,20,50,0.4,15,23,0.652,119
1545,SAS,2022-11-30,111,@,OKC,0,240,41,92,0.446,31,55,0.564,10,37,0.27,19,25,0.76,111,48,94,0.511,39,67,0.582,9,27,0.333,14,21,0.667,119
1546,BRK,2022-11-27,111,,POR,1,240,41,78,0.526,26,43,0.605,15,35,0.429,14,18,0.778,111,35,79,0.443,23,46,0.5,12,33,0.364,15,22,0.682,97
1547,NOP,2022-11-25,111,@,MEM,0,240,37,86,0.43,27,55,0.491,10,31,0.323,27,31,0.871,111,47,91,0.516,29,53,0.547,18,38,0.474,20,27,0.741,132
1548,POR,2022-11-21,111,@,MIL,0,240,44,93,0.473,36,64,0.563,8,29,0.276,15,19,0.789,111,47,86,0.547,38,58,0.655,9,28,0.321,16,25,0.64,119
1549,GSW,2022-11-18,111,,NYK,1,240,41,91,0.451,23,41,0.561,18,50,0.36,11,20,0.55,111,30,87,0.345,21,53,0.396,9,34,0.265,32,34,0.941,101
1550,UTA,2022-11-15,111,,NYK,0,240,36,83,0.434,22,40,0.55,14,43,0.326,25,30,0.833,111,44,93,0.473,33,61,0.541,11,32,0.344,19,25,0.76,118
1551,DET,2022-11-14,111,,TOR,0,240,35,77,0.455,25,46,0.543,10,31,0.323,31,43,0.721,111,40,82,0.488,32,55,0.582,8,27,0.296,27,28,0.964,115
1552,SAS,2022-11-11,111,,MIL,1,240,43,85,0.506,31,54,0.574,12,31,0.387,13,15,0.867,111,32,98,0.327,20,55,0.364,12,43,0.279,17,23,0.739,93
1553,CHI,2022-11-09,111,,NOP,0,240,44,87,0.506,37,60,0.617,7,27,0.259,16,18,0.889,111,42,84,0.5,39,65,0.6,3,19,0.158,28,36,0.778,115
1554,CHI,2022-11-07,111,,TOR,1,240,42,80,0.525,33,52,0.635,9,28,0.321,18,22,0.818,111,36,85,0.424,27,57,0.474,9,28,0.321,16,22,0.727,97
1555,DAL,2022-11-04,111,,TOR,1,240,39,77,0.506,27,43,0.628,12,34,0.353,21,25,0.84,111,39,88,0.443,28,54,0.519,11,34,0.324,21,25,0.84,110
1556,MEM,2022-11-02,111,@,POR,1,240,38,83,0.458,25,55,0.455,13,28,0.464,22,27,0.815,111,36,89,0.404,23,56,0.411,13,33,0.394,21,26,0.808,106
1557,PHI,2022-11-02,111,,WAS,0,240,39,84,0.464,20,48,0.417,19,36,0.528,14,20,0.7,111,45,78,0.577,40,57,0.702,5,21,0.238,26,32,0.813,121
1558,WAS,2022-10-31,111,,PHI,0,240,38,81,0.469,28,56,0.5,10,25,0.4,25,26,0.962,111,46,83,0.554,34,53,0.642,12,30,0.4,14,20,0.7,118
1559,DAL,2022-10-29,111,,OKC,0,265,38,95,0.4,30,55,0.545,8,40,0.2,27,34,0.794,111,44,89,0.494,39,64,0.609,5,25,0.2,24,31,0.774,117
1560,MIN,2022-10-28,111,,LAL,1,240,41,99,0.414,28,59,0.475,13,40,0.325,16,24,0.667,111,37,89,0.416,28,60,0.467,9,29,0.31,19,27,0.704,102
1561,HOU,2022-10-28,111,@,POR,0,240,40,94,0.426,26,56,0.464,14,38,0.368,17,21,0.81,111,48,90,0.533,35,55,0.636,13,35,0.371,16,20,0.8,125
1562,NOP,2022-10-28,111,@,PHO,0,240,38,86,0.442,23,49,0.469,15,37,0.405,20,22,0.909,111,48,92,0.522,38,59,0.644,10,33,0.303,18,20,0.9,124
1563,DAL,2022-10-25,111,@,NOP,0,240,41,82,0.5,29,43,0.674,12,39,0.308,17,24,0.708,111,44,76,0.579,32,49,0.653,12,27,0.444,13,18,0.722,113
1564,LAC,2022-10-22,111,@,SAC,1,240,41,81,0.506,32,59,0.542,9,22,0.409,20,22,0.909,111,40,85,0.471,26,50,0.52,14,35,0.4,15,26,0.577,109
1565,BOS,2022-10-21,111,@,MIA,1,240,41,79,0.519,27,46,0.587,14,33,0.424,15,15,1.0,111,42,92,0.457,34,66,0.515,8,26,0.308,12,15,0.8,104
1566,PHO,2022-10-21,111,@,POR,0,265,43,94,0.457,33,67,0.493,10,27,0.37,15,21,0.714,111,36,82,0.439,26,53,0.491,10,29,0.345,31,36,0.861,113
1567,ORL,2023-04-09,110,@,MIA,0,240,38,90,0.422,21,43,0.488,17,47,0.362,17,24,0.708,110,45,83,0.542,27,39,0.692,18,44,0.409,15,20,0.75,123
1568,GSW,2023-04-02,110,@,DEN,0,240,42,105,0.4,33,63,0.524,9,42,0.214,17,17,1.0,110,44,100,0.44,35,67,0.522,9,33,0.273,15,18,0.833,112
1569,UTA,2023-04-02,110,@,BRK,0,240,40,91,0.44,32,59,0.542,8,32,0.25,22,30,0.733,110,38,86,0.442,29,54,0.537,9,32,0.281,26,34,0.765,111
1570,TOR,2023-03-31,110,@,PHI,0,240,42,84,0.5,34,58,0.586,8,26,0.308,18,23,0.783,110,41,73,0.562,29,42,0.69,12,31,0.387,23,25,0.92,117
1571,CHI,2023-03-29,110,,LAL,0,240,45,88,0.511,36,55,0.655,9,33,0.273,11,13,0.846,110,45,86,0.523,38,66,0.576,7,20,0.35,24,30,0.8,121
1572,CHO,2023-03-26,110,,DAL,1,240,39,88,0.443,27,59,0.458,12,29,0.414,20,24,0.833,110,32,84,0.381,13,35,0.371,19,49,0.388,21,22,0.955,104
1573,LAC,2023-03-25,110,,NOP,0,240,39,75,0.52,24,42,0.571,15,33,0.455,17,21,0.81,110,51,96,0.531,30,62,0.484,21,34,0.618,8,9,0.889,131
1574,DEN,2023-03-18,110,@,NYK,0,240,43,84,0.512,31,51,0.608,12,33,0.364,12,15,0.8,110,41,83,0.494,32,51,0.627,9,32,0.281,25,28,0.893,116
1575,LAL,2023-03-17,110,,DAL,0,240,43,84,0.512,38,64,0.594,5,20,0.25,19,31,0.613,110,40,79,0.506,24,45,0.533,16,34,0.471,15,19,0.789,111
1576,LAL,2023-03-15,110,@,HOU,0,240,34,90,0.378,23,46,0.5,11,44,0.25,31,37,0.838,110,47,89,0.528,39,60,0.65,8,29,0.276,12,19,0.632,114
1577,DEN,2023-03-14,110,@,TOR,0,240,42,76,0.553,36,51,0.706,6,25,0.24,20,25,0.8,110,49,93,0.527,37,63,0.587,12,30,0.4,15,17,0.882,125
1578,POR,2023-03-12,110,@,NOP,0,240,43,88,0.489,33,55,0.6,10,33,0.303,14,20,0.7,110,43,86,0.5,24,46,0.522,19,40,0.475,22,29,0.759,127
1579,OKC,2023-03-11,110,@,NOP,1,240,37,80,0.463,28,52,0.538,9,28,0.321,27,32,0.844,110,34,81,0.42,22,47,0.468,12,34,0.353,16,19,0.842,96
1580,GSW,2023-03-09,110,@,MEM,0,240,36,82,0.439,21,37,0.568,15,45,0.333,23,24,0.958,110,50,93,0.538,32,53,0.604,18,40,0.45,13,18,0.722,131
1581,POR,2023-03-06,110,@,DET,1,240,38,78,0.487,23,45,0.511,15,33,0.455,19,25,0.76,110,40,86,0.465,30,54,0.556,10,32,0.313,14,20,0.7,104
1582,SAS,2023-03-05,110,@,HOU,0,240,43,93,0.462,32,59,0.542,11,34,0.324,13,21,0.619,110,52,85,0.612,39,61,0.639,13,24,0.542,25,29,0.862,142
1583,SAS,2023-03-04,110,,HOU,0,240,38,86,0.442,23,49,0.469,15,37,0.405,19,20,0.95,110,49,87,0.563,41,64,0.641,8,23,0.348,16,22,0.727,122
1584,MIN,2023-03-03,110,@,LAL,1,240,42,89,0.472,28,55,0.509,14,34,0.412,12,16,0.75,110,36,87,0.414,26,56,0.464,10,31,0.323,20,24,0.833,102
1585,SAS,2023-03-02,110,,IND,1,240,45,98,0.459,35,66,0.53,10,32,0.313,10,13,0.769,110,41,90,0.456,33,67,0.493,8,23,0.348,9,11,0.818,99
1586,POR,2023-03-01,110,,NOP,0,240,36,81,0.444,25,43,0.581,11,38,0.289,27,29,0.931,110,46,89,0.517,37,64,0.578,9,25,0.36,20,23,0.87,121
1587,BOS,2023-02-25,110,@,PHI,1,240,43,86,0.5,27,50,0.54,16,36,0.444,8,12,0.667,110,35,78,0.449,26,51,0.51,9,27,0.333,28,35,0.8,107
1588,NOP,2023-02-23,110,@,TOR,0,240,39,84,0.464,26,54,0.481,13,30,0.433,19,25,0.76,110,43,92,0.467,34,61,0.557,9,31,0.29,20,25,0.8,115
1589,PHI,2023-02-23,110,,MEM,1,240,34,84,0.405,21,48,0.438,13,36,0.361,29,36,0.806,110,34,87,0.391,27,55,0.491,7,32,0.219,30,36,0.833,105
1590,SAS,2023-02-15,110,@,CHO,0,240,41,107,0.383,28,69,0.406,13,38,0.342,15,20,0.75,110,43,96,0.448,29,61,0.475,14,35,0.4,20,29,0.69,120
1591,DAL,2023-02-08,110,@,LAC,1,240,41,78,0.526,24,43,0.558,17,35,0.486,11,17,0.647,110,38,86,0.442,26,53,0.491,12,33,0.364,16,21,0.762,104
1592,NOP,2023-01-29,110,@,MIL,0,240,41,93,0.441,28,59,0.475,13,34,0.382,15,21,0.714,110,53,96,0.552,36,53,0.679,17,43,0.395,12,20,0.6,135
1593,SAC,2023-01-28,110,@,MIN,0,240,37,82,0.451,28,49,0.571,9,33,0.273,27,36,0.75,110,42,80,0.525,25,43,0.581,17,37,0.459,16,21,0.762,117
1594,MIA,2023-01-27,110,,ORL,1,240,39,85,0.459,29,52,0.558,10,33,0.303,22,26,0.846,110,33,69,0.478,21,35,0.6,12,34,0.353,27,32,0.844,105
1595,CHI,2023-01-24,110,@,IND,0,240,43,88,0.489,38,64,0.594,5,24,0.208,19,25,0.76,110,42,99,0.424,32,62,0.516,10,37,0.27,22,28,0.786,116
1596,MEM,2023-01-22,110,@,PHO,0,240,40,92,0.435,29,60,0.483,11,32,0.344,19,27,0.704,110,39,88,0.443,26,53,0.491,13,35,0.371,21,25,0.84,112
1597,NOP,2023-01-20,110,@,ORL,0,240,41,91,0.451,31,56,0.554,10,35,0.286,18,24,0.75,110,39,75,0.52,24,45,0.533,15,30,0.5,30,34,0.882,123
1598,LAC,2023-01-17,110,,PHI,0,240,41,82,0.5,29,48,0.604,12,34,0.353,16,20,0.8,110,39,73,0.534,26,42,0.619,13,31,0.419,29,34,0.853,120
1599,MIN,2023-01-14,110,,CLE,1,240,45,80,0.563,36,52,0.692,9,28,0.321,11,15,0.733,110,37,76,0.487,29,48,0.604,8,28,0.286,20,23,0.87,102
1600,CHI,2023-01-13,110,,OKC,0,240,38,85,0.447,26,47,0.553,12,38,0.316,22,24,0.917,110,47,92,0.511,36,59,0.61,11,33,0.333,19,22,0.864,124
1601,CHI,2023-01-13,110,,OKC,0,240,38,85,0.447,26,47,0.553,12,38,0.316,22,24,0.917,110,47,92,0.511,36,59,0.61,11,33,0.333,19,22,0.864,124
1602,WAS,2023-01-06,110,@,OKC,0,240,38,79,0.481,31,55,0.564,7,24,0.292,27,36,0.75,110,50,98,0.51,33,61,0.541,17,37,0.459,10,14,0.714,127
1603,MIA,2023-01-02,110,@,LAC,1,240,39,85,0.459,27,49,0.551,12,36,0.333,20,24,0.833,110,29,67,0.433,17,38,0.447,12,29,0.414,30,34,0.882,100
1604,LAC,2022-12-29,110,@,BOS,0,240,43,89,0.483,28,50,0.56,15,39,0.385,9,14,0.643,110,44,91,0.484,33,52,0.635,11,39,0.282,17,22,0.773,116
1605,ORL,2022-12-27,110,,LAL,0,240,42,84,0.5,32,56,0.571,10,28,0.357,16,25,0.64,110,49,90,0.544,32,47,0.681,17,43,0.395,14,17,0.824,129
1606,GSW,2022-12-27,110,,CHO,1,240,41,95,0.432,33,58,0.569,8,37,0.216,20,24,0.833,110,38,92,0.413,28,54,0.519,10,38,0.263,19,25,0.76,105
1607,MIN,2022-12-26,110,@,MIA,0,240,43,79,0.544,28,45,0.622,15,34,0.441,9,14,0.643,110,47,102,0.461,34,53,0.642,13,49,0.265,6,8,0.75,113
1608,HOU,2022-12-21,110,,ORL,0,240,41,88,0.466,24,45,0.533,17,43,0.395,11,17,0.647,110,41,91,0.451,30,54,0.556,11,37,0.297,23,33,0.697,116
1609,CHI,2022-12-21,110,@,ATL,1,240,43,86,0.5,36,62,0.581,7,24,0.292,17,22,0.773,110,39,91,0.429,25,54,0.463,14,37,0.378,16,16,1.0,108
1610,PHO,2022-12-20,110,,WAS,0,240,41,89,0.461,28,57,0.491,13,32,0.406,15,19,0.789,110,38,80,0.475,27,53,0.509,11,27,0.407,26,37,0.703,113
1611,TOR,2022-12-18,110,,GSW,0,240,40,95,0.421,27,62,0.435,13,33,0.394,17,22,0.773,110,43,81,0.531,25,42,0.595,18,39,0.462,22,26,0.846,126
1612,POR,2022-12-16,110,@,DAL,0,240,39,89,0.438,26,52,0.5,13,37,0.351,19,25,0.76,110,45,81,0.556,27,38,0.711,18,43,0.419,22,26,0.846,130
1613,OKC,2022-12-16,110,,MIN,0,240,41,88,0.466,30,51,0.588,11,37,0.297,17,21,0.81,110,43,87,0.494,31,62,0.5,12,25,0.48,14,25,0.56,112
1614,MIA,2022-12-14,110,@,OKC,1,240,37,86,0.43,13,30,0.433,24,56,0.429,12,15,0.8,110,41,82,0.5,32,58,0.552,9,24,0.375,17,23,0.739,108
1615,UTA,2022-12-10,110,@,DEN,0,240,39,85,0.459,24,44,0.545,15,41,0.366,17,21,0.81,110,47,86,0.547,39,60,0.65,8,26,0.308,13,16,0.813,115
1616,CLE,2022-12-10,110,,OKC,1,240,40,85,0.471,28,53,0.528,12,32,0.375,18,26,0.692,110,38,83,0.458,28,54,0.519,10,29,0.345,16,20,0.8,102
1617,LAC,2022-12-08,110,@,MIA,0,240,37,80,0.463,20,44,0.455,17,36,0.472,19,21,0.905,110,46,90,0.511,34,58,0.586,12,32,0.375,11,14,0.786,115
1618,TOR,2022-12-05,110,,BOS,0,240,39,85,0.459,29,57,0.509,10,28,0.357,22,30,0.733,110,44,90,0.489,31,54,0.574,13,36,0.361,15,21,0.714,116
1619,SAC,2022-12-04,110,,CHI,1,240,40,86,0.465,27,43,0.628,13,43,0.302,17,19,0.895,110,38,86,0.442,29,61,0.475,9,25,0.36,16,19,0.842,101
1620,DET,2022-11-29,110,,NYK,0,240,42,83,0.506,29,44,0.659,13,39,0.333,13,20,0.65,110,54,96,0.563,38,61,0.623,16,35,0.457,16,21,0.762,140
1621,CHO,2022-11-25,110,,MIN,1,240,40,89,0.449,32,64,0.5,8,25,0.32,22,32,0.688,110,41,96,0.427,32,55,0.582,9,41,0.22,17,18,0.944,108
1622,MIA,2022-11-25,110,,WAS,1,240,42,89,0.472,35,63,0.556,7,26,0.269,19,23,0.826,110,40,93,0.43,29,54,0.537,11,39,0.282,16,20,0.8,107
1623,SAS,2022-11-23,110,,NOP,0,240,41,85,0.482,31,51,0.608,10,34,0.294,18,28,0.643,110,47,82,0.573,33,49,0.673,14,33,0.424,21,30,0.7,129
1624,DET,2022-11-22,110,@,DEN,1,240,45,88,0.511,37,60,0.617,8,28,0.286,12,14,0.857,110,43,86,0.5,38,67,0.567,5,19,0.263,17,26,0.654,108
1625,OKC,2022-11-18,110,@,MEM,0,240,45,96,0.469,34,62,0.548,11,34,0.324,9,11,0.818,110,39,93,0.419,25,54,0.463,14,39,0.359,29,40,0.725,121
1626,PHI,2022-11-18,110,,MIL,1,240,40,78,0.513,27,50,0.54,13,28,0.464,17,26,0.654,110,41,90,0.456,29,54,0.537,12,36,0.333,8,21,0.381,102
1627,CHI,2022-11-16,110,@,NOP,0,240,44,89,0.494,33,57,0.579,11,32,0.344,11,17,0.647,110,43,85,0.506,26,52,0.5,17,33,0.515,21,24,0.875,124
1628,SAS,2022-11-15,110,@,POR,0,240,44,85,0.518,35,56,0.625,9,29,0.31,13,17,0.765,110,41,79,0.519,26,47,0.553,15,32,0.469,20,26,0.769,117
1629,BRK,2022-11-12,110,@,LAC,1,240,40,83,0.482,24,48,0.5,16,35,0.457,14,21,0.667,110,34,85,0.4,23,54,0.426,11,31,0.355,16,20,0.8,95
1630,POR,2022-11-07,110,@,MIA,1,240,38,72,0.528,22,35,0.629,16,37,0.432,18,21,0.857,110,40,84,0.476,26,45,0.578,14,39,0.359,13,15,0.867,107
1631,UTA,2022-11-06,110,@,LAC,1,240,35,75,0.467,20,35,0.571,15,40,0.375,25,26,0.962,110,43,87,0.494,35,54,0.648,8,33,0.242,8,13,0.615,102
1632,TOR,2022-11-04,110,@,DAL,0,240,39,88,0.443,28,54,0.519,11,34,0.324,21,25,0.84,110,39,77,0.506,27,43,0.628,12,34,0.353,21,25,0.84,111
1633,OKC,2022-11-03,110,,DEN,0,240,45,93,0.484,39,64,0.609,6,29,0.207,14,19,0.737,110,45,84,0.536,27,53,0.509,18,31,0.581,14,16,0.875,122
1634,MIA,2022-11-02,110,,SAC,1,240,44,89,0.494,33,55,0.6,11,34,0.324,11,13,0.846,110,41,86,0.477,28,50,0.56,13,36,0.361,12,14,0.857,107
1635,MIL,2022-10-31,110,,DET,1,240,38,87,0.437,27,47,0.574,11,40,0.275,23,29,0.793,110,41,92,0.446,33,63,0.524,8,29,0.276,18,21,0.857,108
1636,DEN,2022-10-30,110,@,LAL,0,240,41,96,0.427,26,56,0.464,15,40,0.375,13,18,0.722,110,46,96,0.479,33,66,0.5,13,30,0.433,16,20,0.8,121
1637,LAC,2022-10-27,110,@,OKC,0,240,44,82,0.537,35,54,0.648,9,28,0.321,13,18,0.722,110,47,95,0.495,30,57,0.526,17,38,0.447,7,8,0.875,118
1638,SAC,2022-10-27,110,,MEM,0,240,40,83,0.482,28,45,0.622,12,38,0.316,18,22,0.818,110,49,92,0.533,35,59,0.593,14,33,0.424,13,18,0.722,125
1639,MIA,2022-10-27,110,@,GSW,0,240,39,88,0.443,25,45,0.556,14,43,0.326,18,22,0.818,110,46,92,0.5,28,46,0.609,18,46,0.391,13,15,0.867,123
1640,MIL,2022-10-26,110,,BRK,1,240,39,88,0.443,29,52,0.558,10,36,0.278,22,29,0.759,110,34,86,0.395,27,59,0.458,7,27,0.259,24,30,0.8,99
1641,DEN,2022-10-26,110,,LAL,1,240,42,92,0.457,33,58,0.569,9,34,0.265,17,21,0.81,110,40,90,0.444,32,60,0.533,8,30,0.267,11,16,0.688,99
1642,DEN,2022-10-24,110,@,POR,0,240,45,91,0.495,33,60,0.55,12,31,0.387,8,14,0.571,110,48,83,0.578,32,48,0.667,16,35,0.457,23,31,0.742,135
1643,WAS,2023-04-09,109,,HOU,0,240,41,97,0.423,27,52,0.519,14,45,0.311,13,21,0.619,109,44,90,0.489,38,69,0.551,6,21,0.286,20,28,0.714,114
1644,DEN,2023-04-09,109,,SAC,1,240,42,84,0.5,35,56,0.625,7,28,0.25,18,25,0.72,109,37,85,0.435,26,42,0.619,11,43,0.256,10,15,0.667,95
1645,CHO,2023-04-07,109,,HOU,0,240,38,88,0.432,25,47,0.532,13,41,0.317,20,27,0.741,109,42,89,0.472,35,68,0.515,7,21,0.333,21,28,0.75,112
1646,POR,2023-04-04,109,@,MEM,0,240,42,97,0.433,28,55,0.509,14,42,0.333,11,17,0.647,109,42,87,0.483,24,39,0.615,18,48,0.375,17,22,0.773,119
1647,WAS,2023-04-02,109,@,NYK,0,240,39,79,0.494,23,42,0.548,16,37,0.432,15,18,0.833,109,46,88,0.523,33,56,0.589,13,32,0.406,13,18,0.722,118
1648,HOU,2023-04-02,109,,LAL,0,240,44,102,0.431,31,68,0.456,13,34,0.382,8,10,0.8,109,52,93,0.559,43,63,0.683,9,30,0.3,21,28,0.75,134
1649,WAS,2023-03-31,109,,ORL,0,240,41,105,0.39,24,55,0.436,17,50,0.34,10,12,0.833,109,44,88,0.5,36,64,0.563,8,24,0.333,20,26,0.769,116
1650,NOP,2023-03-28,109,@,GSW,0,240,42,90,0.467,30,63,0.476,12,27,0.444,13,14,0.929,109,43,82,0.524,25,42,0.595,18,40,0.45,16,22,0.727,120
1651,DAL,2023-03-24,109,,CHO,0,240,41,84,0.488,32,48,0.667,9,36,0.25,18,24,0.75,109,43,89,0.483,32,61,0.525,11,28,0.393,20,27,0.741,117
1652,BRK,2023-03-21,109,,CLE,0,240,41,92,0.446,32,59,0.542,9,33,0.273,18,23,0.783,109,42,83,0.506,28,54,0.519,14,29,0.483,17,21,0.81,115
1653,SAC,2023-03-21,109,,BOS,0,240,39,81,0.481,22,37,0.595,17,44,0.386,14,21,0.667,109,49,92,0.533,31,48,0.646,18,44,0.409,16,23,0.696,132
1654,CHI,2023-03-20,109,@,PHI,1,290,39,94,0.415,32,61,0.525,7,33,0.212,24,29,0.828,109,38,90,0.422,28,54,0.519,10,36,0.278,19,22,0.864,105
1655,IND,2023-03-20,109,@,CHO,0,240,37,82,0.451,28,56,0.5,9,26,0.346,26,34,0.765,109,41,90,0.456,31,59,0.525,10,31,0.323,23,32,0.719,115
1656,CLE,2023-03-15,109,,PHI,0,240,40,85,0.471,26,44,0.591,14,41,0.341,15,22,0.682,109,39,75,0.52,22,39,0.564,17,36,0.472,23,27,0.852,118
1657,BOS,2023-03-13,109,@,HOU,0,240,39,87,0.448,27,45,0.6,12,42,0.286,19,21,0.905,109,40,90,0.444,29,55,0.527,11,35,0.314,20,27,0.741,111
1658,ATL,2023-03-04,109,@,MIA,0,240,37,79,0.468,28,49,0.571,9,30,0.3,26,30,0.867,109,42,83,0.506,29,48,0.604,13,35,0.371,20,23,0.87,117
1659,WAS,2023-03-04,109,,TOR,0,265,38,75,0.507,24,51,0.471,14,24,0.583,19,22,0.864,109,47,90,0.522,35,60,0.583,12,30,0.4,10,14,0.714,116
1660,LAL,2023-02-28,109,@,MEM,0,240,38,86,0.442,25,52,0.481,13,34,0.382,20,23,0.87,109,51,112,0.455,45,81,0.556,6,31,0.194,13,17,0.765,121
1661,NYK,2023-02-27,109,,BOS,1,240,37,78,0.474,25,47,0.532,12,31,0.387,23,34,0.676,109,37,84,0.44,28,42,0.667,9,42,0.214,11,14,0.786,94
1662,GSW,2023-02-26,109,,MIN,1,240,39,91,0.429,24,49,0.49,15,42,0.357,16,22,0.727,109,38,90,0.422,21,45,0.467,17,45,0.378,11,21,0.524,104
1663,WAS,2023-02-24,109,,NYK,0,240,39,79,0.494,20,35,0.571,19,44,0.432,12,12,1.0,109,45,92,0.489,33,63,0.524,12,29,0.414,13,16,0.813,115
1664,CLE,2023-02-23,109,,DEN,0,240,43,90,0.478,37,64,0.578,6,26,0.231,17,20,0.85,109,39,84,0.464,22,48,0.458,17,36,0.472,20,23,0.87,115
1665,DAL,2023-02-15,109,@,DEN,0,240,39,84,0.464,25,45,0.556,14,39,0.359,17,20,0.85,109,48,84,0.571,37,53,0.698,11,31,0.355,11,15,0.733,118
1666,DET,2023-02-15,109,@,BOS,0,240,43,84,0.512,32,55,0.582,11,29,0.379,12,16,0.75,109,49,92,0.533,28,47,0.596,21,45,0.467,8,10,0.8,127
1667,SAC,2023-02-14,109,@,PHO,0,240,37,83,0.446,23,45,0.511,14,38,0.368,21,24,0.875,109,50,88,0.568,43,66,0.652,7,22,0.318,13,16,0.813,120
1668,SAS,2023-02-13,109,@,CLE,0,240,43,85,0.506,35,64,0.547,8,21,0.381,15,20,0.75,109,44,78,0.564,35,50,0.7,9,28,0.321,20,25,0.8,117
1669,MEM,2023-02-12,109,@,BOS,0,240,42,84,0.5,30,50,0.6,12,34,0.353,13,21,0.619,109,39,88,0.443,18,37,0.486,21,51,0.412,20,26,0.769,119
1670,LAL,2023-02-11,109,@,GSW,1,240,40,89,0.449,32,64,0.5,8,25,0.32,21,26,0.808,109,40,96,0.417,28,52,0.538,12,44,0.273,11,12,0.917,103
1671,SAS,2023-02-01,109,,SAC,0,240,48,88,0.545,40,64,0.625,8,24,0.333,5,7,0.714,109,48,90,0.533,40,63,0.635,8,27,0.296,15,19,0.789,119
1672,PHI,2023-01-30,109,,ORL,0,240,40,85,0.471,29,55,0.527,11,30,0.367,18,23,0.783,109,42,99,0.424,31,70,0.443,11,29,0.379,24,30,0.8,119
1673,ORL,2023-01-28,109,,CHI,0,240,41,83,0.494,31,55,0.564,10,28,0.357,17,24,0.708,109,48,81,0.593,32,46,0.696,16,35,0.457,16,19,0.842,128
1674,BOS,2023-01-12,109,@,BRK,1,240,41,86,0.477,29,50,0.58,12,36,0.333,15,17,0.882,109,38,84,0.452,25,50,0.5,13,34,0.382,9,11,0.818,98
1675,ORL,2023-01-10,109,@,POR,1,240,40,78,0.513,31,54,0.574,9,24,0.375,20,25,0.8,109,42,87,0.483,36,52,0.692,6,35,0.171,16,19,0.842,106
1676,LAL,2023-01-09,109,@,DEN,0,240,41,93,0.441,33,65,0.508,8,28,0.286,19,25,0.76,109,46,99,0.465,31,57,0.544,15,42,0.357,15,17,0.882,122
1677,DAL,2023-01-08,109,@,OKC,0,240,31,73,0.425,17,34,0.5,14,39,0.359,33,42,0.786,109,46,95,0.484,34,67,0.507,12,28,0.429,16,20,0.8,120
1678,MIL,2023-01-06,109,,CHO,0,240,37,84,0.44,17,36,0.472,20,48,0.417,15,24,0.625,109,53,102,0.52,33,54,0.611,20,48,0.417,12,19,0.632,138
1679,DET,2023-01-06,109,@,SAS,0,240,44,93,0.473,33,62,0.532,11,31,0.355,10,17,0.588,109,45,81,0.556,36,57,0.632,9,24,0.375,22,26,0.846,121
1680,MIA,2023-01-04,109,@,LAL,0,240,43,95,0.453,35,66,0.53,8,29,0.276,15,21,0.714,109,40,81,0.494,32,54,0.593,8,27,0.296,24,30,0.8,112
1681,MEM,2022-12-25,109,@,GSW,0,240,39,94,0.415,30,55,0.545,9,39,0.231,22,30,0.733,109,43,91,0.473,25,47,0.532,18,44,0.409,19,26,0.731,123
1682,MIN,2022-12-23,109,@,BOS,0,240,44,91,0.484,34,59,0.576,10,32,0.313,11,15,0.733,109,44,100,0.44,31,54,0.574,13,46,0.283,20,26,0.769,121
1683,NYK,2022-12-18,109,@,IND,1,240,39,83,0.47,31,57,0.544,8,26,0.308,23,30,0.767,109,39,90,0.433,26,52,0.5,13,38,0.342,15,23,0.652,106
1684,MEM,2022-12-17,109,@,OKC,0,240,34,90,0.378,22,45,0.489,12,45,0.267,29,37,0.784,109,38,92,0.413,19,47,0.404,19,45,0.422,20,31,0.645,115
1685,BOS,2022-12-16,109,,ORL,0,240,35,84,0.417,24,38,0.632,11,46,0.239,28,34,0.824,109,42,91,0.462,33,58,0.569,9,33,0.273,24,28,0.857,117
1686,TOR,2022-12-09,109,@,ORL,0,240,36,85,0.424,26,50,0.52,10,35,0.286,27,33,0.818,109,42,71,0.592,32,45,0.711,10,26,0.385,19,21,0.905,113
1687,HOU,2022-12-08,109,@,SAS,0,240,44,98,0.449,34,69,0.493,10,29,0.345,11,15,0.733,109,46,83,0.554,33,47,0.702,13,36,0.361,13,15,0.867,118
1688,MIL,2022-12-05,109,@,ORL,1,240,38,85,0.447,25,45,0.556,13,40,0.325,20,26,0.769,109,34,93,0.366,26,61,0.426,8,32,0.25,26,29,0.897,102
1689,DEN,2022-12-02,109,@,ATL,0,240,45,85,0.529,33,53,0.623,12,32,0.375,7,13,0.538,109,49,88,0.557,39,60,0.65,10,28,0.357,9,14,0.643,117
1690,PHI,2022-12-02,109,@,MEM,0,240,40,91,0.44,26,58,0.448,14,33,0.424,15,17,0.882,109,42,97,0.433,31,67,0.463,11,30,0.367,22,28,0.786,117
1691,MIN,2022-11-30,109,,MEM,1,240,41,89,0.461,29,50,0.58,12,39,0.308,15,19,0.789,109,37,87,0.425,28,61,0.459,9,26,0.346,18,30,0.6,101
1692,MIL,2022-11-30,109,@,NYK,1,240,39,90,0.433,29,55,0.527,10,35,0.286,21,26,0.808,109,42,100,0.42,36,70,0.514,6,30,0.2,13,20,0.65,103
1693,POR,2022-11-30,109,@,LAL,0,240,42,90,0.467,34,66,0.515,8,24,0.333,17,21,0.81,109,48,97,0.495,34,60,0.567,14,37,0.378,18,26,0.692,128
1694,BRK,2022-11-28,109,,ORL,1,240,44,81,0.543,35,53,0.66,9,28,0.321,12,14,0.857,109,38,80,0.475,25,49,0.51,13,31,0.419,13,22,0.591,102
1695,MEM,2022-11-22,109,,SAC,0,240,41,91,0.451,33,61,0.541,8,30,0.267,19,30,0.633,109,39,90,0.433,24,45,0.533,15,45,0.333,20,27,0.741,113
1696,PHI,2022-11-19,109,,MIN,0,240,34,71,0.479,20,39,0.513,14,32,0.438,27,32,0.844,109,40,85,0.471,28,49,0.571,12,36,0.333,20,24,0.833,112
1697,NOP,2022-11-18,109,,BOS,0,240,43,87,0.494,30,52,0.577,13,35,0.371,10,13,0.769,109,41,85,0.482,21,39,0.538,20,46,0.435,15,17,0.882,117
1698,BRK,2022-11-17,109,@,POR,1,240,40,79,0.506,29,50,0.58,11,29,0.379,18,23,0.783,109,36,93,0.387,23,57,0.404,13,36,0.361,22,27,0.815,107
1699,ATL,2022-11-12,109,@,PHI,0,240,40,89,0.449,34,65,0.523,6,24,0.25,23,27,0.852,109,44,80,0.55,36,56,0.643,8,24,0.333,25,31,0.806,121
1700,HOU,2022-11-09,109,@,TOR,0,240,37,84,0.44,28,49,0.571,9,35,0.257,26,31,0.839,109,42,102,0.412,27,58,0.466,15,44,0.341,17,20,0.85,116
1701,SAS,2022-11-07,109,,DEN,0,240,43,82,0.524,31,49,0.633,12,33,0.364,11,18,0.611,109,47,88,0.534,39,64,0.609,8,24,0.333,13,20,0.65,115
1702,BOS,2022-11-07,109,@,MEM,1,240,38,82,0.463,26,45,0.578,12,37,0.324,21,28,0.75,109,41,91,0.451,26,47,0.553,15,44,0.341,9,14,0.643,106
1703,LAC,2022-11-02,109,@,HOU,1,240,41,84,0.488,29,51,0.569,12,33,0.364,15,19,0.789,109,37,88,0.42,26,50,0.52,11,38,0.289,16,21,0.762,101
1704,GSW,2022-11-01,109,@,MIA,0,240,39,84,0.464,21,35,0.6,18,49,0.367,13,17,0.765,109,40,88,0.455,24,46,0.522,16,42,0.381,20,20,1.0,116
1705,IND,2022-10-31,109,@,BRK,0,240,41,87,0.471,30,48,0.625,11,39,0.282,16,23,0.696,109,43,80,0.538,32,50,0.64,11,30,0.367,19,20,0.95,116
1706,ATL,2022-10-31,109,@,TOR,0,240,39,84,0.464,28,55,0.509,11,29,0.379,20,25,0.8,109,46,92,0.5,32,58,0.552,14,34,0.412,33,40,0.825,139
1707,HOU,2022-10-30,109,@,PHO,0,240,38,87,0.437,27,53,0.509,11,34,0.324,22,26,0.846,109,45,84,0.536,33,44,0.75,12,40,0.3,22,30,0.733,124
1708,CHI,2022-10-29,109,,PHI,0,240,36,80,0.45,25,49,0.51,11,31,0.355,26,29,0.897,109,39,79,0.494,25,50,0.5,14,29,0.483,22,27,0.815,114
1709,UTA,2022-10-26,109,,HOU,1,240,38,90,0.422,25,45,0.556,13,45,0.289,20,30,0.667,109,36,94,0.383,25,54,0.463,11,40,0.275,18,24,0.75,101
1710,IND,2022-10-26,109,@,CHI,0,240,37,86,0.43,21,46,0.457,16,40,0.4,19,24,0.792,109,43,87,0.494,27,57,0.474,16,30,0.533,22,24,0.917,124
1711,PHI,2022-10-26,109,@,TOR,0,240,40,79,0.506,24,43,0.558,16,36,0.444,13,19,0.684,109,46,84,0.548,30,47,0.638,16,37,0.432,11,14,0.786,119
1712,ATL,2022-10-23,109,,CHO,0,240,39,95,0.411,31,60,0.517,8,35,0.229,23,28,0.821,109,47,90,0.522,36,64,0.563,11,26,0.423,21,30,0.7,126
1713,SAC,2022-10-22,109,,LAC,0,240,40,85,0.471,26,50,0.52,14,35,0.4,15,26,0.577,109,41,81,0.506,32,59,0.542,9,22,0.409,20,22,0.909,111
1714,TOR,2022-10-22,109,@,MIA,0,240,37,87,0.425,23,48,0.479,14,39,0.359,21,28,0.75,109,38,76,0.5,27,46,0.587,11,30,0.367,25,27,0.926,112
1715,BRK,2022-10-21,109,,TOR,1,240,38,80,0.475,25,45,0.556,13,35,0.371,20,29,0.69,109,41,84,0.488,30,56,0.536,11,28,0.393,12,18,0.667,105
1716,ORL,2022-10-19,109,@,DET,0,240,42,86,0.488,31,56,0.554,11,30,0.367,14,19,0.737,109,40,94,0.426,26,56,0.464,14,38,0.368,19,24,0.792,113
1717,LAL,2022-10-18,109,@,GSW,0,240,40,94,0.426,30,54,0.556,10,40,0.25,19,25,0.76,109,45,99,0.455,29,54,0.537,16,45,0.356,17,23,0.739,123
1718,NOP,2023-04-09,108,@,MIN,0,240,40,90,0.444,37,69,0.536,3,21,0.143,25,29,0.862,108,39,82,0.476,26,46,0.565,13,36,0.361,22,31,0.71,113
1719,MIA,2023-04-07,108,@,WAS,0,240,43,98,0.439,28,51,0.549,15,47,0.319,7,12,0.583,108,39,84,0.464,32,51,0.627,7,33,0.212,29,37,0.784,114
1720,DET,2023-04-05,108,,BRK,0,240,41,84,0.488,28,56,0.5,13,28,0.464,13,14,0.929,108,45,86,0.523,28,43,0.651,17,43,0.395,16,23,0.696,123
1721,CHO,2023-04-02,108,,TOR,0,240,42,85,0.494,27,54,0.5,15,31,0.484,9,13,0.692,108,56,104,0.538,48,76,0.632,8,28,0.286,8,8,1.0,128
1722,MEM,2023-03-31,108,,LAC,1,240,43,96,0.448,34,63,0.54,9,33,0.273,13,17,0.765,108,34,90,0.378,23,55,0.418,11,35,0.314,15,18,0.833,94
1723,DAL,2023-03-29,108,@,PHI,0,240,38,83,0.458,20,37,0.541,18,46,0.391,14,18,0.778,108,37,80,0.463,20,44,0.455,17,36,0.472,25,30,0.833,116
1724,ORL,2023-03-28,108,@,MEM,0,240,41,100,0.41,27,51,0.529,14,49,0.286,12,15,0.8,108,42,88,0.477,30,54,0.556,12,34,0.353,17,23,0.739,113
1725,CLE,2023-03-26,108,,HOU,1,240,39,83,0.47,30,53,0.566,9,30,0.3,21,24,0.875,108,35,80,0.438,29,55,0.527,6,25,0.24,15,18,0.833,91
1726,LAL,2023-03-26,108,,CHI,0,240,38,75,0.507,25,39,0.641,13,36,0.361,19,28,0.679,108,47,87,0.54,33,56,0.589,14,31,0.452,10,13,0.769,118
1727,HOU,2023-03-20,108,,GSW,0,240,39,93,0.419,29,57,0.509,10,36,0.278,20,24,0.833,108,44,88,0.5,27,40,0.675,17,48,0.354,16,19,0.842,121
1728,DAL,2023-03-20,108,@,MEM,0,240,39,84,0.464,28,48,0.583,11,36,0.306,19,20,0.95,108,41,89,0.461,31,54,0.574,10,35,0.286,20,26,0.769,112
1729,DEN,2023-03-19,108,@,BRK,1,240,42,80,0.525,30,57,0.526,12,23,0.522,12,13,0.923,108,38,82,0.463,26,47,0.553,12,35,0.343,14,16,0.875,102
1730,LAC,2023-03-18,108,,ORL,0,240,42,90,0.467,36,68,0.529,6,22,0.273,18,24,0.75,108,42,84,0.5,32,53,0.604,10,31,0.323,19,25,0.76,113
1731,NOP,2023-03-14,108,,LAL,0,240,42,98,0.429,31,55,0.564,11,43,0.256,13,20,0.65,108,40,82,0.488,22,43,0.512,18,39,0.462,25,28,0.893,123
1732,CHO,2023-03-12,108,,CLE,0,240,41,80,0.513,31,59,0.525,10,21,0.476,16,22,0.727,108,41,87,0.471,34,60,0.567,7,27,0.259,25,34,0.735,114
1733,LAL,2023-03-12,108,,NYK,0,240,43,89,0.483,31,53,0.585,12,36,0.333,10,17,0.588,108,42,88,0.477,31,51,0.608,11,37,0.297,17,21,0.81,112
1734,DAL,2023-03-11,108,@,MEM,0,240,39,85,0.459,24,42,0.571,15,43,0.349,15,23,0.652,108,41,86,0.477,31,48,0.646,10,38,0.263,20,24,0.833,112
1735,LAC,2023-03-08,108,,TOR,1,240,39,71,0.549,33,51,0.647,6,20,0.3,24,31,0.774,108,37,96,0.385,24,64,0.375,13,32,0.406,13,14,0.929,100
1736,NOP,2023-03-06,108,@,SAC,0,240,43,80,0.538,32,51,0.627,11,29,0.379,11,14,0.786,108,47,83,0.566,31,45,0.689,16,38,0.421,13,20,0.65,123
1737,GSW,2023-03-03,108,,NOP,1,240,40,78,0.513,30,47,0.638,10,31,0.323,18,20,0.9,108,34,77,0.442,24,48,0.5,10,29,0.345,21,27,0.778,99
1738,TOR,2023-03-02,108,@,WAS,0,240,41,92,0.446,32,59,0.542,9,33,0.273,17,17,1.0,108,43,84,0.512,29,54,0.537,14,30,0.467,19,24,0.792,119
1739,MIN,2023-02-28,108,@,LAC,1,240,43,90,0.478,34,64,0.531,9,26,0.346,13,22,0.591,108,35,83,0.422,24,55,0.436,11,28,0.393,20,23,0.87,101
1740,DAL,2023-02-26,108,,LAL,0,240,39,93,0.419,19,44,0.432,20,49,0.408,10,14,0.714,108,42,97,0.433,36,63,0.571,6,34,0.176,21,28,0.75,111
1741,ORL,2023-02-25,108,,IND,0,240,35,90,0.389,29,61,0.475,6,29,0.207,32,38,0.842,108,48,99,0.485,33,59,0.559,15,40,0.375,10,14,0.714,121
1742,CHO,2023-02-25,108,,MIA,1,240,38,88,0.432,28,57,0.491,10,31,0.323,22,27,0.815,108,32,80,0.4,21,44,0.477,11,36,0.306,28,34,0.824,103
1743,ORL,2023-02-23,108,,DET,1,240,39,95,0.411,27,64,0.422,12,31,0.387,18,23,0.783,108,37,81,0.457,20,47,0.426,17,34,0.5,15,19,0.789,106
1744,MIA,2023-02-13,108,,DEN,0,240,39,89,0.438,27,54,0.5,12,35,0.343,18,20,0.9,108,44,76,0.579,33,48,0.688,11,28,0.393,13,15,0.867,112
1745,NYK,2023-02-10,108,@,PHI,0,240,43,81,0.531,32,49,0.653,11,32,0.344,11,16,0.688,108,44,84,0.524,30,46,0.652,14,38,0.368,17,22,0.773,119
1746,POR,2023-02-06,108,,MIL,0,240,37,91,0.407,28,55,0.509,9,36,0.25,25,29,0.862,108,47,87,0.54,31,45,0.689,16,42,0.381,17,21,0.81,127
1747,NYK,2023-02-05,108,,PHI,1,240,34,79,0.43,22,43,0.512,12,36,0.333,28,39,0.718,108,30,74,0.405,23,49,0.469,7,25,0.28,30,36,0.833,97
1748,ATL,2023-02-04,108,@,DEN,0,240,44,91,0.484,38,71,0.535,6,20,0.3,14,17,0.824,108,48,95,0.505,33,57,0.579,15,38,0.395,17,20,0.85,128
1749,UTA,2023-02-03,108,,ATL,0,240,41,91,0.451,28,47,0.596,13,44,0.295,13,18,0.722,108,44,95,0.463,34,58,0.586,10,37,0.27,17,23,0.739,115
1750,LAC,2023-01-31,108,@,CHI,1,240,37,93,0.398,25,49,0.51,12,44,0.273,22,26,0.846,108,38,77,0.494,26,53,0.491,12,24,0.5,15,21,0.714,103
1751,UTA,2023-01-28,108,,DAL,1,240,39,82,0.476,26,46,0.565,13,36,0.361,17,24,0.708,108,35,80,0.438,17,34,0.5,18,46,0.391,12,17,0.706,100
1752,WAS,2023-01-25,108,@,HOU,1,240,39,98,0.398,27,60,0.45,12,38,0.316,18,23,0.783,108,42,97,0.433,37,69,0.536,5,28,0.179,14,20,0.7,103
1753,DET,2023-01-19,108,,CHI,0,240,39,97,0.402,31,63,0.492,8,34,0.235,22,27,0.815,108,50,92,0.543,43,69,0.623,7,23,0.304,19,21,0.905,126
1754,ORL,2023-01-13,108,@,UTA,0,240,42,96,0.438,28,60,0.467,14,36,0.389,10,16,0.625,108,36,83,0.434,25,48,0.521,11,35,0.314,29,40,0.725,112
1755,WAS,2023-01-13,108,,NYK,0,240,36,93,0.387,23,51,0.451,13,42,0.31,23,26,0.885,108,41,92,0.446,33,63,0.524,8,29,0.276,22,31,0.71,112
1756,MIA,2023-01-12,108,,MIL,1,240,42,95,0.442,33,61,0.541,9,34,0.265,15,16,0.938,108,35,87,0.402,13,30,0.433,22,57,0.386,10,15,0.667,102
1757,LAC,2023-01-08,108,,ATL,0,240,37,95,0.389,27,65,0.415,10,30,0.333,24,31,0.774,108,44,89,0.494,36,63,0.571,8,26,0.308,16,20,0.8,112
1758,TOR,2023-01-06,108,,NYK,0,240,35,83,0.422,25,54,0.463,10,29,0.345,28,35,0.8,108,39,83,0.47,23,46,0.5,16,37,0.432,18,26,0.692,112
1759,BRK,2023-01-06,108,@,NOP,1,240,37,85,0.435,22,52,0.423,15,33,0.455,19,20,0.95,108,35,88,0.398,23,59,0.39,12,29,0.414,20,25,0.8,102
1760,IND,2023-01-06,108,,POR,1,240,38,84,0.452,31,59,0.525,7,25,0.28,25,28,0.893,108,38,94,0.404,29,61,0.475,9,33,0.273,14,17,0.824,99
1761,CLE,2023-01-06,108,@,DEN,0,240,40,88,0.455,30,62,0.484,10,26,0.385,18,32,0.563,108,43,81,0.531,26,46,0.565,17,35,0.486,18,23,0.783,121
1762,HOU,2023-01-04,108,@,NOP,0,240,39,88,0.443,27,50,0.54,12,38,0.316,18,27,0.667,108,41,89,0.461,27,51,0.529,14,38,0.368,23,26,0.885,119
1763,SAC,2023-01-01,108,@,MEM,0,240,39,96,0.406,24,53,0.453,15,43,0.349,15,15,1.0,108,46,100,0.46,36,68,0.529,10,32,0.313,16,24,0.667,118
1764,NYK,2022-12-31,108,@,HOU,1,240,35,90,0.389,20,39,0.513,15,51,0.294,23,32,0.719,108,29,77,0.377,15,31,0.484,14,46,0.304,16,23,0.696,88
1765,BRK,2022-12-28,108,@,ATL,1,240,42,83,0.506,32,57,0.561,10,26,0.385,14,17,0.824,108,42,97,0.433,34,75,0.453,8,22,0.364,15,22,0.682,107
1766,MEM,2022-12-27,108,,PHO,0,240,36,91,0.396,28,61,0.459,8,30,0.267,28,34,0.824,108,43,87,0.494,26,56,0.464,17,31,0.548,22,25,0.88,125
1767,MIA,2022-12-23,108,,IND,0,240,41,95,0.432,28,62,0.452,13,33,0.394,13,14,0.929,108,40,83,0.482,19,36,0.528,21,47,0.447,10,14,0.714,111
1768,ATL,2022-12-21,108,,CHI,0,240,39,91,0.429,25,54,0.463,14,37,0.378,16,16,1.0,108,43,86,0.5,36,62,0.581,7,24,0.292,17,22,0.773,110
1769,DEN,2022-12-16,108,@,LAL,0,240,39,81,0.481,30,54,0.556,9,27,0.333,21,28,0.75,108,48,91,0.527,36,58,0.621,12,33,0.364,18,24,0.75,126
1770,HOU,2022-12-15,108,,MIA,0,240,44,94,0.468,35,61,0.574,9,33,0.273,11,17,0.647,108,39,88,0.443,23,41,0.561,16,47,0.34,17,23,0.739,111
1771,OKC,2022-12-14,108,,MIA,0,240,41,82,0.5,32,58,0.552,9,24,0.375,17,23,0.739,108,37,86,0.43,13,30,0.433,24,56,0.429,12,15,0.8,110
1772,UTA,2022-12-09,108,,MIN,0,240,39,90,0.433,26,46,0.565,13,44,0.295,17,24,0.708,108,42,79,0.532,28,44,0.636,14,35,0.4,20,26,0.769,118
1773,ORL,2022-12-03,108,@,TOR,0,240,38,78,0.487,27,50,0.54,11,28,0.393,21,26,0.808,108,47,84,0.56,38,55,0.691,9,29,0.31,18,25,0.72,121
1774,TOR,2022-11-30,108,@,NOP,0,240,42,88,0.477,31,50,0.62,11,38,0.289,13,19,0.684,108,45,86,0.523,31,53,0.585,14,33,0.424,22,26,0.846,126
1775,ORL,2022-11-30,108,,ATL,0,240,39,79,0.494,31,52,0.596,8,27,0.296,22,25,0.88,108,51,94,0.543,43,62,0.694,8,32,0.25,15,19,0.789,125
1776,PHO,2022-11-25,108,,DET,1,240,42,87,0.483,35,58,0.603,7,29,0.241,17,26,0.654,108,39,92,0.424,30,66,0.455,9,26,0.346,15,16,0.938,102
1777,MIN,2022-11-25,108,@,CHO,0,240,41,96,0.427,32,55,0.582,9,41,0.22,17,18,0.944,108,40,89,0.449,32,64,0.5,8,25,0.32,22,32,0.688,110
1778,DEN,2022-11-22,108,,DET,0,240,43,86,0.5,38,67,0.567,5,19,0.263,17,26,0.654,108,45,88,0.511,37,60,0.617,8,28,0.286,12,14,0.857,110
1779,ORL,2022-11-18,108,@,CHI,1,240,38,77,0.494,26,49,0.531,12,28,0.429,20,22,0.909,108,41,89,0.461,36,68,0.529,5,21,0.238,20,25,0.8,107
1780,ORL,2022-11-16,108,,MIN,0,240,42,93,0.452,33,58,0.569,9,35,0.257,15,17,0.882,108,46,88,0.523,34,52,0.654,12,36,0.333,22,28,0.786,126
1781,DET,2022-11-12,108,,BOS,0,240,37,89,0.416,21,51,0.412,16,38,0.421,18,21,0.857,108,39,91,0.429,21,43,0.488,18,48,0.375,21,24,0.875,117
1782,WAS,2022-11-07,108,@,CHO,1,240,42,80,0.525,37,61,0.607,5,19,0.263,19,30,0.633,108,42,101,0.416,37,69,0.536,5,32,0.156,11,16,0.688,100
1783,MIL,2022-11-05,108,,OKC,1,240,38,90,0.422,21,43,0.488,17,47,0.362,15,17,0.882,108,36,84,0.429,24,49,0.49,12,35,0.343,10,16,0.625,94
1784,POR,2022-11-04,108,@,PHO,1,240,43,85,0.506,33,62,0.532,10,23,0.435,12,15,0.8,108,36,83,0.434,22,49,0.449,14,34,0.412,20,21,0.952,106
1785,CHI,2022-11-01,108,@,BRK,1,240,39,89,0.438,27,59,0.458,12,30,0.4,18,21,0.857,108,36,74,0.486,24,42,0.571,12,32,0.375,15,19,0.789,99
1786,ORL,2022-11-01,108,@,OKC,0,240,39,87,0.448,29,58,0.5,10,29,0.345,20,20,1.0,108,45,95,0.474,35,61,0.574,10,34,0.294,16,20,0.8,116
1787,DET,2022-10-31,108,@,MIL,0,240,41,92,0.446,33,63,0.524,8,29,0.276,18,21,0.857,108,38,87,0.437,27,47,0.574,11,40,0.275,23,29,0.793,110
1788,CHO,2022-10-31,108,,SAC,0,240,43,84,0.512,29,55,0.527,14,29,0.483,8,14,0.571,108,37,85,0.435,20,41,0.488,17,44,0.386,24,28,0.857,115
1789,NYK,2022-10-30,108,@,CLE,0,240,45,92,0.489,35,65,0.538,10,27,0.37,8,16,0.5,108,41,89,0.461,18,39,0.462,23,50,0.46,16,19,0.842,121
1790,NYK,2022-10-28,108,@,MIL,0,240,37,93,0.398,25,58,0.431,12,35,0.343,22,32,0.688,108,42,109,0.385,29,64,0.453,13,45,0.289,22,27,0.815,119
1791,OKC,2022-10-25,108,,LAC,1,240,42,110,0.382,38,80,0.475,4,30,0.133,20,25,0.8,108,35,83,0.422,25,52,0.481,10,31,0.323,14,18,0.778,94
1792,UTA,2022-10-24,108,@,HOU,0,240,44,93,0.473,33,61,0.541,11,32,0.344,9,16,0.563,108,38,90,0.422,27,55,0.491,11,35,0.314,27,32,0.844,114
1793,ATL,2022-10-21,108,,ORL,1,240,40,89,0.449,27,58,0.466,13,31,0.419,15,16,0.938,108,33,80,0.413,25,46,0.543,8,34,0.235,24,30,0.8,98
1794,MIA,2022-10-19,108,,CHI,0,240,37,80,0.463,25,52,0.481,12,28,0.429,22,28,0.786,108,41,93,0.441,28,57,0.491,13,36,0.361,21,28,0.75,116
1795,OKC,2022-10-19,108,@,MIN,0,240,38,99,0.384,24,54,0.444,14,45,0.311,18,22,0.818,108,39,94,0.415,29,56,0.518,10,38,0.263,27,33,0.818,115
1796,TOR,2022-10-19,108,,CLE,1,240,36,86,0.419,23,56,0.411,13,30,0.433,23,32,0.719,108,38,77,0.494,28,49,0.571,10,28,0.357,19,23,0.826,105
1797,BRK,2022-10-19,108,,NOP,0,240,40,89,0.449,30,56,0.536,10,33,0.303,18,24,0.75,108,50,102,0.49,38,76,0.5,12,26,0.462,18,25,0.72,130
1798,SAC,2022-10-19,108,,POR,0,240,39,85,0.459,22,41,0.537,17,44,0.386,13,19,0.684,108,39,88,0.443,28,60,0.467,11,28,0.393,26,33,0.788,115
1799,PHO,2023-04-07,107,@,LAL,0,240,43,104,0.413,34,68,0.5,9,36,0.25,12,14,0.857,107,45,92,0.489,27,56,0.482,18,36,0.5,13,17,0.765,121
1800,MIN,2023-04-04,107,@,BRK,1,240,41,85,0.482,33,61,0.541,8,24,0.333,17,22,0.773,107,39,90,0.433,26,55,0.473,13,35,0.371,11,14,0.786,102
1801,MEM,2023-04-02,107,@,CHI,0,240,39,84,0.464,20,41,0.488,19,43,0.442,10,12,0.833,107,50,94,0.532,41,63,0.651,9,31,0.29,19,22,0.864,128
1802,POR,2023-04-02,107,@,MIN,1,240,43,93,0.462,34,63,0.54,9,30,0.3,12,20,0.6,107,38,79,0.481,27,53,0.509,11,26,0.423,18,23,0.783,105
1803,ATL,2023-03-31,107,@,BRK,0,240,39,91,0.429,31,54,0.574,8,37,0.216,21,23,0.913,107,49,88,0.557,34,55,0.618,15,33,0.455,11,13,0.846,124
1804,NOP,2023-03-30,107,@,DEN,1,240,38,80,0.475,25,53,0.472,13,27,0.481,18,22,0.818,107,32,80,0.4,28,52,0.538,4,28,0.143,20,32,0.625,88
1805,OKC,2023-03-29,107,,DET,1,240,39,87,0.448,29,58,0.5,10,29,0.345,19,25,0.76,107,40,80,0.5,24,47,0.511,16,33,0.485,10,14,0.714,106
1806,PHO,2023-03-29,107,,MIN,1,240,40,96,0.417,34,76,0.447,6,20,0.3,21,27,0.778,107,40,90,0.444,28,55,0.509,12,35,0.343,8,12,0.667,100
1807,DET,2023-03-21,107,@,ATL,0,240,37,91,0.407,24,51,0.471,13,40,0.325,20,24,0.833,107,44,95,0.463,30,57,0.526,14,38,0.368,27,36,0.75,129
1808,HOU,2023-03-19,107,,NOP,0,240,31,76,0.408,22,43,0.512,9,33,0.273,36,38,0.947,107,42,85,0.494,29,54,0.537,13,31,0.419,20,24,0.833,117
1809,MIN,2023-03-18,107,@,TOR,0,240,39,85,0.459,34,62,0.548,5,23,0.217,24,28,0.857,107,48,90,0.533,39,63,0.619,9,27,0.333,17,21,0.81,122
1810,BRK,2023-03-14,107,@,OKC,0,240,35,82,0.427,23,41,0.561,12,41,0.293,25,34,0.735,107,45,99,0.455,34,66,0.515,11,33,0.333,20,23,0.87,121
1811,POR,2023-03-14,107,,NYK,0,240,38,99,0.384,21,54,0.389,17,45,0.378,14,18,0.778,107,42,81,0.519,27,46,0.587,15,35,0.429,24,34,0.706,123
1812,WAS,2023-03-10,107,,ATL,0,240,43,88,0.489,36,61,0.59,7,27,0.259,14,18,0.778,107,42,95,0.442,27,64,0.422,15,31,0.484,15,19,0.789,114
1813,PHI,2023-02-25,107,,BOS,0,240,35,78,0.449,26,51,0.51,9,27,0.333,28,35,0.8,107,43,86,0.5,27,50,0.54,16,36,0.444,8,12,0.667,110
1814,PHO,2023-02-16,107,,LAC,0,240,42,89,0.472,31,58,0.534,11,31,0.355,12,16,0.75,107,40,82,0.488,29,48,0.604,11,34,0.324,25,27,0.926,116
1815,MIA,2023-02-11,107,@,ORL,1,265,37,85,0.435,25,46,0.543,12,39,0.308,21,23,0.913,107,37,87,0.425,26,58,0.448,11,29,0.379,18,23,0.783,103
1816,MIN,2023-02-10,107,@,MEM,0,240,41,88,0.466,26,51,0.51,15,37,0.405,10,12,0.833,107,49,84,0.583,39,59,0.661,10,25,0.4,20,27,0.741,128
1817,NOP,2023-02-10,107,,CLE,0,240,39,82,0.476,30,58,0.517,9,24,0.375,20,25,0.8,107,48,85,0.565,38,57,0.667,10,28,0.357,12,15,0.8,118
1818,PHO,2023-02-09,107,@,ATL,0,240,39,86,0.453,32,56,0.571,7,30,0.233,22,29,0.759,107,43,95,0.453,33,66,0.5,10,29,0.345,20,27,0.741,116
1819,ATL,2023-02-07,107,@,NOP,0,240,38,85,0.447,26,49,0.531,12,36,0.333,19,25,0.76,107,45,91,0.495,33,59,0.559,12,32,0.375,14,21,0.667,116
1820,IND,2023-02-03,107,,SAC,1,240,40,89,0.449,23,48,0.479,17,41,0.415,10,14,0.714,107,37,86,0.43,24,48,0.5,13,38,0.342,17,20,0.85,104
1821,MIL,2023-01-25,107,,DEN,1,240,37,78,0.474,24,48,0.5,13,30,0.433,20,28,0.714,107,38,97,0.392,27,63,0.429,11,34,0.324,12,16,0.75,99
1822,IND,2023-01-21,107,@,PHO,0,240,36,96,0.375,23,59,0.39,13,37,0.351,22,26,0.846,107,38,91,0.418,26,60,0.433,12,31,0.387,24,35,0.686,112
1823,BOS,2023-01-09,107,,CHI,1,240,38,87,0.437,27,46,0.587,11,41,0.268,20,21,0.952,107,39,86,0.453,27,51,0.529,12,35,0.343,9,14,0.643,99
1824,NYK,2023-01-09,107,,MIL,0,240,38,100,0.38,27,59,0.458,11,41,0.268,20,22,0.909,107,39,89,0.438,20,40,0.5,19,49,0.388,14,18,0.778,111
1825,CHO,2023-01-04,107,,MEM,0,240,38,94,0.404,27,56,0.482,11,38,0.289,20,24,0.833,107,47,94,0.5,38,64,0.594,9,30,0.3,28,37,0.757,131
1826,UTA,2022-12-28,107,@,GSW,0,240,37,91,0.407,22,45,0.489,15,46,0.326,18,26,0.692,107,37,87,0.425,21,42,0.5,16,45,0.356,22,27,0.815,112
1827,ATL,2022-12-28,107,,BRK,0,240,42,97,0.433,34,75,0.453,8,22,0.364,15,22,0.682,107,42,83,0.506,32,57,0.561,10,26,0.385,14,17,0.824,108
1828,CLE,2022-12-23,107,,TOR,0,240,39,76,0.513,28,43,0.651,11,33,0.333,18,30,0.6,107,42,84,0.5,23,47,0.489,19,37,0.514,15,18,0.833,118
1829,POR,2022-12-23,107,@,DEN,0,240,39,87,0.448,30,52,0.577,9,35,0.257,20,26,0.769,107,47,81,0.58,37,60,0.617,10,21,0.476,16,26,0.615,120
1830,POR,2022-12-17,107,@,HOU,1,240,40,85,0.471,27,49,0.551,13,36,0.361,14,19,0.737,107,36,90,0.4,33,61,0.541,3,29,0.103,20,29,0.69,95
1831,WAS,2022-12-10,107,,LAC,0,240,37,85,0.435,21,51,0.412,16,34,0.471,17,19,0.895,107,40,94,0.426,21,46,0.457,19,48,0.396,15,16,0.938,114
1832,BOS,2022-12-10,107,@,GSW,0,240,38,87,0.437,26,47,0.553,12,40,0.3,19,26,0.731,107,47,92,0.511,34,53,0.642,13,39,0.333,16,20,0.8,123
1833,CLE,2022-12-02,107,,ORL,1,240,41,84,0.488,25,42,0.595,16,42,0.381,9,9,1.0,107,40,81,0.494,32,58,0.552,8,23,0.348,8,12,0.667,96
1834,WAS,2022-11-30,107,@,BRK,0,240,39,89,0.438,33,65,0.508,6,24,0.25,23,34,0.676,107,39,84,0.464,28,58,0.483,11,26,0.423,24,26,0.923,113
1835,UTA,2022-11-28,107,,CHI,0,240,41,85,0.482,22,36,0.611,19,49,0.388,6,15,0.4,107,43,93,0.462,37,71,0.521,6,22,0.273,22,25,0.88,114
1836,WAS,2022-11-25,107,@,MIA,0,240,40,93,0.43,29,54,0.537,11,39,0.282,16,20,0.8,107,42,89,0.472,35,63,0.556,7,26,0.269,19,23,0.826,110
1837,PHI,2022-11-25,107,@,ORL,1,240,39,82,0.476,25,46,0.543,14,36,0.389,15,18,0.833,107,34,80,0.425,25,45,0.556,9,35,0.257,22,27,0.815,99
1838,LAC,2022-11-23,107,@,GSW,0,240,39,86,0.453,28,57,0.491,11,29,0.379,18,27,0.667,107,48,97,0.495,29,46,0.63,19,51,0.373,9,13,0.692,124
1839,CHO,2022-11-23,107,,PHI,1,240,44,92,0.478,38,69,0.551,6,23,0.261,13,21,0.619,107,38,86,0.442,29,48,0.604,9,38,0.237,16,18,0.889,101
1840,BOS,2022-11-21,107,@,CHI,0,240,38,87,0.437,19,37,0.514,19,50,0.38,12,17,0.706,107,46,89,0.517,32,60,0.533,14,29,0.483,15,20,0.75,121
1841,WAS,2022-11-18,107,,MIA,1,265,41,96,0.427,26,50,0.52,15,46,0.326,10,14,0.714,107,35,98,0.357,24,55,0.436,11,43,0.256,25,32,0.781,106
1842,CHI,2022-11-18,107,,ORL,0,240,41,89,0.461,36,68,0.529,5,21,0.238,20,25,0.8,107,38,77,0.494,26,49,0.531,12,28,0.429,20,22,0.909,108
1843,POR,2022-11-17,107,,BRK,0,240,36,93,0.387,23,57,0.404,13,36,0.361,22,27,0.815,107,40,79,0.506,29,50,0.58,11,29,0.379,18,23,0.783,109
1844,MIA,2022-11-07,107,,POR,0,240,40,84,0.476,26,45,0.578,14,39,0.359,13,15,0.867,107,38,72,0.528,22,35,0.629,16,37,0.432,18,21,0.857,110
1845,MIN,2022-11-07,107,,NYK,0,240,38,81,0.469,27,40,0.675,11,41,0.268,20,24,0.833,107,39,89,0.438,20,41,0.488,19,48,0.396,23,25,0.92,120
1846,SAC,2022-11-02,107,@,MIA,0,240,41,86,0.477,28,50,0.56,13,36,0.361,12,14,0.857,107,44,89,0.494,33,55,0.6,11,34,0.324,11,13,0.846,110
1847,MIN,2022-11-01,107,@,PHO,0,240,37,87,0.425,24,53,0.453,13,34,0.382,20,24,0.833,107,41,89,0.461,24,46,0.522,17,43,0.395,17,22,0.773,116
1848,SAS,2022-10-30,107,,MIN,1,240,36,86,0.419,20,46,0.435,16,40,0.4,19,25,0.76,107,40,99,0.404,36,70,0.514,4,29,0.138,14,20,0.7,98
1849,WAS,2022-10-23,107,@,CLE,0,265,43,87,0.494,31,59,0.525,12,28,0.429,9,15,0.6,107,41,96,0.427,28,63,0.444,13,33,0.394,22,25,0.88,117
1850,HOU,2022-10-19,107,@,ATL,0,240,42,98,0.429,33,63,0.524,9,35,0.257,14,15,0.933,107,45,90,0.5,38,65,0.585,7,25,0.28,20,24,0.833,117
1851,PHO,2022-10-19,107,,DAL,1,240,40,85,0.471,32,63,0.508,8,22,0.364,19,22,0.864,107,35,75,0.467,21,40,0.525,14,35,0.4,21,34,0.618,105
1852,IND,2022-10-19,107,,WAS,0,240,39,97,0.402,24,55,0.436,15,42,0.357,14,21,0.667,107,42,92,0.457,31,61,0.508,11,31,0.355,19,24,0.792,114
1853,CHO,2023-04-09,106,@,CLE,1,240,37,81,0.457,31,49,0.633,6,32,0.188,26,30,0.867,106,35,89,0.393,25,52,0.481,10,37,0.27,15,16,0.938,95
1854,DET,2023-03-29,106,@,OKC,0,240,40,80,0.5,24,47,0.511,16,33,0.485,10,14,0.714,106,39,87,0.448,29,58,0.5,10,29,0.345,19,25,0.76,107
1855,TOR,2023-03-28,106,,MIA,1,240,45,93,0.484,37,57,0.649,8,36,0.222,8,9,0.889,106,32,80,0.4,22,47,0.468,10,33,0.303,18,19,0.947,92
1856,BRK,2023-03-26,106,@,ORL,0,240,37,91,0.407,29,56,0.518,8,35,0.229,24,28,0.857,106,45,85,0.529,38,63,0.603,7,22,0.318,22,28,0.786,119
1857,MIL,2023-03-25,106,@,DEN,0,240,39,88,0.443,30,52,0.577,9,36,0.25,19,21,0.905,106,47,89,0.528,32,53,0.604,15,36,0.417,20,28,0.714,129
1858,NYK,2023-03-23,106,@,ORL,0,240,37,88,0.42,25,48,0.521,12,40,0.3,20,26,0.769,106,40,87,0.46,27,55,0.491,13,32,0.406,18,21,0.857,111
1859,LAC,2023-03-11,106,,NYK,1,240,42,87,0.483,32,57,0.561,10,30,0.333,12,16,0.75,106,32,90,0.356,25,59,0.424,7,31,0.226,24,27,0.889,95
1860,DAL,2023-03-08,106,@,NOP,0,240,38,88,0.432,22,42,0.524,16,46,0.348,14,19,0.737,106,42,83,0.506,29,56,0.518,13,27,0.481,16,18,0.889,113
1861,CHO,2023-03-03,106,,ORL,0,240,38,78,0.487,29,54,0.537,9,24,0.375,21,25,0.84,106,46,86,0.535,36,60,0.6,10,26,0.385,15,19,0.789,117
1862,DET,2023-02-27,106,@,CHO,0,240,42,92,0.457,39,66,0.591,3,26,0.115,19,27,0.704,106,43,83,0.518,30,57,0.526,13,26,0.5,18,22,0.818,117
1863,NOP,2023-02-25,106,@,NYK,0,240,40,102,0.392,32,64,0.5,8,38,0.211,18,21,0.857,106,45,88,0.511,26,40,0.65,19,48,0.396,19,23,0.826,128
1864,DET,2023-02-23,106,@,ORL,0,240,37,81,0.457,20,47,0.426,17,34,0.5,15,19,0.789,106,39,95,0.411,27,64,0.422,12,31,0.387,18,23,0.783,108
1865,MIN,2023-02-16,106,,WAS,0,240,39,95,0.411,31,66,0.47,8,29,0.276,20,22,0.909,106,43,95,0.453,29,60,0.483,14,35,0.4,14,17,0.824,114
1866,BRK,2023-02-13,106,@,NYK,0,240,35,78,0.449,23,49,0.469,12,29,0.414,24,33,0.727,106,45,82,0.549,30,48,0.625,15,34,0.441,19,26,0.731,124
1867,SAS,2023-02-11,106,@,ATL,0,240,40,94,0.426,29,57,0.509,11,37,0.297,15,17,0.882,106,50,103,0.485,40,77,0.519,10,26,0.385,15,19,0.789,125
1868,LAC,2023-02-10,106,,MIL,0,240,42,85,0.494,31,52,0.596,11,33,0.333,11,14,0.786,106,45,90,0.5,28,51,0.549,17,39,0.436,12,16,0.75,119
1869,LAL,2023-02-09,106,,MIL,0,240,42,89,0.472,35,71,0.493,7,18,0.389,15,21,0.714,106,45,99,0.455,33,52,0.635,12,47,0.255,13,18,0.722,115
1870,BOS,2023-02-08,106,,PHI,1,240,40,76,0.526,21,41,0.512,19,35,0.543,7,10,0.7,106,37,83,0.446,27,52,0.519,10,31,0.323,15,20,0.75,99
1871,TOR,2023-02-05,106,@,MEM,1,240,44,101,0.436,33,65,0.508,11,36,0.306,7,12,0.583,106,38,78,0.487,28,51,0.549,10,27,0.37,17,23,0.739,103
1872,PHO,2023-02-03,106,@,BOS,1,240,41,95,0.432,29,63,0.46,12,32,0.375,12,14,0.857,106,29,75,0.387,19,37,0.514,10,38,0.263,26,31,0.839,94
1873,NOP,2023-02-02,106,@,DAL,0,240,42,84,0.5,37,64,0.578,5,20,0.25,17,21,0.81,106,37,85,0.435,23,44,0.523,14,41,0.341,23,29,0.793,111
1874,MIL,2023-02-02,106,,LAC,1,240,39,90,0.433,30,53,0.566,9,37,0.243,19,27,0.704,106,39,95,0.411,26,59,0.441,13,36,0.361,14,20,0.7,105
1875,NYK,2023-02-02,106,,MIA,1,240,40,83,0.482,28,47,0.596,12,36,0.333,14,18,0.778,106,39,87,0.448,26,51,0.51,13,36,0.361,13,16,0.813,104
1876,OKC,2023-02-01,106,@,HOU,0,240,38,103,0.369,26,60,0.433,12,43,0.279,18,22,0.818,106,41,94,0.436,34,71,0.479,7,23,0.304,23,31,0.742,112
1877,SAS,2023-01-30,106,,WAS,0,240,42,97,0.433,35,68,0.515,7,29,0.241,15,23,0.652,106,48,86,0.558,32,56,0.571,16,30,0.533,15,17,0.882,127
1878,TOR,2023-01-30,106,@,PHO,0,240,40,89,0.449,31,56,0.554,9,33,0.273,17,19,0.895,106,43,87,0.494,32,59,0.542,11,28,0.393,17,21,0.81,114
1879,BOS,2023-01-21,106,@,TOR,1,240,38,85,0.447,22,50,0.44,16,35,0.457,14,15,0.933,106,46,86,0.535,39,67,0.582,7,19,0.368,5,7,0.714,104
1880,UTA,2023-01-20,106,,BRK,0,240,37,88,0.42,21,49,0.429,16,39,0.41,16,23,0.696,106,43,80,0.538,25,39,0.641,18,41,0.439,13,20,0.65,117
1881,IND,2023-01-18,106,@,OKC,0,240,39,94,0.415,27,61,0.443,12,33,0.364,16,24,0.667,106,47,93,0.505,31,55,0.564,16,38,0.421,16,21,0.762,126
1882,SAS,2023-01-17,106,,BRK,1,240,37,97,0.381,30,63,0.476,7,34,0.206,25,28,0.893,106,37,88,0.42,34,65,0.523,3,23,0.13,21,24,0.875,98
1883,PHO,2023-01-16,106,@,MEM,0,240,39,89,0.438,29,56,0.518,10,33,0.303,18,19,0.947,106,52,98,0.531,36,61,0.59,16,37,0.432,16,20,0.8,136
1884,CHO,2023-01-14,106,,BOS,0,240,41,88,0.466,33,61,0.541,8,27,0.296,16,19,0.842,106,47,99,0.475,28,46,0.609,19,53,0.358,9,10,0.9,122
1885,POR,2023-01-10,106,,ORL,0,240,42,87,0.483,36,52,0.692,6,35,0.171,16,19,0.842,106,40,78,0.513,31,54,0.574,9,24,0.375,20,25,0.8,109
1886,POR,2023-01-04,106,@,MIN,0,240,33,75,0.44,24,46,0.522,9,29,0.31,31,42,0.738,106,39,76,0.513,30,52,0.577,9,24,0.375,26,36,0.722,113
1887,HOU,2023-01-02,106,,DAL,0,240,38,82,0.463,29,53,0.547,9,29,0.31,21,29,0.724,106,34,81,0.42,21,38,0.553,13,43,0.302,30,34,0.882,111
1888,DET,2023-01-02,106,@,POR,0,240,34,82,0.415,28,64,0.438,6,18,0.333,32,41,0.78,106,48,84,0.571,34,53,0.642,14,31,0.452,25,35,0.714,135
1889,CHO,2022-12-31,106,,BRK,0,240,38,96,0.396,27,55,0.491,11,41,0.268,19,21,0.905,106,48,80,0.6,35,46,0.761,13,34,0.382,14,19,0.737,123
1890,TOR,2022-12-29,106,,MEM,0,240,39,96,0.406,29,68,0.426,10,28,0.357,18,24,0.75,106,48,95,0.505,35,66,0.53,13,29,0.448,10,14,0.714,119
1891,SAC,2022-12-27,106,,DEN,0,240,40,82,0.488,30,47,0.638,10,35,0.286,16,19,0.842,106,41,86,0.477,28,49,0.571,13,37,0.351,18,21,0.857,113
1892,HOU,2022-12-23,106,,DAL,0,240,37,81,0.457,29,55,0.527,8,26,0.308,24,28,0.857,106,36,80,0.45,20,36,0.556,16,44,0.364,24,27,0.889,112
1893,MIL,2022-12-21,106,@,CLE,0,240,39,83,0.47,26,53,0.491,13,30,0.433,15,22,0.682,106,41,85,0.482,31,53,0.585,10,32,0.313,22,28,0.786,114
1894,NYK,2022-12-21,106,,TOR,0,240,42,76,0.553,31,50,0.62,11,26,0.423,11,18,0.611,106,42,94,0.447,33,60,0.55,9,34,0.265,20,22,0.909,113
1895,DAL,2022-12-19,106,@,MIN,0,240,31,76,0.408,12,31,0.387,19,45,0.422,25,31,0.806,106,42,89,0.472,30,58,0.517,12,31,0.387,20,24,0.833,116
1896,IND,2022-12-18,106,,NYK,0,240,39,90,0.433,26,52,0.5,13,38,0.342,15,23,0.652,106,39,83,0.47,31,57,0.544,8,26,0.308,23,30,0.767,109
1897,GSW,2022-12-16,106,@,PHI,0,240,39,94,0.415,22,51,0.431,17,43,0.395,11,13,0.846,106,39,85,0.459,24,47,0.511,15,38,0.395,25,31,0.806,118
1898,CHO,2022-12-16,106,,ATL,0,240,39,98,0.398,24,55,0.436,15,43,0.349,13,19,0.684,106,41,75,0.547,26,46,0.565,15,29,0.517,28,34,0.824,125
1899,MIL,2022-12-09,106,@,DAL,1,240,38,87,0.437,27,55,0.491,11,32,0.344,19,23,0.826,106,41,88,0.466,28,48,0.583,13,40,0.325,10,24,0.417,105
1900,SAC,2022-12-09,106,@,CLE,1,240,35,66,0.53,19,33,0.576,16,33,0.485,20,32,0.625,106,34,79,0.43,24,49,0.49,10,30,0.333,17,22,0.773,95
1901,DEN,2022-12-04,106,@,NOP,0,240,41,81,0.506,33,50,0.66,8,31,0.258,16,24,0.667,106,41,81,0.506,30,55,0.545,11,26,0.423,28,36,0.778,121
1902,MIA,2022-11-27,106,@,ATL,1,240,40,82,0.488,31,49,0.633,9,33,0.273,17,19,0.895,106,35,88,0.398,25,52,0.481,10,36,0.278,18,19,0.947,98
1903,SAC,2022-11-23,106,@,ATL,0,240,41,89,0.461,32,58,0.552,9,31,0.29,15,21,0.714,106,41,92,0.446,30,62,0.484,11,30,0.367,22,23,0.957,115
1904,BRK,2022-11-22,106,@,PHI,0,240,44,80,0.55,35,52,0.673,9,28,0.321,9,13,0.692,106,43,99,0.434,27,67,0.403,16,32,0.5,13,16,0.813,115
1905,WAS,2022-11-20,106,,CHO,1,240,40,93,0.43,27,59,0.458,13,34,0.382,13,18,0.722,106,39,100,0.39,31,68,0.456,8,32,0.25,16,23,0.696,102
1906,MIA,2022-11-18,106,@,WAS,0,265,35,98,0.357,24,55,0.436,11,43,0.256,25,32,0.781,106,41,96,0.427,26,50,0.52,15,46,0.326,10,14,0.714,107
1907,NYK,2022-11-16,106,@,DEN,1,240,37,84,0.44,29,50,0.58,8,34,0.235,24,31,0.774,106,36,82,0.439,22,44,0.5,14,38,0.368,17,20,0.85,103
1908,HOU,2022-11-14,106,,LAC,0,240,39,86,0.453,30,56,0.536,9,30,0.3,19,31,0.613,106,41,81,0.506,27,43,0.628,14,38,0.368,26,33,0.788,122
1909,MIL,2022-11-14,106,,ATL,0,240,34,82,0.415,28,53,0.528,6,29,0.207,32,41,0.78,106,44,92,0.478,37,72,0.514,7,20,0.35,26,30,0.867,121
1910,HOU,2022-11-12,106,@,NOP,0,240,40,79,0.506,28,43,0.651,12,36,0.333,14,18,0.778,106,42,86,0.488,34,57,0.596,8,29,0.276,27,31,0.871,119
1911,GSW,2022-11-11,106,,CLE,1,240,40,82,0.488,25,46,0.543,15,36,0.417,11,14,0.786,106,37,92,0.402,29,62,0.468,8,30,0.267,19,26,0.731,101
1912,POR,2022-11-10,106,@,NOP,1,240,37,85,0.435,25,51,0.49,12,34,0.353,20,26,0.769,106,33,79,0.418,23,51,0.451,10,28,0.357,19,24,0.792,95
1913,MEM,2022-11-07,106,,BOS,0,240,41,91,0.451,26,47,0.553,15,44,0.341,9,14,0.643,106,38,82,0.463,26,45,0.578,12,37,0.324,21,28,0.75,109
1914,SAS,2022-11-04,106,,LAC,0,240,42,88,0.477,30,57,0.526,12,31,0.387,10,18,0.556,106,42,80,0.525,27,47,0.574,15,33,0.455,14,19,0.737,113
1915,NYK,2022-11-04,106,@,PHI,1,240,37,80,0.463,28,47,0.596,9,33,0.273,23,27,0.852,106,37,98,0.378,24,51,0.471,13,47,0.277,17,21,0.81,104
1916,PHO,2022-11-04,106,,POR,0,240,36,83,0.434,22,49,0.449,14,34,0.412,20,21,0.952,106,43,85,0.506,33,62,0.532,10,23,0.435,12,15,0.8,108
1917,CHI,2022-11-02,106,,CHO,1,240,38,88,0.432,24,57,0.421,14,31,0.452,16,18,0.889,106,36,92,0.391,29,60,0.483,7,32,0.219,9,16,0.563,88
1918,POR,2022-11-02,106,,MEM,0,240,36,89,0.404,23,56,0.411,13,33,0.394,21,26,0.808,106,38,83,0.458,25,55,0.455,13,28,0.464,22,27,0.815,111
1919,IND,2022-10-24,106,@,PHI,0,240,38,90,0.422,26,46,0.565,12,44,0.273,18,23,0.783,106,38,80,0.475,19,37,0.514,19,43,0.442,25,28,0.893,120
1920,MIN,2022-10-24,106,,SAS,0,240,38,86,0.442,30,55,0.545,8,31,0.258,22,24,0.917,106,48,105,0.457,36,68,0.529,12,37,0.324,7,13,0.538,115
1921,OKC,2022-10-23,106,,MIN,0,240,41,94,0.436,32,53,0.604,9,41,0.22,15,21,0.714,106,46,88,0.523,36,54,0.667,10,34,0.294,14,22,0.636,116
1922,POR,2022-10-23,106,@,LAL,1,240,37,84,0.44,27,57,0.474,10,27,0.37,22,27,0.815,106,41,92,0.446,35,59,0.593,6,33,0.182,16,20,0.8,104
1923,DET,2022-10-21,106,@,NYK,0,240,39,90,0.433,30,54,0.556,9,36,0.25,19,32,0.594,106,50,95,0.526,34,57,0.596,16,38,0.421,14,22,0.636,130
1924,BRK,2023-04-09,105,,PHI,0,240,35,83,0.422,23,51,0.451,12,32,0.375,23,28,0.821,105,53,101,0.525,39,69,0.565,14,32,0.438,14,19,0.737,134
1925,MIL,2023-04-09,105,@,TOR,0,240,38,82,0.463,26,48,0.542,12,34,0.353,17,21,0.81,105,48,95,0.505,37,62,0.597,11,33,0.333,14,16,0.875,121
1926,NYK,2023-04-07,105,@,NOP,0,240,38,88,0.432,24,45,0.533,14,43,0.326,15,20,0.75,105,42,79,0.532,32,51,0.627,10,28,0.357,19,20,0.95,113
1927,MIL,2023-04-05,105,,CHI,1,240,39,92,0.424,21,46,0.457,18,46,0.391,9,11,0.818,105,36,83,0.434,25,50,0.5,11,33,0.333,9,11,0.818,92
1928,DET,2023-04-04,105,,MIA,0,240,36,73,0.493,25,45,0.556,11,28,0.393,22,27,0.815,105,41,80,0.513,28,44,0.636,13,36,0.361,23,26,0.885,118
1929,CHI,2023-04-04,105,,ATL,0,240,41,89,0.461,34,58,0.586,7,31,0.226,16,20,0.8,105,48,86,0.558,38,58,0.655,10,28,0.357,17,19,0.895,123
1930,MIN,2023-04-02,105,,POR,0,240,38,79,0.481,27,53,0.509,11,26,0.423,18,23,0.783,105,43,93,0.462,34,63,0.54,9,30,0.3,12,20,0.6,107
1931,IND,2023-04-02,105,@,CLE,0,240,36,83,0.434,27,59,0.458,9,24,0.375,24,29,0.828,105,44,90,0.489,35,66,0.53,9,24,0.375,18,26,0.692,115
1932,PHI,2023-03-25,105,@,PHO,0,240,34,78,0.436,21,47,0.447,13,31,0.419,24,27,0.889,105,47,93,0.505,32,61,0.525,15,32,0.469,16,19,0.842,125
1933,OKC,2023-03-23,105,@,LAC,0,240,41,93,0.441,28,54,0.519,13,39,0.333,10,11,0.909,105,47,84,0.56,29,47,0.617,18,37,0.486,15,20,0.75,127
1934,PHI,2023-03-20,105,,CHI,0,290,38,90,0.422,28,54,0.519,10,36,0.278,19,22,0.864,105,39,94,0.415,32,61,0.525,7,33,0.212,24,29,0.828,109
1935,ORL,2023-03-19,105,@,LAL,0,240,41,102,0.402,31,64,0.484,10,38,0.263,13,17,0.765,105,36,78,0.462,23,46,0.5,13,32,0.406,26,32,0.813,111
1936,NYK,2023-03-07,105,,CHO,0,240,38,89,0.427,27,49,0.551,11,40,0.275,18,24,0.75,105,42,85,0.494,30,53,0.566,12,32,0.375,16,21,0.762,112
1937,GSW,2023-03-05,105,@,LAL,0,240,36,91,0.396,18,39,0.462,18,52,0.346,15,18,0.833,105,42,95,0.442,31,62,0.5,11,33,0.333,18,22,0.818,113
1938,BOS,2023-03-03,105,,BRK,0,240,41,84,0.488,32,55,0.582,9,29,0.31,14,20,0.7,105,40,95,0.421,26,51,0.51,14,44,0.318,21,26,0.808,115
1939,PHO,2023-03-01,105,@,CHO,1,240,42,89,0.472,33,64,0.516,9,25,0.36,12,15,0.8,105,32,88,0.364,23,55,0.418,9,33,0.273,18,28,0.643,91
1940,POR,2023-02-28,105,@,GSW,0,240,37,86,0.43,25,47,0.532,12,39,0.308,19,22,0.864,105,49,91,0.538,37,61,0.607,12,30,0.4,13,16,0.813,123
1941,MEM,2023-02-23,105,@,PHI,0,240,34,87,0.391,27,55,0.491,7,32,0.219,30,36,0.833,105,34,84,0.405,21,48,0.438,13,36,0.361,29,36,0.806,110
1942,MIA,2023-02-15,105,@,BRK,0,240,38,83,0.458,30,55,0.545,8,28,0.286,21,29,0.724,105,41,77,0.532,24,38,0.632,17,39,0.436,17,20,0.85,116
1943,CHO,2023-02-11,105,,DEN,0,240,40,85,0.471,32,53,0.604,8,32,0.25,17,29,0.586,105,50,99,0.505,45,76,0.592,5,23,0.217,14,17,0.824,119
1944,CHI,2023-02-09,105,@,BRK,0,240,42,91,0.462,37,65,0.569,5,26,0.192,16,21,0.762,105,39,91,0.429,22,47,0.468,17,44,0.386,21,25,0.84,116
1945,LAC,2023-02-02,105,@,MIL,0,240,39,95,0.411,26,59,0.441,13,36,0.361,14,20,0.7,105,39,90,0.433,30,53,0.566,9,37,0.243,19,27,0.704,106
1946,PHI,2023-02-01,105,,ORL,1,240,34,78,0.436,20,43,0.465,14,35,0.4,23,26,0.885,105,33,87,0.379,27,49,0.551,6,38,0.158,22,29,0.759,94
1947,DET,2023-01-30,105,@,DAL,0,240,36,79,0.456,22,40,0.55,14,39,0.359,19,27,0.704,105,39,79,0.494,29,45,0.644,10,34,0.294,23,33,0.697,111
1948,POR,2023-01-28,105,,TOR,0,240,40,76,0.526,33,52,0.635,7,24,0.292,18,23,0.783,105,48,92,0.522,38,62,0.613,10,30,0.333,17,18,0.944,123
1949,ORL,2023-01-27,105,@,MIA,0,240,33,69,0.478,21,35,0.6,12,34,0.353,27,32,0.844,105,39,85,0.459,29,52,0.558,10,33,0.303,22,26,0.846,110
1950,NYK,2023-01-24,105,,CLE,1,240,37,75,0.493,20,42,0.476,17,33,0.515,14,21,0.667,105,40,87,0.46,28,54,0.519,12,33,0.364,11,16,0.688,103
1951,PHI,2023-01-19,105,@,POR,1,240,41,81,0.506,33,55,0.6,8,26,0.308,15,19,0.789,105,32,85,0.376,23,48,0.479,9,37,0.243,22,29,0.759,95
1952,NYK,2023-01-18,105,,WAS,0,240,40,96,0.417,33,70,0.471,7,26,0.269,18,27,0.667,105,42,95,0.442,26,53,0.491,16,42,0.381,16,19,0.842,116
1953,ATL,2023-01-11,105,,MIL,0,240,39,87,0.448,28,57,0.491,11,30,0.367,16,18,0.889,105,45,98,0.459,27,50,0.54,18,48,0.375,6,11,0.545,114
1954,POR,2023-01-08,105,@,TOR,0,240,34,76,0.447,25,46,0.543,9,30,0.3,28,37,0.757,105,40,91,0.44,28,60,0.467,12,31,0.387,25,29,0.862,117
1955,CHO,2022-12-27,105,@,GSW,0,240,38,92,0.413,28,54,0.519,10,38,0.263,19,25,0.76,105,41,95,0.432,33,58,0.569,8,37,0.216,20,24,0.833,110
1956,DET,2022-12-23,105,@,ATL,0,240,37,90,0.411,28,57,0.491,9,33,0.273,22,29,0.759,105,49,92,0.533,37,58,0.638,12,34,0.353,20,24,0.833,130
1957,CHO,2022-12-21,105,@,LAC,0,240,37,92,0.402,28,61,0.459,9,31,0.29,22,29,0.759,105,41,81,0.506,18,32,0.563,23,49,0.469,21,23,0.913,126
1958,DEN,2022-12-20,105,,MEM,1,240,40,89,0.449,30,62,0.484,10,27,0.37,15,25,0.6,105,36,81,0.444,31,55,0.564,5,26,0.192,14,21,0.667,91
1959,HOU,2022-12-19,105,,SAS,0,240,40,94,0.426,35,70,0.5,5,24,0.208,20,31,0.645,105,46,83,0.554,29,49,0.592,17,34,0.5,15,19,0.789,124
1960,CLE,2022-12-14,105,@,DAL,1,240,41,78,0.526,33,54,0.611,8,24,0.333,15,19,0.789,105,29,74,0.392,16,36,0.444,13,38,0.342,19,26,0.731,90
1961,DAL,2022-12-09,105,,MIL,0,240,41,88,0.466,28,48,0.583,13,40,0.325,10,24,0.417,105,38,87,0.437,27,55,0.491,11,32,0.344,19,23,0.826,106
1962,MIL,2022-12-03,105,@,CHO,1,240,39,83,0.47,27,51,0.529,12,32,0.375,15,19,0.789,105,34,87,0.391,29,63,0.46,5,24,0.208,23,26,0.885,96
1963,TOR,2022-12-02,105,@,BRK,0,240,38,87,0.437,31,63,0.492,7,24,0.292,22,30,0.733,105,44,82,0.537,33,50,0.66,11,32,0.344,15,22,0.682,114
1964,CHO,2022-11-28,105,@,BOS,0,240,42,86,0.488,31,57,0.544,11,29,0.379,10,15,0.667,105,55,93,0.591,31,41,0.756,24,52,0.462,6,7,0.857,140
1965,NOP,2022-11-28,105,,OKC,1,240,39,87,0.448,30,55,0.545,9,32,0.281,18,20,0.9,105,34,92,0.37,22,54,0.407,12,38,0.316,21,23,0.913,101
1966,TOR,2022-11-26,105,,DAL,1,240,38,88,0.432,30,62,0.484,8,26,0.308,21,26,0.808,105,35,73,0.479,24,34,0.706,11,39,0.282,19,24,0.792,100
1967,OKC,2022-11-26,105,@,HOU,0,240,38,97,0.392,28,53,0.528,10,44,0.227,19,23,0.826,105,45,86,0.523,27,50,0.54,18,36,0.5,10,14,0.714,118
1968,LAL,2022-11-25,105,@,SAS,1,240,40,83,0.482,32,56,0.571,8,27,0.296,17,20,0.85,105,38,100,0.38,32,67,0.478,6,33,0.182,12,16,0.75,94
1969,WAS,2022-11-23,105,@,MIA,0,240,42,89,0.472,32,51,0.627,10,38,0.263,11,19,0.579,105,39,93,0.419,23,52,0.442,16,41,0.39,19,22,0.864,113
1970,LAL,2022-11-22,105,@,PHO,0,240,36,85,0.424,32,63,0.508,4,22,0.182,29,35,0.829,105,48,102,0.471,32,68,0.471,16,34,0.471,3,5,0.6,115
1971,MIN,2022-11-21,105,,MIA,1,240,37,85,0.435,23,38,0.605,14,47,0.298,17,20,0.85,105,35,90,0.389,24,52,0.462,11,38,0.289,20,30,0.667,101
1972,ORL,2022-11-14,105,,CHO,0,240,36,88,0.409,22,52,0.423,14,36,0.389,19,23,0.826,105,42,88,0.477,35,53,0.66,7,35,0.2,21,24,0.875,112
1973,PHI,2022-11-13,105,,UTA,1,240,40,83,0.482,36,60,0.6,4,23,0.174,21,26,0.808,105,37,94,0.394,26,57,0.456,11,37,0.297,13,23,0.565,98
1974,DAL,2022-11-10,105,@,WAS,0,240,37,86,0.43,19,39,0.487,18,47,0.383,13,21,0.619,105,41,84,0.488,29,54,0.537,12,30,0.4,19,20,0.95,113
1975,POR,2022-11-09,105,@,CHO,1,240,40,75,0.533,29,41,0.707,11,34,0.324,14,25,0.56,105,34,91,0.374,24,51,0.471,10,40,0.25,17,24,0.708,95
1976,GSW,2022-11-04,105,@,NOP,0,240,35,71,0.493,23,39,0.59,12,32,0.375,23,25,0.92,105,41,81,0.506,29,52,0.558,12,29,0.414,20,29,0.69,114
1977,MEM,2022-10-31,105,@,UTA,0,240,38,92,0.413,32,66,0.485,6,26,0.231,23,42,0.548,105,42,89,0.472,23,42,0.548,19,47,0.404,18,22,0.818,121
1978,ORL,2022-10-30,105,@,DAL,0,240,37,81,0.457,26,52,0.5,11,29,0.379,20,27,0.741,105,41,83,0.494,30,48,0.625,11,35,0.314,21,28,0.75,114
1979,GSW,2022-10-25,105,@,PHO,0,240,41,91,0.451,31,56,0.554,10,35,0.286,13,17,0.765,105,47,92,0.511,35,63,0.556,12,29,0.414,28,34,0.824,134
1980,PHI,2022-10-22,105,,SAS,0,240,37,84,0.44,27,53,0.509,10,31,0.323,21,28,0.75,105,43,89,0.483,27,51,0.529,16,38,0.421,12,15,0.8,114
1981,HOU,2022-10-22,105,@,MIL,0,240,36,93,0.387,20,56,0.357,16,37,0.432,17,22,0.773,105,48,85,0.565,32,54,0.593,16,31,0.516,13,21,0.619,125
1982,TOR,2022-10-21,105,@,BRK,0,240,41,84,0.488,30,56,0.536,11,28,0.393,12,18,0.667,105,38,80,0.475,25,45,0.556,13,35,0.371,20,29,0.69,109
1983,CLE,2022-10-19,105,@,TOR,0,240,38,77,0.494,28,49,0.571,10,28,0.357,19,23,0.826,105,36,86,0.419,23,56,0.411,13,30,0.433,23,32,0.719,108
1984,DAL,2022-10-19,105,@,PHO,0,240,35,75,0.467,21,40,0.525,14,35,0.4,21,34,0.618,105,40,85,0.471,32,63,0.508,8,22,0.364,19,22,0.864,107
1985,PHI,2023-04-02,104,@,MIL,0,240,40,87,0.46,28,51,0.549,12,36,0.333,12,13,0.923,104,46,80,0.575,36,52,0.692,10,28,0.357,15,21,0.714,117
1986,IND,2023-03-27,104,,DAL,0,240,39,93,0.419,31,65,0.477,8,28,0.286,18,23,0.783,104,47,83,0.566,29,46,0.63,18,37,0.486,15,17,0.882,127
1987,WAS,2023-03-26,104,@,TOR,0,240,38,86,0.442,22,50,0.44,16,36,0.444,12,20,0.6,104,45,98,0.459,34,67,0.507,11,31,0.355,13,16,0.813,114
1988,DAL,2023-03-26,104,@,CHO,0,240,32,84,0.381,13,35,0.371,19,49,0.388,21,22,0.955,104,39,88,0.443,27,59,0.458,12,29,0.414,20,24,0.833,110
1989,WAS,2023-03-22,104,,DEN,0,240,44,87,0.506,40,61,0.656,4,26,0.154,12,16,0.75,104,42,83,0.506,27,51,0.529,15,32,0.469,19,21,0.905,118
1990,BOS,2023-03-15,104,@,MIN,1,240,34,84,0.405,22,44,0.5,12,40,0.3,24,30,0.8,104,37,84,0.44,25,48,0.521,12,36,0.333,16,22,0.727,102
1991,CHO,2023-03-14,104,,CLE,0,240,43,76,0.566,37,53,0.698,6,23,0.261,12,15,0.8,104,45,88,0.511,31,58,0.534,14,30,0.467,16,19,0.842,120
1992,PHO,2023-03-14,104,,MIL,0,240,41,95,0.432,33,72,0.458,8,23,0.348,14,16,0.875,104,40,85,0.471,28,46,0.609,12,39,0.308,24,37,0.649,116
1993,MEM,2023-03-13,104,@,DAL,1,240,38,83,0.458,26,46,0.565,12,37,0.324,16,19,0.842,104,35,90,0.389,23,44,0.523,12,46,0.261,6,8,0.75,88
1994,CLE,2023-03-08,104,@,MIA,1,240,39,80,0.488,30,52,0.577,9,28,0.321,17,19,0.895,104,35,70,0.5,27,41,0.659,8,29,0.276,22,29,0.759,100
1995,DET,2023-03-06,104,,POR,0,240,40,86,0.465,30,54,0.556,10,32,0.313,14,20,0.7,104,38,78,0.487,23,45,0.511,15,33,0.455,19,25,0.76,110
1996,CHI,2023-03-03,104,,PHO,0,240,39,83,0.47,32,60,0.533,7,23,0.304,19,25,0.76,104,42,84,0.5,22,37,0.595,20,47,0.426,21,25,0.84,125
1997,TOR,2023-02-28,104,,CHI,1,240,38,94,0.404,23,52,0.442,15,42,0.357,13,19,0.684,104,37,71,0.521,27,46,0.587,10,25,0.4,14,17,0.824,98
1998,BRK,2023-02-28,104,,MIL,0,240,36,83,0.434,24,47,0.511,12,36,0.333,20,25,0.8,104,50,102,0.49,36,65,0.554,14,37,0.378,4,12,0.333,118
1999,MIN,2023-02-26,104,@,GSW,0,240,38,90,0.422,21,45,0.467,17,45,0.378,11,21,0.524,104,39,91,0.429,24,49,0.49,15,42,0.357,16,22,0.727,109
2000,MIL,2023-02-26,104,,PHO,1,240,38,87,0.437,25,42,0.595,13,45,0.289,15,21,0.714,104,40,95,0.421,32,71,0.451,8,24,0.333,13,22,0.591,101
2001,HOU,2023-02-13,104,@,PHI,0,240,35,86,0.407,29,62,0.468,6,24,0.25,28,31,0.903,104,46,82,0.561,31,48,0.646,15,34,0.441,16,17,0.941,123
2002,IND,2023-02-10,104,,PHO,0,240,36,85,0.424,25,46,0.543,11,39,0.282,21,28,0.75,104,43,93,0.462,33,60,0.55,10,33,0.303,21,24,0.875,117
2003,DEN,2023-02-09,104,@,ORL,0,240,39,84,0.464,29,51,0.569,10,33,0.303,16,24,0.667,104,47,97,0.485,38,70,0.543,9,27,0.333,12,19,0.632,115
2004,CHO,2023-02-08,104,@,WAS,0,240,39,93,0.419,30,62,0.484,9,31,0.29,17,21,0.81,104,44,87,0.506,29,50,0.58,15,37,0.405,15,17,0.882,118
2005,LAC,2023-02-08,104,,DAL,0,240,38,86,0.442,26,53,0.491,12,33,0.364,16,21,0.762,104,41,78,0.526,24,43,0.558,17,35,0.486,11,17,0.647,110
2006,MEM,2023-02-07,104,,CHI,1,240,39,81,0.481,28,48,0.583,11,33,0.333,15,21,0.714,104,32,87,0.368,25,52,0.481,7,35,0.2,18,27,0.667,89
2007,SAS,2023-02-06,104,@,CHI,0,240,40,90,0.444,32,64,0.5,8,26,0.308,16,17,0.941,104,50,89,0.562,44,67,0.657,6,22,0.273,22,25,0.88,128
2008,SAC,2023-02-05,104,@,NOP,0,240,35,82,0.427,24,40,0.6,11,42,0.262,23,27,0.852,104,48,85,0.565,34,59,0.576,14,26,0.538,26,34,0.765,136
2009,SAC,2023-02-03,104,@,IND,0,240,37,86,0.43,24,48,0.5,13,38,0.342,17,20,0.85,104,40,89,0.449,23,48,0.479,17,41,0.415,10,14,0.714,107
2010,MIA,2023-02-02,104,@,NYK,0,240,39,87,0.448,26,51,0.51,13,36,0.361,13,16,0.813,104,40,83,0.482,28,47,0.596,12,36,0.333,14,18,0.778,106
2011,LAL,2023-01-30,104,@,BRK,0,240,35,89,0.393,24,60,0.4,11,29,0.379,23,37,0.622,104,45,95,0.474,29,54,0.537,16,41,0.39,15,19,0.789,121
2012,SAS,2023-01-25,104,@,LAL,0,240,40,106,0.377,32,72,0.444,8,34,0.235,16,18,0.889,104,40,90,0.444,30,57,0.526,10,33,0.303,23,30,0.767,113
2013,TOR,2023-01-21,104,,BOS,0,240,46,86,0.535,39,67,0.582,7,19,0.368,5,7,0.714,104,38,85,0.447,22,50,0.44,16,35,0.457,14,15,0.933,106
2014,HOU,2023-01-21,104,@,MIN,0,240,38,79,0.481,29,55,0.527,9,24,0.375,19,33,0.576,104,38,83,0.458,21,42,0.5,17,41,0.415,20,24,0.833,113
2015,DET,2023-01-15,104,,NYK,0,240,37,83,0.446,19,39,0.487,18,44,0.409,12,15,0.8,104,40,88,0.455,28,58,0.483,12,30,0.4,25,31,0.806,117
2016,MIN,2023-01-08,104,@,HOU,1,240,38,80,0.475,28,52,0.538,10,28,0.357,18,22,0.818,104,38,89,0.427,27,53,0.509,11,36,0.306,9,15,0.6,96
2017,MIA,2023-01-06,104,@,PHO,1,240,33,78,0.423,21,40,0.525,12,38,0.316,26,31,0.839,104,34,82,0.415,28,59,0.475,6,23,0.261,22,25,0.88,96
2018,MIL,2023-01-04,104,@,TOR,1,265,35,88,0.398,22,49,0.449,13,39,0.333,21,30,0.7,104,38,116,0.328,29,70,0.414,9,46,0.196,16,20,0.8,101
2019,MIN,2022-12-31,104,,DET,0,240,36,83,0.434,26,49,0.531,10,34,0.294,22,26,0.846,104,43,89,0.483,33,62,0.532,10,27,0.37,20,28,0.714,116
2020,PHO,2022-12-30,104,@,TOR,0,240,35,71,0.493,21,41,0.512,14,30,0.467,20,23,0.87,104,40,81,0.494,29,48,0.604,11,33,0.333,22,26,0.846,113
2021,DAL,2022-12-21,104,@,MIN,1,240,34,75,0.453,21,36,0.583,13,39,0.333,23,27,0.852,104,42,85,0.494,34,55,0.618,8,30,0.267,7,10,0.7,99
2022,PHI,2022-12-19,104,,TOR,1,265,32,80,0.4,17,38,0.447,15,42,0.357,25,27,0.926,104,37,88,0.42,26,48,0.542,11,40,0.275,16,20,0.8,101
2023,LAL,2022-12-19,104,@,PHO,0,240,39,87,0.448,27,59,0.458,12,28,0.429,14,17,0.824,104,46,93,0.495,26,54,0.481,20,39,0.513,18,24,0.75,130
2024,NOP,2022-12-07,104,,DET,1,240,39,85,0.459,31,58,0.534,8,27,0.296,18,23,0.783,104,35,90,0.389,20,48,0.417,15,42,0.357,13,16,0.813,98
2025,GSW,2022-12-05,104,,IND,0,240,38,94,0.404,25,50,0.5,13,44,0.295,15,19,0.789,104,43,90,0.478,28,51,0.549,15,39,0.385,11,18,0.611,112
2026,PHI,2022-11-28,104,,ATL,1,240,39,86,0.453,29,58,0.5,10,28,0.357,16,18,0.889,104,37,74,0.5,25,47,0.532,12,27,0.444,15,22,0.682,101
2027,LAC,2022-11-25,104,,DEN,0,240,37,68,0.544,26,46,0.565,11,22,0.5,19,34,0.559,104,44,89,0.494,34,59,0.576,10,30,0.333,16,23,0.696,114
2028,SAC,2022-11-25,104,@,BOS,0,240,36,87,0.414,27,51,0.529,9,36,0.25,23,26,0.885,104,41,83,0.494,25,46,0.543,16,37,0.432,24,27,0.889,122
2029,MIA,2022-11-16,104,@,TOR,0,240,36,66,0.545,23,31,0.742,13,35,0.371,19,22,0.864,104,44,86,0.512,37,60,0.617,7,26,0.269,17,22,0.773,112
2030,TOR,2022-11-12,104,@,IND,0,240,37,94,0.394,30,59,0.508,7,35,0.2,23,29,0.793,104,41,82,0.5,22,39,0.564,19,43,0.442,17,23,0.739,118
2031,ATL,2022-11-10,104,,PHI,1,240,39,88,0.443,33,62,0.532,6,26,0.231,20,23,0.87,104,32,83,0.386,26,53,0.491,6,30,0.2,25,30,0.833,95
2032,CHI,2022-11-06,104,@,TOR,0,240,40,88,0.455,27,52,0.519,13,36,0.361,11,13,0.846,104,44,103,0.427,34,66,0.515,10,37,0.27,15,20,0.75,113
2033,PHI,2022-11-04,104,,NYK,0,240,37,98,0.378,24,51,0.471,13,47,0.277,17,21,0.81,104,37,80,0.463,28,47,0.596,9,33,0.273,23,27,0.852,106
2034,LAL,2022-10-23,104,,POR,0,240,41,92,0.446,35,59,0.593,6,33,0.182,16,20,0.8,104,37,84,0.44,27,57,0.474,10,27,0.37,22,27,0.815,106
2035,MIA,2022-10-21,104,,BOS,0,240,42,92,0.457,34,66,0.515,8,26,0.308,12,15,0.8,104,41,79,0.519,27,46,0.587,14,33,0.424,15,15,1.0,111
2036,CHI,2023-04-09,103,,DET,1,240,40,95,0.421,34,65,0.523,6,30,0.2,17,22,0.773,103,31,85,0.365,22,52,0.423,9,33,0.273,10,13,0.769,81
2037,DEN,2023-04-04,103,@,HOU,0,240,41,87,0.471,30,51,0.588,11,36,0.306,10,18,0.556,103,47,102,0.461,35,71,0.493,12,31,0.387,18,24,0.75,124
2038,PHI,2023-04-04,103,,BOS,1,240,39,78,0.5,28,49,0.571,11,29,0.379,14,16,0.875,103,38,91,0.418,23,46,0.5,15,45,0.333,10,16,0.625,101
2039,NOP,2023-04-04,103,,SAC,0,240,37,84,0.44,30,64,0.469,7,20,0.35,22,27,0.815,103,46,91,0.505,29,49,0.592,17,42,0.405,12,15,0.8,121
2040,UTA,2023-03-27,103,,PHO,0,240,38,86,0.442,29,50,0.58,9,36,0.25,18,27,0.667,103,43,101,0.426,32,65,0.492,11,36,0.306,20,22,0.909,117
2041,DET,2023-03-09,103,,CHO,0,240,40,89,0.449,33,68,0.485,7,21,0.333,16,20,0.8,103,43,86,0.5,35,62,0.565,8,24,0.333,19,32,0.594,113
2042,MEM,2023-03-07,103,@,LAL,0,240,36,93,0.387,27,56,0.482,9,37,0.243,22,29,0.759,103,41,90,0.456,34,62,0.548,7,28,0.25,23,29,0.793,112
2043,UTA,2023-03-03,103,@,OKC,0,240,38,78,0.487,29,49,0.592,9,29,0.31,18,23,0.783,103,52,104,0.5,35,61,0.574,17,43,0.395,9,14,0.643,130
2044,MIA,2023-02-25,103,@,CHO,0,240,32,80,0.4,21,44,0.477,11,36,0.306,28,34,0.824,103,38,88,0.432,28,57,0.491,10,31,0.323,22,27,0.815,108
2045,NOP,2023-02-13,103,@,OKC,1,240,39,74,0.527,30,44,0.682,9,30,0.3,16,18,0.889,103,38,90,0.422,29,57,0.509,9,33,0.273,15,18,0.833,100
2046,ORL,2023-02-11,103,,MIA,0,265,37,87,0.425,26,58,0.448,11,29,0.379,18,23,0.783,103,37,85,0.435,25,46,0.543,12,39,0.308,21,23,0.913,107
2047,GSW,2023-02-11,103,,LAL,0,240,40,96,0.417,28,52,0.538,12,44,0.273,11,12,0.917,103,40,89,0.449,32,64,0.5,8,25,0.32,21,26,0.808,109
2048,MEM,2023-02-05,103,,TOR,0,240,38,78,0.487,28,51,0.549,10,27,0.37,17,23,0.739,103,44,101,0.436,33,65,0.508,11,36,0.306,7,12,0.583,106
2049,IND,2023-02-05,103,,CLE,0,240,40,92,0.435,32,60,0.533,8,32,0.25,15,22,0.682,103,46,88,0.523,31,51,0.608,15,37,0.405,15,16,0.938,122
2050,CHI,2023-01-31,103,,LAC,0,240,38,77,0.494,26,53,0.491,12,24,0.5,15,21,0.714,103,37,93,0.398,25,49,0.51,12,44,0.273,22,26,0.846,108
2051,NOP,2023-01-28,103,,WAS,0,240,39,92,0.424,31,63,0.492,8,29,0.276,17,19,0.895,103,40,88,0.455,29,52,0.558,11,36,0.306,22,29,0.759,113
2052,HOU,2023-01-25,103,,WAS,0,240,42,97,0.433,37,69,0.536,5,28,0.179,14,20,0.7,103,39,98,0.398,27,60,0.45,12,38,0.316,18,23,0.783,108
2053,CLE,2023-01-24,103,@,NYK,0,240,40,87,0.46,28,54,0.519,12,33,0.364,11,16,0.688,103,37,75,0.493,20,42,0.476,17,33,0.515,14,21,0.667,105
2054,LAC,2023-01-18,103,@,UTA,0,240,37,92,0.402,22,58,0.379,15,34,0.441,14,21,0.667,103,45,87,0.517,26,55,0.473,19,32,0.594,17,22,0.773,126
2055,NOP,2023-01-16,103,@,CLE,0,240,38,75,0.507,28,48,0.583,10,27,0.37,17,22,0.773,103,39,80,0.488,30,52,0.577,9,28,0.321,26,33,0.788,113
2056,TOR,2023-01-14,103,,ATL,0,240,36,87,0.414,29,58,0.5,7,29,0.241,24,30,0.8,103,43,84,0.512,32,57,0.561,11,27,0.407,17,18,0.944,114
2057,LAC,2023-01-13,103,,DEN,0,240,41,87,0.471,31,58,0.534,10,29,0.345,11,14,0.786,103,41,82,0.5,27,49,0.551,14,33,0.424,19,25,0.76,115
2058,SAS,2023-01-02,103,@,BRK,0,240,42,97,0.433,34,66,0.515,8,31,0.258,11,18,0.611,103,58,93,0.624,47,73,0.644,11,20,0.55,12,15,0.8,139
2059,CLE,2022-12-31,103,@,CHI,1,240,39,85,0.459,26,47,0.553,13,38,0.342,12,19,0.632,103,39,81,0.481,32,60,0.533,7,21,0.333,17,24,0.708,102
2060,MIA,2022-12-20,103,,CHI,0,240,38,81,0.469,23,37,0.622,15,44,0.341,12,17,0.706,103,40,73,0.548,27,42,0.643,13,31,0.419,20,24,0.833,113
2061,SAC,2022-12-13,103,@,PHI,0,240,38,92,0.413,28,50,0.56,10,42,0.238,17,20,0.85,103,43,84,0.512,27,49,0.551,16,35,0.457,21,27,0.778,123
2062,ATL,2022-12-12,103,@,MEM,0,240,37,104,0.356,25,67,0.373,12,37,0.324,17,22,0.773,103,50,83,0.602,37,51,0.725,13,32,0.406,15,18,0.833,128
2063,DET,2022-12-09,103,@,MEM,0,240,36,90,0.4,25,55,0.455,11,35,0.314,20,27,0.741,103,44,91,0.484,35,59,0.593,9,32,0.281,17,32,0.531,114
2064,BOS,2022-12-04,103,@,BRK,1,240,35,81,0.432,20,43,0.465,15,38,0.395,18,20,0.9,103,34,84,0.405,25,58,0.431,9,26,0.346,15,22,0.682,92
2065,NYK,2022-11-30,103,,MIL,0,240,42,100,0.42,36,70,0.514,6,30,0.2,13,20,0.65,103,39,90,0.433,29,55,0.527,10,35,0.286,21,26,0.808,109
2066,ORL,2022-11-27,103,,PHI,0,240,36,79,0.456,24,39,0.615,12,40,0.3,19,25,0.76,103,50,77,0.649,39,50,0.78,11,27,0.407,22,27,0.815,133
2067,DEN,2022-11-16,103,,NYK,0,240,36,82,0.439,22,44,0.5,14,38,0.368,17,20,0.85,103,37,84,0.44,29,50,0.58,8,34,0.235,24,31,0.774,106
2068,DAL,2022-11-15,103,,LAC,1,240,35,80,0.438,18,37,0.486,17,43,0.395,16,24,0.667,103,34,64,0.531,22,36,0.611,12,28,0.429,21,26,0.808,101
2069,BRK,2022-11-13,103,@,LAL,0,240,36,80,0.45,29,53,0.547,7,27,0.259,24,31,0.774,103,44,91,0.484,33,64,0.516,11,27,0.407,17,20,0.85,116
2070,CHI,2022-11-13,103,,DEN,0,240,40,81,0.494,34,59,0.576,6,22,0.273,17,21,0.81,103,48,80,0.6,35,53,0.66,13,27,0.481,17,21,0.81,126
2071,MIN,2022-11-11,103,@,MEM,0,240,37,79,0.468,27,49,0.551,10,30,0.333,19,22,0.864,103,44,88,0.5,37,55,0.673,7,33,0.212,19,27,0.704,114
2072,OKC,2022-11-07,103,@,DET,0,240,41,102,0.402,31,69,0.449,10,33,0.303,11,17,0.647,103,39,93,0.419,30,60,0.5,9,33,0.273,25,33,0.758,112
2073,MEM,2022-11-06,103,,WAS,1,240,39,91,0.429,30,62,0.484,9,29,0.31,16,20,0.8,103,41,96,0.427,33,55,0.6,8,41,0.195,7,10,0.7,97
2074,DAL,2022-11-02,103,,UTA,1,240,42,84,0.5,31,46,0.674,11,38,0.289,8,15,0.533,103,39,84,0.464,29,54,0.537,10,30,0.333,12,14,0.857,100
2075,CLE,2022-10-26,103,,ORL,1,240,36,87,0.414,26,54,0.481,10,33,0.303,21,30,0.7,103,35,81,0.432,29,57,0.509,6,24,0.25,16,21,0.762,92
2076,LAC,2022-10-20,103,@,LAL,1,240,37,80,0.463,28,51,0.549,9,29,0.31,20,31,0.645,103,33,94,0.351,24,49,0.49,9,45,0.2,22,26,0.846,97
2077,TOR,2023-04-07,102,@,BOS,0,240,40,93,0.43,31,62,0.5,9,31,0.29,13,17,0.765,102,45,81,0.556,30,37,0.811,15,44,0.341,16,21,0.762,121
2078,BRK,2023-04-04,102,,MIN,0,240,39,90,0.433,26,55,0.473,13,35,0.371,11,14,0.786,102,41,85,0.482,33,61,0.541,8,24,0.333,17,22,0.773,107
2079,DET,2023-04-02,102,@,ORL,0,240,32,78,0.41,23,45,0.511,9,33,0.273,29,36,0.806,102,43,75,0.573,26,42,0.619,17,33,0.515,25,40,0.625,128
2080,POR,2023-03-19,102,,LAC,0,240,37,82,0.451,31,53,0.585,6,29,0.207,22,24,0.917,102,43,94,0.457,31,66,0.47,12,28,0.429,19,23,0.826,117
2081,BRK,2023-03-19,102,,DEN,0,240,38,82,0.463,26,47,0.553,12,35,0.343,14,16,0.875,102,42,80,0.525,30,57,0.526,12,23,0.522,12,13,0.923,108
2082,MIN,2023-03-15,102,,BOS,0,240,37,84,0.44,25,48,0.521,12,36,0.333,16,22,0.727,102,34,84,0.405,22,44,0.5,12,40,0.3,24,30,0.8,104
2083,OKC,2023-03-12,102,@,SAS,1,240,36,95,0.379,26,56,0.464,10,39,0.256,20,23,0.87,102,33,88,0.375,23,52,0.442,10,36,0.278,14,19,0.737,90
2084,BRK,2023-03-05,102,,CHO,1,240,36,92,0.391,24,49,0.49,12,43,0.279,18,22,0.818,102,33,88,0.375,25,58,0.431,8,30,0.267,12,15,0.8,86
2085,LAL,2023-03-03,102,,MIN,0,240,36,87,0.414,26,56,0.464,10,31,0.323,20,24,0.833,102,42,89,0.472,28,55,0.509,14,34,0.412,12,16,0.75,110
2086,SAS,2023-02-28,102,@,UTA,1,240,39,91,0.429,31,65,0.477,8,26,0.308,16,25,0.64,102,30,85,0.353,20,51,0.392,10,34,0.294,24,36,0.667,94
2087,CHI,2023-02-26,102,,WAS,1,240,40,79,0.506,32,49,0.653,8,30,0.267,14,17,0.824,102,32,76,0.421,26,48,0.542,6,28,0.214,12,23,0.522,82
2088,SAS,2023-02-25,102,@,UTA,0,240,38,97,0.392,29,63,0.46,9,34,0.265,17,21,0.81,102,43,92,0.467,33,64,0.516,10,28,0.357,22,28,0.786,118
2089,NOP,2023-02-15,102,@,LAL,0,240,39,89,0.438,32,64,0.5,7,25,0.28,17,24,0.708,102,44,83,0.53,34,46,0.739,10,37,0.27,22,36,0.611,120
2090,NYK,2023-02-07,102,@,ORL,1,240,37,81,0.457,22,38,0.579,15,43,0.349,13,19,0.684,102,37,79,0.468,31,54,0.574,6,25,0.24,18,24,0.75,98
2091,NOP,2023-01-25,102,,MIN,0,240,37,85,0.435,25,47,0.532,12,38,0.316,16,21,0.762,102,40,82,0.488,29,53,0.547,11,29,0.379,20,28,0.714,111
2092,CHO,2023-01-23,102,@,UTA,0,240,38,85,0.447,36,69,0.522,2,16,0.125,24,34,0.706,102,41,86,0.477,25,46,0.543,16,40,0.4,22,26,0.846,120
2093,MIL,2023-01-21,102,@,CLE,0,240,39,86,0.453,25,47,0.532,14,39,0.359,10,11,0.909,102,48,86,0.558,41,64,0.641,7,22,0.318,11,17,0.647,114
2094,BRK,2023-01-15,102,,OKC,0,240,39,91,0.429,27,50,0.54,12,41,0.293,12,19,0.632,102,40,90,0.444,28,59,0.475,12,31,0.387,20,26,0.769,112
2095,CLE,2023-01-14,102,@,MIN,0,240,37,76,0.487,29,48,0.604,8,28,0.286,20,23,0.87,102,45,80,0.563,36,52,0.692,9,28,0.321,11,15,0.733,110
2096,MIL,2023-01-12,102,@,MIA,0,240,35,87,0.402,13,30,0.433,22,57,0.386,10,15,0.667,102,42,95,0.442,33,61,0.541,9,34,0.265,15,16,0.938,108
2097,BRK,2023-01-08,102,@,MIA,1,240,39,76,0.513,27,43,0.628,12,33,0.364,12,15,0.8,102,38,92,0.413,25,57,0.439,13,35,0.371,12,17,0.706,101
2098,NOP,2023-01-06,102,,BRK,0,240,35,88,0.398,23,59,0.39,12,29,0.414,20,25,0.8,102,37,85,0.435,22,52,0.423,15,33,0.455,19,20,0.95,108
2099,NYK,2023-01-02,102,,PHO,1,240,36,74,0.486,23,41,0.561,13,33,0.394,17,25,0.68,102,34,87,0.391,24,50,0.48,10,37,0.27,5,7,0.714,83
2100,CHI,2022-12-31,102,,CLE,0,240,39,81,0.481,32,60,0.533,7,21,0.333,17,24,0.708,102,39,85,0.459,26,47,0.553,13,38,0.342,12,19,0.632,103
2101,PHO,2022-12-28,102,@,WAS,0,240,39,87,0.448,26,56,0.464,13,31,0.419,11,16,0.688,102,47,82,0.573,39,56,0.696,8,26,0.308,25,28,0.893,127
2102,HOU,2022-12-27,102,@,BOS,0,240,38,95,0.4,24,50,0.48,14,45,0.311,12,14,0.857,102,43,91,0.473,23,35,0.657,20,56,0.357,20,23,0.87,126
2103,LAC,2022-12-17,102,,WAS,1,240,37,86,0.43,25,57,0.439,12,29,0.414,16,26,0.615,102,36,84,0.429,27,59,0.458,9,25,0.36,12,13,0.923,93
2104,OKC,2022-12-10,102,@,CLE,0,240,38,83,0.458,28,54,0.519,10,29,0.345,16,20,0.8,102,40,85,0.471,28,53,0.528,12,32,0.375,18,26,0.692,110
2105,CHO,2022-12-09,102,,NYK,0,240,37,84,0.44,31,58,0.534,6,26,0.231,22,28,0.786,102,41,93,0.441,28,59,0.475,13,34,0.382,26,30,0.867,121
2106,OKC,2022-12-07,102,@,MEM,0,240,34,92,0.37,20,54,0.37,14,38,0.368,20,23,0.87,102,48,94,0.511,34,56,0.607,14,38,0.368,13,16,0.813,123
2107,LAL,2022-12-06,102,@,CLE,0,240,38,89,0.427,32,53,0.604,6,36,0.167,20,24,0.833,102,48,93,0.516,41,66,0.621,7,27,0.259,13,17,0.765,116
2108,ORL,2022-12-05,102,,MIL,0,240,34,93,0.366,26,61,0.426,8,32,0.25,26,29,0.897,102,38,85,0.447,25,45,0.556,13,40,0.325,20,26,0.769,109
2109,ORL,2022-11-28,102,@,BRK,0,240,38,80,0.475,25,49,0.51,13,31,0.419,13,22,0.591,102,44,81,0.543,35,53,0.66,9,28,0.321,12,14,0.857,109
2110,CLE,2022-11-27,102,@,DET,1,240,33,77,0.429,25,49,0.51,8,28,0.286,28,33,0.848,102,36,79,0.456,28,51,0.549,8,28,0.286,14,26,0.538,94
2111,DET,2022-11-25,102,@,PHO,0,240,39,92,0.424,30,66,0.455,9,26,0.346,15,16,0.938,102,42,87,0.483,35,58,0.603,7,29,0.241,17,26,0.654,108
2112,CLE,2022-11-25,102,@,MIL,0,240,34,87,0.391,22,54,0.407,12,33,0.364,22,26,0.846,102,42,83,0.506,27,51,0.529,15,32,0.469,18,25,0.72,117
2113,ATL,2022-11-21,102,@,CLE,0,240,38,87,0.437,27,53,0.509,11,34,0.324,15,17,0.882,102,42,70,0.6,32,51,0.627,10,19,0.526,20,23,0.87,114
2114,ORL,2022-11-21,102,@,IND,0,240,36,85,0.424,25,50,0.5,11,35,0.314,19,25,0.76,102,43,86,0.5,30,40,0.75,13,46,0.283,24,27,0.889,123
2115,CHO,2022-11-20,102,@,WAS,0,240,39,100,0.39,31,68,0.456,8,32,0.25,16,23,0.696,102,40,93,0.43,27,59,0.458,13,34,0.382,13,18,0.722,106
2116,MIL,2022-11-18,102,@,PHI,0,240,41,90,0.456,29,54,0.537,12,36,0.333,8,21,0.381,102,40,78,0.513,27,50,0.54,13,28,0.464,17,26,0.654,110
2117,MEM,2022-11-15,102,@,NOP,0,240,38,92,0.413,29,57,0.509,9,35,0.257,17,25,0.68,102,43,91,0.473,25,53,0.472,18,38,0.474,9,12,0.75,113
2118,WAS,2022-11-13,102,,MEM,1,240,36,86,0.419,17,46,0.37,19,40,0.475,11,21,0.524,102,38,96,0.396,29,68,0.426,9,28,0.321,7,10,0.7,92
2119,LAC,2022-11-06,102,,UTA,0,240,43,87,0.494,35,54,0.648,8,33,0.242,8,13,0.615,102,35,75,0.467,20,35,0.571,15,40,0.375,25,26,0.962,110
2120,PHO,2022-11-05,102,,POR,1,240,35,82,0.427,24,52,0.462,11,30,0.367,21,28,0.75,102,30,79,0.38,23,64,0.359,7,15,0.467,15,24,0.625,82
2121,MIN,2022-11-04,102,,MIL,0,240,39,92,0.424,28,51,0.549,11,41,0.268,13,17,0.765,102,41,85,0.482,24,47,0.511,17,38,0.447,16,28,0.571,115
2122,LAL,2022-10-28,102,@,MIN,0,240,37,89,0.416,28,60,0.467,9,29,0.31,19,27,0.704,102,41,99,0.414,28,59,0.475,13,40,0.325,16,24,0.667,111
2123,BOS,2022-10-24,102,@,CHI,0,240,37,100,0.37,19,52,0.365,18,48,0.375,10,12,0.833,102,42,87,0.483,32,66,0.485,10,21,0.476,26,29,0.897,120
2124,ORL,2022-10-24,102,@,NYK,0,240,36,86,0.419,29,51,0.569,7,35,0.2,23,27,0.852,102,43,93,0.462,32,56,0.571,11,37,0.297,18,25,0.72,115
2125,WAS,2022-10-21,102,,CHI,1,240,41,80,0.513,31,54,0.574,10,26,0.385,10,11,0.909,102,33,79,0.418,26,52,0.5,7,27,0.259,27,33,0.818,100
2126,DEN,2022-10-19,102,@,UTA,0,240,40,83,0.482,35,61,0.574,5,22,0.227,17,18,0.944,102,42,83,0.506,26,45,0.578,16,38,0.421,23,31,0.742,123
2127,SAS,2022-10-19,102,,CHO,0,240,40,99,0.404,33,65,0.508,7,34,0.206,15,21,0.714,102,48,94,0.511,35,65,0.538,13,29,0.448,20,23,0.87,129
2128,POR,2023-04-09,101,,GSW,0,240,38,95,0.4,29,60,0.483,9,35,0.257,16,24,0.667,101,58,96,0.604,31,47,0.66,27,49,0.551,14,16,0.875,157
2129,BRK,2023-04-07,101,,ORL,1,240,35,89,0.393,26,47,0.553,9,42,0.214,22,25,0.88,101,31,87,0.356,24,49,0.49,7,38,0.184,15,17,0.882,84
2130,PHI,2023-04-06,101,,MIA,0,240,39,76,0.513,29,40,0.725,10,36,0.278,13,15,0.867,101,49,88,0.557,31,49,0.633,18,39,0.462,13,15,0.867,129
2131,BOS,2023-04-04,101,@,PHI,0,240,38,91,0.418,23,46,0.5,15,45,0.333,10,16,0.625,101,39,78,0.5,28,49,0.571,11,29,0.379,14,16,0.875,103
2132,NYK,2023-03-29,101,,MIA,1,240,38,76,0.5,25,45,0.556,13,31,0.419,12,23,0.522,101,35,79,0.443,22,40,0.55,13,39,0.333,9,14,0.643,92
2133,OKC,2023-03-21,101,@,LAC,1,240,39,93,0.419,29,56,0.518,10,37,0.27,13,14,0.929,101,41,86,0.477,35,55,0.636,6,31,0.194,12,21,0.571,100
2134,SAC,2023-03-16,101,@,BRK,1,240,32,82,0.39,19,41,0.463,13,41,0.317,24,32,0.75,101,33,80,0.413,19,41,0.463,14,39,0.359,16,23,0.696,96
2135,OKC,2023-03-08,101,@,PHO,0,240,33,88,0.375,18,45,0.4,15,43,0.349,20,21,0.952,101,49,94,0.521,29,51,0.569,20,43,0.465,14,16,0.875,132
2136,LAC,2023-02-28,101,,MIN,0,240,35,83,0.422,24,55,0.436,11,28,0.393,20,23,0.87,101,43,90,0.478,34,64,0.531,9,26,0.346,13,22,0.591,108
2137,ORL,2023-02-27,101,@,NOP,1,240,36,79,0.456,27,45,0.6,9,34,0.265,20,26,0.769,101,34,76,0.447,28,49,0.571,6,27,0.222,19,23,0.826,93
2138,MIA,2023-02-27,101,@,PHI,1,240,35,81,0.432,20,44,0.455,15,37,0.405,16,22,0.727,101,32,73,0.438,22,46,0.478,10,27,0.37,25,28,0.893,99
2139,PHO,2023-02-26,101,@,MIL,0,240,40,95,0.421,32,71,0.451,8,24,0.333,13,22,0.591,101,38,87,0.437,25,42,0.595,13,45,0.289,15,21,0.714,104
2140,HOU,2023-02-24,101,@,GSW,0,240,36,92,0.391,25,57,0.439,11,35,0.314,18,22,0.818,101,37,78,0.474,11,24,0.458,26,54,0.481,16,18,0.889,116
2141,ATL,2023-02-15,101,,NYK,0,240,40,97,0.412,35,71,0.493,5,26,0.192,16,21,0.762,101,45,96,0.469,31,53,0.585,14,43,0.326,18,22,0.818,122
2142,POR,2023-02-14,101,,WAS,0,240,36,86,0.419,24,44,0.545,12,42,0.286,17,24,0.708,101,45,79,0.57,28,46,0.609,17,33,0.515,19,22,0.864,126
2143,PHI,2023-02-11,101,@,BRK,1,240,33,75,0.44,27,52,0.519,6,23,0.261,29,30,0.967,101,37,92,0.402,24,52,0.462,13,40,0.325,11,13,0.846,98
2144,OKC,2023-01-22,101,@,DEN,1,240,40,89,0.449,33,63,0.524,7,26,0.269,14,16,0.875,101,36,82,0.439,26,54,0.481,10,28,0.357,17,33,0.515,99
2145,DAL,2023-01-10,101,@,LAC,0,240,30,69,0.435,18,31,0.581,12,38,0.316,29,36,0.806,101,39,86,0.453,27,55,0.491,12,31,0.387,23,30,0.767,113
2146,MIA,2023-01-08,101,,BRK,0,240,38,92,0.413,25,57,0.439,13,35,0.371,12,17,0.706,101,39,76,0.513,27,43,0.628,12,33,0.364,12,15,0.8,102
2147,GSW,2023-01-07,101,,ORL,0,240,33,88,0.375,15,30,0.5,18,58,0.31,17,21,0.81,101,44,87,0.506,31,55,0.564,13,32,0.406,14,24,0.583,115
2148,TOR,2023-01-04,101,,MIL,0,265,38,116,0.328,29,70,0.414,9,46,0.196,16,20,0.8,101,35,88,0.398,22,49,0.449,13,39,0.333,21,30,0.7,104
2149,NOP,2022-12-31,101,@,MEM,0,240,32,91,0.352,24,61,0.393,8,30,0.267,29,36,0.806,101,47,92,0.511,42,63,0.667,5,29,0.172,17,22,0.773,116
2150,ORL,2022-12-28,101,@,DET,0,240,35,85,0.412,30,63,0.476,5,22,0.227,26,34,0.765,101,36,80,0.45,18,38,0.474,18,42,0.429,31,40,0.775,121
2151,OKC,2022-12-21,101,,POR,1,240,36,77,0.468,28,53,0.528,8,24,0.333,21,25,0.84,101,39,79,0.494,25,43,0.581,14,36,0.389,6,9,0.667,98
2152,TOR,2022-12-19,101,@,PHI,0,265,37,88,0.42,26,48,0.542,11,40,0.275,16,20,0.8,101,32,80,0.4,17,38,0.447,15,42,0.357,25,27,0.926,104
2153,SAS,2022-12-17,101,,MIA,0,240,33,77,0.429,23,50,0.46,10,27,0.37,25,33,0.758,101,42,82,0.512,31,52,0.596,11,30,0.367,16,23,0.696,111
2154,MIL,2022-12-15,101,@,MEM,0,240,35,94,0.372,22,44,0.5,13,50,0.26,18,27,0.667,101,56,102,0.549,44,70,0.629,12,32,0.375,18,23,0.783,142
2155,MEM,2022-12-05,101,,MIA,1,240,42,90,0.467,34,58,0.586,8,32,0.25,9,9,1.0,101,31,79,0.392,17,39,0.436,14,40,0.35,17,22,0.773,93
2156,CHI,2022-12-04,101,@,SAC,0,240,38,86,0.442,29,61,0.475,9,25,0.36,16,19,0.842,101,40,86,0.465,27,43,0.628,13,43,0.302,17,19,0.895,110
2157,HOU,2022-12-03,101,@,GSW,0,240,40,91,0.44,37,63,0.587,3,28,0.107,18,20,0.9,101,45,85,0.529,20,33,0.606,25,52,0.481,5,10,0.5,120
2158,MEM,2022-11-30,101,@,MIN,0,240,37,87,0.425,28,61,0.459,9,26,0.346,18,30,0.6,101,41,89,0.461,29,50,0.58,12,39,0.308,15,19,0.789,109
2159,OKC,2022-11-28,101,@,NOP,0,240,34,92,0.37,22,54,0.407,12,38,0.316,21,23,0.913,101,39,87,0.448,30,55,0.545,9,32,0.281,18,20,0.9,105
2160,ATL,2022-11-28,101,@,PHI,0,240,37,74,0.5,25,47,0.532,12,27,0.444,15,22,0.682,101,39,86,0.453,29,58,0.5,10,28,0.357,16,18,0.889,104
2161,IND,2022-11-23,101,,MIN,0,240,37,96,0.385,21,52,0.404,16,44,0.364,11,16,0.688,101,47,77,0.61,39,55,0.709,8,22,0.364,13,17,0.765,115
2162,PHI,2022-11-23,101,@,CHO,0,240,38,86,0.442,29,48,0.604,9,38,0.237,16,18,0.889,101,44,92,0.478,38,69,0.551,6,23,0.261,13,21,0.619,107
2163,MIA,2022-11-21,101,@,MIN,0,240,35,90,0.389,24,52,0.462,11,38,0.289,20,30,0.667,101,37,85,0.435,23,38,0.605,14,47,0.298,17,20,0.85,105
2164,NYK,2022-11-18,101,@,GSW,0,240,30,87,0.345,21,53,0.396,9,34,0.265,32,34,0.941,101,41,91,0.451,23,41,0.561,18,50,0.36,11,20,0.55,111
2165,ATL,2022-11-16,101,,BOS,0,240,42,101,0.416,35,69,0.507,7,32,0.219,10,13,0.769,101,48,88,0.545,27,42,0.643,21,46,0.457,9,10,0.9,126
2166,HOU,2022-11-16,101,@,DAL,1,240,35,75,0.467,25,53,0.472,10,22,0.455,21,24,0.875,101,31,102,0.304,19,47,0.404,12,55,0.218,18,19,0.947,92
2167,LAC,2022-11-15,101,@,DAL,0,240,34,64,0.531,22,36,0.611,12,28,0.429,21,26,0.808,101,35,80,0.438,18,37,0.486,17,43,0.395,16,24,0.667,103
2168,CLE,2022-11-11,101,@,GSW,0,240,37,92,0.402,29,62,0.468,8,30,0.267,19,26,0.731,101,40,82,0.488,25,46,0.543,15,36,0.417,11,14,0.786,106
2169,LAL,2022-11-09,101,@,LAC,0,240,40,88,0.455,30,56,0.536,10,32,0.313,11,17,0.647,101,41,81,0.506,29,48,0.604,12,33,0.364,20,26,0.769,114
2170,SAS,2022-11-05,101,@,DEN,0,240,39,80,0.488,27,50,0.54,12,30,0.4,11,19,0.579,101,53,87,0.609,38,58,0.655,15,29,0.517,5,10,0.5,126
2171,IND,2022-11-04,101,,MIA,1,240,37,80,0.463,25,41,0.61,12,39,0.308,15,23,0.652,101,31,81,0.383,20,42,0.476,11,39,0.282,26,26,1.0,99
2172,HOU,2022-11-02,101,,LAC,0,240,37,88,0.42,26,50,0.52,11,38,0.289,16,21,0.762,101,41,84,0.488,29,51,0.569,12,33,0.364,15,19,0.789,109
2173,UTA,2022-10-28,101,@,DEN,0,240,38,91,0.418,28,52,0.538,10,39,0.256,15,19,0.789,101,39,85,0.459,22,48,0.458,17,37,0.459,22,34,0.647,117
2174,HOU,2022-10-26,101,@,UTA,0,240,36,94,0.383,25,54,0.463,11,40,0.275,18,24,0.75,101,38,90,0.422,25,45,0.556,13,45,0.289,20,30,0.667,109
2175,MEM,2023-04-09,100,@,OKC,0,240,40,92,0.435,33,55,0.6,7,37,0.189,13,18,0.722,100,45,90,0.5,33,54,0.611,12,36,0.333,13,16,0.813,115
2176,CHO,2023-04-04,100,,TOR,0,240,36,77,0.468,24,46,0.522,12,31,0.387,16,19,0.842,100,42,88,0.477,27,55,0.491,15,33,0.455,21,28,0.75,120
2177,PHO,2023-03-31,100,,DEN,1,240,37,88,0.42,27,61,0.443,10,27,0.37,16,21,0.762,100,38,95,0.4,32,69,0.464,6,26,0.231,11,20,0.55,93
2178,MIN,2023-03-29,100,@,PHO,0,240,40,90,0.444,28,55,0.509,12,35,0.343,8,12,0.667,100,40,96,0.417,34,76,0.447,6,20,0.3,21,27,0.778,107
2179,MIA,2023-03-25,100,,BRK,0,240,38,80,0.475,26,50,0.52,12,30,0.4,12,14,0.857,100,44,89,0.494,26,49,0.531,18,40,0.45,23,25,0.92,129
2180,LAC,2023-03-21,100,,OKC,0,240,41,86,0.477,35,55,0.636,6,31,0.194,12,21,0.571,100,39,93,0.419,29,56,0.518,10,37,0.27,13,14,0.929,101
2181,DET,2023-03-19,100,,MIA,0,240,38,82,0.463,28,50,0.56,10,32,0.313,14,17,0.824,100,38,79,0.481,25,40,0.625,13,39,0.333,23,25,0.92,112
2182,DET,2023-03-16,100,,DEN,0,240,39,85,0.459,27,58,0.466,12,27,0.444,10,18,0.556,100,47,89,0.528,39,65,0.6,8,24,0.333,17,25,0.68,119
2183,MIA,2023-03-08,100,,CLE,0,240,35,70,0.5,27,41,0.659,8,29,0.276,22,29,0.759,100,39,80,0.488,30,52,0.577,9,28,0.321,17,19,0.895,104
2184,TOR,2023-03-08,100,@,LAC,0,240,37,96,0.385,24,64,0.375,13,32,0.406,13,14,0.929,100,39,71,0.549,33,51,0.647,6,20,0.3,24,31,0.774,108
2185,CHI,2023-02-16,100,,MIL,0,240,37,97,0.381,27,65,0.415,10,32,0.313,16,21,0.762,100,40,88,0.455,22,41,0.537,18,47,0.383,14,18,0.778,112
2186,ORL,2023-02-13,100,@,CHI,1,240,38,81,0.469,30,54,0.556,8,27,0.296,16,19,0.842,100,35,86,0.407,32,65,0.492,3,21,0.143,18,19,0.947,91
2187,OKC,2023-02-13,100,,NOP,0,240,38,90,0.422,29,57,0.509,9,33,0.273,15,18,0.833,100,39,74,0.527,30,44,0.682,9,30,0.3,16,18,0.889,103
2188,DET,2023-02-04,100,,PHO,0,240,35,81,0.432,19,39,0.487,16,42,0.381,14,22,0.636,100,42,75,0.56,31,52,0.596,11,23,0.478,21,31,0.677,116
2189,PHO,2023-02-01,100,,ATL,0,240,35,86,0.407,31,58,0.534,4,28,0.143,26,31,0.839,100,52,91,0.571,33,58,0.569,19,33,0.576,9,11,0.818,132
2190,MIA,2023-01-31,100,@,CLE,1,240,34,78,0.436,20,47,0.426,14,31,0.452,18,25,0.72,100,40,83,0.482,29,43,0.674,11,40,0.275,6,12,0.5,97
2191,IND,2023-01-29,100,@,MEM,0,240,36,79,0.456,27,47,0.574,9,32,0.281,19,21,0.905,100,43,89,0.483,34,52,0.654,9,37,0.243,17,22,0.773,112
2192,DAL,2023-01-28,100,@,UTA,0,240,35,80,0.438,17,34,0.5,18,46,0.391,12,17,0.706,100,39,82,0.476,26,46,0.565,13,36,0.361,17,24,0.708,108
2193,MEM,2023-01-27,100,@,MIN,0,240,38,93,0.409,30,60,0.5,8,33,0.242,16,19,0.842,100,44,86,0.512,31,51,0.608,13,35,0.371,10,15,0.667,111
2194,CLE,2023-01-27,100,@,OKC,0,240,39,88,0.443,31,59,0.525,8,29,0.276,14,18,0.778,100,40,76,0.526,30,58,0.517,10,18,0.556,22,25,0.88,112
2195,SAS,2023-01-26,100,@,LAC,0,240,37,82,0.451,29,58,0.5,8,24,0.333,18,28,0.643,100,52,89,0.584,34,51,0.667,18,38,0.474,16,21,0.762,138
2196,MEM,2023-01-23,100,@,SAC,0,240,40,98,0.408,28,62,0.452,12,36,0.333,8,10,0.8,100,49,88,0.557,27,48,0.563,22,40,0.55,13,14,0.929,133
2197,ATL,2023-01-23,100,@,CHI,0,240,39,85,0.459,29,52,0.558,10,33,0.303,12,19,0.632,100,44,95,0.463,33,61,0.541,11,34,0.324,12,18,0.667,111
2198,MIA,2023-01-22,100,,NOP,1,240,35,80,0.438,27,46,0.587,8,34,0.235,22,27,0.815,100,37,78,0.474,29,48,0.604,8,30,0.267,14,18,0.778,96
2199,HOU,2023-01-15,100,@,LAC,0,240,38,84,0.452,31,53,0.585,7,31,0.226,17,23,0.739,100,46,88,0.523,32,56,0.571,14,32,0.438,15,21,0.714,121
2200,WAS,2023-01-11,100,,CHI,1,240,38,82,0.463,31,59,0.525,7,23,0.304,17,21,0.81,100,41,88,0.466,32,59,0.542,9,29,0.31,6,9,0.667,97
2201,LAC,2023-01-02,100,,MIA,0,240,29,67,0.433,17,38,0.447,12,29,0.414,30,34,0.882,100,39,85,0.459,27,49,0.551,12,36,0.333,20,24,0.833,110
2202,ORL,2022-12-30,100,,WAS,0,240,42,100,0.42,37,73,0.507,5,27,0.185,11,16,0.688,100,42,75,0.56,27,40,0.675,15,35,0.429,20,25,0.8,119
2203,PHO,2022-12-23,100,,MEM,0,240,38,87,0.437,29,52,0.558,9,35,0.257,15,26,0.577,100,45,91,0.495,38,68,0.559,7,23,0.304,28,38,0.737,125
2204,MIL,2022-12-23,100,@,BRK,0,240,37,84,0.44,28,47,0.596,9,37,0.243,17,22,0.773,100,46,93,0.495,32,61,0.525,14,32,0.438,12,13,0.923,118
2205,CLE,2022-12-17,100,,DAL,1,265,40,94,0.426,33,58,0.569,7,36,0.194,13,22,0.591,100,36,88,0.409,21,39,0.538,15,49,0.306,12,19,0.632,99
2206,NOP,2022-12-13,100,@,UTA,0,240,37,93,0.398,33,66,0.5,4,27,0.148,22,33,0.667,100,49,103,0.476,34,56,0.607,15,47,0.319,8,12,0.667,121
2207,WAS,2022-12-12,100,,BRK,0,240,37,79,0.468,26,48,0.542,11,31,0.355,15,22,0.682,100,44,89,0.494,36,62,0.581,8,27,0.296,16,18,0.889,112
2208,IND,2022-12-04,100,@,POR,0,240,40,91,0.44,30,58,0.517,10,33,0.303,10,12,0.833,100,42,86,0.488,25,46,0.543,17,40,0.425,15,22,0.682,116
2209,NYK,2022-12-03,100,,DAL,0,240,35,77,0.455,25,46,0.543,10,31,0.323,20,28,0.714,100,43,100,0.43,19,39,0.487,24,61,0.393,11,14,0.786,121
2210,HOU,2022-11-30,100,@,DEN,0,240,37,88,0.42,25,47,0.532,12,41,0.293,14,18,0.778,100,44,83,0.53,27,51,0.529,17,32,0.531,15,20,0.75,120
2211,TOR,2022-11-28,100,,CLE,1,240,37,84,0.44,25,56,0.446,12,28,0.429,14,17,0.824,100,34,90,0.378,27,52,0.519,7,38,0.184,13,16,0.813,88
2212,IND,2022-11-27,100,@,LAC,0,240,36,94,0.383,27,52,0.519,9,42,0.214,19,23,0.826,100,42,94,0.447,36,62,0.581,6,32,0.188,24,32,0.75,114
2213,DAL,2022-11-26,100,@,TOR,0,240,35,73,0.479,24,34,0.706,11,39,0.282,19,24,0.792,100,38,88,0.432,30,62,0.484,8,26,0.308,21,26,0.808,105
2214,PHI,2022-11-07,100,,PHO,1,240,31,80,0.388,19,48,0.396,12,32,0.375,26,31,0.839,100,32,73,0.438,26,54,0.481,6,19,0.316,18,22,0.818,88
2215,CHO,2022-11-07,100,,WAS,0,240,42,101,0.416,37,69,0.536,5,32,0.156,11,16,0.688,100,42,80,0.525,37,61,0.607,5,19,0.263,19,30,0.633,108
2216,LAL,2022-11-06,100,,CLE,0,240,40,87,0.46,32,60,0.533,8,27,0.296,12,21,0.571,100,37,84,0.44,29,52,0.558,8,32,0.25,32,36,0.889,114
2217,UTA,2022-11-02,100,@,DAL,0,240,39,84,0.464,29,54,0.537,10,30,0.333,12,14,0.857,100,42,84,0.5,31,46,0.674,11,38,0.289,8,15,0.533,103
2218,SAS,2022-11-02,100,,TOR,0,240,37,94,0.394,23,51,0.451,14,43,0.326,12,14,0.857,100,57,106,0.538,43,73,0.589,14,33,0.424,15,16,0.938,143
2219,CHI,2022-10-21,100,@,WAS,0,240,33,79,0.418,26,52,0.5,7,27,0.259,27,33,0.818,100,41,80,0.513,31,54,0.574,10,26,0.385,10,11,0.909,102
2220,MIL,2023-03-30,99,,BOS,0,240,38,101,0.376,24,58,0.414,14,43,0.326,9,13,0.692,99,51,91,0.56,29,48,0.604,22,43,0.512,16,20,0.8,140
2221,MIN,2023-03-26,99,@,GSW,1,240,34,80,0.425,17,40,0.425,17,40,0.425,14,25,0.56,99,34,82,0.415,19,42,0.452,15,40,0.375,13,17,0.765,96
2222,MIA,2023-03-18,99,@,CHI,0,240,35,82,0.427,25,45,0.556,10,37,0.27,19,24,0.792,99,45,80,0.563,28,46,0.609,17,34,0.5,6,6,1.0,113
2223,NOP,2023-03-03,99,@,GSW,0,240,34,77,0.442,24,48,0.5,10,29,0.345,21,27,0.778,99,40,78,0.513,30,47,0.638,10,31,0.323,18,20,0.9,108
2224,IND,2023-03-02,99,@,SAS,0,240,41,90,0.456,33,67,0.493,8,23,0.348,9,11,0.818,99,45,98,0.459,35,66,0.53,10,32,0.313,10,13,0.769,110
2225,HOU,2023-03-01,99,,MEM,0,240,36,90,0.4,25,56,0.446,11,34,0.324,16,25,0.64,99,40,83,0.482,23,42,0.548,17,41,0.415,16,19,0.842,113
2226,PHI,2023-02-27,99,,MIA,0,240,32,73,0.438,22,46,0.478,10,27,0.37,25,28,0.893,99,35,81,0.432,20,44,0.455,15,37,0.405,16,22,0.727,101
2227,MIA,2023-02-24,99,@,MIL,0,240,36,92,0.391,27,52,0.519,9,40,0.225,18,25,0.72,99,47,98,0.48,28,52,0.538,19,46,0.413,15,19,0.789,128
2228,PHI,2023-02-08,99,@,BOS,0,240,37,83,0.446,27,52,0.519,10,31,0.323,15,20,0.75,99,40,76,0.526,21,41,0.512,19,35,0.543,7,10,0.7,106
2229,DET,2023-02-06,99,,BOS,0,240,37,87,0.425,28,54,0.519,9,33,0.273,16,21,0.762,99,39,83,0.47,23,46,0.5,16,37,0.432,17,21,0.81,111
2230,LAC,2023-01-29,99,@,CLE,0,240,37,89,0.416,35,70,0.5,2,19,0.105,23,27,0.852,99,44,78,0.564,24,45,0.533,20,33,0.606,14,19,0.737,122
2231,DAL,2023-01-26,99,@,PHO,1,240,33,77,0.429,20,43,0.465,13,34,0.382,20,28,0.714,99,35,86,0.407,22,54,0.407,13,32,0.406,12,16,0.75,95
2232,DEN,2023-01-25,99,@,MIL,0,240,38,97,0.392,27,63,0.429,11,34,0.324,12,16,0.75,99,37,78,0.474,24,48,0.5,13,30,0.433,20,28,0.714,107
2233,DEN,2023-01-24,99,@,NOP,1,240,39,80,0.488,28,47,0.596,11,33,0.333,10,13,0.769,99,38,85,0.447,33,59,0.559,5,26,0.192,17,20,0.85,98
2234,DEN,2023-01-22,99,,OKC,0,240,36,82,0.439,26,54,0.481,10,28,0.357,17,33,0.515,99,40,89,0.449,33,63,0.524,7,26,0.269,14,16,0.875,101
2235,CHI,2023-01-09,99,@,BOS,0,240,39,86,0.453,27,51,0.529,12,35,0.343,9,14,0.643,99,38,87,0.437,27,46,0.587,11,41,0.268,20,21,0.952,107
2236,POR,2023-01-06,99,@,IND,0,240,38,94,0.404,29,61,0.475,9,33,0.273,14,17,0.824,99,38,84,0.452,31,59,0.525,7,25,0.28,25,28,0.893,108
2237,MIN,2022-12-21,99,,DAL,0,240,42,85,0.494,34,55,0.618,8,30,0.267,7,10,0.7,99,34,75,0.453,21,36,0.583,13,39,0.333,23,27,0.852,104
2238,UTA,2022-12-19,99,@,CLE,0,240,36,93,0.387,26,59,0.441,10,34,0.294,17,23,0.739,99,43,70,0.614,28,44,0.636,15,26,0.577,21,26,0.808,122
2239,DAL,2022-12-17,99,@,CLE,0,265,36,88,0.409,21,39,0.538,15,49,0.306,12,19,0.632,99,40,94,0.426,33,58,0.569,7,36,0.194,13,22,0.591,100
2240,LAC,2022-12-14,99,,MIN,1,240,34,89,0.382,20,43,0.465,14,46,0.304,17,21,0.81,99,31,74,0.419,27,52,0.519,4,22,0.182,22,30,0.733,88
2241,SAC,2022-12-11,99,@,NYK,0,240,33,83,0.398,23,44,0.523,10,39,0.256,23,35,0.657,99,40,89,0.449,32,54,0.593,8,35,0.229,24,27,0.889,112
2242,TOR,2022-12-11,99,@,ORL,0,240,30,75,0.4,24,50,0.48,6,25,0.24,33,38,0.868,99,36,77,0.468,22,46,0.478,14,31,0.452,25,31,0.806,111
2243,SAS,2022-12-02,99,,NOP,0,240,38,98,0.388,27,59,0.458,11,39,0.282,12,16,0.75,99,40,92,0.435,28,50,0.56,12,42,0.286,25,26,0.962,117
2244,ORL,2022-11-25,99,,PHI,0,240,34,80,0.425,25,45,0.556,9,35,0.257,22,27,0.815,99,39,82,0.476,25,46,0.543,14,36,0.389,15,18,0.833,107
2245,DEN,2022-11-18,99,@,DAL,0,240,38,90,0.422,28,60,0.467,10,30,0.333,13,18,0.722,99,46,77,0.597,33,45,0.733,13,32,0.406,22,28,0.786,127
2246,IND,2022-11-18,99,@,HOU,1,240,33,82,0.402,21,41,0.512,12,41,0.293,21,27,0.778,99,29,86,0.337,23,58,0.397,6,28,0.214,27,32,0.844,91
2247,CHO,2022-11-04,99,@,MEM,0,240,33,86,0.384,25,59,0.424,8,27,0.296,25,31,0.806,99,50,98,0.51,34,62,0.548,16,36,0.444,14,18,0.778,130
2248,MIA,2022-11-04,99,@,IND,0,240,31,81,0.383,20,42,0.476,11,39,0.282,26,26,1.0,99,37,80,0.463,25,41,0.61,12,39,0.308,15,23,0.652,101
2249,NYK,2022-11-02,99,,ATL,0,240,37,90,0.411,27,54,0.5,10,36,0.278,15,20,0.75,99,44,107,0.411,32,73,0.438,12,34,0.353,12,16,0.75,112
2250,BRK,2022-11-01,99,,CHI,0,240,36,74,0.486,24,42,0.571,12,32,0.375,15,19,0.789,99,39,89,0.438,27,59,0.458,12,30,0.4,18,21,0.857,108
2251,LAL,2022-10-26,99,@,DEN,0,240,40,90,0.444,32,60,0.533,8,30,0.267,11,16,0.688,99,42,92,0.457,33,58,0.569,9,34,0.265,17,21,0.81,110
2252,BRK,2022-10-26,99,@,MIL,0,240,34,86,0.395,27,59,0.458,7,27,0.259,24,30,0.8,99,39,88,0.443,29,52,0.558,10,36,0.278,22,29,0.759,110
2253,DET,2022-10-25,99,@,WAS,0,240,36,88,0.409,28,60,0.467,8,28,0.286,19,25,0.76,99,44,85,0.518,34,52,0.654,10,33,0.303,22,26,0.846,120
2254,UTA,2023-04-06,98,,OKC,0,240,41,83,0.494,36,52,0.692,5,31,0.161,11,16,0.688,98,39,97,0.402,24,52,0.462,15,45,0.333,21,26,0.808,114
2255,CHI,2023-02-28,98,@,TOR,0,240,37,71,0.521,27,46,0.587,10,25,0.4,14,17,0.824,98,38,94,0.404,23,52,0.442,15,42,0.357,13,19,0.684,104
2256,BRK,2023-02-11,98,,PHI,0,240,37,92,0.402,24,52,0.462,13,40,0.325,11,13,0.846,98,33,75,0.44,27,52,0.519,6,23,0.261,29,30,0.967,101
2257,SAS,2023-02-08,98,@,TOR,0,240,35,87,0.402,26,55,0.473,9,32,0.281,19,27,0.704,98,43,88,0.489,33,60,0.55,10,28,0.357,16,21,0.762,112
2258,ORL,2023-02-07,98,,NYK,0,240,37,79,0.468,31,54,0.574,6,25,0.24,18,24,0.75,98,37,81,0.457,22,38,0.579,15,43,0.349,13,19,0.684,102
2259,DEN,2023-02-05,98,@,MIN,0,240,34,71,0.479,28,46,0.609,6,25,0.24,24,31,0.774,98,48,87,0.552,38,60,0.633,10,27,0.37,22,30,0.733,128
2260,CHO,2023-02-02,98,@,CHI,0,240,39,93,0.419,32,58,0.552,7,35,0.2,13,15,0.867,98,41,79,0.519,30,51,0.588,11,28,0.393,21,26,0.808,114
2261,NOP,2023-01-24,98,,DEN,0,240,38,85,0.447,33,59,0.559,5,26,0.192,17,20,0.85,98,39,80,0.488,28,47,0.596,11,33,0.333,10,13,0.769,99
2262,MIA,2023-01-24,98,,BOS,1,240,34,94,0.362,22,61,0.361,12,33,0.364,18,23,0.783,98,32,74,0.432,22,42,0.524,10,32,0.313,21,27,0.778,95
2263,BOS,2023-01-23,98,@,ORL,0,240,36,83,0.434,18,37,0.486,18,46,0.391,8,11,0.727,98,43,84,0.512,32,57,0.561,11,27,0.407,16,24,0.667,113
2264,DAL,2023-01-22,98,,LAC,0,240,35,80,0.438,22,45,0.489,13,35,0.371,15,26,0.577,98,35,77,0.455,23,49,0.469,12,28,0.429,30,31,0.968,112
2265,NOP,2023-01-18,98,,MIA,0,240,37,80,0.463,24,50,0.48,13,30,0.433,11,18,0.611,98,50,94,0.532,38,59,0.644,12,35,0.343,12,16,0.75,124
2266,BRK,2023-01-17,98,@,SAS,0,240,37,88,0.42,34,65,0.523,3,23,0.13,21,24,0.875,98,37,97,0.381,30,63,0.476,7,34,0.206,25,28,0.893,106
2267,BRK,2023-01-12,98,,BOS,0,240,38,84,0.452,25,50,0.5,13,34,0.382,9,11,0.818,98,41,86,0.477,29,50,0.58,12,36,0.333,15,17,0.882,109
2268,PHO,2023-01-08,98,,CLE,0,240,37,84,0.44,23,58,0.397,14,26,0.538,10,11,0.909,98,45,78,0.577,34,49,0.694,11,29,0.379,11,17,0.647,112
2269,LAL,2022-12-28,98,@,MIA,0,240,37,77,0.481,24,41,0.585,13,36,0.361,11,15,0.733,98,44,92,0.478,33,57,0.579,11,35,0.314,13,16,0.813,112
2270,POR,2022-12-21,98,@,OKC,0,240,39,79,0.494,25,43,0.581,14,36,0.389,6,9,0.667,98,36,77,0.468,28,53,0.528,8,24,0.333,21,25,0.84,101
2271,DET,2022-12-07,98,@,NOP,0,240,35,90,0.389,20,48,0.417,15,42,0.357,13,16,0.813,98,39,85,0.459,31,58,0.534,8,27,0.296,18,23,0.783,104
2272,PHO,2022-12-07,98,,BOS,0,240,37,93,0.398,29,61,0.475,8,32,0.25,16,19,0.842,98,49,101,0.485,33,56,0.589,16,45,0.356,11,13,0.846,125
2273,ATL,2022-11-27,98,,MIA,0,240,35,88,0.398,25,52,0.481,10,36,0.278,18,19,0.947,98,40,82,0.488,31,49,0.633,9,33,0.273,17,19,0.895,106
2274,TOR,2022-11-23,98,,BRK,0,240,36,101,0.356,29,72,0.403,7,29,0.241,19,25,0.76,98,45,82,0.549,28,44,0.636,17,38,0.447,5,7,0.714,112
2275,DEN,2022-11-20,98,@,DAL,1,240,37,78,0.474,28,51,0.549,9,27,0.333,15,19,0.789,98,35,78,0.449,20,36,0.556,15,42,0.357,12,21,0.571,97
2276,CLE,2022-11-16,98,@,MIL,0,240,36,84,0.429,24,56,0.429,12,28,0.429,14,17,0.824,98,41,86,0.477,25,47,0.532,16,39,0.41,15,27,0.556,113
2277,UTA,2022-11-13,98,@,PHI,0,240,37,94,0.394,26,57,0.456,11,37,0.297,13,23,0.565,98,40,83,0.482,36,60,0.6,4,23,0.174,21,26,0.808,105
2278,MIL,2022-11-07,98,@,ATL,0,240,36,87,0.414,23,47,0.489,13,40,0.325,13,16,0.813,98,46,99,0.465,35,70,0.5,11,29,0.379,14,17,0.824,117
2279,BRK,2022-11-05,98,@,CHO,1,240,33,84,0.393,21,48,0.438,12,36,0.333,20,22,0.909,98,32,86,0.372,18,44,0.409,14,42,0.333,16,23,0.696,94
2280,MIN,2022-10-30,98,@,SAS,0,240,40,99,0.404,36,70,0.514,4,29,0.138,14,20,0.7,98,36,86,0.419,20,46,0.435,16,40,0.4,19,25,0.76,107
2281,POR,2022-10-26,98,,MIA,0,240,34,78,0.436,22,41,0.537,12,37,0.324,18,26,0.692,98,44,87,0.506,29,49,0.592,15,38,0.395,16,19,0.842,119
2282,TOR,2022-10-24,98,@,MIA,1,240,34,86,0.395,20,54,0.37,14,32,0.438,16,20,0.8,98,29,83,0.349,21,49,0.429,8,34,0.235,24,27,0.889,90
2283,ORL,2022-10-21,98,@,ATL,0,240,33,80,0.413,25,46,0.543,8,34,0.235,24,30,0.8,98,40,89,0.449,27,58,0.466,13,31,0.419,15,16,0.938,108
2284,SAC,2023-04-07,97,,GSW,0,240,38,98,0.388,27,59,0.458,11,39,0.282,10,18,0.556,97,41,78,0.526,25,42,0.595,16,36,0.444,21,24,0.875,119
2285,BOS,2023-04-05,97,,TOR,1,240,38,89,0.427,27,51,0.529,11,38,0.289,10,18,0.556,97,37,90,0.411,31,57,0.544,6,33,0.182,13,17,0.765,93
2286,DET,2023-03-24,97,@,TOR,0,240,34,73,0.466,28,48,0.583,6,25,0.24,23,30,0.767,97,41,92,0.446,28,55,0.509,13,37,0.351,23,29,0.793,118
2287,DET,2023-03-14,97,@,WAS,0,240,38,99,0.384,28,65,0.431,10,34,0.294,11,12,0.917,97,44,85,0.518,37,53,0.698,7,32,0.219,22,22,1.0,117
2288,IND,2023-03-13,97,@,DET,0,240,36,86,0.419,26,52,0.5,10,34,0.294,15,24,0.625,97,48,100,0.48,34,64,0.531,14,36,0.389,7,10,0.7,117
2289,MEM,2023-03-03,97,@,DEN,0,240,31,84,0.369,20,52,0.385,11,32,0.344,24,31,0.774,97,40,87,0.46,32,56,0.571,8,31,0.258,25,31,0.806,113
2290,CLE,2023-02-11,97,,CHI,1,240,36,86,0.419,27,51,0.529,9,35,0.257,16,19,0.842,97,36,74,0.486,31,53,0.585,5,21,0.238,12,15,0.8,89
2291,MIA,2023-02-10,97,,HOU,1,240,32,77,0.416,20,39,0.513,12,38,0.316,21,22,0.955,97,35,84,0.417,28,54,0.519,7,30,0.233,18,24,0.75,95
2292,PHI,2023-02-05,97,@,NYK,0,240,30,74,0.405,23,49,0.469,7,25,0.28,30,36,0.833,97,34,79,0.43,22,43,0.512,12,36,0.333,28,39,0.718,108
2293,CLE,2023-01-31,97,,MIA,0,240,40,83,0.482,29,43,0.674,11,40,0.275,6,12,0.5,97,34,78,0.436,20,47,0.426,14,31,0.452,18,25,0.72,100
2294,CHO,2023-01-24,97,@,PHO,0,240,39,96,0.406,33,71,0.465,6,25,0.24,13,18,0.722,97,47,94,0.5,25,55,0.455,22,39,0.564,12,13,0.923,128
2295,PHO,2023-01-11,97,@,DEN,0,240,39,90,0.433,30,58,0.517,9,32,0.281,10,14,0.714,97,48,85,0.565,33,51,0.647,15,34,0.441,15,21,0.714,126
2296,CHI,2023-01-11,97,@,WAS,0,240,41,88,0.466,32,59,0.542,9,29,0.31,6,9,0.667,97,38,82,0.463,31,59,0.525,7,23,0.304,17,21,0.81,100
2297,UTA,2022-12-17,97,@,MIL,0,240,39,86,0.453,23,39,0.59,16,47,0.34,3,6,0.5,97,48,90,0.533,30,52,0.577,18,38,0.474,9,11,0.818,123
2298,PHO,2022-12-13,97,@,HOU,0,240,33,103,0.32,20,52,0.385,13,51,0.255,18,19,0.947,97,34,81,0.42,22,46,0.478,12,35,0.343,31,34,0.912,111
2299,HOU,2022-12-11,97,,MIL,1,240,40,91,0.44,34,64,0.531,6,27,0.222,11,12,0.917,97,33,90,0.367,21,47,0.447,12,43,0.279,14,18,0.778,92
2300,POR,2022-11-27,97,@,BRK,0,240,35,79,0.443,23,46,0.5,12,33,0.364,15,22,0.682,97,41,78,0.526,26,43,0.605,15,35,0.429,14,18,0.778,111
2301,DAL,2022-11-20,97,,DEN,0,240,35,78,0.449,20,36,0.556,15,42,0.357,12,21,0.571,97,37,78,0.474,28,51,0.549,9,27,0.333,15,19,0.789,98
2302,SAS,2022-11-19,97,@,LAC,0,240,36,87,0.414,29,61,0.475,7,26,0.269,18,21,0.857,97,44,81,0.543,23,41,0.561,21,40,0.525,10,19,0.526,119
2303,PHO,2022-11-11,97,@,ORL,0,240,38,95,0.4,25,53,0.472,13,42,0.31,8,9,0.889,97,43,82,0.524,28,49,0.571,15,33,0.455,13,15,0.867,114
2304,TOR,2022-11-07,97,@,CHI,0,240,36,85,0.424,27,57,0.474,9,28,0.321,16,22,0.727,97,42,80,0.525,33,52,0.635,9,28,0.321,18,22,0.818,111
2305,WAS,2022-11-06,97,@,MEM,0,240,41,96,0.427,33,55,0.6,8,41,0.195,7,10,0.7,97,39,91,0.429,30,62,0.484,9,29,0.31,16,20,0.8,103
2306,LAL,2022-10-20,97,,LAC,0,240,33,94,0.351,24,49,0.49,9,45,0.2,22,26,0.846,97,37,80,0.463,28,51,0.549,9,29,0.31,20,31,0.645,103
2307,GSW,2023-03-26,96,,MIN,0,240,34,82,0.415,19,42,0.452,15,40,0.375,13,17,0.765,96,34,80,0.425,17,40,0.425,17,40,0.425,14,25,0.56,99
2308,POR,2023-03-24,96,,CHI,0,240,37,86,0.43,31,55,0.564,6,31,0.194,16,18,0.889,96,48,84,0.571,31,56,0.554,17,28,0.607,11,14,0.786,124
2309,CHO,2023-03-23,96,@,NOP,0,240,38,83,0.458,29,46,0.63,9,37,0.243,11,16,0.688,96,45,98,0.459,34,64,0.531,11,34,0.324,14,15,0.933,115
2310,BRK,2023-03-16,96,,SAC,0,240,33,80,0.413,19,41,0.463,14,39,0.359,16,23,0.696,96,32,82,0.39,19,41,0.463,13,41,0.317,24,32,0.75,101
2311,NOP,2023-03-11,96,,OKC,0,240,34,81,0.42,22,47,0.468,12,34,0.353,16,19,0.842,96,37,80,0.463,28,52,0.538,9,28,0.321,27,32,0.844,110
2312,DEN,2023-03-08,96,,CHI,0,240,37,88,0.42,22,48,0.458,15,40,0.375,7,15,0.467,96,46,89,0.517,38,65,0.585,8,24,0.333,17,18,0.944,117
2313,HOU,2023-03-07,96,,BRK,0,240,36,83,0.434,29,57,0.509,7,26,0.269,17,24,0.708,96,40,81,0.494,25,41,0.61,15,40,0.375,23,29,0.793,118
2314,MIA,2023-03-01,96,,PHI,0,240,34,78,0.436,27,49,0.551,7,29,0.241,21,23,0.913,96,41,83,0.494,26,44,0.591,15,39,0.385,22,22,1.0,119
2315,HOU,2023-02-15,96,@,OKC,0,240,30,89,0.337,20,52,0.385,10,37,0.27,26,38,0.684,96,42,87,0.483,33,53,0.623,9,34,0.265,40,47,0.851,133
2316,BRK,2023-02-01,96,@,BOS,0,240,36,88,0.409,27,49,0.551,9,39,0.231,15,18,0.833,96,53,92,0.576,27,38,0.711,26,54,0.481,7,10,0.7,139
2317,CHI,2023-01-26,96,@,CHO,0,240,37,91,0.407,33,66,0.5,4,25,0.16,18,22,0.818,96,39,84,0.464,32,52,0.615,7,32,0.219,26,31,0.839,111
2318,NOP,2023-01-22,96,@,MIA,0,240,37,78,0.474,29,48,0.604,8,30,0.267,14,18,0.778,96,35,80,0.438,27,46,0.587,8,34,0.235,22,27,0.815,100
2319,HOU,2023-01-08,96,,MIN,0,240,38,89,0.427,27,53,0.509,11,36,0.306,9,15,0.6,96,38,80,0.475,28,52,0.538,10,28,0.357,18,22,0.818,104
2320,PHO,2023-01-06,96,,MIA,0,240,34,82,0.415,28,59,0.475,6,23,0.261,22,25,0.88,96,33,78,0.423,21,40,0.525,12,38,0.316,26,31,0.839,104
2321,OKC,2022-12-31,96,,PHI,0,240,35,92,0.38,23,56,0.411,12,36,0.333,14,22,0.636,96,46,99,0.465,35,65,0.538,11,34,0.324,12,17,0.706,115
2322,MIA,2022-12-06,96,,DET,0,240,33,77,0.429,23,45,0.511,10,32,0.313,20,26,0.769,96,43,87,0.494,24,46,0.522,19,41,0.463,11,15,0.733,116
2323,CHO,2022-12-03,96,,MIL,0,240,34,87,0.391,29,63,0.46,5,24,0.208,23,26,0.885,96,39,83,0.47,27,51,0.529,12,32,0.375,15,19,0.789,105
2324,LAC,2022-12-03,96,,SAC,0,240,33,93,0.355,24,60,0.4,9,33,0.273,21,26,0.808,96,46,89,0.517,35,57,0.614,11,32,0.344,20,30,0.667,123
2325,ORL,2022-12-02,96,@,CLE,0,240,40,81,0.494,32,58,0.552,8,23,0.348,8,12,0.667,96,41,84,0.488,25,42,0.595,16,42,0.381,9,9,1.0,107
2326,POR,2022-11-23,96,@,CLE,0,240,35,78,0.449,22,47,0.468,13,31,0.419,13,13,1.0,96,41,74,0.554,29,47,0.617,12,27,0.444,20,23,0.87,114
2327,LAC,2022-11-17,96,,DET,1,240,33,81,0.407,22,51,0.431,11,30,0.367,19,24,0.792,96,33,88,0.375,27,57,0.474,6,31,0.194,19,24,0.792,91
2328,DAL,2022-11-07,96,,BRK,1,240,32,72,0.444,20,44,0.455,12,28,0.429,20,24,0.833,96,35,80,0.438,25,51,0.49,10,29,0.345,14,19,0.737,94
2329,CHI,2022-10-22,96,,CLE,0,240,34,84,0.405,27,55,0.491,7,29,0.241,21,25,0.84,96,48,85,0.565,32,58,0.552,16,27,0.593,16,18,0.889,128
2330,MEM,2022-10-22,96,@,DAL,0,240,34,79,0.43,25,46,0.543,9,33,0.273,19,24,0.792,96,45,90,0.5,28,51,0.549,17,39,0.436,30,36,0.833,137
2331,SAC,2023-04-09,95,@,DEN,0,240,37,85,0.435,26,42,0.619,11,43,0.256,10,15,0.667,95,42,84,0.5,35,56,0.625,7,28,0.25,18,25,0.72,109
2332,CLE,2023-04-09,95,,CHO,0,240,35,89,0.393,25,52,0.481,10,37,0.27,15,16,0.938,95,37,81,0.457,31,49,0.633,6,32,0.188,26,30,0.867,106
2333,IND,2023-03-24,95,@,BOS,0,240,39,84,0.464,35,58,0.603,4,26,0.154,13,22,0.591,95,44,93,0.473,26,51,0.51,18,42,0.429,14,19,0.737,120
2334,NYK,2023-03-11,95,@,LAC,0,240,32,90,0.356,25,59,0.424,7,31,0.226,24,27,0.889,95,42,87,0.483,32,57,0.561,10,30,0.333,12,16,0.75,106
2335,TOR,2023-02-25,95,@,DET,1,240,33,88,0.375,26,62,0.419,7,26,0.269,22,34,0.647,95,38,94,0.404,32,70,0.457,6,24,0.25,9,14,0.643,91
2336,HOU,2023-02-10,95,@,MIA,0,240,35,84,0.417,28,54,0.519,7,30,0.233,18,24,0.75,95,32,77,0.416,20,39,0.513,12,38,0.316,21,22,0.955,97
2337,HOU,2023-01-26,95,,CLE,0,240,39,76,0.513,34,55,0.618,5,21,0.238,12,20,0.6,95,40,87,0.46,25,51,0.49,15,36,0.417,18,22,0.818,113
2338,PHO,2023-01-26,95,,DAL,0,240,35,86,0.407,22,54,0.407,13,32,0.406,12,16,0.75,95,33,77,0.429,20,43,0.465,13,34,0.382,20,28,0.714,99
2339,SAC,2023-01-25,95,,TOR,0,240,35,73,0.479,22,41,0.537,13,32,0.406,12,13,0.923,95,48,97,0.495,36,57,0.632,12,40,0.3,5,7,0.714,113
2340,BOS,2023-01-24,95,@,MIA,0,240,32,74,0.432,22,42,0.524,10,32,0.313,21,27,0.778,95,34,94,0.362,22,61,0.361,12,33,0.364,18,23,0.783,98
2341,POR,2023-01-19,95,,PHI,0,240,32,85,0.376,23,48,0.479,9,37,0.243,22,29,0.759,95,41,81,0.506,33,55,0.6,8,26,0.308,15,19,0.789,105
2342,MIL,2023-01-14,95,@,MIA,0,240,34,84,0.405,15,36,0.417,19,48,0.396,8,12,0.667,95,45,87,0.517,34,65,0.523,11,22,0.5,10,12,0.833,111
2343,DAL,2023-01-05,95,,BOS,0,240,34,90,0.378,27,58,0.466,7,32,0.219,20,25,0.8,95,41,84,0.488,25,41,0.61,16,43,0.372,26,31,0.839,124
2344,MIL,2023-01-01,95,,WAS,0,240,34,96,0.354,21,47,0.447,13,49,0.265,14,15,0.933,95,50,94,0.532,43,67,0.642,7,27,0.259,11,16,0.688,118
2345,ORL,2022-12-18,95,@,BOS,1,240,33,86,0.384,21,57,0.368,12,29,0.414,17,19,0.895,95,31,89,0.348,19,42,0.452,12,47,0.255,18,21,0.857,92
2346,HOU,2022-12-17,95,,POR,0,240,36,90,0.4,33,61,0.541,3,29,0.103,20,29,0.69,95,40,85,0.471,27,49,0.551,13,36,0.361,14,19,0.737,107
2347,LAC,2022-12-15,95,,PHO,0,240,34,90,0.378,22,57,0.386,12,33,0.364,15,21,0.714,95,44,95,0.463,35,63,0.556,9,32,0.281,14,18,0.778,111
2348,CLE,2022-12-09,95,,SAC,0,240,34,79,0.43,24,49,0.49,10,30,0.333,17,22,0.773,95,35,66,0.53,19,33,0.576,16,33,0.485,20,32,0.625,106
2349,SAS,2022-12-04,95,,PHO,0,240,38,87,0.437,32,56,0.571,6,31,0.194,13,18,0.722,95,49,94,0.521,30,57,0.526,19,37,0.514,16,20,0.8,133
2350,NYK,2022-11-20,95,@,PHO,0,240,34,85,0.4,27,60,0.45,7,25,0.28,20,25,0.8,95,43,101,0.426,26,62,0.419,17,39,0.436,13,18,0.722,116
2351,SAS,2022-11-14,95,@,GSW,0,240,36,100,0.36,26,60,0.433,10,40,0.25,13,19,0.684,95,47,88,0.534,24,43,0.558,23,45,0.511,15,16,0.938,132
2352,LAC,2022-11-12,95,,BRK,0,240,34,85,0.4,23,54,0.426,11,31,0.355,16,20,0.8,95,40,83,0.482,24,48,0.5,16,35,0.457,14,21,0.667,110
2353,NOP,2022-11-10,95,,POR,0,240,33,79,0.418,23,51,0.451,10,28,0.357,19,24,0.792,95,37,85,0.435,25,51,0.49,12,34,0.353,20,26,0.769,106
2354,PHI,2022-11-10,95,@,ATL,0,240,32,83,0.386,26,53,0.491,6,30,0.2,25,30,0.833,95,39,88,0.443,33,62,0.532,6,26,0.231,20,23,0.87,104
2355,CHO,2022-11-09,95,,POR,0,240,34,91,0.374,24,51,0.471,10,40,0.25,17,24,0.708,95,40,75,0.533,29,41,0.707,11,34,0.324,14,25,0.56,105
2356,LAC,2022-10-31,95,,HOU,1,240,37,87,0.425,28,51,0.549,9,36,0.25,12,17,0.706,95,34,88,0.386,26,60,0.433,8,28,0.286,17,23,0.739,93
2357,LAC,2022-10-23,95,,PHO,0,240,36,82,0.439,27,50,0.54,9,32,0.281,14,20,0.7,95,43,93,0.462,28,51,0.549,15,42,0.357,11,12,0.917,112
2358,ORL,2023-04-06,94,,CLE,0,240,33,83,0.398,20,44,0.455,13,39,0.333,15,19,0.789,94,46,88,0.523,28,50,0.56,18,38,0.474,8,9,0.889,118
2359,SAS,2023-04-04,94,@,PHO,0,240,35,90,0.389,22,50,0.44,13,40,0.325,11,14,0.786,94,43,89,0.483,33,56,0.589,10,33,0.303,19,26,0.731,115
2360,LAC,2023-03-31,94,@,MEM,0,240,34,90,0.378,23,55,0.418,11,35,0.314,15,18,0.833,94,43,96,0.448,34,63,0.54,9,33,0.273,13,17,0.765,108
2361,SAS,2023-03-22,94,@,MIL,0,240,36,93,0.387,27,54,0.5,9,39,0.231,13,20,0.65,94,51,98,0.52,36,55,0.655,15,43,0.349,13,24,0.542,130
2362,WAS,2023-03-17,94,@,CLE,0,240,35,76,0.461,27,53,0.509,8,23,0.348,16,20,0.8,94,48,87,0.552,44,68,0.647,4,19,0.211,17,22,0.773,117
2363,MIN,2023-03-07,94,,PHI,0,240,34,86,0.395,23,50,0.46,11,36,0.306,15,21,0.714,94,40,81,0.494,25,56,0.446,15,25,0.6,22,23,0.957,117
2364,UTA,2023-02-28,94,,SAS,0,240,30,85,0.353,20,51,0.392,10,34,0.294,24,36,0.667,94,39,91,0.429,31,65,0.477,8,26,0.308,16,25,0.64,102
2365,BOS,2023-02-27,94,@,NYK,0,240,37,84,0.44,28,42,0.667,9,42,0.214,11,14,0.786,94,37,78,0.474,25,47,0.532,12,31,0.387,23,34,0.676,109
2366,DEN,2023-02-25,94,@,MEM,0,240,36,89,0.404,25,52,0.481,11,37,0.297,11,14,0.786,94,45,95,0.474,30,51,0.588,15,44,0.341,7,8,0.875,112
2367,BOS,2023-02-03,94,,PHO,0,240,29,75,0.387,19,37,0.514,10,38,0.263,26,31,0.839,94,41,95,0.432,29,63,0.46,12,32,0.375,12,14,0.857,106
2368,ORL,2023-02-01,94,@,PHI,0,240,33,87,0.379,27,49,0.551,6,38,0.158,22,29,0.759,94,34,78,0.436,20,43,0.465,14,35,0.4,23,26,0.885,105
2369,GSW,2022-12-20,94,@,NYK,0,240,35,74,0.473,23,39,0.59,12,35,0.343,12,13,0.923,94,45,87,0.517,28,47,0.596,17,40,0.425,25,32,0.781,132
2370,DET,2022-11-27,94,,CLE,0,240,36,79,0.456,28,51,0.549,8,28,0.286,14,26,0.538,94,33,77,0.429,25,49,0.51,8,28,0.286,28,33,0.848,102
2371,SAS,2022-11-25,94,,LAL,0,240,38,100,0.38,32,67,0.478,6,33,0.182,12,16,0.75,94,40,83,0.482,32,56,0.571,8,27,0.296,17,20,0.85,105
2372,ORL,2022-11-09,94,,DAL,1,240,36,73,0.493,28,52,0.538,8,21,0.381,14,21,0.667,94,32,85,0.376,21,43,0.488,11,42,0.262,12,19,0.632,87
2373,BRK,2022-11-07,94,@,DAL,0,240,35,80,0.438,25,51,0.49,10,29,0.345,14,19,0.737,94,32,72,0.444,20,44,0.455,12,28,0.429,20,24,0.833,96
2374,CHO,2022-11-05,94,,BRK,0,240,32,86,0.372,18,44,0.409,14,42,0.333,16,23,0.696,94,33,84,0.393,21,48,0.438,12,36,0.333,20,22,0.909,98
2375,OKC,2022-11-05,94,@,MIL,0,240,36,84,0.429,24,49,0.49,12,35,0.343,10,16,0.625,94,38,90,0.422,21,43,0.488,17,47,0.362,15,17,0.882,108
2376,WAS,2022-10-30,94,@,BOS,0,240,38,98,0.388,31,66,0.47,7,32,0.219,11,16,0.688,94,36,79,0.456,15,32,0.469,21,47,0.447,19,20,0.95,112
2377,LAC,2022-10-25,94,@,OKC,0,240,35,83,0.422,25,52,0.481,10,31,0.323,14,18,0.778,94,42,110,0.382,38,80,0.475,4,30,0.133,20,25,0.8,108
2378,TOR,2023-04-05,93,@,BOS,0,240,37,90,0.411,31,57,0.544,6,33,0.182,13,17,0.765,93,38,89,0.427,27,51,0.529,11,38,0.289,10,18,0.556,97
2379,DEN,2023-03-31,93,@,PHO,0,240,38,95,0.4,32,69,0.464,6,26,0.231,11,20,0.55,93,37,88,0.42,27,61,0.443,10,27,0.37,16,21,0.762,100
2380,SAS,2023-03-26,93,@,BOS,0,240,36,97,0.371,28,61,0.459,8,36,0.222,13,18,0.722,93,52,91,0.571,34,47,0.723,18,44,0.409,15,21,0.714,137
2381,WAS,2023-03-12,93,@,PHI,0,240,34,84,0.405,28,58,0.483,6,26,0.231,19,23,0.826,93,41,80,0.513,30,51,0.588,11,29,0.379,19,23,0.826,112
2382,POR,2023-03-08,93,@,BOS,0,240,30,82,0.366,19,43,0.442,11,39,0.282,22,27,0.815,93,42,88,0.477,24,39,0.615,18,49,0.367,13,20,0.65,115
2383,NOP,2023-02-27,93,,ORL,0,240,34,76,0.447,28,49,0.571,6,27,0.222,19,23,0.826,93,36,79,0.456,27,45,0.6,9,34,0.265,20,26,0.769,101
2384,TOR,2023-02-26,93,@,CLE,0,240,36,93,0.387,27,68,0.397,9,25,0.36,12,15,0.8,93,44,84,0.524,26,48,0.542,18,36,0.5,12,14,0.857,118
2385,IND,2022-12-26,93,@,NOP,0,240,35,83,0.422,26,48,0.542,9,35,0.257,14,20,0.7,93,41,90,0.456,29,50,0.58,12,40,0.3,19,24,0.792,113
2386,DET,2022-12-21,93,@,PHI,0,240,31,79,0.392,25,56,0.446,6,23,0.261,25,34,0.735,93,41,93,0.441,30,56,0.536,11,37,0.297,20,22,0.909,113
2387,WAS,2022-12-17,93,@,LAC,0,240,36,84,0.429,27,59,0.458,9,25,0.36,12,13,0.923,93,37,86,0.43,25,57,0.439,12,29,0.414,16,26,0.615,102
2388,BOS,2022-12-12,93,@,LAC,0,240,33,76,0.434,24,37,0.649,9,39,0.231,18,26,0.692,93,44,90,0.489,34,65,0.523,10,25,0.4,15,21,0.714,113
2389,MIA,2022-12-05,93,@,MEM,0,240,31,79,0.392,17,39,0.436,14,40,0.35,17,22,0.773,93,42,90,0.467,34,58,0.586,8,32,0.25,9,9,1.0,101
2390,MIL,2022-11-11,93,@,SAS,0,240,32,98,0.327,20,55,0.364,12,43,0.279,17,23,0.739,93,43,85,0.506,31,54,0.574,12,31,0.387,13,15,0.867,111
2391,HOU,2022-10-31,93,@,LAC,0,240,34,88,0.386,26,60,0.433,8,28,0.286,17,23,0.739,93,37,87,0.425,28,51,0.549,9,36,0.25,12,17,0.706,95
2392,CHO,2022-10-28,93,@,ORL,0,240,33,86,0.384,22,48,0.458,11,38,0.289,16,24,0.667,93,42,85,0.494,32,48,0.667,10,37,0.27,19,26,0.731,113
2393,CHI,2023-04-05,92,@,MIL,0,240,36,83,0.434,25,50,0.5,11,33,0.333,9,11,0.818,92,39,92,0.424,21,46,0.457,18,46,0.391,9,11,0.818,105
2394,MIA,2023-03-29,92,@,NYK,0,240,35,79,0.443,22,40,0.55,13,39,0.333,9,14,0.643,92,38,76,0.5,25,45,0.556,13,31,0.419,12,23,0.522,101
2395,MIA,2023-03-28,92,@,TOR,0,240,32,80,0.4,22,47,0.468,10,33,0.303,18,19,0.947,92,45,93,0.484,37,57,0.649,8,36,0.222,8,9,0.889,106
2396,BOS,2022-12-18,92,,ORL,0,240,31,89,0.348,19,42,0.452,12,47,0.255,18,21,0.857,92,33,86,0.384,21,57,0.368,12,29,0.414,17,19,0.895,95
2397,MIL,2022-12-11,92,@,HOU,0,240,33,90,0.367,21,47,0.447,12,43,0.279,14,18,0.778,92,40,91,0.44,34,64,0.531,6,27,0.222,11,12,0.917,97
2398,NYK,2022-12-04,92,,CLE,1,240,35,86,0.407,30,57,0.526,5,29,0.172,17,21,0.81,92,29,83,0.349,21,48,0.438,8,35,0.229,15,20,0.75,81
2399,BRK,2022-12-04,92,,BOS,0,240,34,84,0.405,25,58,0.431,9,26,0.346,15,22,0.682,92,35,81,0.432,20,43,0.465,15,38,0.395,18,20,0.9,103
2400,SAS,2022-11-20,92,@,LAL,0,240,41,105,0.39,34,71,0.479,7,34,0.206,3,10,0.3,92,45,85,0.529,33,51,0.647,12,34,0.353,21,24,0.875,123
2401,DAL,2022-11-16,92,,HOU,0,240,31,102,0.304,19,47,0.404,12,55,0.218,18,19,0.947,92,35,75,0.467,25,53,0.472,10,22,0.455,21,24,0.875,101
2402,MEM,2022-11-13,92,@,WAS,0,240,38,96,0.396,29,68,0.426,9,28,0.321,7,10,0.7,92,36,86,0.419,17,46,0.37,19,40,0.475,11,21,0.524,102
2403,ORL,2022-10-26,92,@,CLE,0,240,35,81,0.432,29,57,0.509,6,24,0.25,16,21,0.762,92,36,87,0.414,26,54,0.481,10,33,0.303,21,30,0.7,103
2404,CHO,2023-03-31,91,,CHI,0,240,35,77,0.455,21,40,0.525,14,37,0.378,7,10,0.7,91,45,88,0.511,32,57,0.561,13,31,0.419,18,22,0.818,121
2405,HOU,2023-03-26,91,@,CLE,0,240,35,80,0.438,29,55,0.527,6,25,0.24,15,18,0.833,91,39,83,0.47,30,53,0.566,9,30,0.3,21,24,0.875,108
2406,CHI,2023-03-22,91,,PHI,0,240,34,83,0.41,28,58,0.483,6,25,0.24,17,22,0.773,91,39,82,0.476,23,45,0.511,16,37,0.432,22,26,0.846,116
2407,LAC,2023-03-02,91,@,GSW,0,240,32,89,0.36,23,46,0.5,9,43,0.209,18,21,0.857,91,39,93,0.419,25,47,0.532,14,46,0.304,23,27,0.852,115
2408,CHO,2023-03-01,91,,PHO,0,240,32,88,0.364,23,55,0.418,9,33,0.273,18,28,0.643,91,42,89,0.472,33,64,0.516,9,25,0.36,12,15,0.8,105
2409,DET,2023-02-25,91,,TOR,0,240,38,94,0.404,32,70,0.457,6,24,0.25,9,14,0.643,91,33,88,0.375,26,62,0.419,7,26,0.269,22,34,0.647,95
2410,CHI,2023-02-13,91,,ORL,0,240,35,86,0.407,32,65,0.492,3,21,0.143,18,19,0.947,91,38,81,0.469,30,54,0.556,8,27,0.296,16,19,0.842,100
2411,WAS,2023-02-06,91,,CLE,0,240,35,82,0.427,29,54,0.537,6,28,0.214,15,19,0.789,91,44,78,0.564,32,49,0.653,12,29,0.414,14,20,0.7,114
2412,LAC,2023-01-05,91,@,DEN,0,240,34,91,0.374,29,54,0.537,5,37,0.135,18,25,0.72,91,45,89,0.506,31,53,0.585,14,36,0.389,18,21,0.857,122
2413,MEM,2022-12-20,91,@,DEN,0,240,36,81,0.444,31,55,0.564,5,26,0.192,14,21,0.667,91,40,89,0.449,30,62,0.484,10,27,0.37,15,25,0.6,105
2414,CHI,2022-12-16,91,,NYK,0,240,36,77,0.468,24,47,0.511,12,30,0.4,7,8,0.875,91,37,92,0.402,20,48,0.417,17,44,0.386,23,32,0.719,114
2415,HOU,2022-11-18,91,,IND,0,240,29,86,0.337,23,58,0.397,6,28,0.214,27,32,0.844,91,33,82,0.402,21,41,0.512,12,41,0.293,21,27,0.778,99
2416,DET,2022-11-17,91,@,LAC,0,240,33,88,0.375,27,57,0.474,6,31,0.194,19,24,0.792,91,33,81,0.407,22,51,0.431,11,30,0.367,19,24,0.792,96
2417,DET,2022-11-02,91,@,MIL,0,240,33,79,0.418,22,48,0.458,11,31,0.355,14,15,0.933,91,43,92,0.467,33,54,0.611,10,38,0.263,20,24,0.833,116
2418,LAC,2022-10-30,91,,NOP,0,240,36,86,0.419,25,47,0.532,11,39,0.282,8,13,0.615,91,46,93,0.495,31,57,0.544,15,36,0.417,5,8,0.625,112
2419,POR,2023-03-27,90,,NOP,0,240,35,90,0.389,28,57,0.491,7,33,0.212,13,15,0.867,90,49,86,0.57,37,58,0.638,12,28,0.429,14,17,0.824,124
2420,SAS,2023-03-12,90,,OKC,0,240,33,88,0.375,23,52,0.442,10,36,0.278,14,19,0.737,90,36,95,0.379,26,56,0.464,10,39,0.256,20,23,0.87,102
2421,DET,2023-03-04,90,@,CLE,0,240,33,81,0.407,27,57,0.474,6,24,0.25,18,25,0.72,90,45,91,0.495,31,57,0.544,14,34,0.412,10,18,0.556,114
2422,MIA,2023-01-20,90,@,DAL,0,240,33,69,0.478,29,49,0.592,4,20,0.2,20,27,0.741,90,37,80,0.463,19,42,0.452,18,38,0.474,23,28,0.821,115
2423,CLE,2023-01-04,90,,PHO,1,240,30,77,0.39,19,41,0.463,11,36,0.306,19,23,0.826,90,32,81,0.395,22,53,0.415,10,28,0.357,14,18,0.778,88
2424,DAL,2022-12-14,90,,CLE,0,240,29,74,0.392,16,36,0.444,13,38,0.342,19,26,0.731,90,41,78,0.526,33,54,0.611,8,24,0.333,15,19,0.789,105
2425,TOR,2022-10-28,90,,PHI,0,240,33,86,0.384,24,47,0.511,9,39,0.231,15,24,0.625,90,43,82,0.524,27,44,0.614,16,38,0.421,10,11,0.909,112
2426,MIA,2022-10-24,90,,TOR,0,240,29,83,0.349,21,49,0.429,8,34,0.235,24,27,0.889,90,34,86,0.395,20,54,0.37,14,32,0.438,16,20,0.8,98
2427,MIL,2022-10-20,90,@,PHI,1,240,34,84,0.405,21,42,0.5,13,42,0.31,9,14,0.643,90,36,83,0.434,31,59,0.525,5,24,0.208,11,13,0.846,88
2428,CHI,2023-02-11,89,@,CLE,0,240,36,74,0.486,31,53,0.585,5,21,0.238,12,15,0.8,89,36,86,0.419,27,51,0.529,9,35,0.257,16,19,0.842,97
2429,CHI,2023-02-07,89,@,MEM,0,240,32,87,0.368,25,52,0.481,7,35,0.2,18,27,0.667,89,39,81,0.481,28,48,0.583,11,33,0.333,15,21,0.714,104
2430,ATL,2022-12-07,89,@,NYK,0,240,32,85,0.376,26,49,0.531,6,36,0.167,19,24,0.792,89,37,83,0.446,20,47,0.426,17,36,0.472,22,24,0.917,113
2431,DEN,2023-03-30,88,,NOP,0,240,32,80,0.4,28,52,0.538,4,28,0.143,20,32,0.625,88,38,80,0.475,25,53,0.472,13,27,0.481,18,22,0.818,107
2432,DAL,2023-03-13,88,,MEM,0,240,35,90,0.389,23,44,0.523,12,46,0.261,6,8,0.75,88,38,83,0.458,26,46,0.565,12,37,0.324,16,19,0.842,104
2433,PHO,2023-01-04,88,@,CLE,0,240,32,81,0.395,22,53,0.415,10,28,0.357,14,18,0.778,88,30,77,0.39,19,41,0.463,11,36,0.306,19,23,0.826,90
2434,HOU,2022-12-31,88,,NYK,0,240,29,77,0.377,15,31,0.484,14,46,0.304,16,23,0.696,88,35,90,0.389,20,39,0.513,15,51,0.294,23,32,0.719,108
2435,MIN,2022-12-14,88,@,LAC,0,240,31,74,0.419,27,52,0.519,4,22,0.182,22,30,0.733,88,34,89,0.382,20,43,0.465,14,46,0.304,17,21,0.81,99
2436,CLE,2022-11-28,88,@,TOR,0,240,34,90,0.378,27,52,0.519,7,38,0.184,13,16,0.813,88,37,84,0.44,25,56,0.446,12,28,0.429,14,17,0.824,100
2437,PHO,2022-11-07,88,@,PHI,0,240,32,73,0.438,26,54,0.481,6,19,0.316,18,22,0.818,88,31,80,0.388,19,48,0.396,12,32,0.375,26,31,0.839,100
2438,DET,2022-11-04,88,,CLE,0,240,31,83,0.373,18,46,0.391,13,37,0.351,13,15,0.867,88,44,81,0.543,33,55,0.6,11,26,0.423,13,16,0.813,112
2439,CHO,2022-11-02,88,@,CHI,0,240,36,92,0.391,29,60,0.483,7,32,0.219,9,16,0.563,88,38,88,0.432,24,57,0.421,14,31,0.452,16,18,0.889,106
2440,PHI,2022-10-20,88,,MIL,0,240,36,83,0.434,31,59,0.525,5,24,0.208,11,13,0.846,88,34,84,0.405,21,42,0.5,13,42,0.31,9,14,0.643,90
2441,BRK,2023-02-24,87,@,CHI,0,240,30,81,0.37,18,37,0.486,12,44,0.273,15,19,0.789,87,50,88,0.568,38,62,0.613,12,26,0.462,19,28,0.679,131
2442,MIA,2022-12-12,87,@,IND,1,240,32,83,0.386,23,49,0.469,9,34,0.265,14,18,0.778,87,28,79,0.354,17,40,0.425,11,39,0.282,15,20,0.75,82
2443,MIA,2022-11-20,87,@,CLE,0,240,31,80,0.388,25,49,0.51,6,31,0.194,19,22,0.864,87,44,83,0.53,31,46,0.674,13,37,0.351,12,16,0.75,113
2444,DAL,2022-11-09,87,@,ORL,0,240,32,85,0.376,21,43,0.488,11,42,0.262,12,19,0.632,87,36,73,0.493,28,52,0.538,8,21,0.381,14,21,0.667,94
2445,CHO,2023-03-05,86,@,BRK,0,240,33,88,0.375,25,58,0.431,8,30,0.267,12,15,0.8,86,36,92,0.391,24,49,0.49,12,43,0.279,18,22,0.818,102
2446,WAS,2022-11-04,86,,BRK,0,240,30,83,0.361,22,49,0.449,8,34,0.235,18,22,0.818,86,50,90,0.556,36,62,0.581,14,28,0.5,14,14,1.0,128
2447,DET,2023-02-08,85,@,CLE,0,240,30,81,0.37,22,49,0.449,8,32,0.25,17,18,0.944,85,43,87,0.494,37,61,0.607,6,26,0.231,21,25,0.84,113
2448,PHI,2022-11-30,85,@,CLE,0,240,32,77,0.416,26,51,0.51,6,26,0.231,15,18,0.833,85,45,74,0.608,30,45,0.667,15,29,0.517,8,10,0.8,113
2449,NYK,2022-11-09,85,@,BRK,0,240,28,87,0.322,16,44,0.364,12,43,0.279,17,26,0.654,85,42,87,0.483,28,53,0.528,14,34,0.412,14,20,0.7,112
2450,ORL,2023-04-07,84,@,BRK,0,240,31,87,0.356,24,49,0.49,7,38,0.184,15,17,0.882,84,35,89,0.393,26,47,0.553,9,42,0.214,22,25,0.88,101
2451,SAS,2023-03-21,84,@,NOP,0,240,30,87,0.345,17,46,0.37,13,41,0.317,11,19,0.579,84,45,81,0.556,35,57,0.614,10,24,0.417,19,23,0.826,119
2452,PHO,2023-01-02,83,@,NYK,0,240,34,87,0.391,24,50,0.48,10,37,0.27,5,7,0.714,83,36,74,0.486,23,41,0.561,13,33,0.394,17,25,0.68,102
2453,GSW,2022-11-21,83,@,NOP,0,240,28,74,0.378,18,31,0.581,10,43,0.233,17,19,0.895,83,49,91,0.538,34,49,0.694,15,42,0.357,15,21,0.714,128
2454,CHO,2023-03-17,82,,PHI,0,240,29,86,0.337,24,51,0.471,5,35,0.143,19,26,0.731,82,46,92,0.5,36,60,0.6,10,32,0.313,19,25,0.76,121
2455,WAS,2023-02-26,82,@,CHI,0,240,32,76,0.421,26,48,0.542,6,28,0.214,12,23,0.522,82,40,79,0.506,32,49,0.653,8,30,0.267,14,17,0.824,102
2456,IND,2022-12-12,82,,MIA,0,240,28,79,0.354,17,40,0.425,11,39,0.282,15,20,0.75,82,32,83,0.386,23,49,0.469,9,34,0.265,14,18,0.778,87
2457,POR,2022-11-05,82,@,PHO,0,240,30,79,0.38,23,64,0.359,7,15,0.467,15,24,0.625,82,35,82,0.427,24,52,0.462,11,30,0.367,21,28,0.75,102
2458,DET,2023-04-09,81,@,CHI,0,240,31,85,0.365,22,52,0.423,9,33,0.273,10,13,0.769,81,40,95,0.421,34,65,0.523,6,30,0.2,17,22,0.773,103
2459,CLE,2022-12-04,81,@,NYK,0,240,29,83,0.349,21,48,0.438,8,35,0.229,15,20,0.75,81,35,86,0.407,30,57,0.526,5,29,0.172,17,21,0.81,92
2460,POR,2023-03-29,80,,SAC,0,240,30,93,0.323,21,54,0.389,9,39,0.231,11,12,0.917,80,42,92,0.457,24,44,0.545,18,48,0.375,18,24,0.75,120
