Rk,Team,Date,PTS,Unnamed: 4,Opp,Result,MP,FG,FGA,FG%,2P,2PA,2P%,3P,3PA,3P%,FT,FTA,FT%,PTS.1,FG.1,FGA.1,FG%.1,2P.1,2PA.1,2P%.1,3P.1,3PA.1,3P%.1,FT.1,FTA.1,FT%.1,PTS.2
1,WAS,2021-05-03,154,,IND,1,240,63,103,0.612,54,81,0.667,9,22,0.409,19,24,0.792,154,53,107,0.495,39,80,0.488,14,27,0.519,21,25,0.84,141
2,UTA,2021-04-28,154,@,SAC,1,240,55,86,0.64,31,45,0.689,24,41,0.585,20,21,0.952,154,42,87,0.483,35,66,0.53,7,21,0.333,14,17,0.824,105
3,IND,2021-05-01,152,@,OKC,1,240,57,87,0.655,36,54,0.667,21,33,0.636,17,22,0.773,152,38,111,0.342,30,73,0.411,8,38,0.211,11,23,0.478,95
4,WAS,2021-01-31,149,,BRK,1,240,56,108,0.519,44,69,0.638,12,39,0.308,25,32,0.781,149,50,88,0.568,31,52,0.596,19,36,0.528,27,33,0.818,146
5,GSW,2021-04-14,147,@,OKC,1,240,52,95,0.547,28,48,0.583,24,47,0.511,19,23,0.826,147,44,92,0.478,37,65,0.569,7,27,0.259,14,25,0.56,109
6,GSW,2021-02-04,147,@,DAL,1,240,51,89,0.573,29,46,0.63,22,43,0.512,23,27,0.852,147,38,92,0.413,18,42,0.429,20,50,0.4,20,23,0.87,116
7,BRK,2021-01-29,147,@,OKC,1,240,57,100,0.57,38,55,0.691,19,45,0.422,14,16,0.875,147,40,86,0.465,24,48,0.5,16,38,0.421,29,34,0.853,125
8,CLE,2021-01-20,147,,BRK,1,290,56,109,0.514,36,69,0.522,20,40,0.5,15,21,0.714,147,48,106,0.453,33,65,0.508,15,41,0.366,24,27,0.889,135
9,SAS,2021-05-10,146,,MIL,1,240,56,94,0.596,39,65,0.6,17,29,0.586,17,21,0.81,146,47,94,0.5,34,53,0.642,13,41,0.317,18,23,0.783,125
10,SAS,2021-04-26,146,@,WAS,1,265,55,103,0.534,49,86,0.57,6,17,0.353,30,35,0.857,146,58,109,0.532,52,89,0.584,6,20,0.3,21,25,0.84,143
11,BRK,2021-01-31,146,@,WAS,0,240,50,88,0.568,31,52,0.596,19,36,0.528,27,33,0.818,146,56,108,0.519,44,69,0.638,12,39,0.308,25,32,0.781,149
12,BOS,2021-04-09,145,,MIN,1,265,47,87,0.54,28,45,0.622,19,42,0.452,32,34,0.941,145,47,96,0.49,32,54,0.593,15,42,0.357,27,30,0.9,136
13,BRK,2020-12-30,145,,ATL,1,240,54,100,0.54,35,59,0.593,19,41,0.463,18,23,0.783,145,47,99,0.475,29,53,0.547,18,46,0.391,29,35,0.829,141
14,NOP,2021-02-16,144,@,MEM,1,240,56,91,0.615,37,53,0.698,19,38,0.5,13,17,0.765,144,42,88,0.477,29,57,0.509,13,31,0.419,16,18,0.889,113
15,TOR,2021-01-08,144,@,SAC,1,240,53,91,0.582,33,52,0.635,20,39,0.513,18,22,0.818,144,46,81,0.568,31,47,0.66,15,34,0.441,16,28,0.571,123
16,MIL,2020-12-29,144,@,MIA,1,240,51,92,0.554,22,41,0.537,29,51,0.569,13,15,0.867,144,37,79,0.468,26,42,0.619,11,37,0.297,12,18,0.667,97
17,BOS,2021-04-30,143,,SAS,1,265,49,105,0.467,31,67,0.463,18,38,0.474,27,36,0.75,143,49,92,0.533,38,68,0.559,11,24,0.458,31,38,0.816,140
18,HOU,2021-04-29,143,,MIL,1,240,49,98,0.5,24,52,0.462,25,46,0.543,20,24,0.833,143,49,93,0.527,33,54,0.611,16,39,0.41,22,25,0.88,136
19,WAS,2021-04-26,143,,SAS,0,265,58,109,0.532,52,89,0.584,6,20,0.3,21,25,0.84,143,55,103,0.534,49,86,0.57,6,17,0.353,30,35,0.857,146
20,DAL,2021-02-12,143,,NOP,1,240,51,88,0.58,26,43,0.605,25,45,0.556,16,21,0.762,143,48,90,0.533,31,53,0.585,17,37,0.459,17,23,0.739,130
21,MIL,2021-05-13,142,@,IND,1,240,54,94,0.574,43,64,0.672,11,30,0.367,23,31,0.742,142,50,110,0.455,29,67,0.433,21,43,0.488,12,15,0.8,133
22,MIL,2021-05-07,141,,HOU,1,240,51,95,0.537,32,49,0.653,19,46,0.413,20,23,0.87,141,48,96,0.5,23,43,0.535,25,53,0.472,12,18,0.667,133
23,POR,2021-05-05,141,@,CLE,1,240,53,92,0.576,37,59,0.627,16,33,0.485,19,25,0.76,141,37,92,0.402,24,54,0.444,13,38,0.342,18,26,0.692,105
24,IND,2021-05-03,141,@,WAS,0,240,53,107,0.495,39,80,0.488,14,27,0.519,21,25,0.84,141,63,103,0.612,54,81,0.667,9,22,0.409,19,24,0.792,154
25,IND,2021-04-07,141,,MIN,1,240,55,93,0.591,41,65,0.631,14,28,0.5,17,19,0.895,141,48,91,0.527,38,63,0.603,10,28,0.357,31,40,0.775,137
26,SAC,2021-03-25,141,,GSW,1,240,53,89,0.596,34,51,0.667,19,38,0.5,16,19,0.842,141,45,88,0.511,28,56,0.5,17,32,0.531,12,12,1.0,119
27,BOS,2021-01-24,141,,CLE,1,240,52,93,0.559,38,65,0.585,14,28,0.5,23,27,0.852,141,34,85,0.4,24,52,0.462,10,33,0.303,25,34,0.735,103
28,PHI,2021-01-06,141,,WAS,1,240,50,81,0.617,32,52,0.615,18,29,0.621,23,33,0.697,141,47,94,0.5,31,57,0.544,16,37,0.432,26,35,0.743,136
29,ATL,2020-12-30,141,@,BRK,0,240,47,99,0.475,29,53,0.547,18,46,0.391,29,35,0.829,141,54,100,0.54,35,59,0.593,19,41,0.463,18,23,0.783,145
30,PHO,2021-05-15,140,@,SAS,1,240,52,94,0.553,37,61,0.607,15,33,0.455,21,22,0.955,140,39,88,0.443,35,62,0.565,4,26,0.154,21,24,0.875,103
31,POR,2021-05-10,140,,HOU,1,240,47,92,0.511,29,52,0.558,18,40,0.45,28,35,0.8,140,42,85,0.494,24,47,0.511,18,38,0.474,27,28,0.964,129
32,NOP,2021-05-01,140,@,MIN,1,265,47,92,0.511,33,56,0.589,14,36,0.389,32,46,0.696,140,48,106,0.453,33,58,0.569,15,48,0.313,25,32,0.781,136
33,SAS,2021-04-30,140,@,BOS,0,265,49,92,0.533,38,68,0.559,11,24,0.458,31,38,0.816,140,49,105,0.467,31,67,0.463,18,38,0.474,27,36,0.75,143
34,PHO,2021-04-02,140,,OKC,1,240,54,90,0.6,39,57,0.684,15,33,0.455,17,21,0.81,140,35,89,0.393,20,51,0.392,15,38,0.395,18,23,0.783,103
35,MIL,2021-03-22,140,,IND,1,240,53,94,0.564,29,55,0.527,24,39,0.615,10,15,0.667,140,45,111,0.405,33,61,0.541,12,50,0.24,11,12,0.917,113
36,NYK,2021-02-25,140,,SAC,1,240,51,87,0.586,32,51,0.627,19,36,0.528,19,21,0.905,140,42,85,0.494,30,50,0.6,12,35,0.343,25,33,0.758,121
37,MEM,2021-05-05,139,@,MIN,1,240,52,97,0.536,38,68,0.559,14,29,0.483,21,28,0.75,139,49,94,0.521,30,55,0.545,19,39,0.487,18,22,0.818,135
38,DEN,2021-04-19,139,,MEM,1,290,51,102,0.5,36,63,0.571,15,39,0.385,22,26,0.846,139,51,107,0.477,34,67,0.507,17,40,0.425,18,24,0.75,137
39,BRK,2021-04-07,139,,NOP,1,240,51,92,0.554,32,51,0.627,19,41,0.463,18,22,0.818,139,38,89,0.427,32,62,0.516,6,27,0.222,29,39,0.744,111
40,IND,2021-04-03,139,@,SAS,1,265,52,94,0.553,40,65,0.615,12,29,0.414,23,26,0.885,139,48,99,0.485,38,70,0.543,10,29,0.345,27,32,0.844,133
41,MIL,2021-02-23,139,,MIN,1,240,53,99,0.535,33,57,0.579,20,42,0.476,13,18,0.722,139,42,98,0.429,23,44,0.523,19,54,0.352,9,9,1.0,112
42,UTA,2021-02-05,138,@,CHO,1,240,48,87,0.552,22,37,0.595,26,50,0.52,16,18,0.889,138,48,104,0.462,37,69,0.536,11,35,0.314,14,17,0.824,121
43,LAC,2021-01-15,138,@,SAC,1,240,52,89,0.584,34,54,0.63,18,35,0.514,16,20,0.8,138,40,85,0.471,32,59,0.542,8,26,0.308,12,17,0.706,100
44,LAL,2020-12-25,138,,DAL,1,240,51,91,0.56,32,52,0.615,19,39,0.487,17,24,0.708,138,41,83,0.494,28,51,0.549,13,32,0.406,20,26,0.769,115
45,MIL,2020-12-25,138,,GSW,1,240,50,90,0.556,30,54,0.556,20,36,0.556,18,26,0.692,138,34,99,0.343,24,54,0.444,10,45,0.222,21,25,0.84,99
46,NYK,2021-04-21,137,,ATL,1,265,49,91,0.538,30,56,0.536,19,35,0.543,20,25,0.8,137,49,102,0.48,37,68,0.544,12,34,0.353,17,24,0.708,127
47,MEM,2021-04-19,137,@,DEN,0,290,51,107,0.477,34,67,0.507,17,40,0.425,18,24,0.75,137,51,102,0.5,36,63,0.571,15,39,0.385,22,26,0.846,139
48,MIN,2021-04-07,137,@,IND,0,240,48,91,0.527,38,63,0.603,10,28,0.357,31,40,0.775,137,55,93,0.591,41,65,0.631,14,28,0.5,17,19,0.895,141
49,UTA,2021-04-03,137,,ORL,1,240,51,92,0.554,25,37,0.676,26,55,0.473,9,12,0.75,137,32,87,0.368,30,64,0.469,2,23,0.087,25,31,0.806,91
50,IND,2021-03-19,137,@,MIA,1,240,52,89,0.584,32,53,0.604,20,36,0.556,13,19,0.684,137,41,92,0.446,32,58,0.552,9,34,0.265,19,20,0.95,110
51,LAL,2021-03-16,137,,MIN,1,240,50,87,0.575,37,61,0.607,13,26,0.5,24,28,0.857,137,47,90,0.522,36,55,0.655,11,35,0.314,16,22,0.727,121
52,TOR,2021-02-10,137,@,WAS,1,240,49,93,0.527,30,61,0.492,19,32,0.594,20,23,0.87,137,42,93,0.452,30,52,0.577,12,41,0.293,19,23,0.826,115
53,PHI,2021-01-12,137,,MIA,1,265,50,102,0.49,31,47,0.66,19,55,0.345,18,25,0.72,137,48,104,0.462,29,48,0.604,19,56,0.339,19,24,0.792,134
54,GSW,2021-01-04,137,,SAC,1,240,51,97,0.526,28,54,0.519,23,43,0.535,12,14,0.857,137,34,90,0.378,24,55,0.436,10,35,0.286,28,39,0.718,106
55,GSW,2021-01-03,137,,POR,1,240,49,88,0.557,36,54,0.667,13,34,0.382,26,34,0.765,137,41,98,0.418,27,55,0.491,14,43,0.326,26,33,0.788,122
56,MIN,2021-05-16,136,,DAL,1,240,49,90,0.544,32,50,0.64,17,40,0.425,21,25,0.84,136,44,91,0.484,28,53,0.528,16,38,0.421,17,20,0.85,121
57,GSW,2021-05-08,136,,OKC,1,240,47,81,0.58,20,27,0.741,27,54,0.5,15,18,0.833,136,38,94,0.404,29,57,0.509,9,37,0.243,12,20,0.6,97
58,MIN,2021-05-01,136,,NOP,0,265,48,106,0.453,33,58,0.569,15,48,0.313,25,32,0.781,136,47,92,0.511,33,56,0.589,14,36,0.389,32,46,0.696,140
59,MIL,2021-04-29,136,@,HOU,0,240,49,93,0.527,33,54,0.611,16,39,0.41,22,25,0.88,136,49,98,0.5,24,52,0.462,25,46,0.543,20,24,0.833,143
60,MIN,2021-04-09,136,@,BOS,0,265,47,96,0.49,32,54,0.593,15,42,0.357,27,30,0.9,136,47,87,0.54,28,45,0.622,19,42,0.452,32,34,0.941,145
61,BRK,2021-02-15,136,@,SAC,1,240,51,89,0.573,24,42,0.571,27,47,0.574,7,12,0.583,136,51,96,0.531,39,63,0.619,12,33,0.364,11,13,0.846,125
62,HOU,2021-02-01,136,@,OKC,1,240,49,102,0.48,21,50,0.42,28,52,0.538,10,11,0.909,136,39,89,0.438,26,55,0.473,13,34,0.382,15,19,0.789,106
63,WAS,2021-01-06,136,@,PHI,0,240,47,94,0.5,31,57,0.544,16,37,0.432,26,35,0.743,136,50,81,0.617,32,52,0.615,18,29,0.621,23,33,0.697,141
64,ATL,2021-05-05,135,,PHO,1,240,53,84,0.631,40,58,0.69,13,26,0.5,16,18,0.889,135,33,79,0.418,21,47,0.447,12,32,0.375,25,29,0.862,103
65,MIL,2021-05-05,135,,WAS,1,240,48,89,0.539,30,52,0.577,18,37,0.486,21,28,0.75,135,47,96,0.49,39,74,0.527,8,22,0.364,32,43,0.744,134
66,MIN,2021-05-05,135,,MEM,0,240,49,94,0.521,30,55,0.545,19,39,0.487,18,22,0.818,135,52,97,0.536,38,68,0.559,14,29,0.483,21,28,0.75,139
67,PHI,2021-05-05,135,@,HOU,1,240,50,94,0.532,35,59,0.593,15,35,0.429,20,22,0.909,135,42,93,0.452,25,48,0.521,17,45,0.378,14,18,0.778,115
68,NOP,2021-04-22,135,@,ORL,1,240,50,90,0.556,38,62,0.613,12,28,0.429,23,26,0.885,135,36,98,0.367,23,62,0.371,13,36,0.361,15,19,0.789,100
69,TOR,2021-04-10,135,@,CLE,1,240,53,86,0.616,36,54,0.667,17,32,0.531,12,14,0.857,135,39,86,0.453,24,51,0.471,15,35,0.429,22,26,0.846,115
70,TOR,2021-03-24,135,,DEN,1,240,45,89,0.506,21,41,0.512,24,48,0.5,21,23,0.913,135,41,98,0.418,27,55,0.491,14,43,0.326,15,18,0.833,111
71,NOP,2021-03-14,135,,LAC,1,240,53,81,0.654,41,55,0.745,12,26,0.462,17,21,0.81,135,42,92,0.457,27,49,0.551,15,43,0.349,16,19,0.842,115
72,MIN,2021-03-11,135,@,NOP,1,240,51,95,0.537,32,55,0.582,19,40,0.475,14,16,0.875,135,43,100,0.43,37,68,0.544,6,32,0.188,13,24,0.542,105
73,CHO,2021-03-03,135,@,MIN,1,240,51,98,0.52,34,59,0.576,17,39,0.436,16,21,0.762,135,39,96,0.406,30,56,0.536,9,40,0.225,15,18,0.833,102
74,LAC,2021-02-23,135,,WAS,1,240,54,94,0.574,35,56,0.625,19,38,0.5,8,13,0.615,135,47,88,0.534,36,68,0.529,11,20,0.55,11,16,0.688,116
75,LAL,2021-02-06,135,,DET,1,290,51,91,0.56,42,72,0.583,9,19,0.474,24,28,0.857,135,45,94,0.479,29,52,0.558,16,42,0.381,23,28,0.821,129
76,BRK,2021-01-20,135,@,CLE,0,290,48,106,0.453,33,65,0.508,15,41,0.366,24,27,0.889,135,56,109,0.514,36,69,0.522,20,40,0.5,15,21,0.714,147
77,POR,2021-01-07,135,,MIN,1,240,49,90,0.544,31,49,0.633,18,41,0.439,19,23,0.826,135,39,93,0.419,25,52,0.481,14,41,0.341,25,33,0.758,117
78,WAS,2021-05-05,134,@,MIL,0,240,47,96,0.49,39,74,0.527,8,22,0.364,32,43,0.744,134,48,89,0.539,30,52,0.577,18,37,0.486,21,28,0.75,135
79,PHO,2021-05-04,134,@,CLE,1,265,55,105,0.524,43,74,0.581,12,31,0.387,12,13,0.923,134,41,90,0.456,28,61,0.459,13,29,0.448,23,27,0.852,118
80,BRK,2021-04-20,134,@,NOP,1,240,49,89,0.551,35,52,0.673,14,37,0.378,22,28,0.786,134,51,91,0.56,39,58,0.672,12,33,0.364,15,24,0.625,129
81,MIN,2021-04-20,134,@,SAC,1,240,51,90,0.567,33,47,0.702,18,43,0.419,14,19,0.737,134,44,97,0.454,26,55,0.473,18,42,0.429,14,16,0.875,120
82,PHO,2021-04-10,134,,WAS,1,240,55,107,0.514,38,64,0.594,17,43,0.395,7,7,1.0,134,39,84,0.464,30,59,0.508,9,25,0.36,19,28,0.679,106
83,DEN,2021-04-06,134,,DET,1,240,56,94,0.596,42,63,0.667,14,31,0.452,8,9,0.889,134,44,81,0.543,29,46,0.63,15,35,0.429,16,20,0.8,119
84,ATL,2021-04-01,134,@,SAS,1,290,50,100,0.5,37,76,0.487,13,24,0.542,21,26,0.808,134,49,110,0.445,36,70,0.514,13,40,0.325,18,24,0.75,129
85,LAC,2021-03-24,134,@,SAS,1,240,49,88,0.557,32,55,0.582,17,33,0.515,19,30,0.633,134,39,85,0.459,32,63,0.508,7,22,0.318,16,19,0.842,101
86,BOS,2021-03-14,134,@,HOU,1,240,51,92,0.554,33,55,0.6,18,37,0.486,14,21,0.667,134,35,91,0.385,19,41,0.463,16,50,0.32,21,31,0.677,107
87,PHI,2021-03-14,134,,SAS,1,240,56,98,0.571,41,69,0.594,15,29,0.517,7,11,0.636,134,36,85,0.424,32,64,0.5,4,21,0.19,23,31,0.742,99
88,MIL,2021-03-11,134,,NYK,1,240,50,87,0.575,32,49,0.653,18,38,0.474,16,17,0.941,134,37,88,0.42,24,51,0.471,13,37,0.351,14,21,0.667,101
89,IND,2021-02-17,134,@,MIN,1,265,49,97,0.505,36,71,0.507,13,26,0.5,23,27,0.852,134,45,107,0.421,30,67,0.448,15,40,0.375,23,25,0.92,128
90,UTA,2021-02-15,134,,PHI,1,240,45,86,0.523,27,41,0.659,18,45,0.4,26,31,0.839,134,47,94,0.5,39,71,0.549,8,23,0.348,21,24,0.875,123
91,BRK,2021-02-13,134,@,GSW,1,240,50,93,0.538,34,54,0.63,16,39,0.41,18,20,0.9,134,44,90,0.489,35,56,0.625,9,34,0.265,20,25,0.8,117
92,DAL,2021-02-06,134,,GSW,1,240,44,96,0.458,23,49,0.469,21,47,0.447,25,30,0.833,134,46,86,0.535,26,41,0.634,20,45,0.444,20,23,0.87,132
93,IND,2021-02-02,134,,MEM,1,240,49,82,0.598,33,53,0.623,16,29,0.552,20,29,0.69,134,42,93,0.452,33,68,0.485,9,25,0.36,23,24,0.958,116
94,MIL,2021-02-01,134,,POR,1,240,53,96,0.552,32,54,0.593,21,42,0.5,7,12,0.583,134,39,104,0.375,24,62,0.387,15,42,0.357,13,13,1.0,106
95,MIA,2021-01-12,134,@,PHI,0,265,48,104,0.462,29,48,0.604,19,56,0.339,19,24,0.792,134,50,102,0.49,31,47,0.66,19,55,0.345,18,25,0.72,137
96,IND,2021-05-13,133,,MIL,0,240,50,110,0.455,29,67,0.433,21,43,0.488,12,15,0.8,133,54,94,0.574,43,64,0.672,11,30,0.367,23,31,0.742,142
97,MEM,2021-05-11,133,,DAL,1,240,51,89,0.573,35,56,0.625,16,33,0.485,15,16,0.938,133,37,88,0.42,25,50,0.5,12,38,0.316,18,19,0.947,104
98,WAS,2021-05-08,133,@,IND,1,265,49,110,0.445,40,78,0.513,9,32,0.281,26,30,0.867,133,50,104,0.481,43,75,0.573,7,29,0.241,25,30,0.833,132
99,HOU,2021-05-07,133,@,MIL,0,240,48,96,0.5,23,43,0.535,25,53,0.472,12,18,0.667,133,51,95,0.537,32,49,0.653,19,46,0.413,20,23,0.87,141
100,IND,2021-05-06,133,,ATL,1,240,54,87,0.621,46,67,0.687,8,20,0.4,17,19,0.895,133,48,94,0.511,33,57,0.579,15,37,0.405,15,18,0.833,126
101,DAL,2021-04-27,133,@,GSW,1,240,48,92,0.522,30,57,0.526,18,35,0.514,19,22,0.864,133,34,84,0.405,18,41,0.439,16,43,0.372,19,24,0.792,103
102,POR,2021-04-27,133,@,IND,1,240,50,106,0.472,30,71,0.423,20,35,0.571,13,16,0.813,133,40,86,0.465,30,56,0.536,10,30,0.333,22,28,0.786,112
103,NYK,2021-04-09,133,,MEM,1,265,45,96,0.469,31,64,0.484,14,32,0.438,29,33,0.879,133,47,94,0.5,33,64,0.516,14,30,0.467,21,34,0.618,129
104,LAC,2021-04-06,133,,POR,1,240,46,89,0.517,30,48,0.625,16,41,0.39,25,30,0.833,133,37,92,0.402,26,56,0.464,11,36,0.306,31,37,0.838,116
105,PHO,2021-04-05,133,@,HOU,1,240,44,86,0.512,26,49,0.531,18,37,0.486,27,31,0.871,133,43,79,0.544,26,46,0.565,17,33,0.515,27,33,0.818,130
106,SAS,2021-04-03,133,,IND,0,265,48,99,0.485,38,70,0.543,10,29,0.345,27,32,0.844,133,52,94,0.553,40,65,0.615,12,29,0.414,23,26,0.885,139
107,POR,2021-04-03,133,,OKC,1,240,51,104,0.49,31,58,0.534,20,46,0.435,11,14,0.786,133,30,85,0.353,22,51,0.431,8,34,0.235,17,24,0.708,85
108,MIL,2021-03-15,133,@,WAS,1,240,52,94,0.553,41,66,0.621,11,28,0.393,18,19,0.947,133,44,87,0.506,28,49,0.571,16,38,0.421,18,24,0.75,122
109,MEM,2021-02-28,133,@,HOU,1,240,50,94,0.532,40,64,0.625,10,30,0.333,23,28,0.821,133,23,83,0.277,19,38,0.5,4,45,0.089,34,41,0.829,84
110,CHI,2021-02-24,133,,MIN,1,265,55,93,0.591,45,68,0.662,10,25,0.4,13,16,0.813,133,47,104,0.452,35,66,0.53,12,38,0.316,20,21,0.952,126
111,DEN,2021-02-10,133,,CLE,1,240,51,85,0.6,35,49,0.714,16,36,0.444,15,21,0.714,133,36,94,0.383,28,57,0.491,8,37,0.216,15,20,0.75,95
112,MEM,2021-02-01,133,@,SAS,1,240,52,93,0.559,37,63,0.587,15,30,0.5,14,18,0.778,133,37,89,0.416,24,52,0.462,13,37,0.351,15,22,0.682,102
113,HOU,2021-01-23,133,@,DAL,1,240,47,86,0.547,31,49,0.633,16,37,0.432,23,29,0.793,133,37,83,0.446,32,58,0.552,5,25,0.2,29,40,0.725,108
114,CHI,2020-12-31,133,@,WAS,1,240,50,92,0.543,36,56,0.643,14,36,0.389,19,25,0.76,133,42,84,0.5,28,55,0.509,14,29,0.483,32,41,0.78,130
115,POR,2021-05-16,132,,DEN,1,240,46,87,0.529,28,44,0.636,18,43,0.419,22,26,0.846,132,44,98,0.449,30,61,0.492,14,37,0.378,14,15,0.933,116
116,IND,2021-05-08,132,,WAS,0,265,50,104,0.481,43,75,0.573,7,29,0.241,25,30,0.833,132,49,110,0.445,40,78,0.513,9,32,0.281,26,30,0.867,133
117,BOS,2021-05-05,132,@,ORL,1,240,51,96,0.531,30,51,0.588,21,45,0.467,9,12,0.75,132,33,85,0.388,27,60,0.45,6,25,0.24,24,28,0.857,96
118,MIL,2021-04-24,132,,PHI,1,240,49,95,0.516,31,55,0.564,18,40,0.45,16,24,0.667,132,31,82,0.378,24,51,0.471,7,31,0.226,25,34,0.735,94
119,IND,2021-04-14,132,@,HOU,1,240,50,94,0.532,35,58,0.603,15,36,0.417,17,22,0.773,132,48,104,0.462,38,70,0.543,10,34,0.294,18,22,0.818,124
120,IND,2021-04-11,132,@,MEM,1,240,52,99,0.525,39,62,0.629,13,37,0.351,15,17,0.882,132,53,115,0.461,47,95,0.495,6,20,0.3,13,19,0.684,125
121,DET,2021-04-05,132,@,OKC,1,240,49,95,0.516,36,67,0.537,13,28,0.464,21,24,0.875,132,41,97,0.423,36,70,0.514,5,27,0.185,21,25,0.84,108
122,SAC,2021-03-29,132,@,SAS,1,240,47,84,0.56,29,48,0.604,18,36,0.5,20,25,0.8,132,47,93,0.505,37,66,0.561,10,27,0.37,11,14,0.786,115
123,WAS,2021-03-29,132,,IND,1,240,55,99,0.556,45,80,0.563,10,19,0.526,12,18,0.667,132,44,93,0.473,32,63,0.508,12,30,0.4,24,33,0.727,124
124,MEM,2021-03-22,132,,BOS,1,265,55,110,0.5,43,75,0.573,12,35,0.343,10,15,0.667,132,47,90,0.522,30,55,0.545,17,35,0.486,15,24,0.625,126
125,DAL,2021-03-21,132,@,POR,1,240,48,86,0.558,29,49,0.592,19,37,0.514,17,20,0.85,132,34,89,0.382,25,48,0.521,9,41,0.22,15,19,0.789,92
126,BOS,2021-03-04,132,,TOR,1,240,45,74,0.608,32,45,0.711,13,29,0.448,29,40,0.725,132,45,91,0.495,24,41,0.585,21,50,0.42,14,17,0.824,125
127,BRK,2021-03-03,132,@,HOU,1,240,49,85,0.576,32,50,0.64,17,35,0.486,17,24,0.708,132,38,91,0.418,20,48,0.417,18,43,0.419,20,28,0.714,114
128,PHO,2021-02-22,132,,POR,1,240,50,99,0.505,34,66,0.515,16,33,0.485,16,18,0.889,132,37,84,0.44,25,45,0.556,12,39,0.308,14,19,0.737,100
129,UTA,2021-02-22,132,,CHO,1,240,45,85,0.529,17,30,0.567,28,55,0.509,14,17,0.824,132,41,89,0.461,30,53,0.566,11,36,0.306,17,21,0.81,110
130,PHO,2021-02-19,132,@,NOP,1,240,51,88,0.58,29,49,0.592,22,39,0.564,8,12,0.667,132,42,82,0.512,31,50,0.62,11,32,0.344,19,24,0.792,114
131,GSW,2021-02-06,132,@,DAL,0,240,46,86,0.535,26,41,0.634,20,45,0.444,20,23,0.87,132,44,96,0.458,23,49,0.469,21,47,0.447,25,30,0.833,134
132,ATL,2021-02-06,132,,TOR,1,240,42,74,0.568,23,38,0.605,19,36,0.528,29,33,0.879,132,41,97,0.423,28,59,0.475,13,38,0.342,26,34,0.765,121
133,POR,2021-02-02,132,@,WAS,1,240,44,95,0.463,23,49,0.469,21,46,0.457,23,23,1.0,132,46,83,0.554,30,43,0.698,16,40,0.4,13,17,0.765,121
134,BRK,2021-01-27,132,@,ATL,1,265,52,98,0.531,41,66,0.621,11,32,0.344,17,20,0.85,132,45,94,0.479,32,61,0.525,13,33,0.394,25,28,0.893,128
135,POR,2021-01-13,132,@,SAC,1,240,44,90,0.489,21,42,0.5,23,48,0.479,21,27,0.778,132,44,84,0.524,25,46,0.543,19,38,0.5,19,26,0.731,126
136,HOU,2021-01-08,132,,ORL,1,240,51,91,0.56,29,44,0.659,22,47,0.468,8,11,0.727,132,34,89,0.382,26,60,0.433,8,29,0.276,14,16,0.875,90
137,WAS,2021-05-06,131,@,TOR,1,265,41,94,0.436,28,64,0.438,13,30,0.433,36,43,0.837,131,47,105,0.448,33,67,0.493,14,38,0.368,21,27,0.778,129
138,IND,2021-04-25,131,@,ORL,1,240,50,91,0.549,35,59,0.593,15,32,0.469,16,18,0.889,131,40,101,0.396,30,69,0.435,10,32,0.313,22,28,0.786,112
139,LAC,2021-04-11,131,,DET,1,240,50,80,0.625,35,53,0.66,15,27,0.556,16,21,0.762,131,46,87,0.529,31,55,0.564,15,32,0.469,17,19,0.895,124
140,MEM,2021-04-07,131,@,ATL,1,240,48,89,0.539,31,49,0.633,17,40,0.425,18,21,0.857,131,45,101,0.446,35,73,0.479,10,28,0.357,13,15,0.867,113
141,WAS,2021-04-07,131,@,ORL,1,240,49,85,0.576,30,49,0.612,19,36,0.528,14,16,0.875,131,44,93,0.473,32,62,0.516,12,31,0.387,16,23,0.696,116
142,NYK,2021-03-23,131,,WAS,1,240,47,92,0.511,31,62,0.5,16,30,0.533,21,24,0.875,131,38,79,0.481,29,56,0.518,9,23,0.391,28,35,0.8,113
143,DEN,2021-03-19,131,,CHI,1,265,48,91,0.527,34,57,0.596,14,34,0.412,21,27,0.778,131,47,90,0.522,30,55,0.545,17,35,0.486,16,23,0.696,127
144,WAS,2021-03-18,131,,UTA,1,240,47,86,0.547,40,69,0.58,7,17,0.412,30,38,0.789,131,44,96,0.458,26,48,0.542,18,48,0.375,16,28,0.571,122
145,GSW,2021-03-14,131,,UTA,1,240,50,89,0.562,34,58,0.586,16,31,0.516,15,18,0.833,131,41,93,0.441,26,49,0.531,15,44,0.341,22,29,0.759,119
146,PHI,2021-03-03,131,,UTA,1,265,48,93,0.516,40,68,0.588,8,25,0.32,27,35,0.771,131,44,100,0.44,23,56,0.411,21,44,0.477,14,19,0.737,123
147,WAS,2021-02-15,131,,HOU,1,240,48,92,0.522,36,62,0.581,12,30,0.4,23,31,0.742,131,43,91,0.473,35,54,0.648,8,37,0.216,25,34,0.735,119
148,NOP,2021-01-29,131,,MIL,1,240,45,96,0.469,24,48,0.5,21,48,0.438,20,28,0.714,131,48,96,0.5,35,61,0.574,13,35,0.371,17,22,0.773,126
149,UTA,2021-01-08,131,@,MIL,1,240,49,97,0.505,24,44,0.545,25,53,0.472,8,13,0.615,131,44,98,0.449,31,56,0.554,13,42,0.31,17,21,0.81,118
150,SAS,2020-12-23,131,@,MEM,1,240,48,95,0.505,38,70,0.543,10,25,0.4,25,29,0.862,131,49,95,0.516,39,68,0.574,10,27,0.37,11,18,0.611,119
151,MIA,2021-05-09,130,@,BOS,1,240,47,82,0.573,31,47,0.66,16,35,0.457,20,22,0.909,130,45,83,0.542,31,45,0.689,14,38,0.368,20,25,0.8,124
152,BRK,2021-04-29,130,@,IND,1,240,47,89,0.528,35,54,0.648,12,35,0.343,24,28,0.857,130,41,96,0.427,30,57,0.526,11,39,0.282,20,21,0.952,113
153,POR,2021-04-28,130,@,MEM,1,240,45,92,0.489,30,52,0.577,15,40,0.375,25,28,0.893,130,37,88,0.42,28,56,0.5,9,32,0.281,26,30,0.867,109
154,MEM,2021-04-23,130,@,POR,1,240,52,98,0.531,43,68,0.632,9,30,0.3,17,22,0.773,130,46,96,0.479,32,61,0.525,14,35,0.4,22,27,0.815,128
155,BRK,2021-04-16,130,,CHO,1,240,47,85,0.553,26,44,0.591,21,41,0.512,15,16,0.938,130,44,83,0.53,32,49,0.653,12,34,0.353,15,20,0.75,115
156,MIL,2021-04-14,130,@,MIN,1,240,46,98,0.469,27,58,0.466,19,40,0.475,19,23,0.826,130,34,92,0.37,19,51,0.373,15,41,0.366,22,31,0.71,105
157,HOU,2021-04-05,130,,PHO,0,240,43,79,0.544,26,46,0.565,17,33,0.515,27,33,0.818,130,44,86,0.512,26,49,0.531,18,37,0.486,27,31,0.871,133
158,TOR,2021-04-02,130,,GSW,1,240,47,88,0.534,32,53,0.604,15,35,0.429,21,25,0.84,130,26,79,0.329,15,45,0.333,11,34,0.324,14,18,0.778,77
159,LAC,2021-03-11,130,,GSW,1,240,44,96,0.458,26,55,0.473,18,41,0.439,24,29,0.828,130,38,88,0.432,29,52,0.558,9,36,0.25,19,27,0.704,104
160,DAL,2021-03-01,130,@,ORL,1,240,47,90,0.522,30,44,0.682,17,46,0.37,19,23,0.826,130,47,95,0.495,27,54,0.5,20,41,0.488,10,14,0.714,124
161,PHI,2021-03-01,130,,IND,1,240,50,88,0.568,35,53,0.66,15,35,0.429,15,16,0.938,130,44,91,0.484,36,62,0.581,8,29,0.276,18,21,0.857,114
162,GSW,2021-02-26,130,,CHO,1,240,48,79,0.608,37,55,0.673,11,24,0.458,23,25,0.92,130,41,89,0.461,24,48,0.5,17,41,0.415,22,32,0.688,121
163,WAS,2021-02-17,130,,DEN,1,240,44,86,0.512,29,53,0.547,15,33,0.455,27,34,0.794,130,48,92,0.522,31,54,0.574,17,38,0.447,15,18,0.833,128
164,NOP,2021-02-12,130,@,DAL,0,240,48,90,0.533,31,53,0.585,17,37,0.459,17,23,0.739,130,51,88,0.58,26,43,0.605,25,45,0.556,16,21,0.762,143
165,MEM,2021-02-10,130,,CHO,1,240,47,94,0.5,24,45,0.533,23,49,0.469,13,18,0.722,130,45,82,0.549,31,53,0.585,14,29,0.483,10,12,0.833,114
166,NOP,2021-02-09,130,,HOU,1,240,47,92,0.511,35,61,0.574,12,31,0.387,24,28,0.857,130,38,91,0.418,25,48,0.521,13,43,0.302,12,21,0.571,101
167,MIL,2021-02-03,130,,IND,1,240,48,102,0.471,27,54,0.5,21,48,0.438,13,14,0.929,130,43,95,0.453,32,61,0.525,11,34,0.324,13,15,0.867,110
168,GSW,2021-01-25,130,,MIN,1,240,44,89,0.494,30,59,0.508,14,30,0.467,28,37,0.757,130,39,94,0.415,31,70,0.443,8,24,0.333,22,25,0.88,108
169,DEN,2021-01-22,130,@,PHO,1,265,53,103,0.515,47,77,0.61,6,26,0.231,18,19,0.947,130,47,94,0.5,30,50,0.6,17,44,0.386,15,15,1.0,126
170,LAC,2021-01-10,130,,CHI,1,240,45,92,0.489,25,54,0.463,20,38,0.526,20,25,0.8,130,47,77,0.61,29,44,0.659,18,33,0.545,15,17,0.882,127
171,MIL,2021-01-06,130,,DET,1,240,49,90,0.544,30,47,0.638,19,43,0.442,13,21,0.619,130,38,97,0.392,25,56,0.446,13,41,0.317,26,30,0.867,115
172,BRK,2021-01-05,130,,UTA,1,240,52,93,0.559,38,57,0.667,14,36,0.389,12,16,0.75,130,33,86,0.384,22,52,0.423,11,34,0.324,19,27,0.704,96
173,UTA,2021-01-03,130,@,SAS,1,240,49,89,0.551,28,48,0.583,21,41,0.512,11,19,0.579,130,44,105,0.419,38,86,0.442,6,19,0.316,15,21,0.714,109
174,WAS,2021-01-01,130,@,MIN,1,240,49,89,0.551,33,56,0.589,16,33,0.485,16,21,0.762,130,42,88,0.477,29,52,0.558,13,36,0.361,12,21,0.571,109
175,WAS,2020-12-31,130,,CHI,0,240,42,84,0.5,28,55,0.509,14,29,0.483,32,41,0.78,130,50,92,0.543,36,56,0.643,14,36,0.389,19,25,0.76,133
176,NYK,2020-12-27,130,,MIL,1,240,46,85,0.541,30,58,0.517,16,27,0.593,22,27,0.815,130,41,95,0.432,34,57,0.596,7,38,0.184,21,29,0.724,110
177,ORL,2020-12-26,130,@,WAS,1,240,48,95,0.505,37,64,0.578,11,31,0.355,23,29,0.793,130,46,95,0.484,33,58,0.569,13,37,0.351,15,28,0.536,120
178,MIA,2021-05-11,129,@,BOS,1,240,48,81,0.593,32,51,0.627,16,30,0.533,17,22,0.773,129,46,88,0.523,28,51,0.549,18,37,0.486,11,17,0.647,121
179,HOU,2021-05-10,129,@,POR,0,240,42,85,0.494,24,47,0.511,18,38,0.474,27,28,0.964,129,47,92,0.511,29,52,0.558,18,40,0.45,28,35,0.8,140
180,TOR,2021-05-06,129,,WAS,0,265,47,105,0.448,33,67,0.493,14,38,0.368,21,27,0.778,129,41,94,0.436,28,64,0.438,13,30,0.433,36,43,0.837,131
181,POR,2021-05-02,129,@,BOS,1,240,44,85,0.518,25,47,0.532,19,38,0.5,22,26,0.846,129,43,89,0.483,23,50,0.46,20,39,0.513,13,15,0.867,119
182,DEN,2021-04-24,129,,HOU,1,240,50,84,0.595,34,47,0.723,16,37,0.432,13,16,0.813,129,41,82,0.5,26,42,0.619,15,40,0.375,19,28,0.679,116
183,WAS,2021-04-23,129,@,OKC,1,240,48,93,0.516,30,61,0.492,18,32,0.563,15,16,0.938,129,39,93,0.419,29,60,0.483,10,33,0.303,21,25,0.84,109
184,NOP,2021-04-20,129,,BRK,0,240,51,91,0.56,39,58,0.672,12,33,0.364,15,24,0.625,129,49,89,0.551,35,52,0.673,14,37,0.378,22,28,0.786,134
185,ATL,2021-04-18,129,,IND,1,240,45,92,0.489,32,60,0.533,13,32,0.406,26,34,0.765,129,45,92,0.489,35,60,0.583,10,32,0.313,17,20,0.85,117
186,MEM,2021-04-09,129,@,NYK,0,265,47,94,0.5,33,64,0.516,14,30,0.467,21,34,0.618,129,45,96,0.469,31,64,0.484,14,32,0.438,29,33,0.879,133
187,CLE,2021-04-08,129,@,OKC,1,240,48,94,0.511,35,57,0.614,13,37,0.351,20,24,0.833,129,40,89,0.449,27,57,0.474,13,32,0.406,9,13,0.692,102
188,MIL,2021-04-03,129,@,SAC,1,240,50,93,0.538,39,62,0.629,11,31,0.355,18,20,0.9,129,49,99,0.495,32,60,0.533,17,39,0.436,13,13,1.0,128
189,SAS,2021-04-01,129,,ATL,0,290,49,110,0.445,36,70,0.514,13,40,0.325,18,24,0.75,129,50,100,0.5,37,76,0.487,13,24,0.542,21,26,0.808,134
190,LAC,2021-03-29,129,,MIL,1,240,51,95,0.537,32,61,0.525,19,34,0.559,8,10,0.8,129,38,81,0.469,27,51,0.529,11,30,0.367,18,21,0.857,105
191,HOU,2021-03-27,129,@,MIN,1,240,50,92,0.543,32,53,0.604,18,39,0.462,11,13,0.846,129,36,85,0.424,23,45,0.511,13,40,0.325,22,28,0.786,107
192,PHI,2021-03-20,129,,SAC,1,240,48,86,0.558,37,63,0.587,11,23,0.478,22,29,0.759,129,39,85,0.459,29,57,0.509,10,28,0.357,17,27,0.63,105
193,DEN,2021-03-17,129,,CHO,1,240,52,90,0.578,36,46,0.783,16,44,0.364,9,13,0.692,129,36,80,0.45,24,42,0.571,12,38,0.316,20,28,0.714,104
194,DET,2021-03-03,129,@,TOR,1,240,48,91,0.527,28,50,0.56,20,41,0.488,13,21,0.619,129,34,77,0.442,22,41,0.537,12,36,0.333,25,30,0.833,105
195,NOP,2021-03-01,129,,UTA,1,240,52,92,0.565,45,81,0.556,7,11,0.636,18,23,0.783,129,46,101,0.455,29,58,0.5,17,43,0.395,15,18,0.833,124
196,BRK,2021-02-25,129,,ORL,1,240,49,92,0.533,29,47,0.617,20,45,0.444,11,14,0.786,129,35,87,0.402,26,51,0.51,9,36,0.25,13,15,0.867,92
197,MIL,2021-02-25,129,,NOP,1,240,52,96,0.542,39,65,0.6,13,31,0.419,12,16,0.75,129,51,102,0.5,38,63,0.603,13,39,0.333,10,14,0.714,125
198,GSW,2021-02-15,129,,CLE,1,240,46,88,0.523,29,51,0.569,17,37,0.459,20,21,0.952,129,37,95,0.389,29,65,0.446,8,30,0.267,16,20,0.8,98
199,UTA,2021-02-12,129,,MIL,1,240,43,82,0.524,29,44,0.659,14,38,0.368,29,34,0.853,129,42,92,0.457,30,59,0.508,12,33,0.364,19,27,0.704,115
200,POR,2021-02-12,129,,CLE,1,240,43,83,0.518,30,48,0.625,13,35,0.371,30,33,0.909,129,38,87,0.437,30,64,0.469,8,23,0.348,26,37,0.703,110
201,CHI,2021-02-10,129,,NOP,1,240,48,81,0.593,23,34,0.676,25,47,0.532,8,11,0.727,129,41,81,0.506,28,45,0.622,13,36,0.361,21,26,0.808,116
202,DET,2021-02-06,129,@,LAL,0,290,45,94,0.479,29,52,0.558,16,42,0.381,23,28,0.821,129,51,91,0.56,42,72,0.583,9,19,0.474,24,28,0.857,135
203,CHO,2021-02-01,129,@,MIA,1,265,43,95,0.453,22,54,0.407,21,41,0.512,22,26,0.846,129,43,91,0.473,24,45,0.533,19,46,0.413,16,25,0.64,121
204,LAC,2021-01-31,129,@,NYK,1,240,44,81,0.543,27,43,0.628,17,38,0.447,24,28,0.857,129,41,85,0.482,31,58,0.534,10,27,0.37,23,28,0.821,115
205,MEM,2021-01-30,129,@,SAS,1,240,51,91,0.56,34,56,0.607,17,35,0.486,10,15,0.667,129,39,83,0.47,26,54,0.481,13,29,0.448,21,26,0.808,112
206,IND,2021-01-25,129,,TOR,1,240,40,78,0.513,28,49,0.571,12,29,0.414,37,45,0.822,129,38,93,0.409,24,55,0.436,14,38,0.368,24,27,0.889,114
207,MIL,2021-01-24,129,,ATL,1,240,50,91,0.549,40,60,0.667,10,31,0.323,19,27,0.704,129,42,83,0.506,28,44,0.636,14,39,0.359,17,22,0.773,115
208,UTA,2021-01-21,129,,NOP,1,240,44,88,0.5,27,49,0.551,17,39,0.436,24,25,0.96,129,42,85,0.494,31,60,0.517,11,25,0.44,23,30,0.767,118
209,LAC,2021-01-17,129,,IND,1,240,48,87,0.552,29,48,0.604,19,39,0.487,14,20,0.7,129,37,89,0.416,26,51,0.51,11,38,0.289,11,16,0.688,96
210,OKC,2021-01-10,129,@,BRK,1,240,49,90,0.544,34,51,0.667,15,39,0.385,16,17,0.941,129,43,85,0.506,33,51,0.647,10,34,0.294,20,24,0.833,116
211,GSW,2020-12-27,129,@,CHI,1,240,42,104,0.404,24,57,0.421,18,47,0.383,27,30,0.9,129,44,86,0.512,27,45,0.6,17,41,0.415,23,31,0.742,128
212,PHI,2021-05-16,128,,ORL,1,240,46,94,0.489,27,54,0.5,19,40,0.475,17,23,0.739,128,36,76,0.474,26,48,0.542,10,28,0.357,35,41,0.854,117
213,BRK,2021-05-12,128,,SAS,1,240,48,79,0.608,36,51,0.706,12,28,0.429,20,27,0.741,128,43,101,0.426,35,70,0.5,8,31,0.258,22,27,0.815,116
214,MIN,2021-05-09,128,@,ORL,1,240,47,97,0.485,31,52,0.596,16,45,0.356,18,24,0.75,128,36,91,0.396,27,55,0.491,9,36,0.25,15,22,0.682,96
215,PHO,2021-05-07,128,,NYK,1,240,43,92,0.467,25,51,0.49,18,41,0.439,24,25,0.96,128,38,84,0.452,27,52,0.519,11,32,0.344,18,23,0.783,105
216,POR,2021-04-30,128,@,BRK,1,240,47,91,0.516,31,55,0.564,16,36,0.444,18,20,0.9,128,40,95,0.421,27,54,0.5,13,41,0.317,16,19,0.842,109
217,BRK,2021-04-25,128,,PHO,1,240,46,87,0.529,33,59,0.559,13,28,0.464,23,27,0.852,128,43,90,0.478,31,56,0.554,12,34,0.353,21,25,0.84,119
218,POR,2021-04-23,128,,MEM,0,240,46,96,0.479,32,61,0.525,14,35,0.4,22,27,0.815,128,52,98,0.531,43,68,0.632,9,30,0.3,17,22,0.773,130
219,SAC,2021-04-21,128,,MIN,1,240,43,74,0.581,26,41,0.634,17,33,0.515,25,31,0.806,128,46,87,0.529,31,53,0.585,15,34,0.441,18,22,0.818,125
220,PHO,2021-04-19,128,@,MIL,1,265,51,106,0.481,34,64,0.531,17,42,0.405,9,10,0.9,128,49,102,0.48,38,68,0.559,11,34,0.324,18,19,0.947,127
221,MEM,2021-04-17,128,@,MIL,1,240,51,93,0.548,36,53,0.679,15,40,0.375,11,12,0.917,128,39,91,0.429,23,44,0.523,16,47,0.34,21,27,0.778,115
222,DEN,2021-04-16,128,@,HOU,1,240,46,94,0.489,37,63,0.587,9,31,0.29,27,31,0.871,128,38,86,0.442,27,51,0.529,11,35,0.314,12,18,0.667,99
223,UTA,2021-04-10,128,,SAC,1,240,40,88,0.455,22,38,0.579,18,50,0.36,30,35,0.857,128,42,88,0.477,28,46,0.609,14,42,0.333,14,22,0.636,112
224,SAC,2021-04-03,128,,MIL,0,240,49,99,0.495,32,60,0.533,17,39,0.436,13,13,1.0,128,50,93,0.538,39,62,0.629,11,31,0.355,18,20,0.9,129
225,DAL,2021-03-24,128,@,MIN,1,240,48,99,0.485,32,55,0.582,16,44,0.364,16,22,0.727,128,38,86,0.442,26,48,0.542,12,38,0.316,20,26,0.769,108
226,NOP,2021-03-23,128,,LAL,1,240,47,90,0.522,37,61,0.607,10,29,0.345,24,26,0.923,128,36,85,0.424,18,48,0.375,18,37,0.486,21,30,0.7,111
227,LAL,2021-03-15,128,@,GSW,1,240,49,78,0.628,38,51,0.745,11,27,0.407,19,25,0.76,128,34,79,0.43,21,42,0.5,13,37,0.351,16,24,0.667,97
228,OKC,2021-03-14,128,,MEM,1,240,42,73,0.575,26,42,0.619,16,31,0.516,28,34,0.824,128,47,92,0.511,40,70,0.571,7,22,0.318,21,29,0.724,122
229,CHI,2021-03-03,128,@,NOP,1,240,48,94,0.511,36,66,0.545,12,28,0.429,20,22,0.909,128,46,83,0.554,40,61,0.656,6,22,0.273,26,38,0.684,124
230,DEN,2021-03-02,128,@,MIL,1,240,53,95,0.558,42,65,0.646,11,30,0.367,11,12,0.917,128,32,79,0.405,21,39,0.538,11,40,0.275,22,31,0.71,97
231,WAS,2021-02-27,128,,MIN,1,240,44,98,0.449,31,65,0.477,13,33,0.394,27,34,0.794,128,41,95,0.432,30,60,0.5,11,35,0.314,19,29,0.655,112
232,NOP,2021-02-24,128,,DET,1,240,50,90,0.556,40,67,0.597,10,23,0.435,18,29,0.621,128,47,89,0.528,34,53,0.642,13,36,0.361,11,16,0.688,118
233,MIL,2021-02-21,128,,SAC,1,240,44,90,0.489,33,62,0.532,11,28,0.393,29,36,0.806,128,44,100,0.44,32,67,0.478,12,33,0.364,15,20,0.75,115
234,PHO,2021-02-20,128,@,MEM,1,240,46,86,0.535,22,40,0.55,24,46,0.522,12,13,0.923,128,36,93,0.387,31,60,0.517,5,33,0.152,20,23,0.87,97
235,MIN,2021-02-17,128,,IND,0,265,45,107,0.421,30,67,0.448,15,40,0.375,23,25,0.92,128,49,97,0.505,36,71,0.507,13,26,0.5,23,27,0.852,134
236,DEN,2021-02-17,128,@,WAS,0,240,48,92,0.522,31,54,0.574,17,38,0.447,15,18,0.833,128,44,86,0.512,29,53,0.547,15,33,0.455,27,34,0.794,130
237,BRK,2021-02-16,128,@,PHO,1,240,47,82,0.573,27,42,0.643,20,40,0.5,14,15,0.933,128,48,88,0.545,32,51,0.627,16,37,0.432,12,12,1.0,124
238,LAC,2021-02-14,128,,CLE,1,240,42,88,0.477,29,58,0.5,13,30,0.433,31,36,0.861,128,43,93,0.462,36,68,0.529,7,25,0.28,18,25,0.72,111
239,TOR,2021-02-08,128,@,MEM,1,240,42,77,0.545,22,40,0.55,20,37,0.541,24,26,0.923,128,37,87,0.425,24,48,0.5,13,39,0.333,26,29,0.897,113
240,DEN,2021-01-31,128,,UTA,1,240,47,87,0.54,29,59,0.492,18,28,0.643,16,19,0.842,128,32,75,0.427,12,28,0.429,20,47,0.426,33,39,0.846,117
241,ATL,2021-01-27,128,,BRK,0,265,45,94,0.479,32,61,0.525,13,33,0.394,25,28,0.893,128,52,98,0.531,41,66,0.621,11,32,0.344,17,20,0.85,132
242,BRK,2021-01-23,128,,MIA,1,240,44,83,0.53,25,46,0.543,19,37,0.514,21,26,0.808,128,42,89,0.472,29,43,0.674,13,46,0.283,27,32,0.844,124
243,NOP,2021-01-17,128,@,SAC,1,240,45,85,0.529,34,63,0.54,11,22,0.5,27,34,0.794,128,47,91,0.516,34,52,0.654,13,39,0.333,16,18,0.889,123
244,LAL,2021-01-13,128,@,OKC,1,240,47,95,0.495,30,58,0.517,17,37,0.459,17,22,0.773,128,37,86,0.43,27,55,0.491,10,31,0.323,15,19,0.789,99
245,WAS,2021-01-11,128,,PHO,1,240,48,92,0.522,33,58,0.569,15,34,0.441,17,28,0.607,128,39,87,0.448,35,60,0.583,4,27,0.148,25,30,0.833,107
246,MIA,2021-01-09,128,@,WAS,1,240,46,93,0.495,30,50,0.6,16,43,0.372,20,26,0.769,128,44,99,0.444,29,59,0.492,15,40,0.375,21,28,0.75,124
247,SAC,2021-01-06,128,,CHI,1,240,47,91,0.516,33,54,0.611,14,37,0.378,20,27,0.741,128,49,93,0.527,35,53,0.66,14,40,0.35,12,15,0.8,124
248,LAC,2020-12-30,128,,POR,1,240,47,95,0.495,29,57,0.509,18,38,0.474,16,22,0.727,128,32,76,0.421,20,38,0.526,12,38,0.316,29,34,0.853,105
249,ATL,2020-12-28,128,,DET,1,240,40,82,0.488,20,40,0.5,20,42,0.476,28,32,0.875,128,43,98,0.439,30,57,0.526,13,41,0.317,21,24,0.875,120
250,CHI,2020-12-27,128,,GSW,0,240,44,86,0.512,27,45,0.6,17,41,0.415,23,31,0.742,128,42,104,0.404,24,57,0.421,18,47,0.383,27,30,0.9,129
251,CLE,2020-12-26,128,@,DET,1,290,48,99,0.485,35,69,0.507,13,30,0.433,19,30,0.633,128,40,98,0.408,24,53,0.453,16,45,0.356,23,32,0.719,119
252,POR,2020-12-26,128,,HOU,1,265,47,102,0.461,28,57,0.491,19,45,0.422,15,23,0.652,128,45,87,0.517,34,52,0.654,11,35,0.314,25,32,0.781,126
253,UTA,2021-05-07,127,,DEN,1,240,43,89,0.483,22,43,0.512,21,46,0.457,20,23,0.87,127,43,83,0.518,26,45,0.578,17,38,0.447,17,20,0.85,120
254,DAL,2021-05-04,127,@,MIA,1,240,46,87,0.529,24,39,0.615,22,48,0.458,13,18,0.722,127,39,84,0.464,21,43,0.488,18,41,0.439,17,21,0.81,113
255,PHI,2021-04-28,127,,ATL,1,240,48,89,0.539,32,53,0.604,16,36,0.444,15,22,0.682,127,27,81,0.333,21,62,0.339,6,19,0.316,23,29,0.793,83
256,DAL,2021-04-21,127,,DET,1,240,46,92,0.5,30,49,0.612,16,43,0.372,19,26,0.731,127,40,79,0.506,27,47,0.574,13,32,0.406,24,31,0.774,117
257,ATL,2021-04-21,127,@,NYK,0,265,49,102,0.48,37,68,0.544,12,34,0.353,17,24,0.708,127,49,91,0.538,30,56,0.536,19,35,0.543,20,25,0.8,137
258,MIL,2021-04-19,127,,PHO,0,265,49,102,0.48,38,68,0.559,11,34,0.324,18,19,0.947,127,51,106,0.481,34,64,0.531,17,42,0.405,9,10,0.9,128
259,LAL,2021-04-17,127,,UTA,1,265,48,93,0.516,37,60,0.617,11,33,0.333,20,23,0.87,127,42,101,0.416,19,42,0.452,23,59,0.39,8,8,1.0,115
260,BRK,2021-04-13,127,@,MIN,1,240,46,91,0.505,31,55,0.564,15,36,0.417,20,24,0.833,127,30,87,0.345,17,38,0.447,13,49,0.265,24,33,0.727,97
261,CHO,2021-04-09,127,@,MIL,1,240,44,91,0.484,25,41,0.61,19,50,0.38,20,22,0.909,127,44,98,0.449,30,60,0.5,14,38,0.368,17,23,0.739,119
262,MIL,2021-04-02,127,@,POR,1,240,49,90,0.544,37,51,0.725,12,39,0.308,17,19,0.895,127,36,99,0.364,15,45,0.333,21,54,0.389,16,22,0.727,109
263,DAL,2021-03-29,127,@,OKC,1,240,51,96,0.531,35,52,0.673,16,44,0.364,9,13,0.692,127,38,81,0.469,29,55,0.527,9,26,0.346,21,33,0.636,106
264,CHI,2021-03-19,127,@,DEN,0,265,47,90,0.522,30,55,0.545,17,35,0.486,16,23,0.696,127,48,91,0.527,34,57,0.596,14,34,0.412,21,27,0.778,131
265,PHI,2021-03-12,127,@,WAS,1,240,49,90,0.544,38,69,0.551,11,21,0.524,18,18,1.0,127,40,82,0.488,32,58,0.552,8,24,0.333,13,22,0.591,101
266,PHI,2021-03-11,127,@,CHI,1,240,53,103,0.515,43,70,0.614,10,33,0.303,11,15,0.733,127,39,83,0.47,25,54,0.463,14,29,0.483,13,16,0.813,105
267,PHO,2021-03-11,127,@,POR,1,240,49,83,0.59,36,59,0.61,13,24,0.542,16,19,0.842,127,43,94,0.457,25,51,0.49,18,43,0.419,17,19,0.895,121
268,MEM,2021-03-10,127,,WAS,1,240,50,99,0.505,42,76,0.553,8,23,0.348,19,29,0.655,127,38,95,0.4,27,59,0.458,11,36,0.306,25,27,0.926,112
269,CHO,2021-02-28,127,@,SAC,1,240,45,83,0.542,34,53,0.642,11,30,0.367,26,27,0.963,127,50,92,0.543,34,56,0.607,16,36,0.444,10,17,0.588,126
270,ATL,2021-02-24,127,,BOS,1,240,45,85,0.529,22,43,0.512,23,42,0.548,14,17,0.824,127,42,95,0.442,34,64,0.531,8,31,0.258,20,23,0.87,112
271,BRK,2021-02-23,127,,SAC,1,240,44,89,0.494,27,49,0.551,17,40,0.425,22,31,0.71,127,45,87,0.517,30,56,0.536,15,31,0.484,13,19,0.684,118
272,WAS,2021-02-22,127,@,LAL,1,265,47,96,0.49,38,71,0.535,9,25,0.36,24,33,0.727,127,49,104,0.471,34,60,0.567,15,44,0.341,11,17,0.647,124
273,DAL,2021-02-08,127,,MIN,1,240,45,87,0.517,33,53,0.623,12,34,0.353,25,30,0.833,127,42,91,0.462,24,49,0.49,18,42,0.429,20,28,0.714,122
274,UTA,2021-01-23,127,,GSW,1,240,45,94,0.479,25,44,0.568,20,50,0.4,17,22,0.773,127,42,93,0.452,28,54,0.519,14,39,0.359,10,15,0.667,108
275,OKC,2021-01-15,127,,CHI,1,265,48,105,0.457,33,60,0.55,15,45,0.333,16,24,0.667,127,43,91,0.473,22,45,0.489,21,46,0.457,18,25,0.72,125
276,SAC,2021-01-11,127,,IND,1,240,47,84,0.56,32,52,0.615,15,32,0.469,18,23,0.783,127,47,97,0.485,34,58,0.586,13,39,0.333,15,18,0.833,122
277,CHI,2021-01-10,127,@,LAC,0,240,47,77,0.61,29,44,0.659,18,33,0.545,15,17,0.882,127,45,92,0.489,25,54,0.463,20,38,0.526,20,25,0.8,130
278,PHI,2021-01-02,127,,CHO,1,240,47,79,0.595,31,44,0.705,16,35,0.457,17,24,0.708,127,38,92,0.413,25,57,0.439,13,35,0.371,23,26,0.885,112
279,LAL,2020-12-27,127,,MIN,1,240,50,90,0.556,37,55,0.673,13,35,0.371,14,18,0.778,127,38,103,0.369,32,68,0.471,6,35,0.171,9,14,0.643,91
280,SAC,2021-05-09,126,,OKC,1,240,45,85,0.529,29,49,0.592,16,36,0.444,20,24,0.833,126,34,87,0.391,23,50,0.46,11,37,0.297,19,29,0.655,98
281,ATL,2021-05-06,126,@,IND,0,240,48,94,0.511,33,57,0.579,15,37,0.405,15,18,0.833,126,54,87,0.621,46,67,0.687,8,20,0.4,17,19,0.895,133
282,UTA,2021-05-05,126,,SAS,1,240,49,88,0.557,31,47,0.66,18,41,0.439,10,14,0.714,126,37,92,0.402,30,69,0.435,7,23,0.304,13,20,0.65,94
283,PHI,2021-04-30,126,,ATL,1,240,47,101,0.465,37,73,0.507,10,28,0.357,22,26,0.846,126,36,82,0.439,26,54,0.481,10,28,0.357,22,28,0.786,104
284,MIN,2021-04-29,126,,GSW,1,240,43,94,0.457,23,53,0.434,20,41,0.488,20,29,0.69,126,42,85,0.494,27,47,0.574,15,38,0.395,15,21,0.714,114
285,MEM,2021-04-16,126,@,CHI,1,240,45,86,0.523,28,46,0.609,17,40,0.425,19,24,0.792,126,45,96,0.469,32,62,0.516,13,34,0.382,12,15,0.8,115
286,LAC,2021-04-13,126,@,IND,1,240,48,89,0.539,35,61,0.574,13,28,0.464,17,19,0.895,126,44,96,0.458,35,56,0.625,9,40,0.225,18,22,0.818,115
287,PHO,2021-04-12,126,,HOU,1,240,45,94,0.479,20,49,0.408,25,45,0.556,11,18,0.611,126,44,87,0.506,27,45,0.6,17,42,0.405,15,19,0.789,120
288,LAL,2021-04-10,126,@,BRK,1,240,47,93,0.505,28,59,0.475,19,34,0.559,13,20,0.65,126,35,80,0.438,30,53,0.566,5,27,0.185,26,30,0.867,101
289,LAC,2021-04-09,126,,HOU,1,240,48,88,0.545,29,51,0.569,19,37,0.514,11,13,0.846,126,39,83,0.47,27,46,0.587,12,37,0.324,19,27,0.704,109
290,ATL,2021-04-02,126,@,NOP,1,240,49,87,0.563,36,58,0.621,13,29,0.448,15,21,0.714,126,38,88,0.432,30,59,0.508,8,29,0.276,19,23,0.826,103
291,DEN,2021-03-28,126,,ATL,1,240,50,92,0.543,35,56,0.625,15,36,0.417,11,16,0.688,126,36,76,0.474,24,42,0.571,12,34,0.353,18,21,0.857,102
292,UTA,2021-03-27,126,,MEM,1,240,46,92,0.5,27,47,0.574,19,45,0.422,15,20,0.75,126,39,97,0.402,30,64,0.469,9,33,0.273,23,30,0.767,110
293,BOS,2021-03-22,126,@,MEM,0,265,47,90,0.522,30,55,0.545,17,35,0.486,15,24,0.625,126,55,110,0.5,43,75,0.573,12,35,0.343,10,15,0.667,132
294,SAC,2021-02-28,126,,CHO,0,240,50,92,0.543,34,56,0.607,16,36,0.444,10,17,0.588,126,45,83,0.542,34,53,0.642,11,30,0.367,26,27,0.963,127
295,DEN,2021-02-27,126,@,OKC,1,240,49,89,0.551,34,58,0.586,15,31,0.484,13,16,0.813,126,37,88,0.42,26,41,0.634,11,47,0.234,11,15,0.733,96
296,MIN,2021-02-24,126,@,CHI,0,265,47,104,0.452,35,66,0.53,12,38,0.316,20,21,0.952,126,55,93,0.591,45,68,0.662,10,25,0.4,13,16,0.813,133
297,POR,2021-02-17,126,@,NOP,1,240,46,90,0.511,28,49,0.571,18,41,0.439,16,18,0.889,126,43,89,0.483,28,57,0.491,15,32,0.469,23,29,0.793,124
298,HOU,2021-01-30,126,@,NOP,1,240,45,92,0.489,25,46,0.543,20,46,0.435,16,20,0.8,126,41,91,0.451,29,50,0.58,12,41,0.293,18,29,0.621,112
299,CHO,2021-01-30,126,,MIL,1,240,44,92,0.478,23,48,0.479,21,44,0.477,17,20,0.85,126,40,82,0.488,22,37,0.595,18,45,0.4,16,24,0.667,114
300,MIL,2021-01-29,126,@,NOP,0,240,48,96,0.5,35,61,0.574,13,35,0.371,17,22,0.773,126,45,96,0.469,24,48,0.5,21,48,0.438,20,28,0.714,131
301,SAC,2021-01-29,126,@,TOR,1,240,43,78,0.551,27,42,0.643,16,36,0.444,24,31,0.774,126,42,86,0.488,29,54,0.537,13,32,0.406,27,33,0.818,124
302,PHO,2021-01-22,126,,DEN,0,265,47,94,0.5,30,50,0.6,17,44,0.386,15,15,1.0,126,53,103,0.515,47,77,0.61,6,26,0.231,18,19,0.947,130
303,SAC,2021-01-13,126,,POR,0,240,44,84,0.524,25,46,0.543,19,38,0.5,19,26,0.731,126,44,90,0.489,21,42,0.5,23,48,0.479,21,27,0.778,132
304,BOS,2021-01-04,126,@,TOR,1,240,41,84,0.488,26,55,0.473,15,29,0.517,29,34,0.853,126,36,90,0.4,23,53,0.434,13,37,0.351,29,38,0.763,114
305,MIL,2021-01-01,126,,CHI,1,240,42,85,0.494,20,40,0.5,22,45,0.489,20,30,0.667,126,38,87,0.437,32,61,0.525,6,26,0.231,14,20,0.7,96
306,BOS,2020-12-30,126,,MEM,1,240,49,91,0.538,33,52,0.635,16,39,0.41,12,14,0.857,126,40,93,0.43,31,60,0.517,9,33,0.273,18,25,0.72,107
307,HOU,2020-12-26,126,@,POR,0,265,45,87,0.517,34,52,0.654,11,35,0.314,25,32,0.781,126,47,102,0.461,28,57,0.491,19,45,0.422,15,23,0.652,128
308,IND,2021-05-16,125,@,TOR,1,240,48,95,0.505,33,58,0.569,15,37,0.405,14,18,0.778,125,39,97,0.402,27,59,0.458,12,38,0.316,23,29,0.793,113
309,GSW,2021-05-14,125,,NOP,1,240,42,87,0.483,25,48,0.521,17,39,0.436,24,30,0.8,125,46,99,0.465,35,72,0.486,11,27,0.407,19,28,0.679,122
310,DAL,2021-05-12,125,,NOP,1,240,47,96,0.49,32,51,0.627,15,45,0.333,16,20,0.8,125,36,87,0.414,29,59,0.492,7,28,0.25,28,38,0.737,107
311,MIL,2021-05-10,125,@,SAS,0,240,47,94,0.5,34,53,0.642,13,41,0.317,18,23,0.783,125,56,94,0.596,39,65,0.6,17,29,0.586,17,21,0.81,146
312,ATL,2021-05-10,125,,WAS,1,240,46,96,0.479,36,66,0.545,10,30,0.333,23,26,0.885,125,51,100,0.51,38,74,0.514,13,26,0.5,9,11,0.818,124
313,BRK,2021-05-08,125,@,DEN,1,240,41,66,0.621,25,35,0.714,16,31,0.516,27,33,0.818,125,42,92,0.457,28,51,0.549,14,41,0.341,21,23,0.913,119
314,DAL,2021-05-01,125,,WAS,1,240,47,87,0.54,30,49,0.612,17,38,0.447,14,22,0.636,125,47,91,0.516,41,72,0.569,6,19,0.316,24,31,0.774,124
315,CHO,2021-04-25,125,,BOS,1,240,47,93,0.505,26,50,0.52,21,43,0.488,10,11,0.909,125,34,88,0.386,20,47,0.426,14,41,0.341,22,26,0.846,104
316,MIN,2021-04-21,125,@,SAC,0,240,46,87,0.529,31,53,0.585,15,34,0.441,18,22,0.818,125,43,74,0.581,26,41,0.634,17,33,0.515,25,31,0.806,128
317,WAS,2021-04-12,125,@,UTA,1,240,47,90,0.522,38,71,0.535,9,19,0.474,22,28,0.786,125,41,85,0.482,26,49,0.531,15,36,0.417,24,31,0.774,121
318,MEM,2021-04-11,125,,IND,0,240,53,115,0.461,47,95,0.495,6,20,0.3,13,19,0.684,125,52,99,0.525,39,62,0.629,13,37,0.351,15,17,0.882,132
319,GSW,2021-04-10,125,,HOU,1,240,49,91,0.538,35,56,0.625,14,35,0.4,13,16,0.813,125,41,88,0.466,28,51,0.549,13,37,0.351,14,20,0.7,109
320,CLE,2021-04-05,125,@,SAS,1,240,45,86,0.523,33,52,0.635,12,34,0.353,23,27,0.852,125,35,83,0.422,30,57,0.526,5,26,0.192,26,32,0.813,101
321,NYK,2021-04-03,125,@,DET,1,240,43,79,0.544,24,40,0.6,19,39,0.487,20,27,0.741,125,29,82,0.354,20,54,0.37,9,28,0.321,14,20,0.7,81
322,POR,2021-03-25,125,@,MIA,1,240,44,92,0.478,24,46,0.522,20,46,0.435,17,19,0.895,125,47,84,0.56,31,50,0.62,16,34,0.471,12,13,0.923,122
323,LAC,2021-03-20,125,,CHO,1,240,45,86,0.523,33,52,0.635,12,34,0.353,23,23,1.0,125,31,80,0.388,16,39,0.41,15,41,0.366,21,28,0.75,98
324,POR,2021-03-19,125,,DAL,1,240,44,93,0.473,22,46,0.478,22,47,0.468,15,17,0.882,125,44,81,0.543,25,39,0.641,19,42,0.452,12,13,0.923,119
325,POR,2021-03-16,125,,NOP,1,240,38,73,0.521,20,30,0.667,18,43,0.419,31,31,1.0,125,46,88,0.523,30,55,0.545,16,33,0.485,16,20,0.8,124
326,MIL,2021-03-13,125,@,WAS,1,240,43,99,0.434,26,54,0.481,17,45,0.378,22,25,0.88,125,43,94,0.457,27,53,0.509,16,41,0.39,17,22,0.773,119
327,POR,2021-03-13,125,@,MIN,1,240,43,89,0.483,30,49,0.612,13,40,0.325,26,30,0.867,125,44,86,0.512,34,60,0.567,10,26,0.385,23,31,0.742,121
328,SAC,2021-03-11,125,,HOU,1,240,45,92,0.489,34,59,0.576,11,33,0.333,24,28,0.857,125,41,99,0.414,30,54,0.556,11,45,0.244,12,17,0.706,105
329,TOR,2021-03-04,125,@,BOS,0,240,45,91,0.495,24,41,0.585,21,50,0.42,14,17,0.824,125,45,74,0.608,32,45,0.711,13,29,0.448,29,40,0.725,132
330,MEM,2021-03-02,125,@,WAS,1,240,47,95,0.495,34,66,0.515,13,29,0.448,18,23,0.783,125,41,81,0.506,30,50,0.6,11,31,0.355,18,25,0.72,111
331,NOP,2021-02-25,125,@,MIL,0,240,51,102,0.5,38,63,0.603,13,39,0.333,10,14,0.714,125,52,96,0.542,39,65,0.6,13,31,0.419,12,16,0.75,129
332,LAC,2021-02-15,125,,MIA,1,240,47,85,0.553,32,53,0.604,15,32,0.469,16,20,0.8,125,46,91,0.505,38,55,0.691,8,36,0.222,18,22,0.818,118
333,SAC,2021-02-15,125,,BRK,0,240,51,96,0.531,39,63,0.619,12,33,0.364,11,13,0.846,125,51,89,0.573,24,42,0.571,27,47,0.574,7,12,0.583,136
334,IND,2021-02-13,125,@,ATL,1,240,45,89,0.506,33,58,0.569,12,31,0.387,23,27,0.852,125,43,90,0.478,34,59,0.576,9,31,0.29,18,23,0.783,113
335,SAS,2021-02-12,125,@,ATL,1,240,45,85,0.529,33,54,0.611,12,31,0.387,23,28,0.821,125,39,90,0.433,28,58,0.483,11,32,0.344,25,33,0.758,114
336,LAC,2021-02-12,125,@,CHI,1,240,50,86,0.581,37,56,0.661,13,30,0.433,12,15,0.8,125,40,85,0.471,28,53,0.528,12,32,0.375,14,15,0.933,106
337,PHO,2021-02-10,125,,MIL,1,240,46,87,0.529,31,56,0.554,15,31,0.484,18,25,0.72,125,43,85,0.506,27,48,0.563,16,37,0.432,22,30,0.733,124
338,MIL,2021-02-08,125,@,DEN,1,240,45,89,0.506,29,49,0.592,16,40,0.4,19,22,0.864,125,41,94,0.436,26,58,0.448,15,36,0.417,15,16,0.938,112
339,OKC,2021-01-29,125,,BRK,0,240,40,86,0.465,24,48,0.5,16,38,0.421,29,34,0.853,125,57,100,0.57,38,55,0.691,19,45,0.422,14,16,0.875,147
340,OKC,2021-01-25,125,@,POR,1,240,43,84,0.512,25,44,0.568,18,40,0.45,21,35,0.6,125,46,98,0.469,32,57,0.561,14,41,0.341,16,21,0.762,122
341,CLE,2021-01-22,125,,BRK,1,240,45,87,0.517,37,62,0.597,8,25,0.32,27,32,0.844,125,42,87,0.483,28,44,0.636,14,43,0.326,15,17,0.882,113
342,SAS,2021-01-18,125,@,POR,1,240,48,90,0.533,33,57,0.579,15,33,0.455,14,16,0.875,125,39,90,0.433,29,55,0.527,10,35,0.286,16,19,0.842,104
343,BRK,2021-01-18,125,,MIL,1,240,46,84,0.548,31,53,0.585,15,31,0.484,18,21,0.857,125,46,105,0.438,35,67,0.522,11,38,0.289,20,24,0.833,123
344,CHI,2021-01-18,125,,HOU,1,240,43,92,0.467,23,47,0.489,20,45,0.444,19,21,0.905,125,46,88,0.523,29,48,0.604,17,40,0.425,11,17,0.647,120
345,CHI,2021-01-15,125,@,OKC,0,265,43,91,0.473,22,45,0.489,21,46,0.457,18,25,0.72,125,48,105,0.457,33,60,0.55,15,45,0.333,16,24,0.667,127
346,PHI,2021-01-14,125,,MIA,1,240,44,82,0.537,27,45,0.6,17,37,0.459,20,24,0.833,125,40,81,0.494,28,47,0.596,12,34,0.353,16,26,0.615,108
347,POR,2021-01-09,125,@,SAC,1,240,44,100,0.44,27,59,0.458,17,41,0.415,20,23,0.87,125,33,81,0.407,25,51,0.49,8,30,0.267,25,35,0.714,99
348,SAS,2021-01-09,125,@,MIN,1,265,44,101,0.436,31,69,0.449,13,32,0.406,24,29,0.828,125,48,96,0.5,33,66,0.5,15,30,0.5,11,17,0.647,122
349,PHO,2021-01-09,125,@,IND,1,240,46,94,0.489,30,53,0.566,16,41,0.39,17,17,1.0,125,44,92,0.478,32,63,0.508,12,29,0.414,17,24,0.708,117
350,MIL,2021-01-04,125,,DET,1,240,49,85,0.576,35,51,0.686,14,34,0.412,13,16,0.813,125,43,98,0.439,26,58,0.448,17,40,0.425,12,12,1.0,115
351,SAC,2020-12-29,125,,DEN,1,240,46,94,0.489,30,61,0.492,16,33,0.485,17,22,0.773,125,44,81,0.543,33,53,0.623,11,28,0.393,16,20,0.8,115
352,IND,2020-12-26,125,@,CHI,1,240,52,93,0.559,43,67,0.642,9,26,0.346,12,19,0.632,125,34,91,0.374,18,52,0.346,16,39,0.41,22,25,0.88,106
353,BRK,2020-12-22,125,,GSW,1,240,42,92,0.457,27,57,0.474,15,35,0.429,26,32,0.813,125,37,99,0.374,27,66,0.409,10,33,0.303,15,23,0.652,99
354,ATL,2021-05-16,124,,HOU,1,240,49,90,0.544,42,69,0.609,7,21,0.333,19,26,0.731,124,31,92,0.337,13,29,0.448,18,63,0.286,15,20,0.75,95
355,BOS,2021-05-15,124,@,MIN,1,240,46,95,0.484,28,53,0.528,18,42,0.429,14,18,0.778,124,39,95,0.411,34,58,0.586,5,37,0.135,25,34,0.735,108
356,LAL,2021-05-12,124,,HOU,1,240,52,91,0.571,45,71,0.634,7,20,0.35,13,22,0.591,124,43,85,0.506,25,43,0.581,18,42,0.429,18,27,0.667,122
357,WAS,2021-05-10,124,@,ATL,0,240,51,100,0.51,38,74,0.514,13,26,0.5,9,11,0.818,124,46,96,0.479,36,66,0.545,10,30,0.333,23,26,0.885,125
358,DAL,2021-05-09,124,@,CLE,1,240,50,93,0.538,35,54,0.648,15,39,0.385,9,11,0.818,124,33,86,0.384,22,55,0.4,11,31,0.355,20,31,0.645,97
359,BOS,2021-05-09,124,,MIA,0,240,45,83,0.542,31,45,0.689,14,38,0.368,20,25,0.8,124,47,82,0.573,31,47,0.66,16,35,0.457,20,22,0.909,130
360,UTA,2021-05-08,124,,HOU,1,240,45,85,0.529,30,47,0.638,15,38,0.395,19,21,0.905,124,43,98,0.439,25,47,0.532,18,51,0.353,12,17,0.706,116
361,POR,2021-05-08,124,,SAS,1,240,45,97,0.464,33,63,0.524,12,34,0.353,22,30,0.733,124,37,93,0.398,29,63,0.46,8,30,0.267,20,23,0.87,102
362,MIL,2021-05-04,124,,BRK,1,240,44,98,0.449,30,61,0.492,14,37,0.378,22,27,0.815,124,41,84,0.488,21,41,0.512,20,43,0.465,16,26,0.615,118
363,MIA,2021-05-01,124,@,CLE,1,240,47,87,0.54,29,51,0.569,18,36,0.5,12,15,0.8,124,37,74,0.5,17,34,0.5,20,40,0.5,13,17,0.765,107
364,WAS,2021-05-01,124,@,DAL,0,240,47,91,0.516,41,72,0.569,6,19,0.316,24,31,0.774,124,47,87,0.54,30,49,0.612,17,38,0.447,14,22,0.636,125
365,MIL,2021-04-22,124,,PHI,1,240,45,81,0.556,25,41,0.61,20,40,0.5,14,23,0.609,124,46,91,0.505,34,64,0.531,12,27,0.444,13,18,0.722,117
366,LAC,2021-04-18,124,,MIN,1,240,45,89,0.506,24,47,0.511,21,42,0.5,13,17,0.765,124,36,88,0.409,19,43,0.442,17,45,0.378,16,21,0.762,105
367,HOU,2021-04-14,124,,IND,0,240,48,104,0.462,38,70,0.543,10,34,0.294,18,22,0.818,124,50,94,0.532,35,58,0.603,15,36,0.417,17,22,0.773,132
368,MIL,2021-04-11,124,@,ORL,1,240,46,94,0.489,27,54,0.5,19,40,0.475,13,15,0.867,124,32,86,0.372,24,50,0.48,8,36,0.222,15,19,0.789,87
369,DET,2021-04-11,124,@,LAC,0,240,46,87,0.529,31,55,0.564,15,32,0.469,17,19,0.895,124,50,80,0.625,35,53,0.66,15,27,0.556,16,21,0.762,131
370,MEM,2021-04-06,124,@,MIA,1,240,46,84,0.548,29,43,0.674,17,41,0.415,15,20,0.75,124,44,82,0.537,31,49,0.633,13,33,0.394,11,18,0.611,112
371,POR,2021-03-31,124,@,DET,1,240,42,82,0.512,26,52,0.5,16,30,0.533,24,26,0.923,124,40,86,0.465,31,59,0.525,9,27,0.333,12,17,0.706,101
372,IND,2021-03-29,124,@,WAS,0,240,44,93,0.473,32,63,0.508,12,30,0.4,24,33,0.727,124,55,99,0.556,45,80,0.563,10,19,0.526,12,18,0.667,132
373,ATL,2021-03-26,124,@,GSW,1,240,46,84,0.548,33,51,0.647,13,33,0.394,19,24,0.792,124,39,79,0.494,27,51,0.529,12,28,0.429,18,26,0.692,108
374,BRK,2021-03-17,124,@,IND,1,240,42,87,0.483,33,60,0.55,9,27,0.333,31,40,0.775,124,43,84,0.512,34,52,0.654,9,32,0.281,20,25,0.8,115
375,NOP,2021-03-16,124,@,POR,0,240,46,88,0.523,30,55,0.545,16,33,0.485,16,20,0.8,124,38,73,0.521,20,30,0.667,18,43,0.419,31,31,1.0,125
376,NOP,2021-03-03,124,,CHI,0,240,46,83,0.554,40,61,0.656,6,22,0.273,26,38,0.684,124,48,94,0.511,36,66,0.545,12,28,0.429,20,22,0.909,128
377,ORL,2021-03-01,124,,DAL,0,240,47,95,0.495,27,54,0.5,20,41,0.488,10,14,0.714,124,47,90,0.522,30,44,0.682,17,46,0.37,19,23,0.826,130
378,UTA,2021-03-01,124,@,NOP,0,240,46,101,0.455,29,58,0.5,17,43,0.395,15,18,0.833,124,52,92,0.565,45,81,0.556,7,11,0.636,18,23,0.783,129
379,BRK,2021-03-01,124,@,SAS,1,265,47,100,0.47,30,59,0.508,17,41,0.415,13,17,0.765,124,44,97,0.454,29,62,0.468,15,35,0.429,10,15,0.667,113
380,UTA,2021-02-27,124,@,ORL,1,240,45,85,0.529,28,40,0.7,17,45,0.378,17,24,0.708,124,44,96,0.458,30,62,0.484,14,34,0.412,7,8,0.875,109
381,MIA,2021-02-26,124,,UTA,1,240,44,86,0.512,30,55,0.545,14,31,0.452,22,25,0.88,124,40,94,0.426,25,48,0.521,15,46,0.326,21,23,0.913,116
382,CHO,2021-02-24,124,@,PHO,1,240,43,88,0.489,30,52,0.577,13,36,0.361,25,27,0.926,124,44,87,0.506,30,49,0.612,14,38,0.368,19,27,0.704,121
383,LAL,2021-02-22,124,,WAS,0,265,49,104,0.471,34,60,0.567,15,44,0.341,11,17,0.647,124,47,96,0.49,38,71,0.535,9,25,0.36,24,33,0.727,127
384,ORL,2021-02-19,124,,GSW,1,240,46,94,0.489,28,51,0.549,18,43,0.419,14,17,0.824,124,46,97,0.474,27,55,0.491,19,42,0.452,9,15,0.6,120
385,NOP,2021-02-17,124,,POR,0,240,43,89,0.483,28,57,0.491,15,32,0.469,23,29,0.793,124,46,90,0.511,28,49,0.571,18,41,0.439,16,18,0.889,126
386,PHO,2021-02-16,124,,BRK,0,240,48,88,0.545,32,51,0.627,16,37,0.432,12,12,1.0,124,47,82,0.573,27,42,0.643,20,40,0.5,14,15,0.933,128
387,TOR,2021-02-16,124,@,MIL,1,240,46,91,0.505,29,48,0.604,17,43,0.395,15,21,0.714,124,40,83,0.482,26,46,0.565,14,37,0.378,19,25,0.76,113
388,MEM,2021-02-14,124,@,SAC,1,240,50,94,0.532,41,73,0.562,9,21,0.429,15,19,0.789,124,41,82,0.5,33,49,0.673,8,33,0.242,20,26,0.769,110
389,MIL,2021-02-10,124,@,PHO,0,240,43,85,0.506,27,48,0.563,16,37,0.432,22,30,0.733,124,46,87,0.529,31,56,0.554,15,31,0.484,18,25,0.72,125
390,MIL,2021-02-06,124,@,CLE,1,240,47,86,0.547,31,52,0.596,16,34,0.471,14,23,0.609,124,39,86,0.453,33,58,0.569,6,28,0.214,15,21,0.714,99
391,PHI,2021-02-06,124,,BRK,1,240,48,94,0.511,38,67,0.567,10,27,0.37,18,22,0.818,124,39,88,0.443,24,47,0.511,15,41,0.366,15,17,0.882,108
392,BRK,2021-02-02,124,,LAC,1,240,45,79,0.57,32,48,0.667,13,31,0.419,21,26,0.808,124,45,99,0.455,30,63,0.476,15,36,0.417,15,17,0.882,120
393,TOR,2021-01-29,124,,SAC,0,240,42,86,0.488,29,54,0.537,13,32,0.406,27,33,0.818,124,43,78,0.551,27,42,0.643,16,36,0.444,24,31,0.774,126
394,NOP,2021-01-27,124,,WAS,1,240,46,89,0.517,29,46,0.63,17,43,0.395,15,24,0.625,124,37,92,0.402,24,54,0.444,13,38,0.342,19,21,0.905,106
395,MIA,2021-01-23,124,@,BRK,0,240,42,89,0.472,29,43,0.674,13,46,0.283,27,32,0.844,124,44,83,0.53,25,46,0.543,19,37,0.514,21,26,0.808,128
396,DAL,2021-01-20,124,@,IND,1,240,51,97,0.526,43,70,0.614,8,27,0.296,14,17,0.824,124,41,92,0.446,25,53,0.472,16,39,0.41,14,21,0.667,112
397,BOS,2021-01-15,124,,ORL,1,240,45,88,0.511,28,46,0.609,17,42,0.405,17,19,0.895,124,38,94,0.404,31,66,0.47,7,28,0.25,14,22,0.636,97
398,WAS,2021-01-09,124,,MIA,0,240,44,99,0.444,29,59,0.492,15,40,0.375,21,28,0.75,124,46,93,0.495,30,50,0.6,16,43,0.372,20,26,0.769,128
399,DAL,2021-01-07,124,@,DEN,1,265,42,87,0.483,26,47,0.553,16,40,0.4,24,31,0.774,124,43,97,0.443,28,53,0.528,15,44,0.341,16,21,0.762,117
400,CHI,2021-01-06,124,@,SAC,0,240,49,93,0.527,35,53,0.66,14,40,0.35,12,15,0.8,124,47,91,0.516,33,54,0.611,14,37,0.378,20,27,0.741,128
401,DEN,2021-01-03,124,@,MIN,1,240,45,92,0.489,26,47,0.553,19,45,0.422,15,21,0.714,124,44,85,0.518,34,54,0.63,10,31,0.323,11,16,0.688,109
402,LAC,2020-12-29,124,,MIN,1,240,47,88,0.534,31,57,0.544,16,31,0.516,14,16,0.875,124,37,89,0.416,24,51,0.471,13,38,0.342,14,17,0.824,101
403,DEN,2020-12-28,124,,HOU,1,240,46,87,0.529,32,56,0.571,14,31,0.452,18,32,0.563,124,39,86,0.453,23,47,0.489,16,39,0.41,17,23,0.739,111
404,DAL,2020-12-27,124,@,LAC,1,240,43,87,0.494,29,46,0.63,14,41,0.341,24,27,0.889,124,26,76,0.342,22,43,0.512,4,33,0.121,17,20,0.85,73
405,ATL,2020-12-23,124,@,CHI,1,240,43,80,0.538,29,45,0.644,14,35,0.4,24,29,0.828,124,36,87,0.414,28,52,0.538,8,35,0.229,24,28,0.857,104
406,SAC,2020-12-23,124,@,DEN,1,265,45,102,0.441,35,71,0.493,10,31,0.323,24,31,0.774,124,47,98,0.48,39,69,0.565,8,29,0.276,20,24,0.833,122
407,PHO,2021-05-16,123,@,SAS,1,240,53,104,0.51,40,69,0.58,13,35,0.371,4,4,1.0,123,50,98,0.51,43,74,0.581,7,24,0.292,14,19,0.737,121
408,BRK,2021-05-16,123,,CLE,1,240,47,83,0.566,31,53,0.585,16,30,0.533,13,17,0.765,123,38,85,0.447,26,46,0.565,12,39,0.308,21,31,0.677,109
409,LAL,2021-05-09,123,,PHO,1,240,39,80,0.488,26,50,0.52,13,30,0.433,32,41,0.78,123,39,73,0.534,28,48,0.583,11,25,0.44,21,25,0.84,110
410,GSW,2021-05-03,123,@,NOP,1,240,47,88,0.534,30,44,0.682,17,44,0.386,12,14,0.857,123,39,90,0.433,34,65,0.523,5,25,0.2,25,32,0.781,108
411,ATL,2021-05-03,123,,POR,1,240,44,84,0.524,24,43,0.558,20,41,0.488,15,18,0.833,123,43,95,0.453,26,54,0.481,17,41,0.415,11,14,0.786,114
412,PHO,2021-05-02,123,@,OKC,1,240,45,84,0.536,33,53,0.623,12,31,0.387,21,27,0.778,123,45,92,0.489,32,62,0.516,13,30,0.433,17,24,0.708,120
413,WAS,2021-04-14,123,@,SAC,1,240,47,90,0.522,40,66,0.606,7,24,0.292,22,27,0.815,123,42,91,0.462,33,64,0.516,9,27,0.333,18,24,0.75,111
414,DEN,2021-04-14,123,,MIA,1,240,48,89,0.539,31,53,0.585,17,36,0.472,10,13,0.769,123,39,79,0.494,26,47,0.553,13,32,0.406,15,18,0.833,106
415,PHI,2021-04-14,123,,BRK,1,240,45,87,0.517,32,59,0.542,13,28,0.464,20,25,0.8,123,43,83,0.518,39,62,0.629,4,21,0.19,27,30,0.9,117
416,ATL,2021-04-06,123,,NOP,1,240,44,88,0.5,24,57,0.421,20,31,0.645,15,22,0.682,123,37,91,0.407,25,53,0.472,12,38,0.316,21,28,0.75,107
417,MIN,2021-03-18,123,@,PHO,1,240,44,93,0.473,33,59,0.559,11,34,0.324,24,35,0.686,123,45,85,0.529,30,49,0.612,15,36,0.417,14,19,0.737,119
418,CHI,2021-03-16,123,,OKC,1,240,48,94,0.511,36,58,0.621,12,36,0.333,15,18,0.833,123,42,90,0.467,35,70,0.5,7,20,0.35,11,13,0.846,102
419,POR,2021-03-04,123,,SAC,1,240,42,88,0.477,27,50,0.54,15,38,0.395,24,25,0.96,123,49,103,0.476,38,74,0.514,11,29,0.379,10,16,0.625,119
420,UTA,2021-03-03,123,@,PHI,0,265,44,100,0.44,23,56,0.411,21,44,0.477,14,19,0.737,123,48,93,0.516,40,68,0.588,8,25,0.32,27,35,0.771,131
421,SAC,2021-03-03,123,,LAL,1,240,48,80,0.6,36,55,0.655,12,25,0.48,15,19,0.789,123,49,93,0.527,37,66,0.561,12,27,0.444,10,14,0.714,120
422,POR,2021-03-01,123,,CHO,1,240,46,86,0.535,22,40,0.55,24,46,0.522,7,10,0.7,123,43,88,0.489,28,54,0.519,15,34,0.441,10,17,0.588,111
423,ATL,2021-02-21,123,,DEN,1,240,42,81,0.519,30,47,0.638,12,34,0.353,27,33,0.818,123,43,84,0.512,27,48,0.563,16,36,0.444,13,16,0.813,115
424,NYK,2021-02-15,123,,ATL,1,240,42,83,0.506,25,49,0.51,17,34,0.5,22,27,0.815,123,36,85,0.424,25,52,0.481,11,33,0.333,29,32,0.906,112
425,PHI,2021-02-15,123,@,UTA,0,240,47,94,0.5,39,71,0.549,8,23,0.348,21,24,0.875,123,45,86,0.523,27,41,0.659,18,45,0.4,26,31,0.839,134
426,DET,2021-02-14,123,,NOP,1,240,45,84,0.536,28,49,0.571,17,35,0.486,16,20,0.8,123,40,90,0.444,31,55,0.564,9,35,0.257,23,28,0.821,112
427,ORL,2021-02-12,123,@,SAC,1,240,46,91,0.505,31,57,0.544,15,34,0.441,16,20,0.8,123,43,83,0.518,31,50,0.62,12,33,0.364,14,19,0.737,112
428,ORL,2021-02-05,123,,CHI,1,240,42,81,0.519,31,54,0.574,11,27,0.407,28,37,0.757,123,46,96,0.479,37,66,0.561,9,30,0.3,18,20,0.9,119
429,TOR,2021-02-05,123,@,BRK,1,240,49,97,0.505,36,65,0.554,13,32,0.406,12,14,0.857,123,39,80,0.488,22,38,0.579,17,42,0.405,22,29,0.759,117
430,MIL,2021-02-05,123,@,CLE,1,240,50,97,0.515,43,75,0.573,7,22,0.318,16,22,0.727,123,41,92,0.446,30,60,0.5,11,32,0.344,12,16,0.75,105
431,NOP,2021-02-03,123,,PHO,1,240,46,90,0.511,32,57,0.561,14,33,0.424,17,21,0.81,123,38,82,0.463,30,47,0.638,8,35,0.229,17,20,0.85,101
432,TOR,2021-02-02,123,@,ORL,1,240,40,83,0.482,20,38,0.526,20,45,0.444,23,25,0.92,123,41,89,0.461,27,51,0.529,14,38,0.368,12,14,0.857,108
433,POR,2021-01-30,123,@,CHI,1,240,45,88,0.511,28,46,0.609,17,42,0.405,16,19,0.842,123,43,85,0.506,22,40,0.55,21,45,0.467,15,15,1.0,122
434,GSW,2021-01-27,123,,MIN,1,240,45,85,0.529,30,51,0.588,15,34,0.441,18,23,0.783,123,37,87,0.425,23,51,0.451,14,36,0.389,23,33,0.697,111
435,CHI,2021-01-22,123,@,CHO,1,240,49,96,0.51,34,53,0.642,15,43,0.349,10,12,0.833,123,42,85,0.494,35,53,0.66,7,32,0.219,19,25,0.76,110
436,ATL,2021-01-20,123,,DET,1,265,44,100,0.44,35,77,0.455,9,23,0.391,26,38,0.684,123,44,97,0.454,34,66,0.515,10,31,0.323,17,19,0.895,115
437,MIL,2021-01-18,123,@,BRK,0,240,46,105,0.438,35,67,0.522,11,38,0.289,20,24,0.833,123,46,84,0.548,31,53,0.585,15,31,0.484,18,21,0.857,125
438,SAC,2021-01-17,123,,NOP,0,240,47,91,0.516,34,52,0.654,13,39,0.333,16,18,0.889,123,45,85,0.529,34,63,0.54,11,22,0.5,27,34,0.794,128
439,SAC,2021-01-08,123,,TOR,0,240,46,81,0.568,31,47,0.66,15,34,0.441,16,28,0.571,123,53,91,0.582,33,52,0.635,20,39,0.513,18,22,0.818,144
440,PHO,2021-01-06,123,,TOR,1,240,40,83,0.482,19,43,0.442,21,40,0.525,22,24,0.917,123,39,79,0.494,25,44,0.568,14,35,0.4,23,32,0.719,115
441,DEN,2021-01-05,123,,MIN,1,240,41,79,0.519,33,54,0.611,8,25,0.32,33,45,0.733,123,42,91,0.462,31,57,0.544,11,34,0.324,21,27,0.778,116
442,WAS,2021-01-03,123,@,BRK,1,240,43,104,0.413,31,71,0.437,12,33,0.364,25,34,0.735,123,40,81,0.494,26,49,0.531,14,32,0.438,28,31,0.903,122
443,POR,2021-01-01,123,@,GSW,1,240,40,92,0.435,20,49,0.408,20,43,0.465,23,30,0.767,123,31,79,0.392,24,44,0.545,7,35,0.2,29,33,0.879,98
444,BRK,2020-12-25,123,@,BOS,1,240,41,76,0.539,26,47,0.553,15,29,0.517,26,31,0.839,123,37,98,0.378,29,71,0.408,8,27,0.296,13,19,0.684,95
445,MIL,2021-05-15,122,,MIA,1,240,46,86,0.535,33,51,0.647,13,35,0.371,17,24,0.708,122,40,96,0.417,18,47,0.383,22,49,0.449,6,8,0.75,108
446,LAL,2021-05-15,122,@,IND,1,240,41,86,0.477,30,57,0.526,11,29,0.379,29,36,0.806,122,46,89,0.517,37,56,0.661,9,33,0.273,14,19,0.737,115
447,PHI,2021-05-14,122,,ORL,1,240,44,93,0.473,28,59,0.475,16,34,0.471,18,19,0.947,122,33,83,0.398,23,53,0.434,10,30,0.333,21,28,0.75,97
448,HOU,2021-05-14,122,,LAC,1,240,46,86,0.535,32,49,0.653,14,37,0.378,16,22,0.727,122,45,93,0.484,34,58,0.586,11,35,0.314,14,15,0.933,115
449,NOP,2021-05-14,122,@,GSW,0,240,46,99,0.465,35,72,0.486,11,27,0.407,19,28,0.679,122,42,87,0.483,25,48,0.521,17,39,0.436,24,30,0.8,125
450,HOU,2021-05-12,122,@,LAL,0,240,43,85,0.506,25,43,0.581,18,42,0.429,18,27,0.667,122,52,91,0.571,45,71,0.634,7,20,0.35,13,22,0.591,124
451,SAC,2021-05-11,122,,OKC,1,240,44,86,0.512,25,47,0.532,19,39,0.487,15,19,0.789,122,39,84,0.464,30,61,0.492,9,23,0.391,19,28,0.679,106
452,GSW,2021-05-11,122,,PHO,1,240,47,95,0.495,36,55,0.655,11,40,0.275,17,20,0.85,122,41,79,0.519,25,42,0.595,16,37,0.432,18,20,0.9,116
453,CHO,2021-05-07,122,,ORL,1,240,44,89,0.494,35,56,0.625,9,33,0.273,25,33,0.758,122,41,98,0.418,32,68,0.471,9,30,0.3,21,28,0.75,112
454,NYK,2021-05-02,122,@,HOU,1,240,45,86,0.523,27,51,0.529,18,35,0.514,14,16,0.875,122,34,79,0.43,26,44,0.591,8,35,0.229,21,32,0.656,97
455,WAS,2021-04-30,122,@,CLE,1,240,46,92,0.5,38,74,0.514,8,18,0.444,22,26,0.846,122,34,82,0.415,27,49,0.551,7,33,0.212,18,28,0.643,93
456,IND,2021-04-21,122,,OKC,1,240,46,101,0.455,32,61,0.525,14,40,0.35,16,20,0.8,122,48,104,0.462,39,75,0.52,9,29,0.31,11,16,0.688,116
457,NYK,2021-04-18,122,,NOP,1,265,45,95,0.474,34,66,0.515,11,29,0.379,21,24,0.875,122,41,101,0.406,35,74,0.473,6,27,0.222,24,30,0.8,112
458,PHO,2021-04-15,122,,SAC,1,240,48,86,0.558,34,48,0.708,14,38,0.368,12,14,0.857,122,43,78,0.551,29,48,0.604,14,30,0.467,14,19,0.737,114
459,UTA,2021-04-08,122,,POR,1,240,43,95,0.453,31,53,0.585,12,42,0.286,24,27,0.889,122,38,96,0.396,25,48,0.521,13,48,0.271,14,18,0.778,103
460,CHI,2021-04-08,122,@,TOR,1,240,47,87,0.54,35,57,0.614,12,30,0.4,16,18,0.889,122,42,97,0.433,31,63,0.492,11,34,0.324,18,22,0.818,113
461,GSW,2021-04-06,122,,MIL,1,240,46,96,0.479,31,56,0.554,15,40,0.375,15,17,0.882,122,44,86,0.512,30,54,0.556,14,32,0.438,19,22,0.864,121
462,NOP,2021-04-04,122,@,HOU,1,240,42,91,0.462,26,54,0.481,16,37,0.432,22,35,0.629,122,41,89,0.461,25,49,0.51,16,40,0.4,17,24,0.708,115
463,PHI,2021-04-03,122,,MIN,1,240,41,81,0.506,29,53,0.547,12,28,0.429,28,37,0.757,122,35,78,0.449,23,42,0.548,12,36,0.333,31,36,0.861,113
464,POR,2021-03-28,122,@,TOR,1,240,46,97,0.474,36,63,0.571,10,34,0.294,20,24,0.833,122,39,87,0.448,25,45,0.556,14,42,0.333,25,33,0.758,117
465,LAC,2021-03-27,122,,PHI,1,240,45,85,0.529,34,59,0.576,11,26,0.423,21,27,0.778,122,39,77,0.506,29,51,0.569,10,26,0.385,24,33,0.727,112
466,BOS,2021-03-26,122,@,MIL,1,240,43,88,0.489,21,41,0.512,22,47,0.468,14,16,0.875,122,44,99,0.444,25,52,0.481,19,47,0.404,7,11,0.636,114
467,MIA,2021-03-25,122,,POR,0,240,47,84,0.56,31,50,0.62,16,34,0.471,12,13,0.923,122,44,92,0.478,24,46,0.522,20,46,0.435,17,19,0.895,125
468,CHO,2021-03-24,122,@,HOU,1,240,41,80,0.513,23,42,0.548,18,38,0.474,22,29,0.759,122,33,86,0.384,17,37,0.459,16,49,0.327,15,22,0.682,97
469,UTA,2021-03-18,122,@,WAS,0,240,44,96,0.458,26,48,0.542,18,48,0.375,16,28,0.571,122,47,86,0.547,40,69,0.58,7,17,0.412,30,38,0.789,131
470,PHO,2021-03-15,122,,MEM,1,240,47,83,0.566,35,53,0.66,12,30,0.4,16,18,0.889,122,38,87,0.437,33,64,0.516,5,23,0.217,18,26,0.692,99
471,CHO,2021-03-15,122,,SAC,1,240,45,94,0.479,33,64,0.516,12,30,0.4,20,25,0.8,122,48,86,0.558,39,55,0.709,9,31,0.29,11,17,0.647,116
472,WAS,2021-03-15,122,,MIL,0,240,44,87,0.506,28,49,0.571,16,38,0.421,18,24,0.75,122,52,94,0.553,41,66,0.621,11,28,0.393,18,19,0.947,133
473,MEM,2021-03-14,122,@,OKC,0,240,47,92,0.511,40,70,0.571,7,22,0.318,21,29,0.724,122,42,73,0.575,26,42,0.619,16,31,0.516,28,34,0.824,128
474,IND,2021-03-13,122,@,PHO,1,240,46,87,0.529,33,59,0.559,13,28,0.464,17,21,0.81,122,43,91,0.473,31,60,0.517,12,31,0.387,13,17,0.765,111
475,TOR,2021-02-26,122,,HOU,1,240,40,89,0.449,24,48,0.5,16,41,0.39,26,27,0.963,122,39,91,0.429,23,44,0.523,16,47,0.34,17,20,0.85,111
476,MEM,2021-02-25,122,,LAC,1,240,50,92,0.543,39,73,0.534,11,19,0.579,11,16,0.688,122,34,84,0.405,22,50,0.44,12,34,0.353,14,16,0.875,94
477,CHI,2021-02-20,122,,SAC,1,240,49,82,0.598,38,59,0.644,11,23,0.478,13,15,0.867,122,44,98,0.449,36,69,0.522,8,29,0.276,18,22,0.818,114
478,ATL,2021-02-17,122,@,BOS,1,240,44,77,0.571,36,53,0.679,8,24,0.333,26,31,0.839,122,40,86,0.465,30,55,0.545,10,31,0.323,24,27,0.889,114
479,MEM,2021-02-17,122,,OKC,1,240,42,83,0.506,30,57,0.526,12,26,0.462,26,33,0.788,122,35,78,0.449,16,37,0.432,19,41,0.463,24,28,0.857,113
480,DEN,2021-02-14,122,,LAL,1,240,39,85,0.459,20,38,0.526,19,47,0.404,25,34,0.735,122,40,87,0.46,34,59,0.576,6,28,0.214,19,29,0.655,105
481,SAS,2021-02-14,122,@,CHO,1,240,48,96,0.5,38,62,0.613,10,34,0.294,16,19,0.842,122,45,95,0.474,33,61,0.541,12,34,0.353,8,11,0.727,110
482,DET,2021-02-09,122,,BRK,1,240,47,84,0.56,34,55,0.618,13,29,0.448,15,21,0.714,122,43,86,0.5,32,56,0.571,11,30,0.367,14,16,0.875,111
483,UTA,2021-02-09,122,,BOS,1,240,40,84,0.476,22,36,0.611,18,48,0.375,24,27,0.889,122,38,86,0.442,25,57,0.439,13,29,0.448,19,23,0.826,108
484,MIN,2021-02-08,122,@,DAL,0,240,42,91,0.462,24,49,0.49,18,42,0.429,20,28,0.714,122,45,87,0.517,33,53,0.623,12,34,0.353,25,30,0.833,127
485,MIA,2021-02-05,122,,WAS,1,240,43,86,0.5,27,50,0.54,16,36,0.444,20,23,0.87,122,33,89,0.371,25,56,0.446,8,33,0.242,21,24,0.875,95
486,DAL,2021-02-03,122,@,ATL,1,240,43,93,0.462,30,53,0.566,13,40,0.325,23,25,0.92,122,45,90,0.5,31,52,0.596,14,38,0.368,12,17,0.706,116
487,CHI,2021-01-30,122,,POR,0,240,43,85,0.506,22,40,0.55,21,45,0.467,15,15,1.0,122,45,88,0.511,28,46,0.609,17,42,0.405,16,19,0.842,123
488,CLE,2021-01-27,122,,DET,1,240,47,87,0.54,36,66,0.545,11,21,0.524,17,23,0.739,122,37,82,0.451,26,55,0.473,11,27,0.407,22,29,0.759,107
489,POR,2021-01-25,122,,OKC,0,240,46,98,0.469,32,57,0.561,14,41,0.341,16,21,0.762,122,43,84,0.512,25,44,0.568,18,40,0.45,21,35,0.6,125
490,PHI,2021-01-22,122,,BOS,1,240,45,81,0.556,33,53,0.623,12,28,0.429,20,24,0.833,122,41,90,0.456,29,60,0.483,12,30,0.4,16,20,0.8,110
491,DAL,2021-01-22,122,@,SAS,1,240,45,93,0.484,31,54,0.574,14,39,0.359,18,20,0.9,122,41,89,0.461,29,61,0.475,12,28,0.429,23,30,0.767,117
492,BRK,2021-01-16,122,,ORL,1,240,42,78,0.538,26,43,0.605,16,35,0.457,22,25,0.88,122,44,95,0.463,30,49,0.612,14,46,0.304,13,16,0.813,115
493,BRK,2021-01-12,122,,DEN,1,240,48,79,0.608,32,47,0.681,16,32,0.5,10,15,0.667,122,44,88,0.5,26,51,0.51,18,37,0.486,10,16,0.625,116
494,IND,2021-01-11,122,@,SAC,0,240,47,97,0.485,34,58,0.586,13,39,0.333,15,18,0.833,122,47,84,0.56,32,52,0.615,15,32,0.469,18,23,0.783,127
495,MIN,2021-01-09,122,,SAS,0,265,48,96,0.5,33,66,0.5,15,30,0.5,11,17,0.647,122,44,101,0.436,31,69,0.449,13,32,0.406,24,29,0.828,125
496,BRK,2021-01-07,122,,PHI,1,240,44,97,0.454,29,60,0.483,15,37,0.405,19,29,0.655,122,41,87,0.471,32,61,0.525,9,26,0.346,18,20,0.9,109
497,BRK,2021-01-03,122,,WAS,0,240,40,81,0.494,26,49,0.531,14,32,0.438,28,31,0.903,122,43,104,0.413,31,71,0.437,12,33,0.364,25,34,0.735,123
498,BOS,2021-01-03,122,@,DET,1,240,49,87,0.563,34,54,0.63,15,33,0.455,9,13,0.692,122,41,86,0.477,25,50,0.5,16,36,0.444,22,25,0.88,120
499,POR,2021-01-03,122,@,GSW,0,240,41,98,0.418,27,55,0.491,14,43,0.326,26,33,0.788,122,49,88,0.557,36,54,0.667,13,34,0.382,26,34,0.765,137
500,HOU,2020-12-31,122,,SAC,1,240,45,86,0.523,32,50,0.64,13,36,0.361,19,25,0.76,122,45,96,0.469,34,63,0.54,11,33,0.333,18,24,0.75,119
501,ATL,2020-12-26,122,@,MEM,1,240,38,89,0.427,25,53,0.472,13,36,0.361,33,38,0.868,122,37,93,0.398,24,50,0.48,13,43,0.302,25,29,0.862,112
502,DEN,2020-12-23,122,,SAC,0,265,47,98,0.48,39,69,0.565,8,29,0.276,20,24,0.833,122,45,102,0.441,35,71,0.493,10,31,0.323,24,31,0.774,124
503,BOS,2020-12-23,122,,MIL,1,240,48,101,0.475,30,61,0.492,18,40,0.45,8,11,0.727,122,46,90,0.511,32,55,0.582,14,35,0.4,15,18,0.833,121
504,DAL,2021-05-16,121,@,MIN,0,240,44,91,0.484,28,53,0.528,16,38,0.421,17,20,0.85,121,49,90,0.544,32,50,0.64,17,40,0.425,21,25,0.84,136
505,SAS,2021-05-16,121,,PHO,0,240,50,98,0.51,43,74,0.581,7,24,0.292,14,19,0.737,121,53,104,0.51,40,69,0.58,13,35,0.371,4,4,1.0,123
506,UTA,2021-05-16,121,@,SAC,1,240,41,86,0.477,23,47,0.489,18,39,0.462,21,25,0.84,121,42,90,0.467,33,60,0.55,9,30,0.3,6,10,0.6,99
507,BOS,2021-05-11,121,,MIA,0,240,46,88,0.523,28,51,0.549,18,37,0.486,11,17,0.647,121,48,81,0.593,32,51,0.627,16,30,0.533,17,22,0.773,129
508,CHI,2021-05-07,121,,BOS,1,240,43,99,0.434,25,59,0.424,18,40,0.45,17,18,0.944,121,35,86,0.407,24,47,0.511,11,39,0.282,18,23,0.783,99
509,MIA,2021-05-07,121,,MIN,1,240,44,87,0.506,31,55,0.564,13,32,0.406,20,27,0.741,121,41,85,0.482,31,48,0.646,10,37,0.27,20,30,0.667,112
510,TOR,2021-05-02,121,@,LAL,1,240,42,94,0.447,27,56,0.482,15,38,0.395,22,31,0.71,121,41,85,0.482,30,56,0.536,11,29,0.379,21,31,0.677,114
511,MIA,2021-05-02,121,@,CHO,1,240,45,88,0.511,34,50,0.68,11,38,0.289,20,27,0.741,121,40,81,0.494,26,48,0.542,14,33,0.424,17,22,0.773,111
512,PHO,2021-04-30,121,,UTA,1,240,48,88,0.545,37,55,0.673,11,33,0.333,14,19,0.737,121,35,80,0.438,21,41,0.512,14,39,0.359,16,18,0.889,100
513,DEN,2021-04-29,121,,TOR,1,240,44,93,0.473,32,58,0.552,12,35,0.343,21,26,0.808,121,40,83,0.482,24,51,0.471,16,32,0.5,15,18,0.833,111
514,PHI,2021-04-26,121,,OKC,1,240,47,86,0.547,33,55,0.6,14,31,0.452,13,18,0.722,121,35,78,0.449,28,48,0.583,7,30,0.233,13,23,0.565,90
515,CLE,2021-04-21,121,,CHI,1,240,45,88,0.511,29,52,0.558,16,36,0.444,15,19,0.789,121,39,79,0.494,26,42,0.619,13,37,0.351,14,18,0.778,105
516,SAC,2021-04-18,121,@,DAL,1,240,44,89,0.494,33,65,0.508,11,24,0.458,22,25,0.88,121,39,87,0.448,23,39,0.59,16,48,0.333,13,20,0.65,107
517,WAS,2021-04-17,121,,DET,1,240,50,94,0.532,41,78,0.526,9,16,0.563,12,19,0.632,121,37,84,0.44,28,57,0.491,9,27,0.333,17,23,0.739,100
518,BOS,2021-04-15,121,@,LAL,1,240,48,85,0.565,34,53,0.642,14,32,0.438,11,13,0.846,121,44,98,0.449,32,61,0.525,12,37,0.324,13,19,0.684,113
519,UTA,2021-04-12,121,,WAS,0,240,41,85,0.482,26,49,0.531,15,36,0.417,24,31,0.774,121,47,90,0.522,38,71,0.535,9,19,0.474,22,28,0.786,125
520,MIN,2021-04-11,121,,CHI,1,240,40,81,0.494,24,45,0.533,16,36,0.444,25,25,1.0,121,47,92,0.511,32,54,0.593,15,38,0.395,8,13,0.615,117
521,DEN,2021-04-09,121,,SAS,1,240,43,79,0.544,29,52,0.558,14,27,0.519,21,23,0.913,121,43,93,0.462,34,66,0.515,9,27,0.333,24,28,0.857,119
522,MIL,2021-04-06,121,@,GSW,0,240,44,86,0.512,30,54,0.556,14,32,0.438,19,22,0.864,121,46,96,0.479,31,56,0.554,15,40,0.375,15,17,0.882,122
523,PHO,2021-03-31,121,,CHI,1,240,46,81,0.568,35,56,0.625,11,25,0.44,18,24,0.75,121,43,99,0.434,32,66,0.485,11,33,0.333,19,21,0.905,116
524,MIL,2021-03-24,121,,BOS,1,240,45,90,0.5,28,53,0.528,17,37,0.459,14,20,0.7,121,45,94,0.479,26,47,0.553,19,47,0.404,10,10,1.0,119
525,ORL,2021-03-19,121,,BRK,1,240,43,84,0.512,22,44,0.5,21,40,0.525,14,20,0.7,121,43,91,0.473,33,54,0.611,10,37,0.27,17,23,0.739,113
526,SAC,2021-03-17,121,@,WAS,1,240,41,93,0.441,31,60,0.517,10,33,0.303,29,35,0.829,121,46,94,0.489,42,69,0.609,4,25,0.16,23,28,0.821,119
527,MIN,2021-03-16,121,@,LAL,0,240,47,90,0.522,36,55,0.655,11,35,0.314,16,22,0.727,121,50,87,0.575,37,61,0.607,13,26,0.5,24,28,0.857,137
528,DEN,2021-03-15,121,,IND,1,240,45,97,0.464,30,69,0.435,15,28,0.536,16,19,0.842,121,39,90,0.433,22,48,0.458,17,42,0.405,11,13,0.846,106
529,ATL,2021-03-13,121,,SAC,1,240,43,84,0.512,31,51,0.608,12,33,0.364,23,33,0.697,121,43,98,0.439,36,62,0.581,7,36,0.194,13,16,0.813,106
530,MIN,2021-03-13,121,,POR,0,240,44,86,0.512,34,60,0.567,10,26,0.385,23,31,0.742,121,43,89,0.483,30,49,0.612,13,40,0.325,26,30,0.867,125
531,ATL,2021-03-11,121,@,TOR,1,240,39,90,0.433,24,48,0.5,15,42,0.357,28,35,0.8,121,42,96,0.438,25,59,0.424,17,37,0.459,19,23,0.826,120
532,POR,2021-03-11,121,,PHO,0,240,43,94,0.457,25,51,0.49,18,43,0.419,17,19,0.895,121,49,83,0.59,36,59,0.61,13,24,0.542,16,19,0.842,127
533,BRK,2021-03-11,121,,BOS,1,240,42,88,0.477,23,46,0.5,19,42,0.452,18,22,0.818,121,41,91,0.451,28,51,0.549,13,40,0.325,14,22,0.636,109
534,CHO,2021-02-26,121,@,GSW,0,240,41,89,0.461,24,48,0.5,17,41,0.415,22,32,0.688,121,48,79,0.608,37,55,0.673,11,24,0.458,23,25,0.92,130
535,SAC,2021-02-25,121,@,NYK,0,240,42,85,0.494,30,50,0.6,12,35,0.343,25,33,0.758,121,51,87,0.586,32,51,0.627,19,36,0.528,19,21,0.905,140
536,PHO,2021-02-24,121,,CHO,0,240,44,87,0.506,30,49,0.612,14,38,0.368,19,27,0.704,121,43,88,0.489,30,52,0.577,13,36,0.361,25,27,0.926,124
537,BOS,2021-02-19,121,,ATL,1,240,50,90,0.556,36,55,0.655,14,35,0.4,7,10,0.7,121,38,90,0.422,28,60,0.467,10,30,0.333,23,25,0.92,109
538,POR,2021-02-14,121,@,DAL,1,240,45,85,0.529,27,45,0.6,18,40,0.45,13,19,0.684,121,40,81,0.494,26,40,0.65,14,41,0.341,24,25,0.96,118
539,NYK,2021-02-13,121,,HOU,1,240,45,86,0.523,33,58,0.569,12,28,0.429,19,23,0.826,121,33,88,0.375,25,45,0.556,8,43,0.186,25,30,0.833,99
540,TOR,2021-02-06,121,@,ATL,0,240,41,97,0.423,28,59,0.475,13,38,0.342,26,34,0.765,121,42,74,0.568,23,38,0.605,19,36,0.528,29,33,0.879,132
541,CHO,2021-02-05,121,,UTA,0,240,48,104,0.462,37,69,0.536,11,35,0.314,14,17,0.824,121,48,87,0.552,22,37,0.595,26,50,0.52,16,18,0.889,138
542,POR,2021-02-04,121,@,PHI,1,240,45,98,0.459,32,67,0.478,13,31,0.419,18,23,0.783,121,39,81,0.481,32,54,0.593,7,27,0.259,20,24,0.833,105
543,LAC,2021-02-03,121,@,CLE,1,240,44,79,0.557,24,45,0.533,20,34,0.588,13,17,0.765,121,41,92,0.446,37,82,0.451,4,10,0.4,13,17,0.765,99
544,WAS,2021-02-02,121,,POR,0,240,46,83,0.554,30,43,0.698,16,40,0.4,13,17,0.765,121,44,95,0.463,23,49,0.469,21,46,0.457,23,23,1.0,132
545,MIA,2021-02-01,121,,CHO,0,265,43,91,0.473,24,45,0.533,19,46,0.413,16,25,0.64,121,43,95,0.453,22,54,0.407,21,41,0.512,22,26,0.846,129
546,SAC,2021-01-27,121,@,ORL,1,240,45,92,0.489,31,59,0.525,14,33,0.424,17,26,0.654,121,40,96,0.417,30,70,0.429,10,26,0.385,17,18,0.944,107
547,SAS,2021-01-24,121,,WAS,1,240,48,96,0.5,33,65,0.508,15,31,0.484,10,11,0.909,121,39,92,0.424,25,50,0.5,14,42,0.333,9,14,0.643,101
548,GSW,2021-01-20,121,,SAS,1,240,46,91,0.505,31,53,0.585,15,38,0.395,14,20,0.7,121,35,94,0.372,31,61,0.508,4,33,0.121,25,31,0.806,99
549,MIL,2021-01-11,121,@,ORL,1,240,46,91,0.505,33,56,0.589,13,35,0.371,16,20,0.8,121,39,91,0.429,28,60,0.467,11,31,0.355,10,13,0.769,99
550,LAL,2020-12-30,121,@,SAS,1,240,46,82,0.561,32,56,0.571,14,26,0.538,15,20,0.75,121,40,87,0.46,30,63,0.476,10,24,0.417,17,23,0.739,107
551,LAC,2020-12-25,121,@,DEN,1,240,41,74,0.554,22,36,0.611,19,38,0.5,20,24,0.833,121,37,81,0.457,26,45,0.578,11,36,0.306,23,31,0.742,108
552,MIL,2020-12-23,121,@,BOS,0,240,46,90,0.511,32,55,0.582,14,35,0.4,15,18,0.833,121,48,101,0.475,30,61,0.492,18,40,0.45,8,11,0.727,122
553,IND,2020-12-23,121,,NYK,1,240,46,94,0.489,38,60,0.633,8,34,0.235,21,29,0.724,121,39,85,0.459,27,57,0.474,12,28,0.429,17,23,0.739,107
554,CLE,2020-12-23,121,,CHO,1,240,46,87,0.529,32,57,0.561,14,30,0.467,15,20,0.75,121,45,90,0.5,29,46,0.63,16,44,0.364,8,15,0.533,114
555,MIA,2021-05-16,120,@,DET,1,240,47,84,0.56,34,50,0.68,13,34,0.382,13,20,0.65,120,40,86,0.465,29,51,0.569,11,35,0.314,16,22,0.727,107
556,WAS,2021-05-14,120,,CLE,1,240,41,89,0.461,34,64,0.531,7,25,0.28,31,37,0.838,120,39,84,0.464,29,48,0.604,10,36,0.278,17,21,0.81,105
557,ATL,2021-05-12,120,,WAS,1,240,44,86,0.512,34,53,0.642,10,33,0.303,22,28,0.786,120,45,101,0.446,35,72,0.486,10,29,0.345,16,19,0.842,116
558,DEN,2021-05-07,120,@,UTA,0,240,43,83,0.518,26,45,0.578,17,38,0.447,17,20,0.85,120,43,89,0.483,22,43,0.512,21,46,0.457,20,23,0.87,127
559,CHI,2021-05-06,120,@,CHO,1,240,46,91,0.505,28,54,0.519,18,37,0.486,10,17,0.588,120,38,90,0.422,22,55,0.4,16,35,0.457,7,18,0.389,99
560,OKC,2021-05-02,120,,PHO,0,240,45,92,0.489,32,62,0.516,13,30,0.433,17,24,0.708,120,45,84,0.536,33,53,0.623,12,31,0.387,21,27,0.778,123
561,BOS,2021-04-28,120,,CHO,1,240,44,92,0.478,29,52,0.558,15,40,0.375,17,22,0.773,120,37,87,0.425,24,52,0.462,13,35,0.371,24,32,0.75,111
562,DEN,2021-04-26,120,,MEM,1,240,45,94,0.479,34,61,0.557,11,33,0.333,19,22,0.864,120,34,81,0.42,30,49,0.612,4,32,0.125,24,31,0.774,96
563,NOP,2021-04-26,120,,LAC,1,240,44,82,0.537,29,53,0.547,15,29,0.517,17,26,0.654,120,36,90,0.4,22,45,0.489,14,45,0.311,17,17,1.0,103
564,MEM,2021-04-25,120,@,POR,1,240,42,91,0.462,30,68,0.441,12,23,0.522,24,28,0.857,120,39,105,0.371,25,67,0.373,14,38,0.368,21,25,0.84,113
565,NYK,2021-04-24,120,,TOR,1,240,42,75,0.56,26,44,0.591,16,31,0.516,20,24,0.833,120,36,83,0.434,19,39,0.487,17,44,0.386,14,19,0.737,103
566,SAC,2021-04-20,120,,MIN,0,240,44,97,0.454,26,55,0.473,18,42,0.429,14,16,0.875,120,51,90,0.567,33,47,0.702,18,43,0.419,14,19,0.737,134
567,MIL,2021-04-15,120,@,ATL,1,240,46,95,0.484,30,52,0.577,16,43,0.372,12,17,0.706,120,39,86,0.453,25,52,0.481,14,34,0.412,17,19,0.895,109
568,HOU,2021-04-12,120,@,PHO,0,240,44,87,0.506,27,45,0.6,17,42,0.405,15,19,0.789,120,45,94,0.479,20,49,0.408,25,45,0.556,11,18,0.611,126
569,SAS,2021-04-12,120,@,ORL,1,240,48,93,0.516,38,68,0.559,10,25,0.4,14,18,0.778,120,36,80,0.45,31,60,0.517,5,20,0.25,20,32,0.625,97
570,ATL,2021-04-09,120,,CHI,1,240,47,84,0.56,40,57,0.702,7,27,0.259,19,23,0.826,120,41,86,0.477,28,53,0.528,13,33,0.394,13,14,0.929,108
571,MEM,2021-04-02,120,,MIN,1,240,42,95,0.442,23,56,0.411,19,39,0.487,17,25,0.68,120,38,85,0.447,26,52,0.5,12,33,0.364,20,23,0.87,108
572,DET,2021-04-01,120,,WAS,1,240,45,94,0.479,33,65,0.508,12,29,0.414,18,22,0.818,120,40,85,0.471,35,66,0.53,5,19,0.263,6,19,0.316,91
573,SAS,2021-03-31,120,,SAC,1,240,43,92,0.467,33,66,0.5,10,26,0.385,24,34,0.706,120,39,92,0.424,28,57,0.491,11,35,0.314,17,19,0.895,106
574,BRK,2021-03-31,120,,HOU,1,240,44,90,0.489,31,54,0.574,13,36,0.361,19,19,1.0,120,39,78,0.5,26,38,0.684,13,40,0.325,17,24,0.708,108
575,MEM,2021-03-29,120,@,HOU,1,240,46,85,0.541,35,54,0.648,11,31,0.355,17,24,0.708,120,40,94,0.426,29,52,0.558,11,42,0.262,19,22,0.864,110
576,SAS,2021-03-27,120,,CHI,1,240,46,85,0.541,36,60,0.6,10,25,0.4,18,28,0.643,120,41,95,0.432,33,61,0.541,8,34,0.235,14,18,0.778,104
577,UTA,2021-03-22,120,@,CHI,1,240,45,92,0.489,28,53,0.528,17,39,0.436,13,15,0.867,120,39,96,0.406,33,70,0.471,6,26,0.231,11,12,0.917,95
578,MIL,2021-03-20,120,,SAS,1,240,45,92,0.489,31,54,0.574,14,38,0.368,16,18,0.889,120,46,96,0.479,34,63,0.54,12,33,0.364,9,10,0.9,113
579,TOR,2021-03-11,120,,ATL,0,240,42,96,0.438,25,59,0.424,17,37,0.459,19,23,0.826,120,39,90,0.433,24,48,0.5,15,42,0.357,28,35,0.8,121
580,PHO,2021-03-04,120,,GSW,1,240,49,96,0.51,37,66,0.561,12,30,0.4,10,13,0.769,120,38,88,0.432,26,53,0.491,12,35,0.343,10,16,0.625,98
581,LAL,2021-03-03,120,@,SAC,0,240,49,93,0.527,37,66,0.561,12,27,0.444,10,14,0.714,120,48,80,0.6,36,55,0.655,12,25,0.48,15,19,0.789,123
582,CHI,2021-02-22,120,@,HOU,1,240,49,91,0.538,34,55,0.618,15,36,0.417,7,10,0.7,120,37,96,0.385,24,56,0.429,13,40,0.325,13,19,0.684,100
583,NOP,2021-02-21,120,,BOS,1,265,42,94,0.447,31,58,0.534,11,36,0.306,25,37,0.676,120,39,98,0.398,29,61,0.475,10,37,0.27,27,34,0.794,115
584,DEN,2021-02-19,120,@,CLE,1,240,46,80,0.575,31,49,0.633,15,31,0.484,13,17,0.765,120,39,83,0.47,27,52,0.519,12,31,0.387,13,21,0.619,103
585,GSW,2021-02-19,120,@,ORL,0,240,46,97,0.474,27,55,0.491,19,42,0.452,9,15,0.6,120,46,94,0.489,28,51,0.549,18,43,0.419,14,17,0.824,124
586,GSW,2021-02-17,120,,MIA,1,265,43,95,0.453,25,43,0.581,18,52,0.346,16,21,0.762,120,44,97,0.454,31,61,0.508,13,36,0.361,11,12,0.917,112
587,CHI,2021-02-15,120,@,IND,1,265,44,102,0.431,31,69,0.449,13,33,0.394,19,22,0.864,120,39,92,0.424,30,59,0.508,9,33,0.273,25,31,0.806,112
588,PHO,2021-02-13,120,,PHI,1,240,48,79,0.608,38,54,0.704,10,25,0.4,14,17,0.824,120,38,73,0.521,31,56,0.554,7,17,0.412,28,33,0.848,111
589,CHO,2021-02-12,120,,MIN,1,240,44,90,0.489,31,54,0.574,13,36,0.361,19,19,1.0,120,45,99,0.455,29,58,0.5,16,41,0.39,8,14,0.571,114
590,BOS,2021-02-11,120,,TOR,1,240,39,86,0.453,19,47,0.404,20,39,0.513,22,28,0.786,120,41,83,0.494,32,55,0.582,9,28,0.321,15,19,0.789,106
591,OKC,2021-02-06,120,,MIN,1,240,46,90,0.511,34,57,0.596,12,33,0.364,16,20,0.8,120,47,93,0.505,35,57,0.614,12,36,0.333,12,22,0.545,118
592,LAC,2021-02-02,120,@,BRK,0,240,45,99,0.455,30,63,0.476,15,36,0.417,15,17,0.882,120,45,79,0.57,32,48,0.667,13,31,0.419,21,26,0.808,124
593,UTA,2021-01-29,120,,DAL,1,240,38,87,0.437,18,39,0.462,20,48,0.417,24,26,0.923,120,37,86,0.43,28,53,0.528,9,33,0.273,18,27,0.667,101
594,MIN,2021-01-23,120,,NOP,1,240,39,91,0.429,27,57,0.474,12,34,0.353,30,37,0.811,120,40,87,0.46,30,54,0.556,10,33,0.303,20,28,0.714,110
595,DEN,2021-01-23,120,@,PHO,1,290,40,97,0.412,25,61,0.41,15,36,0.417,25,32,0.781,120,41,102,0.402,25,49,0.51,16,53,0.302,14,18,0.778,112
596,IND,2021-01-22,120,,ORL,1,265,46,93,0.495,34,59,0.576,12,34,0.353,16,18,0.889,120,43,94,0.457,26,57,0.456,17,37,0.459,15,24,0.625,118
597,LAC,2021-01-22,120,,OKC,1,240,43,84,0.512,33,51,0.647,10,33,0.303,24,25,0.96,120,41,87,0.471,27,45,0.6,14,42,0.333,10,13,0.769,106
598,HOU,2021-01-18,120,@,CHI,0,240,46,88,0.523,29,48,0.604,17,40,0.425,11,17,0.647,120,43,92,0.467,23,47,0.489,20,45,0.444,19,21,0.905,125
599,DET,2021-01-16,120,@,MIA,1,240,46,91,0.505,28,45,0.622,18,46,0.391,10,15,0.667,120,32,67,0.478,20,38,0.526,12,29,0.414,24,27,0.889,100
600,LAL,2021-01-10,120,@,HOU,1,240,46,91,0.505,36,62,0.581,10,29,0.345,18,24,0.75,120,37,90,0.411,25,49,0.51,12,41,0.293,16,23,0.696,102
601,DET,2021-01-03,120,,BOS,0,240,41,86,0.477,25,50,0.5,16,36,0.444,22,25,0.88,120,49,87,0.563,34,54,0.63,15,33,0.455,9,13,0.692,122
602,NOP,2021-01-02,120,,TOR,1,240,35,83,0.422,21,45,0.467,14,38,0.368,36,47,0.766,120,38,91,0.418,24,43,0.558,14,48,0.292,26,27,0.963,116
603,DET,2020-12-28,120,@,ATL,0,240,43,98,0.439,30,57,0.526,13,41,0.317,21,24,0.875,120,40,82,0.488,20,40,0.5,20,42,0.476,28,32,0.875,128
604,ORL,2020-12-27,120,@,WAS,1,240,37,85,0.435,28,60,0.467,9,25,0.36,37,38,0.974,120,47,97,0.485,39,65,0.6,8,32,0.25,11,13,0.846,113
605,WAS,2020-12-26,120,,ORL,0,240,46,95,0.484,33,58,0.569,13,37,0.351,15,28,0.536,120,48,95,0.505,37,64,0.578,11,31,0.355,23,29,0.793,130
606,UTA,2020-12-23,120,@,POR,1,240,43,94,0.457,24,44,0.545,19,50,0.38,15,19,0.789,120,37,92,0.402,25,59,0.424,12,33,0.364,14,17,0.824,100
607,MIN,2021-05-11,119,@,DET,1,240,45,98,0.459,31,50,0.62,14,48,0.292,15,21,0.714,119,35,75,0.467,25,52,0.481,10,23,0.435,20,26,0.769,100
608,GSW,2021-05-10,119,,UTA,1,240,41,88,0.466,27,46,0.587,14,42,0.333,23,25,0.92,119,41,91,0.451,28,47,0.596,13,44,0.295,21,24,0.875,116
609,DEN,2021-05-08,119,,BRK,0,240,42,92,0.457,28,51,0.549,14,41,0.341,21,23,0.913,119,41,66,0.621,25,35,0.714,16,31,0.516,27,33,0.818,125
610,ORL,2021-05-03,119,@,DET,1,240,45,88,0.511,35,65,0.538,10,23,0.435,19,25,0.76,119,44,93,0.473,33,58,0.569,11,35,0.314,13,18,0.722,112
611,BOS,2021-05-02,119,,POR,0,240,43,89,0.483,23,50,0.46,20,39,0.513,13,15,0.867,119,44,85,0.518,25,47,0.532,19,38,0.5,22,26,0.846,129
612,OKC,2021-04-27,119,@,BOS,1,240,39,81,0.481,26,51,0.51,13,30,0.433,28,36,0.778,119,41,97,0.423,30,48,0.625,11,49,0.224,22,25,0.88,115
613,WAS,2021-04-25,119,,CLE,1,240,43,89,0.483,31,58,0.534,12,31,0.387,21,26,0.808,119,40,78,0.513,30,51,0.588,10,27,0.37,20,25,0.8,110
614,PHO,2021-04-25,119,@,BRK,0,240,43,90,0.478,31,56,0.554,12,34,0.353,21,25,0.84,119,46,87,0.529,33,59,0.559,13,28,0.464,23,27,0.852,128
615,WAS,2021-04-19,119,,OKC,1,240,46,91,0.505,36,60,0.6,10,31,0.323,17,29,0.586,119,36,83,0.434,23,50,0.46,13,33,0.394,22,27,0.815,107
616,BOS,2021-04-17,119,,GSW,1,240,44,94,0.468,29,48,0.604,15,46,0.326,16,20,0.8,119,41,80,0.513,24,40,0.6,17,40,0.425,15,20,0.75,114
617,MIN,2021-04-16,119,,MIA,1,240,42,81,0.519,27,45,0.6,15,36,0.417,20,29,0.69,119,39,80,0.488,25,46,0.543,14,34,0.412,19,26,0.731,111
618,UTA,2021-04-16,119,,IND,1,240,42,87,0.483,26,45,0.578,16,42,0.381,19,24,0.792,119,41,105,0.39,28,66,0.424,13,39,0.333,16,17,0.941,111
619,GSW,2021-04-15,119,@,CLE,1,240,47,92,0.511,30,46,0.652,17,46,0.37,8,10,0.8,119,35,81,0.432,25,50,0.5,10,31,0.323,21,27,0.778,101
620,SAS,2021-04-11,119,@,DAL,1,240,45,83,0.542,37,62,0.597,8,21,0.381,21,27,0.778,119,45,94,0.479,32,52,0.615,13,42,0.31,14,15,0.933,117
621,SAS,2021-04-09,119,@,DEN,0,240,43,93,0.462,34,66,0.515,9,27,0.333,24,28,0.857,119,43,79,0.544,29,52,0.558,14,27,0.519,21,23,0.913,121
622,MIL,2021-04-09,119,,CHO,0,240,44,98,0.449,30,60,0.5,14,38,0.368,17,23,0.739,119,44,91,0.484,25,41,0.61,19,50,0.38,20,22,0.909,127
623,DET,2021-04-06,119,@,DEN,0,240,44,81,0.543,29,46,0.63,15,35,0.429,16,20,0.8,119,56,94,0.596,42,63,0.667,14,31,0.452,8,9,0.889,134
624,DEN,2021-04-04,119,,ORL,1,240,43,88,0.489,34,59,0.576,9,29,0.31,24,31,0.774,119,42,89,0.472,29,54,0.537,13,35,0.371,12,17,0.706,109
625,GSW,2021-03-25,119,@,SAC,0,240,45,88,0.511,28,56,0.5,17,32,0.531,12,12,1.0,119,53,89,0.596,34,51,0.667,19,38,0.5,16,19,0.842,141
626,BOS,2021-03-24,119,@,MIL,0,240,45,94,0.479,26,47,0.553,19,47,0.404,10,10,1.0,119,45,90,0.5,28,53,0.528,17,37,0.459,14,20,0.7,121
627,SAC,2021-03-22,119,@,CLE,1,240,49,90,0.544,36,60,0.6,13,30,0.433,8,12,0.667,119,41,96,0.427,37,79,0.468,4,17,0.235,19,23,0.826,105
628,LAC,2021-03-22,119,,ATL,1,240,42,85,0.494,25,47,0.532,17,38,0.447,18,20,0.9,119,43,95,0.453,31,61,0.508,12,34,0.353,12,16,0.75,110
629,DAL,2021-03-19,119,@,POR,0,240,44,81,0.543,25,39,0.641,19,42,0.452,12,13,0.923,119,44,93,0.473,22,46,0.478,22,47,0.468,15,17,0.882,125
630,PHO,2021-03-18,119,,MIN,0,240,45,85,0.529,30,49,0.612,15,36,0.417,14,19,0.737,119,44,93,0.473,33,59,0.559,11,34,0.324,24,35,0.686,123
631,WAS,2021-03-17,119,,SAC,0,240,46,94,0.489,42,69,0.609,4,25,0.16,23,28,0.821,119,41,93,0.441,31,60,0.517,10,33,0.303,29,35,0.829,121
632,ATL,2021-03-16,119,@,HOU,1,240,44,86,0.512,27,49,0.551,17,37,0.459,14,16,0.875,119,42,88,0.477,29,54,0.537,13,34,0.382,10,13,0.769,107
633,UTA,2021-03-14,119,@,GSW,0,240,41,93,0.441,26,49,0.531,15,44,0.341,22,29,0.759,119,50,89,0.562,34,58,0.586,16,31,0.516,15,18,0.833,131
634,NYK,2021-03-13,119,@,OKC,1,240,44,90,0.489,30,55,0.545,14,35,0.4,17,22,0.773,119,37,76,0.487,29,44,0.659,8,32,0.25,15,21,0.714,97
635,WAS,2021-03-13,119,,MIL,0,240,43,94,0.457,27,53,0.509,16,41,0.39,17,22,0.773,119,43,99,0.434,26,54,0.481,17,45,0.378,22,25,0.88,125
636,WAS,2021-03-04,119,,LAC,1,240,40,88,0.455,31,65,0.477,9,23,0.391,30,42,0.714,119,38,82,0.463,22,47,0.468,16,35,0.457,25,27,0.926,117
637,SAC,2021-03-04,119,@,POR,0,240,49,103,0.476,38,74,0.514,11,29,0.379,10,16,0.625,119,42,88,0.477,27,50,0.54,15,38,0.395,24,25,0.96,123
638,SAS,2021-03-02,119,,NYK,1,240,43,89,0.483,25,47,0.532,18,42,0.429,15,21,0.714,119,33,81,0.407,18,45,0.4,15,36,0.417,12,15,0.8,93
639,LAC,2021-02-26,119,@,MEM,1,240,44,80,0.55,30,45,0.667,14,35,0.4,17,18,0.944,119,39,97,0.402,30,69,0.435,9,28,0.321,12,16,0.75,99
640,HOU,2021-02-15,119,@,WAS,0,240,43,91,0.473,35,54,0.648,8,37,0.216,25,34,0.735,119,48,92,0.522,36,62,0.581,12,30,0.4,23,31,0.742,131
641,LAC,2021-02-10,119,@,MIN,1,240,41,82,0.5,29,59,0.492,12,23,0.522,25,29,0.862,119,41,95,0.432,26,54,0.481,15,41,0.366,15,19,0.789,112
642,PHI,2021-02-09,119,@,SAC,1,240,41,85,0.482,32,65,0.492,9,20,0.45,28,35,0.8,119,43,99,0.434,29,57,0.509,14,42,0.333,11,19,0.579,111
643,PHO,2021-02-08,119,,CLE,1,240,47,90,0.522,36,66,0.545,11,24,0.458,14,19,0.737,119,44,86,0.512,36,62,0.581,8,24,0.333,17,25,0.68,113
644,CHO,2021-02-08,119,,HOU,1,240,44,90,0.489,25,49,0.51,19,41,0.463,12,13,0.923,119,35,86,0.407,22,39,0.564,13,47,0.277,11,16,0.688,94
645,LAL,2021-02-08,119,,OKC,1,265,44,95,0.463,35,57,0.614,9,38,0.237,22,29,0.759,119,43,110,0.391,31,72,0.431,12,38,0.316,14,19,0.737,112
646,CHO,2021-02-07,119,,WAS,1,240,42,99,0.424,27,63,0.429,15,36,0.417,20,26,0.769,119,34,90,0.378,25,50,0.5,9,40,0.225,20,28,0.714,97
647,SAC,2021-02-06,119,,DEN,1,240,44,91,0.484,30,56,0.536,14,35,0.4,17,24,0.708,119,45,97,0.464,32,62,0.516,13,35,0.371,11,14,0.786,114
648,BOS,2021-02-05,119,@,LAC,1,240,43,90,0.478,27,52,0.519,16,38,0.421,17,21,0.81,119,42,81,0.519,28,49,0.571,14,32,0.438,17,21,0.81,115
649,CHI,2021-02-05,119,@,ORL,0,240,46,96,0.479,37,66,0.561,9,30,0.3,18,20,0.9,119,42,81,0.519,31,54,0.574,11,27,0.407,28,37,0.757,123
650,PHI,2021-01-31,119,@,IND,1,240,45,92,0.489,37,66,0.561,8,26,0.308,21,31,0.677,119,41,84,0.488,31,56,0.554,10,28,0.357,18,22,0.818,110
651,SAS,2021-01-29,119,,DEN,1,240,44,81,0.543,34,58,0.586,10,23,0.435,21,26,0.808,119,41,78,0.526,27,47,0.574,14,31,0.452,13,20,0.65,109
652,BOS,2021-01-25,119,@,CHI,1,240,44,87,0.506,29,58,0.5,15,29,0.517,16,20,0.8,119,41,88,0.466,24,49,0.49,17,39,0.436,4,10,0.4,103
653,DET,2021-01-25,119,,PHI,1,240,35,70,0.5,18,32,0.563,17,38,0.447,32,38,0.842,119,40,94,0.426,31,66,0.47,9,28,0.321,15,20,0.75,104
654,NYK,2021-01-21,119,@,GSW,1,240,38,82,0.463,27,58,0.466,11,24,0.458,32,41,0.78,119,33,86,0.384,24,48,0.5,9,38,0.237,29,39,0.744,104
655,DEN,2021-01-19,119,,OKC,1,240,46,105,0.438,32,63,0.508,14,42,0.333,13,14,0.929,119,36,86,0.419,22,43,0.512,14,43,0.326,15,23,0.652,101
656,IND,2020-12-31,119,,CLE,1,240,42,87,0.483,26,52,0.5,16,35,0.457,19,24,0.792,119,37,82,0.451,25,59,0.424,12,23,0.522,13,24,0.542,99
657,SAC,2020-12-31,119,@,HOU,0,240,45,96,0.469,34,63,0.54,11,33,0.333,18,24,0.75,119,45,86,0.523,32,50,0.64,13,36,0.361,19,25,0.76,122
658,MIA,2020-12-30,119,,MIL,1,240,40,82,0.488,25,43,0.581,15,39,0.385,24,29,0.828,119,40,102,0.392,24,61,0.393,16,41,0.39,12,13,0.923,108
659,SAS,2020-12-26,119,,TOR,1,240,47,100,0.47,33,66,0.5,14,34,0.412,11,16,0.688,119,44,96,0.458,29,55,0.527,15,41,0.366,11,15,0.733,114
660,DET,2020-12-26,119,,CLE,0,290,40,98,0.408,24,53,0.453,16,45,0.356,23,32,0.719,119,48,99,0.485,35,69,0.507,13,30,0.433,19,30,0.633,128
661,MEM,2020-12-23,119,,SAS,0,240,49,95,0.516,39,68,0.574,10,27,0.37,11,18,0.611,119,48,95,0.505,38,70,0.543,10,25,0.4,25,29,0.862,131
662,CHI,2021-05-16,118,,MIL,1,240,45,87,0.517,31,55,0.564,14,32,0.438,14,19,0.737,118,38,90,0.422,26,53,0.491,12,37,0.324,24,32,0.75,112
663,NYK,2021-05-15,118,,CHO,1,265,45,88,0.511,29,51,0.569,16,37,0.432,12,15,0.8,118,39,102,0.382,26,53,0.491,13,49,0.265,18,24,0.75,109
664,PHO,2021-05-13,118,,POR,1,240,41,88,0.466,28,56,0.5,13,32,0.406,23,26,0.885,118,44,81,0.543,29,48,0.604,15,33,0.455,14,18,0.778,117
665,PHI,2021-05-08,118,,DET,1,240,41,84,0.488,32,54,0.593,9,30,0.3,27,31,0.871,118,41,84,0.488,30,50,0.6,11,34,0.324,11,16,0.688,104
666,GSW,2021-05-06,118,,OKC,1,240,42,86,0.488,23,39,0.59,19,47,0.404,15,18,0.833,118,36,88,0.409,27,49,0.551,9,39,0.231,16,20,0.8,97
667,LAC,2021-05-06,118,,LAL,1,240,41,77,0.532,28,46,0.609,13,31,0.419,23,26,0.885,118,33,87,0.379,23,51,0.451,10,36,0.278,18,29,0.621,94
668,CLE,2021-05-04,118,,PHO,0,265,41,90,0.456,28,61,0.459,13,29,0.448,23,27,0.852,118,55,105,0.524,43,74,0.581,12,31,0.387,12,13,0.923,134
669,BRK,2021-05-04,118,@,MIL,0,240,41,84,0.488,21,41,0.512,20,43,0.465,16,26,0.615,118,44,98,0.449,30,61,0.492,14,37,0.378,22,27,0.815,124
670,NYK,2021-05-03,118,@,MEM,1,240,45,89,0.506,31,62,0.5,14,27,0.519,14,18,0.778,118,34,86,0.395,18,45,0.4,16,41,0.39,20,24,0.833,104
671,PHO,2021-04-26,118,@,NYK,1,240,45,83,0.542,31,49,0.633,14,34,0.412,14,17,0.824,118,45,87,0.517,33,58,0.569,12,29,0.414,8,10,0.8,110
672,ATL,2021-04-23,118,,MIA,1,240,43,80,0.538,28,45,0.622,15,35,0.429,17,19,0.895,118,38,79,0.481,25,42,0.595,13,37,0.351,14,16,0.875,103
673,GSW,2021-04-23,118,,DEN,1,240,45,84,0.536,30,45,0.667,15,39,0.385,13,18,0.722,118,34,88,0.386,21,42,0.5,13,46,0.283,16,20,0.8,97
674,WAS,2021-04-21,118,,GSW,1,240,38,91,0.418,28,63,0.444,10,28,0.357,32,38,0.842,118,40,101,0.396,25,56,0.446,15,45,0.333,19,21,0.905,114
675,POR,2021-04-10,118,,DET,1,240,43,90,0.478,30,61,0.492,13,29,0.448,19,24,0.792,118,37,83,0.446,28,57,0.491,9,26,0.346,20,28,0.714,103
676,BOS,2021-04-02,118,,HOU,1,240,46,88,0.523,29,47,0.617,17,41,0.415,9,12,0.75,118,37,86,0.43,25,50,0.5,12,36,0.333,16,26,0.615,102
677,DET,2021-03-29,118,,TOR,1,240,38,75,0.507,23,45,0.511,15,30,0.5,27,34,0.794,118,35,86,0.407,24,50,0.48,11,36,0.306,23,28,0.821,104
678,UTA,2021-03-24,118,,BRK,1,240,41,91,0.451,18,36,0.5,23,55,0.418,13,14,0.929,118,35,97,0.361,28,62,0.452,7,35,0.2,11,15,0.733,88
679,CHI,2021-03-14,118,,TOR,1,240,44,97,0.454,32,53,0.604,12,44,0.273,18,23,0.783,118,34,90,0.378,22,45,0.489,12,45,0.267,15,21,0.714,95
680,DEN,2021-03-01,118,@,CHI,1,240,46,87,0.529,36,60,0.6,10,27,0.37,16,20,0.8,118,42,94,0.447,30,56,0.536,12,38,0.316,16,22,0.727,112
681,PHO,2021-02-28,118,@,MIN,1,240,44,89,0.494,37,62,0.597,7,27,0.259,23,24,0.958,118,35,93,0.376,27,58,0.466,8,35,0.229,21,24,0.875,99
682,OKC,2021-02-26,118,,ATL,1,240,46,88,0.523,30,46,0.652,16,42,0.381,10,16,0.625,118,43,97,0.443,31,57,0.544,12,40,0.3,11,17,0.647,109
683,BOS,2021-02-26,118,,IND,1,240,42,82,0.512,33,60,0.55,9,22,0.409,25,29,0.862,118,35,89,0.393,20,43,0.465,15,46,0.326,27,29,0.931,112
684,DET,2021-02-24,118,@,NOP,0,240,47,89,0.528,34,53,0.642,13,36,0.361,11,16,0.688,118,50,90,0.556,40,67,0.597,10,23,0.435,18,29,0.621,128
685,SAC,2021-02-23,118,@,BRK,0,240,45,87,0.517,30,56,0.536,15,31,0.484,13,19,0.684,118,44,89,0.494,27,49,0.551,17,40,0.425,22,31,0.71,127
686,WAS,2021-02-20,118,@,POR,1,240,45,89,0.506,39,63,0.619,6,26,0.231,22,29,0.759,118,37,103,0.359,18,48,0.375,19,55,0.345,18,25,0.72,111
687,MIA,2021-02-18,118,@,SAC,1,240,49,95,0.516,37,61,0.607,12,34,0.353,8,10,0.8,118,43,93,0.462,28,52,0.538,15,41,0.366,9,16,0.563,110
688,PHI,2021-02-17,118,,HOU,1,240,39,81,0.481,27,55,0.491,12,26,0.462,28,32,0.875,118,42,92,0.457,27,45,0.6,15,47,0.319,14,18,0.778,113
689,MIA,2021-02-15,118,@,LAC,0,240,46,91,0.505,38,55,0.691,8,36,0.222,18,22,0.818,118,47,85,0.553,32,53,0.604,15,32,0.469,16,20,0.8,125
690,DAL,2021-02-14,118,,POR,0,240,40,81,0.494,26,40,0.65,14,41,0.341,24,25,0.96,118,45,85,0.529,27,45,0.6,18,40,0.45,13,19,0.684,121
691,POR,2021-02-11,118,,PHI,1,240,40,93,0.43,23,55,0.418,17,38,0.447,21,23,0.913,118,42,86,0.488,36,59,0.61,6,27,0.222,24,29,0.828,114
692,DAL,2021-02-10,118,,ATL,1,240,43,84,0.512,29,49,0.592,14,35,0.4,18,20,0.9,118,40,88,0.455,26,49,0.531,14,39,0.359,23,28,0.821,117
693,MIN,2021-02-06,118,@,OKC,0,240,47,93,0.505,35,57,0.614,12,36,0.333,12,22,0.545,118,46,90,0.511,34,57,0.596,12,33,0.364,16,20,0.8,120
694,CHI,2021-02-06,118,@,ORL,1,240,47,91,0.516,32,61,0.525,15,30,0.5,9,13,0.692,118,37,95,0.389,31,68,0.456,6,27,0.222,12,12,1.0,92
695,NOP,2021-02-06,118,,MEM,1,240,45,87,0.517,30,54,0.556,15,33,0.455,13,21,0.619,118,40,90,0.444,27,51,0.529,13,39,0.333,16,19,0.842,109
696,PHI,2021-02-03,118,@,CHO,1,240,41,79,0.519,31,55,0.564,10,24,0.417,26,32,0.813,118,39,87,0.448,25,50,0.5,14,37,0.378,19,23,0.826,111
697,SAC,2021-02-01,118,@,NOP,1,240,42,88,0.477,28,45,0.622,14,43,0.326,20,26,0.769,118,40,101,0.396,31,71,0.437,9,30,0.3,20,24,0.833,109
698,GSW,2021-01-30,118,,DET,1,240,47,89,0.528,30,53,0.566,17,36,0.472,7,10,0.7,118,29,77,0.377,20,41,0.488,9,36,0.25,24,32,0.75,91
699,PHI,2021-01-29,118,@,MIN,1,240,39,87,0.448,31,71,0.437,8,16,0.5,32,38,0.842,118,35,82,0.427,25,49,0.51,10,33,0.303,14,18,0.778,94
700,ORL,2021-01-22,118,@,IND,0,265,43,94,0.457,26,57,0.456,17,37,0.459,15,24,0.625,118,46,93,0.495,34,59,0.576,12,34,0.353,16,18,0.889,120
701,NOP,2021-01-21,118,@,UTA,0,240,42,85,0.494,31,60,0.517,11,25,0.44,23,30,0.767,118,44,88,0.5,27,49,0.551,17,39,0.436,24,25,0.96,129
702,UTA,2021-01-19,118,,NOP,1,240,43,85,0.506,22,38,0.579,21,47,0.447,11,17,0.647,118,43,95,0.453,37,69,0.536,6,26,0.231,10,15,0.667,102
703,MEM,2021-01-13,118,@,MIN,1,240,50,106,0.472,42,81,0.519,8,25,0.32,10,13,0.769,118,39,90,0.433,30,53,0.566,9,37,0.243,20,24,0.833,107
704,CHO,2021-01-08,118,@,NOP,1,240,41,87,0.471,25,45,0.556,16,42,0.381,20,25,0.8,118,38,77,0.494,23,39,0.59,15,38,0.395,19,26,0.731,110
705,MIL,2021-01-08,118,,UTA,0,240,44,98,0.449,31,56,0.554,13,42,0.31,17,21,0.81,118,49,97,0.505,24,44,0.545,25,53,0.472,8,13,0.615,131
706,SAS,2021-01-07,118,@,LAL,1,240,43,92,0.467,27,57,0.474,16,35,0.457,16,17,0.941,118,43,86,0.5,33,56,0.589,10,30,0.333,13,21,0.619,109
707,MIA,2021-01-04,118,,OKC,1,240,46,81,0.568,30,47,0.638,16,34,0.471,10,18,0.556,118,29,79,0.367,16,31,0.516,13,48,0.271,19,27,0.704,90
708,IND,2021-01-04,118,@,NOP,1,265,45,93,0.484,26,48,0.542,19,45,0.422,9,13,0.692,118,44,101,0.436,35,74,0.473,9,27,0.333,19,24,0.792,116
709,PHI,2021-01-04,118,,CHO,1,240,46,95,0.484,35,63,0.556,11,32,0.344,15,23,0.652,118,36,86,0.419,23,47,0.489,13,39,0.333,16,22,0.727,101
710,CHI,2021-01-03,118,,DAL,1,240,39,85,0.459,26,48,0.542,13,37,0.351,27,30,0.9,118,39,89,0.438,28,47,0.596,11,42,0.262,19,27,0.704,108
711,CHO,2020-12-30,118,@,DAL,1,240,43,84,0.512,28,50,0.56,15,34,0.441,17,21,0.81,118,34,87,0.391,22,45,0.489,12,42,0.286,19,33,0.576,99
712,ORL,2020-12-29,118,@,OKC,1,240,49,96,0.51,42,74,0.568,7,22,0.318,13,16,0.813,118,43,87,0.494,32,53,0.604,11,34,0.324,10,19,0.526,107
713,CLE,2020-12-27,118,,PHI,1,240,48,91,0.527,39,68,0.574,9,23,0.391,13,16,0.813,118,33,79,0.418,21,42,0.5,12,37,0.324,16,22,0.727,94
714,OKC,2021-05-16,117,,LAC,1,240,50,94,0.532,42,68,0.618,8,26,0.308,9,16,0.563,117,45,106,0.425,35,63,0.556,10,43,0.233,12,15,0.8,112
715,ORL,2021-05-16,117,@,PHI,0,240,36,76,0.474,26,48,0.542,10,28,0.357,35,41,0.854,117,46,94,0.489,27,54,0.5,19,40,0.475,17,23,0.739,128
716,POR,2021-05-13,117,@,PHO,0,240,44,81,0.543,29,48,0.604,15,33,0.455,14,18,0.778,117,41,88,0.466,28,56,0.5,13,32,0.406,23,26,0.885,118
717,DEN,2021-05-11,117,@,CHO,1,240,41,83,0.494,28,50,0.56,13,33,0.394,22,26,0.846,117,42,91,0.462,31,52,0.596,11,39,0.282,17,20,0.85,112
718,MIL,2021-05-02,117,,BRK,1,240,48,98,0.49,33,61,0.541,15,37,0.405,6,12,0.5,117,41,96,0.427,24,54,0.444,17,42,0.405,15,17,0.882,114
719,GSW,2021-04-25,117,,SAC,1,240,46,95,0.484,32,59,0.542,14,36,0.389,11,15,0.733,117,41,86,0.477,27,49,0.551,14,37,0.378,17,22,0.773,113
720,PHI,2021-04-22,117,@,MIL,0,240,46,91,0.505,34,64,0.531,12,27,0.444,13,18,0.722,117,45,81,0.556,25,41,0.61,20,40,0.5,14,23,0.609,124
721,DET,2021-04-21,117,@,DAL,0,240,40,79,0.506,27,47,0.574,13,32,0.406,24,31,0.774,117,46,92,0.5,30,49,0.612,16,43,0.372,19,26,0.731,127
722,LAC,2021-04-21,117,,MEM,1,240,38,84,0.452,24,57,0.421,14,27,0.519,27,36,0.75,117,38,84,0.452,25,54,0.463,13,30,0.433,16,23,0.696,105
723,IND,2021-04-18,117,@,ATL,0,240,45,92,0.489,35,60,0.583,10,32,0.313,17,20,0.85,117,45,92,0.489,32,60,0.533,13,32,0.406,26,34,0.765,129
724,WAS,2021-04-16,117,,NOP,1,265,45,96,0.469,41,69,0.594,4,27,0.148,23,32,0.719,117,40,97,0.412,33,69,0.478,7,28,0.25,28,33,0.848,115
725,NYK,2021-04-16,117,@,DAL,1,240,44,86,0.512,30,58,0.517,14,28,0.5,15,21,0.714,117,40,91,0.44,25,46,0.543,15,45,0.333,14,19,0.737,109
726,BRK,2021-04-14,117,@,PHI,0,240,43,83,0.518,39,62,0.629,4,21,0.19,27,30,0.9,117,45,87,0.517,32,59,0.542,13,28,0.464,20,25,0.8,123
727,TOR,2021-04-14,117,,SAS,1,240,41,88,0.466,27,58,0.466,14,30,0.467,21,25,0.84,117,38,89,0.427,21,50,0.42,17,39,0.436,19,27,0.704,112
728,NOP,2021-04-12,117,,SAC,1,240,42,77,0.545,36,58,0.621,6,19,0.316,27,39,0.692,117,39,90,0.433,29,55,0.527,10,35,0.286,22,37,0.595,110
729,DAL,2021-04-11,117,,SAS,0,240,45,94,0.479,32,52,0.615,13,42,0.31,14,15,0.933,117,45,83,0.542,37,62,0.597,8,21,0.381,21,27,0.778,119
730,CHI,2021-04-11,117,@,MIN,0,240,47,92,0.511,32,54,0.593,15,38,0.395,8,13,0.615,117,40,81,0.494,24,45,0.533,16,36,0.444,25,25,1.0,121
731,PHI,2021-04-10,117,@,OKC,1,240,44,94,0.468,32,56,0.571,12,38,0.316,17,25,0.68,117,38,76,0.5,30,56,0.536,8,20,0.4,9,19,0.474,93
732,PHO,2021-04-07,117,,UTA,1,265,45,101,0.446,34,67,0.507,11,34,0.324,16,20,0.8,117,46,103,0.447,35,59,0.593,11,44,0.25,10,15,0.667,113
733,ATL,2021-04-04,117,,GSW,1,240,35,81,0.432,23,49,0.469,12,32,0.375,35,45,0.778,117,43,92,0.467,33,52,0.635,10,40,0.25,15,21,0.714,111
734,PHO,2021-03-30,117,,ATL,1,240,45,88,0.511,33,56,0.589,12,32,0.375,15,18,0.833,117,41,85,0.482,28,53,0.528,13,32,0.406,15,21,0.714,110
735,TOR,2021-03-28,117,,POR,0,240,39,87,0.448,25,45,0.556,14,42,0.333,25,33,0.758,117,46,97,0.474,36,63,0.571,10,34,0.294,20,24,0.833,122
736,UTA,2021-03-26,117,,MEM,1,240,45,98,0.459,33,65,0.508,12,33,0.364,15,18,0.833,117,44,97,0.454,32,67,0.478,12,30,0.4,14,18,0.778,114
737,HOU,2021-03-22,117,,TOR,1,240,41,90,0.456,27,54,0.5,14,36,0.389,21,26,0.808,117,37,87,0.425,27,47,0.574,10,40,0.25,15,19,0.789,99
738,CLE,2021-03-17,117,,BOS,1,240,40,74,0.541,30,51,0.588,10,23,0.435,27,33,0.818,117,40,88,0.455,30,50,0.6,10,38,0.263,20,29,0.69,110
739,UTA,2021-03-16,117,@,BOS,1,240,38,80,0.475,19,37,0.514,19,43,0.442,22,24,0.917,117,48,98,0.49,38,69,0.551,10,29,0.345,3,4,0.75,109
740,BRK,2021-03-15,117,,NYK,1,240,44,76,0.579,32,47,0.681,12,29,0.414,17,22,0.773,117,37,92,0.402,22,50,0.44,15,42,0.357,23,27,0.852,112
741,LAC,2021-03-04,117,@,WAS,0,240,38,82,0.463,22,47,0.468,16,35,0.457,25,27,0.926,117,40,88,0.455,31,65,0.477,9,23,0.391,30,42,0.714,119
742,BOS,2021-03-02,117,,LAC,1,240,42,86,0.488,26,54,0.481,16,32,0.5,17,23,0.739,117,43,87,0.494,25,49,0.51,18,38,0.474,8,9,0.889,112
743,LAL,2021-02-28,117,,GSW,1,240,40,85,0.471,29,54,0.537,11,31,0.355,26,38,0.684,117,35,86,0.407,27,52,0.519,8,34,0.235,13,19,0.684,91
744,SAS,2021-02-27,117,,NOP,1,240,41,86,0.477,29,54,0.537,12,32,0.375,23,28,0.821,117,40,91,0.44,31,59,0.525,9,32,0.281,25,31,0.806,114
745,OKC,2021-02-21,117,@,CLE,1,240,43,79,0.544,30,51,0.588,13,28,0.464,18,24,0.75,117,39,84,0.464,31,49,0.633,8,35,0.229,15,20,0.75,101
746,GSW,2021-02-13,117,,BRK,0,240,44,90,0.489,35,56,0.625,9,34,0.265,20,25,0.8,117,50,93,0.538,34,54,0.63,16,39,0.41,18,20,0.9,134
747,ATL,2021-02-10,117,@,DAL,0,240,40,88,0.455,26,49,0.531,14,39,0.359,23,28,0.821,117,43,84,0.512,29,49,0.592,14,35,0.4,18,20,0.9,118
748,BRK,2021-02-05,117,,TOR,0,240,39,80,0.488,22,38,0.579,17,42,0.405,22,29,0.759,117,49,97,0.505,36,65,0.554,13,32,0.406,12,14,0.857,123
749,UTA,2021-02-02,117,,DET,1,240,38,82,0.463,22,40,0.55,16,42,0.381,25,29,0.862,117,39,93,0.419,30,66,0.455,9,27,0.333,18,20,0.9,105
750,UTA,2021-01-31,117,@,DEN,0,240,32,75,0.427,12,28,0.429,20,47,0.426,33,39,0.846,117,47,87,0.54,29,59,0.492,18,28,0.643,16,19,0.842,128
751,ORL,2021-01-25,117,,CHO,1,240,42,88,0.477,23,51,0.451,19,37,0.514,14,22,0.636,117,39,89,0.438,28,51,0.549,11,38,0.289,19,27,0.704,108
752,DEN,2021-01-25,117,@,DAL,1,240,40,79,0.506,25,44,0.568,15,35,0.429,22,28,0.786,117,41,84,0.488,30,52,0.577,11,32,0.344,20,24,0.833,113
753,SAS,2021-01-22,117,,DAL,0,240,41,89,0.461,29,61,0.475,12,28,0.429,23,30,0.767,117,45,93,0.484,31,54,0.574,14,39,0.359,18,20,0.9,122
754,PHI,2021-01-20,117,,BOS,1,240,36,78,0.462,27,51,0.529,9,27,0.333,36,45,0.8,117,42,89,0.472,30,56,0.536,12,33,0.364,13,20,0.65,109
755,CHI,2021-01-17,117,@,DAL,1,240,43,85,0.506,36,60,0.6,7,25,0.28,24,33,0.727,117,41,93,0.441,33,62,0.532,8,31,0.258,11,19,0.579,101
756,UTA,2021-01-12,117,@,CLE,1,240,42,84,0.5,18,39,0.462,24,45,0.533,9,12,0.75,117,35,90,0.389,27,59,0.458,8,31,0.258,9,14,0.643,87
757,LAL,2021-01-12,117,@,HOU,1,240,42,84,0.5,28,52,0.538,14,32,0.438,19,27,0.704,117,38,97,0.392,26,57,0.456,12,40,0.3,12,16,0.75,100
758,IND,2021-01-09,117,,PHO,0,240,44,92,0.478,32,63,0.508,12,29,0.414,17,24,0.708,117,46,94,0.489,30,53,0.566,16,41,0.39,17,17,1.0,125
759,LAL,2021-01-08,117,,CHI,1,240,41,81,0.506,29,52,0.558,12,29,0.414,23,27,0.852,117,46,91,0.505,36,65,0.554,10,26,0.385,13,14,0.929,115
760,MIN,2021-01-07,117,@,POR,0,240,39,93,0.419,25,52,0.481,14,41,0.341,25,33,0.758,117,49,90,0.544,31,49,0.633,18,41,0.439,19,23,0.826,135
761,DEN,2021-01-07,117,,DAL,0,265,43,97,0.443,28,53,0.528,15,44,0.341,16,21,0.762,117,42,87,0.483,26,47,0.553,16,40,0.4,24,31,0.774,124
762,DEN,2021-05-16,116,@,POR,0,240,44,98,0.449,30,61,0.492,14,37,0.378,14,15,0.933,116,46,87,0.529,28,44,0.636,18,43,0.419,22,26,0.846,132
763,MEM,2021-05-13,116,,SAC,1,240,45,90,0.5,34,57,0.596,11,33,0.333,15,18,0.833,116,42,96,0.438,25,55,0.455,17,41,0.415,9,14,0.643,110
764,ATL,2021-05-13,116,,ORL,1,240,41,94,0.436,27,58,0.466,14,36,0.389,20,24,0.833,116,36,94,0.383,25,58,0.431,11,36,0.306,10,15,0.667,93
765,WAS,2021-05-12,116,@,ATL,0,240,45,101,0.446,35,72,0.486,10,29,0.345,16,19,0.842,116,44,86,0.512,34,53,0.642,10,33,0.303,22,28,0.786,120
766,SAS,2021-05-12,116,@,BRK,0,240,43,101,0.426,35,70,0.5,8,31,0.258,22,27,0.815,116,48,79,0.608,36,51,0.706,12,28,0.429,20,27,0.741,128
767,PHO,2021-05-11,116,@,GSW,0,240,41,79,0.519,25,42,0.595,16,37,0.432,18,20,0.9,116,47,95,0.495,36,55,0.655,11,40,0.275,17,20,0.85,122
768,UTA,2021-05-10,116,@,GSW,0,240,41,91,0.451,28,47,0.596,13,44,0.295,21,24,0.875,116,41,88,0.466,27,46,0.587,14,42,0.333,23,25,0.92,119
769,HOU,2021-05-08,116,@,UTA,0,240,43,98,0.439,25,47,0.532,18,51,0.353,12,17,0.706,116,45,85,0.529,30,47,0.638,15,38,0.395,19,21,0.905,124
770,WAS,2021-04-28,116,,LAL,1,240,47,90,0.522,41,72,0.569,6,18,0.333,16,21,0.762,116,42,96,0.438,32,62,0.516,10,34,0.294,13,21,0.619,107
771,MIA,2021-04-28,116,,SAS,1,240,43,85,0.506,34,60,0.567,9,25,0.36,21,24,0.875,116,41,88,0.466,31,56,0.554,10,32,0.313,19,24,0.792,111
772,BRK,2021-04-27,116,@,TOR,1,240,40,83,0.482,22,38,0.579,18,45,0.4,18,18,1.0,116,36,91,0.396,21,48,0.438,15,43,0.349,16,19,0.842,103
773,HOU,2021-04-24,116,@,DEN,0,240,41,82,0.5,26,42,0.619,15,40,0.375,19,28,0.679,116,50,84,0.595,34,47,0.723,16,37,0.432,13,16,0.813,129
774,PHO,2021-04-21,116,@,PHI,1,240,41,86,0.477,26,44,0.591,15,42,0.357,19,21,0.905,116,41,80,0.513,28,55,0.509,13,25,0.52,18,26,0.692,113
775,OKC,2021-04-21,116,@,IND,0,240,48,104,0.462,39,75,0.52,9,29,0.31,11,16,0.688,116,46,101,0.455,32,61,0.525,14,40,0.35,16,20,0.8,122
776,NYK,2021-04-14,116,@,NOP,1,240,44,97,0.454,27,64,0.422,17,33,0.515,11,13,0.846,116,40,88,0.455,34,60,0.567,6,28,0.214,20,24,0.833,106
777,BOS,2021-04-13,116,@,POR,1,240,42,90,0.467,27,55,0.491,15,35,0.429,17,24,0.708,116,43,90,0.478,26,47,0.553,17,43,0.395,12,17,0.706,115
778,GSW,2021-04-12,116,,DEN,1,240,39,81,0.481,21,37,0.568,18,44,0.409,20,22,0.909,116,39,83,0.47,31,57,0.544,8,26,0.308,21,25,0.84,107
779,NOP,2021-04-11,116,@,CLE,1,240,44,86,0.512,37,62,0.597,7,24,0.292,21,26,0.808,116,41,85,0.482,28,45,0.622,13,40,0.325,14,17,0.824,109
780,DAL,2021-04-08,116,,MIL,1,240,43,97,0.443,26,52,0.5,17,45,0.378,13,18,0.722,116,38,100,0.38,26,67,0.388,12,33,0.364,13,16,0.813,101
781,ORL,2021-04-07,116,,WAS,0,240,44,93,0.473,32,62,0.516,12,31,0.387,16,23,0.696,116,49,85,0.576,30,49,0.612,19,36,0.528,14,16,0.875,131
782,POR,2021-04-06,116,@,LAC,0,240,37,92,0.402,26,56,0.464,11,36,0.306,31,37,0.838,116,46,89,0.517,30,48,0.625,16,41,0.39,25,30,0.833,133
783,MIN,2021-04-05,116,,SAC,1,240,38,91,0.418,26,59,0.441,12,32,0.375,28,33,0.848,116,39,88,0.443,30,52,0.577,9,36,0.25,19,24,0.792,106
784,MEM,2021-04-04,116,@,PHI,1,240,44,89,0.494,28,51,0.549,16,38,0.421,12,15,0.8,116,37,89,0.416,29,55,0.527,8,34,0.235,18,28,0.643,100
785,BOS,2021-04-04,116,,CHO,1,240,43,94,0.457,22,40,0.55,21,54,0.389,9,11,0.818,116,32,80,0.4,22,49,0.449,10,31,0.323,12,20,0.6,86
786,MIA,2021-04-01,116,,GSW,1,240,39,82,0.476,26,43,0.605,13,39,0.333,25,30,0.833,116,36,82,0.439,21,45,0.467,15,37,0.405,22,25,0.88,109
787,CHI,2021-03-31,116,@,PHO,0,240,43,99,0.434,32,66,0.485,11,33,0.333,19,21,0.905,116,46,81,0.568,35,56,0.625,11,25,0.44,18,24,0.75,121
788,GSW,2021-03-29,116,,CHI,1,240,46,92,0.5,30,54,0.556,16,38,0.421,8,9,0.889,116,44,84,0.524,38,60,0.633,6,24,0.25,8,11,0.727,102
789,MEM,2021-03-24,116,@,OKC,1,240,47,99,0.475,36,69,0.522,11,30,0.367,11,13,0.846,116,43,95,0.453,33,60,0.55,10,35,0.286,11,17,0.647,107
790,IND,2021-03-24,116,,DET,1,240,45,97,0.464,30,63,0.476,15,34,0.441,11,14,0.786,116,44,83,0.53,33,55,0.6,11,28,0.393,12,19,0.632,111
791,BRK,2021-03-23,116,@,POR,1,240,43,87,0.494,34,57,0.596,9,30,0.3,21,27,0.778,116,36,90,0.4,17,35,0.486,19,55,0.345,21,23,0.913,112
792,CLE,2021-03-21,116,,TOR,1,240,39,77,0.506,22,44,0.5,17,33,0.515,21,28,0.75,116,37,95,0.389,22,49,0.449,15,46,0.326,16,19,0.842,105
793,SAS,2021-03-19,116,@,CLE,1,240,41,88,0.466,34,70,0.486,7,18,0.389,27,33,0.818,116,39,89,0.438,32,62,0.516,7,27,0.259,25,32,0.781,110
794,GSW,2021-03-19,116,@,MEM,1,240,44,91,0.484,29,50,0.58,15,41,0.366,13,18,0.722,116,39,84,0.464,31,58,0.534,8,26,0.308,17,21,0.81,103
795,ATL,2021-03-18,116,,OKC,1,240,47,87,0.54,36,54,0.667,11,33,0.333,11,13,0.846,116,34,93,0.366,21,59,0.356,13,34,0.382,12,16,0.75,93
796,LAL,2021-03-18,116,,CHO,1,240,44,92,0.478,31,53,0.585,13,39,0.333,15,20,0.75,116,41,83,0.494,30,54,0.556,11,29,0.379,12,20,0.6,105
797,DET,2021-03-17,116,,TOR,1,240,38,75,0.507,26,46,0.565,12,29,0.414,28,32,0.875,116,37,86,0.43,25,46,0.543,12,40,0.3,26,34,0.765,112
798,SAC,2021-03-15,116,@,CHO,0,240,48,86,0.558,39,55,0.709,9,31,0.29,11,17,0.647,116,45,94,0.479,33,64,0.516,12,30,0.4,20,25,0.8,122
799,DAL,2021-03-13,116,@,DEN,1,240,42,86,0.488,24,40,0.6,18,46,0.391,14,16,0.875,116,37,90,0.411,21,49,0.429,16,41,0.39,13,18,0.722,103
800,NOP,2021-03-12,116,,CLE,1,240,47,101,0.465,41,77,0.532,6,24,0.25,16,19,0.842,116,30,88,0.341,23,56,0.411,7,32,0.219,15,20,0.75,82
801,OKC,2021-03-11,116,,DAL,1,240,41,91,0.451,25,59,0.424,16,32,0.5,18,20,0.9,116,35,82,0.427,20,48,0.417,15,34,0.441,23,33,0.697,108
802,UTA,2021-02-26,116,@,MIA,0,240,40,94,0.426,25,48,0.521,15,46,0.326,21,23,0.913,116,44,86,0.512,30,55,0.545,14,31,0.452,22,25,0.88,124
803,MIA,2021-02-24,116,,TOR,1,240,37,80,0.463,20,42,0.476,17,38,0.447,25,29,0.862,116,37,74,0.5,17,30,0.567,20,44,0.455,14,17,0.824,108
804,WAS,2021-02-23,116,@,LAC,0,240,47,88,0.534,36,68,0.529,11,20,0.55,11,16,0.688,116,54,94,0.574,35,56,0.625,19,38,0.5,8,13,0.615,135
805,LAC,2021-02-19,116,,UTA,1,240,43,89,0.483,33,59,0.559,10,30,0.333,20,22,0.909,116,41,86,0.477,29,52,0.558,12,34,0.353,18,21,0.857,112
806,MIN,2021-02-14,116,@,TOR,1,240,43,82,0.524,27,43,0.628,16,39,0.41,14,19,0.737,116,38,91,0.418,28,58,0.483,10,33,0.303,26,31,0.839,112
807,NOP,2021-02-10,116,@,CHI,0,240,41,81,0.506,28,45,0.622,13,36,0.361,21,26,0.808,116,48,81,0.593,23,34,0.676,25,47,0.532,8,11,0.727,129
808,DAL,2021-02-04,116,,GSW,0,240,38,92,0.413,18,42,0.429,20,50,0.4,20,23,0.87,116,51,89,0.573,29,46,0.63,22,43,0.512,23,27,0.852,147
809,SAC,2021-02-03,116,,BOS,1,240,42,92,0.457,29,55,0.527,13,37,0.351,19,23,0.826,116,39,86,0.453,28,53,0.528,11,33,0.333,22,29,0.759,111
810,ATL,2021-02-03,116,,DAL,0,240,45,90,0.5,31,52,0.596,14,38,0.368,12,17,0.706,116,43,93,0.462,30,53,0.566,13,40,0.325,23,25,0.92,122
811,MEM,2021-02-02,116,@,IND,0,240,42,93,0.452,33,68,0.485,9,25,0.36,23,24,0.958,116,49,82,0.598,33,53,0.623,16,29,0.552,20,29,0.69,134
812,LAC,2021-01-29,116,@,ORL,1,240,46,94,0.489,33,57,0.579,13,37,0.351,11,11,1.0,116,32,89,0.36,22,56,0.393,10,33,0.303,16,18,0.889,90
813,ATL,2021-01-29,116,@,WAS,1,240,39,87,0.448,27,50,0.54,12,37,0.324,26,34,0.765,116,31,85,0.365,24,57,0.421,7,28,0.25,31,38,0.816,100
814,UTA,2021-01-27,116,,DAL,1,240,42,91,0.462,26,50,0.52,16,41,0.39,16,21,0.762,116,42,91,0.462,30,56,0.536,12,35,0.343,8,9,0.889,104
815,IND,2021-01-27,116,@,CHO,1,240,45,88,0.511,29,48,0.604,16,40,0.4,10,12,0.833,116,37,90,0.411,24,52,0.462,13,38,0.342,19,21,0.905,106
816,POR,2021-01-24,116,,NYK,1,240,39,83,0.47,22,37,0.595,17,46,0.37,21,23,0.913,116,39,86,0.453,27,57,0.474,12,29,0.414,23,25,0.92,113
817,ATL,2021-01-22,116,@,MIN,1,240,38,83,0.458,23,48,0.479,15,35,0.429,25,30,0.833,116,40,93,0.43,32,61,0.525,8,32,0.25,10,12,0.833,98
818,TOR,2021-01-18,116,,DAL,1,240,44,88,0.5,32,55,0.582,12,33,0.364,16,18,0.889,116,31,82,0.378,22,46,0.478,9,36,0.25,22,27,0.815,93
819,TOR,2021-01-16,116,,CHO,1,240,36,86,0.419,15,37,0.405,21,49,0.429,23,26,0.885,116,38,87,0.437,23,51,0.451,15,36,0.417,22,29,0.759,113
820,UTA,2021-01-15,116,,ATL,1,240,43,92,0.467,23,48,0.479,20,44,0.455,10,14,0.714,116,38,92,0.413,33,64,0.516,5,28,0.179,11,15,0.733,92
821,BRK,2021-01-13,116,@,NYK,1,240,44,91,0.484,28,51,0.549,16,40,0.4,12,17,0.706,116,44,92,0.478,33,64,0.516,11,28,0.393,10,12,0.833,109
822,DEN,2021-01-12,116,@,BRK,0,240,44,88,0.5,26,51,0.51,18,37,0.486,10,16,0.625,116,48,79,0.608,32,47,0.681,16,32,0.5,10,15,0.667,122
823,BRK,2021-01-10,116,,OKC,0,240,43,85,0.506,33,51,0.647,10,34,0.294,20,24,0.833,116,49,90,0.544,34,51,0.667,15,39,0.385,16,17,0.941,129
824,BOS,2021-01-08,116,,WAS,1,240,41,86,0.477,29,54,0.537,12,32,0.375,22,30,0.733,116,41,88,0.466,30,59,0.508,11,29,0.379,14,16,0.875,107
825,MIN,2021-01-05,116,@,DEN,0,240,42,91,0.462,31,57,0.544,11,34,0.324,21,27,0.778,116,41,79,0.519,33,54,0.611,8,25,0.32,33,45,0.733,123
826,SAS,2021-01-05,116,@,LAC,1,240,44,96,0.458,24,56,0.429,20,40,0.5,8,11,0.727,116,43,86,0.5,28,51,0.549,15,35,0.429,12,13,0.923,113
827,NOP,2021-01-04,116,,IND,0,265,44,101,0.436,35,74,0.473,9,27,0.333,19,24,0.792,116,45,93,0.484,26,48,0.542,19,45,0.422,9,13,0.692,118
828,TOR,2021-01-02,116,@,NOP,0,240,38,91,0.418,24,43,0.558,14,48,0.292,26,27,0.963,116,35,83,0.422,21,45,0.467,14,38,0.368,36,47,0.766,120
829,PHI,2020-12-31,116,@,ORL,1,240,44,91,0.484,29,58,0.5,15,33,0.455,13,15,0.867,116,33,95,0.347,26,67,0.388,7,28,0.25,19,21,0.905,92
830,BOS,2020-12-29,116,@,IND,1,240,40,80,0.5,31,58,0.534,9,22,0.409,27,37,0.73,116,43,84,0.512,31,51,0.608,12,33,0.364,13,16,0.813,111
831,GSW,2020-12-29,116,@,DET,1,240,38,76,0.5,24,43,0.558,14,33,0.424,26,36,0.722,116,35,92,0.38,22,57,0.386,13,35,0.371,23,29,0.793,106
832,MEM,2020-12-28,116,@,BRK,1,265,42,98,0.429,32,69,0.464,10,29,0.345,22,29,0.759,116,41,100,0.41,27,58,0.466,14,42,0.333,15,17,0.882,111
833,PHO,2020-12-27,116,@,SAC,1,240,46,94,0.489,32,59,0.542,14,35,0.4,10,11,0.909,116,36,76,0.474,26,53,0.491,10,23,0.435,18,25,0.72,100
834,MIN,2020-12-26,116,@,UTA,1,240,45,101,0.446,32,72,0.444,13,29,0.448,13,18,0.722,116,36,94,0.383,26,60,0.433,10,34,0.294,29,37,0.784,111
835,LAC,2020-12-22,116,@,LAL,1,240,44,93,0.473,30,53,0.566,14,40,0.35,14,19,0.737,116,38,81,0.469,29,52,0.558,9,29,0.31,24,31,0.774,109
836,WAS,2021-05-16,115,,CHO,1,240,44,91,0.484,34,60,0.567,10,31,0.323,17,21,0.81,115,37,94,0.394,23,49,0.469,14,45,0.311,22,24,0.917,110
837,IND,2021-05-15,115,,LAL,0,240,46,89,0.517,37,56,0.661,9,33,0.273,14,19,0.737,115,41,86,0.477,30,57,0.526,11,29,0.379,29,36,0.806,122
838,LAC,2021-05-14,115,@,HOU,0,240,45,93,0.484,34,58,0.586,11,35,0.314,14,15,0.933,115,46,86,0.535,32,49,0.653,14,37,0.378,16,22,0.727,122
839,BRK,2021-05-11,115,@,CHI,1,240,42,89,0.472,30,56,0.536,12,33,0.364,19,25,0.76,115,39,96,0.406,21,52,0.404,18,44,0.409,11,14,0.786,107
840,LAC,2021-05-11,115,@,TOR,1,240,39,78,0.5,28,46,0.609,11,32,0.344,26,26,1.0,115,35,86,0.407,25,49,0.51,10,37,0.27,16,19,0.842,96
841,MEM,2021-05-10,115,,NOP,1,240,45,91,0.495,36,61,0.59,9,30,0.3,16,27,0.593,115,43,97,0.443,33,74,0.446,10,23,0.435,14,21,0.667,110
842,HOU,2021-05-05,115,,PHI,0,240,42,93,0.452,25,48,0.521,17,45,0.378,14,18,0.778,115,50,94,0.532,35,59,0.593,15,35,0.429,20,22,0.909,135
843,DAL,2021-04-29,115,@,DET,1,240,40,89,0.449,27,59,0.458,13,30,0.433,22,23,0.957,115,36,71,0.507,26,42,0.619,10,29,0.345,23,34,0.676,105
844,BOS,2021-04-27,115,,OKC,0,240,41,97,0.423,30,48,0.625,11,49,0.224,22,25,0.88,115,39,81,0.481,26,51,0.51,13,30,0.433,28,36,0.778,119
845,IND,2021-04-24,115,,DET,1,240,40,96,0.417,30,64,0.469,10,32,0.313,25,35,0.714,115,39,96,0.406,29,62,0.468,10,34,0.294,21,26,0.808,109
846,DAL,2021-04-22,115,,LAL,1,240,40,82,0.488,31,58,0.534,9,24,0.375,26,36,0.722,115,43,90,0.478,33,60,0.55,10,30,0.333,14,17,0.824,110
847,UTA,2021-04-17,115,@,LAL,0,265,42,101,0.416,19,42,0.452,23,59,0.39,8,8,1.0,115,48,93,0.516,37,60,0.617,11,33,0.333,20,23,0.87,127
848,MIL,2021-04-17,115,,MEM,0,240,39,91,0.429,23,44,0.523,16,47,0.34,21,27,0.778,115,51,93,0.548,36,53,0.679,15,40,0.375,11,12,0.917,128
849,CHI,2021-04-16,115,,MEM,0,240,45,96,0.469,32,62,0.516,13,34,0.382,12,15,0.8,115,45,86,0.523,28,46,0.609,17,40,0.425,19,24,0.792,126
850,NOP,2021-04-16,115,@,WAS,0,265,40,97,0.412,33,69,0.478,7,28,0.25,28,33,0.848,115,45,96,0.469,41,69,0.594,4,27,0.148,23,32,0.719,117
851,CHO,2021-04-16,115,@,BRK,0,240,44,83,0.53,32,49,0.653,12,34,0.353,15,20,0.75,115,47,85,0.553,26,44,0.591,21,41,0.512,15,16,0.938,130
852,ORL,2021-04-14,115,@,CHI,1,240,44,89,0.494,32,62,0.516,12,27,0.444,15,20,0.75,115,41,86,0.477,24,49,0.49,17,37,0.459,7,9,0.778,106
853,IND,2021-04-13,115,,LAC,0,240,44,96,0.458,35,56,0.625,9,40,0.225,18,22,0.818,115,48,89,0.539,35,61,0.574,13,28,0.464,17,19,0.895,126
854,POR,2021-04-13,115,,BOS,0,240,43,90,0.478,26,47,0.553,17,43,0.395,12,17,0.706,115,42,90,0.467,27,55,0.491,15,35,0.429,17,24,0.708,116
855,CLE,2021-04-10,115,,TOR,0,240,39,86,0.453,24,51,0.471,15,35,0.429,22,26,0.846,115,53,86,0.616,36,54,0.667,17,32,0.531,12,14,0.857,135
856,HOU,2021-04-04,115,,NOP,0,240,41,89,0.461,25,49,0.51,16,40,0.4,17,24,0.708,115,42,91,0.462,26,54,0.481,16,37,0.432,22,35,0.629,122
857,CHI,2021-04-04,115,,BRK,1,240,43,78,0.551,35,56,0.625,8,22,0.364,21,30,0.7,115,45,93,0.484,34,65,0.523,11,28,0.393,6,7,0.857,107
858,MIA,2021-04-03,115,,CLE,1,240,44,82,0.537,29,44,0.659,15,38,0.395,12,16,0.75,115,35,74,0.473,25,43,0.581,10,31,0.323,21,25,0.84,101
859,LAL,2021-04-02,115,@,SAC,1,240,43,91,0.473,26,58,0.448,17,33,0.515,12,20,0.6,115,36,85,0.424,26,50,0.52,10,35,0.286,12,16,0.75,94
860,ORL,2021-04-01,115,@,NOP,1,265,45,106,0.425,40,81,0.494,5,25,0.2,20,23,0.87,115,41,93,0.441,29,64,0.453,12,29,0.414,16,19,0.842,110
861,SAS,2021-03-29,115,,SAC,0,240,47,93,0.505,37,66,0.561,10,27,0.37,11,14,0.786,115,47,84,0.56,29,48,0.604,18,36,0.5,20,25,0.8,132
862,NOP,2021-03-29,115,@,BOS,1,240,41,82,0.5,25,51,0.49,16,31,0.516,17,30,0.567,115,40,93,0.43,26,50,0.52,14,43,0.326,15,19,0.789,109
863,UTA,2021-03-19,115,@,TOR,1,240,34,74,0.459,22,37,0.595,12,37,0.324,35,41,0.854,115,40,83,0.482,19,39,0.487,21,44,0.477,11,14,0.786,112
864,IND,2021-03-17,115,,BRK,0,240,43,84,0.512,34,52,0.654,9,32,0.281,20,25,0.8,115,42,87,0.483,33,60,0.55,9,27,0.333,31,40,0.775,124
865,LAC,2021-03-14,115,@,NOP,0,240,42,92,0.457,27,49,0.551,15,43,0.349,16,19,0.842,115,53,81,0.654,41,55,0.745,12,26,0.462,17,21,0.81,135
866,DAL,2021-03-10,115,,SAS,1,240,43,83,0.518,30,43,0.698,13,40,0.325,16,19,0.842,115,38,83,0.458,26,55,0.473,12,28,0.429,16,20,0.8,104
867,ATL,2021-03-03,115,@,ORL,1,240,38,85,0.447,17,40,0.425,21,45,0.467,18,19,0.947,115,36,84,0.429,23,49,0.469,13,35,0.371,27,27,1.0,112
868,DAL,2021-02-27,115,@,BRK,1,240,45,86,0.523,31,50,0.62,14,36,0.389,11,17,0.647,115,35,86,0.407,21,42,0.5,14,44,0.318,14,19,0.737,98
869,SAC,2021-02-21,115,@,MIL,0,240,44,100,0.44,32,67,0.478,12,33,0.364,15,20,0.75,115,44,90,0.489,33,62,0.532,11,28,0.393,29,36,0.806,128
870,BOS,2021-02-21,115,@,NOP,0,265,39,98,0.398,29,61,0.475,10,37,0.27,27,34,0.794,115,42,94,0.447,31,58,0.534,11,36,0.306,25,37,0.676,120
871,DEN,2021-02-21,115,@,ATL,0,240,43,84,0.512,27,48,0.563,16,36,0.444,13,16,0.813,115,42,81,0.519,30,47,0.638,12,34,0.353,27,33,0.818,123
872,POR,2021-02-16,115,@,OKC,1,240,42,96,0.438,22,49,0.449,20,47,0.426,11,17,0.647,115,37,85,0.435,27,52,0.519,10,33,0.303,20,27,0.741,104
873,MIL,2021-02-12,115,@,UTA,0,240,42,92,0.457,30,59,0.508,12,33,0.364,19,27,0.704,115,43,82,0.524,29,44,0.659,14,38,0.368,29,34,0.853,129
874,LAL,2021-02-12,115,,MEM,1,240,43,85,0.506,37,55,0.673,6,30,0.2,23,33,0.697,115,39,80,0.488,27,51,0.529,12,29,0.414,15,19,0.789,105
875,WAS,2021-02-10,115,,TOR,0,240,42,93,0.452,30,52,0.577,12,41,0.293,19,23,0.826,115,49,93,0.527,30,61,0.492,19,32,0.594,20,23,0.87,137
876,LAC,2021-02-05,115,,BOS,0,240,42,81,0.519,28,49,0.571,14,32,0.438,17,21,0.81,115,43,90,0.478,27,52,0.519,16,38,0.421,17,21,0.81,119
877,HOU,2021-02-04,115,@,MEM,1,240,41,87,0.471,22,42,0.524,19,45,0.422,14,17,0.824,115,37,87,0.425,25,52,0.481,12,35,0.343,17,24,0.708,103
878,TOR,2021-01-31,115,,ORL,1,240,41,90,0.456,29,51,0.569,12,39,0.308,21,22,0.955,115,33,82,0.402,20,46,0.435,13,36,0.361,23,28,0.821,102
879,NYK,2021-01-31,115,,LAC,0,240,41,85,0.482,31,58,0.534,10,27,0.37,23,28,0.821,115,44,81,0.543,27,43,0.628,17,38,0.447,24,28,0.857,129
880,MIL,2021-01-27,115,@,TOR,1,240,40,93,0.43,24,49,0.49,16,44,0.364,19,26,0.731,115,38,94,0.404,16,39,0.41,22,55,0.4,10,12,0.833,108
881,LAL,2021-01-25,115,@,CLE,1,240,42,87,0.483,32,55,0.582,10,32,0.313,21,28,0.75,115,40,86,0.465,31,65,0.477,9,21,0.429,19,22,0.864,108
882,ATL,2021-01-24,115,@,MIL,0,240,42,83,0.506,28,44,0.636,14,39,0.359,17,22,0.773,115,50,91,0.549,40,60,0.667,10,31,0.323,19,27,0.704,129
883,DET,2021-01-20,115,@,ATL,0,265,44,97,0.454,34,66,0.515,10,31,0.323,17,19,0.895,115,44,100,0.44,35,77,0.455,9,23,0.391,26,38,0.684,123
884,LAC,2021-01-20,115,,SAC,1,240,41,86,0.477,25,51,0.49,16,35,0.457,17,18,0.944,115,39,86,0.453,26,58,0.448,13,28,0.464,5,12,0.417,96
885,GSW,2021-01-18,115,@,LAL,1,240,44,87,0.506,32,50,0.64,12,37,0.324,15,20,0.75,115,40,83,0.482,31,54,0.574,9,29,0.31,24,33,0.727,113
886,ORL,2021-01-16,115,@,BRK,0,240,44,95,0.463,30,49,0.612,14,46,0.304,13,16,0.813,115,42,78,0.538,26,43,0.605,16,35,0.457,22,25,0.88,122
887,DEN,2021-01-09,115,@,PHI,1,240,45,90,0.5,33,57,0.579,12,33,0.364,13,15,0.867,115,43,103,0.417,32,68,0.471,11,35,0.314,6,10,0.6,103
888,GSW,2021-01-08,115,,LAC,1,240,40,82,0.488,20,41,0.488,20,41,0.488,15,18,0.833,115,40,83,0.482,26,52,0.5,14,31,0.452,11,13,0.846,105
889,MEM,2021-01-08,115,,BRK,1,240,45,98,0.459,32,66,0.485,13,32,0.406,12,14,0.857,115,38,81,0.469,24,50,0.48,14,31,0.452,20,21,0.952,110
890,CHI,2021-01-08,115,@,LAL,0,240,46,91,0.505,36,65,0.554,10,26,0.385,13,14,0.929,115,41,81,0.506,29,52,0.558,12,29,0.414,23,27,0.852,117
891,DET,2021-01-06,115,@,MIL,0,240,38,97,0.392,25,56,0.446,13,41,0.317,26,30,0.867,115,49,90,0.544,30,47,0.638,19,43,0.442,13,21,0.619,130
892,TOR,2021-01-06,115,@,PHO,0,240,39,79,0.494,25,44,0.568,14,35,0.4,23,32,0.719,115,40,83,0.482,19,43,0.442,21,40,0.525,22,24,0.917,123
893,DET,2021-01-04,115,@,MIL,0,240,43,98,0.439,26,58,0.448,17,40,0.425,12,12,1.0,115,49,85,0.576,35,51,0.686,14,34,0.412,13,16,0.813,125
894,DEN,2020-12-29,115,@,SAC,0,240,44,81,0.543,33,53,0.623,11,28,0.393,16,20,0.8,115,46,94,0.489,30,61,0.492,16,33,0.485,17,22,0.773,125
895,CHI,2020-12-29,115,@,WAS,1,240,38,87,0.437,23,51,0.451,15,36,0.417,24,32,0.75,115,37,84,0.44,27,47,0.574,10,37,0.27,23,26,0.885,107
896,POR,2020-12-28,115,@,LAL,1,240,43,92,0.467,27,46,0.587,16,46,0.348,13,15,0.867,115,41,87,0.471,31,60,0.517,10,27,0.37,15,18,0.833,107
897,DAL,2020-12-25,115,@,LAL,0,240,41,83,0.494,28,51,0.549,13,32,0.406,20,26,0.769,115,51,91,0.56,32,52,0.615,19,39,0.487,17,24,0.708,138
898,DAL,2021-05-14,114,,TOR,1,240,39,90,0.433,22,48,0.458,17,42,0.405,19,21,0.905,114,42,85,0.494,29,47,0.617,13,38,0.342,13,17,0.765,110
899,CHI,2021-05-13,114,,TOR,1,240,45,83,0.542,28,47,0.596,17,36,0.472,7,10,0.7,114,40,90,0.444,28,54,0.519,12,36,0.333,10,18,0.556,102
900,DEN,2021-05-13,114,@,MIN,1,240,46,96,0.479,34,60,0.567,12,36,0.333,10,11,0.909,114,34,80,0.425,18,39,0.462,16,41,0.39,19,32,0.594,103
901,MIL,2021-05-11,114,,ORL,1,240,43,101,0.426,35,68,0.515,8,33,0.242,20,27,0.741,114,39,94,0.415,29,64,0.453,10,30,0.333,14,20,0.7,102
902,POR,2021-05-03,114,@,ATL,0,240,43,95,0.453,26,54,0.481,17,41,0.415,11,14,0.786,114,44,84,0.524,24,43,0.558,20,41,0.488,15,18,0.833,123
903,BRK,2021-05-02,114,@,MIL,0,240,41,96,0.427,24,54,0.444,17,42,0.405,15,17,0.882,114,48,98,0.49,33,61,0.541,15,37,0.405,6,12,0.5,117
904,LAL,2021-05-02,114,,TOR,0,240,41,85,0.482,30,56,0.536,11,29,0.379,21,31,0.677,114,42,94,0.447,27,56,0.482,15,38,0.395,22,31,0.71,121
905,GSW,2021-04-29,114,@,MIN,0,240,42,85,0.494,27,47,0.574,15,38,0.395,15,21,0.714,114,43,94,0.457,23,53,0.434,20,41,0.488,20,29,0.69,126
906,DEN,2021-04-28,114,,NOP,1,240,43,85,0.506,33,53,0.623,10,32,0.313,18,23,0.783,114,43,87,0.494,31,57,0.544,12,30,0.4,14,19,0.737,112
907,MIN,2021-04-27,114,@,HOU,1,240,45,93,0.484,35,55,0.636,10,38,0.263,14,25,0.56,114,42,86,0.488,35,55,0.636,7,31,0.226,16,22,0.727,107
908,MIL,2021-04-27,114,@,CHO,1,240,47,93,0.505,38,58,0.655,9,35,0.257,11,14,0.786,114,38,82,0.463,26,47,0.553,12,35,0.343,16,23,0.696,104
909,LAL,2021-04-26,114,@,ORL,1,240,47,87,0.54,36,56,0.643,11,31,0.355,9,14,0.643,114,36,76,0.474,25,51,0.49,11,25,0.44,20,24,0.833,103
910,TOR,2021-04-21,114,,BRK,1,240,39,90,0.433,21,43,0.488,18,47,0.383,18,21,0.857,114,36,91,0.396,23,50,0.46,13,41,0.317,18,23,0.783,103
911,GSW,2021-04-21,114,@,WAS,0,240,40,101,0.396,25,56,0.446,15,45,0.333,19,21,0.905,114,38,91,0.418,28,63,0.444,10,28,0.357,32,38,0.842,118
912,HOU,2021-04-18,114,@,ORL,1,240,42,82,0.512,26,48,0.542,16,34,0.471,14,20,0.7,114,41,91,0.451,30,59,0.508,11,32,0.344,17,19,0.895,110
913,GSW,2021-04-17,114,@,BOS,0,240,41,80,0.513,24,40,0.6,17,40,0.425,15,20,0.75,114,44,94,0.468,29,48,0.604,15,46,0.326,16,20,0.8,119
914,SAC,2021-04-15,114,@,PHO,0,240,43,78,0.551,29,48,0.604,14,30,0.467,14,19,0.737,114,48,86,0.558,34,48,0.708,14,38,0.368,12,14,0.857,122
915,DAL,2021-04-14,114,@,MEM,1,240,44,88,0.5,31,48,0.646,13,40,0.325,13,17,0.765,114,42,90,0.467,29,56,0.518,13,34,0.382,16,21,0.762,113
916,BRK,2021-04-05,114,,NYK,1,240,42,92,0.457,32,60,0.533,10,32,0.313,20,26,0.769,114,40,86,0.465,26,57,0.456,14,29,0.483,18,22,0.818,112
917,CHO,2021-04-02,114,@,IND,1,240,43,95,0.453,35,64,0.547,8,31,0.258,20,29,0.69,114,38,82,0.463,28,49,0.571,10,33,0.303,11,19,0.579,97
918,PHI,2021-04-01,114,@,CLE,1,240,40,93,0.43,25,56,0.446,15,37,0.405,19,25,0.76,114,34,80,0.425,24,45,0.533,10,35,0.286,16,21,0.762,94
919,CHO,2021-03-30,114,@,WAS,1,240,42,90,0.467,28,56,0.5,14,34,0.412,16,19,0.842,114,41,100,0.41,31,63,0.492,10,37,0.27,12,15,0.8,104
920,UTA,2021-03-29,114,,CLE,1,240,38,82,0.463,19,41,0.463,19,41,0.463,19,23,0.826,114,29,83,0.349,22,49,0.449,7,34,0.206,10,16,0.625,75
921,MEM,2021-03-26,114,@,UTA,0,240,44,97,0.454,32,67,0.478,12,30,0.4,14,18,0.778,114,45,98,0.459,33,65,0.508,12,33,0.364,15,18,0.833,117
922,MIL,2021-03-26,114,,BOS,0,240,44,99,0.444,25,52,0.481,19,47,0.404,7,11,0.636,114,43,88,0.489,21,41,0.512,22,47,0.468,14,16,0.875,122
923,OKC,2021-03-21,114,@,HOU,1,240,42,91,0.462,29,52,0.558,13,39,0.333,17,25,0.68,114,39,79,0.494,25,41,0.61,14,38,0.368,20,27,0.741,112
924,MIN,2021-03-14,114,,POR,1,240,36,73,0.493,23,35,0.657,13,38,0.342,29,39,0.744,114,39,89,0.438,22,44,0.5,17,45,0.378,17,21,0.81,112
925,CHO,2021-03-13,114,,TOR,1,240,39,81,0.481,18,32,0.563,21,49,0.429,15,19,0.789,114,37,96,0.385,22,50,0.44,15,46,0.326,15,18,0.833,104
926,UTA,2021-03-12,114,,HOU,1,240,39,81,0.481,24,41,0.585,15,40,0.375,21,25,0.84,114,41,112,0.366,32,69,0.464,9,43,0.209,8,13,0.615,99
927,NYK,2021-03-04,114,,DET,1,240,45,83,0.542,36,56,0.643,9,27,0.333,15,19,0.789,114,39,80,0.488,25,44,0.568,14,36,0.389,12,15,0.8,104
928,HOU,2021-03-03,114,,BRK,0,240,38,91,0.418,20,48,0.417,18,43,0.419,20,28,0.714,114,49,85,0.576,32,50,0.64,17,35,0.486,17,24,0.708,132
929,IND,2021-03-03,114,@,CLE,1,240,47,83,0.566,39,58,0.672,8,25,0.32,12,16,0.75,114,43,83,0.518,32,55,0.582,11,28,0.393,14,15,0.933,111
930,PHO,2021-03-02,114,@,LAL,1,240,38,77,0.494,22,48,0.458,16,29,0.552,22,25,0.88,114,40,79,0.506,29,48,0.604,11,31,0.355,13,17,0.765,104
931,IND,2021-03-01,114,@,PHI,0,240,44,91,0.484,36,62,0.581,8,29,0.276,18,21,0.857,114,50,88,0.568,35,53,0.66,15,35,0.429,15,16,0.938,130
932,NOP,2021-02-27,114,@,SAS,0,240,40,91,0.44,31,59,0.525,9,32,0.281,25,31,0.806,114,41,86,0.477,29,54,0.537,12,32,0.375,23,28,0.821,117
933,UTA,2021-02-24,114,,LAL,1,240,41,87,0.471,19,39,0.487,22,48,0.458,10,15,0.667,114,34,85,0.4,26,52,0.5,8,33,0.242,13,20,0.65,89
934,GSW,2021-02-23,114,@,NYK,1,240,40,89,0.449,27,51,0.529,13,38,0.342,21,24,0.875,114,38,97,0.392,27,68,0.397,11,29,0.379,19,22,0.864,106
935,SAC,2021-02-20,114,@,CHI,0,240,44,98,0.449,36,69,0.522,8,29,0.276,18,22,0.818,114,49,82,0.598,38,59,0.644,11,23,0.478,13,15,0.867,122
936,NOP,2021-02-19,114,,PHO,0,240,42,82,0.512,31,50,0.62,11,32,0.344,19,24,0.792,114,51,88,0.58,29,49,0.592,22,39,0.564,8,12,0.667,132
937,UTA,2021-02-17,114,@,LAC,1,240,42,98,0.429,29,58,0.5,13,40,0.325,17,20,0.85,114,38,86,0.442,29,60,0.483,9,26,0.346,11,17,0.647,96
938,BOS,2021-02-17,114,,ATL,0,240,40,86,0.465,30,55,0.545,10,31,0.323,24,27,0.889,114,44,77,0.571,36,53,0.679,8,24,0.333,26,31,0.839,122
939,OKC,2021-02-14,114,,MIL,1,240,45,95,0.474,30,59,0.508,15,36,0.417,9,16,0.563,114,45,97,0.464,32,59,0.542,13,38,0.342,6,9,0.667,109
940,ATL,2021-02-12,114,,SAS,0,240,39,90,0.433,28,58,0.483,11,32,0.344,25,33,0.758,114,45,85,0.529,33,54,0.611,12,31,0.387,23,28,0.821,125
941,MIN,2021-02-12,114,@,CHO,0,240,45,99,0.455,29,58,0.5,16,41,0.39,8,14,0.571,114,44,90,0.489,31,54,0.574,13,36,0.361,19,19,1.0,120
942,PHI,2021-02-11,114,@,POR,0,240,42,86,0.488,36,59,0.61,6,27,0.222,24,29,0.828,114,40,93,0.43,23,55,0.418,17,38,0.447,21,23,0.913,118
943,CHO,2021-02-10,114,@,MEM,0,240,45,82,0.549,31,53,0.585,14,29,0.483,10,12,0.833,114,47,94,0.5,24,45,0.533,23,49,0.469,13,18,0.722,130
944,LAL,2021-02-10,114,,OKC,1,265,42,89,0.472,32,54,0.593,10,35,0.286,20,24,0.833,114,47,100,0.47,40,69,0.58,7,31,0.226,12,14,0.857,113
945,GSW,2021-02-09,114,@,SAS,1,240,42,91,0.462,25,51,0.49,17,40,0.425,13,19,0.684,114,32,86,0.372,24,62,0.387,8,24,0.333,19,21,0.905,91
946,DEN,2021-02-06,114,@,SAC,0,240,45,97,0.464,32,62,0.516,13,35,0.371,11,14,0.786,114,44,91,0.484,30,56,0.536,14,35,0.4,17,24,0.708,119
947,NOP,2021-02-05,114,@,IND,1,240,41,76,0.539,28,51,0.549,13,25,0.52,19,26,0.731,114,41,93,0.441,21,51,0.412,20,42,0.476,11,16,0.688,113
948,LAL,2021-02-04,114,,DEN,1,240,46,81,0.568,38,57,0.667,8,24,0.333,14,22,0.636,114,36,92,0.391,28,64,0.438,8,28,0.286,13,15,0.867,93
949,MIL,2021-01-30,114,@,CHO,0,240,40,82,0.488,22,37,0.595,18,45,0.4,16,24,0.667,114,44,92,0.478,23,48,0.479,21,44,0.477,17,20,0.85,126
950,PHO,2021-01-28,114,,GSW,1,240,41,88,0.466,30,56,0.536,11,32,0.344,21,23,0.913,114,38,99,0.384,27,61,0.443,11,38,0.289,6,8,0.75,93
951,TOR,2021-01-25,114,@,IND,0,240,38,93,0.409,24,55,0.436,14,38,0.368,24,27,0.889,114,40,78,0.513,28,49,0.571,12,29,0.414,37,45,0.822,129
952,PHI,2021-01-23,114,@,DET,1,240,38,83,0.458,30,60,0.5,8,23,0.348,30,38,0.789,114,37,86,0.43,23,53,0.434,14,33,0.424,22,30,0.733,110
953,DEN,2021-01-14,114,,GSW,1,240,41,90,0.456,30,53,0.566,11,37,0.297,21,27,0.778,114,38,81,0.469,27,52,0.519,11,29,0.379,17,24,0.708,104
954,DEN,2021-01-10,114,@,NYK,1,240,45,84,0.536,30,49,0.612,15,35,0.429,9,12,0.75,114,32,74,0.432,26,53,0.491,6,21,0.286,19,25,0.76,89
955,IND,2021-01-06,114,,HOU,1,240,42,89,0.472,33,66,0.5,9,23,0.391,21,26,0.808,114,39,81,0.481,31,51,0.608,8,30,0.267,21,26,0.808,107
956,TOR,2021-01-04,114,,BOS,0,240,36,90,0.4,23,53,0.434,13,37,0.351,29,38,0.763,114,41,84,0.488,26,55,0.473,15,29,0.517,29,34,0.853,126
957,ATL,2021-01-01,114,@,BRK,1,240,43,93,0.462,27,54,0.5,16,39,0.41,12,14,0.857,114,35,86,0.407,28,49,0.571,7,37,0.189,19,23,0.826,96
958,TOR,2020-12-26,114,@,SAS,0,240,44,96,0.458,29,55,0.527,15,41,0.366,11,15,0.733,114,47,100,0.47,33,66,0.5,14,34,0.412,11,16,0.688,119
959,CHO,2020-12-23,114,@,CLE,0,240,45,90,0.5,29,46,0.63,16,44,0.364,8,15,0.533,114,46,87,0.529,32,57,0.561,14,30,0.467,15,20,0.75,121
960,GSW,2021-05-16,113,,MEM,1,240,41,83,0.494,26,44,0.591,15,39,0.385,16,18,0.889,113,40,92,0.435,34,67,0.507,6,25,0.24,15,19,0.789,101
961,TOR,2021-05-16,113,,IND,0,240,39,97,0.402,27,59,0.458,12,38,0.316,23,29,0.793,113,48,95,0.505,33,58,0.569,15,37,0.405,14,18,0.778,125
962,LAC,2021-05-13,113,@,CHO,1,240,40,75,0.533,19,30,0.633,21,45,0.467,12,16,0.75,113,33,84,0.393,24,51,0.471,9,33,0.273,15,19,0.789,90
963,SAS,2021-05-07,113,@,SAC,1,240,46,89,0.517,42,67,0.627,4,22,0.182,17,19,0.895,113,41,84,0.488,28,52,0.538,13,32,0.406,9,15,0.6,104
964,DAL,2021-05-06,113,,BRK,1,240,40,89,0.449,25,55,0.455,15,34,0.441,18,26,0.692,113,41,95,0.432,28,58,0.483,13,37,0.351,14,15,0.933,109
965,DEN,2021-05-05,113,,NYK,1,240,37,97,0.381,25,58,0.431,12,39,0.308,27,33,0.818,113,33,86,0.384,20,51,0.392,13,35,0.371,18,27,0.667,97
966,MIA,2021-05-04,113,,DAL,0,240,39,84,0.464,21,43,0.488,18,41,0.439,17,21,0.81,113,46,87,0.529,24,39,0.615,22,48,0.458,13,18,0.722,127
967,PHI,2021-05-02,113,@,SAS,1,265,42,94,0.447,31,64,0.484,11,30,0.367,18,25,0.72,113,43,96,0.448,31,65,0.477,12,31,0.387,13,17,0.765,111
968,GSW,2021-05-01,113,@,HOU,1,240,39,84,0.464,21,38,0.553,18,46,0.391,17,24,0.708,113,32,89,0.36,23,47,0.489,9,42,0.214,14,22,0.636,87
969,IND,2021-04-29,113,,BRK,0,240,41,96,0.427,30,57,0.526,11,39,0.282,20,21,0.952,113,47,89,0.528,35,54,0.648,12,35,0.343,24,28,0.857,130
970,NYK,2021-04-28,113,,CHI,1,240,42,91,0.462,30,64,0.469,12,27,0.444,17,19,0.895,113,39,85,0.459,29,56,0.518,10,29,0.345,6,10,0.6,94
971,SAC,2021-04-26,113,,DAL,1,240,42,81,0.519,29,52,0.558,13,29,0.448,16,18,0.889,113,43,92,0.467,31,50,0.62,12,42,0.286,8,14,0.571,106
972,SAC,2021-04-25,113,@,GSW,0,240,41,86,0.477,27,49,0.551,14,37,0.378,17,22,0.773,113,46,95,0.484,32,59,0.542,14,36,0.389,11,15,0.733,117
973,POR,2021-04-25,113,,MEM,0,240,39,105,0.371,25,67,0.373,14,38,0.368,21,25,0.84,113,42,91,0.462,30,68,0.441,12,23,0.522,24,28,0.857,120
974,PHI,2021-04-21,113,,PHO,0,240,41,80,0.513,28,55,0.509,13,25,0.52,18,26,0.692,113,41,86,0.477,26,44,0.591,15,42,0.357,19,21,0.905,116
975,LAC,2021-04-20,113,@,POR,1,240,45,90,0.5,34,52,0.654,11,38,0.289,12,15,0.8,113,42,94,0.447,28,50,0.56,14,44,0.318,14,19,0.737,112
976,MIA,2021-04-19,113,,HOU,1,240,45,93,0.484,26,45,0.578,19,48,0.396,4,7,0.571,113,33,85,0.388,24,47,0.511,9,38,0.237,16,17,0.941,91
977,TOR,2021-04-16,113,,ORL,1,240,41,82,0.5,27,47,0.574,14,35,0.4,17,18,0.944,113,35,77,0.455,27,54,0.5,8,23,0.348,24,34,0.706,102
978,LAL,2021-04-15,113,,BOS,0,240,44,98,0.449,32,61,0.525,12,37,0.324,13,19,0.684,113,48,85,0.565,34,53,0.642,14,32,0.438,11,13,0.846,121
979,MEM,2021-04-14,113,,DAL,0,240,42,90,0.467,29,56,0.518,13,34,0.382,16,21,0.762,113,44,88,0.5,31,48,0.646,13,40,0.325,13,17,0.765,114
980,PHI,2021-04-12,113,@,DAL,1,240,39,80,0.488,27,49,0.551,12,31,0.387,23,33,0.697,113,35,83,0.422,26,47,0.553,9,36,0.25,16,20,0.8,95
981,DET,2021-04-08,113,@,SAC,1,240,44,84,0.524,36,61,0.59,8,23,0.348,17,20,0.85,113,38,86,0.442,31,56,0.554,7,30,0.233,18,26,0.692,101
982,TOR,2021-04-08,113,,CHI,0,240,42,97,0.433,31,63,0.492,11,34,0.324,18,22,0.818,113,47,87,0.54,35,57,0.614,12,30,0.4,16,18,0.889,122
983,LAC,2021-04-08,113,,PHO,1,240,42,84,0.5,24,47,0.511,18,37,0.486,11,12,0.917,113,36,71,0.507,30,47,0.638,6,24,0.25,25,30,0.833,103
984,UTA,2021-04-07,113,@,PHO,0,265,46,103,0.447,35,59,0.593,11,44,0.25,10,15,0.667,113,45,101,0.446,34,67,0.507,11,34,0.324,16,20,0.8,117
985,CHO,2021-04-07,113,@,OKC,1,240,43,97,0.443,28,53,0.528,15,44,0.341,12,13,0.923,113,37,85,0.435,21,44,0.477,16,41,0.39,12,17,0.706,102
986,ATL,2021-04-07,113,,MEM,0,240,45,101,0.446,35,73,0.479,10,28,0.357,13,15,0.867,113,48,89,0.539,31,49,0.633,17,40,0.425,18,21,0.857,131
987,CHI,2021-04-06,113,@,IND,1,240,44,94,0.468,30,61,0.492,14,33,0.424,11,14,0.786,113,38,88,0.432,29,58,0.5,9,30,0.3,12,16,0.75,97
988,MIN,2021-04-03,113,@,PHI,0,240,35,78,0.449,23,42,0.548,12,36,0.333,31,36,0.861,113,41,81,0.506,29,53,0.547,12,28,0.429,28,37,0.757,122
989,UTA,2021-04-02,113,,CHI,1,240,37,79,0.468,24,43,0.558,13,36,0.361,26,27,0.963,113,43,89,0.483,36,61,0.59,7,28,0.25,13,17,0.765,106
990,OKC,2021-03-31,113,,TOR,1,240,39,86,0.453,25,53,0.472,14,33,0.424,21,28,0.75,113,35,90,0.389,19,44,0.432,16,46,0.348,17,20,0.85,103
991,DAL,2021-03-31,113,@,BOS,1,240,38,77,0.494,19,38,0.5,19,39,0.487,18,25,0.72,113,39,94,0.415,28,47,0.596,11,47,0.234,19,23,0.826,108
992,DEN,2021-03-26,113,@,NOP,1,240,47,93,0.505,33,65,0.508,14,28,0.5,5,7,0.714,113,39,78,0.5,27,49,0.551,12,29,0.414,18,20,0.9,108
993,BRK,2021-03-26,113,@,DET,1,240,37,84,0.44,24,51,0.471,13,33,0.394,26,34,0.765,113,33,73,0.452,22,42,0.524,11,31,0.355,34,47,0.723,111
994,WAS,2021-03-23,113,@,NYK,0,240,38,79,0.481,29,56,0.518,9,23,0.391,28,35,0.8,113,47,92,0.511,31,62,0.5,16,30,0.533,21,24,0.875,131
995,IND,2021-03-22,113,@,MIL,0,240,45,111,0.405,33,61,0.541,12,50,0.24,11,12,0.917,113,53,94,0.564,29,55,0.527,24,39,0.615,10,15,0.667,140
996,NOP,2021-03-21,113,@,DEN,1,240,41,85,0.482,33,57,0.579,8,28,0.286,23,30,0.767,113,44,88,0.5,32,54,0.593,12,34,0.353,8,10,0.8,108
997,BRK,2021-03-21,113,,WAS,1,240,44,90,0.489,35,61,0.574,9,29,0.31,16,22,0.727,113,42,79,0.532,35,58,0.603,7,21,0.333,15,19,0.789,106
998,SAS,2021-03-20,113,@,MIL,0,240,46,96,0.479,34,63,0.54,12,33,0.364,9,10,0.9,113,45,92,0.489,31,54,0.574,14,38,0.368,16,18,0.889,120
999,DET,2021-03-19,113,@,HOU,1,240,37,85,0.435,23,56,0.411,14,29,0.483,25,28,0.893,113,39,88,0.443,30,56,0.536,9,32,0.281,13,16,0.813,100
1000,BRK,2021-03-19,113,@,ORL,0,240,43,91,0.473,33,54,0.611,10,37,0.27,17,23,0.739,113,43,84,0.512,22,44,0.5,21,40,0.525,14,20,0.7,121
1001,PHO,2021-03-19,113,,MIN,1,240,43,86,0.5,29,59,0.492,14,27,0.519,13,17,0.765,113,37,79,0.468,24,44,0.545,13,35,0.371,14,18,0.778,101
1002,MIA,2021-03-16,113,,CLE,1,240,42,85,0.494,32,58,0.552,10,27,0.37,19,21,0.905,113,39,86,0.453,29,51,0.569,10,35,0.286,10,14,0.714,98
1003,DEN,2021-03-04,113,@,IND,1,240,45,77,0.584,33,49,0.673,12,28,0.429,11,16,0.688,113,41,90,0.456,27,51,0.529,14,39,0.359,7,12,0.583,103
1004,SAS,2021-03-01,113,,BRK,0,265,44,97,0.454,29,62,0.468,15,35,0.429,10,15,0.667,113,47,100,0.47,30,59,0.508,17,41,0.415,13,17,0.765,124
1005,OKC,2021-02-17,113,@,MEM,0,240,35,78,0.449,16,37,0.432,19,41,0.463,24,28,0.857,113,42,83,0.506,30,57,0.526,12,26,0.462,26,33,0.788,122
1006,HOU,2021-02-17,113,@,PHI,0,240,42,92,0.457,27,45,0.6,15,47,0.319,14,18,0.778,113,39,81,0.481,27,55,0.491,12,26,0.462,28,32,0.875,118
1007,MIL,2021-02-16,113,,TOR,0,240,40,83,0.482,26,46,0.565,14,37,0.378,19,25,0.76,113,46,91,0.505,29,48,0.604,17,43,0.395,15,21,0.714,124
1008,MEM,2021-02-16,113,,NOP,0,240,42,88,0.477,29,57,0.509,13,31,0.419,16,18,0.889,113,56,91,0.615,37,53,0.698,19,38,0.5,13,17,0.765,144
1009,ATL,2021-02-13,113,,IND,0,240,43,90,0.478,34,59,0.576,9,31,0.29,18,23,0.783,113,45,89,0.506,33,58,0.569,12,31,0.387,23,27,0.852,125
1010,OKC,2021-02-10,113,@,LAL,0,265,47,100,0.47,40,69,0.58,7,31,0.226,12,14,0.857,113,42,89,0.472,32,54,0.593,10,35,0.286,20,24,0.833,114
1011,MEM,2021-02-08,113,,TOR,0,240,37,87,0.425,24,48,0.5,13,39,0.333,26,29,0.897,113,42,77,0.545,22,40,0.55,20,37,0.541,24,26,0.923,128
1012,CLE,2021-02-08,113,@,PHO,0,240,44,86,0.512,36,62,0.581,8,24,0.333,17,25,0.68,113,47,90,0.522,36,66,0.545,11,24,0.458,14,19,0.737,119
1013,SAC,2021-02-07,113,@,LAC,1,240,46,94,0.489,36,65,0.554,10,29,0.345,11,15,0.733,113,41,99,0.414,33,71,0.465,8,28,0.286,20,23,0.87,110
1014,IND,2021-02-05,113,,NOP,0,240,41,93,0.441,21,51,0.412,20,42,0.476,11,16,0.688,113,41,76,0.539,28,51,0.549,13,25,0.52,19,26,0.731,114
1015,DAL,2021-01-25,113,,DEN,0,240,41,84,0.488,30,52,0.577,11,32,0.344,20,24,0.833,113,40,79,0.506,25,44,0.568,15,35,0.429,22,28,0.786,117
1016,NYK,2021-01-24,113,@,POR,0,240,39,86,0.453,27,57,0.474,12,29,0.414,23,25,0.92,113,39,83,0.47,22,37,0.595,17,46,0.37,21,23,0.913,116
1017,BRK,2021-01-22,113,@,CLE,0,240,42,87,0.483,28,44,0.636,14,43,0.326,15,17,0.882,113,45,87,0.517,37,62,0.597,8,25,0.32,27,32,0.844,125
1018,LAL,2021-01-21,113,@,MIL,1,240,41,88,0.466,22,51,0.431,19,37,0.514,12,15,0.8,113,44,87,0.506,35,59,0.593,9,28,0.321,9,12,0.75,106
1019,MIA,2021-01-18,113,,DET,1,240,43,75,0.573,31,45,0.689,12,30,0.4,15,19,0.789,113,38,82,0.463,25,45,0.556,13,37,0.351,18,24,0.75,107
1020,LAL,2021-01-18,113,,GSW,0,240,40,83,0.482,31,54,0.574,9,29,0.31,24,33,0.727,113,44,87,0.506,32,50,0.64,12,37,0.324,15,20,0.75,115
1021,CHO,2021-01-16,113,@,TOR,0,240,38,87,0.437,23,51,0.451,15,36,0.417,22,29,0.759,113,36,86,0.419,15,37,0.405,21,49,0.429,23,26,0.885,116
1022,CHO,2021-01-09,113,,ATL,1,240,40,77,0.519,25,44,0.568,15,33,0.455,18,24,0.75,113,34,89,0.382,20,44,0.455,14,45,0.311,23,28,0.821,105
1023,LAC,2021-01-05,113,,SAS,0,240,43,86,0.5,28,51,0.549,15,35,0.429,12,13,0.923,113,44,96,0.458,24,56,0.429,20,40,0.5,8,11,0.727,116
1024,NYK,2021-01-04,113,@,ATL,1,240,43,85,0.506,36,64,0.563,7,21,0.333,20,25,0.8,113,40,87,0.46,30,56,0.536,10,31,0.323,18,23,0.783,108
1025,DAL,2021-01-04,113,@,HOU,1,240,39,82,0.476,23,43,0.535,16,39,0.41,19,20,0.95,113,30,77,0.39,19,37,0.514,11,40,0.275,29,36,0.806,100
1026,NOP,2020-12-31,113,@,OKC,1,240,44,91,0.484,31,55,0.564,13,36,0.361,12,19,0.632,113,30,80,0.375,15,32,0.469,15,48,0.313,5,15,0.333,80
1027,WAS,2020-12-27,113,,ORL,0,240,47,97,0.485,39,65,0.6,8,32,0.25,11,13,0.846,113,37,85,0.435,28,60,0.467,9,25,0.36,37,38,0.974,120
1028,NOP,2020-12-23,113,@,TOR,1,240,42,80,0.525,23,38,0.605,19,42,0.452,10,20,0.5,113,38,89,0.427,24,43,0.558,14,46,0.304,9,12,0.75,99
1029,ORL,2020-12-23,113,,MIA,1,240,42,88,0.477,32,60,0.533,10,28,0.357,19,30,0.633,113,42,83,0.506,35,63,0.556,7,20,0.35,16,19,0.842,107
1030,PHI,2020-12-23,113,,WAS,1,240,41,87,0.471,33,59,0.559,8,28,0.286,23,30,0.767,113,39,85,0.459,26,58,0.448,13,27,0.481,16,23,0.696,107
1031,MIL,2021-05-16,112,@,CHI,0,240,38,90,0.422,26,53,0.491,12,37,0.324,24,32,0.75,112,45,87,0.517,31,55,0.564,14,32,0.438,14,19,0.737,118
1032,LAC,2021-05-16,112,@,OKC,0,240,45,106,0.425,35,63,0.556,10,43,0.233,12,15,0.8,112,50,94,0.532,42,68,0.618,8,26,0.308,9,16,0.563,117
1033,CHO,2021-05-11,112,,DEN,0,240,42,91,0.462,31,52,0.596,11,39,0.282,17,20,0.85,112,41,83,0.494,28,50,0.56,13,33,0.394,22,26,0.846,117
1034,NOP,2021-05-09,112,@,CHO,1,240,45,96,0.469,33,59,0.559,12,37,0.324,10,22,0.455,112,42,95,0.442,29,58,0.5,13,37,0.351,13,18,0.722,110
1035,ORL,2021-05-07,112,@,CHO,0,240,41,98,0.418,32,68,0.471,9,30,0.3,21,28,0.75,112,44,89,0.494,35,56,0.625,9,33,0.273,25,33,0.758,122
1036,MIN,2021-05-07,112,@,MIA,0,240,41,85,0.482,31,48,0.646,10,37,0.27,20,30,0.667,112,44,87,0.506,31,55,0.564,13,32,0.406,20,27,0.741,121
1037,DET,2021-05-03,112,,ORL,0,240,44,93,0.473,33,58,0.569,11,35,0.314,13,18,0.722,112,45,88,0.511,35,65,0.538,10,23,0.435,19,25,0.76,119
1038,ORL,2021-05-01,112,,MEM,1,240,38,85,0.447,27,60,0.45,11,25,0.44,25,28,0.893,112,44,96,0.458,34,67,0.507,10,29,0.345,13,21,0.619,111
1039,NOP,2021-04-28,112,@,DEN,0,240,43,87,0.494,31,57,0.544,12,30,0.4,14,19,0.737,112,43,85,0.506,33,53,0.623,10,32,0.313,18,23,0.783,114
1040,IND,2021-04-27,112,,POR,0,240,40,86,0.465,30,56,0.536,10,30,0.333,22,28,0.786,112,50,106,0.472,30,71,0.423,20,35,0.571,13,16,0.813,133
1041,TOR,2021-04-26,112,,CLE,1,240,43,79,0.544,35,50,0.7,8,29,0.276,18,20,0.9,112,36,83,0.434,26,45,0.578,10,38,0.263,14,16,0.875,96
1042,ORL,2021-04-25,112,,IND,0,240,40,101,0.396,30,69,0.435,10,32,0.313,22,28,0.786,112,50,91,0.549,35,59,0.593,15,32,0.469,16,18,0.889,131
1043,UTA,2021-04-21,112,@,HOU,1,240,41,90,0.456,24,44,0.545,17,46,0.37,13,16,0.813,112,35,99,0.354,25,50,0.5,10,49,0.204,9,17,0.529,89
1044,POR,2021-04-20,112,,LAC,0,240,42,94,0.447,28,50,0.56,14,44,0.318,14,19,0.737,112,45,90,0.5,34,52,0.654,11,38,0.289,12,15,0.8,113
1045,ATL,2021-04-20,112,,ORL,1,240,39,94,0.415,30,60,0.5,9,34,0.265,25,29,0.862,112,34,86,0.395,26,49,0.531,8,37,0.216,20,29,0.69,96
1046,NOP,2021-04-18,112,@,NYK,0,265,41,101,0.406,35,74,0.473,6,27,0.222,24,30,0.8,112,45,95,0.474,34,66,0.515,11,29,0.379,21,24,0.875,122
1047,TOR,2021-04-18,112,,OKC,1,240,37,96,0.385,20,58,0.345,17,38,0.447,21,24,0.875,112,37,82,0.451,23,49,0.469,14,33,0.424,18,21,0.857,106
1048,SAS,2021-04-14,112,@,TOR,0,240,38,89,0.427,21,50,0.42,17,39,0.436,19,27,0.704,112,41,88,0.466,27,58,0.466,14,30,0.467,21,25,0.84,117
1049,SAC,2021-04-10,112,@,UTA,0,240,42,88,0.477,28,46,0.609,14,42,0.333,14,22,0.636,112,40,88,0.455,22,38,0.579,18,50,0.36,30,35,0.857,128
1050,MIA,2021-04-06,112,,MEM,0,240,44,82,0.537,31,49,0.633,13,33,0.394,11,18,0.611,112,46,84,0.548,29,43,0.674,17,41,0.415,15,20,0.75,124
1051,NYK,2021-04-05,112,@,BRK,0,240,40,86,0.465,26,57,0.456,14,29,0.483,18,22,0.818,112,42,92,0.457,32,60,0.533,10,32,0.313,20,26,0.769,114
1052,MIL,2021-03-31,112,@,LAL,1,240,42,79,0.532,28,53,0.528,14,26,0.538,14,18,0.778,112,35,87,0.402,25,51,0.49,10,36,0.278,17,22,0.773,97
1053,BRK,2021-03-29,112,,MIN,1,240,40,85,0.471,30,55,0.545,10,30,0.333,22,25,0.88,112,40,103,0.388,26,59,0.441,14,44,0.318,13,17,0.765,107
1054,NOP,2021-03-27,112,,DAL,1,240,42,81,0.519,33,55,0.6,9,26,0.346,19,29,0.655,112,37,83,0.446,27,52,0.519,10,31,0.323,19,24,0.792,103
1055,PHI,2021-03-27,112,@,LAC,0,240,39,77,0.506,29,51,0.569,10,26,0.385,24,33,0.727,112,45,85,0.529,34,59,0.576,11,26,0.423,21,27,0.778,122
1056,POR,2021-03-26,112,@,ORL,1,240,40,85,0.471,22,45,0.489,18,40,0.45,14,21,0.667,112,42,95,0.442,30,68,0.441,12,27,0.444,9,17,0.529,105
1057,ORL,2021-03-24,112,,PHO,1,240,42,90,0.467,29,53,0.547,13,37,0.351,15,19,0.789,112,40,90,0.444,29,57,0.509,11,33,0.333,20,22,0.909,111
1058,POR,2021-03-23,112,,BRK,0,240,36,90,0.4,17,35,0.486,19,55,0.345,21,23,0.913,112,43,87,0.494,34,57,0.596,9,30,0.3,21,27,0.778,116
1059,OKC,2021-03-22,112,@,MIN,1,240,41,87,0.471,20,50,0.4,21,37,0.568,9,10,0.9,112,38,92,0.413,24,53,0.453,14,39,0.359,13,18,0.722,103
1060,HOU,2021-03-21,112,,OKC,0,240,39,79,0.494,25,41,0.61,14,38,0.368,20,27,0.741,112,42,91,0.462,29,52,0.558,13,39,0.333,17,25,0.68,114
1061,BOS,2021-03-21,112,,ORL,1,240,40,88,0.455,17,33,0.515,23,55,0.418,9,9,1.0,112,32,84,0.381,21,50,0.42,11,34,0.324,21,30,0.7,96
1062,TOR,2021-03-19,112,,UTA,0,240,40,83,0.482,19,39,0.487,21,44,0.477,11,14,0.786,112,34,74,0.459,22,37,0.595,12,37,0.324,35,41,0.854,115
1063,TOR,2021-03-17,112,@,DET,0,240,37,86,0.43,25,46,0.543,12,40,0.3,26,34,0.765,112,38,75,0.507,26,46,0.565,12,29,0.414,28,32,0.875,116
1064,NYK,2021-03-15,112,@,BRK,0,240,37,92,0.402,22,50,0.44,15,42,0.357,23,27,0.852,112,44,76,0.579,32,47,0.681,12,29,0.414,17,22,0.773,117
1065,POR,2021-03-14,112,@,MIN,0,240,39,89,0.438,22,44,0.5,17,45,0.378,17,21,0.81,112,36,73,0.493,23,35,0.657,13,38,0.342,29,39,0.744,114
1066,WAS,2021-03-10,112,@,MEM,0,240,38,95,0.4,27,59,0.458,11,36,0.306,25,27,0.926,112,50,99,0.505,42,76,0.553,8,23,0.348,19,29,0.655,127
1067,MIL,2021-03-04,112,@,MEM,1,240,42,95,0.442,32,61,0.525,10,34,0.294,18,22,0.818,112,40,101,0.396,32,67,0.478,8,34,0.235,23,24,0.958,111
1068,ORL,2021-03-03,112,,ATL,0,240,36,84,0.429,23,49,0.469,13,35,0.371,27,27,1.0,112,38,85,0.447,17,40,0.425,21,45,0.467,18,19,0.947,115
1069,LAC,2021-03-02,112,@,BOS,0,240,43,87,0.494,25,49,0.51,18,38,0.474,8,9,0.889,112,42,86,0.488,26,54,0.481,16,32,0.5,17,23,0.739,117
1070,CHI,2021-03-01,112,,DEN,0,240,42,94,0.447,30,56,0.536,12,38,0.316,16,22,0.727,112,46,87,0.529,36,60,0.6,10,27,0.37,16,20,0.8,118
1071,MIN,2021-02-27,112,@,WAS,0,240,41,95,0.432,30,60,0.5,11,35,0.314,19,29,0.655,112,44,98,0.449,31,65,0.477,13,33,0.394,27,34,0.794,128
1072,CLE,2021-02-27,112,@,PHI,1,265,41,97,0.423,33,73,0.452,8,24,0.333,22,29,0.759,112,38,83,0.458,28,55,0.509,10,28,0.357,23,35,0.657,109
1073,IND,2021-02-26,112,@,BOS,0,240,35,89,0.393,20,43,0.465,15,46,0.326,27,29,0.931,112,42,82,0.512,33,60,0.55,9,22,0.409,25,29,0.862,118
1074,WAS,2021-02-25,112,@,DEN,1,240,41,86,0.477,33,60,0.55,8,26,0.308,22,25,0.88,112,37,85,0.435,22,47,0.468,15,38,0.395,21,24,0.875,110
1075,BOS,2021-02-24,112,@,ATL,0,240,42,95,0.442,34,64,0.531,8,31,0.258,20,23,0.87,112,45,85,0.529,22,43,0.512,23,42,0.548,14,17,0.824,127
1076,CLE,2021-02-24,112,,HOU,1,240,43,85,0.506,27,49,0.551,16,36,0.444,10,15,0.667,112,36,90,0.4,26,57,0.456,10,33,0.303,14,17,0.824,96
1077,MIN,2021-02-23,112,@,MIL,0,240,42,98,0.429,23,44,0.523,19,54,0.352,9,9,1.0,112,53,99,0.535,33,57,0.579,20,42,0.476,13,18,0.722,139
1078,CLE,2021-02-23,112,,ATL,1,240,41,78,0.526,26,50,0.52,15,28,0.536,15,19,0.789,112,40,89,0.449,26,58,0.448,14,31,0.452,17,23,0.739,111
1079,BRK,2021-02-21,112,@,LAC,1,240,44,92,0.478,33,54,0.611,11,38,0.289,13,19,0.684,112,40,87,0.46,25,52,0.481,15,35,0.429,13,18,0.722,108
1080,UTA,2021-02-19,112,@,LAC,0,240,41,86,0.477,29,52,0.558,12,34,0.353,18,21,0.857,112,43,89,0.483,33,59,0.559,10,30,0.333,20,22,0.909,116
1081,PHI,2021-02-19,112,,CHI,1,240,41,87,0.471,34,66,0.515,7,21,0.333,23,29,0.793,112,40,95,0.421,33,63,0.524,7,32,0.219,18,18,1.0,105
1082,MIA,2021-02-17,112,@,GSW,0,265,44,97,0.454,31,61,0.508,13,36,0.361,11,12,0.917,112,43,95,0.453,25,43,0.581,18,52,0.346,16,21,0.762,120
1083,LAL,2021-02-16,112,@,MIN,1,240,42,77,0.545,31,51,0.608,11,26,0.423,17,21,0.81,112,39,93,0.419,23,59,0.39,16,34,0.471,10,13,0.769,104
1084,BOS,2021-02-16,112,,DEN,1,240,39,81,0.481,24,39,0.615,15,42,0.357,19,21,0.905,112,38,84,0.452,29,50,0.58,9,34,0.265,14,15,0.933,99
1085,IND,2021-02-15,112,,CHI,0,265,39,92,0.424,30,59,0.508,9,33,0.273,25,31,0.806,112,44,102,0.431,31,69,0.449,13,33,0.394,19,22,0.864,120
1086,ATL,2021-02-15,112,@,NYK,0,240,36,85,0.424,25,52,0.481,11,33,0.333,29,32,0.906,112,42,83,0.506,25,49,0.51,17,34,0.5,22,27,0.815,123
1087,TOR,2021-02-14,112,,MIN,0,240,38,91,0.418,28,58,0.483,10,33,0.303,26,31,0.839,112,43,82,0.524,27,43,0.628,16,39,0.41,14,19,0.737,116
1088,NOP,2021-02-14,112,@,DET,0,240,40,90,0.444,31,55,0.564,9,35,0.257,23,28,0.821,112,45,84,0.536,28,49,0.571,17,35,0.486,16,20,0.8,123
1089,UTA,2021-02-13,112,,MIA,1,240,39,85,0.459,27,39,0.692,12,46,0.261,22,29,0.759,112,35,86,0.407,23,50,0.46,12,36,0.333,12,17,0.706,94
1090,SAC,2021-02-12,112,,ORL,0,240,43,83,0.518,31,50,0.62,12,33,0.364,14,19,0.737,112,46,91,0.505,31,57,0.544,15,34,0.441,16,20,0.8,123
1091,MIN,2021-02-10,112,,LAC,0,240,41,95,0.432,26,54,0.481,15,41,0.366,15,19,0.789,112,41,82,0.5,29,59,0.492,12,23,0.522,25,29,0.862,119
1092,OKC,2021-02-08,112,@,LAL,0,265,43,110,0.391,31,72,0.431,12,38,0.316,14,19,0.737,112,44,95,0.463,35,57,0.614,9,38,0.237,22,29,0.759,119
1093,DEN,2021-02-08,112,,MIL,0,240,41,94,0.436,26,58,0.448,15,36,0.417,15,16,0.938,112,45,89,0.506,29,49,0.592,16,40,0.4,19,22,0.864,125
1094,UTA,2021-02-04,112,@,ATL,1,240,44,91,0.484,31,64,0.484,13,27,0.481,11,13,0.846,112,32,98,0.327,23,67,0.343,9,31,0.29,18,19,0.947,91
1095,SAS,2021-01-30,112,,MEM,0,240,39,83,0.47,26,54,0.481,13,29,0.448,21,26,0.808,112,51,91,0.56,34,56,0.607,17,35,0.486,10,15,0.667,129
1096,NOP,2021-01-30,112,,HOU,0,240,41,91,0.451,29,50,0.58,12,41,0.293,18,29,0.621,112,45,92,0.489,25,46,0.543,20,46,0.435,16,20,0.8,126
1097,PHO,2021-01-23,112,,DEN,0,290,41,102,0.402,25,49,0.51,16,53,0.302,14,18,0.778,112,40,97,0.412,25,61,0.41,15,36,0.417,25,32,0.781,120
1098,IND,2021-01-20,112,,DAL,0,240,41,92,0.446,25,53,0.472,16,39,0.41,14,21,0.667,112,51,97,0.526,43,70,0.614,8,27,0.296,14,17,0.824,124
1099,POR,2021-01-16,112,,ATL,1,240,40,103,0.388,25,59,0.424,15,44,0.341,17,20,0.85,112,38,87,0.437,32,57,0.561,6,30,0.2,24,28,0.857,106
1100,LAL,2021-01-15,112,,NOP,1,240,39,93,0.419,24,56,0.429,15,37,0.405,19,26,0.731,112,41,86,0.477,32,57,0.561,9,29,0.31,4,8,0.5,95
1101,MIL,2021-01-15,112,,DAL,1,240,43,96,0.448,29,59,0.492,14,37,0.378,12,25,0.48,112,45,97,0.464,32,61,0.525,13,36,0.361,6,13,0.462,109
1102,SAS,2021-01-12,112,@,OKC,1,240,41,95,0.432,31,60,0.517,10,35,0.286,20,22,0.909,112,36,83,0.434,29,57,0.509,7,26,0.269,23,29,0.793,102
1103,POR,2021-01-11,112,,TOR,1,240,38,83,0.458,24,41,0.585,14,42,0.333,22,25,0.88,112,40,89,0.449,21,42,0.5,19,47,0.404,12,12,1.0,111
1104,ATL,2021-01-11,112,,PHI,1,240,37,99,0.374,20,55,0.364,17,44,0.386,21,27,0.778,112,37,92,0.402,29,56,0.518,8,36,0.222,12,13,0.923,94
1105,DAL,2021-01-09,112,,ORL,1,240,39,79,0.494,19,39,0.487,20,40,0.5,14,18,0.778,112,38,89,0.427,32,58,0.552,6,31,0.194,16,22,0.727,98
1106,NYK,2021-01-06,112,,UTA,1,240,45,87,0.517,37,65,0.569,8,22,0.364,14,19,0.737,112,40,91,0.44,26,47,0.553,14,44,0.318,6,11,0.545,100
1107,LAC,2021-01-03,112,@,PHO,1,240,40,83,0.482,23,54,0.426,17,29,0.586,15,19,0.789,112,37,75,0.493,27,42,0.643,10,33,0.303,23,28,0.821,107
1108,CHO,2021-01-02,112,@,PHI,0,240,38,92,0.413,25,57,0.439,13,35,0.371,23,26,0.885,112,47,79,0.595,31,44,0.705,16,35,0.457,17,24,0.708,127
1109,MEM,2020-12-26,112,,ATL,0,240,37,93,0.398,24,50,0.48,13,43,0.302,25,29,0.862,112,38,89,0.427,25,53,0.472,13,36,0.361,33,38,0.868,122
1110,IND,2021-05-10,111,@,CLE,1,240,44,88,0.5,33,61,0.541,11,27,0.407,12,16,0.75,111,33,93,0.355,20,54,0.37,13,39,0.333,23,30,0.767,102
1111,DET,2021-05-06,111,,MEM,1,240,44,83,0.53,33,55,0.6,11,28,0.393,12,14,0.857,111,38,89,0.427,28,52,0.538,10,37,0.27,11,17,0.647,97
1112,CHO,2021-05-02,111,,MIA,0,240,40,81,0.494,26,48,0.542,14,33,0.424,17,22,0.773,111,45,88,0.511,34,50,0.68,11,38,0.289,20,27,0.741,121
1113,SAC,2021-05-02,111,@,DAL,1,240,45,81,0.556,34,53,0.642,11,28,0.393,10,16,0.625,111,34,81,0.42,28,46,0.609,6,35,0.171,25,31,0.806,99
1114,SAS,2021-05-02,111,,PHI,0,265,43,96,0.448,31,65,0.477,12,31,0.387,13,17,0.765,111,42,94,0.447,31,64,0.484,11,30,0.367,18,25,0.72,113
1115,MEM,2021-05-01,111,@,ORL,0,240,44,96,0.458,34,67,0.507,10,29,0.345,13,21,0.619,111,38,85,0.447,27,60,0.45,11,25,0.44,25,28,0.893,112
1116,TOR,2021-04-29,111,@,DEN,0,240,40,83,0.482,24,51,0.471,16,32,0.5,15,18,0.833,111,44,93,0.473,32,58,0.552,12,35,0.343,21,26,0.808,121
1117,SAS,2021-04-28,111,@,MIA,0,240,41,88,0.466,31,56,0.554,10,32,0.313,19,24,0.792,111,43,85,0.506,34,60,0.567,9,25,0.36,21,24,0.875,116
1118,CHO,2021-04-28,111,@,BOS,0,240,37,87,0.425,24,52,0.462,13,35,0.371,24,32,0.75,111,44,92,0.478,29,52,0.558,15,40,0.375,17,22,0.773,120
1119,ATL,2021-04-25,111,,MIL,1,240,40,88,0.455,27,53,0.509,13,35,0.371,18,23,0.783,111,39,81,0.481,31,53,0.585,8,28,0.286,18,23,0.783,104
1120,UTA,2021-04-19,111,@,LAL,1,240,43,75,0.573,28,42,0.667,15,33,0.455,10,11,0.909,111,34,79,0.43,22,51,0.431,12,28,0.429,17,25,0.68,97
1121,SAS,2021-04-17,111,@,PHO,1,240,45,89,0.506,33,60,0.55,12,29,0.414,9,12,0.75,111,36,90,0.4,30,63,0.476,6,27,0.222,7,16,0.438,85
1122,IND,2021-04-16,111,@,UTA,0,240,41,105,0.39,28,66,0.424,13,39,0.333,16,17,0.941,111,42,87,0.483,26,45,0.578,16,42,0.381,19,24,0.792,119
1123,MIA,2021-04-16,111,@,MIN,0,240,39,80,0.488,25,46,0.543,14,34,0.412,19,26,0.731,111,42,81,0.519,27,45,0.6,15,36,0.417,20,29,0.69,119
1124,SAC,2021-04-14,111,,WAS,0,240,42,91,0.462,33,64,0.516,9,27,0.333,18,24,0.75,111,47,90,0.522,40,66,0.606,7,24,0.292,22,27,0.815,123
1125,NYK,2021-04-12,111,,LAL,1,240,42,89,0.472,37,62,0.597,5,27,0.185,22,27,0.815,111,35,80,0.438,23,44,0.523,12,36,0.333,14,18,0.778,96
1126,IND,2021-04-09,111,@,ORL,1,240,38,92,0.413,27,59,0.458,11,33,0.333,24,28,0.857,111,38,90,0.422,32,66,0.485,6,24,0.25,24,31,0.774,106
1127,NOP,2021-04-07,111,@,BRK,0,240,38,89,0.427,32,62,0.516,6,27,0.222,29,39,0.744,111,51,92,0.554,32,51,0.627,19,41,0.463,18,22,0.818,139
1128,DAL,2021-04-05,111,,UTA,1,240,41,91,0.451,18,42,0.429,23,49,0.469,6,8,0.75,111,37,88,0.42,25,44,0.568,12,44,0.273,17,22,0.773,103
1129,GSW,2021-04-04,111,@,ATL,0,240,43,92,0.467,33,52,0.635,10,40,0.25,15,21,0.714,111,35,81,0.432,23,49,0.469,12,32,0.375,35,45,0.778,117
1130,BRK,2021-04-01,111,,CHO,1,240,44,91,0.484,24,46,0.522,20,45,0.444,3,4,0.75,111,30,86,0.349,17,48,0.354,13,38,0.342,16,19,0.842,89
1131,UTA,2021-03-31,111,@,MEM,1,240,38,89,0.427,22,40,0.55,16,49,0.327,19,25,0.76,111,42,90,0.467,37,72,0.514,5,18,0.278,18,23,0.783,107
1132,BOS,2021-03-27,111,@,OKC,1,240,44,96,0.458,32,58,0.552,12,38,0.316,11,14,0.786,111,34,83,0.41,23,45,0.511,11,38,0.289,15,24,0.625,94
1133,DET,2021-03-26,111,,BRK,0,240,33,73,0.452,22,42,0.524,11,31,0.355,34,47,0.723,111,37,84,0.44,24,51,0.471,13,33,0.394,26,34,0.765,113
1134,DET,2021-03-24,111,@,IND,0,240,44,83,0.53,33,55,0.6,11,28,0.393,12,19,0.632,111,45,97,0.464,30,63,0.476,15,34,0.441,11,14,0.786,116
1135,DEN,2021-03-24,111,@,TOR,0,240,41,98,0.418,27,55,0.491,14,43,0.326,15,18,0.833,111,45,89,0.506,21,41,0.512,24,48,0.5,21,23,0.913,135
1136,PHO,2021-03-24,111,@,ORL,0,240,40,90,0.444,29,57,0.509,11,33,0.333,20,22,0.909,111,42,90,0.467,29,53,0.547,13,37,0.351,15,19,0.789,112
1137,LAL,2021-03-23,111,@,NOP,0,240,36,85,0.424,18,48,0.375,18,37,0.486,21,30,0.7,111,47,90,0.522,37,61,0.607,10,29,0.345,24,26,0.923,128
1138,PHO,2021-03-21,111,,LAL,1,240,42,87,0.483,33,55,0.6,9,32,0.281,18,23,0.783,111,35,85,0.412,30,60,0.5,5,25,0.2,19,28,0.679,94
1139,MEM,2021-03-20,111,,GSW,1,240,37,95,0.389,27,63,0.429,10,32,0.313,27,31,0.871,111,31,90,0.344,18,49,0.367,13,41,0.317,28,34,0.824,103
1140,PHO,2021-03-13,111,,IND,0,240,43,91,0.473,31,60,0.517,12,31,0.387,13,17,0.765,111,46,87,0.529,33,59,0.559,13,28,0.464,17,21,0.81,122
1141,MIA,2021-03-11,111,,ORL,1,240,41,91,0.451,25,42,0.595,16,49,0.327,13,22,0.591,111,39,96,0.406,27,62,0.435,12,34,0.353,13,15,0.867,103
1142,MEM,2021-03-04,111,,MIL,0,240,40,101,0.396,32,67,0.478,8,34,0.235,23,24,0.958,111,42,95,0.442,32,61,0.525,10,34,0.294,18,22,0.818,112
1143,CLE,2021-03-03,111,,IND,0,240,43,83,0.518,32,55,0.582,11,28,0.393,14,15,0.933,111,47,83,0.566,39,58,0.672,8,25,0.32,12,16,0.75,114
1144,WAS,2021-03-02,111,,MEM,0,240,41,81,0.506,30,50,0.6,11,31,0.355,18,25,0.72,111,47,95,0.495,34,66,0.515,13,29,0.448,18,23,0.783,125
1145,CHO,2021-03-01,111,@,POR,0,240,43,88,0.489,28,54,0.519,15,34,0.441,10,17,0.588,111,46,86,0.535,22,40,0.55,24,46,0.522,7,10,0.7,123
1146,BOS,2021-02-28,111,,WAS,1,240,42,89,0.472,32,59,0.542,10,30,0.333,17,24,0.708,111,38,84,0.452,29,52,0.558,9,32,0.281,25,29,0.862,110
1147,HOU,2021-02-26,111,@,TOR,0,240,39,91,0.429,23,44,0.523,16,47,0.34,17,20,0.85,111,40,89,0.449,24,48,0.5,16,41,0.39,26,27,0.963,122
1148,PHI,2021-02-25,111,,DAL,1,240,39,90,0.433,27,61,0.443,12,29,0.414,21,25,0.84,111,32,78,0.41,19,44,0.432,13,34,0.382,20,23,0.87,97
1149,GSW,2021-02-24,111,@,IND,1,240,39,83,0.47,34,57,0.596,5,26,0.192,28,31,0.903,111,37,81,0.457,30,52,0.577,7,29,0.241,26,32,0.813,107
1150,DEN,2021-02-23,111,,POR,1,240,40,94,0.426,26,58,0.448,14,36,0.389,17,18,0.944,111,41,87,0.471,27,46,0.587,14,41,0.341,10,10,1.0,106
1151,ATL,2021-02-23,111,@,CLE,0,240,40,89,0.449,26,58,0.448,14,31,0.452,17,23,0.739,111,41,78,0.526,26,50,0.52,15,28,0.536,15,19,0.789,112
1152,POR,2021-02-20,111,,WAS,0,240,37,103,0.359,18,48,0.375,19,55,0.345,18,25,0.72,111,45,89,0.506,39,63,0.619,6,26,0.231,22,29,0.759,118
1153,CLE,2021-02-14,111,@,LAC,0,240,43,93,0.462,36,68,0.529,7,25,0.28,18,25,0.72,111,42,88,0.477,29,58,0.5,13,30,0.433,31,36,0.861,128
1154,PHI,2021-02-13,111,@,PHO,0,240,38,73,0.521,31,56,0.554,7,17,0.412,28,33,0.848,111,48,79,0.608,38,54,0.704,10,25,0.4,14,17,0.824,120
1155,GSW,2021-02-11,111,,ORL,1,240,41,88,0.466,21,38,0.553,20,50,0.4,9,12,0.75,111,38,97,0.392,23,64,0.359,15,33,0.455,14,18,0.778,105
1156,IND,2021-02-11,111,@,DET,1,240,44,86,0.512,30,55,0.545,14,31,0.452,9,10,0.9,111,38,85,0.447,33,57,0.579,5,28,0.179,14,19,0.737,95
1157,BRK,2021-02-09,111,@,DET,0,240,43,86,0.5,32,56,0.571,11,30,0.367,14,16,0.875,111,47,84,0.56,34,55,0.618,13,29,0.448,15,21,0.714,122
1158,SAC,2021-02-09,111,,PHI,0,240,43,99,0.434,29,57,0.509,14,42,0.333,11,19,0.579,111,41,85,0.482,32,65,0.492,9,20,0.45,28,35,0.8,119
1159,SAS,2021-02-06,111,@,HOU,1,240,37,87,0.425,29,62,0.468,8,25,0.32,29,36,0.806,111,38,88,0.432,26,50,0.52,12,38,0.316,18,25,0.72,106
1160,BOS,2021-02-03,111,@,SAC,0,240,39,86,0.453,28,53,0.528,11,33,0.333,22,29,0.759,111,42,92,0.457,29,55,0.527,13,37,0.351,19,23,0.826,116
1161,CHO,2021-02-03,111,,PHI,0,240,39,87,0.448,25,50,0.5,14,37,0.378,19,23,0.826,111,41,79,0.519,31,55,0.564,10,24,0.417,26,32,0.813,118
1162,SAS,2021-02-03,111,,MIN,1,240,43,96,0.448,36,70,0.514,7,26,0.269,18,24,0.75,111,43,94,0.457,30,61,0.492,13,33,0.394,9,11,0.818,108
1163,BOS,2021-02-02,111,@,GSW,1,240,39,84,0.464,26,50,0.52,13,34,0.382,20,27,0.741,111,38,83,0.458,23,46,0.5,15,37,0.405,16,23,0.696,107
1164,PHO,2021-01-30,111,@,DAL,1,240,37,81,0.457,27,59,0.458,10,22,0.455,27,31,0.871,111,44,83,0.53,35,54,0.648,9,29,0.31,8,14,0.571,105
1165,MIN,2021-01-27,111,@,GSW,0,240,37,87,0.425,23,51,0.451,14,36,0.389,23,33,0.697,111,45,85,0.529,30,51,0.588,15,34,0.441,18,23,0.783,123
1166,MIA,2021-01-20,111,@,TOR,1,240,39,80,0.488,21,40,0.525,18,40,0.45,15,17,0.882,111,35,88,0.398,19,39,0.487,16,49,0.327,16,18,0.889,102
1167,TOR,2021-01-14,111,,CHO,1,240,40,88,0.455,20,38,0.526,20,50,0.4,11,13,0.846,111,42,87,0.483,27,52,0.519,15,35,0.429,9,12,0.75,108
1168,IND,2021-01-14,111,@,POR,1,240,44,92,0.478,35,62,0.565,9,30,0.3,14,18,0.778,111,32,87,0.368,19,44,0.432,13,43,0.302,10,10,1.0,87
1169,LAC,2021-01-13,111,,NOP,1,240,35,74,0.473,17,37,0.459,18,37,0.486,23,27,0.852,111,42,88,0.477,32,60,0.533,10,28,0.357,12,16,0.75,106
1170,TOR,2021-01-11,111,@,POR,0,240,40,89,0.449,21,42,0.5,19,47,0.404,12,12,1.0,111,38,83,0.458,24,41,0.585,14,42,0.333,22,25,0.88,112
1171,OKC,2021-01-06,111,@,NOP,1,240,40,87,0.46,21,41,0.512,19,46,0.413,12,16,0.75,111,44,89,0.494,40,67,0.597,4,22,0.182,18,23,0.783,110
1172,CHI,2021-01-05,111,@,POR,1,240,40,91,0.44,24,50,0.48,16,41,0.39,15,18,0.833,111,39,94,0.415,20,43,0.465,19,51,0.373,11,17,0.647,108
1173,PHO,2020-12-29,111,,NOP,1,240,37,84,0.44,18,37,0.486,19,47,0.404,18,19,0.947,111,37,77,0.481,34,53,0.642,3,24,0.125,9,18,0.5,86
1174,IND,2020-12-29,111,,BOS,0,240,43,84,0.512,31,51,0.608,12,33,0.364,13,16,0.813,111,40,80,0.5,31,58,0.534,9,22,0.409,27,37,0.73,116
1175,BRK,2020-12-28,111,,MEM,0,265,41,100,0.41,27,58,0.466,14,42,0.333,15,17,0.882,111,42,98,0.429,32,69,0.464,10,29,0.345,22,29,0.759,116
1176,HOU,2020-12-28,111,@,DEN,0,240,39,86,0.453,23,47,0.489,16,39,0.41,17,23,0.739,111,46,87,0.529,32,56,0.571,14,31,0.452,18,32,0.563,124
1177,UTA,2020-12-26,111,,MIN,0,240,36,94,0.383,26,60,0.433,10,34,0.294,29,37,0.784,111,45,101,0.446,32,72,0.444,13,29,0.448,13,18,0.722,116
1178,MIA,2020-12-25,111,,NOP,1,240,38,75,0.507,22,38,0.579,16,37,0.432,19,23,0.826,111,31,78,0.397,21,43,0.488,10,35,0.286,26,33,0.788,98
1179,MIN,2020-12-23,111,,DET,1,240,38,88,0.432,27,47,0.574,11,41,0.268,24,28,0.857,111,45,93,0.484,37,58,0.638,8,35,0.229,3,8,0.375,101
1180,CHO,2021-05-16,110,@,WAS,0,240,37,94,0.394,23,49,0.469,14,45,0.311,22,24,0.917,110,44,91,0.484,34,60,0.567,10,31,0.323,17,21,0.81,115
1181,LAL,2021-05-16,110,@,NOP,1,240,45,96,0.469,34,61,0.557,11,35,0.314,9,15,0.6,110,37,78,0.474,28,53,0.528,9,25,0.36,15,21,0.714,98
1182,TOR,2021-05-14,110,@,DAL,0,240,42,85,0.494,29,47,0.617,13,38,0.342,13,17,0.765,110,39,90,0.433,22,48,0.458,17,42,0.405,19,21,0.905,114
1183,SAC,2021-05-13,110,@,MEM,0,240,42,96,0.438,25,55,0.455,17,41,0.415,9,14,0.643,110,45,90,0.5,34,57,0.596,11,33,0.333,15,18,0.833,116
1184,NOP,2021-05-10,110,@,MEM,0,240,43,97,0.443,33,74,0.446,10,23,0.435,14,21,0.667,110,45,91,0.495,36,61,0.59,9,30,0.3,16,27,0.593,115
1185,CHO,2021-05-09,110,,NOP,0,240,42,95,0.442,29,58,0.5,13,37,0.351,13,18,0.722,110,45,96,0.469,33,59,0.559,12,37,0.324,10,22,0.455,112
1186,PHO,2021-05-09,110,@,LAL,0,240,39,73,0.534,28,48,0.583,11,25,0.44,21,25,0.84,110,39,80,0.488,26,50,0.52,13,30,0.433,32,41,0.78,123
1187,DAL,2021-05-07,110,,CLE,1,240,41,83,0.494,31,51,0.608,10,32,0.313,18,22,0.818,110,32,83,0.386,26,54,0.481,6,29,0.207,20,26,0.769,90
1188,UTA,2021-05-03,110,,SAS,1,240,44,88,0.5,33,52,0.635,11,36,0.306,11,16,0.688,110,42,90,0.467,37,72,0.514,5,18,0.278,10,10,1.0,99
1189,DEN,2021-05-01,110,@,LAC,1,240,39,80,0.488,27,48,0.563,12,32,0.375,20,21,0.952,110,36,83,0.434,22,49,0.449,14,34,0.412,18,24,0.75,104
1190,SAC,2021-04-30,110,@,LAL,1,240,39,86,0.453,27,53,0.509,12,33,0.364,20,22,0.909,110,42,83,0.506,35,55,0.636,7,28,0.25,15,21,0.714,106
1191,NYK,2021-04-26,110,,PHO,0,240,45,87,0.517,33,58,0.569,12,29,0.414,8,10,0.8,110,45,83,0.542,31,49,0.633,14,34,0.412,14,17,0.824,118
1192,CHI,2021-04-26,110,@,MIA,1,240,41,77,0.532,30,48,0.625,11,29,0.379,17,22,0.773,110,36,84,0.429,29,48,0.604,7,36,0.194,23,25,0.92,102
1193,CLE,2021-04-25,110,@,WAS,0,240,40,78,0.513,30,51,0.588,10,27,0.37,20,25,0.8,110,43,89,0.483,31,58,0.534,12,31,0.387,21,26,0.808,119
1194,SAS,2021-04-24,110,@,NOP,1,240,37,85,0.435,28,54,0.519,9,31,0.29,27,32,0.844,110,41,87,0.471,32,65,0.492,9,22,0.409,17,32,0.531,108
1195,LAL,2021-04-22,110,@,DAL,0,240,43,90,0.478,33,60,0.55,10,30,0.333,14,17,0.824,110,40,82,0.488,31,58,0.534,9,24,0.375,26,36,0.722,115
1196,ORL,2021-04-18,110,,HOU,0,240,41,91,0.451,30,59,0.508,11,32,0.344,17,19,0.895,110,42,82,0.512,26,48,0.542,16,34,0.471,14,20,0.7,114
1197,DET,2021-04-16,110,,OKC,1,240,38,90,0.422,28,55,0.509,10,35,0.286,24,34,0.706,110,39,97,0.402,32,58,0.552,7,39,0.179,19,26,0.731,104
1198,SAC,2021-04-12,110,@,NOP,0,240,39,90,0.433,29,55,0.527,10,35,0.286,22,37,0.595,110,42,77,0.545,36,58,0.621,6,19,0.316,27,39,0.692,117
1199,WAS,2021-04-09,110,@,GSW,1,240,43,89,0.483,38,70,0.543,5,19,0.263,19,24,0.792,110,41,88,0.466,30,52,0.577,11,36,0.306,14,21,0.667,107
1200,MIA,2021-04-08,110,,LAL,1,240,34,71,0.479,24,46,0.522,10,25,0.4,32,40,0.8,110,35,79,0.443,23,44,0.523,12,35,0.343,22,25,0.88,104
1201,LAL,2021-04-06,110,@,TOR,1,240,39,79,0.494,21,39,0.538,18,40,0.45,14,22,0.636,110,36,91,0.396,31,58,0.534,5,33,0.152,24,30,0.8,101
1202,NOP,2021-04-01,110,,ORL,0,265,41,93,0.441,29,64,0.453,12,29,0.414,16,19,0.842,110,45,106,0.425,40,81,0.494,5,25,0.2,20,23,0.87,115
1203,ATL,2021-03-30,110,@,PHO,0,240,41,85,0.482,28,53,0.528,13,32,0.406,15,21,0.714,110,45,88,0.511,33,56,0.589,12,32,0.375,15,18,0.833,117
1204,HOU,2021-03-29,110,,MEM,0,240,40,94,0.426,29,52,0.558,11,42,0.262,19,22,0.864,110,46,85,0.541,35,54,0.648,11,31,0.355,17,24,0.708,120
1205,MEM,2021-03-27,110,@,UTA,0,240,39,97,0.402,30,64,0.469,9,33,0.273,23,30,0.767,110,46,92,0.5,27,47,0.574,19,45,0.422,15,20,0.75,126
1206,CHO,2021-03-26,110,,MIA,1,240,39,79,0.494,21,36,0.583,18,43,0.419,14,19,0.737,110,40,87,0.46,25,44,0.568,15,43,0.349,10,20,0.5,105
1207,SAC,2021-03-24,110,,ATL,1,240,40,84,0.476,30,54,0.556,10,30,0.333,20,22,0.909,110,41,85,0.482,34,60,0.567,7,25,0.28,19,23,0.826,108
1208,PHO,2021-03-23,110,@,MIA,1,240,45,91,0.495,33,54,0.611,12,37,0.324,8,9,0.889,110,36,86,0.419,23,50,0.46,13,36,0.361,15,17,0.882,100
1209,DEN,2021-03-23,110,@,ORL,1,240,45,91,0.495,37,61,0.607,8,30,0.267,12,13,0.923,110,39,88,0.443,28,54,0.519,11,34,0.324,10,14,0.714,99
1210,ATL,2021-03-22,110,@,LAC,0,240,43,95,0.453,31,61,0.508,12,34,0.353,12,16,0.75,110,42,85,0.494,25,47,0.532,17,38,0.447,18,20,0.9,119
1211,MIA,2021-03-19,110,,IND,0,240,41,92,0.446,32,58,0.552,9,34,0.265,19,20,0.95,110,52,89,0.584,32,53,0.604,20,36,0.556,13,19,0.684,137
1212,CLE,2021-03-19,110,,SAS,0,240,39,89,0.438,32,62,0.516,7,27,0.259,25,32,0.781,110,41,88,0.466,34,70,0.486,7,18,0.389,27,33,0.818,116
1213,BOS,2021-03-17,110,@,CLE,0,240,40,88,0.455,30,50,0.6,10,38,0.263,20,29,0.69,110,40,74,0.541,30,51,0.588,10,23,0.435,27,33,0.818,117
1214,WAS,2021-02-28,110,@,BOS,0,240,38,84,0.452,29,52,0.558,9,32,0.281,25,29,0.862,110,42,89,0.472,32,59,0.542,10,30,0.333,17,24,0.708,111
1215,NYK,2021-02-27,110,,IND,1,240,40,81,0.494,28,57,0.491,12,24,0.5,18,22,0.818,110,38,84,0.452,27,56,0.482,11,28,0.393,20,25,0.8,107
1216,SAC,2021-02-26,110,@,DET,1,240,37,89,0.416,30,57,0.526,7,32,0.219,29,41,0.707,110,37,82,0.451,25,49,0.51,12,33,0.364,21,32,0.656,107
1217,DEN,2021-02-25,110,,WAS,0,240,37,85,0.435,22,47,0.468,15,38,0.395,21,24,0.875,110,41,86,0.477,33,60,0.55,8,26,0.308,22,25,0.88,112
1218,DAL,2021-02-23,110,,BOS,1,240,42,89,0.472,29,56,0.518,13,33,0.394,13,15,0.867,110,41,86,0.477,29,47,0.617,12,39,0.308,13,18,0.722,107
1219,CHO,2021-02-22,110,@,UTA,0,240,41,89,0.461,30,53,0.566,11,36,0.306,17,21,0.81,110,45,85,0.529,17,30,0.567,28,55,0.509,14,17,0.824,132
1220,TOR,2021-02-21,110,,PHI,1,240,40,81,0.494,26,47,0.553,14,34,0.412,16,18,0.889,110,33,85,0.388,22,48,0.458,11,37,0.297,26,35,0.743,103
1221,SAC,2021-02-18,110,,MIA,0,240,43,93,0.462,28,52,0.538,15,41,0.366,9,16,0.563,110,49,95,0.516,37,61,0.607,12,34,0.353,8,10,0.8,118
1222,TOR,2021-02-18,110,@,MIL,1,240,38,78,0.487,26,43,0.605,12,35,0.343,22,23,0.957,110,35,88,0.398,25,54,0.463,10,34,0.294,16,23,0.696,96
1223,CHO,2021-02-14,110,,SAS,0,240,45,95,0.474,33,61,0.541,12,34,0.353,8,11,0.727,110,48,96,0.5,38,62,0.613,10,34,0.294,16,19,0.842,122
1224,SAC,2021-02-14,110,,MEM,0,240,41,82,0.5,33,49,0.673,8,33,0.242,20,26,0.769,110,50,94,0.532,41,73,0.562,9,21,0.429,15,19,0.789,124
1225,CLE,2021-02-12,110,@,POR,0,240,38,87,0.437,30,64,0.469,8,23,0.348,26,37,0.703,110,43,83,0.518,30,48,0.625,13,35,0.371,30,33,0.909,129
1226,LAC,2021-02-07,110,,SAC,0,240,41,99,0.414,33,71,0.465,8,28,0.286,20,23,0.87,110,46,94,0.489,36,65,0.554,10,29,0.345,11,15,0.733,113
1227,NYK,2021-02-06,110,,POR,1,240,44,88,0.5,31,58,0.534,13,30,0.433,9,13,0.692,110,37,89,0.416,20,42,0.476,17,47,0.362,8,16,0.5,99
1228,IND,2021-02-03,110,@,MIL,0,240,43,95,0.453,32,61,0.525,11,34,0.324,13,15,0.867,110,48,102,0.471,27,54,0.5,21,48,0.438,13,14,0.929,130
1229,CHI,2021-02-01,110,,NYK,1,240,42,88,0.477,31,54,0.574,11,34,0.324,15,20,0.75,110,37,87,0.425,31,58,0.534,6,29,0.207,22,26,0.846,102
1230,IND,2021-01-31,110,,PHI,0,240,41,84,0.488,31,56,0.554,10,28,0.357,18,22,0.818,110,45,92,0.489,37,66,0.561,8,26,0.308,21,31,0.677,119
1231,SAS,2021-01-27,110,,BOS,1,240,46,82,0.561,38,54,0.704,8,28,0.286,10,16,0.625,110,42,98,0.429,32,68,0.471,10,30,0.333,12,14,0.857,106
1232,DET,2021-01-23,110,,PHI,0,240,37,86,0.43,23,53,0.434,14,33,0.424,22,30,0.733,110,38,83,0.458,30,60,0.5,8,23,0.348,30,38,0.789,114
1233,NOP,2021-01-23,110,@,MIN,0,240,40,87,0.46,30,54,0.556,10,33,0.303,20,28,0.714,110,39,91,0.429,27,57,0.474,12,34,0.353,30,37,0.811,120
1234,BOS,2021-01-22,110,@,PHI,0,240,41,90,0.456,29,60,0.483,12,30,0.4,16,20,0.8,110,45,81,0.556,33,53,0.623,12,28,0.429,20,24,0.833,122
1235,CHO,2021-01-22,110,,CHI,0,240,42,85,0.494,35,53,0.66,7,32,0.219,19,25,0.76,110,49,96,0.51,34,53,0.642,15,43,0.349,10,12,0.833,123
1236,MIL,2021-01-13,110,@,DET,1,240,41,85,0.482,22,42,0.524,19,43,0.442,9,14,0.643,110,36,92,0.391,22,57,0.386,14,35,0.4,15,22,0.682,101
1237,NOP,2021-01-08,110,,CHO,0,240,38,77,0.494,23,39,0.59,15,38,0.395,19,26,0.731,110,41,87,0.471,25,45,0.556,16,42,0.381,20,25,0.8,118
1238,BRK,2021-01-08,110,@,MEM,0,240,38,81,0.469,24,50,0.48,14,31,0.452,20,21,0.952,110,45,98,0.459,32,66,0.485,13,32,0.406,12,14,0.857,115
1239,DET,2021-01-08,110,,PHO,1,265,37,90,0.411,26,56,0.464,11,34,0.324,25,29,0.862,110,41,91,0.451,24,39,0.615,17,52,0.327,6,13,0.462,105
1240,NOP,2021-01-06,110,,OKC,0,240,44,89,0.494,40,67,0.597,4,22,0.182,18,23,0.783,110,40,87,0.46,21,41,0.512,19,46,0.413,12,16,0.75,111
1241,UTA,2020-12-28,110,@,OKC,1,240,43,86,0.5,30,50,0.6,13,36,0.361,11,14,0.786,110,40,86,0.465,25,48,0.521,15,38,0.395,14,19,0.737,109
1242,MIL,2020-12-27,110,@,NYK,0,240,41,95,0.432,34,57,0.596,7,38,0.184,21,29,0.724,110,46,85,0.541,30,58,0.517,16,27,0.593,22,27,0.815,130
1243,CLE,2021-05-16,109,@,BRK,0,240,38,85,0.447,26,46,0.565,12,39,0.308,21,31,0.677,109,47,83,0.566,31,53,0.585,16,30,0.533,13,17,0.765,123
1244,CHO,2021-05-15,109,@,NYK,0,265,39,102,0.382,26,53,0.491,13,49,0.265,18,24,0.75,109,45,88,0.511,29,51,0.569,16,37,0.432,12,15,0.8,118
1245,UTA,2021-05-14,109,@,OKC,1,240,40,93,0.43,27,54,0.5,13,39,0.333,16,21,0.762,109,36,84,0.429,30,65,0.462,6,19,0.316,15,16,0.938,93
1246,MEM,2021-05-08,109,@,TOR,1,240,38,85,0.447,24,42,0.571,14,43,0.326,19,26,0.731,109,36,94,0.383,26,62,0.419,10,32,0.313,17,24,0.708,99
1247,PHI,2021-05-07,109,,NOP,1,240,38,85,0.447,23,50,0.46,15,35,0.429,18,22,0.818,109,41,101,0.406,32,65,0.492,9,36,0.25,16,22,0.727,107
1248,BRK,2021-05-06,109,@,DAL,0,240,41,95,0.432,28,58,0.483,13,37,0.351,14,15,0.933,109,40,89,0.449,25,55,0.455,15,34,0.441,18,26,0.692,113
1249,BRK,2021-04-30,109,,POR,0,240,40,95,0.421,27,54,0.5,13,41,0.317,16,19,0.842,109,47,91,0.516,31,55,0.564,16,36,0.444,18,20,0.9,128
1250,NOP,2021-04-29,109,@,OKC,1,240,45,101,0.446,40,72,0.556,5,29,0.172,14,19,0.737,109,34,89,0.382,23,50,0.46,11,39,0.282,16,20,0.8,95
1251,ORL,2021-04-28,109,@,CLE,1,240,43,85,0.506,33,56,0.589,10,29,0.345,13,20,0.65,109,37,92,0.402,25,48,0.521,12,44,0.273,18,24,0.75,104
1252,MEM,2021-04-28,109,,POR,0,240,37,88,0.42,28,56,0.5,9,32,0.281,26,30,0.867,109,45,92,0.489,30,52,0.577,15,40,0.375,25,28,0.893,130
1253,PHO,2021-04-28,109,,LAC,1,240,43,91,0.473,30,54,0.556,13,37,0.351,10,13,0.769,109,41,80,0.513,29,49,0.592,12,31,0.387,7,9,0.778,101
1254,DET,2021-04-24,109,@,IND,0,240,39,96,0.406,29,62,0.468,10,34,0.294,21,26,0.808,109,40,96,0.417,30,64,0.469,10,32,0.313,25,35,0.714,115
1255,OKC,2021-04-23,109,,WAS,0,240,39,93,0.419,29,60,0.483,10,33,0.303,21,25,0.84,109,48,93,0.516,30,61,0.492,18,32,0.563,15,16,0.938,129
1256,BRK,2021-04-23,109,,BOS,1,240,37,86,0.43,26,54,0.481,11,32,0.344,24,28,0.857,109,38,94,0.404,21,52,0.404,17,42,0.405,11,16,0.688,104
1257,LAC,2021-04-23,109,@,HOU,1,240,39,97,0.402,27,63,0.429,12,34,0.353,19,23,0.826,109,36,89,0.404,23,47,0.489,13,42,0.31,19,22,0.864,104
1258,NYK,2021-04-20,109,,CHO,1,240,40,83,0.482,22,38,0.579,18,45,0.4,11,12,0.917,109,39,86,0.453,23,47,0.489,16,39,0.41,3,8,0.375,97
1259,SAS,2021-04-19,109,@,IND,1,240,36,84,0.429,28,56,0.5,8,28,0.286,29,35,0.829,109,34,104,0.327,26,70,0.371,8,34,0.235,18,27,0.667,94
1260,DET,2021-04-19,109,,CLE,1,240,42,86,0.488,32,59,0.542,10,27,0.37,15,21,0.714,109,42,86,0.488,37,60,0.617,5,26,0.192,16,20,0.8,105
1261,MIA,2021-04-18,109,,BRK,1,240,38,87,0.437,22,48,0.458,16,39,0.41,17,21,0.81,109,39,82,0.476,22,39,0.564,17,43,0.395,12,18,0.667,107
1262,CHO,2021-04-18,109,,POR,1,240,39,83,0.47,21,40,0.525,18,43,0.419,13,17,0.765,109,36,91,0.396,26,55,0.473,10,36,0.278,19,28,0.679,101
1263,DAL,2021-04-16,109,,NYK,0,240,40,91,0.44,25,46,0.543,15,45,0.333,14,19,0.737,109,44,86,0.512,30,58,0.517,14,28,0.5,15,21,0.714,117
1264,ATL,2021-04-15,109,,MIL,0,240,39,86,0.453,25,52,0.481,14,34,0.412,17,19,0.895,109,46,95,0.484,30,52,0.577,16,43,0.372,12,17,0.706,120
1265,OKC,2021-04-14,109,,GSW,0,240,44,92,0.478,37,65,0.569,7,27,0.259,14,25,0.56,109,52,95,0.547,28,48,0.583,24,47,0.511,19,23,0.826,147
1266,CLE,2021-04-11,109,,NOP,0,240,41,85,0.482,28,45,0.622,13,40,0.325,14,17,0.824,109,44,86,0.512,37,62,0.597,7,24,0.292,21,26,0.808,116
1267,HOU,2021-04-10,109,@,GSW,0,240,41,88,0.466,28,51,0.549,13,37,0.351,14,20,0.7,109,49,91,0.538,35,56,0.625,14,35,0.4,13,16,0.813,125
1268,HOU,2021-04-09,109,@,LAC,0,240,39,83,0.47,27,46,0.587,12,37,0.324,19,27,0.704,109,48,88,0.545,29,51,0.569,19,37,0.514,11,13,0.846,126
1269,ORL,2021-04-04,109,@,DEN,0,240,42,89,0.472,29,54,0.537,13,35,0.371,12,17,0.706,109,43,88,0.489,34,59,0.576,9,29,0.31,24,31,0.774,119
1270,DAL,2021-04-03,109,@,WAS,1,240,40,90,0.444,30,60,0.5,10,30,0.333,19,24,0.792,109,35,86,0.407,30,61,0.492,5,25,0.2,12,15,0.8,87
1271,POR,2021-04-02,109,,MIL,0,240,36,99,0.364,15,45,0.333,21,54,0.389,16,22,0.727,109,49,90,0.544,37,51,0.725,12,39,0.308,17,19,0.895,127
1272,GSW,2021-04-01,109,@,MIA,0,240,36,82,0.439,21,45,0.467,15,37,0.405,22,25,0.88,109,39,82,0.476,26,43,0.605,13,39,0.333,25,30,0.833,116
1273,BOS,2021-03-29,109,,NOP,0,240,40,93,0.43,26,50,0.52,14,43,0.326,15,19,0.789,109,41,82,0.5,25,51,0.49,16,31,0.516,17,30,0.567,115
1274,IND,2021-03-26,109,@,DAL,1,240,38,87,0.437,18,40,0.45,20,47,0.426,13,18,0.722,109,39,95,0.411,31,60,0.517,8,35,0.229,8,14,0.571,94
1275,PHI,2021-03-25,109,@,LAL,1,240,39,80,0.488,22,35,0.629,17,45,0.378,14,21,0.667,109,34,78,0.436,25,52,0.481,9,26,0.346,24,33,0.727,101
1276,IND,2021-03-21,109,@,MIA,1,265,38,98,0.388,23,53,0.434,15,45,0.333,18,20,0.9,109,39,97,0.402,30,60,0.5,9,37,0.243,19,23,0.826,106
1277,MIL,2021-03-17,109,@,PHI,1,265,41,101,0.406,32,62,0.516,9,39,0.231,18,24,0.75,109,43,109,0.394,29,68,0.426,14,41,0.341,5,8,0.625,105
1278,BOS,2021-03-16,109,,UTA,0,240,48,98,0.49,38,69,0.551,10,29,0.345,3,4,0.75,109,38,80,0.475,19,37,0.514,19,43,0.442,22,24,0.917,117
1279,SAS,2021-03-15,109,@,DET,1,240,47,83,0.566,35,58,0.603,12,25,0.48,3,5,0.6,109,39,83,0.47,32,58,0.552,7,25,0.28,14,25,0.56,99
1280,LAC,2021-03-15,109,@,DAL,1,240,43,86,0.5,29,54,0.537,14,32,0.438,9,11,0.818,109,39,79,0.494,22,38,0.579,17,41,0.415,4,5,0.8,99
1281,BOS,2021-03-11,109,@,BRK,0,240,41,91,0.451,28,51,0.549,13,40,0.325,14,22,0.636,109,42,88,0.477,23,46,0.5,19,42,0.452,18,22,0.818,121
1282,MIA,2021-02-28,109,,ATL,1,240,39,86,0.453,28,49,0.571,11,37,0.297,20,22,0.909,109,36,87,0.414,28,52,0.538,8,35,0.229,19,22,0.864,99
1283,NYK,2021-02-28,109,@,DET,1,240,44,86,0.512,31,60,0.517,13,26,0.5,8,10,0.8,109,28,72,0.389,19,40,0.475,9,32,0.281,25,31,0.806,90
1284,ORL,2021-02-27,109,,UTA,0,240,44,96,0.458,30,62,0.484,14,34,0.412,7,8,0.875,109,45,85,0.529,28,40,0.7,17,45,0.378,17,24,0.708,124
1285,PHI,2021-02-27,109,,CLE,0,265,38,83,0.458,28,55,0.509,10,28,0.357,23,35,0.657,109,41,97,0.423,33,73,0.452,8,24,0.333,22,29,0.759,112
1286,ATL,2021-02-26,109,@,OKC,0,240,43,97,0.443,31,57,0.544,12,40,0.3,11,17,0.647,109,46,88,0.523,30,46,0.652,16,42,0.381,10,16,0.625,118
1287,PHI,2021-02-23,109,@,TOR,1,240,33,80,0.413,16,42,0.381,17,38,0.447,26,30,0.867,109,40,93,0.43,29,56,0.518,11,37,0.297,11,13,0.846,102
1288,ATL,2021-02-19,109,@,BOS,0,240,38,90,0.422,28,60,0.467,10,30,0.333,23,25,0.92,109,50,90,0.556,36,55,0.655,14,35,0.4,7,10,0.7,121
1289,MEM,2021-02-19,109,,DET,1,240,42,90,0.467,37,70,0.529,5,20,0.25,20,23,0.87,109,36,86,0.419,22,41,0.537,14,45,0.311,9,13,0.692,95
1290,BRK,2021-02-18,109,@,LAL,1,240,38,77,0.494,20,38,0.526,18,39,0.462,15,24,0.625,109,40,83,0.482,32,53,0.604,8,30,0.267,10,14,0.714,98
1291,PHO,2021-02-14,109,,ORL,1,240,41,92,0.446,29,55,0.527,12,37,0.324,15,16,0.938,109,33,89,0.371,27,54,0.5,6,35,0.171,18,22,0.818,90
1292,MIL,2021-02-14,109,@,OKC,0,240,45,97,0.464,32,59,0.542,13,38,0.342,6,9,0.667,109,45,95,0.474,30,59,0.508,15,36,0.417,9,16,0.563,114
1293,NYK,2021-02-12,109,@,WAS,1,240,44,98,0.449,38,74,0.514,6,24,0.25,15,22,0.682,109,34,89,0.382,25,55,0.455,9,34,0.265,14,20,0.7,91
1294,MIA,2021-02-07,109,@,NYK,1,240,40,83,0.482,27,48,0.563,13,35,0.371,16,20,0.8,109,38,85,0.447,22,43,0.512,16,42,0.381,11,15,0.733,103
1295,MEM,2021-02-06,109,@,NOP,0,240,40,90,0.444,27,51,0.529,13,39,0.333,16,19,0.842,109,45,87,0.517,30,54,0.556,15,33,0.455,13,21,0.619,118
1296,PHO,2021-02-05,109,,DET,1,240,42,85,0.494,30,53,0.566,12,32,0.375,13,16,0.813,109,34,91,0.374,27,55,0.491,7,36,0.194,17,28,0.607,92
1297,NOP,2021-02-01,109,,SAC,0,240,40,101,0.396,31,71,0.437,9,30,0.3,20,24,0.833,109,42,88,0.477,28,45,0.622,14,43,0.326,20,26,0.769,118
1298,PHO,2021-02-01,109,@,DAL,1,240,43,92,0.467,30,57,0.526,13,35,0.371,10,12,0.833,109,37,86,0.43,27,54,0.5,10,32,0.313,24,25,0.96,108
1299,MIN,2021-01-31,109,,CLE,1,240,41,91,0.451,25,51,0.49,16,40,0.4,11,15,0.733,109,41,84,0.488,37,68,0.544,4,16,0.25,18,23,0.783,104
1300,DEN,2021-01-29,109,@,SAS,0,240,41,78,0.526,27,47,0.574,14,31,0.452,13,20,0.65,109,44,81,0.543,34,58,0.586,10,23,0.435,21,26,0.808,119
1301,LAC,2021-01-28,109,@,MIA,1,240,36,87,0.414,19,45,0.422,17,42,0.405,20,22,0.909,109,40,90,0.444,27,57,0.474,13,33,0.394,12,15,0.8,105
1302,DEN,2021-01-27,109,@,MIA,1,240,42,92,0.457,28,49,0.571,14,43,0.326,11,11,1.0,109,30,80,0.375,17,35,0.486,13,45,0.289,9,11,0.818,82
1303,BOS,2021-01-20,109,@,PHI,0,240,42,89,0.472,30,56,0.536,12,33,0.364,13,20,0.65,109,36,78,0.462,27,51,0.529,9,27,0.333,36,45,0.8,117
1304,PHO,2021-01-20,109,@,HOU,1,240,42,89,0.472,34,55,0.618,8,34,0.235,17,19,0.895,109,37,88,0.42,27,57,0.474,10,31,0.323,19,22,0.864,103
1305,UTA,2021-01-17,109,@,DEN,1,240,39,76,0.513,24,39,0.615,15,37,0.405,16,28,0.571,109,40,100,0.4,26,63,0.413,14,37,0.378,11,15,0.733,105
1306,DAL,2021-01-15,109,@,MIL,0,240,45,97,0.464,32,61,0.525,13,36,0.361,6,13,0.462,109,43,96,0.448,29,59,0.492,14,37,0.378,12,25,0.48,112
1307,HOU,2021-01-14,109,@,SAS,1,240,42,86,0.488,29,53,0.547,13,33,0.394,12,19,0.632,109,42,92,0.457,33,61,0.541,9,31,0.29,12,16,0.75,105
1308,NYK,2021-01-13,109,,BRK,0,240,44,92,0.478,33,64,0.516,11,28,0.393,10,12,0.833,109,44,91,0.484,28,51,0.549,16,40,0.4,12,17,0.706,116
1309,CHO,2021-01-11,109,,NYK,1,240,38,78,0.487,25,46,0.543,13,32,0.406,20,23,0.87,109,34,87,0.391,25,50,0.5,9,37,0.243,11,17,0.647,88
1310,PHI,2021-01-07,109,@,BRK,0,240,41,87,0.471,32,61,0.525,9,26,0.346,18,20,0.9,109,44,97,0.454,29,60,0.483,15,37,0.405,19,29,0.655,122
1311,LAL,2021-01-07,109,,SAS,0,240,43,86,0.5,33,56,0.589,10,30,0.333,13,21,0.619,109,43,92,0.467,27,57,0.474,16,35,0.457,16,17,0.941,118
1312,SAS,2021-01-03,109,,UTA,0,240,44,105,0.419,38,86,0.442,6,19,0.316,15,21,0.714,109,49,89,0.551,28,48,0.583,21,41,0.512,11,19,0.579,130
1313,MIN,2021-01-03,109,,DEN,0,240,44,85,0.518,34,54,0.63,10,31,0.323,11,16,0.688,109,45,92,0.489,26,47,0.553,19,45,0.422,15,21,0.714,124
1314,MIN,2021-01-01,109,,WAS,0,240,42,88,0.477,29,52,0.558,13,36,0.361,12,21,0.571,109,49,89,0.551,33,56,0.589,16,33,0.485,16,21,0.762,130
1315,LAL,2021-01-01,109,@,SAS,1,240,41,101,0.406,27,68,0.397,14,33,0.424,13,16,0.813,109,36,85,0.424,23,51,0.451,13,34,0.382,18,26,0.692,103
1316,OKC,2020-12-28,109,,UTA,0,240,40,86,0.465,25,48,0.521,15,38,0.395,14,19,0.737,109,43,86,0.5,30,50,0.6,13,36,0.361,11,14,0.786,110
1317,PHI,2020-12-26,109,@,NYK,1,240,41,88,0.466,30,57,0.526,11,31,0.355,16,22,0.727,109,32,83,0.386,24,54,0.444,8,29,0.276,17,23,0.739,89
1318,OKC,2020-12-26,109,@,CHO,1,240,40,88,0.455,30,52,0.577,10,36,0.278,19,24,0.792,109,37,93,0.398,24,61,0.393,13,32,0.406,20,32,0.625,107
1319,LAL,2020-12-22,109,,LAC,0,240,38,81,0.469,29,52,0.558,9,29,0.31,24,31,0.774,109,44,93,0.473,30,53,0.566,14,40,0.35,14,19,0.737,116
1320,MIN,2021-05-15,108,,BOS,0,240,39,95,0.411,34,58,0.586,5,37,0.135,25,34,0.735,108,46,95,0.484,28,53,0.528,18,42,0.429,14,18,0.778,124
1321,MIA,2021-05-15,108,@,MIL,0,240,40,96,0.417,18,47,0.383,22,49,0.449,6,8,0.75,108,46,86,0.535,33,51,0.647,13,35,0.371,17,24,0.708,122
1322,CHI,2021-05-09,108,@,DET,1,240,43,84,0.512,31,52,0.596,12,32,0.375,10,14,0.714,108,36,79,0.456,25,52,0.481,11,27,0.407,13,22,0.591,96
1323,NOP,2021-05-04,108,,GSW,1,240,39,97,0.402,27,67,0.403,12,30,0.4,18,22,0.818,108,39,93,0.419,19,40,0.475,20,53,0.377,5,7,0.714,103
1324,NOP,2021-05-03,108,,GSW,0,240,39,90,0.433,34,65,0.523,5,25,0.2,25,32,0.781,108,47,88,0.534,30,44,0.682,17,44,0.386,12,14,0.857,123
1325,ATL,2021-05-01,108,,CHI,1,240,37,74,0.5,23,38,0.605,14,36,0.389,20,26,0.769,108,40,85,0.471,34,61,0.557,6,24,0.25,11,17,0.647,97
1326,MIL,2021-04-30,108,@,CHI,1,240,42,90,0.467,33,65,0.508,9,25,0.36,15,20,0.75,108,37,96,0.385,27,63,0.429,10,33,0.303,14,21,0.667,98
1327,NOP,2021-04-24,108,,SAS,0,240,41,87,0.471,32,65,0.492,9,22,0.409,17,32,0.531,108,37,85,0.435,28,54,0.519,9,31,0.29,27,32,0.844,110
1328,DAL,2021-04-24,108,,LAL,1,240,38,78,0.487,25,48,0.521,13,30,0.433,19,25,0.76,108,33,86,0.384,21,41,0.512,12,45,0.267,15,19,0.789,93
1329,CHO,2021-04-23,108,,CLE,1,240,40,94,0.426,26,54,0.481,14,40,0.35,14,18,0.778,108,41,80,0.513,31,50,0.62,10,30,0.333,10,14,0.714,102
1330,CHI,2021-04-22,108,,CHO,1,240,43,87,0.494,29,44,0.659,14,43,0.326,8,11,0.727,108,35,82,0.427,27,51,0.529,8,31,0.258,13,17,0.765,91
1331,ATL,2021-04-13,108,@,TOR,1,240,40,84,0.476,27,54,0.5,13,30,0.433,15,22,0.682,108,42,88,0.477,32,49,0.653,10,39,0.256,9,13,0.692,103
1332,CHI,2021-04-09,108,@,ATL,0,240,41,86,0.477,28,53,0.528,13,33,0.394,13,14,0.929,108,47,84,0.56,40,57,0.702,7,27,0.259,19,23,0.826,120
1333,OKC,2021-04-05,108,,DET,0,240,41,97,0.423,36,70,0.514,5,27,0.185,21,25,0.84,108,49,95,0.516,36,67,0.537,13,28,0.464,21,24,0.875,132
1334,MIN,2021-04-02,108,@,MEM,0,240,38,85,0.447,26,52,0.5,12,33,0.364,20,23,0.87,108,42,95,0.442,23,56,0.411,19,39,0.487,17,25,0.68,120
1335,HOU,2021-03-31,108,@,BRK,0,240,39,78,0.5,26,38,0.684,13,40,0.325,17,24,0.708,108,44,90,0.489,31,54,0.574,13,36,0.361,19,19,1.0,120
1336,BOS,2021-03-31,108,,DAL,0,240,39,94,0.415,28,47,0.596,11,47,0.234,19,23,0.826,108,38,77,0.494,19,38,0.5,19,39,0.487,18,25,0.72,113
1337,GSW,2021-03-26,108,,ATL,0,240,39,79,0.494,27,51,0.529,12,28,0.429,18,26,0.692,108,46,84,0.548,33,51,0.647,13,33,0.394,19,24,0.792,124
1338,NOP,2021-03-26,108,,DEN,0,240,39,78,0.5,27,49,0.551,12,29,0.414,18,20,0.9,108,47,93,0.505,33,65,0.508,14,28,0.5,5,7,0.714,113
1339,ATL,2021-03-24,108,@,SAC,0,240,41,85,0.482,34,60,0.567,7,25,0.28,19,23,0.826,108,40,84,0.476,30,54,0.556,10,30,0.333,20,22,0.909,110
1340,MIN,2021-03-24,108,,DAL,0,240,38,86,0.442,26,48,0.542,12,38,0.316,20,26,0.769,108,48,99,0.485,32,55,0.582,16,44,0.364,16,22,0.727,128
1341,PHI,2021-03-23,108,@,GSW,1,240,39,86,0.453,32,62,0.516,7,24,0.292,23,35,0.657,108,36,83,0.434,28,58,0.483,8,25,0.32,18,26,0.692,98
1342,DEN,2021-03-21,108,,NOP,0,240,44,88,0.5,32,54,0.593,12,34,0.353,8,10,0.8,108,41,85,0.482,33,57,0.579,8,28,0.286,23,30,0.767,113
1343,GSW,2021-03-17,108,@,HOU,1,240,41,90,0.456,25,45,0.556,16,45,0.356,10,12,0.833,108,33,80,0.413,26,53,0.491,7,27,0.259,21,40,0.525,94
1344,DAL,2021-03-11,108,@,OKC,0,240,35,82,0.427,20,48,0.417,15,34,0.441,23,33,0.697,108,41,91,0.451,25,59,0.424,16,32,0.5,18,20,0.9,116
1345,POR,2021-03-03,108,,GSW,1,240,36,86,0.419,22,37,0.595,14,49,0.286,22,26,0.846,108,41,97,0.423,26,55,0.473,15,42,0.357,9,14,0.643,106
1346,TOR,2021-02-24,108,@,MIA,0,240,37,74,0.5,17,30,0.567,20,44,0.455,14,17,0.824,108,37,80,0.463,20,42,0.476,17,38,0.447,25,29,0.862,116
1347,MIA,2021-02-22,108,@,OKC,1,240,36,81,0.444,21,41,0.512,15,40,0.375,21,25,0.84,108,32,74,0.432,18,35,0.514,14,39,0.359,16,19,0.842,94
1348,LAC,2021-02-21,108,,BRK,0,240,40,87,0.46,25,52,0.481,15,35,0.429,13,18,0.722,108,44,92,0.478,33,54,0.611,11,38,0.289,13,19,0.684,112
1349,DET,2021-02-12,108,@,BOS,1,240,34,79,0.43,19,41,0.463,15,38,0.395,25,30,0.833,108,36,82,0.439,28,55,0.509,8,27,0.296,22,30,0.733,102
1350,BOS,2021-02-09,108,@,UTA,0,240,38,86,0.442,25,57,0.439,13,29,0.448,19,23,0.826,108,40,84,0.476,22,36,0.611,18,48,0.375,24,27,0.889,122
1351,BRK,2021-02-06,108,@,PHI,0,240,39,88,0.443,24,47,0.511,15,41,0.366,15,17,0.882,108,48,94,0.511,38,67,0.567,10,27,0.37,18,22,0.818,124
1352,MIN,2021-02-03,108,@,SAS,0,240,43,94,0.457,30,61,0.492,13,33,0.394,9,11,0.818,108,43,96,0.448,36,70,0.514,7,26,0.269,18,24,0.75,111
1353,ORL,2021-02-02,108,,TOR,0,240,41,89,0.461,27,51,0.529,14,38,0.368,12,14,0.857,108,40,83,0.482,20,38,0.526,20,45,0.444,23,25,0.92,123
1354,DAL,2021-02-01,108,,PHO,0,240,37,86,0.43,27,54,0.5,10,32,0.313,24,25,0.96,108,43,92,0.467,30,57,0.526,13,35,0.371,10,12,0.833,109
1355,CHO,2021-01-29,108,,IND,1,240,43,85,0.506,27,48,0.563,16,37,0.432,6,9,0.667,108,42,87,0.483,31,52,0.596,11,35,0.314,10,13,0.769,105
1356,TOR,2021-01-27,108,,MIL,0,240,38,94,0.404,16,39,0.41,22,55,0.4,10,12,0.833,108,40,93,0.43,24,49,0.49,16,44,0.364,19,26,0.731,115
1357,ATL,2021-01-26,108,,LAC,1,240,37,80,0.463,27,54,0.5,10,26,0.385,24,25,0.96,108,36,89,0.404,28,63,0.444,8,26,0.308,19,22,0.864,99
1358,UTA,2021-01-26,108,,NYK,1,240,37,92,0.402,22,44,0.5,15,48,0.313,19,22,0.864,108,36,83,0.434,26,56,0.464,10,27,0.37,12,17,0.706,94
1359,CHO,2021-01-25,108,@,ORL,0,240,39,89,0.438,28,51,0.549,11,38,0.289,19,27,0.704,108,42,88,0.477,23,51,0.451,19,37,0.514,14,22,0.636,117
1360,MIN,2021-01-25,108,@,GSW,0,240,39,94,0.415,31,70,0.443,8,24,0.333,22,25,0.88,108,44,89,0.494,30,59,0.508,14,30,0.467,28,37,0.757,130
1361,CLE,2021-01-25,108,,LAL,0,240,40,86,0.465,31,65,0.477,9,21,0.429,19,22,0.864,108,42,87,0.483,32,55,0.582,10,32,0.313,21,28,0.75,115
1362,LAC,2021-01-24,108,,OKC,1,240,41,92,0.446,27,46,0.587,14,46,0.304,12,16,0.75,108,42,95,0.442,35,60,0.583,7,35,0.2,9,14,0.643,100
1363,GSW,2021-01-23,108,@,UTA,0,240,42,93,0.452,28,54,0.519,14,39,0.359,10,15,0.667,108,45,94,0.479,25,44,0.568,20,50,0.4,17,22,0.773,127
1364,DAL,2021-01-23,108,,HOU,0,240,37,83,0.446,32,58,0.552,5,25,0.2,29,40,0.725,108,47,86,0.547,31,49,0.633,16,37,0.432,23,29,0.793,133
1365,MEM,2021-01-18,108,,PHO,1,240,41,83,0.494,30,57,0.526,11,26,0.423,15,20,0.75,108,40,88,0.455,25,52,0.481,15,36,0.417,9,16,0.563,104
1366,ATL,2021-01-18,108,,MIN,1,240,37,79,0.468,26,51,0.51,11,28,0.393,23,25,0.92,108,36,91,0.396,22,54,0.407,14,37,0.378,11,16,0.688,97
1367,MIA,2021-01-14,108,@,PHI,0,240,40,81,0.494,28,47,0.596,12,34,0.353,16,26,0.615,108,44,82,0.537,27,45,0.6,17,37,0.459,20,24,0.833,125
1368,CHO,2021-01-14,108,@,TOR,0,240,42,87,0.483,27,52,0.519,15,35,0.429,9,12,0.75,108,40,88,0.455,20,38,0.526,20,50,0.4,11,13,0.846,111
1369,LAC,2021-01-06,108,@,GSW,1,240,36,81,0.444,25,47,0.532,11,34,0.324,25,25,1.0,108,39,86,0.453,31,56,0.554,8,30,0.267,15,19,0.789,101
1370,POR,2021-01-05,108,,CHI,0,240,39,94,0.415,20,43,0.465,19,51,0.373,11,17,0.647,108,40,91,0.44,24,50,0.48,16,41,0.39,15,18,0.833,111
1371,ATL,2021-01-04,108,,NYK,0,240,40,87,0.46,30,56,0.536,10,31,0.323,18,23,0.783,108,43,85,0.506,36,64,0.563,7,21,0.333,20,25,0.8,113
1372,LAL,2021-01-03,108,@,MEM,1,240,41,89,0.461,29,54,0.537,12,35,0.343,14,19,0.737,108,39,95,0.411,30,62,0.484,9,33,0.273,7,8,0.875,94
1373,DAL,2021-01-03,108,@,CHI,0,240,39,89,0.438,28,47,0.596,11,42,0.262,19,27,0.704,108,39,85,0.459,26,48,0.542,13,37,0.351,27,30,0.9,118
1374,OKC,2021-01-02,108,@,ORL,1,240,38,86,0.442,25,45,0.556,13,41,0.317,19,21,0.905,108,40,108,0.37,30,70,0.429,10,38,0.263,9,12,0.75,99
1375,MEM,2021-01-01,108,@,CHO,1,240,43,90,0.478,29,51,0.569,14,39,0.359,8,10,0.8,108,35,86,0.407,26,55,0.473,9,31,0.29,14,21,0.667,93
1376,MIL,2020-12-30,108,@,MIA,0,240,40,102,0.392,24,61,0.393,16,41,0.39,12,13,0.923,108,40,82,0.488,25,43,0.581,15,39,0.385,24,29,0.828,119
1377,IND,2020-12-27,108,,BOS,1,240,45,88,0.511,38,62,0.613,7,26,0.269,11,15,0.733,108,40,79,0.506,31,56,0.554,9,23,0.391,18,24,0.75,107
1378,DEN,2020-12-25,108,,LAC,0,240,37,81,0.457,26,45,0.578,11,36,0.306,23,31,0.742,108,41,74,0.554,22,36,0.611,19,38,0.5,20,24,0.833,121
1379,DET,2021-05-16,107,,MIA,0,240,40,86,0.465,29,51,0.569,11,35,0.314,16,22,0.727,107,47,84,0.56,34,50,0.68,13,34,0.382,13,20,0.65,120
1380,MEM,2021-05-14,107,,SAC,1,240,37,84,0.44,26,51,0.51,11,33,0.333,22,35,0.629,107,37,96,0.385,27,54,0.5,10,42,0.238,22,27,0.815,106
1381,NOP,2021-05-12,107,@,DAL,0,240,36,87,0.414,29,59,0.492,7,28,0.25,28,38,0.737,107,47,96,0.49,32,51,0.627,15,45,0.333,16,20,0.8,125
1382,CHI,2021-05-11,107,,BRK,0,240,39,96,0.406,21,52,0.404,18,44,0.409,11,14,0.786,107,42,89,0.472,30,56,0.536,12,33,0.364,19,25,0.76,115
1383,NOP,2021-05-07,107,@,PHI,0,240,41,101,0.406,32,65,0.492,9,36,0.25,16,22,0.727,107,38,85,0.447,23,50,0.46,15,35,0.429,18,22,0.818,109
1384,CLE,2021-05-01,107,,MIA,0,240,37,74,0.5,17,34,0.5,20,40,0.5,13,17,0.765,107,47,87,0.54,29,51,0.569,18,36,0.5,12,15,0.8,124
1385,CHO,2021-05-01,107,,DET,1,240,42,87,0.483,28,50,0.56,14,37,0.378,9,20,0.45,107,35,91,0.385,22,54,0.407,13,37,0.351,11,17,0.647,94
1386,LAL,2021-04-28,107,@,WAS,0,240,42,96,0.438,32,62,0.516,10,34,0.294,13,21,0.619,107,47,90,0.522,41,72,0.569,6,18,0.333,16,21,0.762,116
1387,HOU,2021-04-27,107,,MIN,0,240,42,86,0.488,35,55,0.636,7,31,0.226,16,22,0.727,107,45,93,0.484,35,55,0.636,10,38,0.263,14,25,0.56,114
1388,MIA,2021-04-21,107,@,SAS,1,240,39,83,0.47,26,52,0.5,13,31,0.419,16,20,0.8,107,31,77,0.403,21,42,0.5,10,35,0.286,15,20,0.75,87
1389,OKC,2021-04-19,107,@,WAS,0,240,36,83,0.434,23,50,0.46,13,33,0.394,22,27,0.815,107,46,91,0.505,36,60,0.6,10,31,0.323,17,29,0.586,119
1390,GSW,2021-04-19,107,@,PHI,1,240,34,76,0.447,20,44,0.455,14,32,0.438,25,32,0.781,107,35,89,0.393,23,57,0.404,12,32,0.375,14,18,0.778,96
1391,BRK,2021-04-18,107,@,MIA,0,240,39,82,0.476,22,39,0.564,17,43,0.395,12,18,0.667,107,38,87,0.437,22,48,0.458,16,39,0.41,17,21,0.81,109
1392,DAL,2021-04-18,107,,SAC,0,240,39,87,0.448,23,39,0.59,16,48,0.333,13,20,0.65,107,44,89,0.494,33,65,0.508,11,24,0.458,22,25,0.88,121
1393,POR,2021-04-16,107,@,SAS,1,240,41,89,0.461,30,60,0.5,11,29,0.379,14,16,0.875,107,45,95,0.474,38,72,0.528,7,23,0.304,9,10,0.9,106
1394,DEN,2021-04-12,107,@,GSW,0,240,39,83,0.47,31,57,0.544,8,26,0.308,21,25,0.84,107,39,81,0.481,21,37,0.568,18,44,0.409,20,22,0.909,116
1395,MIA,2021-04-11,107,@,POR,1,240,41,83,0.494,29,54,0.537,12,29,0.414,13,20,0.65,107,37,77,0.481,26,42,0.619,11,35,0.314,13,19,0.684,98
1396,GSW,2021-04-09,107,,WAS,0,240,41,88,0.466,30,52,0.577,11,36,0.306,14,21,0.667,107,43,89,0.483,38,70,0.543,5,19,0.263,19,24,0.792,110
1397,NOP,2021-04-06,107,@,ATL,0,240,37,91,0.407,25,53,0.472,12,38,0.316,21,28,0.75,107,44,88,0.5,24,57,0.421,20,31,0.645,15,22,0.682,123
1398,BRK,2021-04-04,107,@,CHI,0,240,45,93,0.484,34,65,0.523,11,28,0.393,6,7,0.857,107,43,78,0.551,35,56,0.625,8,22,0.364,21,30,0.7,115
1399,MEM,2021-03-31,107,,UTA,0,240,42,90,0.467,37,72,0.514,5,18,0.278,18,23,0.783,107,38,89,0.427,22,40,0.55,16,49,0.327,19,25,0.76,111
1400,MIN,2021-03-29,107,@,BRK,0,240,40,103,0.388,26,59,0.441,14,44,0.318,13,17,0.765,107,40,85,0.471,30,55,0.545,10,30,0.333,22,25,0.88,112
1401,MIN,2021-03-27,107,,HOU,0,240,36,85,0.424,23,45,0.511,13,40,0.325,22,28,0.786,107,50,92,0.543,32,53,0.604,18,39,0.462,11,13,0.846,129
1402,MIN,2021-03-26,107,,HOU,1,240,39,103,0.379,29,65,0.446,10,38,0.263,19,24,0.792,107,37,87,0.425,20,43,0.465,17,44,0.386,10,13,0.769,101
1403,OKC,2021-03-24,107,,MEM,0,240,43,95,0.453,33,60,0.55,10,35,0.286,11,17,0.647,107,47,99,0.475,36,69,0.522,11,30,0.367,11,13,0.846,116
1404,SAC,2021-03-19,107,@,BOS,1,240,37,81,0.457,25,51,0.49,12,30,0.4,21,26,0.808,107,39,91,0.429,27,60,0.45,12,31,0.387,6,7,0.857,96
1405,HOU,2021-03-16,107,,ATL,0,240,42,88,0.477,29,54,0.537,13,34,0.382,10,13,0.769,107,44,86,0.512,27,49,0.551,17,37,0.459,14,16,0.875,119
1406,HOU,2021-03-14,107,,BOS,0,240,35,91,0.385,19,41,0.463,16,50,0.32,21,31,0.677,107,51,92,0.554,33,55,0.6,18,37,0.486,14,21,0.667,134
1407,OKC,2021-03-04,107,@,SAS,1,240,37,85,0.435,25,45,0.556,12,40,0.3,21,26,0.808,107,40,85,0.471,30,54,0.556,10,31,0.323,12,12,1.0,102
1408,IND,2021-02-27,107,@,NYK,0,240,38,84,0.452,27,56,0.482,11,28,0.393,20,25,0.8,107,40,81,0.494,28,57,0.491,12,24,0.5,18,22,0.818,110
1409,DET,2021-02-26,107,,SAC,0,240,37,82,0.451,25,49,0.51,12,33,0.364,21,32,0.656,107,37,89,0.416,30,57,0.526,7,32,0.219,29,41,0.707,110
1410,IND,2021-02-24,107,,GSW,0,240,37,81,0.457,30,52,0.577,7,29,0.241,26,32,0.813,107,39,83,0.47,34,57,0.596,5,26,0.192,28,31,0.903,111
1411,BOS,2021-02-23,107,@,DAL,0,240,41,86,0.477,29,47,0.617,12,39,0.308,13,18,0.722,107,42,89,0.472,29,56,0.518,13,33,0.394,13,15,0.867,110
1412,ORL,2021-02-17,107,,NYK,1,240,42,92,0.457,26,58,0.448,16,34,0.471,7,10,0.7,107,33,87,0.379,26,60,0.433,7,27,0.259,16,19,0.842,89
1413,NYK,2021-02-03,107,@,CHI,1,240,43,89,0.483,32,67,0.478,11,22,0.5,10,15,0.667,107,43,88,0.489,37,52,0.712,6,36,0.167,11,16,0.688,103
1414,GSW,2021-02-02,107,,BOS,0,240,38,83,0.458,23,46,0.5,15,37,0.405,16,23,0.696,107,39,84,0.464,26,50,0.52,13,34,0.382,20,27,0.741,111
1415,LAL,2021-02-01,107,@,ATL,1,240,40,77,0.519,33,54,0.611,7,23,0.304,20,24,0.833,107,37,78,0.474,26,49,0.531,11,29,0.379,14,17,0.824,99
1416,DET,2021-01-28,107,,LAL,1,240,40,87,0.46,26,51,0.51,14,36,0.389,13,13,1.0,107,36,88,0.409,24,60,0.4,12,28,0.429,8,12,0.667,92
1417,PHI,2021-01-27,107,,LAL,1,240,41,85,0.482,32,60,0.533,9,25,0.36,16,26,0.615,107,41,86,0.477,33,62,0.532,8,24,0.333,16,25,0.64,106
1418,ORL,2021-01-27,107,,SAC,0,240,40,96,0.417,30,70,0.429,10,26,0.385,17,18,0.944,107,45,92,0.489,31,59,0.525,14,33,0.424,17,26,0.654,121
1419,DET,2021-01-27,107,@,CLE,0,240,37,82,0.451,26,55,0.473,11,27,0.407,22,29,0.759,107,47,87,0.54,36,66,0.545,11,21,0.524,17,23,0.739,122
1420,HOU,2021-01-26,107,,WAS,1,240,37,88,0.42,25,51,0.49,12,37,0.324,21,29,0.724,107,33,85,0.388,28,59,0.475,5,26,0.192,17,23,0.739,88
1421,CHO,2021-01-24,107,@,ORL,1,240,42,88,0.477,28,52,0.538,14,36,0.389,9,16,0.563,107,39,87,0.448,22,49,0.449,17,38,0.447,9,13,0.692,104
1422,TOR,2021-01-24,107,@,IND,1,240,37,90,0.411,22,55,0.4,15,35,0.429,18,26,0.692,107,35,87,0.402,22,48,0.458,13,39,0.333,19,22,0.864,102
1423,DET,2021-01-18,107,@,MIA,0,240,38,82,0.463,25,45,0.556,13,37,0.351,18,24,0.75,107,43,75,0.573,31,45,0.689,12,30,0.4,15,19,0.789,113
1424,MIN,2021-01-13,107,,MEM,0,240,39,90,0.433,30,53,0.566,9,37,0.243,20,24,0.833,107,50,106,0.472,42,81,0.519,8,25,0.32,10,13,0.769,118
1425,PHO,2021-01-11,107,@,WAS,0,240,39,87,0.448,35,60,0.583,4,27,0.148,25,30,0.833,107,48,92,0.522,33,58,0.569,15,34,0.441,17,28,0.607,128
1426,WAS,2021-01-08,107,@,BOS,0,240,41,88,0.466,30,59,0.508,11,29,0.379,14,16,0.875,107,41,86,0.477,29,54,0.537,12,32,0.375,22,30,0.733,116
1427,HOU,2021-01-06,107,@,IND,0,240,39,81,0.481,31,51,0.608,8,30,0.267,21,26,0.808,107,42,89,0.472,33,66,0.5,9,23,0.391,21,26,0.808,114
1428,BOS,2021-01-06,107,@,MIA,1,240,42,99,0.424,30,64,0.469,12,35,0.343,11,12,0.917,107,35,81,0.432,22,45,0.489,13,36,0.361,22,26,0.846,105
1429,PHO,2021-01-03,107,,LAC,0,240,37,75,0.493,27,42,0.643,10,33,0.303,23,28,0.821,107,40,83,0.482,23,54,0.426,17,29,0.586,15,19,0.789,112
1430,SAS,2020-12-30,107,,LAL,0,240,40,87,0.46,30,63,0.476,10,24,0.417,17,23,0.739,107,46,82,0.561,32,56,0.571,14,26,0.538,15,20,0.75,121
1431,MEM,2020-12-30,107,@,BOS,0,240,40,93,0.43,31,60,0.517,9,33,0.273,18,25,0.72,107,49,91,0.538,33,52,0.635,16,39,0.41,12,14,0.857,126
1432,OKC,2020-12-29,107,,ORL,0,240,43,87,0.494,32,53,0.604,11,34,0.324,10,19,0.526,107,49,96,0.51,42,74,0.568,7,22,0.318,13,16,0.813,118
1433,WAS,2020-12-29,107,,CHI,0,240,37,84,0.44,27,47,0.574,10,37,0.27,23,26,0.885,107,38,87,0.437,23,51,0.451,15,36,0.417,24,32,0.75,115
1434,LAL,2020-12-28,107,,POR,0,240,41,87,0.471,31,60,0.517,10,27,0.37,15,18,0.833,107,43,92,0.467,27,46,0.587,16,46,0.348,13,15,0.867,115
1435,BOS,2020-12-27,107,@,IND,0,240,40,79,0.506,31,56,0.554,9,23,0.391,18,24,0.75,107,45,88,0.511,38,62,0.613,7,26,0.269,11,15,0.733,108
1436,CHO,2020-12-26,107,,OKC,0,240,37,93,0.398,24,61,0.393,13,32,0.406,20,32,0.625,107,40,88,0.455,30,52,0.577,10,36,0.278,19,24,0.792,109
1437,WAS,2020-12-23,107,@,PHI,0,240,39,85,0.459,26,58,0.448,13,27,0.481,16,23,0.696,107,41,87,0.471,33,59,0.559,8,28,0.286,23,30,0.767,113
1438,MIA,2020-12-23,107,@,ORL,0,240,42,83,0.506,35,63,0.556,7,20,0.35,16,19,0.842,107,42,88,0.477,32,60,0.533,10,28,0.357,19,30,0.633,113
1439,NYK,2020-12-23,107,@,IND,0,240,39,85,0.459,27,57,0.474,12,28,0.429,17,23,0.739,107,46,94,0.489,38,60,0.633,8,34,0.235,21,29,0.724,121
1440,SAC,2021-05-14,106,@,MEM,0,240,37,96,0.385,27,54,0.5,10,42,0.238,22,27,0.815,106,37,84,0.44,26,51,0.51,11,33,0.333,22,35,0.629,107
1441,MIA,2021-05-13,106,,PHI,1,240,41,81,0.506,28,46,0.609,13,35,0.371,11,11,1.0,106,36,78,0.462,29,53,0.547,7,25,0.28,15,20,0.75,94
1442,OKC,2021-05-11,106,@,SAC,0,240,39,84,0.464,30,61,0.492,9,23,0.391,19,28,0.679,106,44,86,0.512,25,47,0.532,19,39,0.487,15,19,0.789,122
1443,NYK,2021-05-09,106,@,LAC,1,240,42,90,0.467,29,58,0.5,13,32,0.406,9,9,1.0,106,37,86,0.43,25,51,0.49,12,35,0.343,14,16,0.875,100
1444,POR,2021-05-07,106,,LAL,1,240,37,88,0.42,25,51,0.49,12,37,0.324,20,21,0.952,106,37,89,0.416,26,59,0.441,11,30,0.367,16,22,0.727,101
1445,PHI,2021-05-03,106,@,CHI,1,240,40,75,0.533,29,47,0.617,11,28,0.393,15,21,0.714,106,36,87,0.414,25,53,0.472,11,34,0.324,11,14,0.786,94
1446,UTA,2021-05-01,106,,TOR,1,240,37,78,0.474,20,37,0.541,17,41,0.415,15,18,0.833,106,42,94,0.447,30,61,0.492,12,33,0.364,6,9,0.667,102
1447,LAL,2021-04-30,106,,SAC,0,240,42,83,0.506,35,55,0.636,7,28,0.25,15,21,0.714,106,39,86,0.453,27,53,0.509,12,33,0.364,20,22,0.909,110
1448,DAL,2021-04-26,106,@,SAC,0,240,43,92,0.467,31,50,0.62,12,42,0.286,8,14,0.571,106,42,81,0.519,29,52,0.558,13,29,0.448,16,18,0.889,113
1449,MIA,2021-04-24,106,,CHI,1,240,36,80,0.45,22,43,0.512,14,37,0.378,20,24,0.833,106,38,79,0.481,25,41,0.61,13,38,0.342,12,13,0.923,101
1450,SAS,2021-04-22,106,,DET,1,240,37,80,0.463,26,56,0.464,11,24,0.458,21,27,0.778,106,35,77,0.455,27,55,0.491,8,22,0.364,13,22,0.591,91
1451,DEN,2021-04-21,106,@,POR,1,240,39,88,0.443,26,49,0.531,13,39,0.333,15,17,0.882,106,40,87,0.46,28,51,0.549,12,36,0.333,13,15,0.867,105
1452,OKC,2021-04-18,106,@,TOR,0,240,37,82,0.451,23,49,0.469,14,33,0.424,18,21,0.857,106,37,96,0.385,20,58,0.345,17,38,0.447,21,24,0.875,112
1453,CHI,2021-04-17,106,,CLE,1,240,41,82,0.5,25,42,0.595,16,40,0.4,8,9,0.889,106,39,88,0.443,27,58,0.466,12,30,0.4,6,7,0.857,96
1454,PHI,2021-04-16,106,,LAC,1,240,35,83,0.422,21,39,0.538,14,44,0.318,22,30,0.733,106,37,82,0.451,18,43,0.419,19,39,0.487,10,16,0.625,103
1455,SAS,2021-04-16,106,,POR,0,240,45,95,0.474,38,72,0.528,7,23,0.304,9,10,0.9,106,41,89,0.461,30,60,0.5,11,29,0.379,14,16,0.875,107
1456,MIA,2021-04-14,106,@,DEN,0,240,39,79,0.494,26,47,0.553,13,32,0.406,15,18,0.833,106,48,89,0.539,31,53,0.585,17,36,0.472,10,13,0.769,123
1457,CHI,2021-04-14,106,,ORL,0,240,41,86,0.477,24,49,0.49,17,37,0.459,7,9,0.778,106,44,89,0.494,32,62,0.516,12,27,0.444,15,20,0.75,115
1458,NOP,2021-04-14,106,,NYK,0,240,40,88,0.455,34,60,0.567,6,28,0.214,20,24,0.833,106,44,97,0.454,27,64,0.422,17,33,0.515,11,13,0.846,116
1459,PHO,2021-04-13,106,,MIA,1,240,38,82,0.463,25,40,0.625,13,42,0.31,17,18,0.944,106,31,82,0.378,22,38,0.579,9,44,0.205,15,19,0.789,86
1460,UTA,2021-04-13,106,,OKC,1,240,36,86,0.419,19,39,0.487,17,47,0.362,17,20,0.85,106,36,93,0.387,22,59,0.373,14,34,0.412,10,18,0.556,96
1461,WAS,2021-04-10,106,@,PHO,0,240,39,84,0.464,30,59,0.508,9,25,0.36,19,28,0.679,106,55,107,0.514,38,64,0.594,17,43,0.395,7,7,1.0,134
1462,ORL,2021-04-09,106,,IND,0,240,38,90,0.422,32,66,0.485,6,24,0.25,24,31,0.774,106,38,92,0.413,27,59,0.458,11,33,0.333,24,28,0.857,111
1463,DEN,2021-04-07,106,,SAS,1,240,40,91,0.44,32,65,0.492,8,26,0.308,18,24,0.75,106,38,91,0.418,32,67,0.478,6,24,0.25,14,21,0.667,96
1464,PHI,2021-04-06,106,@,BOS,1,240,34,73,0.466,25,49,0.51,9,24,0.375,29,39,0.744,106,33,70,0.471,19,36,0.528,14,34,0.412,16,18,0.889,96
1465,SAC,2021-04-05,106,@,MIN,0,240,39,88,0.443,30,52,0.577,9,36,0.25,19,24,0.792,106,38,91,0.418,26,59,0.441,12,32,0.375,28,33,0.848,116
1466,CHI,2021-04-02,106,@,UTA,0,240,43,89,0.483,36,61,0.59,7,28,0.25,13,17,0.765,106,37,79,0.468,24,43,0.558,13,36,0.361,26,27,0.963,113
1467,SAC,2021-03-31,106,@,SAS,0,240,39,92,0.424,28,57,0.491,11,35,0.314,17,19,0.895,106,43,92,0.467,33,66,0.5,10,26,0.385,24,34,0.706,120
1468,OKC,2021-03-29,106,,DAL,0,240,38,81,0.469,29,55,0.527,9,26,0.346,21,33,0.636,106,51,96,0.531,35,52,0.673,16,44,0.364,9,13,0.692,127
1469,WAS,2021-03-27,106,,DET,1,240,44,91,0.484,35,70,0.5,9,21,0.429,9,9,1.0,106,33,85,0.388,23,56,0.411,10,29,0.345,16,19,0.842,92
1470,NYK,2021-03-25,106,,WAS,1,240,34,93,0.366,27,65,0.415,7,28,0.25,31,42,0.738,106,37,80,0.463,29,54,0.537,8,26,0.308,20,33,0.606,102
1471,MIA,2021-03-21,106,,IND,0,265,39,97,0.402,30,60,0.5,9,37,0.243,19,23,0.826,106,38,98,0.388,23,53,0.434,15,45,0.333,18,20,0.9,109
1472,WAS,2021-03-21,106,@,BRK,0,240,42,79,0.532,35,58,0.603,7,21,0.333,15,19,0.789,106,44,90,0.489,35,61,0.574,9,29,0.31,16,22,0.727,113
1473,SAS,2021-03-17,106,@,CHI,1,240,38,89,0.427,30,58,0.517,8,31,0.258,22,30,0.733,106,40,91,0.44,29,58,0.5,11,33,0.333,8,9,0.889,99
1474,IND,2021-03-15,106,@,DEN,0,240,39,90,0.433,22,48,0.458,17,42,0.405,11,13,0.846,106,45,97,0.464,30,69,0.435,15,28,0.536,16,19,0.842,121
1475,SAC,2021-03-13,106,@,ATL,0,240,43,98,0.439,36,62,0.581,7,36,0.194,13,16,0.813,106,43,84,0.512,31,51,0.608,12,33,0.364,23,33,0.697,121
1476,GSW,2021-03-03,106,@,POR,0,240,41,97,0.423,26,55,0.473,15,42,0.357,9,14,0.643,106,36,86,0.419,22,37,0.595,14,49,0.286,22,26,0.846,108
1477,PHO,2021-02-26,106,@,CHI,1,240,44,88,0.5,38,66,0.576,6,22,0.273,12,15,0.8,106,39,78,0.5,27,47,0.574,12,31,0.387,7,10,0.7,97
1478,NYK,2021-02-23,106,,GSW,0,240,38,97,0.392,27,68,0.397,11,29,0.379,19,22,0.864,106,40,89,0.449,27,51,0.529,13,38,0.342,21,24,0.875,114
1479,POR,2021-02-23,106,@,DEN,0,240,41,87,0.471,27,46,0.587,14,41,0.341,10,10,1.0,106,40,94,0.426,26,58,0.448,14,36,0.389,17,18,0.944,111
1480,CHI,2021-02-12,106,,LAC,0,240,40,85,0.471,28,53,0.528,12,32,0.375,14,15,0.933,106,50,86,0.581,37,56,0.661,13,30,0.433,12,15,0.8,125
1481,TOR,2021-02-11,106,@,BOS,0,240,41,83,0.494,32,55,0.582,9,28,0.321,15,19,0.789,106,39,86,0.453,19,47,0.404,20,39,0.513,22,28,0.786,120
1482,POR,2021-02-09,106,,ORL,1,240,35,90,0.389,17,44,0.386,18,46,0.391,18,19,0.947,106,37,88,0.42,26,53,0.491,11,35,0.314,12,22,0.545,97
1483,HOU,2021-02-06,106,,SAS,0,240,38,88,0.432,26,50,0.52,12,38,0.316,18,25,0.72,106,37,87,0.425,29,62,0.468,8,25,0.32,29,36,0.806,111
1484,MIN,2021-02-05,106,@,OKC,1,240,41,94,0.436,25,54,0.463,16,40,0.4,8,9,0.889,106,39,85,0.459,26,51,0.51,13,34,0.382,12,17,0.706,103
1485,POR,2021-02-01,106,@,MIL,0,240,39,104,0.375,24,62,0.387,15,42,0.357,13,13,1.0,106,53,96,0.552,32,54,0.593,21,42,0.5,7,12,0.583,134
1486,OKC,2021-02-01,106,,HOU,0,240,39,89,0.438,26,55,0.473,13,34,0.382,15,19,0.789,106,49,102,0.48,21,50,0.42,28,52,0.538,10,11,0.909,136
1487,WAS,2021-01-27,106,@,NOP,0,240,37,92,0.402,24,54,0.444,13,38,0.342,19,21,0.905,106,46,89,0.517,29,46,0.63,17,43,0.395,15,24,0.625,124
1488,BOS,2021-01-27,106,@,SAS,0,240,42,98,0.429,32,68,0.471,10,30,0.333,12,14,0.857,106,46,82,0.561,38,54,0.704,8,28,0.286,10,16,0.625,110
1489,LAL,2021-01-27,106,@,PHI,0,240,41,86,0.477,33,62,0.532,8,24,0.333,16,25,0.64,106,41,85,0.482,32,60,0.533,9,25,0.36,16,26,0.615,107
1490,CHO,2021-01-27,106,,IND,0,240,37,90,0.411,24,52,0.462,13,38,0.342,19,21,0.905,106,45,88,0.511,29,48,0.604,16,40,0.4,10,12,0.833,116
1491,OKC,2021-01-22,106,@,LAC,0,240,41,87,0.471,27,45,0.6,14,42,0.333,10,13,0.769,106,43,84,0.512,33,51,0.647,10,33,0.303,24,25,0.96,120
1492,MIL,2021-01-21,106,,LAL,0,240,44,87,0.506,35,59,0.593,9,28,0.321,9,12,0.75,106,41,88,0.466,22,51,0.431,19,37,0.514,12,15,0.8,113
1493,ATL,2021-01-16,106,@,POR,0,240,38,87,0.437,32,57,0.561,6,30,0.2,24,28,0.857,106,40,103,0.388,25,59,0.424,15,44,0.341,17,20,0.85,112
1494,MEM,2021-01-16,106,,PHI,1,240,43,99,0.434,35,70,0.5,8,29,0.276,12,18,0.667,106,37,84,0.44,30,59,0.508,7,25,0.28,23,32,0.719,104
1495,CLE,2021-01-15,106,,NYK,1,240,36,79,0.456,27,52,0.519,9,27,0.333,25,34,0.735,106,40,82,0.488,31,57,0.544,9,25,0.36,14,16,0.875,103
1496,NOP,2021-01-13,106,@,LAC,0,240,42,88,0.477,32,60,0.533,10,28,0.357,12,16,0.75,106,35,74,0.473,17,37,0.459,18,37,0.486,23,27,0.852,111
1497,GSW,2021-01-10,106,,TOR,1,240,38,93,0.409,25,47,0.532,13,46,0.283,17,19,0.895,106,39,96,0.406,26,58,0.448,13,38,0.342,14,22,0.636,105
1498,SAC,2021-01-04,106,@,GSW,0,240,34,90,0.378,24,55,0.436,10,35,0.286,28,39,0.718,106,51,97,0.526,28,54,0.519,23,43,0.535,12,14,0.857,137
1499,NYK,2021-01-02,106,@,IND,1,240,42,83,0.506,30,56,0.536,12,27,0.444,10,13,0.769,106,34,84,0.405,15,34,0.441,19,50,0.38,15,18,0.833,102
1500,PHO,2021-01-01,106,@,DEN,1,240,37,76,0.487,24,41,0.585,13,35,0.371,19,21,0.905,106,39,86,0.453,27,57,0.474,12,29,0.414,13,16,0.813,103
1501,UTA,2021-01-01,106,,LAC,1,240,41,89,0.461,26,47,0.553,15,42,0.357,9,14,0.643,106,33,85,0.388,20,52,0.385,13,33,0.394,21,24,0.875,100
1502,PHO,2020-12-31,106,@,UTA,1,240,41,84,0.488,24,51,0.471,17,33,0.515,7,10,0.7,106,35,84,0.417,23,50,0.46,12,34,0.353,13,19,0.684,95
1503,DET,2020-12-29,106,,GSW,0,240,35,92,0.38,22,57,0.386,13,35,0.371,23,29,0.793,106,38,76,0.5,24,43,0.558,14,33,0.424,26,36,0.722,116
1504,CHO,2020-12-27,106,,BRK,1,240,43,96,0.448,33,62,0.532,10,34,0.294,10,17,0.588,106,35,82,0.427,18,35,0.514,17,47,0.362,17,25,0.68,104
1505,SAC,2020-12-26,106,,PHO,1,240,39,86,0.453,34,63,0.54,5,23,0.217,23,33,0.697,106,41,98,0.418,30,54,0.556,11,44,0.25,10,13,0.769,103
1506,CHI,2020-12-26,106,,IND,0,240,34,91,0.374,18,52,0.346,16,39,0.41,22,25,0.88,106,52,93,0.559,43,67,0.642,9,26,0.346,12,19,0.632,125
1507,PHO,2020-12-23,106,,DAL,1,240,38,79,0.481,27,49,0.551,11,30,0.367,19,27,0.704,106,36,85,0.424,27,48,0.563,9,37,0.243,21,26,0.808,102
1508,BRK,2021-05-15,105,,CHI,1,240,41,87,0.471,27,53,0.509,14,34,0.412,9,15,0.6,105,34,98,0.347,23,57,0.404,11,41,0.268,12,17,0.706,91
1509,CLE,2021-05-14,105,@,WAS,0,240,39,84,0.464,29,48,0.604,10,36,0.278,17,21,0.81,105,41,89,0.461,34,64,0.531,7,25,0.28,31,37,0.838,120
1510,POR,2021-05-12,105,@,UTA,1,240,40,91,0.44,27,59,0.458,13,32,0.406,12,17,0.706,105,35,85,0.412,23,45,0.511,12,40,0.3,16,21,0.762,98
1511,NYK,2021-05-07,105,@,PHO,0,240,38,84,0.452,27,52,0.519,11,32,0.344,18,23,0.783,105,43,92,0.467,25,51,0.49,18,41,0.439,24,25,0.96,128
1512,CLE,2021-05-05,105,,POR,0,240,37,92,0.402,24,54,0.444,13,38,0.342,18,26,0.692,105,53,92,0.576,37,59,0.627,16,33,0.485,19,25,0.76,141
1513,LAC,2021-05-04,105,,TOR,1,240,39,75,0.52,24,41,0.585,15,34,0.441,12,13,0.923,105,40,87,0.46,28,52,0.538,12,35,0.343,8,13,0.615,100
1514,DET,2021-04-29,105,,DAL,0,240,36,71,0.507,26,42,0.619,10,29,0.345,23,34,0.676,105,40,89,0.449,27,59,0.458,13,30,0.433,22,23,0.957,115
1515,SAC,2021-04-28,105,,UTA,0,240,42,87,0.483,35,66,0.53,7,21,0.333,14,17,0.824,105,55,86,0.64,31,45,0.689,24,41,0.585,20,21,0.952,154
1516,MIN,2021-04-26,105,,UTA,1,240,37,83,0.446,21,39,0.538,16,44,0.364,15,21,0.714,105,37,95,0.389,21,38,0.553,16,57,0.281,14,19,0.737,104
1517,POR,2021-04-21,105,,DEN,0,240,40,87,0.46,28,51,0.549,12,36,0.333,13,15,0.867,105,39,88,0.443,26,49,0.531,13,39,0.333,15,17,0.882,106
1518,CHI,2021-04-21,105,@,CLE,0,240,39,79,0.494,26,42,0.619,13,37,0.351,14,18,0.778,105,45,88,0.511,29,52,0.558,16,36,0.444,15,19,0.789,121
1519,MEM,2021-04-21,105,@,LAC,0,240,38,84,0.452,25,54,0.463,13,30,0.433,16,23,0.696,105,38,84,0.452,24,57,0.421,14,27,0.519,27,36,0.75,117
1520,CLE,2021-04-19,105,@,DET,0,240,42,86,0.488,37,60,0.617,5,26,0.192,16,20,0.8,105,42,86,0.488,32,59,0.542,10,27,0.37,15,21,0.714,109
1521,MIN,2021-04-18,105,@,LAC,0,240,36,88,0.409,19,43,0.442,17,45,0.378,16,21,0.762,105,45,89,0.506,24,47,0.511,21,42,0.5,13,17,0.765,124
1522,MIN,2021-04-14,105,,MIL,0,240,34,92,0.37,19,51,0.373,15,41,0.366,22,31,0.71,105,46,98,0.469,27,58,0.466,19,40,0.475,19,23,0.826,130
1523,BOS,2021-04-11,105,@,DEN,1,240,39,87,0.448,32,54,0.593,7,33,0.212,20,23,0.87,105,32,88,0.364,24,54,0.444,8,34,0.235,15,18,0.833,87
1524,ATL,2021-04-11,105,@,CHO,1,240,38,84,0.452,21,45,0.467,17,39,0.436,12,16,0.75,105,37,80,0.463,22,37,0.595,15,43,0.349,12,14,0.857,101
1525,MIL,2021-03-29,105,@,LAC,0,240,38,81,0.469,27,51,0.529,11,30,0.367,18,21,0.857,105,51,95,0.537,32,61,0.525,19,34,0.559,8,10,0.8,129
1526,ORL,2021-03-26,105,,POR,0,240,42,95,0.442,30,68,0.441,12,27,0.444,9,17,0.529,105,40,85,0.471,22,45,0.489,18,40,0.45,14,21,0.667,112
1527,MIA,2021-03-26,105,@,CHO,0,240,40,87,0.46,25,44,0.568,15,43,0.349,10,20,0.5,105,39,79,0.494,21,36,0.583,18,43,0.419,14,19,0.737,110
1528,CLE,2021-03-22,105,,SAC,0,240,41,96,0.427,37,79,0.468,4,17,0.235,19,23,0.826,105,49,90,0.544,36,60,0.6,13,30,0.433,8,12,0.667,119
1529,TOR,2021-03-21,105,@,CLE,0,240,37,95,0.389,22,49,0.449,15,46,0.326,16,19,0.842,105,39,77,0.506,22,44,0.5,17,33,0.515,21,28,0.75,116
1530,SAC,2021-03-20,105,@,PHI,0,240,39,85,0.459,29,57,0.509,10,28,0.357,17,27,0.63,105,48,86,0.558,37,63,0.587,11,23,0.478,22,29,0.759,129
1531,CHO,2021-03-18,105,@,LAL,0,240,41,83,0.494,30,54,0.556,11,29,0.379,12,20,0.6,105,44,92,0.478,31,53,0.585,13,39,0.333,15,20,0.75,116
1532,PHI,2021-03-17,105,,MIL,0,265,43,109,0.394,29,68,0.426,14,41,0.341,5,8,0.625,105,41,101,0.406,32,62,0.516,9,39,0.231,18,24,0.75,109
1533,DAL,2021-03-17,105,,LAC,1,240,40,79,0.506,25,45,0.556,15,34,0.441,10,12,0.833,105,37,88,0.42,28,56,0.5,9,32,0.281,6,11,0.545,89
1534,LAL,2021-03-12,105,,IND,1,240,34,76,0.447,27,54,0.5,7,22,0.318,30,39,0.769,105,37,88,0.42,29,52,0.558,8,36,0.222,18,21,0.857,100
1535,HOU,2021-03-11,105,@,SAC,0,240,41,99,0.414,30,54,0.556,11,45,0.244,12,17,0.706,105,45,92,0.489,34,59,0.576,11,33,0.333,24,28,0.857,125
1536,CHI,2021-03-11,105,,PHI,0,240,39,83,0.47,25,54,0.463,14,29,0.483,13,16,0.813,105,53,103,0.515,43,70,0.614,10,33,0.303,11,15,0.733,127
1537,NOP,2021-03-11,105,,MIN,0,240,43,100,0.43,37,68,0.544,6,32,0.188,13,24,0.542,105,51,95,0.537,32,55,0.582,19,40,0.475,14,16,0.875,135
1538,CHO,2021-03-11,105,,DET,1,240,36,90,0.4,26,60,0.433,10,30,0.333,23,24,0.958,105,38,85,0.447,23,39,0.59,15,46,0.326,11,14,0.786,102
1539,TOR,2021-03-03,105,,DET,0,240,34,77,0.442,22,41,0.537,12,36,0.333,25,30,0.833,105,48,91,0.527,28,50,0.56,20,41,0.488,13,21,0.619,129
1540,MIL,2021-02-28,105,,LAC,1,240,38,85,0.447,26,47,0.553,12,38,0.316,17,22,0.773,105,40,97,0.412,26,53,0.491,14,44,0.318,6,7,0.857,100
1541,DET,2021-02-23,105,@,ORL,1,240,41,88,0.466,31,54,0.574,10,34,0.294,13,16,0.813,105,33,88,0.375,19,50,0.38,14,38,0.368,13,22,0.591,93
1542,ORL,2021-02-21,105,,DET,1,240,35,81,0.432,26,51,0.51,9,30,0.3,26,29,0.897,105,34,91,0.374,23,51,0.451,11,40,0.275,17,21,0.81,96
1543,CHI,2021-02-19,105,@,PHI,0,240,40,95,0.421,33,63,0.524,7,32,0.219,18,18,1.0,105,41,87,0.471,34,66,0.515,7,21,0.333,23,29,0.793,112
1544,CHI,2021-02-17,105,,DET,1,240,41,85,0.482,33,57,0.579,8,28,0.286,15,24,0.625,105,37,82,0.451,29,54,0.537,8,28,0.286,20,24,0.833,102
1545,LAL,2021-02-14,105,@,DEN,0,240,40,87,0.46,34,59,0.576,6,28,0.214,19,29,0.655,105,39,85,0.459,20,38,0.526,19,47,0.404,25,34,0.735,122
1546,MEM,2021-02-12,105,@,LAL,0,240,39,80,0.488,27,51,0.529,12,29,0.414,15,19,0.789,105,43,85,0.506,37,55,0.673,6,30,0.2,23,33,0.697,115
1547,ORL,2021-02-11,105,@,GSW,0,240,38,97,0.392,23,64,0.359,15,33,0.455,14,18,0.778,105,41,88,0.466,21,38,0.553,20,50,0.4,9,12,0.75,111
1548,SAS,2021-02-08,105,,GSW,1,240,39,96,0.406,28,65,0.431,11,31,0.355,16,19,0.842,105,38,86,0.442,25,49,0.51,13,37,0.351,11,15,0.733,100
1549,WAS,2021-02-08,105,@,CHI,1,240,36,86,0.419,30,60,0.5,6,26,0.231,27,36,0.75,105,36,85,0.424,27,55,0.491,9,30,0.3,20,24,0.833,101
1550,CLE,2021-02-05,105,,MIL,0,240,41,92,0.446,30,60,0.5,11,32,0.344,12,16,0.75,105,50,97,0.515,43,75,0.573,7,22,0.318,16,22,0.727,123
1551,PHI,2021-02-04,105,,POR,0,240,39,81,0.481,32,54,0.593,7,27,0.259,20,24,0.833,105,45,98,0.459,32,67,0.478,13,31,0.419,18,23,0.783,121
1552,DET,2021-02-02,105,@,UTA,0,240,39,93,0.419,30,66,0.455,9,27,0.333,18,20,0.9,105,38,82,0.463,22,40,0.55,16,42,0.381,25,29,0.862,117
1553,MIA,2021-01-30,105,,SAC,1,240,36,77,0.468,25,45,0.556,11,32,0.344,22,26,0.846,105,41,85,0.482,24,40,0.6,17,45,0.378,5,11,0.455,104
1554,DAL,2021-01-30,105,,PHO,0,240,44,83,0.53,35,54,0.648,9,29,0.31,8,14,0.571,105,37,81,0.457,27,59,0.458,10,22,0.455,27,31,0.871,111
1555,IND,2021-01-29,105,@,CHO,0,240,42,87,0.483,31,52,0.596,11,35,0.314,10,13,0.769,105,43,85,0.506,27,48,0.563,16,37,0.432,6,9,0.667,108
1556,MIA,2021-01-28,105,,LAC,0,240,40,90,0.444,27,57,0.474,13,33,0.394,12,15,0.8,105,36,87,0.414,19,45,0.422,17,42,0.405,20,22,0.909,109
1557,DEN,2021-01-17,105,,UTA,0,240,40,100,0.4,26,63,0.413,14,37,0.378,11,15,0.733,105,39,76,0.513,24,39,0.615,15,37,0.405,16,28,0.571,109
1558,NYK,2021-01-17,105,@,BOS,1,240,38,80,0.475,26,49,0.531,12,31,0.387,17,21,0.81,105,25,84,0.298,18,38,0.474,7,46,0.152,18,29,0.621,75
1559,SAS,2021-01-14,105,,HOU,0,240,42,92,0.457,33,61,0.541,9,31,0.29,12,16,0.75,105,42,86,0.488,29,53,0.547,13,33,0.394,12,19,0.632,109
1560,TOR,2021-01-10,105,@,GSW,0,240,39,96,0.406,26,58,0.448,13,38,0.342,14,22,0.636,105,38,93,0.409,25,47,0.532,13,46,0.283,17,19,0.895,106
1561,ATL,2021-01-09,105,@,CHO,0,240,34,89,0.382,20,44,0.455,14,45,0.311,23,28,0.821,105,40,77,0.519,25,44,0.568,15,33,0.455,18,24,0.75,113
1562,LAC,2021-01-08,105,@,GSW,0,240,40,83,0.482,26,52,0.5,14,31,0.452,11,13,0.846,105,40,82,0.488,20,41,0.488,20,41,0.488,15,18,0.833,115
1563,PHO,2021-01-08,105,@,DET,0,265,41,91,0.451,24,39,0.615,17,52,0.327,6,13,0.462,105,37,90,0.411,26,56,0.464,11,34,0.324,25,29,0.862,110
1564,ORL,2021-01-06,105,,CLE,1,240,40,81,0.494,28,52,0.538,12,29,0.414,13,18,0.722,105,36,85,0.424,32,59,0.542,4,26,0.154,18,26,0.692,94
1565,MIA,2021-01-06,105,,BOS,0,240,35,81,0.432,22,45,0.489,13,36,0.361,22,26,0.846,105,42,99,0.424,30,64,0.469,12,35,0.343,11,12,0.917,107
1566,POR,2020-12-30,105,@,LAC,0,240,32,76,0.421,20,38,0.526,12,38,0.316,29,34,0.853,105,47,95,0.495,29,57,0.509,18,38,0.474,16,22,0.727,128
1567,DEN,2021-05-14,104,@,DET,1,240,42,86,0.488,33,54,0.611,9,32,0.281,11,14,0.786,104,34,83,0.41,28,46,0.609,6,37,0.162,17,23,0.739,91
1568,DAL,2021-05-11,104,@,MEM,0,240,37,88,0.42,25,50,0.5,12,38,0.316,18,19,0.947,104,51,89,0.573,35,56,0.625,16,33,0.485,15,16,0.938,133
1569,DET,2021-05-08,104,@,PHI,0,240,41,84,0.488,30,50,0.6,11,34,0.324,11,16,0.688,104,41,84,0.488,32,54,0.593,9,30,0.3,27,31,0.871,118
1570,SAC,2021-05-07,104,,SAS,0,240,41,84,0.488,28,52,0.538,13,32,0.406,9,15,0.6,104,46,89,0.517,42,67,0.627,4,22,0.182,17,19,0.895,113
1571,SAC,2021-05-05,104,@,IND,1,240,43,95,0.453,35,63,0.556,8,32,0.25,10,14,0.714,104,36,83,0.434,27,58,0.466,9,25,0.36,12,17,0.706,93
1572,MEM,2021-05-03,104,,NYK,0,240,34,86,0.395,18,45,0.4,16,41,0.39,20,24,0.833,104,45,89,0.506,31,62,0.5,14,27,0.519,14,18,0.778,118
1573,LAC,2021-05-01,104,,DEN,0,240,36,83,0.434,22,49,0.449,14,34,0.412,18,24,0.75,104,39,80,0.488,27,48,0.563,12,32,0.375,20,21,0.952,110
1574,ATL,2021-04-30,104,@,PHI,0,240,36,82,0.439,26,54,0.481,10,28,0.357,22,28,0.786,104,47,101,0.465,37,73,0.507,10,28,0.357,22,26,0.846,126
1575,CLE,2021-04-28,104,,ORL,0,240,37,92,0.402,25,48,0.521,12,44,0.273,18,24,0.75,104,43,85,0.506,33,56,0.589,10,29,0.345,13,20,0.65,109
1576,CHO,2021-04-27,104,,MIL,0,240,38,82,0.463,26,47,0.553,12,35,0.343,16,23,0.696,104,47,93,0.505,38,58,0.655,9,35,0.257,11,14,0.786,114
1577,UTA,2021-04-26,104,@,MIN,0,240,37,95,0.389,21,38,0.553,16,57,0.281,14,19,0.737,104,37,83,0.446,21,39,0.538,16,44,0.364,15,21,0.714,105
1578,BOS,2021-04-25,104,@,CHO,0,240,34,88,0.386,20,47,0.426,14,41,0.341,22,26,0.846,104,47,93,0.505,26,50,0.52,21,43,0.488,10,11,0.909,125
1579,MIL,2021-04-25,104,@,ATL,0,240,39,81,0.481,31,53,0.585,8,28,0.286,18,23,0.783,104,40,88,0.455,27,53,0.509,13,35,0.371,18,23,0.783,111
1580,HOU,2021-04-23,104,,LAC,0,240,36,89,0.404,23,47,0.489,13,42,0.31,19,22,0.864,104,39,97,0.402,27,63,0.429,12,34,0.353,19,23,0.826,109
1581,BOS,2021-04-23,104,@,BRK,0,240,38,94,0.404,21,52,0.404,17,42,0.405,11,16,0.688,104,37,86,0.43,26,54,0.481,11,32,0.344,24,28,0.857,109
1582,OKC,2021-04-16,104,@,DET,0,240,39,97,0.402,32,58,0.552,7,39,0.179,19,26,0.731,104,38,90,0.422,28,55,0.509,10,35,0.286,24,34,0.706,110
1583,LAL,2021-04-08,104,@,MIA,0,240,35,79,0.443,23,44,0.523,12,35,0.343,22,25,0.88,104,34,71,0.479,24,46,0.522,10,25,0.4,32,40,0.8,110
1584,LAC,2021-04-04,104,,LAL,1,240,41,86,0.477,27,58,0.466,14,28,0.5,8,9,0.889,104,32,80,0.4,25,57,0.439,7,23,0.304,15,20,0.75,86
1585,DEN,2021-03-30,104,,PHI,1,240,39,81,0.481,27,50,0.54,12,31,0.387,14,17,0.824,104,35,82,0.427,24,47,0.511,11,35,0.314,14,15,0.933,95
1586,WAS,2021-03-30,104,,CHO,0,240,41,100,0.41,31,63,0.492,10,37,0.27,12,15,0.8,104,42,90,0.467,28,56,0.5,14,34,0.412,16,19,0.842,114
1587,TOR,2021-03-29,104,@,DET,0,240,35,86,0.407,24,50,0.48,11,36,0.306,23,28,0.821,104,38,75,0.507,23,45,0.511,15,30,0.5,27,34,0.794,118
1588,CHI,2021-03-27,104,@,SAS,0,240,41,95,0.432,33,61,0.541,8,34,0.235,14,18,0.778,104,46,85,0.541,36,60,0.6,10,25,0.4,18,28,0.643,120
1589,PHO,2021-03-26,104,@,TOR,1,240,43,90,0.478,34,54,0.63,9,36,0.25,9,9,1.0,104,37,90,0.411,25,45,0.556,12,45,0.267,14,16,0.875,100
1590,CHO,2021-03-17,104,@,DEN,0,240,36,80,0.45,24,42,0.571,12,38,0.316,20,28,0.714,104,52,90,0.578,36,46,0.783,16,44,0.364,9,13,0.692,129
1591,TOR,2021-03-13,104,@,CHO,0,240,37,96,0.385,22,50,0.44,15,46,0.326,15,18,0.833,104,39,81,0.481,18,32,0.563,21,49,0.429,15,19,0.789,114
1592,SAS,2021-03-12,104,,ORL,1,240,40,89,0.449,30,60,0.5,10,29,0.345,14,18,0.778,104,29,80,0.363,19,42,0.452,10,38,0.263,9,12,0.75,77
1593,GSW,2021-03-11,104,@,LAC,0,240,38,88,0.432,29,52,0.558,9,36,0.25,19,27,0.704,104,44,96,0.458,26,55,0.473,18,41,0.439,24,29,0.828,130
1594,SAS,2021-03-10,104,@,DAL,0,240,38,83,0.458,26,55,0.473,12,28,0.429,16,20,0.8,104,43,83,0.518,30,43,0.698,13,40,0.325,16,19,0.842,115
1595,DET,2021-03-04,104,@,NYK,0,240,39,80,0.488,25,44,0.568,14,36,0.389,12,15,0.8,104,45,83,0.542,36,56,0.643,9,27,0.333,15,19,0.789,114
1596,LAL,2021-03-02,104,,PHO,0,240,40,79,0.506,29,48,0.604,11,31,0.355,13,17,0.765,104,38,77,0.494,22,48,0.458,16,29,0.552,22,25,0.88,114
1597,OKC,2021-02-16,104,,POR,0,240,37,85,0.435,27,52,0.519,10,33,0.303,20,27,0.741,104,42,96,0.438,22,49,0.449,20,47,0.426,11,17,0.647,115
1598,MIN,2021-02-16,104,,LAL,0,240,39,93,0.419,23,59,0.39,16,34,0.471,10,13,0.769,104,42,77,0.545,31,51,0.608,11,26,0.423,17,21,0.81,112
1599,WAS,2021-02-14,104,,BOS,1,240,33,83,0.398,26,53,0.491,7,30,0.233,31,36,0.861,104,32,90,0.356,23,55,0.418,9,35,0.257,18,30,0.6,91
1600,BRK,2021-02-10,104,,IND,1,240,32,76,0.421,23,45,0.511,9,31,0.29,31,35,0.886,104,36,92,0.391,21,54,0.389,15,38,0.395,7,11,0.636,94
1601,OKC,2021-02-03,104,,HOU,1,240,36,83,0.434,26,50,0.52,10,33,0.303,22,26,0.846,104,33,86,0.384,21,40,0.525,12,46,0.261,9,13,0.692,87
1602,CLE,2021-01-31,104,@,MIN,0,240,41,84,0.488,37,68,0.544,4,16,0.25,18,23,0.783,104,41,91,0.451,25,51,0.49,16,40,0.4,11,15,0.733,109
1603,SAC,2021-01-30,104,@,MIA,0,240,41,85,0.482,24,40,0.6,17,45,0.378,5,11,0.455,104,36,77,0.468,25,45,0.556,11,32,0.344,22,26,0.846,105
1604,HOU,2021-01-28,104,,POR,1,240,38,90,0.422,25,43,0.581,13,47,0.277,15,18,0.833,104,39,93,0.419,22,52,0.423,17,41,0.415,6,8,0.75,101
1605,DAL,2021-01-27,104,@,UTA,0,240,42,91,0.462,30,56,0.536,12,35,0.343,8,9,0.889,104,42,91,0.462,26,50,0.52,16,41,0.39,16,21,0.762,116
1606,PHI,2021-01-25,104,@,DET,0,240,40,94,0.426,31,66,0.47,9,28,0.321,15,20,0.75,104,35,70,0.5,18,32,0.563,17,38,0.447,32,38,0.842,119
1607,ORL,2021-01-24,104,,CHO,0,240,39,87,0.448,22,49,0.449,17,38,0.447,9,13,0.692,104,42,88,0.477,28,52,0.538,14,36,0.389,9,16,0.563,107
1608,GSW,2021-01-21,104,,NYK,0,240,33,86,0.384,24,48,0.5,9,38,0.237,29,39,0.744,104,38,82,0.463,27,58,0.466,11,24,0.458,32,41,0.78,119
1609,POR,2021-01-18,104,,SAS,0,240,39,90,0.433,29,55,0.527,10,35,0.286,16,19,0.842,104,48,90,0.533,33,57,0.579,15,33,0.455,14,16,0.875,125
1610,PHO,2021-01-18,104,@,MEM,0,240,40,88,0.455,25,52,0.481,15,36,0.417,9,16,0.563,104,41,83,0.494,30,57,0.526,11,26,0.423,15,20,0.75,108
1611,PHI,2021-01-16,104,@,MEM,0,240,37,84,0.44,30,59,0.508,7,25,0.28,23,32,0.719,104,43,99,0.434,35,70,0.5,8,29,0.276,12,18,0.667,106
1612,GSW,2021-01-14,104,@,DEN,0,240,38,81,0.469,27,52,0.519,11,29,0.379,17,24,0.708,104,41,90,0.456,30,53,0.566,11,37,0.297,21,27,0.778,114
1613,DAL,2021-01-13,104,@,CHO,1,240,40,96,0.417,25,50,0.5,15,46,0.326,9,16,0.563,104,38,100,0.38,28,62,0.452,10,38,0.263,7,14,0.5,93
1614,IND,2021-01-12,104,@,GSW,1,240,39,88,0.443,30,60,0.5,9,28,0.321,17,25,0.68,104,34,89,0.382,21,51,0.412,13,38,0.342,14,22,0.636,95
1615,BRK,2020-12-27,104,@,CHO,0,240,35,82,0.427,18,35,0.514,17,47,0.362,17,25,0.68,104,43,96,0.448,33,62,0.532,10,34,0.294,10,17,0.588,106
1616,CHI,2020-12-23,104,,ATL,0,240,36,87,0.414,28,52,0.538,8,35,0.229,24,28,0.857,104,43,80,0.538,29,45,0.644,14,35,0.4,24,29,0.828,124
1617,SAS,2021-05-15,103,,PHO,0,240,39,88,0.443,35,62,0.565,4,26,0.154,21,24,0.875,103,52,94,0.553,37,61,0.607,15,33,0.455,21,22,0.955,140
1618,MIN,2021-05-13,103,,DEN,0,240,34,80,0.425,18,39,0.462,16,41,0.39,19,32,0.594,103,46,96,0.479,34,60,0.567,12,36,0.333,10,11,0.909,114
1619,IND,2021-05-11,103,,PHI,1,240,37,83,0.446,23,42,0.548,14,41,0.341,15,16,0.938,103,38,87,0.437,30,61,0.492,8,26,0.308,10,14,0.714,94
1620,PHO,2021-05-05,103,@,ATL,0,240,33,79,0.418,21,47,0.447,12,32,0.375,25,29,0.862,103,53,84,0.631,40,58,0.69,13,26,0.5,16,18,0.889,135
1621,SAC,2021-05-04,103,@,OKC,1,240,39,95,0.411,27,52,0.519,12,43,0.279,13,16,0.813,103,35,98,0.357,24,62,0.387,11,36,0.306,18,25,0.72,99
1622,GSW,2021-05-04,103,@,NOP,0,240,39,93,0.419,19,40,0.475,20,53,0.377,5,7,0.714,103,39,97,0.402,27,67,0.403,12,30,0.4,18,22,0.818,108
1623,TOR,2021-04-27,103,,BRK,0,240,36,91,0.396,21,48,0.438,15,43,0.349,16,19,0.842,103,40,83,0.482,22,38,0.579,18,45,0.4,18,18,1.0,116
1624,GSW,2021-04-27,103,,DAL,0,240,34,84,0.405,18,41,0.439,16,43,0.372,19,24,0.792,103,48,92,0.522,30,57,0.526,18,35,0.514,19,22,0.864,133
1625,ORL,2021-04-26,103,,LAL,0,240,36,76,0.474,25,51,0.49,11,25,0.44,20,24,0.833,103,47,87,0.54,36,56,0.643,11,31,0.355,9,14,0.643,114
1626,LAC,2021-04-26,103,@,NOP,0,240,36,90,0.4,22,45,0.489,14,45,0.311,17,17,1.0,103,44,82,0.537,29,53,0.547,15,29,0.517,17,26,0.654,120
1627,TOR,2021-04-24,103,@,NYK,0,240,36,83,0.434,19,39,0.487,17,44,0.386,14,19,0.737,103,42,75,0.56,26,44,0.591,16,31,0.516,20,24,0.833,120
1628,MIA,2021-04-23,103,@,ATL,0,240,38,79,0.481,25,42,0.595,13,37,0.351,14,16,0.875,103,43,80,0.538,28,45,0.622,15,35,0.429,17,19,0.895,118
1629,BRK,2021-04-21,103,@,TOR,0,240,36,91,0.396,23,50,0.46,13,41,0.317,18,23,0.783,103,39,90,0.433,21,43,0.488,18,47,0.383,18,21,0.857,114
1630,LAC,2021-04-16,103,@,PHI,0,240,37,82,0.451,18,43,0.419,19,39,0.487,10,16,0.625,103,35,83,0.422,21,39,0.538,14,44,0.318,22,30,0.733,106
1631,CLE,2021-04-14,103,@,CHO,1,240,37,76,0.487,24,45,0.533,13,31,0.419,16,19,0.842,103,34,84,0.405,18,40,0.45,16,44,0.364,6,12,0.5,90
1632,TOR,2021-04-13,103,,ATL,0,240,42,88,0.477,32,49,0.653,10,39,0.256,9,13,0.692,103,40,84,0.476,27,54,0.5,13,30,0.433,15,22,0.682,108
1633,DET,2021-04-10,103,@,POR,0,240,37,83,0.446,28,57,0.491,9,26,0.346,20,28,0.714,103,43,90,0.478,30,61,0.492,13,29,0.448,19,24,0.792,118
1634,POR,2021-04-08,103,@,UTA,0,240,38,96,0.396,25,48,0.521,13,48,0.271,14,18,0.778,103,43,95,0.453,31,53,0.585,12,42,0.286,24,27,0.889,122
1635,PHO,2021-04-08,103,@,LAC,0,240,36,71,0.507,30,47,0.638,6,24,0.25,25,30,0.833,103,42,84,0.5,24,47,0.511,18,37,0.486,11,12,0.917,113
1636,TOR,2021-04-05,103,,WAS,1,240,44,94,0.468,37,61,0.607,7,33,0.212,8,11,0.727,103,37,94,0.394,25,59,0.424,12,35,0.343,15,18,0.833,101
1637,UTA,2021-04-05,103,@,DAL,0,240,37,88,0.42,25,44,0.568,12,44,0.273,17,22,0.773,103,41,91,0.451,18,42,0.429,23,49,0.469,6,8,0.75,111
1638,OKC,2021-04-02,103,@,PHO,0,240,35,89,0.393,20,51,0.392,15,38,0.395,18,23,0.783,103,54,90,0.6,39,57,0.684,15,33,0.455,17,21,0.81,140
1639,NOP,2021-04-02,103,,ATL,0,240,38,88,0.432,30,59,0.508,8,29,0.276,19,23,0.826,103,49,87,0.563,36,58,0.621,13,29,0.448,15,21,0.714,126
1640,TOR,2021-03-31,103,@,OKC,0,240,35,90,0.389,19,44,0.432,16,46,0.348,17,20,0.85,103,39,86,0.453,25,53,0.472,14,33,0.424,21,28,0.75,113
1641,ORL,2021-03-30,103,@,LAC,1,240,38,92,0.413,33,75,0.44,5,17,0.294,22,25,0.88,103,37,89,0.416,25,52,0.481,12,37,0.324,10,10,1.0,96
1642,DAL,2021-03-27,103,@,NOP,0,240,37,83,0.446,27,52,0.519,10,31,0.323,19,24,0.792,103,42,81,0.519,33,55,0.6,9,26,0.346,19,29,0.655,112
1643,CLE,2021-03-24,103,@,CHI,1,240,42,92,0.457,31,63,0.492,11,29,0.379,8,10,0.8,103,37,83,0.446,29,55,0.527,8,28,0.286,12,14,0.857,94
1644,MIN,2021-03-22,103,,OKC,0,240,38,92,0.413,24,53,0.453,14,39,0.359,13,18,0.722,103,41,87,0.471,20,50,0.4,21,37,0.568,9,10,0.9,112
1645,GSW,2021-03-20,103,@,MEM,0,240,31,90,0.344,18,49,0.367,13,41,0.317,28,34,0.824,103,37,95,0.389,27,63,0.429,10,32,0.313,27,31,0.871,111
1646,MEM,2021-03-19,103,,GSW,0,240,39,84,0.464,31,58,0.534,8,26,0.308,17,21,0.81,103,44,91,0.484,29,50,0.58,15,41,0.366,13,18,0.722,116
1647,DEN,2021-03-13,103,,DAL,0,240,37,90,0.411,21,49,0.429,16,41,0.39,13,18,0.722,103,42,86,0.488,24,40,0.6,18,46,0.391,14,16,0.875,116
1648,DEN,2021-03-12,103,@,MEM,1,240,41,92,0.446,28,55,0.509,13,37,0.351,8,11,0.727,103,40,87,0.46,26,59,0.441,14,28,0.5,8,8,1.0,102
1649,ORL,2021-03-11,103,@,MIA,0,240,39,96,0.406,27,62,0.435,12,34,0.353,13,15,0.867,103,41,91,0.451,25,42,0.595,16,49,0.327,13,22,0.591,111
1650,MIA,2021-03-04,103,@,NOP,1,240,36,73,0.493,26,43,0.605,10,30,0.333,21,25,0.84,103,33,84,0.393,22,41,0.537,11,43,0.256,16,20,0.8,93
1651,IND,2021-03-04,103,,DEN,0,240,41,90,0.456,27,51,0.529,14,39,0.359,7,12,0.583,103,45,77,0.584,33,49,0.673,12,28,0.429,11,16,0.688,113
1652,PHI,2021-02-21,103,@,TOR,0,240,33,85,0.388,22,48,0.458,11,37,0.297,26,35,0.743,103,40,81,0.494,26,47,0.553,14,34,0.412,16,18,0.889,110
1653,NYK,2021-02-21,103,,MIN,1,240,33,78,0.423,27,60,0.45,6,18,0.333,31,38,0.816,103,33,82,0.402,17,47,0.362,16,35,0.457,17,21,0.81,99
1654,CLE,2021-02-19,103,,DEN,0,240,39,83,0.47,27,52,0.519,12,31,0.387,13,21,0.619,103,46,80,0.575,31,49,0.633,15,31,0.484,13,17,0.765,120
1655,UTA,2021-02-07,103,@,IND,1,240,38,92,0.413,25,50,0.5,13,42,0.31,14,21,0.667,103,37,93,0.398,29,64,0.453,8,29,0.276,13,18,0.722,95
1656,NYK,2021-02-07,103,,MIA,0,240,38,85,0.447,22,43,0.512,16,42,0.381,11,15,0.733,103,40,83,0.482,27,48,0.563,13,35,0.371,16,20,0.8,109
1657,OKC,2021-02-05,103,,MIN,0,240,39,85,0.459,26,51,0.51,13,34,0.382,12,17,0.706,103,41,94,0.436,25,54,0.463,16,40,0.4,8,9,0.889,106
1658,MEM,2021-02-04,103,,HOU,0,240,37,87,0.425,25,52,0.481,12,35,0.343,17,24,0.708,103,41,87,0.471,22,42,0.524,19,45,0.422,14,17,0.824,115
1659,CHI,2021-02-03,103,,NYK,0,240,43,88,0.489,37,52,0.712,6,36,0.167,11,16,0.688,103,43,89,0.483,32,67,0.478,11,22,0.5,10,15,0.667,107
1660,WAS,2021-02-03,103,@,MIA,1,240,35,84,0.417,20,47,0.426,15,37,0.405,18,25,0.72,103,36,83,0.434,24,48,0.5,12,35,0.343,16,22,0.727,100
1661,CHI,2021-01-25,103,,BOS,0,240,41,88,0.466,24,49,0.49,17,39,0.436,4,10,0.4,103,44,87,0.506,29,58,0.5,15,29,0.517,16,20,0.8,119
1662,CLE,2021-01-24,103,@,BOS,0,240,34,85,0.4,24,52,0.462,10,33,0.303,25,34,0.735,103,52,93,0.559,38,65,0.585,14,28,0.5,23,27,0.852,141
1663,SAC,2021-01-22,103,,NYK,1,240,38,91,0.418,26,57,0.456,12,34,0.353,15,21,0.714,103,36,94,0.383,31,72,0.431,5,22,0.227,17,25,0.68,94
1664,HOU,2021-01-22,103,@,DET,1,240,37,95,0.389,23,54,0.426,14,41,0.341,15,20,0.75,103,31,82,0.378,16,50,0.32,15,32,0.469,25,37,0.676,102
1665,HOU,2021-01-20,103,,PHO,0,240,37,88,0.42,27,57,0.474,10,31,0.323,19,22,0.864,103,42,89,0.472,34,55,0.618,8,34,0.235,17,19,0.895,109
1666,SAS,2021-01-16,103,,HOU,1,240,40,100,0.4,35,76,0.461,5,24,0.208,18,23,0.783,103,31,84,0.369,19,52,0.365,12,32,0.375,17,27,0.63,91
1667,NYK,2021-01-15,103,@,CLE,0,240,40,82,0.488,31,57,0.544,9,25,0.36,14,16,0.875,103,36,79,0.456,27,52,0.519,9,27,0.333,25,34,0.735,106
1668,PHI,2021-01-09,103,,DEN,0,240,43,103,0.417,32,68,0.471,11,35,0.314,6,10,0.6,103,45,90,0.5,33,57,0.579,12,33,0.364,13,15,0.867,115
1669,ORL,2021-01-04,103,,CLE,1,240,38,88,0.432,23,54,0.426,15,34,0.441,12,13,0.923,103,33,85,0.388,23,57,0.404,10,28,0.357,7,12,0.583,83
1670,DEN,2021-01-01,103,,PHO,0,240,39,86,0.453,27,57,0.474,12,29,0.414,13,16,0.813,103,37,76,0.487,24,41,0.585,13,35,0.371,19,21,0.905,106
1671,SAS,2021-01-01,103,,LAL,0,240,36,85,0.424,23,51,0.451,13,34,0.382,18,26,0.692,103,41,101,0.406,27,68,0.397,14,33,0.424,13,16,0.813,109
1672,PHO,2020-12-26,103,@,SAC,0,240,41,98,0.418,30,54,0.556,11,44,0.25,10,13,0.769,103,39,86,0.453,34,63,0.54,5,23,0.217,23,33,0.697,106
1673,NYK,2021-05-13,102,,SAS,1,240,35,86,0.407,21,51,0.412,14,35,0.4,18,18,1.0,102,38,91,0.418,32,70,0.457,6,21,0.286,16,19,0.842,98
1674,TOR,2021-05-13,102,@,CHI,0,240,40,90,0.444,28,54,0.519,12,36,0.333,10,18,0.556,102,45,83,0.542,28,47,0.596,17,36,0.472,7,10,0.7,114
1675,CLE,2021-05-12,102,,BOS,1,240,36,80,0.45,28,56,0.5,8,24,0.333,22,27,0.815,102,36,101,0.356,24,60,0.4,12,41,0.293,10,14,0.714,94
1676,ORL,2021-05-11,102,@,MIL,0,240,39,94,0.415,29,64,0.453,10,30,0.333,14,20,0.7,102,43,101,0.426,35,68,0.515,8,33,0.242,20,27,0.741,114
1677,CLE,2021-05-10,102,,IND,0,240,33,93,0.355,20,54,0.37,13,39,0.333,23,30,0.767,102,44,88,0.5,33,61,0.541,11,27,0.407,12,16,0.75,111
1678,SAS,2021-05-08,102,@,POR,0,240,37,93,0.398,29,63,0.46,8,30,0.267,20,23,0.87,102,45,97,0.464,33,63,0.524,12,34,0.353,22,30,0.733,124
1679,CHO,2021-05-04,102,@,DET,1,240,38,93,0.409,30,62,0.484,8,31,0.258,18,24,0.75,102,39,85,0.459,30,53,0.566,9,32,0.281,12,20,0.6,99
1680,TOR,2021-05-01,102,@,UTA,0,240,42,94,0.447,30,61,0.492,12,33,0.364,6,9,0.667,102,37,78,0.474,20,37,0.541,17,41,0.415,15,18,0.833,106
1681,MIA,2021-04-26,102,,CHI,0,240,36,84,0.429,29,48,0.604,7,36,0.194,23,25,0.92,102,41,77,0.532,30,48,0.625,11,29,0.379,17,22,0.773,110
1682,CLE,2021-04-23,102,@,CHO,0,240,41,80,0.513,31,50,0.62,10,30,0.333,10,14,0.714,102,40,94,0.426,26,54,0.481,14,40,0.35,14,18,0.778,108
1683,CHI,2021-04-19,102,@,BOS,1,240,41,91,0.451,30,59,0.508,11,32,0.344,9,10,0.9,102,36,77,0.468,26,52,0.5,10,25,0.4,14,15,0.933,96
1684,ORL,2021-04-16,102,@,TOR,0,240,35,77,0.455,27,54,0.5,8,23,0.348,24,34,0.706,102,41,82,0.5,27,47,0.574,14,35,0.4,17,18,0.944,113
1685,NYK,2021-04-11,102,,TOR,1,240,35,88,0.398,26,53,0.491,9,35,0.257,23,27,0.852,102,33,79,0.418,22,45,0.489,11,34,0.324,19,23,0.826,96
1686,OKC,2021-04-08,102,,CLE,0,240,40,89,0.449,27,57,0.474,13,32,0.406,9,13,0.692,102,48,94,0.511,35,57,0.614,13,37,0.351,20,24,0.833,129
1687,OKC,2021-04-07,102,,CHO,0,240,37,85,0.435,21,44,0.477,16,41,0.39,12,17,0.706,102,43,97,0.443,28,53,0.528,15,44,0.341,12,13,0.923,113
1688,HOU,2021-04-07,102,,DAL,1,240,38,88,0.432,21,44,0.477,17,44,0.386,9,16,0.563,102,33,87,0.379,23,48,0.479,10,39,0.256,17,22,0.773,93
1689,HOU,2021-04-02,102,@,BOS,0,240,37,86,0.43,25,50,0.5,12,36,0.333,16,26,0.615,102,46,88,0.523,29,47,0.617,17,41,0.415,9,12,0.75,118
1690,MIN,2021-03-31,102,,NYK,1,240,36,87,0.414,22,47,0.468,14,40,0.35,16,19,0.842,102,39,82,0.476,28,59,0.475,11,23,0.478,12,17,0.706,101
1691,CHI,2021-03-29,102,@,GSW,0,240,44,84,0.524,38,60,0.633,6,24,0.25,8,11,0.727,102,46,92,0.5,30,54,0.556,16,38,0.421,8,9,0.889,116
1692,ATL,2021-03-28,102,@,DEN,0,240,36,76,0.474,24,42,0.571,12,34,0.353,18,21,0.857,102,50,92,0.543,35,56,0.625,15,36,0.417,11,16,0.688,126
1693,NYK,2021-03-27,102,@,MIL,1,240,40,93,0.43,24,49,0.49,16,44,0.364,6,8,0.75,102,36,87,0.414,22,51,0.431,14,36,0.389,10,16,0.625,96
1694,WAS,2021-03-25,102,@,NYK,0,240,37,80,0.463,29,54,0.537,8,26,0.308,20,33,0.606,102,34,93,0.366,27,65,0.415,7,28,0.25,31,42,0.738,106
1695,OKC,2021-03-16,102,@,CHI,0,240,42,90,0.467,35,70,0.5,7,20,0.35,11,13,0.846,102,48,94,0.511,36,58,0.621,12,36,0.333,15,18,0.833,123
1696,MIA,2021-03-14,102,@,ORL,1,240,37,89,0.416,23,39,0.59,14,50,0.28,14,15,0.933,102,33,75,0.44,17,35,0.486,16,40,0.4,15,21,0.714,97
1697,MEM,2021-03-12,102,,DEN,0,240,40,87,0.46,26,59,0.441,14,28,0.5,8,8,1.0,102,41,92,0.446,28,55,0.509,13,37,0.351,8,11,0.727,103
1698,DET,2021-03-11,102,@,CHO,0,240,38,85,0.447,23,39,0.59,15,46,0.326,11,14,0.786,102,36,90,0.4,26,60,0.433,10,30,0.333,23,24,0.958,105
1699,SAS,2021-03-04,102,,OKC,0,240,40,85,0.471,30,54,0.556,10,31,0.323,12,12,1.0,102,37,85,0.435,25,45,0.556,12,40,0.3,21,26,0.808,107
1700,MIN,2021-03-03,102,,CHO,0,240,39,96,0.406,30,56,0.536,9,40,0.225,15,18,0.833,102,51,98,0.52,34,59,0.576,17,39,0.436,16,21,0.762,135
1701,LAL,2021-02-26,102,,POR,1,240,37,88,0.42,30,61,0.492,7,27,0.259,21,28,0.75,102,32,83,0.386,21,46,0.457,11,37,0.297,18,20,0.9,93
1702,OKC,2021-02-24,102,,SAS,1,240,37,89,0.416,19,45,0.422,18,44,0.409,10,11,0.909,102,40,86,0.465,31,61,0.508,9,25,0.36,10,15,0.667,99
1703,TOR,2021-02-23,102,,PHI,0,240,40,93,0.43,29,56,0.518,11,37,0.297,11,13,0.846,102,33,80,0.413,16,42,0.381,17,38,0.447,26,30,0.867,109
1704,DAL,2021-02-22,102,,MEM,1,240,35,80,0.438,20,39,0.513,15,41,0.366,17,26,0.654,102,37,94,0.394,31,63,0.492,6,31,0.194,12,19,0.632,92
1705,CHO,2021-02-20,102,,GSW,1,240,37,75,0.493,17,35,0.486,20,40,0.5,8,9,0.889,102,37,85,0.435,24,46,0.522,13,39,0.333,13,17,0.765,100
1706,DET,2021-02-17,102,@,CHI,0,240,37,82,0.451,29,54,0.537,8,28,0.286,20,24,0.833,102,41,85,0.482,33,57,0.579,8,28,0.286,15,24,0.625,105
1707,BOS,2021-02-12,102,,DET,0,240,36,82,0.439,28,55,0.509,8,27,0.296,22,30,0.733,102,34,79,0.43,19,41,0.463,15,38,0.395,25,30,0.833,108
1708,SAS,2021-02-01,102,,MEM,0,240,37,89,0.416,24,52,0.462,13,37,0.351,15,22,0.682,102,52,93,0.559,37,63,0.587,15,30,0.5,14,18,0.778,133
1709,NYK,2021-02-01,102,@,CHI,0,240,37,87,0.425,31,58,0.534,6,29,0.207,22,26,0.846,102,42,88,0.477,31,54,0.574,11,34,0.324,15,20,0.75,110
1710,ORL,2021-01-31,102,@,TOR,0,240,33,82,0.402,20,46,0.435,13,36,0.361,23,28,0.821,102,41,90,0.456,29,51,0.569,12,39,0.308,21,22,0.955,115
1711,NYK,2021-01-29,102,,CLE,1,240,39,80,0.488,29,53,0.547,10,27,0.37,14,16,0.875,102,29,84,0.345,21,58,0.362,8,26,0.308,15,18,0.833,81
1712,OKC,2021-01-27,102,@,PHO,1,240,38,85,0.447,22,45,0.489,16,40,0.4,10,14,0.714,102,36,95,0.379,21,52,0.404,15,43,0.349,10,12,0.833,97
1713,IND,2021-01-24,102,,TOR,0,240,35,87,0.402,22,48,0.458,13,39,0.333,19,22,0.864,102,37,90,0.411,22,55,0.4,15,35,0.429,18,26,0.692,107
1714,DET,2021-01-22,102,,HOU,0,240,31,82,0.378,16,50,0.32,15,32,0.469,25,37,0.676,102,37,95,0.389,23,54,0.426,14,41,0.341,15,20,0.75,103
1715,TOR,2021-01-20,102,,MIA,0,240,35,88,0.398,19,39,0.487,16,49,0.327,16,18,0.889,102,39,80,0.488,21,40,0.525,18,40,0.45,15,17,0.882,111
1716,NOP,2021-01-19,102,@,UTA,0,240,43,95,0.453,37,69,0.536,6,26,0.231,10,15,0.667,102,43,85,0.506,22,38,0.579,21,47,0.447,11,17,0.647,118
1717,OKC,2021-01-12,102,,SAS,0,240,36,83,0.434,29,57,0.509,7,26,0.269,23,29,0.793,102,41,95,0.432,31,60,0.517,10,35,0.286,20,22,0.909,112
1718,HOU,2021-01-10,102,,LAL,0,240,37,90,0.411,25,49,0.51,12,41,0.293,16,23,0.696,102,46,91,0.505,36,62,0.581,10,29,0.345,18,24,0.75,120
1719,CHO,2021-01-06,102,@,ATL,1,240,32,85,0.376,21,49,0.429,11,36,0.306,27,33,0.818,102,36,96,0.375,29,56,0.518,7,40,0.175,15,18,0.833,94
1720,IND,2021-01-02,102,,NYK,0,240,34,84,0.405,15,34,0.441,19,50,0.38,15,18,0.833,102,42,83,0.506,30,56,0.536,12,27,0.444,10,13,0.769,106
1721,HOU,2021-01-02,102,,SAC,1,240,36,81,0.444,23,40,0.575,13,41,0.317,17,23,0.739,102,35,90,0.389,26,62,0.419,9,28,0.321,15,21,0.714,94
1722,DAL,2020-12-23,102,@,PHO,0,240,36,85,0.424,27,48,0.563,9,37,0.243,21,26,0.808,102,38,79,0.481,27,49,0.551,11,30,0.367,19,27,0.704,106
1723,MEM,2021-05-16,101,@,GSW,0,240,40,92,0.435,34,67,0.507,6,25,0.24,15,19,0.789,101,41,83,0.494,26,44,0.591,15,39,0.385,16,18,0.889,113
1724,LAL,2021-05-11,101,,NYK,1,265,37,89,0.416,25,61,0.41,12,28,0.429,15,19,0.789,101,34,87,0.391,24,58,0.414,10,29,0.345,21,23,0.913,99
1725,LAL,2021-05-07,101,@,POR,0,240,37,89,0.416,26,59,0.441,11,30,0.367,16,22,0.727,101,37,88,0.42,25,51,0.49,12,37,0.324,20,21,0.952,106
1726,LAC,2021-04-28,101,@,PHO,0,240,41,80,0.513,29,49,0.592,12,31,0.387,7,9,0.778,101,43,91,0.473,30,54,0.556,13,37,0.351,10,13,0.769,109
1727,MIN,2021-04-24,101,@,UTA,1,240,40,92,0.435,31,54,0.574,9,38,0.237,12,20,0.6,101,33,82,0.402,14,35,0.4,19,47,0.404,11,15,0.733,96
1728,CHI,2021-04-24,101,@,MIA,0,240,38,79,0.481,25,41,0.61,13,38,0.342,12,13,0.923,101,36,80,0.45,22,43,0.512,14,37,0.378,20,24,0.833,106
1729,POR,2021-04-18,101,@,CHO,0,240,36,91,0.396,26,55,0.473,10,36,0.278,19,28,0.679,101,39,83,0.47,21,40,0.525,18,43,0.419,13,17,0.765,109
1730,CLE,2021-04-15,101,,GSW,0,240,35,81,0.432,25,50,0.5,10,31,0.323,21,27,0.778,101,47,92,0.511,30,46,0.652,17,46,0.37,8,10,0.8,119
1731,LAL,2021-04-13,101,@,CHO,1,240,34,82,0.415,18,38,0.474,16,44,0.364,17,18,0.944,101,36,83,0.434,27,48,0.563,9,35,0.257,12,18,0.667,93
1732,MEM,2021-04-12,101,,CHI,1,240,40,85,0.471,31,57,0.544,9,28,0.321,12,14,0.857,101,36,86,0.419,31,55,0.564,5,31,0.161,13,17,0.765,90
1733,CHO,2021-04-11,101,,ATL,0,240,37,80,0.463,22,37,0.595,15,43,0.349,12,14,0.857,101,38,84,0.452,21,45,0.467,17,39,0.436,12,16,0.75,105
1734,BRK,2021-04-10,101,,LAL,0,240,35,80,0.438,30,53,0.566,5,27,0.185,26,30,0.867,101,47,93,0.505,28,59,0.475,19,34,0.559,13,20,0.65,126
1735,NOP,2021-04-09,101,,PHI,1,240,39,90,0.433,35,68,0.515,4,22,0.182,19,30,0.633,101,33,79,0.418,22,48,0.458,11,31,0.355,17,24,0.708,94
1736,SAC,2021-04-08,101,,DET,0,240,38,86,0.442,31,56,0.554,7,30,0.233,18,26,0.692,101,44,84,0.524,36,61,0.59,8,23,0.348,17,20,0.85,113
1737,MIL,2021-04-08,101,@,DAL,0,240,38,100,0.38,26,67,0.388,12,33,0.364,13,16,0.813,101,43,97,0.443,26,52,0.5,17,45,0.378,13,18,0.722,116
1738,BOS,2021-04-07,101,,NYK,1,240,36,86,0.419,21,46,0.457,15,40,0.375,14,20,0.7,101,35,84,0.417,19,51,0.373,16,33,0.485,13,16,0.813,99
1739,TOR,2021-04-06,101,,LAL,0,240,36,91,0.396,31,58,0.534,5,33,0.152,24,30,0.8,101,39,79,0.494,21,39,0.538,18,40,0.45,14,22,0.636,110
1740,WAS,2021-04-05,101,@,TOR,0,240,37,94,0.394,25,59,0.424,12,35,0.343,15,18,0.833,101,44,94,0.468,37,61,0.607,7,33,0.212,8,11,0.727,103
1741,SAS,2021-04-05,101,,CLE,0,240,35,83,0.422,30,57,0.526,5,26,0.192,26,32,0.813,101,45,86,0.523,33,52,0.635,12,34,0.353,23,27,0.852,125
1742,CLE,2021-04-03,101,@,MIA,0,240,35,74,0.473,25,43,0.581,10,31,0.323,21,25,0.84,101,44,82,0.537,29,44,0.659,15,38,0.395,12,16,0.75,115
1743,DEN,2021-04-01,101,@,LAC,1,240,39,81,0.481,26,56,0.464,13,25,0.52,10,14,0.714,101,35,85,0.412,25,51,0.49,10,34,0.294,14,16,0.875,94
1744,NYK,2021-03-31,101,@,MIN,0,240,39,82,0.476,28,59,0.475,11,23,0.478,12,17,0.706,101,36,87,0.414,22,47,0.468,14,40,0.35,16,19,0.842,102
1745,DET,2021-03-31,101,,POR,0,240,40,86,0.465,31,59,0.525,9,27,0.333,12,17,0.706,101,42,82,0.512,26,52,0.5,16,30,0.533,24,26,0.923,124
1746,PHO,2021-03-28,101,@,CHO,1,265,34,96,0.354,26,56,0.464,8,40,0.2,25,29,0.862,101,34,85,0.4,21,42,0.5,13,43,0.302,16,23,0.696,97
1747,HOU,2021-03-26,101,@,MIN,0,240,37,87,0.425,20,43,0.465,17,44,0.386,10,13,0.769,101,39,103,0.379,29,65,0.446,10,38,0.263,19,24,0.792,107
1748,LAL,2021-03-25,101,,PHI,0,240,34,78,0.436,25,52,0.481,9,26,0.346,24,33,0.727,101,39,80,0.488,22,35,0.629,17,45,0.378,14,21,0.667,109
1749,SAS,2021-03-24,101,,LAC,0,240,39,85,0.459,32,63,0.508,7,22,0.318,16,19,0.842,101,49,88,0.557,32,55,0.582,17,33,0.515,19,30,0.633,134
1750,PHI,2021-03-21,101,@,NYK,1,265,38,82,0.463,27,57,0.474,11,25,0.44,14,23,0.609,101,38,88,0.432,27,64,0.422,11,24,0.458,13,23,0.565,100
1751,MIN,2021-03-19,101,@,PHO,0,240,37,79,0.468,24,44,0.545,13,35,0.371,14,18,0.778,101,43,86,0.5,29,59,0.492,14,27,0.519,13,17,0.765,113
1752,POR,2021-03-18,101,,NOP,1,240,33,87,0.379,19,44,0.432,14,43,0.326,21,25,0.84,101,33,83,0.398,23,46,0.5,10,37,0.27,17,25,0.68,93
1753,WAS,2021-03-12,101,,PHI,0,240,40,82,0.488,32,58,0.552,8,24,0.333,13,22,0.591,101,49,90,0.544,38,69,0.551,11,21,0.524,18,18,1.0,127
1754,MIA,2021-03-12,101,@,CHI,1,240,37,80,0.463,25,45,0.556,12,35,0.343,15,20,0.75,101,34,92,0.37,19,54,0.352,15,38,0.395,7,7,1.0,90
1755,NYK,2021-03-11,101,@,MIL,0,240,37,88,0.42,24,51,0.471,13,37,0.351,14,21,0.667,101,50,87,0.575,32,49,0.653,18,38,0.474,16,17,0.941,134
1756,CLE,2021-03-01,101,@,HOU,1,240,36,73,0.493,26,43,0.605,10,30,0.333,19,24,0.792,101,31,76,0.408,21,45,0.467,10,31,0.323,18,24,0.75,90
1757,CLE,2021-02-21,101,,OKC,0,240,39,84,0.464,31,49,0.633,8,35,0.229,15,20,0.75,101,43,79,0.544,30,51,0.588,13,28,0.464,18,24,0.75,117
1758,MIA,2021-02-11,101,@,HOU,1,240,34,79,0.43,19,37,0.514,15,42,0.357,18,20,0.9,101,32,83,0.386,17,33,0.515,15,50,0.3,15,20,0.75,94
1759,HOU,2021-02-09,101,@,NOP,0,240,38,91,0.418,25,48,0.521,13,43,0.302,12,21,0.571,101,47,92,0.511,35,61,0.574,12,31,0.387,24,28,0.857,130
1760,CHI,2021-02-08,101,,WAS,0,240,36,85,0.424,27,55,0.491,9,30,0.3,20,24,0.833,101,36,86,0.419,30,60,0.5,6,26,0.231,27,36,0.75,105
1761,PHO,2021-02-03,101,@,NOP,0,240,38,82,0.463,30,47,0.638,8,35,0.229,17,20,0.85,101,46,90,0.511,32,57,0.561,14,33,0.424,17,21,0.81,123
1762,DAL,2021-01-29,101,@,UTA,0,240,37,86,0.43,28,53,0.528,9,33,0.273,18,27,0.667,101,38,87,0.437,18,39,0.462,20,48,0.417,24,26,0.923,120
1763,POR,2021-01-28,101,@,HOU,0,240,39,93,0.419,22,52,0.423,17,41,0.415,6,8,0.75,101,38,90,0.422,25,43,0.581,13,47,0.277,15,18,0.833,104
1764,WAS,2021-01-24,101,@,SAS,0,240,39,92,0.424,25,50,0.5,14,42,0.333,9,14,0.643,101,48,96,0.5,33,65,0.508,15,31,0.484,10,11,0.909,121
1765,LAL,2021-01-23,101,@,CHI,1,240,36,79,0.456,32,60,0.533,4,19,0.211,25,31,0.806,101,33,84,0.393,25,59,0.424,8,25,0.32,16,22,0.727,90
1766,TOR,2021-01-22,101,,MIA,1,240,39,84,0.464,22,44,0.5,17,40,0.425,6,9,0.667,101,33,77,0.429,26,46,0.565,7,31,0.226,8,10,0.8,81
1767,OKC,2021-01-19,101,@,DEN,0,240,36,86,0.419,22,43,0.512,14,43,0.326,15,23,0.652,101,46,105,0.438,32,63,0.508,14,42,0.333,13,14,0.929,119
1768,DAL,2021-01-17,101,,CHI,0,240,41,93,0.441,33,62,0.532,8,31,0.258,11,19,0.579,101,43,85,0.506,36,60,0.6,7,25,0.28,24,33,0.727,117
1769,DET,2021-01-13,101,,MIL,0,240,36,92,0.391,22,57,0.386,14,35,0.4,15,22,0.682,101,41,85,0.482,22,42,0.524,19,43,0.442,9,14,0.643,110
1770,MEM,2021-01-11,101,@,CLE,1,240,40,78,0.513,35,58,0.603,5,20,0.25,16,21,0.762,101,37,82,0.451,26,56,0.464,11,26,0.423,6,14,0.429,91
1771,OKC,2021-01-08,101,@,NYK,1,240,38,87,0.437,27,53,0.509,11,34,0.324,14,21,0.667,101,34,96,0.354,25,69,0.362,9,27,0.333,12,20,0.6,89
1772,GSW,2021-01-06,101,,LAC,0,240,39,86,0.453,31,56,0.554,8,30,0.267,15,19,0.789,101,36,81,0.444,25,47,0.532,11,34,0.324,25,25,1.0,108
1773,CHO,2021-01-04,101,@,PHI,0,240,36,86,0.419,23,47,0.489,13,39,0.333,16,22,0.727,101,46,95,0.484,35,63,0.556,11,32,0.344,15,23,0.652,118
1774,MIN,2020-12-29,101,@,LAC,0,240,37,89,0.416,24,51,0.471,13,38,0.342,14,17,0.824,101,47,88,0.534,31,57,0.544,16,31,0.516,14,16,0.875,124
1775,DET,2020-12-23,101,@,MIN,0,240,45,93,0.484,37,58,0.638,8,35,0.229,3,8,0.375,101,38,88,0.432,27,47,0.574,11,41,0.268,24,28,0.857,111
1776,DET,2021-05-11,100,,MIN,0,240,35,75,0.467,25,52,0.481,10,23,0.435,20,26,0.769,100,45,98,0.459,31,50,0.62,14,48,0.292,15,21,0.714,119
1777,LAC,2021-05-09,100,,NYK,0,240,37,86,0.43,25,51,0.49,12,35,0.343,14,16,0.875,100,42,90,0.467,29,58,0.5,13,32,0.406,9,9,1.0,106
1778,TOR,2021-05-04,100,@,LAC,0,240,40,87,0.46,28,52,0.538,12,35,0.343,8,13,0.615,100,39,75,0.52,24,41,0.585,15,34,0.441,12,13,0.923,105
1779,UTA,2021-04-30,100,@,PHO,0,240,35,80,0.438,21,41,0.512,14,39,0.359,16,18,0.889,100,48,88,0.545,37,55,0.673,11,33,0.333,14,19,0.737,121
1780,DET,2021-04-26,100,,ATL,1,240,40,84,0.476,31,58,0.534,9,26,0.346,11,15,0.733,100,33,85,0.388,29,58,0.5,4,27,0.148,16,17,0.941,86
1781,ORL,2021-04-22,100,,NOP,0,240,36,98,0.367,23,62,0.371,13,36,0.361,15,19,0.789,100,50,90,0.556,38,62,0.613,12,28,0.429,23,26,0.885,135
1782,DET,2021-04-17,100,@,WAS,0,240,37,84,0.44,28,57,0.491,9,27,0.333,17,23,0.739,100,50,94,0.532,41,78,0.526,9,16,0.563,12,19,0.632,121
1783,LAC,2021-04-14,100,@,DET,1,240,37,93,0.398,30,64,0.469,7,29,0.241,19,21,0.905,100,37,85,0.435,30,61,0.492,7,24,0.292,17,22,0.773,98
1784,PHI,2021-04-04,100,,MEM,0,240,37,89,0.416,29,55,0.527,8,34,0.235,18,28,0.643,100,44,89,0.494,28,51,0.549,16,38,0.421,12,15,0.8,116
1785,SAC,2021-03-27,100,,CLE,1,240,41,80,0.513,34,50,0.68,7,30,0.233,11,14,0.786,100,37,84,0.44,28,58,0.483,9,26,0.346,15,23,0.652,98
1786,LAL,2021-03-26,100,,CLE,1,240,38,78,0.487,32,52,0.615,6,26,0.231,18,25,0.72,100,31,80,0.388,26,54,0.481,5,26,0.192,19,28,0.679,86
1787,TOR,2021-03-26,100,,PHO,0,240,37,90,0.411,25,45,0.556,12,45,0.267,14,16,0.875,100,43,90,0.478,34,54,0.63,9,36,0.25,9,9,1.0,104
1788,MIA,2021-03-23,100,,PHO,0,240,36,86,0.419,23,50,0.46,13,36,0.361,15,17,0.882,100,45,91,0.495,33,54,0.611,12,37,0.324,8,9,0.889,110
1789,CHO,2021-03-22,100,@,SAS,1,240,34,81,0.42,22,49,0.449,12,32,0.375,20,23,0.87,100,36,78,0.462,25,46,0.543,11,32,0.344,14,17,0.824,97
1790,CHI,2021-03-21,100,@,DET,1,240,37,80,0.463,23,52,0.442,14,28,0.5,12,14,0.857,100,32,82,0.39,28,57,0.491,4,25,0.16,18,25,0.72,86
1791,NYK,2021-03-21,100,,PHI,0,265,38,88,0.432,27,64,0.422,11,24,0.458,13,23,0.565,100,38,82,0.463,27,57,0.474,11,25,0.44,14,23,0.609,101
1792,HOU,2021-03-19,100,,DET,0,240,39,88,0.443,30,56,0.536,9,32,0.281,13,16,0.813,100,37,85,0.435,23,56,0.411,14,29,0.483,25,28,0.893,113
1793,ATL,2021-03-14,100,,CLE,1,240,32,71,0.451,20,42,0.476,12,29,0.414,24,26,0.923,100,31,81,0.383,23,51,0.451,8,30,0.267,12,23,0.522,82
1794,BRK,2021-03-13,100,,DET,1,240,39,80,0.488,33,53,0.623,6,27,0.222,16,22,0.727,100,36,89,0.404,28,57,0.491,8,32,0.25,15,20,0.75,95
1795,IND,2021-03-12,100,@,LAL,0,240,37,88,0.42,29,52,0.558,8,36,0.222,18,21,0.857,100,34,76,0.447,27,54,0.5,7,22,0.318,30,39,0.769,105
1796,LAC,2021-02-28,100,@,MIL,0,240,40,97,0.412,26,53,0.491,14,44,0.318,6,7,0.857,100,38,85,0.447,26,47,0.553,12,38,0.316,17,22,0.773,105
1797,HOU,2021-02-22,100,,CHI,0,240,37,96,0.385,24,56,0.429,13,40,0.325,13,19,0.684,100,49,91,0.538,34,55,0.618,15,36,0.417,7,10,0.7,120
1798,POR,2021-02-22,100,@,PHO,0,240,37,84,0.44,25,45,0.556,12,39,0.308,14,19,0.737,100,50,99,0.505,34,66,0.515,16,33,0.485,16,18,0.889,132
1799,GSW,2021-02-20,100,@,CHO,0,240,37,85,0.435,24,46,0.522,13,39,0.333,13,17,0.765,100,37,75,0.493,17,35,0.486,20,40,0.5,8,9,0.889,102
1800,GSW,2021-02-08,100,@,SAS,0,240,38,86,0.442,25,49,0.51,13,37,0.351,11,15,0.733,100,39,96,0.406,28,65,0.431,11,31,0.355,16,19,0.842,105
1801,PHO,2021-02-07,100,,BOS,1,240,40,82,0.488,32,53,0.604,8,29,0.276,12,12,1.0,100,33,93,0.355,16,49,0.327,17,44,0.386,8,12,0.667,91
1802,MIA,2021-02-03,100,,WAS,0,240,36,83,0.434,24,48,0.5,12,35,0.343,16,22,0.727,100,35,84,0.417,20,47,0.426,15,37,0.405,18,25,0.72,103
1803,CLE,2021-02-01,100,,MIN,1,240,35,84,0.417,28,62,0.452,7,22,0.318,23,31,0.742,100,40,102,0.392,29,64,0.453,11,38,0.289,7,11,0.636,98
1804,WAS,2021-01-29,100,,ATL,0,240,31,85,0.365,24,57,0.421,7,28,0.25,31,38,0.816,100,39,87,0.448,27,50,0.54,12,37,0.324,26,34,0.765,116
1805,OKC,2021-01-24,100,@,LAC,0,240,42,95,0.442,35,60,0.583,7,35,0.2,9,14,0.643,100,41,92,0.446,27,46,0.587,14,46,0.304,12,16,0.75,108
1806,MIA,2021-01-16,100,,DET,0,240,32,67,0.478,20,38,0.526,12,29,0.414,24,27,0.889,100,46,91,0.505,28,45,0.622,18,46,0.391,10,15,0.667,120
1807,SAC,2021-01-15,100,,LAC,0,240,40,85,0.471,32,59,0.542,8,26,0.308,12,17,0.706,100,52,89,0.584,34,54,0.63,18,35,0.514,16,20,0.8,138
1808,HOU,2021-01-12,100,,LAL,0,240,38,97,0.392,26,57,0.456,12,40,0.3,12,16,0.75,100,42,84,0.5,28,52,0.538,14,32,0.438,19,27,0.704,117
1809,MIL,2021-01-09,100,,CLE,1,240,37,84,0.44,25,48,0.521,12,36,0.333,14,18,0.778,100,36,87,0.414,29,61,0.475,7,26,0.269,11,16,0.688,90
1810,UTA,2021-01-06,100,@,NYK,0,240,40,91,0.44,26,47,0.553,14,44,0.318,6,11,0.545,100,45,87,0.517,37,65,0.569,8,22,0.364,14,19,0.737,112
1811,HOU,2021-01-04,100,,DAL,0,240,30,77,0.39,19,37,0.514,11,40,0.275,29,36,0.806,100,39,82,0.476,23,43,0.535,16,39,0.41,19,20,0.95,113
1812,LAC,2021-01-01,100,@,UTA,0,240,33,85,0.388,20,52,0.385,13,33,0.394,21,24,0.875,100,41,89,0.461,26,47,0.553,15,42,0.357,9,14,0.643,106
1813,TOR,2020-12-31,100,,NYK,1,240,34,83,0.41,17,31,0.548,17,52,0.327,15,21,0.714,100,32,88,0.364,29,52,0.558,3,36,0.083,16,20,0.8,83
1814,PHI,2020-12-29,100,,TOR,1,240,32,84,0.381,24,53,0.453,8,31,0.258,28,33,0.848,100,32,90,0.356,15,45,0.333,17,45,0.378,12,14,0.857,93
1815,SAC,2020-12-27,100,,PHO,0,240,36,76,0.474,26,53,0.491,10,23,0.435,18,25,0.72,100,46,94,0.489,32,59,0.542,14,35,0.4,10,11,0.909,116
1816,POR,2020-12-23,100,,UTA,0,240,37,92,0.402,25,59,0.424,12,33,0.364,14,17,0.824,100,43,94,0.457,24,44,0.545,19,50,0.38,15,19,0.789,120
1817,SAC,2021-05-16,99,,UTA,0,240,42,90,0.467,33,60,0.55,9,30,0.3,6,10,0.6,99,41,86,0.477,23,47,0.489,18,39,0.462,21,25,0.84,121
1818,NYK,2021-05-11,99,@,LAL,0,265,34,87,0.391,24,58,0.414,10,29,0.345,21,23,0.913,99,37,89,0.416,25,61,0.41,12,28,0.429,15,19,0.789,101
1819,TOR,2021-05-08,99,,MEM,0,240,36,94,0.383,26,62,0.419,10,32,0.313,17,24,0.708,99,38,85,0.447,24,42,0.571,14,43,0.326,19,26,0.731,109
1820,BOS,2021-05-07,99,@,CHI,0,240,35,86,0.407,24,47,0.511,11,39,0.282,18,23,0.783,99,43,99,0.434,25,59,0.424,18,40,0.45,17,18,0.944,121
1821,CHO,2021-05-06,99,,CHI,0,240,38,90,0.422,22,55,0.4,16,35,0.457,7,18,0.389,99,46,91,0.505,28,54,0.519,18,37,0.486,10,17,0.588,120
1822,OKC,2021-05-04,99,,SAC,0,240,35,98,0.357,24,62,0.387,11,36,0.306,18,25,0.72,99,39,95,0.411,27,52,0.519,12,43,0.279,13,16,0.813,103
1823,DET,2021-05-04,99,,CHO,0,240,39,85,0.459,30,53,0.566,9,32,0.281,12,20,0.6,99,38,93,0.409,30,62,0.484,8,31,0.258,18,24,0.75,102
1824,SAS,2021-05-03,99,@,UTA,0,240,42,90,0.467,37,72,0.514,5,18,0.278,10,10,1.0,99,44,88,0.5,33,52,0.635,11,36,0.306,11,16,0.688,110
1825,DAL,2021-05-02,99,,SAC,0,240,34,81,0.42,28,46,0.609,6,35,0.171,25,31,0.806,99,45,81,0.556,34,53,0.642,11,28,0.393,10,16,0.625,111
1826,BOS,2021-04-22,99,,PHO,1,240,33,77,0.429,21,37,0.568,12,40,0.3,21,24,0.875,99,36,88,0.409,30,53,0.566,6,35,0.171,8,9,0.889,86
1827,HOU,2021-04-16,99,,DEN,0,240,38,86,0.442,27,51,0.529,11,35,0.314,12,18,0.667,99,46,94,0.489,37,63,0.587,9,31,0.29,27,31,0.871,128
1828,NYK,2021-04-07,99,@,BOS,0,240,35,84,0.417,19,51,0.373,16,33,0.485,13,16,0.813,99,36,86,0.419,21,46,0.457,15,40,0.375,14,20,0.7,101
1829,DAL,2021-04-02,99,@,NYK,1,240,41,88,0.466,29,51,0.569,12,37,0.324,5,10,0.5,99,32,89,0.36,20,51,0.392,12,38,0.316,10,10,1.0,86
1830,ORL,2021-03-23,99,,DEN,0,240,39,88,0.443,28,54,0.519,11,34,0.324,10,14,0.714,99,45,91,0.495,37,61,0.607,8,30,0.267,12,13,0.923,110
1831,TOR,2021-03-22,99,@,HOU,0,240,37,87,0.425,27,47,0.574,10,40,0.25,15,19,0.789,99,41,90,0.456,27,54,0.5,14,36,0.389,21,26,0.808,117
1832,ATL,2021-03-20,99,@,LAL,1,240,39,98,0.398,26,61,0.426,13,37,0.351,8,9,0.889,99,34,81,0.42,26,55,0.473,8,26,0.308,18,24,0.75,94
1833,CHI,2021-03-17,99,,SAS,0,240,40,91,0.44,29,58,0.5,11,33,0.333,8,9,0.889,99,38,89,0.427,30,58,0.517,8,31,0.258,22,30,0.733,106
1834,PHI,2021-03-16,99,,NYK,1,240,37,90,0.411,26,58,0.448,11,32,0.344,14,19,0.737,99,37,84,0.44,29,60,0.483,8,24,0.333,14,22,0.636,96
1835,DAL,2021-03-15,99,,LAC,0,240,39,79,0.494,22,38,0.579,17,41,0.415,4,5,0.8,99,43,86,0.5,29,54,0.537,14,32,0.438,9,11,0.818,109
1836,DET,2021-03-15,99,,SAS,0,240,39,83,0.47,32,58,0.552,7,25,0.28,14,25,0.56,99,47,83,0.566,35,58,0.603,12,25,0.48,3,5,0.6,109
1837,MEM,2021-03-15,99,@,PHO,0,240,38,87,0.437,33,64,0.516,5,23,0.217,18,26,0.692,99,47,83,0.566,35,53,0.66,12,30,0.4,16,18,0.889,122
1838,SAS,2021-03-14,99,@,PHI,0,240,36,85,0.424,32,64,0.5,4,21,0.19,23,31,0.742,99,56,98,0.571,41,69,0.594,15,29,0.517,7,11,0.636,134
1839,HOU,2021-03-12,99,@,UTA,0,240,41,112,0.366,32,69,0.464,9,43,0.209,8,13,0.615,99,39,81,0.481,24,41,0.585,15,40,0.375,21,25,0.84,114
1840,ATL,2021-02-28,99,@,MIA,0,240,36,87,0.414,28,52,0.538,8,35,0.229,19,22,0.864,99,39,86,0.453,28,49,0.571,11,37,0.297,20,22,0.909,109
1841,MIN,2021-02-28,99,,PHO,0,240,35,93,0.376,27,58,0.466,8,35,0.229,21,24,0.875,99,44,89,0.494,37,62,0.597,7,27,0.259,23,24,0.958,118
1842,MEM,2021-02-26,99,,LAC,0,240,39,97,0.402,30,69,0.435,9,28,0.321,12,16,0.75,99,44,80,0.55,30,45,0.667,14,35,0.4,17,18,0.944,119
1843,SAS,2021-02-24,99,@,OKC,0,240,40,86,0.465,31,61,0.508,9,25,0.36,10,15,0.667,99,37,89,0.416,19,45,0.422,18,44,0.409,10,11,0.909,102
1844,MIN,2021-02-21,99,@,NYK,0,240,33,82,0.402,17,47,0.362,16,35,0.457,17,21,0.81,99,33,78,0.423,27,60,0.45,6,18,0.333,31,38,0.816,103
1845,DEN,2021-02-16,99,@,BOS,0,240,38,84,0.452,29,50,0.58,9,34,0.265,14,15,0.933,99,39,81,0.481,24,39,0.615,15,42,0.357,19,21,0.905,112
1846,HOU,2021-02-13,99,@,NYK,0,240,33,88,0.375,25,45,0.556,8,43,0.186,25,30,0.833,99,45,86,0.523,33,58,0.569,12,28,0.429,19,23,0.826,121
1847,POR,2021-02-06,99,@,NYK,0,240,37,89,0.416,20,42,0.476,17,47,0.362,8,16,0.5,99,44,88,0.5,31,58,0.534,13,30,0.433,9,13,0.692,110
1848,CLE,2021-02-06,99,,MIL,0,240,39,86,0.453,33,58,0.569,6,28,0.214,15,21,0.714,99,47,86,0.547,31,52,0.596,16,34,0.471,14,23,0.609,124
1849,CLE,2021-02-03,99,,LAC,0,240,41,92,0.446,37,82,0.451,4,10,0.4,13,17,0.765,99,44,79,0.557,24,45,0.533,20,34,0.588,13,17,0.765,121
1850,ATL,2021-02-01,99,,LAL,0,240,37,78,0.474,26,49,0.531,11,29,0.379,14,17,0.824,99,40,77,0.519,33,54,0.611,7,23,0.304,20,24,0.833,107
1851,LAC,2021-01-26,99,@,ATL,0,240,36,89,0.404,28,63,0.444,8,26,0.308,19,22,0.864,99,37,80,0.463,27,54,0.5,10,26,0.385,24,25,0.96,108
1852,SAS,2021-01-20,99,@,GSW,0,240,35,94,0.372,31,61,0.508,4,33,0.121,25,31,0.806,99,46,91,0.505,31,53,0.585,15,38,0.395,14,20,0.7,121
1853,OKC,2021-01-13,99,,LAL,0,240,37,86,0.43,27,55,0.491,10,31,0.323,15,19,0.789,99,47,95,0.495,30,58,0.517,17,37,0.459,17,22,0.773,128
1854,ORL,2021-01-11,99,,MIL,0,240,39,91,0.429,28,60,0.467,11,31,0.355,10,13,0.769,99,46,91,0.505,33,56,0.589,13,35,0.371,16,20,0.8,121
1855,SAC,2021-01-09,99,,POR,0,240,33,81,0.407,25,51,0.49,8,30,0.267,25,35,0.714,99,44,100,0.44,27,59,0.458,17,41,0.415,20,23,0.87,125
1856,ORL,2021-01-02,99,,OKC,0,240,40,108,0.37,30,70,0.429,10,38,0.263,9,12,0.75,99,38,86,0.442,25,45,0.556,13,41,0.317,19,21,0.905,108
1857,CLE,2020-12-31,99,@,IND,0,240,37,82,0.451,25,59,0.424,12,23,0.522,13,24,0.542,99,42,87,0.483,26,52,0.5,16,35,0.457,19,24,0.792,119
1858,DAL,2020-12-30,99,,CHO,0,240,34,87,0.391,22,45,0.489,12,42,0.286,19,33,0.576,99,43,84,0.512,28,50,0.56,15,34,0.441,17,21,0.81,118
1859,GSW,2020-12-25,99,@,MIL,0,240,34,99,0.343,24,54,0.444,10,45,0.222,21,25,0.84,99,50,90,0.556,30,54,0.556,20,36,0.556,18,26,0.692,138
1860,TOR,2020-12-23,99,,NOP,0,240,38,89,0.427,24,43,0.558,14,46,0.304,9,12,0.75,99,42,80,0.525,23,38,0.605,19,42,0.452,10,20,0.5,113
1861,GSW,2020-12-22,99,@,BRK,0,240,37,99,0.374,27,66,0.409,10,33,0.303,15,23,0.652,99,42,92,0.457,27,57,0.474,15,35,0.429,26,32,0.813,125
1862,NOP,2021-05-16,98,,LAL,0,240,37,78,0.474,28,53,0.528,9,25,0.36,15,21,0.714,98,45,96,0.469,34,61,0.557,11,35,0.314,9,15,0.6,110
1863,SAS,2021-05-13,98,@,NYK,0,240,38,91,0.418,32,70,0.457,6,21,0.286,16,19,0.842,98,35,86,0.407,21,51,0.412,14,35,0.4,18,18,1.0,102
1864,UTA,2021-05-12,98,,POR,0,240,35,85,0.412,23,45,0.511,12,40,0.3,16,21,0.762,98,40,91,0.44,27,59,0.458,13,32,0.406,12,17,0.706,105
1865,OKC,2021-05-09,98,@,SAC,0,240,34,87,0.391,23,50,0.46,11,37,0.297,19,29,0.655,98,45,85,0.529,29,49,0.592,16,36,0.444,20,24,0.833,126
1866,CHI,2021-04-30,98,,MIL,0,240,37,96,0.385,27,63,0.429,10,33,0.303,14,21,0.667,98,42,90,0.467,33,65,0.508,9,25,0.36,15,20,0.75,108
1867,DET,2021-04-14,98,,LAC,0,240,37,85,0.435,30,61,0.492,7,24,0.292,17,22,0.773,98,37,93,0.398,30,64,0.469,7,29,0.241,19,21,0.905,100
1868,POR,2021-04-11,98,,MIA,0,240,37,77,0.481,26,42,0.619,11,35,0.314,13,19,0.684,98,41,83,0.494,29,54,0.537,12,29,0.414,13,20,0.65,107
1869,MIA,2021-03-29,98,@,NYK,1,240,37,86,0.43,27,52,0.519,10,34,0.294,14,17,0.824,98,33,80,0.413,23,44,0.523,10,36,0.278,12,20,0.6,88
1870,CLE,2021-03-27,98,@,SAC,0,240,37,84,0.44,28,58,0.483,9,26,0.346,15,23,0.652,98,41,80,0.513,34,50,0.68,7,30,0.233,11,14,0.786,100
1871,LAC,2021-03-25,98,@,SAS,1,240,34,89,0.382,21,55,0.382,13,34,0.382,17,18,0.944,98,33,82,0.402,25,59,0.424,8,23,0.348,11,13,0.846,85
1872,GSW,2021-03-23,98,,PHI,0,240,36,83,0.434,28,58,0.483,8,25,0.32,18,26,0.692,98,39,86,0.453,32,62,0.516,7,24,0.292,23,35,0.657,108
1873,CHO,2021-03-20,98,@,LAC,0,240,31,80,0.388,16,39,0.41,15,41,0.366,21,28,0.75,98,45,86,0.523,33,52,0.635,12,34,0.353,23,23,1.0,125
1874,CLE,2021-03-16,98,@,MIA,0,240,39,86,0.453,29,51,0.569,10,35,0.286,10,14,0.714,98,42,85,0.494,32,58,0.552,10,27,0.37,19,21,0.905,113
1875,GSW,2021-03-04,98,@,PHO,0,240,38,88,0.432,26,53,0.491,12,35,0.343,10,16,0.625,98,49,96,0.51,37,66,0.561,12,30,0.4,10,13,0.769,120
1876,BRK,2021-02-27,98,,DAL,0,240,35,86,0.407,21,42,0.5,14,44,0.318,14,19,0.737,98,45,86,0.523,31,50,0.62,14,36,0.389,11,17,0.647,115
1877,MIL,2021-02-19,98,,OKC,1,240,35,86,0.407,24,52,0.462,11,34,0.324,17,25,0.68,98,31,85,0.365,19,45,0.422,12,40,0.3,11,21,0.524,85
1878,LAL,2021-02-18,98,,BRK,0,240,40,83,0.482,32,53,0.604,8,30,0.267,10,14,0.714,98,38,77,0.494,20,38,0.526,18,39,0.462,15,24,0.625,109
1879,CLE,2021-02-15,98,@,GSW,0,240,37,95,0.389,29,65,0.446,8,30,0.267,16,20,0.8,98,46,88,0.523,29,51,0.569,17,37,0.459,20,21,0.952,129
1880,MIA,2021-02-09,98,,NYK,1,240,26,70,0.371,12,37,0.324,14,33,0.424,32,39,0.821,98,37,87,0.425,27,59,0.458,10,28,0.357,12,16,0.75,96
1881,MIN,2021-02-01,98,@,CLE,0,240,40,102,0.392,29,64,0.453,11,38,0.289,7,11,0.636,98,35,84,0.417,28,62,0.452,7,22,0.318,23,31,0.742,100
1882,BRK,2021-01-25,98,,MIA,1,240,34,85,0.4,23,47,0.489,11,38,0.289,19,22,0.864,98,31,84,0.369,20,41,0.488,11,43,0.256,12,17,0.706,85
1883,MIN,2021-01-22,98,,ATL,0,240,40,93,0.43,32,61,0.525,8,32,0.25,10,12,0.833,98,38,83,0.458,23,48,0.479,15,35,0.429,25,30,0.833,116
1884,ORL,2021-01-09,98,@,DAL,0,240,38,89,0.427,32,58,0.552,6,31,0.194,16,22,0.727,98,39,79,0.494,19,39,0.487,20,40,0.5,14,18,0.778,112
1885,GSW,2021-01-01,98,,POR,0,240,31,79,0.392,24,44,0.545,7,35,0.2,29,33,0.879,98,40,92,0.435,20,49,0.408,20,43,0.465,23,30,0.767,123
1886,NOP,2020-12-27,98,,SAS,1,240,36,94,0.383,31,70,0.443,5,24,0.208,21,29,0.724,98,38,89,0.427,27,53,0.509,11,36,0.306,8,8,1.0,95
1887,NOP,2020-12-25,98,@,MIA,0,240,31,78,0.397,21,43,0.488,10,35,0.286,26,33,0.788,98,38,75,0.507,22,38,0.579,16,37,0.432,19,23,0.826,111
1888,ORL,2021-05-14,97,@,PHI,0,240,33,83,0.398,23,53,0.434,10,30,0.333,21,28,0.75,97,44,93,0.473,28,59,0.475,16,34,0.471,18,19,0.947,122
1889,CLE,2021-05-09,97,,DAL,0,240,33,86,0.384,22,55,0.4,11,31,0.355,20,31,0.645,97,50,93,0.538,35,54,0.648,15,39,0.385,9,11,0.818,124
1890,OKC,2021-05-08,97,@,GSW,0,240,38,94,0.404,29,57,0.509,9,37,0.243,12,20,0.6,97,47,81,0.58,20,27,0.741,27,54,0.5,15,18,0.833,136
1891,MEM,2021-05-06,97,@,DET,0,240,38,89,0.427,28,52,0.538,10,37,0.27,11,17,0.647,97,44,83,0.53,33,55,0.6,11,28,0.393,12,14,0.857,111
1892,OKC,2021-05-06,97,@,GSW,0,240,36,88,0.409,27,49,0.551,9,39,0.231,16,20,0.8,97,42,86,0.488,23,39,0.59,19,47,0.404,15,18,0.833,118
1893,NYK,2021-05-05,97,@,DEN,0,240,33,86,0.384,20,51,0.392,13,35,0.371,18,27,0.667,97,37,97,0.381,25,58,0.431,12,39,0.308,27,33,0.818,113
1894,HOU,2021-05-02,97,,NYK,0,240,34,79,0.43,26,44,0.591,8,35,0.229,21,32,0.656,97,45,86,0.523,27,51,0.529,18,35,0.514,14,16,0.875,122
1895,CHI,2021-05-01,97,@,ATL,0,240,40,85,0.471,34,61,0.557,6,24,0.25,11,17,0.647,97,37,74,0.5,23,38,0.605,14,36,0.389,20,26,0.769,108
1896,DEN,2021-04-23,97,@,GSW,0,240,34,88,0.386,21,42,0.5,13,46,0.283,16,20,0.8,97,45,84,0.536,30,45,0.667,15,39,0.385,13,18,0.722,118
1897,CHO,2021-04-20,97,@,NYK,0,240,39,86,0.453,23,47,0.489,16,39,0.41,3,8,0.375,97,40,83,0.482,22,38,0.579,18,45,0.4,11,12,0.917,109
1898,LAL,2021-04-19,97,,UTA,0,240,34,79,0.43,22,51,0.431,12,28,0.429,17,25,0.68,97,43,75,0.573,28,42,0.667,15,33,0.455,10,11,0.909,111
1899,MIN,2021-04-13,97,,BRK,0,240,30,87,0.345,17,38,0.447,13,49,0.265,24,33,0.727,97,46,91,0.505,31,55,0.564,15,36,0.417,20,24,0.833,127
1900,ORL,2021-04-12,97,,SAS,0,240,36,80,0.45,31,60,0.517,5,20,0.25,20,32,0.625,97,48,93,0.516,38,68,0.559,10,25,0.4,14,18,0.778,120
1901,IND,2021-04-06,97,,CHI,0,240,38,88,0.432,29,58,0.5,9,30,0.3,12,16,0.75,97,44,94,0.468,30,61,0.492,14,33,0.424,11,14,0.786,113
1902,IND,2021-04-02,97,,CHO,0,240,38,82,0.463,28,49,0.571,10,33,0.303,11,19,0.579,97,43,95,0.453,35,64,0.547,8,31,0.258,20,29,0.69,114
1903,LAL,2021-03-31,97,,MIL,0,240,35,87,0.402,25,51,0.49,10,36,0.278,17,22,0.773,97,42,79,0.532,28,53,0.528,14,26,0.538,14,18,0.778,112
1904,CHO,2021-03-28,97,,PHO,0,265,34,85,0.4,21,42,0.5,13,43,0.302,16,23,0.696,97,34,96,0.354,26,56,0.464,8,40,0.2,25,29,0.862,101
1905,HOU,2021-03-24,97,,CHO,0,240,33,86,0.384,17,37,0.459,16,49,0.327,15,22,0.682,97,41,80,0.513,23,42,0.548,18,38,0.474,22,29,0.759,122
1906,SAS,2021-03-22,97,,CHO,0,240,36,78,0.462,25,46,0.543,11,32,0.344,14,17,0.824,97,34,81,0.42,22,49,0.449,12,32,0.375,20,23,0.87,100
1907,GSW,2021-03-15,97,,LAL,0,240,34,79,0.43,21,42,0.5,13,37,0.351,16,24,0.667,97,49,78,0.628,38,51,0.745,11,27,0.407,19,25,0.76,128
1908,ORL,2021-03-14,97,,MIA,0,240,33,75,0.44,17,35,0.486,16,40,0.4,15,21,0.714,97,37,89,0.416,23,39,0.59,14,50,0.28,14,15,0.933,102
1909,OKC,2021-03-13,97,,NYK,0,240,37,76,0.487,29,44,0.659,8,32,0.25,15,21,0.714,97,44,90,0.489,30,55,0.545,14,35,0.4,17,22,0.773,119
1910,MIL,2021-03-02,97,,DEN,0,240,32,79,0.405,21,39,0.538,11,40,0.275,22,31,0.71,97,53,95,0.558,42,65,0.646,11,30,0.367,11,12,0.917,128
1911,CHI,2021-02-26,97,,PHO,0,240,39,78,0.5,27,47,0.574,12,31,0.387,7,10,0.7,97,44,88,0.5,38,66,0.576,6,22,0.273,12,15,0.8,106
1912,DAL,2021-02-25,97,@,PHI,0,240,32,78,0.41,19,44,0.432,13,34,0.382,20,23,0.87,97,39,90,0.433,27,61,0.443,12,29,0.414,21,25,0.84,111
1913,MEM,2021-02-20,97,,PHO,0,240,36,93,0.387,31,60,0.517,5,33,0.152,20,23,0.87,97,46,86,0.535,22,40,0.55,24,46,0.522,12,13,0.923,128
1914,DEN,2021-02-12,97,,OKC,1,240,40,87,0.46,30,47,0.638,10,40,0.25,7,10,0.7,97,36,90,0.4,26,58,0.448,10,32,0.313,13,17,0.765,95
1915,ORL,2021-02-09,97,@,POR,0,240,37,88,0.42,26,53,0.491,11,35,0.314,12,22,0.545,97,35,90,0.389,17,44,0.386,18,46,0.391,18,19,0.947,106
1916,WAS,2021-02-07,97,@,CHO,0,240,34,90,0.378,25,50,0.5,9,40,0.225,20,28,0.714,97,42,99,0.424,27,63,0.429,15,36,0.417,20,26,0.769,119
1917,PHO,2021-01-27,97,,OKC,0,240,36,95,0.379,21,52,0.404,15,43,0.349,10,12,0.833,97,38,85,0.447,22,45,0.489,16,40,0.4,10,14,0.714,102
1918,ORL,2021-01-20,97,@,MIN,1,240,36,92,0.391,26,61,0.426,10,31,0.323,15,21,0.714,97,36,85,0.424,21,50,0.42,15,35,0.429,9,14,0.643,96
1919,MIN,2021-01-18,97,@,ATL,0,240,36,91,0.396,22,54,0.407,14,37,0.378,11,16,0.688,97,37,79,0.468,26,51,0.51,11,28,0.393,23,25,0.92,108
1920,ORL,2021-01-15,97,@,BOS,0,240,38,94,0.404,31,66,0.47,7,28,0.25,14,22,0.636,97,45,88,0.511,28,46,0.609,17,42,0.405,17,19,0.895,124
1921,MIA,2020-12-29,97,,MIL,0,240,37,79,0.468,26,42,0.619,11,37,0.297,12,18,0.667,97,51,92,0.554,22,41,0.537,29,51,0.569,13,15,0.867,144
1922,NYK,2021-05-16,96,,BOS,1,240,34,79,0.43,21,52,0.404,13,27,0.481,15,19,0.789,96,35,86,0.407,24,45,0.533,11,41,0.268,11,15,0.733,92
1923,TOR,2021-05-11,96,,LAC,0,240,35,86,0.407,25,49,0.51,10,37,0.27,16,19,0.842,96,39,78,0.5,28,46,0.609,11,32,0.344,26,26,1.0,115
1924,ORL,2021-05-09,96,,MIN,0,240,36,91,0.396,27,55,0.491,9,36,0.25,15,22,0.682,96,47,97,0.485,31,52,0.596,16,45,0.356,18,24,0.75,128
1925,DET,2021-05-09,96,,CHI,0,240,36,79,0.456,25,52,0.481,11,27,0.407,13,22,0.591,96,43,84,0.512,31,52,0.596,12,32,0.375,10,14,0.714,108
1926,ORL,2021-05-05,96,,BOS,0,240,33,85,0.388,27,60,0.45,6,25,0.24,24,28,0.857,96,51,96,0.531,30,51,0.588,21,45,0.467,9,12,0.75,132
1927,CLE,2021-04-26,96,@,TOR,0,240,36,83,0.434,26,45,0.578,10,38,0.263,14,16,0.875,96,43,79,0.544,35,50,0.7,8,29,0.276,18,20,0.9,112
1928,MEM,2021-04-26,96,@,DEN,0,240,34,81,0.42,30,49,0.612,4,32,0.125,24,31,0.774,96,45,94,0.479,34,61,0.557,11,33,0.333,19,22,0.864,120
1929,UTA,2021-04-24,96,,MIN,0,240,33,82,0.402,14,35,0.4,19,47,0.404,11,15,0.733,96,40,92,0.435,31,54,0.574,9,38,0.237,12,20,0.6,101
1930,ORL,2021-04-20,96,@,ATL,0,240,34,86,0.395,26,49,0.531,8,37,0.216,20,29,0.69,96,39,94,0.415,30,60,0.5,9,34,0.265,25,29,0.862,112
1931,PHI,2021-04-19,96,,GSW,0,240,35,89,0.393,23,57,0.404,12,32,0.375,14,18,0.778,96,34,76,0.447,20,44,0.455,14,32,0.438,25,32,0.781,107
1932,BOS,2021-04-19,96,,CHI,0,240,36,77,0.468,26,52,0.5,10,25,0.4,14,15,0.933,96,41,91,0.451,30,59,0.508,11,32,0.344,9,10,0.9,102
1933,CLE,2021-04-17,96,@,CHI,0,240,39,88,0.443,27,58,0.466,12,30,0.4,6,7,0.857,96,41,82,0.5,25,42,0.595,16,40,0.4,8,9,0.889,106
1934,OKC,2021-04-13,96,@,UTA,0,240,36,93,0.387,22,59,0.373,14,34,0.412,10,18,0.556,96,36,86,0.419,19,39,0.487,17,47,0.362,17,20,0.85,106
1935,LAL,2021-04-12,96,@,NYK,0,240,35,80,0.438,23,44,0.523,12,36,0.333,14,18,0.778,96,42,89,0.472,37,62,0.597,5,27,0.185,22,27,0.815,111
1936,TOR,2021-04-11,96,@,NYK,0,240,33,79,0.418,22,45,0.489,11,34,0.324,19,23,0.826,96,35,88,0.398,26,53,0.491,9,35,0.257,23,27,0.852,102
1937,SAS,2021-04-07,96,@,DEN,0,240,38,91,0.418,32,67,0.478,6,24,0.25,14,21,0.667,96,40,91,0.44,32,65,0.492,8,26,0.308,18,24,0.75,106
1938,BOS,2021-04-06,96,,PHI,0,240,33,70,0.471,19,36,0.528,14,34,0.412,16,18,0.889,96,34,73,0.466,25,49,0.51,9,24,0.375,29,39,0.744,106
1939,LAC,2021-03-30,96,,ORL,0,240,37,89,0.416,25,52,0.481,12,37,0.324,10,10,1.0,96,38,92,0.413,33,75,0.44,5,17,0.294,22,25,0.88,103
1940,LAL,2021-03-28,96,,ORL,1,240,34,82,0.415,23,42,0.548,11,40,0.275,17,23,0.739,96,34,88,0.386,23,55,0.418,11,33,0.333,14,17,0.824,93
1941,MIL,2021-03-27,96,,NYK,0,240,36,87,0.414,22,51,0.431,14,36,0.389,10,16,0.625,96,40,93,0.43,24,49,0.49,16,44,0.364,6,8,0.75,102
1942,ORL,2021-03-21,96,@,BOS,0,240,32,84,0.381,21,50,0.42,11,34,0.324,21,30,0.7,96,40,88,0.455,17,33,0.515,23,55,0.418,9,9,1.0,112
1943,BOS,2021-03-19,96,,SAC,0,240,39,91,0.429,27,60,0.45,12,31,0.387,6,7,0.857,96,37,81,0.457,25,51,0.49,12,30,0.4,21,26,0.808,107
1944,NYK,2021-03-16,96,@,PHI,0,240,37,84,0.44,29,60,0.483,8,24,0.333,14,22,0.636,96,37,90,0.411,26,58,0.448,11,32,0.344,14,19,0.737,99
1945,OKC,2021-02-27,96,,DEN,0,240,37,88,0.42,26,41,0.634,11,47,0.234,11,15,0.733,96,49,89,0.551,34,58,0.586,15,31,0.484,13,16,0.813,126
1946,HOU,2021-02-24,96,@,CLE,0,240,36,90,0.4,26,57,0.456,10,33,0.303,14,17,0.824,96,43,85,0.506,27,49,0.551,16,36,0.444,10,15,0.667,112
1947,DET,2021-02-21,96,@,ORL,0,240,34,91,0.374,23,51,0.451,11,40,0.275,17,21,0.81,96,35,81,0.432,26,51,0.51,9,30,0.3,26,29,0.897,105
1948,MIA,2021-02-20,96,@,LAL,1,240,36,85,0.424,28,57,0.491,8,28,0.286,16,23,0.696,96,33,84,0.393,20,39,0.513,13,45,0.289,15,17,0.882,94
1949,MIL,2021-02-18,96,,TOR,0,240,35,88,0.398,25,54,0.463,10,34,0.294,16,23,0.696,96,38,78,0.487,26,43,0.605,12,35,0.343,22,23,0.957,110
1950,LAC,2021-02-17,96,,UTA,0,240,38,86,0.442,29,60,0.483,9,26,0.346,11,17,0.647,96,42,98,0.429,29,58,0.5,13,40,0.325,17,20,0.85,114
1951,NYK,2021-02-09,96,@,MIA,0,240,37,87,0.425,27,59,0.458,10,28,0.357,12,16,0.75,96,26,70,0.371,12,37,0.324,14,33,0.424,32,39,0.821,98
1952,LAL,2021-01-30,96,@,BOS,1,240,37,84,0.44,28,53,0.528,9,31,0.29,13,19,0.684,96,40,82,0.488,34,61,0.557,6,21,0.286,9,14,0.643,95
1953,MIN,2021-01-20,96,,ORL,0,240,36,85,0.424,21,50,0.42,15,35,0.429,9,14,0.643,96,36,92,0.391,26,61,0.426,10,31,0.323,15,21,0.714,97
1954,SAC,2021-01-20,96,@,LAC,0,240,39,86,0.453,26,58,0.448,13,28,0.464,5,12,0.417,96,41,86,0.477,25,51,0.49,16,35,0.457,17,18,0.944,115
1955,IND,2021-01-17,96,@,LAC,0,240,37,89,0.416,26,51,0.51,11,38,0.289,11,16,0.688,96,48,87,0.552,29,48,0.604,19,39,0.487,14,20,0.7,129
1956,MIN,2021-01-10,96,,SAS,1,240,34,81,0.42,25,55,0.455,9,26,0.346,19,23,0.826,96,36,94,0.383,28,64,0.438,8,30,0.267,8,14,0.571,88
1957,UTA,2021-01-10,96,@,DET,1,240,35,82,0.427,24,47,0.511,11,35,0.314,15,22,0.682,96,29,87,0.333,19,45,0.422,10,42,0.238,18,21,0.857,86
1958,UTA,2021-01-05,96,@,BRK,0,240,33,86,0.384,22,52,0.423,11,34,0.324,19,27,0.704,96,52,93,0.559,38,57,0.667,14,36,0.389,12,16,0.75,130
1959,CLE,2021-01-02,96,@,ATL,1,240,38,91,0.418,31,62,0.5,7,29,0.241,13,17,0.765,96,35,85,0.412,24,53,0.453,11,32,0.344,10,19,0.526,91
1960,BRK,2021-01-01,96,,ATL,0,240,35,86,0.407,28,49,0.571,7,37,0.189,19,23,0.826,96,43,93,0.462,27,54,0.5,16,39,0.41,12,14,0.857,114
1961,DET,2021-01-01,96,,BOS,1,240,36,88,0.409,25,54,0.463,11,34,0.324,13,20,0.65,96,39,83,0.47,31,52,0.596,8,31,0.258,7,14,0.5,93
1962,CHI,2021-01-01,96,@,MIL,0,240,38,87,0.437,32,61,0.525,6,26,0.231,14,20,0.7,96,42,85,0.494,20,40,0.5,22,45,0.489,20,30,0.667,126
1963,HOU,2021-05-16,95,@,ATL,0,240,31,92,0.337,13,29,0.448,18,63,0.286,15,20,0.75,95,49,90,0.544,42,69,0.609,7,21,0.333,19,26,0.731,124
1964,OKC,2021-05-01,95,,IND,0,240,38,111,0.342,30,73,0.411,8,38,0.211,11,23,0.478,95,57,87,0.655,36,54,0.667,21,33,0.636,17,22,0.773,152
1965,OKC,2021-04-29,95,,NOP,0,240,34,89,0.382,23,50,0.46,11,39,0.282,16,20,0.8,95,45,101,0.446,40,72,0.556,5,29,0.172,14,19,0.737,109
1966,DAL,2021-04-12,95,,PHI,0,240,35,83,0.422,26,47,0.553,9,36,0.25,16,20,0.8,95,39,80,0.488,27,49,0.551,12,31,0.387,23,33,0.697,113
1967,PHI,2021-03-30,95,@,DEN,0,240,35,82,0.427,24,47,0.511,11,35,0.314,14,15,0.933,95,39,81,0.481,27,50,0.54,12,31,0.387,14,17,0.824,104
1968,CHI,2021-03-22,95,,UTA,0,240,39,96,0.406,33,70,0.471,6,26,0.231,11,12,0.917,95,45,92,0.489,28,53,0.528,17,39,0.436,13,15,0.867,120
1969,TOR,2021-03-14,95,@,CHI,0,240,34,90,0.378,22,45,0.489,12,45,0.267,15,21,0.714,95,44,97,0.454,32,53,0.604,12,44,0.273,18,23,0.783,118
1970,DET,2021-03-13,95,@,BRK,0,240,36,89,0.404,28,57,0.491,8,32,0.25,15,20,0.75,95,39,80,0.488,33,53,0.623,6,27,0.222,16,22,0.727,100
1971,DET,2021-02-19,95,@,MEM,0,240,36,86,0.419,22,41,0.537,14,45,0.311,9,13,0.692,95,42,90,0.467,37,70,0.529,5,20,0.25,20,23,0.87,109
1972,OKC,2021-02-12,95,@,DEN,0,240,36,90,0.4,26,58,0.448,10,32,0.313,13,17,0.765,95,40,87,0.46,30,47,0.638,10,40,0.25,7,10,0.7,97
1973,DET,2021-02-11,95,,IND,0,240,38,85,0.447,33,57,0.579,5,28,0.179,14,19,0.737,95,44,86,0.512,30,55,0.545,14,31,0.452,9,10,0.9,111
1974,CLE,2021-02-10,95,@,DEN,0,240,36,94,0.383,28,57,0.491,8,37,0.216,15,20,0.75,95,51,85,0.6,35,49,0.714,16,36,0.444,15,21,0.714,133
1975,IND,2021-02-07,95,,UTA,0,240,37,93,0.398,29,64,0.453,8,29,0.276,13,18,0.722,95,38,92,0.413,25,50,0.5,13,42,0.31,14,21,0.667,103
1976,WAS,2021-02-05,95,@,MIA,0,240,33,89,0.371,25,56,0.446,8,33,0.242,21,24,0.875,95,43,86,0.5,27,50,0.54,16,36,0.444,20,23,0.87,122
1977,BOS,2021-01-30,95,,LAL,0,240,40,82,0.488,34,61,0.557,6,21,0.286,9,14,0.643,95,37,84,0.44,28,53,0.528,9,31,0.29,13,19,0.684,96
1978,NOP,2021-01-15,95,@,LAL,0,240,41,86,0.477,32,57,0.561,9,29,0.31,4,8,0.5,95,39,93,0.419,24,56,0.429,15,37,0.405,19,26,0.731,112
1979,GSW,2021-01-12,95,,IND,0,240,34,89,0.382,21,51,0.412,13,38,0.342,14,22,0.636,95,39,88,0.443,30,60,0.5,9,28,0.321,17,25,0.68,104
1980,UTA,2020-12-31,95,,PHO,0,240,35,84,0.417,23,50,0.46,12,34,0.353,13,19,0.684,95,41,84,0.488,24,51,0.471,17,33,0.515,7,10,0.7,106
1981,NYK,2020-12-29,95,@,CLE,1,240,34,79,0.43,20,54,0.37,14,25,0.56,13,21,0.619,95,32,88,0.364,25,56,0.446,7,32,0.219,15,22,0.682,86
1982,SAS,2020-12-27,95,@,NOP,0,240,38,89,0.427,27,53,0.509,11,36,0.306,8,8,1.0,95,36,94,0.383,31,70,0.443,5,24,0.208,21,29,0.724,98
1983,BOS,2020-12-25,95,,BRK,0,240,37,98,0.378,29,71,0.408,8,27,0.296,13,19,0.684,95,41,76,0.539,26,47,0.553,15,29,0.517,26,31,0.839,123
1984,PHI,2021-05-13,94,@,MIA,0,240,36,78,0.462,29,53,0.547,7,25,0.28,15,20,0.75,94,41,81,0.506,28,46,0.609,13,35,0.371,11,11,1.0,106
1985,BOS,2021-05-12,94,@,CLE,0,240,36,101,0.356,24,60,0.4,12,41,0.293,10,14,0.714,94,36,80,0.45,28,56,0.5,8,24,0.333,22,27,0.815,102
1986,PHI,2021-05-11,94,@,IND,0,240,38,87,0.437,30,61,0.492,8,26,0.308,10,14,0.714,94,37,83,0.446,23,42,0.548,14,41,0.341,15,16,0.938,103
1987,LAL,2021-05-06,94,@,LAC,0,240,33,87,0.379,23,51,0.451,10,36,0.278,18,29,0.621,94,41,77,0.532,28,46,0.609,13,31,0.419,23,26,0.885,118
1988,SAS,2021-05-05,94,@,UTA,0,240,37,92,0.402,30,69,0.435,7,23,0.304,13,20,0.65,94,49,88,0.557,31,47,0.66,18,41,0.439,10,14,0.714,126
1989,CHI,2021-05-03,94,,PHI,0,240,36,87,0.414,25,53,0.472,11,34,0.324,11,14,0.786,94,40,75,0.533,29,47,0.617,11,28,0.393,15,21,0.714,106
1990,DET,2021-05-01,94,@,CHO,0,240,35,91,0.385,22,54,0.407,13,37,0.351,11,17,0.647,94,42,87,0.483,28,50,0.56,14,37,0.378,9,20,0.45,107
1991,CHI,2021-04-28,94,@,NYK,0,240,39,85,0.459,29,56,0.518,10,29,0.345,6,10,0.6,94,42,91,0.462,30,64,0.469,12,27,0.444,17,19,0.895,113
1992,PHI,2021-04-24,94,@,MIL,0,240,31,82,0.378,24,51,0.471,7,31,0.226,25,34,0.735,94,49,95,0.516,31,55,0.564,18,40,0.45,16,24,0.667,132
1993,IND,2021-04-19,94,,SAS,0,240,34,104,0.327,26,70,0.371,8,34,0.235,18,27,0.667,94,36,84,0.429,28,56,0.5,8,28,0.286,29,35,0.829,109
1994,PHI,2021-04-09,94,@,NOP,0,240,33,79,0.418,22,48,0.458,11,31,0.355,17,24,0.708,94,39,90,0.433,35,68,0.515,4,22,0.182,19,30,0.633,101
1995,SAC,2021-04-02,94,,LAL,0,240,36,85,0.424,26,50,0.52,10,35,0.286,12,16,0.75,94,43,91,0.473,26,58,0.448,17,33,0.515,12,20,0.6,115
1996,CLE,2021-04-01,94,,PHI,0,240,34,80,0.425,24,45,0.533,10,35,0.286,16,21,0.762,94,40,93,0.43,25,56,0.446,15,37,0.405,19,25,0.76,114
1997,LAC,2021-04-01,94,,DEN,0,240,35,85,0.412,25,51,0.49,10,34,0.294,14,16,0.875,94,39,81,0.481,26,56,0.464,13,25,0.52,10,14,0.714,101
1998,OKC,2021-03-27,94,,BOS,0,240,34,83,0.41,23,45,0.511,11,38,0.289,15,24,0.625,94,44,96,0.458,32,58,0.552,12,38,0.316,11,14,0.786,111
1999,DAL,2021-03-26,94,,IND,0,240,39,95,0.411,31,60,0.517,8,35,0.229,8,14,0.571,94,38,87,0.437,18,40,0.45,20,47,0.426,13,18,0.722,109
2000,CHI,2021-03-24,94,,CLE,0,240,37,83,0.446,29,55,0.527,8,28,0.286,12,14,0.857,94,42,92,0.457,31,63,0.492,11,29,0.379,8,10,0.8,103
2001,LAL,2021-03-21,94,@,PHO,0,240,35,85,0.412,30,60,0.5,5,25,0.2,19,28,0.679,94,42,87,0.483,33,55,0.6,9,32,0.281,18,23,0.783,111
2002,LAL,2021-03-20,94,,ATL,0,240,34,81,0.42,26,55,0.473,8,26,0.308,18,24,0.75,94,39,98,0.398,26,61,0.426,13,37,0.351,8,9,0.889,99
2003,NYK,2021-03-18,94,,ORL,1,240,37,86,0.43,23,52,0.442,14,34,0.412,6,11,0.545,94,35,82,0.427,25,48,0.521,10,34,0.294,13,16,0.813,93
2004,HOU,2021-03-17,94,,GSW,0,240,33,80,0.413,26,53,0.491,7,27,0.259,21,40,0.525,94,41,90,0.456,25,45,0.556,16,45,0.356,10,12,0.833,108
2005,ATL,2021-03-02,94,@,MIA,1,240,34,71,0.479,21,35,0.6,13,36,0.361,13,15,0.867,94,28,75,0.373,19,42,0.452,9,33,0.273,15,22,0.682,80
2006,LAC,2021-02-25,94,@,MEM,0,240,34,84,0.405,22,50,0.44,12,34,0.353,14,16,0.875,94,50,92,0.543,39,73,0.534,11,19,0.579,11,16,0.688,122
2007,OKC,2021-02-22,94,,MIA,0,240,32,74,0.432,18,35,0.514,14,39,0.359,16,19,0.842,94,36,81,0.444,21,41,0.512,15,40,0.375,21,25,0.84,108
2008,LAL,2021-02-20,94,,MIA,0,240,33,84,0.393,20,39,0.513,13,45,0.289,15,17,0.882,94,36,85,0.424,28,57,0.491,8,28,0.286,16,23,0.696,96
2009,MIA,2021-02-13,94,@,UTA,0,240,35,86,0.407,23,50,0.46,12,36,0.333,12,17,0.706,94,39,85,0.459,27,39,0.692,12,46,0.261,22,29,0.759,112
2010,HOU,2021-02-11,94,,MIA,0,240,32,83,0.386,17,33,0.515,15,50,0.3,15,20,0.75,94,34,79,0.43,19,37,0.514,15,42,0.357,18,20,0.9,101
2011,IND,2021-02-10,94,@,BRK,0,240,36,92,0.391,21,54,0.389,15,38,0.395,7,11,0.636,94,32,76,0.421,23,45,0.511,9,31,0.29,31,35,0.886,104
2012,HOU,2021-02-08,94,@,CHO,0,240,35,86,0.407,22,39,0.564,13,47,0.277,11,16,0.688,94,44,90,0.489,25,49,0.51,19,41,0.463,12,13,0.923,119
2013,MIN,2021-01-29,94,,PHI,0,240,35,82,0.427,25,49,0.51,10,33,0.303,14,18,0.778,94,39,87,0.448,31,71,0.437,8,16,0.5,32,38,0.842,118
2014,NYK,2021-01-26,94,@,UTA,0,240,36,83,0.434,26,56,0.464,10,27,0.37,12,17,0.706,94,37,92,0.402,22,44,0.5,15,48,0.313,19,22,0.864,108
2015,NYK,2021-01-22,94,@,SAC,0,240,36,94,0.383,31,72,0.431,5,22,0.227,17,25,0.68,94,38,91,0.418,26,57,0.456,12,34,0.353,15,21,0.714,103
2016,PHI,2021-01-11,94,@,ATL,0,240,37,92,0.402,29,56,0.518,8,36,0.222,12,13,0.923,94,37,99,0.374,20,55,0.364,17,44,0.386,21,27,0.778,112
2017,CLE,2021-01-07,94,@,MEM,1,240,36,79,0.456,23,49,0.469,13,30,0.433,9,16,0.563,94,36,83,0.434,25,52,0.481,11,31,0.355,7,8,0.875,90
2018,CLE,2021-01-06,94,@,ORL,0,240,36,85,0.424,32,59,0.542,4,26,0.154,18,26,0.692,94,40,81,0.494,28,52,0.538,12,29,0.414,13,18,0.722,105
2019,ATL,2021-01-06,94,,CHO,0,240,36,96,0.375,29,56,0.518,7,40,0.175,15,18,0.833,94,32,85,0.376,21,49,0.429,11,36,0.306,27,33,0.818,102
2020,LAL,2021-01-05,94,@,MEM,1,240,38,87,0.437,29,56,0.518,9,31,0.29,9,11,0.818,94,36,87,0.414,26,61,0.426,10,26,0.385,10,13,0.769,92
2021,MEM,2021-01-03,94,,LAL,0,240,39,95,0.411,30,62,0.484,9,33,0.273,7,8,0.875,94,41,89,0.461,29,54,0.537,12,35,0.343,14,19,0.737,108
2022,SAC,2021-01-02,94,@,HOU,0,240,35,90,0.389,26,62,0.419,9,28,0.321,15,21,0.714,94,36,81,0.444,23,40,0.575,13,41,0.317,17,23,0.739,102
2023,PHI,2020-12-27,94,@,CLE,0,240,33,79,0.418,21,42,0.5,12,37,0.324,16,22,0.727,94,48,91,0.527,39,68,0.574,9,23,0.391,13,16,0.813,118
2024,OKC,2021-05-14,93,,UTA,0,240,36,84,0.429,30,65,0.462,6,19,0.316,15,16,0.938,93,40,93,0.43,27,54,0.5,13,39,0.333,16,21,0.762,109
2025,ORL,2021-05-13,93,@,ATL,0,240,36,94,0.383,25,58,0.431,11,36,0.306,10,15,0.667,93,41,94,0.436,27,58,0.466,14,36,0.389,20,24,0.833,116
2026,IND,2021-05-05,93,,SAC,0,240,36,83,0.434,27,58,0.466,9,25,0.36,12,17,0.706,93,43,95,0.453,35,63,0.556,8,32,0.25,10,14,0.714,104
2027,LAL,2021-05-03,93,,DEN,1,240,32,73,0.438,19,43,0.442,13,30,0.433,16,23,0.696,93,36,82,0.439,30,58,0.517,6,24,0.25,11,16,0.688,89
2028,CLE,2021-04-30,93,,WAS,0,240,34,82,0.415,27,49,0.551,7,33,0.212,18,28,0.643,93,46,92,0.5,38,74,0.514,8,18,0.444,22,26,0.846,122
2029,LAL,2021-04-24,93,@,DAL,0,240,33,86,0.384,21,41,0.512,12,45,0.267,15,19,0.789,93,38,78,0.487,25,48,0.521,13,30,0.433,19,25,0.76,108
2030,CHO,2021-04-13,93,,LAL,0,240,36,83,0.434,27,48,0.563,9,35,0.257,12,18,0.667,93,34,82,0.415,18,38,0.474,16,44,0.364,17,18,0.944,101
2031,OKC,2021-04-10,93,,PHI,0,240,38,76,0.5,30,56,0.536,8,20,0.4,9,19,0.474,93,44,94,0.468,32,56,0.571,12,38,0.316,17,25,0.68,117
2032,DAL,2021-04-07,93,@,HOU,0,240,33,87,0.379,23,48,0.479,10,39,0.256,17,22,0.773,93,38,88,0.432,21,44,0.477,17,44,0.386,9,16,0.563,102
2033,ORL,2021-03-28,93,@,LAL,0,240,34,88,0.386,23,55,0.418,11,33,0.333,14,17,0.824,93,34,82,0.415,23,42,0.548,11,40,0.275,17,23,0.739,96
2034,ORL,2021-03-18,93,@,NYK,0,240,35,82,0.427,25,48,0.521,10,34,0.294,13,16,0.813,93,37,86,0.43,23,52,0.442,14,34,0.412,6,11,0.545,94
2035,OKC,2021-03-18,93,@,ATL,0,240,34,93,0.366,21,59,0.356,13,34,0.382,12,16,0.75,93,47,87,0.54,36,54,0.667,11,33,0.333,11,13,0.846,116
2036,NOP,2021-03-18,93,@,POR,0,240,33,83,0.398,23,46,0.5,10,37,0.27,17,25,0.68,93,33,87,0.379,19,44,0.432,14,43,0.326,21,25,0.84,101
2037,NOP,2021-03-04,93,,MIA,0,240,33,84,0.393,22,41,0.537,11,43,0.256,16,20,0.8,93,36,73,0.493,26,43,0.605,10,30,0.333,21,25,0.84,103
2038,NYK,2021-03-02,93,@,SAS,0,240,33,81,0.407,18,45,0.4,15,36,0.417,12,15,0.8,93,43,89,0.483,25,47,0.532,18,42,0.429,15,21,0.714,119
2039,POR,2021-02-26,93,@,LAL,0,240,32,83,0.386,21,46,0.457,11,37,0.297,18,20,0.9,93,37,88,0.42,30,61,0.492,7,27,0.259,21,28,0.75,102
2040,ORL,2021-02-23,93,,DET,0,240,33,88,0.375,19,50,0.38,14,38,0.368,13,22,0.591,93,41,88,0.466,31,54,0.574,10,34,0.294,13,16,0.813,105
2041,DEN,2021-02-04,93,@,LAL,0,240,36,92,0.391,28,64,0.438,8,28,0.286,13,15,0.867,93,46,81,0.568,38,57,0.667,8,24,0.333,14,22,0.636,114
2042,GSW,2021-01-28,93,@,PHO,0,240,38,99,0.384,27,61,0.443,11,38,0.289,6,8,0.75,93,41,88,0.466,30,56,0.536,11,32,0.344,21,23,0.913,114
2043,DAL,2021-01-18,93,@,TOR,0,240,31,82,0.378,22,46,0.478,9,36,0.25,22,27,0.815,93,44,88,0.5,32,55,0.582,12,33,0.364,16,18,0.889,116
2044,CHO,2021-01-13,93,,DAL,0,240,38,100,0.38,28,62,0.452,10,38,0.263,7,14,0.5,93,40,96,0.417,25,50,0.5,15,46,0.326,9,16,0.563,104
2045,CHO,2021-01-01,93,,MEM,0,240,35,86,0.407,26,55,0.473,9,31,0.29,14,21,0.667,93,43,90,0.478,29,51,0.569,14,39,0.359,8,10,0.8,108
2046,DAL,2021-01-01,93,,MIA,1,240,32,78,0.41,20,41,0.488,12,37,0.324,17,23,0.739,93,29,78,0.372,22,45,0.489,7,33,0.212,18,25,0.72,83
2047,BOS,2021-01-01,93,@,DET,0,240,39,83,0.47,31,52,0.596,8,31,0.258,7,14,0.5,93,36,88,0.409,25,54,0.463,11,34,0.324,13,20,0.65,96
2048,TOR,2020-12-29,93,@,PHI,0,240,32,90,0.356,15,45,0.333,17,45,0.378,12,14,0.857,93,32,84,0.381,24,53,0.453,8,31,0.258,28,33,0.848,100
2049,BOS,2021-05-16,92,@,NYK,0,240,35,86,0.407,24,45,0.533,11,41,0.268,11,15,0.733,92,34,79,0.43,21,52,0.404,13,27,0.481,15,19,0.789,96
2050,MEM,2021-04-30,92,,ORL,1,240,34,99,0.343,23,60,0.383,11,39,0.282,13,16,0.813,92,27,86,0.314,21,60,0.35,6,26,0.231,15,20,0.75,75
2051,MIA,2021-03-31,92,@,IND,1,240,32,78,0.41,22,46,0.478,10,32,0.313,18,28,0.643,92,34,85,0.4,23,48,0.479,11,37,0.297,8,12,0.667,87
2052,DET,2021-03-27,92,@,WAS,0,240,33,85,0.388,23,56,0.411,10,29,0.345,16,19,0.842,92,44,91,0.484,35,70,0.5,9,21,0.429,9,9,1.0,106
2053,POR,2021-03-21,92,,DAL,0,240,34,89,0.382,25,48,0.521,9,41,0.22,15,19,0.789,92,48,86,0.558,29,49,0.592,19,37,0.514,17,20,0.85,132
2054,ORL,2021-02-25,92,@,BRK,0,240,35,87,0.402,26,51,0.51,9,36,0.25,13,15,0.867,92,49,92,0.533,29,47,0.617,20,45,0.444,11,14,0.786,129
2055,MEM,2021-02-22,92,@,DAL,0,240,37,94,0.394,31,63,0.492,6,31,0.194,12,19,0.632,92,35,80,0.438,20,39,0.513,15,41,0.366,17,26,0.654,102
2056,ORL,2021-02-06,92,,CHI,0,240,37,95,0.389,31,68,0.456,6,27,0.222,12,12,1.0,92,47,91,0.516,32,61,0.525,15,30,0.5,9,13,0.692,118
2057,DET,2021-02-05,92,@,PHO,0,240,34,91,0.374,27,55,0.491,7,36,0.194,17,28,0.607,92,42,85,0.494,30,53,0.566,12,32,0.375,13,16,0.813,109
2058,LAL,2021-01-28,92,@,DET,0,240,36,88,0.409,24,60,0.4,12,28,0.429,8,12,0.667,92,40,87,0.46,26,51,0.51,14,36,0.389,13,13,1.0,107
2059,ATL,2021-01-15,92,@,UTA,0,240,38,92,0.413,33,64,0.516,5,28,0.179,11,15,0.733,92,43,92,0.467,23,48,0.479,20,44,0.455,10,14,0.714,116
2060,MEM,2021-01-05,92,,LAL,0,240,36,87,0.414,26,61,0.426,10,26,0.385,10,13,0.769,92,38,87,0.437,29,56,0.518,9,31,0.29,9,11,0.818,94
2061,ORL,2020-12-31,92,,PHI,0,240,33,95,0.347,26,67,0.388,7,28,0.25,19,21,0.905,92,44,91,0.484,29,58,0.5,15,33,0.455,13,15,0.867,116
2062,CHI,2021-05-15,91,@,BRK,0,240,34,98,0.347,23,57,0.404,11,41,0.268,12,17,0.706,91,41,87,0.471,27,53,0.509,14,34,0.412,9,15,0.6,105
2063,DET,2021-05-14,91,,DEN,0,240,34,83,0.41,28,46,0.609,6,37,0.162,17,23,0.739,91,42,86,0.488,33,54,0.611,9,32,0.281,11,14,0.786,104
2064,CHO,2021-04-22,91,@,CHI,0,240,35,82,0.427,27,51,0.529,8,31,0.258,13,17,0.765,91,43,87,0.494,29,44,0.659,14,43,0.326,8,11,0.727,108
2065,DET,2021-04-22,91,@,SAS,0,240,35,77,0.455,27,55,0.491,8,22,0.364,13,22,0.591,91,37,80,0.463,26,56,0.464,11,24,0.458,21,27,0.778,106
2066,HOU,2021-04-19,91,@,MIA,0,240,33,85,0.388,24,47,0.511,9,38,0.237,16,17,0.941,91,45,93,0.484,26,45,0.578,19,48,0.396,4,7,0.571,113
2067,ORL,2021-04-03,91,@,UTA,0,240,32,87,0.368,30,64,0.469,2,23,0.087,25,31,0.806,91,51,92,0.554,25,37,0.676,26,55,0.473,9,12,0.75,137
2068,WAS,2021-04-01,91,@,DET,0,240,40,85,0.471,35,66,0.53,5,19,0.263,6,19,0.316,91,45,94,0.479,33,65,0.508,12,29,0.414,18,22,0.818,120
2069,GSW,2021-02-28,91,@,LAL,0,240,35,86,0.407,27,52,0.519,8,34,0.235,13,19,0.684,91,40,85,0.471,29,54,0.537,11,31,0.355,26,38,0.684,117
2070,BOS,2021-02-14,91,@,WAS,0,240,32,90,0.356,23,55,0.418,9,35,0.257,18,30,0.6,91,33,83,0.398,26,53,0.491,7,30,0.233,31,36,0.861,104
2071,WAS,2021-02-12,91,,NYK,0,240,34,89,0.382,25,55,0.455,9,34,0.265,14,20,0.7,91,44,98,0.449,38,74,0.514,6,24,0.25,15,22,0.682,109
2072,SAS,2021-02-09,91,,GSW,0,240,32,86,0.372,24,62,0.387,8,24,0.333,19,21,0.905,91,42,91,0.462,25,51,0.49,17,40,0.425,13,19,0.684,114
2073,BOS,2021-02-07,91,@,PHO,0,240,33,93,0.355,16,49,0.327,17,44,0.386,8,12,0.667,91,40,82,0.488,32,53,0.604,8,29,0.276,12,12,1.0,100
2074,ATL,2021-02-04,91,,UTA,0,240,32,98,0.327,23,67,0.343,9,31,0.29,18,19,0.947,91,44,91,0.484,31,64,0.484,13,27,0.481,11,13,0.846,112
2075,DET,2021-01-30,91,@,GSW,0,240,29,77,0.377,20,41,0.488,9,36,0.25,24,32,0.75,91,47,89,0.528,30,53,0.566,17,36,0.472,7,10,0.7,118
2076,NYK,2021-01-18,91,,ORL,1,240,31,87,0.356,26,60,0.433,5,27,0.185,24,34,0.706,91,29,86,0.337,17,48,0.354,12,38,0.316,14,16,0.875,84
2077,HOU,2021-01-16,91,@,SAS,0,240,31,84,0.369,19,52,0.365,12,32,0.375,17,27,0.63,91,40,100,0.4,35,76,0.461,5,24,0.208,18,23,0.783,103
2078,CLE,2021-01-11,91,,MEM,0,240,37,82,0.451,26,56,0.464,11,26,0.423,6,14,0.429,91,40,78,0.513,35,58,0.603,5,20,0.25,16,21,0.762,101
2079,ATL,2021-01-02,91,,CLE,0,240,35,85,0.412,24,53,0.453,11,32,0.344,10,19,0.526,91,38,91,0.418,31,62,0.5,7,29,0.241,13,17,0.765,96
2080,MIN,2020-12-27,91,@,LAL,0,240,38,103,0.369,32,68,0.471,6,35,0.171,9,14,0.643,91,50,90,0.556,37,55,0.673,13,35,0.371,14,18,0.778,127
2081,CHO,2021-05-13,90,,LAC,0,240,33,84,0.393,24,51,0.471,9,33,0.273,15,19,0.789,90,40,75,0.533,19,30,0.633,21,45,0.467,12,16,0.75,113
2082,CLE,2021-05-07,90,@,DAL,0,240,32,83,0.386,26,54,0.481,6,29,0.207,20,26,0.769,90,41,83,0.494,31,51,0.608,10,32,0.313,18,22,0.818,110
2083,OKC,2021-04-26,90,@,PHI,0,240,35,78,0.449,28,48,0.583,7,30,0.233,13,23,0.565,90,47,86,0.547,33,55,0.6,14,31,0.452,13,18,0.722,121
2084,CHO,2021-04-14,90,,CLE,0,240,34,84,0.405,18,40,0.45,16,44,0.364,6,12,0.5,90,37,76,0.487,24,45,0.533,13,31,0.419,16,19,0.842,103
2085,CHI,2021-04-12,90,@,MEM,0,240,36,86,0.419,31,55,0.564,5,31,0.161,13,17,0.765,90,40,85,0.471,31,57,0.544,9,28,0.321,12,14,0.857,101
2086,CHI,2021-03-12,90,,MIA,0,240,34,92,0.37,19,54,0.352,15,38,0.395,7,7,1.0,90,37,80,0.463,25,45,0.556,12,35,0.343,15,20,0.75,101
2087,HOU,2021-03-01,90,,CLE,0,240,31,76,0.408,21,45,0.467,10,31,0.323,18,24,0.75,90,36,73,0.493,26,43,0.605,10,30,0.333,19,24,0.792,101
2088,DET,2021-02-28,90,,NYK,0,240,28,72,0.389,19,40,0.475,9,32,0.281,25,31,0.806,90,44,86,0.512,31,60,0.517,13,26,0.5,8,10,0.8,109
2089,ORL,2021-02-14,90,@,PHO,0,240,33,89,0.371,27,54,0.5,6,35,0.171,18,22,0.818,90,41,92,0.446,29,55,0.527,12,37,0.324,15,16,0.938,109
2090,ORL,2021-01-29,90,,LAC,0,240,32,89,0.36,22,56,0.393,10,33,0.303,16,18,0.889,90,46,94,0.489,33,57,0.579,13,37,0.351,11,11,1.0,116
2091,CHI,2021-01-23,90,,LAL,0,240,33,84,0.393,25,59,0.424,8,25,0.32,16,22,0.727,90,36,79,0.456,32,60,0.533,4,19,0.211,25,31,0.806,101
2092,CLE,2021-01-09,90,@,MIL,0,240,36,87,0.414,29,61,0.475,7,26,0.269,11,16,0.688,90,37,84,0.44,25,48,0.521,12,36,0.333,14,18,0.778,100
2093,ORL,2021-01-08,90,@,HOU,0,240,34,89,0.382,26,60,0.433,8,29,0.276,14,16,0.875,90,51,91,0.56,29,44,0.659,22,47,0.468,8,11,0.727,132
2094,MEM,2021-01-07,90,,CLE,0,240,36,83,0.434,25,52,0.481,11,31,0.355,7,8,0.875,90,36,79,0.456,23,49,0.469,13,30,0.433,9,16,0.563,94
2095,OKC,2021-01-04,90,@,MIA,0,240,29,79,0.367,16,31,0.516,13,48,0.271,19,27,0.704,90,46,81,0.568,30,47,0.638,16,34,0.471,10,18,0.556,118
2096,DEN,2021-05-03,89,@,LAL,0,240,36,82,0.439,30,58,0.517,6,24,0.25,11,16,0.688,89,32,73,0.438,19,43,0.442,13,30,0.433,16,23,0.696,93
2097,HOU,2021-04-21,89,,UTA,0,240,35,99,0.354,25,50,0.5,10,49,0.204,9,17,0.529,89,41,90,0.456,24,44,0.545,17,46,0.37,13,16,0.813,112
2098,CHO,2021-04-01,89,@,BRK,0,240,30,86,0.349,17,48,0.354,13,38,0.342,16,19,0.842,89,44,91,0.484,24,46,0.522,20,45,0.444,3,4,0.75,111
2099,LAC,2021-03-17,89,@,DAL,0,240,37,88,0.42,28,56,0.5,9,32,0.281,6,11,0.545,89,40,79,0.506,25,45,0.556,15,34,0.441,10,12,0.833,105
2100,MEM,2021-03-17,89,,MIA,1,240,30,85,0.353,20,43,0.465,10,42,0.238,19,25,0.76,89,32,89,0.36,24,55,0.436,8,34,0.235,13,18,0.722,85
2101,LAL,2021-02-24,89,@,UTA,0,240,34,85,0.4,26,52,0.5,8,33,0.242,13,20,0.65,89,41,87,0.471,19,39,0.487,22,48,0.458,10,15,0.667,114
2102,NYK,2021-02-17,89,@,ORL,0,240,33,87,0.379,26,60,0.433,7,27,0.259,16,19,0.842,89,42,92,0.457,26,58,0.448,16,34,0.471,7,10,0.7,107
2103,NYK,2021-01-10,89,,DEN,0,240,32,74,0.432,26,53,0.491,6,21,0.286,19,25,0.76,89,45,84,0.536,30,49,0.612,15,35,0.429,9,12,0.75,114
2104,NYK,2021-01-08,89,,OKC,0,240,34,96,0.354,25,69,0.362,9,27,0.333,12,20,0.6,89,38,87,0.437,27,53,0.509,11,34,0.324,14,21,0.667,101
2105,NYK,2020-12-26,89,,PHI,0,240,32,83,0.386,24,54,0.444,8,29,0.276,17,23,0.739,89,41,88,0.466,30,57,0.526,11,31,0.355,16,22,0.727,109
2106,NYK,2021-03-29,88,,MIA,0,240,33,80,0.413,23,44,0.523,10,36,0.278,12,20,0.6,88,37,86,0.43,27,52,0.519,10,34,0.294,14,17,0.824,98
2107,BRK,2021-03-24,88,@,UTA,0,240,35,97,0.361,28,62,0.452,7,35,0.2,11,15,0.733,88,41,91,0.451,18,36,0.5,23,55,0.418,13,14,0.929,118
2108,WAS,2021-01-26,88,@,HOU,0,240,33,85,0.388,28,59,0.475,5,26,0.192,17,23,0.739,88,37,88,0.42,25,51,0.49,12,37,0.324,21,29,0.724,107
2109,NYK,2021-01-11,88,@,CHO,0,240,34,87,0.391,25,50,0.5,9,37,0.243,11,17,0.647,88,38,78,0.487,25,46,0.543,13,32,0.406,20,23,0.87,109
2110,SAS,2021-01-10,88,@,MIN,0,240,36,94,0.383,28,64,0.438,8,30,0.267,8,14,0.571,88,34,81,0.42,25,55,0.455,9,26,0.346,19,23,0.826,96
2111,HOU,2021-05-01,87,,GSW,0,240,32,89,0.36,23,47,0.489,9,42,0.214,14,22,0.636,87,39,84,0.464,21,38,0.553,18,46,0.391,17,24,0.708,113
2112,SAS,2021-04-21,87,,MIA,0,240,31,77,0.403,21,42,0.5,10,35,0.286,15,20,0.75,87,39,83,0.47,26,52,0.5,13,31,0.419,16,20,0.8,107
2113,DEN,2021-04-11,87,,BOS,0,240,32,88,0.364,24,54,0.444,8,34,0.235,15,18,0.833,87,39,87,0.448,32,54,0.593,7,33,0.212,20,23,0.87,105
2114,ORL,2021-04-11,87,,MIL,0,240,32,86,0.372,24,50,0.48,8,36,0.222,15,19,0.789,87,46,94,0.489,27,54,0.5,19,40,0.475,13,15,0.867,124
2115,WAS,2021-04-03,87,,DAL,0,240,35,86,0.407,30,61,0.492,5,25,0.2,12,15,0.8,87,40,90,0.444,30,60,0.5,10,30,0.333,19,24,0.792,109
2116,IND,2021-03-31,87,,MIA,0,240,34,85,0.4,23,48,0.479,11,37,0.297,8,12,0.667,87,32,78,0.41,22,46,0.478,10,32,0.313,18,28,0.643,92
2117,DAL,2021-03-03,87,,OKC,1,240,32,83,0.386,24,43,0.558,8,40,0.2,15,19,0.789,87,29,87,0.333,20,48,0.417,9,39,0.231,11,17,0.647,78
2118,HOU,2021-02-03,87,@,OKC,0,240,33,86,0.384,21,40,0.525,12,46,0.261,9,13,0.692,87,36,83,0.434,26,50,0.52,10,33,0.303,22,26,0.846,104
2119,POR,2021-01-14,87,,IND,0,240,32,87,0.368,19,44,0.432,13,43,0.302,10,10,1.0,87,44,92,0.478,35,62,0.565,9,30,0.3,14,18,0.778,111
2120,CLE,2021-01-12,87,,UTA,0,240,35,90,0.389,27,59,0.458,8,31,0.258,9,14,0.643,87,42,84,0.5,18,39,0.462,24,45,0.533,9,12,0.75,117
2121,ATL,2021-04-26,86,@,DET,0,240,33,85,0.388,29,58,0.5,4,27,0.148,16,17,0.941,86,40,84,0.476,31,58,0.534,9,26,0.346,11,15,0.733,100
2122,PHO,2021-04-22,86,@,BOS,0,240,36,88,0.409,30,53,0.566,6,35,0.171,8,9,0.889,86,33,77,0.429,21,37,0.568,12,40,0.3,21,24,0.875,99
2123,MIA,2021-04-13,86,@,PHO,0,240,31,82,0.378,22,38,0.579,9,44,0.205,15,19,0.789,86,38,82,0.463,25,40,0.625,13,42,0.31,17,18,0.944,106
2124,CHO,2021-04-04,86,@,BOS,0,240,32,80,0.4,22,49,0.449,10,31,0.323,12,20,0.6,86,43,94,0.457,22,40,0.55,21,54,0.389,9,11,0.818,116
2125,LAL,2021-04-04,86,@,LAC,0,240,32,80,0.4,25,57,0.439,7,23,0.304,15,20,0.75,86,41,86,0.477,27,58,0.466,14,28,0.5,8,9,0.889,104
2126,NYK,2021-04-02,86,,DAL,0,240,32,89,0.36,20,51,0.392,12,38,0.316,10,10,1.0,86,41,88,0.466,29,51,0.569,12,37,0.324,5,10,0.5,99
2127,CLE,2021-03-26,86,@,LAL,0,240,31,80,0.388,26,54,0.481,5,26,0.192,19,28,0.679,86,38,78,0.487,32,52,0.615,6,26,0.231,18,25,0.72,100
2128,DET,2021-03-21,86,,CHI,0,240,32,82,0.39,28,57,0.491,4,25,0.16,18,25,0.72,86,37,80,0.463,23,52,0.442,14,28,0.5,12,14,0.857,100
2129,TOR,2021-02-19,86,@,MIN,1,240,28,85,0.329,16,45,0.356,12,40,0.3,18,22,0.818,86,32,83,0.386,23,45,0.511,9,38,0.237,8,11,0.727,81
2130,DET,2021-01-10,86,,UTA,0,240,29,87,0.333,19,45,0.422,10,42,0.238,18,21,0.857,86,35,82,0.427,24,47,0.511,11,35,0.314,15,22,0.682,96
2131,NOP,2020-12-29,86,@,PHO,0,240,37,77,0.481,34,53,0.642,3,24,0.125,9,18,0.5,86,37,84,0.44,18,37,0.486,19,47,0.404,18,19,0.947,111
2132,CLE,2020-12-29,86,,NYK,0,240,32,88,0.364,25,56,0.446,7,32,0.219,15,22,0.682,86,34,79,0.43,20,54,0.37,14,25,0.56,13,21,0.619,95
2133,PHO,2021-04-17,85,,SAS,0,240,36,90,0.4,30,63,0.476,6,27,0.222,7,16,0.438,85,45,89,0.506,33,60,0.55,12,29,0.414,9,12,0.75,111
2134,OKC,2021-04-03,85,@,POR,0,240,30,85,0.353,22,51,0.431,8,34,0.235,17,24,0.708,85,51,104,0.49,31,58,0.534,20,46,0.435,11,14,0.786,133
2135,SAS,2021-03-25,85,,LAC,0,240,33,82,0.402,25,59,0.424,8,23,0.348,11,13,0.846,85,34,89,0.382,21,55,0.382,13,34,0.382,17,18,0.944,98
2136,MIA,2021-03-17,85,@,MEM,0,240,32,89,0.36,24,55,0.436,8,34,0.235,13,18,0.722,85,30,85,0.353,20,43,0.465,10,42,0.238,19,25,0.76,89
2137,OKC,2021-02-19,85,@,MIL,0,240,31,85,0.365,19,45,0.422,12,40,0.3,11,21,0.524,85,35,86,0.407,24,52,0.462,11,34,0.324,17,25,0.68,98
2138,MIA,2021-01-25,85,@,BRK,0,240,31,84,0.369,20,41,0.488,11,43,0.256,12,17,0.706,85,34,85,0.4,23,47,0.489,11,38,0.289,19,22,0.864,98
2139,HOU,2021-02-28,84,,MEM,0,240,23,83,0.277,19,38,0.5,4,45,0.089,34,41,0.829,84,50,94,0.532,40,64,0.625,10,30,0.333,23,28,0.821,133
2140,ORL,2021-01-18,84,@,NYK,0,240,29,86,0.337,17,48,0.354,12,38,0.316,14,16,0.875,84,31,87,0.356,26,60,0.433,5,27,0.185,24,34,0.706,91
2141,ATL,2021-04-28,83,@,PHI,0,240,27,81,0.333,21,62,0.339,6,19,0.316,23,29,0.793,83,48,89,0.539,32,53,0.604,16,36,0.444,15,22,0.682,127
2142,CLE,2021-01-04,83,@,ORL,0,240,33,85,0.388,23,57,0.404,10,28,0.357,7,12,0.583,83,38,88,0.432,23,54,0.426,15,34,0.441,12,13,0.923,103
2143,MIA,2021-01-01,83,@,DAL,0,240,29,78,0.372,22,45,0.489,7,33,0.212,18,25,0.72,83,32,78,0.41,20,41,0.488,12,37,0.324,17,23,0.739,93
2144,NYK,2020-12-31,83,@,TOR,0,240,32,88,0.364,29,52,0.558,3,36,0.083,16,20,0.8,83,34,83,0.41,17,31,0.548,17,52,0.327,15,21,0.714,100
2145,CLE,2021-03-14,82,@,ATL,0,240,31,81,0.383,23,51,0.451,8,30,0.267,12,23,0.522,82,32,71,0.451,20,42,0.476,12,29,0.414,24,26,0.923,100
2146,CLE,2021-03-12,82,@,NOP,0,240,30,88,0.341,23,56,0.411,7,32,0.219,15,20,0.75,82,47,101,0.465,41,77,0.532,6,24,0.25,16,19,0.842,116
2147,MIA,2021-01-27,82,,DEN,0,240,30,80,0.375,17,35,0.486,13,45,0.289,9,11,0.818,82,42,92,0.457,28,49,0.571,14,43,0.326,11,11,1.0,109
2148,DET,2021-04-03,81,,NYK,0,240,29,82,0.354,20,54,0.37,9,28,0.321,14,20,0.7,81,43,79,0.544,24,40,0.6,19,39,0.487,20,27,0.741,125
2149,MIN,2021-02-19,81,,TOR,0,240,32,83,0.386,23,45,0.511,9,38,0.237,8,11,0.727,81,28,85,0.329,16,45,0.356,12,40,0.3,18,22,0.818,86
2150,CLE,2021-01-29,81,@,NYK,0,240,29,84,0.345,21,58,0.362,8,26,0.308,15,18,0.833,81,39,80,0.488,29,53,0.547,10,27,0.37,14,16,0.875,102
2151,MIA,2021-01-22,81,@,TOR,0,240,33,77,0.429,26,46,0.565,7,31,0.226,8,10,0.8,81,39,84,0.464,22,44,0.5,17,40,0.425,6,9,0.667,101
2152,MIA,2021-03-02,80,,ATL,0,240,28,75,0.373,19,42,0.452,9,33,0.273,15,22,0.682,80,34,71,0.479,21,35,0.6,13,36,0.361,13,15,0.867,94
2153,OKC,2020-12-31,80,,NOP,0,240,30,80,0.375,15,32,0.469,15,48,0.313,5,15,0.333,80,44,91,0.484,31,55,0.564,13,36,0.361,12,19,0.632,113
2154,OKC,2021-03-03,78,@,DAL,0,240,29,87,0.333,20,48,0.417,9,39,0.231,11,17,0.647,78,32,83,0.386,24,43,0.558,8,40,0.2,15,19,0.789,87
2155,GSW,2021-04-02,77,@,TOR,0,240,26,79,0.329,15,45,0.333,11,34,0.324,14,18,0.778,77,47,88,0.534,32,53,0.604,15,35,0.429,21,25,0.84,130
2156,ORL,2021-03-12,77,@,SAS,0,240,29,80,0.363,19,42,0.452,10,38,0.263,9,12,0.75,77,40,89,0.449,30,60,0.5,10,29,0.345,14,18,0.778,104
2157,ORL,2021-04-30,75,@,MEM,0,240,27,86,0.314,21,60,0.35,6,26,0.231,15,20,0.75,75,34,99,0.343,23,60,0.383,11,39,0.282,13,16,0.813,92
2158,CLE,2021-03-29,75,@,UTA,0,240,29,83,0.349,22,49,0.449,7,34,0.206,10,16,0.625,75,38,82,0.463,19,41,0.463,19,41,0.463,19,23,0.826,114
2159,BOS,2021-01-17,75,,NYK,0,240,25,84,0.298,18,38,0.474,7,46,0.152,18,29,0.621,75,38,80,0.475,26,49,0.531,12,31,0.387,17,21,0.81,105
2160,LAC,2020-12-27,73,,DAL,0,240,26,76,0.342,22,43,0.512,4,33,0.121,17,20,0.85,73,43,87,0.494,29,46,0.63,14,41,0.341,24,27,0.889,124
