Rk,Team,Date,PTS,,Opp,Result,MP,FG,FGA,FG%,2P,2PA,2P%,3P,3PA,3P%,FT,FTA,FT%,PTS,FG,FGA,FG%,2P,2PA,2P%,3P,3PA,3P%,FT,FTA,FT%,PTS
1,GSW,2016-11-23,149,,LAL,W 149-106,240,53,86,.616,34,50,.680,19,36,.528,24,35,.686,149,40,93,.430,32,73,.438,8,20,.400,18,22,.818,106
2,GSW,2017-01-28,144,,LAC,W 144-98,240,57,92,.620,40,58,.690,17,34,.500,13,16,.813,144,36,82,.439,24,54,.444,12,28,.429,14,22,.636,98
3,BRK,2017-01-20,143,@,NOP,W 143-114,240,48,83,.578,33,53,.623,15,30,.500,32,35,.914,143,43,105,.410,32,71,.451,11,34,.324,17,23,.739,114
4,HOU,2017-02-25,142,,MIN,W 142-130,240,44,94,.468,22,36,.611,22,58,.379,32,42,.762,142,49,94,.521,40,68,.588,9,26,.346,23,28,.821,130
5,ATL,2017-01-29,142,,NYK,W 142-139 (4OT),340,52,119,.437,42,88,.477,10,31,.323,28,40,.700,142,51,128,.398,33,77,.429,18,51,.353,19,23,.826,139
6,GSW,2016-12-05,142,,IND,W 142-106,240,54,104,.519,40,67,.597,14,37,.378,20,26,.769,142,35,85,.412,32,70,.457,3,15,.200,33,35,.943,106
7,BRK,2017-04-04,141,@,PHI,W 141-118,240,48,75,.640,32,44,.727,16,31,.516,29,33,.879,141,43,97,.443,31,59,.525,12,38,.316,20,27,.741,118
8,CLE,2017-02-06,140,@,WAS,W 140-135 (OT),265,49,92,.533,30,54,.556,19,38,.500,23,28,.821,140,50,99,.505,38,70,.543,12,29,.414,23,26,.885,135
9,DEN,2017-01-12,140,,IND,W 140-112,240,52,90,.578,37,58,.638,15,32,.469,21,23,.913,140,44,94,.468,32,65,.492,12,29,.414,12,13,.923,112
10,HOU,2016-12-30,140,,LAC,W 140-116,240,45,81,.556,31,41,.756,14,40,.350,36,43,.837,140,45,96,.469,32,63,.508,13,33,.394,13,16,.813,116
11,GSW,2017-04-02,139,,WAS,W 139-115,240,50,88,.568,34,52,.654,16,36,.444,23,26,.885,139,43,92,.467,33,65,.508,10,27,.370,19,25,.760,115
12,HOU,2017-03-15,139,,LAL,W 139-100,240,50,91,.549,32,48,.667,18,43,.419,21,32,.656,139,42,91,.462,39,66,.591,3,25,.120,13,18,.722,100
13,NYK,2017-01-29,139,@,ATL,L 139-142 (4OT),340,51,128,.398,33,77,.429,18,51,.353,19,23,.826,139,52,119,.437,42,88,.477,10,31,.323,28,40,.700,142
14,GSW,2016-12-03,138,,PHO,W 138-109,240,49,78,.628,35,57,.614,14,21,.667,26,34,.765,138,41,91,.451,30,59,.508,11,32,.344,16,21,.762,109
15,HOU,2017-03-26,137,,OKC,W 137-125,240,50,79,.633,30,40,.750,20,39,.513,17,21,.810,137,47,94,.500,36,64,.563,11,30,.367,20,28,.714,125
16,PHO,2017-02-15,137,,LAL,W 137-101,240,49,88,.557,39,64,.609,10,24,.417,29,34,.853,137,35,93,.376,26,67,.388,9,26,.346,22,28,.786,101
17,MIL,2017-02-04,137,@,PHO,W 137-112,240,52,82,.634,45,65,.692,7,17,.412,26,35,.743,137,38,91,.418,27,63,.429,11,28,.393,25,30,.833,112
18,HOU,2017-01-15,137,@,BRK,W 137-112,240,46,92,.500,25,48,.521,21,44,.477,24,32,.750,137,41,93,.441,26,49,.531,15,44,.341,15,19,.789,112
19,CLE,2016-11-23,137,,POR,W 137-125,240,48,90,.533,27,54,.500,21,36,.583,20,27,.741,137,47,90,.522,34,61,.557,13,29,.448,18,19,.947,125
20,DET,2017-03-04,136,@,PHI,W 136-106,240,54,95,.568,44,72,.611,10,23,.435,18,21,.857,136,43,88,.489,29,54,.537,14,34,.412,6,7,.857,106
21,ORL,2016-12-20,136,@,MIA,W 136-130 (2OT),290,52,105,.495,41,83,.494,11,22,.500,21,31,.677,136,50,108,.463,38,78,.487,12,30,.400,18,26,.692,130
22,HOU,2017-04-09,135,@,SAC,W 135-128,240,45,80,.563,27,37,.730,18,43,.419,27,31,.871,135,47,94,.500,38,63,.603,9,31,.290,25,30,.833,128
23,CLE,2017-04-02,135,,IND,W 135-130 (2OT),290,47,95,.495,29,52,.558,18,43,.419,23,33,.697,135,48,105,.457,32,64,.500,16,41,.390,18,20,.900,130
24,CLE,2017-03-03,135,@,ATL,W 135-130,240,47,86,.547,22,40,.550,25,46,.543,16,20,.800,135,49,91,.538,39,65,.600,10,26,.385,22,30,.733,130
25,WAS,2017-02-06,135,,CLE,L 135-140 (OT),265,50,99,.505,38,70,.543,12,29,.414,23,26,.885,135,49,92,.533,30,54,.556,19,38,.500,23,28,.821,140
26,GSW,2016-12-17,135,,POR,W 135-90,240,51,87,.586,37,59,.627,14,28,.500,19,26,.731,135,34,86,.395,26,58,.448,8,28,.286,14,20,.700,90
27,DEN,2017-04-04,134,@,NOP,W 134-131,240,53,99,.535,40,69,.580,13,30,.433,15,21,.714,134,51,100,.510,37,68,.544,14,32,.438,15,17,.882,131
28,SAS,2017-01-12,134,,LAL,W 134-94,240,49,81,.605,39,60,.650,10,21,.476,26,29,.897,134,35,85,.412,29,65,.446,6,20,.300,18,25,.720,94
29,HOU,2016-12-07,134,,LAL,W 134-95,240,51,94,.543,36,58,.621,15,36,.417,17,21,.810,134,34,87,.391,29,67,.433,5,20,.250,22,27,.815,95
30,LAC,2017-03-29,133,,WAS,W 133-124,240,47,83,.566,35,53,.660,12,30,.400,27,37,.730,133,46,93,.495,33,59,.559,13,34,.382,19,29,.655,124
31,LAC,2017-03-21,133,@,LAL,W 133-109,240,45,84,.536,30,51,.588,15,33,.455,28,32,.875,133,43,92,.467,37,72,.514,6,20,.300,17,27,.630,109
32,HOU,2017-02-11,133,,PHO,W 133-102,240,42,85,.494,24,49,.490,18,36,.500,31,39,.795,133,37,94,.394,29,72,.403,8,22,.364,20,26,.769,102
33,GSW,2017-02-02,133,@,LAC,W 133-120,240,52,99,.525,38,65,.585,14,34,.412,15,18,.833,133,40,80,.500,30,55,.545,10,25,.400,30,39,.769,120
34,LAC,2016-12-10,133,,NOP,W 133-105,240,54,94,.574,37,58,.638,17,36,.472,8,9,.889,133,40,83,.482,32,64,.500,8,19,.421,17,26,.654,105
35,GSW,2016-11-13,133,,PHO,W 133-120,240,45,87,.517,29,54,.537,16,33,.485,27,31,.871,133,46,90,.511,38,66,.576,8,24,.333,20,26,.769,120
36,DEN,2017-02-13,132,,GSW,W 132-110,240,48,88,.545,24,47,.511,24,41,.585,12,16,.750,132,45,92,.489,37,60,.617,8,32,.250,12,13,.923,110
37,CLE,2017-02-08,132,@,IND,W 132-117,240,46,84,.548,30,48,.625,16,36,.444,24,26,.923,132,41,82,.500,28,57,.491,13,25,.520,22,26,.846,117
38,TOR,2017-01-13,132,,BRK,W 132-113,240,52,97,.536,41,69,.594,11,28,.393,17,21,.810,132,40,86,.465,23,50,.460,17,36,.472,16,20,.800,113
39,DEN,2016-12-15,132,,POR,W 132-120,240,43,84,.512,28,53,.528,15,31,.484,31,35,.886,132,41,88,.466,33,65,.508,8,23,.348,30,36,.833,120
40,HOU,2016-12-14,132,,SAC,W 132-98,240,50,85,.588,28,43,.651,22,42,.524,10,16,.625,132,39,92,.424,28,60,.467,11,32,.344,9,11,.818,98
41,HOU,2016-12-01,132,@,GSW,W 132-127 (2OT),290,48,108,.444,34,64,.531,14,44,.318,22,30,.733,132,43,104,.413,31,60,.517,12,44,.273,29,37,.784,127
42,OKC,2016-11-25,132,@,DEN,W 132-129 (OT),265,48,96,.500,35,70,.500,13,26,.500,23,29,.793,132,48,101,.475,36,67,.537,12,34,.353,21,27,.778,129
43,NOP,2017-04-04,131,,DEN,L 131-134,240,51,100,.510,37,68,.544,14,32,.438,15,17,.882,131,53,99,.535,40,69,.580,13,30,.433,15,21,.714,134
44,TOR,2017-03-27,131,,ORL,W 131-112,240,49,83,.590,39,68,.574,10,15,.667,23,35,.657,131,43,88,.489,39,68,.574,4,20,.200,22,28,.786,112
45,WAS,2017-03-07,131,@,PHO,W 131-127,240,41,90,.456,34,72,.472,7,18,.389,42,53,.792,131,44,88,.500,31,61,.508,13,27,.481,26,33,.788,127
46,DEN,2017-02-10,131,@,NYK,W 131-123,240,54,95,.568,38,63,.603,16,32,.500,7,10,.700,131,52,93,.559,36,55,.655,16,38,.421,3,5,.600,123
47,HOU,2016-12-26,131,,PHO,W 131-115,240,46,92,.500,31,49,.633,15,43,.349,24,30,.800,131,43,101,.426,36,71,.507,7,30,.233,22,27,.815,115
48,ORL,2016-12-13,131,@,ATL,W 131-120,240,51,87,.586,36,53,.679,15,34,.441,14,20,.700,131,45,89,.506,34,61,.557,11,28,.393,19,21,.905,120
49,POR,2016-11-30,131,,IND,W 131-109,240,51,94,.543,39,62,.629,12,32,.375,17,19,.895,131,36,72,.500,30,58,.517,6,14,.429,31,35,.886,109
50,IND,2017-04-02,130,@,CLE,L 130-135 (2OT),290,48,105,.457,32,64,.500,16,41,.390,18,20,.900,130,47,95,.495,29,52,.558,18,43,.419,23,33,.697,135
51,POR,2017-04-01,130,,PHO,W 130-117,240,43,92,.467,28,55,.509,15,37,.405,29,31,.935,130,44,84,.524,41,74,.554,3,10,.300,26,32,.813,117
52,LAL,2017-03-24,130,,MIN,W 130-119 (OT),265,46,88,.523,32,65,.492,14,23,.609,24,28,.857,130,46,95,.484,39,74,.527,7,21,.333,20,22,.909,119
53,BOS,2017-03-24,130,,PHO,W 130-120,240,44,94,.468,30,53,.566,14,41,.341,28,35,.800,130,39,86,.453,33,67,.493,6,19,.316,36,49,.735,120
54,WAS,2017-03-10,130,@,SAC,W 130-122 (OT),265,52,104,.500,43,78,.551,9,26,.346,17,19,.895,130,44,92,.478,32,69,.464,12,23,.522,22,28,.786,122
55,POR,2017-03-04,130,,BRK,W 130-116,240,49,86,.570,33,61,.541,16,25,.640,16,22,.727,130,45,86,.523,31,56,.554,14,30,.467,12,17,.706,116
56,ATL,2017-03-03,130,,CLE,L 130-135,240,49,91,.538,39,65,.600,10,26,.385,22,30,.733,130,47,86,.547,22,40,.550,25,46,.543,16,20,.800,135
57,MEM,2017-02-28,130,,PHO,W 130-112,240,48,86,.558,36,61,.590,12,25,.480,22,29,.759,130,43,83,.518,36,62,.581,7,21,.333,19,24,.792,112
58,MIN,2017-02-25,130,@,HOU,L 130-142,240,49,94,.521,40,68,.588,9,26,.346,23,28,.821,130,44,94,.468,22,36,.611,22,58,.379,32,42,.762,142
59,GSW,2017-02-11,130,@,OKC,W 130-114,240,46,87,.529,33,56,.589,13,31,.419,25,35,.714,130,40,83,.482,34,59,.576,6,24,.250,28,36,.778,114
60,MIA,2016-12-20,130,,ORL,L 130-136 (2OT),290,50,108,.463,38,78,.487,12,30,.400,18,26,.692,130,52,105,.495,41,83,.494,11,22,.500,21,31,.677,136
61,SAS,2016-12-10,130,,BRK,W 130-101,240,50,94,.532,36,68,.529,14,26,.538,16,18,.889,130,36,87,.414,29,60,.483,7,27,.259,22,25,.880,101
62,HOU,2016-11-27,130,@,POR,W 130-114,240,46,82,.561,29,46,.630,17,36,.472,21,28,.750,130,40,83,.482,28,50,.560,12,33,.364,22,29,.759,114
63,IND,2016-10-26,130,,DAL,W 130-121 (OT),265,47,93,.505,37,74,.500,10,19,.526,26,34,.765,130,45,104,.433,27,56,.482,18,48,.375,13,18,.722,121
64,SAC,2017-04-11,129,,PHO,W 129-104,240,43,83,.518,34,64,.531,9,19,.474,34,43,.791,129,41,109,.376,33,79,.418,8,30,.267,14,24,.583,104
65,WAS,2017-03-24,129,,BRK,W 129-108,240,49,97,.505,39,71,.549,10,26,.385,21,22,.955,129,43,82,.524,40,67,.597,3,15,.200,19,26,.731,108
66,DEN,2017-03-16,129,,LAC,W 129-114,240,46,86,.535,31,58,.534,15,28,.536,22,26,.846,129,44,84,.524,28,52,.538,16,32,.500,10,15,.667,114
67,DEN,2017-03-13,129,,LAL,W 129-101,240,45,84,.536,28,46,.609,17,38,.447,22,25,.880,129,42,97,.433,36,77,.468,6,20,.300,11,19,.579,101
68,DEN,2017-02-24,129,,BRK,W 129-109,240,49,97,.505,35,66,.530,14,31,.452,17,24,.708,129,41,83,.494,31,53,.585,10,30,.333,17,31,.548,109
69,HOU,2017-02-23,129,@,NOP,W 129-99,240,45,91,.495,25,40,.625,20,51,.392,19,24,.792,129,36,86,.419,30,55,.545,6,31,.194,21,26,.808,99
70,MIL,2017-02-15,129,@,BRK,W 129-125,240,50,88,.568,43,73,.589,7,15,.467,22,32,.688,129,46,88,.523,32,52,.615,14,36,.389,19,23,.826,125
71,MIN,2017-01-28,129,,BRK,W 129-109,240,47,93,.505,38,73,.521,9,20,.450,26,32,.813,129,41,85,.482,34,64,.531,7,21,.333,20,25,.800,109
72,HOU,2017-01-08,129,@,TOR,W 129-122,240,46,89,.517,35,51,.686,11,38,.289,26,31,.839,129,42,78,.538,31,53,.585,11,25,.440,27,30,.900,122
73,HOU,2016-12-31,129,,NYK,W 129-122,240,42,92,.457,21,37,.568,21,55,.382,24,29,.828,129,47,105,.448,37,73,.507,10,32,.313,18,25,.720,122
74,DEN,2016-11-25,129,,OKC,L 129-132 (OT),265,48,101,.475,36,67,.537,12,34,.353,21,27,.778,129,48,96,.500,35,70,.500,13,26,.500,23,29,.793,132
75,POR,2016-11-20,129,@,BRK,W 129-109,240,49,85,.576,34,49,.694,15,36,.417,16,21,.762,129,37,93,.398,27,58,.466,10,35,.286,25,31,.806,109
76,SAS,2016-10-25,129,@,GSW,W 129-100,240,47,98,.480,35,74,.473,12,24,.500,23,26,.885,129,40,85,.471,33,52,.635,7,33,.212,13,18,.722,100
77,SAC,2017-04-09,128,,HOU,L 128-135,240,47,94,.500,38,63,.603,9,31,.290,25,30,.833,128,45,80,.563,27,37,.730,18,43,.419,27,31,.871,135
78,NOP,2017-03-17,128,,HOU,W 128-112,240,49,92,.533,37,58,.638,12,34,.353,18,24,.750,128,37,91,.407,24,51,.471,13,40,.325,25,32,.781,112
79,CLE,2017-03-14,128,,DET,W 128-96,240,46,77,.597,27,47,.574,19,30,.633,17,23,.739,128,37,99,.374,33,80,.413,4,19,.211,18,19,.947,96
80,CHI,2017-02-24,128,,PHO,W 128-121 (OT),265,46,98,.469,34,72,.472,12,26,.462,24,31,.774,128,49,93,.527,41,69,.594,8,24,.333,15,25,.600,121
81,HOU,2017-02-07,128,,ORL,W 128-104,240,44,89,.494,28,51,.549,16,38,.421,24,36,.667,128,42,88,.477,36,63,.571,6,25,.240,14,20,.700,104
82,CHI,2017-02-01,128,@,OKC,W 128-100,240,49,81,.605,43,66,.652,6,15,.400,24,30,.800,128,38,100,.380,28,63,.444,10,37,.270,14,17,.824,100
83,BOS,2017-01-27,128,,ORL,W 128-98,240,50,89,.562,34,55,.618,16,34,.471,12,15,.800,128,38,87,.437,29,62,.468,9,25,.360,13,18,.722,98
84,MEM,2017-01-06,128,@,GSW,W 128-119 (OT),265,50,103,.485,37,70,.529,13,33,.394,15,19,.789,128,41,83,.494,33,53,.623,8,30,.267,29,39,.744,119
85,TOR,2016-12-03,128,,ATL,W 128-84,240,53,92,.576,40,68,.588,13,24,.542,9,11,.818,128,35,88,.398,28,60,.467,7,28,.250,7,14,.500,84
86,HOU,2016-12-02,128,@,DEN,W 128-110,240,45,88,.511,28,51,.549,17,37,.459,21,25,.840,128,46,104,.442,37,73,.507,9,31,.290,9,16,.563,110
87,CLE,2016-11-25,128,,DAL,W 128-90,240,43,85,.506,23,42,.548,20,43,.465,22,24,.917,128,37,91,.407,29,56,.518,8,35,.229,8,12,.667,90
88,CLE,2016-11-03,128,,BOS,W 128-122,240,41,84,.488,27,50,.540,14,34,.412,32,37,.865,128,46,96,.479,35,64,.547,11,32,.344,19,22,.864,122
89,CLE,2016-11-01,128,,HOU,W 128-120,240,43,83,.518,27,51,.529,16,32,.500,26,31,.839,128,43,90,.478,26,46,.565,17,44,.386,17,25,.680,120
90,IND,2017-04-08,127,@,ORL,W 127-112,240,51,86,.593,40,64,.625,11,22,.500,14,19,.737,127,41,84,.488,27,54,.500,14,30,.467,16,22,.727,112
91,WAS,2017-03-25,127,@,CLE,W 127-115,240,49,82,.598,41,64,.641,8,18,.444,21,26,.808,127,41,83,.494,29,50,.580,12,33,.364,21,27,.778,115
92,PHO,2017-03-07,127,,WAS,L 127-131,240,44,88,.500,31,61,.508,13,27,.481,26,33,.788,127,41,90,.456,34,72,.472,7,18,.389,42,53,.792,131
93,UTA,2017-02-08,127,@,NOP,W 127-94,240,48,88,.545,34,56,.607,14,32,.438,17,21,.810,127,35,77,.455,30,53,.566,5,24,.208,19,25,.760,94
94,DEN,2017-01-26,127,,PHO,W 127-120,240,44,86,.512,35,63,.556,9,23,.391,30,35,.857,127,48,89,.539,38,65,.585,10,24,.417,14,17,.824,120
95,MIL,2017-01-23,127,,HOU,W 127-114,240,47,80,.588,36,57,.632,11,23,.478,22,27,.815,127,39,77,.506,25,42,.595,14,35,.400,22,28,.786,114
96,POR,2017-01-21,127,@,BOS,W 127-123 (OT),265,43,92,.467,33,67,.493,10,25,.400,31,36,.861,127,42,92,.457,29,57,.509,13,35,.371,26,31,.839,123
97,DEN,2017-01-17,127,@,LAL,W 127-121,240,50,88,.568,39,62,.629,11,26,.423,16,26,.615,127,47,108,.435,36,78,.462,11,30,.367,16,18,.889,121
98,GSW,2017-01-12,127,,DET,W 127-107,240,50,89,.562,35,60,.583,15,29,.517,12,18,.667,127,43,88,.489,37,60,.617,6,28,.214,15,20,.750,107
99,LAL,2017-01-06,127,,MIA,W 127-100,240,48,96,.500,38,68,.559,10,28,.357,21,29,.724,127,38,92,.413,30,60,.500,8,32,.250,16,27,.593,100
100,SAS,2017-01-05,127,@,DEN,W 127-99,240,51,90,.567,39,66,.591,12,24,.500,13,17,.765,127,39,86,.453,32,61,.525,7,25,.280,14,17,.824,99
101,GSW,2017-01-02,127,,DEN,W 127-119,240,50,95,.526,39,70,.557,11,25,.440,16,21,.762,127,48,101,.475,39,66,.591,9,35,.257,14,18,.778,119
102,DEN,2016-12-17,127,,NYK,W 127-114,240,50,90,.556,40,63,.635,10,27,.370,17,29,.586,127,35,80,.438,27,57,.474,8,23,.348,36,39,.923,114
103,GSW,2016-12-01,127,,HOU,L 127-132 (2OT),290,43,104,.413,31,60,.517,12,44,.273,29,37,.784,127,48,108,.444,34,64,.531,14,44,.318,22,30,.733,132
104,BRK,2016-11-29,127,,LAC,W 127-122 (2OT),290,45,104,.433,32,66,.485,13,38,.342,24,36,.667,127,46,109,.422,33,69,.478,13,40,.325,17,22,.773,122
105,GSW,2016-11-16,127,@,TOR,W 127-121,240,44,87,.506,31,51,.608,13,36,.361,26,28,.929,127,37,82,.451,27,57,.474,10,25,.400,37,41,.902,121
106,LAC,2016-11-14,127,,BRK,W 127-95,240,48,90,.533,34,65,.523,14,25,.560,17,21,.810,127,34,77,.442,24,44,.545,10,33,.303,17,22,.773,95
107,GSW,2016-11-01,127,@,POR,W 127-104,240,50,89,.562,40,63,.635,10,26,.385,17,23,.739,127,37,86,.430,23,47,.489,14,39,.359,16,21,.762,104
108,ATL,2017-04-09,126,,CLE,W 126-125 (OT),265,44,94,.468,35,63,.556,9,31,.290,29,37,.784,126,45,98,.459,26,52,.500,19,46,.413,16,20,.800,125
109,BRK,2017-03-23,126,,PHO,W 126-98,240,43,95,.453,35,66,.530,8,29,.276,32,42,.762,126,34,93,.366,27,68,.397,7,25,.280,23,34,.676,98
110,DEN,2017-03-22,126,,CLE,W 126-113,240,51,96,.531,40,70,.571,11,26,.423,13,13,1.000,126,43,85,.506,28,48,.583,15,37,.405,12,14,.857,113
111,POR,2017-03-07,126,@,OKC,W 126-121,240,47,85,.553,36,62,.581,11,23,.478,21,27,.778,126,44,85,.518,34,60,.567,10,25,.400,23,30,.767,121
112,GSW,2017-02-01,126,,CHO,W 126-111,240,47,96,.490,26,48,.542,21,48,.438,11,14,.786,126,39,88,.443,30,57,.526,9,31,.290,24,26,.923,111
113,GSW,2017-01-16,126,,CLE,W 126-91,240,46,91,.505,31,57,.544,15,34,.441,19,24,.792,126,31,88,.352,22,54,.407,9,34,.265,20,27,.741,91
114,SAC,2016-12-20,126,,POR,W 126-121,240,40,72,.556,30,49,.612,10,23,.435,36,43,.837,126,44,86,.512,40,58,.690,4,28,.143,29,40,.725,121
115,CLE,2016-12-07,126,@,NYK,W 126-94,240,39,80,.488,17,40,.425,22,40,.550,26,31,.839,126,35,87,.402,24,56,.429,11,31,.355,13,15,.867,94
116,OKC,2016-11-30,126,,WAS,W 126-115 (OT),265,46,95,.484,34,65,.523,12,30,.400,22,31,.710,126,44,98,.449,34,70,.486,10,28,.357,17,26,.654,115
117,HOU,2016-11-17,126,,POR,W 126-109,240,46,95,.484,32,63,.508,14,32,.438,20,25,.800,126,41,90,.456,31,62,.500,10,28,.357,17,21,.810,109
118,LAL,2016-11-12,126,@,NOP,W 126-99,240,52,94,.553,36,64,.563,16,30,.533,6,7,.857,126,39,90,.433,33,70,.471,6,20,.300,15,19,.789,99
119,LAC,2017-04-10,125,,HOU,W 125-96,240,46,91,.505,36,65,.554,10,26,.385,23,28,.821,125,33,84,.393,24,44,.545,9,40,.225,21,27,.778,96
120,CLE,2017-04-09,125,@,ATL,L 125-126 (OT),265,45,98,.459,26,52,.500,19,46,.413,16,20,.800,125,44,94,.468,35,63,.556,9,31,.290,29,37,.784,126
121,OKC,2017-03-26,125,@,HOU,L 125-137,240,47,94,.500,36,64,.563,11,30,.367,20,28,.714,125,50,79,.633,30,40,.750,20,39,.513,17,21,.810,137
122,DEN,2017-03-24,125,@,IND,W 125-117,240,39,82,.476,32,55,.582,7,27,.259,40,43,.930,125,48,95,.505,35,71,.493,13,24,.542,8,11,.727,117
123,HOU,2017-03-20,125,,DEN,W 125-124,240,45,89,.506,28,51,.549,17,38,.447,18,23,.783,125,44,86,.512,32,57,.561,12,29,.414,24,26,.923,124
124,CLE,2017-03-19,125,@,LAL,W 125-120,240,45,85,.529,32,49,.653,13,36,.361,22,27,.815,125,47,91,.516,36,64,.563,11,27,.407,15,19,.789,120
125,NOP,2017-03-11,125,@,CHO,W 125-122 (OT),265,50,99,.505,36,65,.554,14,34,.412,11,16,.688,125,46,102,.451,33,56,.589,13,46,.283,17,20,.850,122
126,WAS,2017-03-11,125,@,POR,W 125-124 (OT),265,47,90,.522,35,65,.538,12,25,.480,19,28,.679,125,48,94,.511,32,62,.516,16,32,.500,12,16,.750,124
127,MIA,2017-03-01,125,,PHI,W 125-98,240,49,90,.544,36,60,.600,13,30,.433,14,21,.667,125,37,85,.435,31,68,.456,6,17,.353,18,22,.818,98
128,DEN,2017-02-28,125,@,CHI,W 125-107,240,45,80,.563,32,50,.640,13,30,.433,22,24,.917,125,44,96,.458,34,70,.486,10,26,.385,9,10,.900,107
129,BRK,2017-02-15,125,,MIL,L 125-129,240,46,88,.523,32,52,.615,14,36,.389,19,23,.826,125,50,88,.568,43,73,.589,7,15,.467,22,32,.688,129
130,CLE,2017-02-11,125,,DEN,W 125-109,240,46,84,.548,31,54,.574,15,30,.500,18,22,.818,125,39,97,.402,27,60,.450,12,37,.324,19,22,.864,109
131,MIA,2017-02-04,125,,PHI,W 125-102,240,48,82,.585,36,60,.600,12,22,.545,17,23,.739,125,35,84,.417,29,61,.475,6,23,.261,26,31,.839,102
132,CLE,2017-02-01,125,,MIN,W 125-97,240,48,89,.539,33,52,.635,15,37,.405,14,22,.636,125,41,94,.436,34,73,.466,7,21,.333,8,10,.800,97
133,GSW,2017-01-20,125,@,HOU,W 125-108,240,47,89,.528,32,51,.627,15,38,.395,16,21,.762,125,43,96,.448,36,61,.590,7,35,.200,15,18,.833,108
134,DEN,2017-01-16,125,,ORL,W 125-112,240,52,89,.584,43,62,.694,9,27,.333,12,15,.800,125,45,88,.511,37,63,.587,8,25,.320,14,18,.778,112
135,DET,2017-01-08,125,@,POR,W 125-124 (2OT),290,54,105,.514,46,80,.575,8,25,.320,9,12,.750,125,51,98,.520,36,63,.571,15,35,.429,7,12,.583,124
136,GSW,2017-01-04,125,,POR,W 125-117,240,44,87,.506,31,51,.608,13,36,.361,24,29,.828,125,40,89,.449,28,63,.444,12,26,.462,25,28,.893,117
137,HOU,2016-12-21,125,@,PHO,W 125-111,240,46,86,.535,28,48,.583,18,38,.474,15,26,.577,125,44,93,.473,35,68,.515,9,25,.360,14,20,.700,111
138,ATL,2016-12-16,125,@,TOR,W 125-121,240,46,86,.535,35,61,.574,11,25,.440,22,32,.688,125,47,86,.547,37,65,.569,10,21,.476,17,26,.654,121
139,MIN,2016-12-03,125,@,CHO,W 125-120 (OT),265,48,106,.453,38,79,.481,10,27,.370,19,22,.864,125,44,101,.436,30,65,.462,14,36,.389,18,26,.692,120
140,POR,2016-11-23,125,@,CLE,L 125-137,240,47,90,.522,34,61,.557,13,29,.448,18,19,.947,125,48,90,.533,27,54,.500,21,36,.583,20,27,.741,137
141,LAL,2016-11-15,125,,BRK,W 125-118,240,41,92,.446,32,64,.500,9,28,.321,34,43,.791,125,45,99,.455,33,58,.569,12,41,.293,16,20,.800,118
142,MIN,2016-11-13,125,,LAL,W 125-99,240,42,80,.525,29,53,.547,13,27,.481,28,42,.667,125,33,71,.465,25,47,.532,8,24,.333,25,30,.833,99
143,GSW,2016-11-10,125,@,DEN,W 125-101,240,46,85,.541,32,55,.582,14,30,.467,19,20,.950,125,38,94,.404,25,58,.431,13,36,.361,12,17,.706,101
144,MIL,2016-11-03,125,,IND,W 125-107,240,47,82,.573,35,55,.636,12,27,.444,19,24,.792,125,38,81,.469,28,58,.483,10,23,.435,21,27,.778,107
145,MIA,2017-04-10,124,,CLE,W 124-121 (OT),265,44,95,.463,32,62,.516,12,33,.364,24,34,.706,124,44,89,.494,30,54,.556,14,35,.400,19,22,.864,121
146,PHO,2017-04-09,124,,DAL,W 124-111,240,44,80,.550,36,61,.590,8,19,.421,28,32,.875,124,41,97,.423,25,52,.481,16,45,.356,13,19,.684,111
147,LAC,2017-03-30,124,@,PHO,W 124-118,240,44,80,.550,32,58,.552,12,22,.545,24,34,.706,124,49,92,.533,42,69,.609,7,23,.304,13,24,.542,118
148,WAS,2017-03-29,124,@,LAC,L 124-133,240,46,93,.495,33,59,.559,13,34,.382,19,29,.655,124,47,83,.566,35,53,.660,12,30,.400,27,37,.730,133
149,DEN,2017-03-20,124,@,HOU,L 124-125,240,44,86,.512,32,57,.561,12,29,.414,24,26,.923,124,45,89,.506,28,51,.549,17,38,.447,18,23,.783,125
150,POR,2017-03-11,124,,WAS,L 124-125 (OT),265,48,94,.511,32,62,.516,16,32,.500,12,16,.750,124,47,90,.522,35,65,.538,12,25,.480,19,28,.679,125
151,LAC,2017-02-26,124,,CHO,W 124-121 (OT),265,45,97,.464,35,65,.538,10,32,.313,24,34,.706,124,38,80,.475,20,40,.500,18,40,.450,27,30,.900,121
152,LAC,2017-02-01,124,@,PHO,W 124-114,240,44,85,.518,39,66,.591,5,19,.263,31,38,.816,124,39,96,.406,32,76,.421,7,20,.350,29,35,.829,114
153,CLE,2017-01-27,124,,BRK,W 124-116,240,49,92,.533,36,56,.643,13,36,.361,13,20,.650,124,43,87,.494,27,54,.500,16,33,.485,14,16,.875,116
154,NOP,2017-01-23,124,,CLE,W 124-122,240,43,87,.494,27,48,.563,16,39,.410,22,30,.733,124,43,93,.462,28,56,.500,15,37,.405,21,25,.840,122
155,POR,2017-01-08,124,,DET,L 124-125 (2OT),290,51,98,.520,36,63,.571,15,35,.429,7,12,.583,124,54,105,.514,46,80,.575,8,25,.320,9,12,.750,125
156,PHI,2016-12-30,124,@,DEN,W 124-122,240,38,87,.437,22,54,.407,16,33,.485,32,40,.800,124,39,84,.464,28,57,.491,11,27,.407,33,41,.805,122
157,CLE,2016-12-29,124,,BOS,W 124-118,240,43,83,.518,29,45,.644,14,38,.368,24,33,.727,124,43,85,.506,31,48,.646,12,37,.324,20,21,.952,118
158,TOR,2016-12-08,124,,MIN,W 124-110,240,43,87,.494,31,60,.517,12,27,.444,26,33,.788,124,45,88,.511,36,60,.600,9,28,.321,11,15,.733,110
159,ORL,2016-12-06,124,@,WAS,W 124-116,240,43,83,.518,31,57,.544,12,26,.462,26,36,.722,124,44,93,.473,33,70,.471,11,23,.478,17,24,.708,116
160,LAC,2016-11-23,124,@,DAL,W 124-104,240,43,85,.506,28,53,.528,15,32,.469,23,31,.742,124,38,84,.452,27,60,.450,11,24,.458,17,18,.944,104
161,GSW,2016-11-19,124,@,MIL,W 124-121,240,42,95,.442,28,57,.491,14,38,.368,26,32,.813,124,46,89,.517,36,69,.522,10,20,.500,19,25,.760,121
162,OKC,2016-11-18,124,,BRK,W 124-105,240,49,89,.551,42,63,.667,7,26,.269,19,24,.792,124,35,83,.422,24,54,.444,11,29,.379,24,30,.800,105
163,POR,2016-11-08,124,,PHO,W 124-121,240,45,81,.556,31,50,.620,14,31,.452,20,28,.714,124,43,86,.500,36,65,.554,7,21,.333,28,33,.848,121
164,HOU,2017-04-12,123,,MIN,W 123-118,240,45,97,.464,26,41,.634,19,56,.339,14,22,.636,123,48,91,.527,37,68,.544,11,23,.478,11,15,.733,118
165,GSW,2017-04-08,123,,NOP,W 123-101,240,49,96,.510,39,63,.619,10,33,.303,15,16,.938,123,42,86,.488,37,65,.569,5,21,.238,12,19,.632,101
166,ATL,2017-04-06,123,,BOS,W 123-116,240,44,89,.494,33,66,.500,11,23,.478,24,34,.706,123,37,90,.411,22,47,.468,15,43,.349,27,34,.794,116
167,HOU,2017-04-02,123,@,PHO,W 123-116,240,47,100,.470,33,62,.532,14,38,.368,15,23,.652,123,42,100,.420,34,66,.515,8,34,.235,24,29,.828,116
168,SAC,2017-04-01,123,@,MIN,W 123-117,240,44,78,.564,33,59,.559,11,19,.579,24,33,.727,123,39,87,.448,30,60,.500,9,27,.333,30,38,.789,117
169,NOP,2017-03-19,123,,MIN,W 123-109,240,49,90,.544,35,60,.583,14,30,.467,11,15,.733,123,44,86,.512,35,61,.574,9,25,.360,12,17,.706,109
170,MIA,2017-03-17,123,,MIN,W 123-105,240,50,85,.588,42,59,.712,8,26,.308,15,19,.789,123,41,82,.500,39,70,.557,2,12,.167,21,22,.955,105
171,OKC,2017-03-16,123,@,TOR,W 123-102,240,47,88,.534,33,63,.524,14,25,.560,15,19,.789,123,37,81,.457,32,61,.525,5,20,.250,23,30,.767,102
172,WAS,2017-03-08,123,@,DEN,W 123-113,240,50,88,.568,39,62,.629,11,26,.423,12,19,.632,123,46,87,.529,33,59,.559,13,28,.464,8,17,.471,113
173,HOU,2017-03-04,123,,MEM,W 123-108,240,39,78,.500,21,36,.583,18,42,.429,27,36,.750,123,43,97,.443,35,69,.507,8,28,.286,14,21,.667,108
174,GSW,2017-02-23,123,,LAC,W 123-113,240,43,81,.531,30,56,.536,13,25,.520,24,26,.923,123,38,93,.409,27,65,.415,11,28,.393,26,37,.703,113
175,NYK,2017-02-10,123,,DEN,L 123-131,240,52,93,.559,36,55,.655,16,38,.421,3,5,.600,123,54,95,.568,38,63,.603,16,32,.500,7,10,.700,131
176,GSW,2017-02-08,123,,CHI,W 123-92,240,48,85,.565,33,57,.579,15,28,.536,12,13,.923,123,37,92,.402,33,68,.485,4,24,.167,14,19,.737,92
177,DEN,2017-01-28,123,@,PHO,W 123-112,240,39,80,.488,31,55,.564,8,25,.320,37,42,.881,123,41,91,.451,35,70,.500,6,21,.286,24,32,.750,112
178,HOU,2017-01-27,123,@,PHI,W 123-118,240,42,81,.519,30,50,.600,12,31,.387,27,28,.964,123,42,78,.538,32,53,.604,10,25,.400,24,32,.750,118
179,WAS,2017-01-24,123,,BOS,W 123-108,240,48,84,.571,39,64,.609,9,20,.450,18,21,.857,123,38,84,.452,28,51,.549,10,33,.303,22,24,.917,108
180,DEN,2017-01-21,123,,LAC,W 123-98,240,46,87,.529,36,63,.571,10,24,.417,21,26,.808,123,40,96,.417,30,64,.469,10,32,.313,8,8,1.000,98
181,BOS,2017-01-21,123,,POR,L 123-127 (OT),265,42,92,.457,29,57,.509,13,35,.371,26,31,.839,123,43,92,.467,33,67,.493,10,25,.400,31,36,.861,127
182,CHI,2017-01-07,123,,TOR,W 123-118 (OT),265,38,97,.392,27,69,.391,11,28,.393,36,39,.923,123,37,85,.435,29,54,.537,8,31,.258,36,43,.837,118
183,IND,2017-01-07,123,,NYK,W 123-109,240,43,86,.500,32,62,.516,11,24,.458,26,28,.929,123,40,87,.460,28,56,.500,12,31,.387,17,24,.708,109
184,CHO,2017-01-04,123,,OKC,W 123-112,240,37,80,.463,28,56,.500,9,24,.375,40,49,.816,123,42,96,.438,33,66,.500,9,30,.300,19,23,.826,112
185,TOR,2017-01-01,123,@,LAL,W 123-114,240,42,75,.560,32,58,.552,10,17,.588,29,32,.906,123,37,92,.402,22,60,.367,15,32,.469,25,31,.806,114
186,HOU,2016-12-27,123,@,DAL,W 123-107,240,41,78,.526,24,46,.522,17,32,.531,24,28,.857,123,36,87,.414,21,49,.429,15,38,.395,20,25,.800,107
187,PHO,2016-12-23,123,,PHI,W 123-116,240,42,79,.532,30,53,.566,12,26,.462,27,37,.730,123,42,83,.506,29,52,.558,13,31,.419,19,22,.864,116
188,MIL,2016-12-23,123,,WAS,W 123-96,240,45,80,.563,36,55,.655,9,25,.360,24,27,.889,123,37,79,.468,30,55,.545,7,24,.292,15,18,.833,96
189,TOR,2016-12-14,123,@,PHI,W 123-114,240,41,87,.471,31,58,.534,10,29,.345,31,36,.861,123,43,86,.500,34,57,.596,9,29,.310,19,25,.760,114
190,LAC,2016-11-21,123,,TOR,W 123-115,240,39,74,.527,29,49,.592,10,25,.400,35,42,.833,123,40,80,.500,32,61,.525,8,19,.421,27,32,.844,115
191,MIN,2016-11-09,123,@,ORL,W 123-107,240,45,87,.517,32,64,.500,13,23,.565,20,26,.769,123,38,85,.447,30,61,.492,8,24,.333,23,30,.767,107
192,DEN,2016-11-06,123,@,BOS,W 123-107,240,44,84,.524,33,61,.541,11,23,.478,24,31,.774,123,41,90,.456,33,65,.508,8,25,.320,17,21,.810,107
193,LAL,2016-11-02,123,@,ATL,W 123-116,240,48,90,.533,39,68,.574,9,22,.409,18,20,.900,123,41,85,.482,30,53,.566,11,32,.344,23,29,.793,116
194,CHI,2017-04-10,122,,ORL,W 122-75,240,48,89,.539,36,63,.571,12,26,.462,14,16,.875,122,29,84,.345,24,57,.421,5,27,.185,12,16,.750,75
195,DEN,2017-04-07,122,,NOP,W 122-106,240,43,78,.551,30,46,.652,13,32,.406,23,32,.719,122,47,99,.475,44,76,.579,3,23,.130,9,13,.692,106
196,CLE,2017-04-04,122,,ORL,W 122-102,240,44,82,.537,26,46,.565,18,36,.500,16,21,.762,122,33,86,.384,22,53,.415,11,33,.333,25,26,.962,102
197,CLE,2017-03-31,122,,PHI,W 122-105,240,50,95,.526,37,66,.561,13,29,.448,9,16,.563,122,40,82,.488,29,49,.592,11,33,.333,14,19,.737,105
198,CHO,2017-03-31,122,,DEN,W 122-114,240,40,86,.465,23,50,.460,17,36,.472,25,30,.833,122,45,90,.500,29,57,.509,16,33,.485,8,11,.727,114
199,POR,2017-03-28,122,,DEN,W 122-113,240,45,91,.495,37,64,.578,8,27,.296,24,33,.727,122,44,94,.468,35,64,.547,9,30,.300,16,20,.800,113
200,OKC,2017-03-22,122,,PHI,W 122-97,240,48,88,.545,44,72,.611,4,16,.250,22,30,.733,122,37,87,.425,29,62,.468,8,25,.320,15,17,.882,97
201,TOR,2017-03-21,122,,CHI,W 122-120 (OT),265,47,95,.495,39,72,.542,8,23,.348,20,27,.741,122,42,90,.467,28,53,.528,14,37,.378,22,27,.815,120
202,GSW,2017-03-16,122,,ORL,W 122-92,240,50,87,.575,40,61,.656,10,26,.385,12,23,.522,122,35,94,.372,28,67,.418,7,27,.259,15,21,.714,92
203,OKC,2017-03-14,122,@,BRK,W 122-104,240,44,89,.494,34,67,.507,10,22,.455,24,34,.706,122,33,71,.465,21,47,.447,12,24,.500,26,30,.867,104
204,CHO,2017-03-11,122,,NOP,L 122-125 (OT),265,46,102,.451,33,56,.589,13,46,.283,17,20,.850,122,50,99,.505,36,65,.554,14,34,.412,11,16,.688,125
205,SAC,2017-03-10,122,,WAS,L 122-130 (OT),265,44,92,.478,32,69,.464,12,23,.522,22,28,.786,122,52,104,.500,43,78,.551,9,26,.346,17,19,.895,130
206,LAL,2017-03-09,122,@,PHO,W 122-110,240,47,98,.480,35,71,.493,12,27,.444,16,24,.667,122,42,91,.462,36,72,.500,6,19,.316,20,25,.800,110
207,DAL,2017-03-07,122,,LAL,W 122-111,240,45,83,.542,28,52,.538,17,31,.548,15,19,.789,122,42,90,.467,31,60,.517,11,30,.367,16,22,.727,111
208,BRK,2017-03-06,122,@,MEM,W 122-109,240,39,73,.534,25,43,.581,14,30,.467,30,38,.789,122,34,77,.442,24,52,.462,10,25,.400,31,39,.795,109
209,HOU,2017-03-01,122,@,LAC,W 122-103,240,37,87,.425,17,35,.486,20,52,.385,28,33,.848,122,42,94,.447,30,60,.500,12,34,.353,7,13,.538,103
210,LAL,2017-02-10,122,@,MIL,W 122-114,240,39,75,.520,24,44,.545,15,31,.484,29,35,.829,122,40,76,.526,32,48,.667,8,28,.286,26,31,.839,114
211,GSW,2017-02-10,122,@,MEM,W 122-107,240,39,77,.506,24,44,.545,15,33,.455,29,38,.763,122,34,87,.391,25,61,.410,9,26,.346,30,37,.811,107
212,NOP,2017-02-10,122,@,MIN,W 122-106,240,45,75,.600,33,50,.660,12,25,.480,20,27,.741,122,38,82,.463,32,55,.582,6,27,.222,24,32,.750,106
213,PHI,2017-01-30,122,,SAC,W 122-119,240,45,83,.542,34,52,.654,11,31,.355,21,26,.808,122,41,74,.554,28,45,.622,13,29,.448,24,29,.828,119
214,CLE,2017-01-23,122,@,NOP,L 122-124,240,43,93,.462,28,56,.500,15,37,.405,21,25,.840,122,43,87,.494,27,48,.563,16,39,.410,22,30,.733,124
215,DAL,2017-01-22,122,,LAL,W 122-73,240,43,87,.494,26,48,.542,17,39,.436,19,19,1.000,122,28,73,.384,25,52,.481,3,21,.143,14,17,.824,73
216,SAS,2017-01-17,122,,MIN,W 122-114,240,43,84,.512,35,66,.530,8,18,.444,28,35,.800,122,36,73,.493,30,60,.500,6,13,.462,36,41,.878,114
217,OKC,2017-01-15,122,@,SAC,W 122-118,240,40,90,.444,31,62,.500,9,28,.321,33,41,.805,122,37,81,.457,28,56,.500,9,25,.360,35,40,.875,118
218,TOR,2017-01-08,122,,HOU,L 122-129,240,42,78,.538,31,53,.585,11,25,.440,27,30,.900,122,46,89,.517,35,51,.686,11,38,.289,26,31,.839,129
219,NYK,2016-12-31,122,@,HOU,L 122-129,240,47,105,.448,37,73,.507,10,32,.313,18,25,.720,122,42,92,.457,21,37,.568,21,55,.382,24,29,.828,129
220,DEN,2016-12-30,122,,PHI,L 122-124,240,39,84,.464,28,57,.491,11,27,.407,33,41,.805,122,38,87,.437,22,54,.407,16,33,.485,32,40,.800,124
221,WAS,2016-12-16,122,,DET,W 122-108,240,44,77,.571,32,52,.615,12,25,.480,22,27,.815,122,42,86,.488,32,58,.552,10,28,.357,14,21,.667,108
222,HOU,2016-12-16,122,,NOP,W 122-100,240,42,94,.447,18,33,.545,24,61,.393,14,19,.737,122,40,98,.408,31,71,.437,9,27,.333,11,20,.550,100
223,TOR,2016-12-12,122,,MIL,W 122-100,240,42,81,.519,28,56,.500,14,25,.560,24,28,.857,122,42,89,.472,38,65,.585,4,24,.167,12,17,.706,100
224,HOU,2016-12-12,122,,BRK,W 122-118,240,42,91,.462,25,48,.521,17,43,.395,21,36,.583,122,42,80,.525,35,60,.583,7,20,.350,27,36,.750,118
225,LAC,2016-11-29,122,@,BRK,L 122-127 (2OT),290,46,109,.422,33,69,.478,13,40,.325,17,22,.773,122,45,104,.433,32,66,.485,13,38,.342,24,36,.667,127
226,TOR,2016-11-28,122,,PHI,W 122-95,240,42,77,.545,29,58,.500,13,19,.684,25,31,.806,122,36,86,.419,22,52,.423,14,34,.412,9,13,.692,95
227,SAC,2016-11-27,122,@,BRK,W 122-105,240,46,86,.535,33,63,.524,13,23,.565,17,22,.773,122,38,87,.437,22,47,.468,16,40,.400,13,14,.929,105
228,BRK,2016-11-12,122,@,PHO,W 122-104,240,40,84,.476,24,47,.511,16,37,.432,26,30,.867,122,40,107,.374,32,74,.432,8,33,.242,16,21,.762,104
229,POR,2016-11-11,122,,SAC,W 122-120 (OT),265,45,86,.523,32,53,.604,13,33,.394,19,27,.704,122,43,88,.489,37,67,.552,6,21,.286,28,35,.800,120
230,IND,2016-11-09,122,,PHI,W 122-115 (OT),265,49,90,.544,40,71,.563,9,19,.474,15,20,.750,122,46,95,.484,32,59,.542,14,36,.389,9,19,.474,115
231,CHO,2016-11-07,122,,IND,W 122-100,240,41,84,.488,29,52,.558,12,32,.375,28,32,.875,122,40,94,.426,31,61,.508,9,33,.273,11,15,.733,100
232,BOS,2016-11-03,122,@,CLE,L 122-128,240,46,96,.479,35,64,.547,11,32,.344,19,22,.864,122,41,84,.488,27,50,.540,14,34,.412,32,37,.865,128
233,GSW,2016-11-03,122,,OKC,W 122-96,240,46,89,.517,32,59,.542,14,30,.467,16,20,.800,122,35,87,.402,25,60,.417,10,27,.370,16,28,.571,96
234,GSW,2016-10-28,122,@,NOP,W 122-114,240,44,91,.484,35,63,.556,9,28,.321,25,28,.893,122,47,100,.470,42,78,.538,5,22,.227,15,23,.652,114
235,BOS,2016-10-26,122,,BRK,W 122-117,240,48,89,.539,37,57,.649,11,32,.344,15,18,.833,122,43,97,.443,28,53,.528,15,44,.341,16,20,.800,117
236,CLE,2017-04-10,121,@,MIA,L 121-124 (OT),265,44,89,.494,30,54,.556,14,35,.400,19,22,.864,121,44,95,.463,32,62,.516,12,33,.364,24,34,.706,124
237,BOS,2017-04-08,121,@,CHO,W 121-114,240,45,87,.517,28,48,.583,17,39,.436,14,17,.824,121,38,84,.452,29,56,.518,9,28,.321,29,32,.906,114
238,GSW,2017-04-04,121,,MIN,W 121-107,240,44,84,.524,30,52,.577,14,32,.438,19,24,.792,121,41,96,.427,37,77,.481,4,19,.211,21,26,.808,107
239,BRK,2017-04-01,121,,ORL,W 121-111,240,50,94,.532,42,63,.667,8,31,.258,13,16,.813,121,45,91,.495,35,66,.530,10,25,.400,11,15,.733,111
240,NOP,2017-03-29,121,,DAL,W 121-118,240,42,84,.500,30,54,.556,12,30,.400,25,33,.758,121,44,91,.484,30,64,.469,14,27,.519,16,17,.941,118
241,BRK,2017-03-16,121,@,NYK,W 121-110,240,41,86,.477,31,54,.574,10,32,.313,29,35,.829,121,41,88,.466,38,70,.543,3,18,.167,25,26,.962,110
242,CHO,2017-03-10,121,,ORL,W 121-81,240,47,79,.595,37,58,.638,10,21,.476,17,20,.850,121,31,76,.408,26,49,.531,5,27,.185,14,22,.636,81
243,OKC,2017-03-07,121,,POR,L 121-126,240,44,85,.518,34,60,.567,10,25,.400,23,30,.767,121,47,85,.553,36,62,.581,11,23,.478,21,27,.778,126
244,CHO,2017-02-26,121,@,LAC,L 121-124 (OT),265,38,80,.475,20,40,.500,18,40,.450,27,30,.900,121,45,97,.464,35,65,.538,10,32,.313,24,34,.706,124
245,PHO,2017-02-24,121,@,CHI,L 121-128 (OT),265,49,93,.527,41,69,.594,8,24,.333,15,25,.600,121,46,98,.469,34,72,.472,12,26,.462,24,31,.774,128
246,DET,2017-02-08,121,,LAL,W 121-102,240,51,97,.526,47,81,.580,4,16,.250,15,24,.625,121,37,86,.430,31,63,.492,6,23,.261,22,26,.846,102
247,LAL,2017-02-06,121,@,NYK,W 121-107,240,44,102,.431,36,74,.486,8,28,.286,25,31,.806,121,37,82,.451,30,61,.492,7,21,.333,26,33,.788,107
248,SAS,2017-02-04,121,,DEN,W 121-97,240,45,79,.570,35,58,.603,10,21,.476,21,26,.808,121,41,92,.446,31,66,.470,10,26,.385,5,10,.500,97
249,HOU,2017-02-03,121,,CHI,W 121-117 (OT),265,44,98,.449,28,55,.509,16,43,.372,17,25,.680,121,48,100,.480,40,75,.533,8,25,.320,13,18,.722,117
250,DEN,2017-02-03,121,,MIL,W 121-117,240,40,89,.449,31,61,.508,9,28,.321,32,44,.727,121,45,83,.542,36,59,.610,9,24,.375,18,23,.783,117
251,CHI,2017-01-29,121,,PHI,W 121-108,240,45,89,.506,37,75,.493,8,14,.571,23,28,.821,121,44,99,.444,34,71,.479,10,28,.357,10,14,.714,108
252,PHI,2017-01-24,121,,LAC,W 121-110,240,45,90,.500,35,61,.574,10,29,.345,21,22,.955,121,33,71,.465,15,37,.405,18,34,.529,26,41,.634,110
253,GSW,2017-01-18,121,,OKC,W 121-100,240,46,85,.541,36,64,.563,10,21,.476,19,27,.704,121,38,90,.422,30,62,.484,8,28,.286,16,19,.842,100
254,LAL,2017-01-17,121,,DEN,L 121-127,240,47,108,.435,36,78,.462,11,30,.367,16,18,.889,121,50,88,.568,39,62,.629,11,26,.423,16,26,.615,127
255,HOU,2017-01-10,121,,CHO,W 121-114,240,40,82,.488,23,43,.535,17,39,.436,24,33,.727,121,44,92,.478,25,49,.510,19,43,.442,7,9,.778,114
256,OKC,2017-01-07,121,,DEN,W 121-106,240,43,89,.483,31,53,.585,12,36,.333,23,29,.793,121,40,99,.404,31,75,.413,9,24,.375,17,24,.708,106
257,IND,2017-01-05,121,,BRK,W 121-109,240,48,93,.516,38,71,.535,10,22,.455,15,19,.789,121,41,90,.456,24,52,.462,17,38,.447,10,13,.769,109
258,IND,2017-01-03,121,@,DET,W 121-116,240,43,74,.581,34,58,.586,9,16,.563,26,30,.867,121,48,97,.495,38,68,.559,10,29,.345,10,12,.833,116
259,CLE,2016-12-31,121,@,CHO,W 121-109,240,43,85,.506,29,54,.537,14,31,.452,21,25,.840,121,40,78,.513,31,54,.574,9,24,.375,20,23,.870,109
260,GSW,2016-12-28,121,,TOR,W 121-111,240,46,81,.568,32,58,.552,14,23,.609,15,18,.833,121,40,103,.388,27,68,.397,13,35,.371,18,22,.818,111
261,OKC,2016-12-21,121,@,NOP,W 121-110,240,45,88,.511,34,60,.567,11,28,.393,20,24,.833,121,42,88,.477,34,68,.500,8,20,.400,18,23,.783,110
262,POR,2016-12-20,121,@,SAC,L 121-126,240,44,86,.512,40,58,.690,4,28,.143,29,40,.725,121,40,72,.556,30,49,.612,10,23,.435,36,43,.837,126
263,TOR,2016-12-16,121,,ATL,L 121-125,240,47,86,.547,37,65,.569,10,21,.476,17,26,.654,121,46,86,.535,35,61,.574,11,25,.440,22,32,.688,125
264,LAC,2016-12-12,121,,POR,W 121-120,240,42,89,.472,31,66,.470,11,23,.478,26,28,.929,121,44,87,.506,34,66,.515,10,21,.476,22,25,.880,120
265,DEN,2016-12-10,121,@,ORL,W 121-113,240,47,83,.566,39,64,.609,8,19,.421,19,25,.760,121,43,88,.489,32,61,.525,11,27,.407,16,24,.667,113
266,DET,2016-12-02,121,@,ATL,W 121-85,240,48,89,.539,31,60,.517,17,29,.586,8,12,.667,121,32,88,.364,26,64,.406,6,24,.250,15,20,.750,85
267,DET,2016-11-30,121,@,BOS,W 121-114,240,48,87,.552,39,67,.582,9,20,.450,16,21,.762,121,40,91,.440,25,49,.510,15,42,.357,19,20,.950,114
268,NOP,2016-11-19,121,,CHO,W 121-116 (OT),265,43,98,.439,29,62,.468,14,36,.389,21,25,.840,121,40,97,.412,25,54,.463,15,43,.349,21,28,.750,116
269,MIL,2016-11-19,121,,GSW,L 121-124,240,46,89,.517,36,69,.522,10,20,.500,19,25,.760,121,42,95,.442,28,57,.491,14,38,.368,26,32,.813,124
270,LAC,2016-11-18,121,@,SAC,W 121-115,240,40,76,.526,27,47,.574,13,29,.448,28,34,.824,121,38,86,.442,28,60,.467,10,26,.385,29,35,.829,115
271,TOR,2016-11-16,121,,GSW,L 121-127,240,37,82,.451,27,57,.474,10,25,.400,37,41,.902,121,44,87,.506,31,51,.608,13,36,.361,26,28,.929,127
272,CLE,2016-11-15,121,,TOR,W 121-117,240,44,83,.530,31,50,.620,13,33,.394,20,28,.714,121,46,96,.479,33,67,.493,13,29,.448,12,18,.667,117
273,PHO,2016-11-08,121,@,POR,L 121-124,240,43,86,.500,36,65,.554,7,21,.333,28,33,.848,121,45,81,.556,31,50,.620,14,31,.452,20,28,.714,124
274,DAL,2016-10-26,121,@,IND,L 121-130 (OT),265,45,104,.433,27,56,.482,18,48,.375,13,18,.722,121,47,93,.505,37,74,.500,10,19,.526,26,34,.765,130
275,IND,2017-04-10,120,@,PHI,W 120-111,240,49,85,.576,44,69,.638,5,16,.313,17,21,.810,120,35,75,.467,22,42,.524,13,33,.394,28,31,.903,111
276,PHO,2017-04-07,120,,OKC,W 120-99,240,43,83,.518,35,65,.538,8,18,.444,26,31,.839,120,34,92,.370,27,62,.435,7,30,.233,24,33,.727,99
277,UTA,2017-04-07,120,,MIN,W 120-113,240,45,75,.600,31,50,.620,14,25,.560,16,22,.727,120,39,79,.494,32,63,.508,7,16,.438,28,28,1.000,113
278,GSW,2017-04-05,120,@,PHO,W 120-111,240,45,89,.506,32,59,.542,13,30,.433,17,24,.708,120,43,103,.417,36,76,.474,7,27,.259,18,26,.692,111
279,CHO,2017-03-26,120,,PHO,W 120-106,240,42,87,.483,28,57,.491,14,30,.467,22,24,.917,120,41,81,.506,35,65,.538,6,16,.375,18,22,.818,106
280,PHO,2017-03-24,120,@,BOS,L 120-130,240,39,86,.453,33,67,.493,6,19,.316,36,49,.735,120,44,94,.468,30,53,.566,14,41,.341,28,35,.800,130
281,CHI,2017-03-21,120,@,TOR,L 120-122 (OT),265,42,90,.467,28,53,.528,14,37,.378,22,27,.815,120,47,95,.495,39,72,.542,8,23,.348,20,27,.741,122
282,LAL,2017-03-19,120,,CLE,L 120-125,240,47,91,.516,36,64,.563,11,27,.407,15,19,.789,120,45,85,.529,32,49,.653,13,36,.361,22,27,.815,125
283,MIA,2017-03-15,120,,NOP,W 120-112,240,44,87,.506,28,52,.538,16,35,.457,16,19,.842,120,42,88,.477,33,66,.500,9,22,.409,19,28,.679,112
284,SAC,2017-03-13,120,,ORL,W 120-115,240,44,82,.537,28,52,.538,16,30,.533,16,21,.762,120,45,98,.459,32,64,.500,13,34,.382,12,12,1.000,115
285,BRK,2017-03-12,120,,NYK,W 120-112,240,40,87,.460,21,49,.429,19,38,.500,21,29,.724,120,39,94,.415,31,71,.437,8,23,.348,26,32,.813,112
286,MIA,2017-03-04,120,,CLE,W 120-92,240,46,88,.523,28,54,.519,18,34,.529,10,12,.833,120,35,73,.479,24,46,.522,11,27,.407,11,18,.611,92
287,PHO,2017-03-02,120,,CHO,W 120-103,240,46,77,.597,39,58,.672,7,19,.368,21,25,.840,120,35,89,.393,25,55,.455,10,34,.294,23,28,.821,103
288,DET,2017-02-28,120,,POR,W 120-113 (OT),265,45,104,.433,38,79,.481,7,25,.280,23,31,.742,120,44,84,.524,34,59,.576,10,25,.400,15,22,.682,113
289,PHI,2017-02-24,120,,WAS,W 120-112,240,43,87,.494,33,58,.569,10,29,.345,24,30,.800,120,38,90,.422,33,66,.500,5,24,.208,31,40,.775,112
290,WAS,2017-02-13,120,,OKC,W 120-98,240,42,73,.575,29,53,.547,13,20,.650,23,28,.821,120,34,96,.354,27,62,.435,7,34,.206,23,30,.767,98
291,BOS,2017-02-09,120,@,POR,W 120-111,240,44,91,.484,34,61,.557,10,30,.333,22,27,.815,120,39,77,.506,30,51,.588,9,26,.346,24,31,.774,111
292,UTA,2017-02-06,120,@,ATL,W 120-95,240,49,80,.613,39,54,.722,10,26,.385,12,18,.667,120,33,74,.446,27,57,.474,6,17,.353,23,32,.719,95
293,LAC,2017-02-02,120,,GSW,L 120-133,240,40,80,.500,30,55,.545,10,25,.400,30,39,.769,120,52,99,.525,38,65,.585,14,34,.412,15,18,.833,133
294,LAL,2017-01-31,120,,DEN,W 120-116,240,47,89,.528,35,63,.556,12,26,.462,14,18,.778,120,41,99,.414,26,72,.361,15,27,.556,19,23,.826,116
295,IND,2017-01-29,120,,HOU,W 120-101,240,47,87,.540,42,66,.636,5,21,.238,21,26,.808,120,34,83,.410,23,44,.523,11,39,.282,22,25,.880,101
296,PHO,2017-01-26,120,@,DEN,L 120-127,240,48,89,.539,38,65,.585,10,24,.417,14,17,.824,120,44,86,.512,35,63,.556,9,23,.391,30,35,.857,127
297,BOS,2017-01-25,120,,HOU,W 120-109,240,47,91,.516,36,59,.610,11,32,.344,15,16,.938,120,36,77,.468,26,46,.565,10,31,.323,27,38,.711,109
298,WAS,2017-01-16,120,,POR,W 120-101,240,42,86,.488,29,63,.460,13,23,.565,23,25,.920,120,37,88,.420,29,62,.468,8,26,.308,19,25,.760,101
299,LAC,2017-01-16,120,,OKC,W 120-98,240,45,82,.549,33,54,.611,12,28,.429,18,22,.818,120,36,85,.424,26,55,.473,10,30,.333,16,19,.842,98
300,CLE,2017-01-13,120,@,SAC,W 120-108,240,44,87,.506,29,50,.580,15,37,.405,17,22,.773,120,42,80,.525,33,55,.600,9,25,.360,15,19,.789,108
301,CLE,2017-01-08,120,@,PHO,W 120-116,240,44,82,.537,29,48,.604,15,34,.441,17,19,.895,120,46,87,.529,37,60,.617,9,27,.333,15,19,.789,116
302,SAC,2017-01-03,120,@,DEN,W 120-113,240,46,88,.523,35,59,.593,11,29,.379,17,18,.944,120,41,82,.500,23,44,.523,18,38,.474,13,13,1.000,113
303,CHO,2016-12-28,120,@,ORL,W 120-101,240,46,84,.548,36,60,.600,10,24,.417,18,19,.947,120,42,86,.488,33,52,.635,9,34,.265,8,10,.800,101
304,BRK,2016-12-26,120,,CHO,W 120-118,240,40,75,.533,25,44,.568,15,31,.484,25,31,.806,120,44,94,.468,36,68,.529,8,26,.308,22,25,.880,118
305,POR,2016-12-15,120,@,DEN,L 120-132,240,41,88,.466,33,65,.508,8,23,.348,30,36,.833,120,43,84,.512,28,53,.528,15,31,.484,31,35,.886,132
306,ATL,2016-12-13,120,,ORL,L 120-131,240,45,89,.506,34,61,.557,11,28,.393,19,21,.905,120,51,87,.586,36,53,.679,15,34,.441,14,20,.700,131
307,POR,2016-12-12,120,@,LAC,L 120-121,240,44,87,.506,34,66,.515,10,21,.476,22,25,.880,120,42,89,.472,31,66,.470,11,23,.478,26,28,.929,121
308,NOP,2016-12-11,120,@,PHO,W 120-119 (OT),265,38,97,.392,22,57,.386,16,40,.400,28,35,.800,120,44,96,.458,30,55,.545,14,41,.341,17,26,.654,119
309,SAC,2016-12-07,120,@,DAL,W 120-89,240,47,84,.560,37,62,.597,10,22,.455,16,21,.762,120,32,78,.410,22,48,.458,10,30,.333,15,20,.750,89
310,CHO,2016-12-03,120,,MIN,L 120-125 (OT),265,44,101,.436,30,65,.462,14,36,.389,18,26,.692,120,48,106,.453,38,79,.481,10,27,.370,19,22,.864,125
311,TOR,2016-11-30,120,,MEM,W 120-105,240,38,69,.551,22,37,.595,16,32,.500,28,33,.848,120,36,82,.439,25,55,.455,11,27,.407,22,26,.846,105
312,UTA,2016-11-29,120,,HOU,W 120-101,240,41,74,.554,26,46,.565,15,28,.536,23,27,.852,120,37,91,.407,26,61,.426,11,30,.367,16,22,.727,101
313,DEN,2016-11-27,120,@,PHO,W 120-114,240,39,89,.438,26,60,.433,13,29,.448,29,32,.906,120,36,89,.404,25,64,.391,11,25,.440,31,36,.861,114
314,GSW,2016-11-21,120,@,IND,W 120-83,240,40,90,.444,27,54,.500,13,36,.361,27,32,.844,120,33,103,.320,27,80,.338,6,23,.261,11,12,.917,83
315,PHI,2016-11-19,120,,PHO,W 120-105,240,45,86,.523,28,51,.549,17,35,.486,13,20,.650,120,39,92,.424,33,71,.465,6,21,.286,21,34,.618,105
316,DEN,2016-11-16,120,,PHO,W 120-104,240,45,93,.484,37,76,.487,8,17,.471,22,24,.917,120,39,79,.494,31,59,.525,8,20,.400,18,29,.621,104
317,PHO,2016-11-13,120,@,GSW,L 120-133,240,46,90,.511,38,66,.576,8,24,.333,20,26,.769,120,45,87,.517,29,54,.537,16,33,.485,27,31,.871,133
318,SAC,2016-11-11,120,@,POR,L 120-122 (OT),265,43,88,.489,37,67,.552,6,21,.286,28,35,.800,120,45,86,.523,32,53,.604,13,33,.394,19,27,.704,122
319,HOU,2016-11-01,120,@,CLE,L 120-128,240,43,90,.478,26,46,.565,17,44,.386,17,25,.680,120,43,83,.518,27,51,.529,16,32,.500,26,31,.839,128
320,LAL,2016-10-26,120,,HOU,W 120-114,240,45,89,.506,33,54,.611,12,35,.343,18,22,.818,120,44,86,.512,37,57,.649,7,29,.241,19,27,.704,114
321,MIN,2017-03-30,119,,LAL,W 119-104,240,43,89,.483,33,68,.485,10,21,.476,23,30,.767,119,40,84,.476,31,57,.544,9,27,.333,15,16,.938,104
322,WAS,2017-03-28,119,@,LAL,W 119-108,240,48,94,.511,42,71,.592,6,23,.261,17,25,.680,119,43,85,.506,35,63,.556,8,22,.364,14,16,.875,108
323,MIN,2017-03-24,119,@,LAL,L 119-130 (OT),265,46,95,.484,39,74,.527,7,21,.333,20,22,.909,119,46,88,.523,32,65,.492,14,23,.609,24,28,.857,130
324,MIN,2017-03-13,119,,WAS,W 119-104,240,45,86,.523,35,65,.538,10,21,.476,19,22,.864,119,36,84,.429,29,58,.500,7,26,.269,25,31,.806,104
325,DEN,2017-03-10,119,,BOS,W 119-99,240,45,85,.529,33,54,.611,12,31,.387,17,22,.773,119,34,81,.420,22,48,.458,12,33,.364,19,23,.826,99
326,GSW,2017-03-06,119,@,ATL,W 119-111,240,41,87,.471,21,43,.488,20,44,.455,17,22,.773,119,38,82,.463,25,54,.463,13,28,.464,22,31,.710,111
327,GSW,2017-02-27,119,@,PHI,W 119-108,240,40,89,.449,34,60,.567,6,29,.207,33,39,.846,119,37,82,.451,27,48,.563,10,34,.294,24,27,.889,108
328,SAS,2017-02-26,119,@,LAL,W 119-98,240,49,94,.521,39,73,.534,10,21,.476,11,13,.846,119,40,87,.460,33,65,.508,7,22,.318,11,18,.611,98
329,CLE,2017-02-23,119,,NYK,W 119-104,240,46,87,.529,31,49,.633,15,38,.395,12,15,.800,119,42,101,.416,34,75,.453,8,26,.308,12,17,.706,104
330,LAC,2017-02-08,119,@,NYK,W 119-115,240,45,92,.489,35,67,.522,10,25,.400,19,28,.679,119,46,92,.500,38,65,.585,8,27,.296,15,18,.833,115
331,MEM,2017-02-01,119,@,DEN,W 119-99,240,45,92,.489,31,62,.500,14,30,.467,15,20,.750,119,32,80,.400,23,55,.418,9,25,.360,26,35,.743,99
332,SAC,2017-01-30,119,@,PHI,L 119-122,240,41,74,.554,28,45,.622,13,29,.448,24,29,.828,119,45,83,.542,34,52,.654,11,31,.355,21,26,.808,122
333,NOP,2017-01-27,119,,SAS,W 119-103,240,48,93,.516,35,63,.556,13,30,.433,10,14,.714,119,33,85,.388,21,57,.368,12,28,.429,25,29,.862,103
334,ATL,2017-01-25,119,@,CHI,W 119-114,240,43,83,.518,26,53,.491,17,30,.567,16,19,.842,119,43,94,.457,35,67,.522,8,27,.296,20,26,.769,114
335,HOU,2017-01-21,119,@,MEM,W 119-95,240,41,80,.513,25,38,.658,16,42,.381,21,25,.840,119,33,89,.371,24,55,.436,9,34,.265,20,28,.714,95
336,TOR,2017-01-17,119,@,BRK,W 119-109,240,48,92,.522,38,73,.521,10,19,.526,13,16,.813,119,40,89,.449,33,63,.524,7,26,.269,22,24,.917,109
337,MIN,2017-01-11,119,,HOU,W 119-105,240,44,81,.543,36,58,.621,8,23,.348,23,25,.920,119,36,87,.414,21,45,.467,15,42,.357,18,22,.818,105
338,GSW,2017-01-06,119,,MEM,L 119-128 (OT),265,41,83,.494,33,53,.623,8,30,.267,29,39,.744,119,50,103,.485,37,70,.529,13,33,.394,15,19,.789,128
339,DEN,2017-01-02,119,@,GSW,L 119-127,240,48,101,.475,39,66,.591,9,35,.257,14,18,.778,119,50,95,.526,39,70,.557,11,25,.440,16,21,.762,127
340,MIL,2016-12-28,119,@,DET,W 119-94,240,48,84,.571,37,62,.597,11,22,.500,12,16,.750,119,39,88,.443,33,64,.516,6,24,.250,10,16,.625,94
341,SAS,2016-12-28,119,,PHO,W 119-98,240,47,87,.540,42,70,.600,5,17,.294,20,25,.800,119,36,74,.486,29,58,.500,7,16,.438,19,24,.792,98
342,SAS,2016-12-25,119,,CHI,W 119-100,240,48,85,.565,39,67,.582,9,18,.500,14,19,.737,119,39,86,.453,32,68,.471,7,18,.389,15,20,.750,100
343,BOS,2016-12-25,119,@,NYK,W 119-114,240,45,93,.484,31,57,.544,14,36,.389,15,20,.750,119,41,87,.471,33,64,.516,8,23,.348,24,27,.889,114
344,GSW,2016-12-23,119,@,DET,W 119-113,240,43,77,.558,32,50,.640,11,27,.407,22,24,.917,119,43,85,.506,33,56,.589,10,29,.345,17,28,.607,113
345,CLE,2016-12-23,119,,BRK,W 119-99,240,45,99,.455,37,64,.578,8,35,.229,21,24,.875,119,38,85,.447,30,55,.545,8,30,.267,15,18,.833,99
346,LAC,2016-12-20,119,,DEN,W 119-102,240,47,86,.547,31,50,.620,16,36,.444,9,13,.692,119,39,90,.433,28,51,.549,11,39,.282,13,20,.650,102
347,CLE,2016-12-17,119,,LAL,W 119-108,240,46,89,.517,31,56,.554,15,33,.455,12,18,.667,119,41,86,.477,25,49,.510,16,37,.432,10,13,.769,108
348,PHO,2016-12-11,119,,NOP,L 119-120 (OT),265,44,96,.458,30,55,.545,14,41,.341,17,26,.654,119,38,97,.392,22,57,.386,16,40,.400,28,35,.800,120
349,PHO,2016-12-09,119,@,LAL,W 119-115,240,45,95,.474,32,65,.492,13,30,.433,16,21,.762,119,40,87,.460,31,61,.508,9,26,.346,26,34,.765,115
350,POR,2016-11-25,119,,NOP,W 119-104,240,47,100,.470,35,68,.515,12,32,.375,13,17,.765,119,36,76,.474,23,53,.434,13,23,.565,19,29,.655,104
351,SAS,2016-11-23,119,@,CHO,W 119-114,240,44,86,.512,31,55,.564,13,31,.419,18,20,.900,119,45,89,.506,34,69,.493,11,20,.550,13,18,.722,114
352,WAS,2016-11-17,119,,NYK,W 119-112,240,44,81,.543,29,56,.518,15,25,.600,16,18,.889,119,41,86,.477,29,57,.509,12,29,.414,18,20,.900,112
353,ORL,2016-11-13,119,@,OKC,W 119-117,240,46,86,.535,35,62,.565,11,24,.458,16,20,.800,119,47,92,.511,40,67,.597,7,25,.280,16,26,.615,117
354,LAC,2016-11-12,119,@,MIN,W 119-105,240,40,76,.526,29,52,.558,11,24,.458,28,37,.757,119,40,89,.449,32,67,.478,8,22,.364,17,21,.810,105
355,BRK,2016-11-08,119,,MIN,W 119-110,240,42,76,.553,30,43,.698,12,33,.364,23,26,.885,119,39,92,.424,27,64,.422,12,28,.429,20,28,.714,110
356,LAL,2016-11-06,119,,PHO,W 119-108,240,41,90,.456,31,67,.463,10,23,.435,27,35,.771,119,40,91,.440,34,71,.479,6,20,.300,22,28,.786,108
357,MIN,2017-04-12,118,@,HOU,L 118-123,240,48,91,.527,37,68,.544,11,23,.478,11,15,.733,118,45,97,.464,26,41,.634,19,56,.339,14,22,.636,123
358,WAS,2017-04-04,118,,CHO,W 118-111,240,43,85,.506,26,51,.510,17,34,.500,15,18,.833,118,40,79,.506,28,45,.622,12,34,.353,19,22,.864,111
359,PHI,2017-04-04,118,,BRK,L 118-141,240,43,97,.443,31,59,.525,12,38,.316,20,27,.741,118,48,75,.640,32,44,.727,16,31,.516,29,33,.879,141
360,PHO,2017-03-30,118,,LAC,L 118-124,240,49,92,.533,42,69,.609,7,23,.304,13,24,.542,118,44,80,.550,32,58,.552,12,22,.545,24,34,.706,124
361,DAL,2017-03-29,118,@,NOP,L 118-121,240,44,91,.484,30,64,.469,14,27,.519,16,17,.941,118,42,84,.500,30,54,.556,12,30,.400,25,33,.758,121
362,MIL,2017-03-28,118,@,CHO,W 118-108,240,46,74,.622,32,44,.727,14,30,.467,12,17,.706,118,39,80,.488,32,52,.615,7,28,.250,23,29,.793,108
363,SAS,2017-03-19,118,,SAC,W 118-102,240,43,87,.494,32,59,.542,11,28,.393,21,27,.778,118,41,83,.494,34,73,.466,7,10,.700,13,17,.765,102
364,PHI,2017-03-12,118,@,LAL,W 118-116,240,41,79,.519,31,55,.564,10,24,.417,26,32,.813,118,44,88,.500,40,68,.588,4,20,.200,24,28,.857,116
365,PHO,2017-03-03,118,,OKC,W 118-111,240,44,89,.494,39,68,.574,5,21,.238,25,31,.806,118,37,87,.425,28,52,.538,9,35,.257,28,35,.800,111
366,OKC,2017-02-26,118,,NOP,W 118-110,240,42,88,.477,36,67,.537,6,21,.286,28,37,.757,118,36,80,.450,28,59,.475,8,21,.381,30,37,.811,110
367,OKC,2017-02-09,118,,CLE,W 118-109,240,50,106,.472,42,79,.532,8,27,.296,10,13,.769,118,38,79,.481,28,58,.483,10,21,.476,23,30,.767,109
368,TOR,2017-02-06,118,,LAC,W 118-109,240,41,84,.488,31,60,.517,10,24,.417,26,29,.897,118,42,90,.467,29,55,.527,13,35,.371,12,18,.667,109
369,DET,2017-02-01,118,,NOP,W 118-98,240,48,88,.545,38,62,.613,10,26,.385,12,17,.706,118,41,82,.500,36,61,.590,5,21,.238,11,14,.786,98
370,PHI,2017-01-27,118,,HOU,L 118-123,240,42,78,.538,32,53,.604,10,25,.400,24,32,.750,118,42,81,.519,30,50,.600,12,31,.387,27,28,.964,123
371,GSW,2017-01-22,118,@,ORL,W 118-98,240,42,89,.472,23,47,.489,19,42,.452,15,19,.789,118,42,96,.438,35,68,.515,7,28,.250,7,16,.438,98
372,SAS,2017-01-21,118,@,CLE,W 118-115 (OT),265,48,96,.500,38,70,.543,10,26,.385,12,14,.857,118,45,91,.495,32,57,.561,13,34,.382,12,22,.545,115
373,CLE,2017-01-19,118,,PHO,W 118-103,240,43,85,.506,24,43,.558,19,42,.452,13,19,.684,118,37,85,.435,33,66,.500,4,19,.211,25,31,.806,103
374,SAS,2017-01-19,118,,DEN,W 118-104,240,44,86,.512,35,64,.547,9,22,.409,21,25,.840,118,37,91,.407,27,60,.450,10,31,.323,20,26,.769,104
375,DET,2017-01-18,118,,ATL,W 118-95,240,45,91,.495,35,66,.530,10,25,.400,18,28,.643,118,30,78,.385,24,53,.453,6,25,.240,29,37,.784,95
376,NOP,2017-01-18,118,,ORL,W 118-98,240,46,93,.495,31,57,.544,15,36,.417,11,15,.733,118,39,88,.443,28,56,.500,11,32,.344,9,11,.818,98
377,SAC,2017-01-15,118,,OKC,L 118-122,240,37,81,.457,28,56,.500,9,25,.360,35,40,.875,118,40,90,.444,31,62,.500,9,28,.321,33,41,.805,122
378,TOR,2017-01-07,118,@,CHI,L 118-123 (OT),265,37,85,.435,29,54,.537,8,31,.258,36,43,.837,118,38,97,.392,27,69,.391,11,28,.393,36,39,.923,123
379,POR,2017-01-05,118,,LAL,W 118-109,240,43,81,.531,31,48,.646,12,33,.364,20,30,.667,118,36,86,.419,26,55,.473,10,31,.323,27,33,.818,109
380,HOU,2017-01-05,118,,OKC,W 118-116,240,41,86,.477,26,47,.553,15,39,.385,21,30,.700,118,41,91,.451,29,61,.475,12,30,.400,22,27,.815,116
381,CHI,2017-01-02,118,,CHO,W 118-111,240,42,90,.467,35,67,.522,7,23,.304,27,29,.931,118,41,83,.494,32,64,.500,9,19,.474,20,22,.909,111
382,WAS,2016-12-30,118,,BRK,W 118-95,240,47,83,.566,36,61,.590,11,22,.500,13,14,.929,118,32,74,.432,22,49,.449,10,25,.400,21,25,.840,95
383,BOS,2016-12-29,118,@,CLE,L 118-124,240,43,85,.506,31,48,.646,12,37,.324,20,21,.952,118,43,83,.518,29,45,.644,14,38,.368,24,33,.727,124
384,CHO,2016-12-26,118,@,BRK,L 118-120,240,44,94,.468,36,68,.529,8,26,.308,22,25,.880,118,40,75,.533,25,44,.568,15,31,.484,25,31,.806,120
385,NYK,2016-12-20,118,,IND,W 118-111,240,44,88,.500,31,65,.477,13,23,.565,17,21,.810,118,39,91,.429,33,68,.485,6,23,.261,27,33,.818,111
386,ORL,2016-12-16,118,,BRK,W 118-111,240,39,97,.402,32,68,.471,7,29,.241,33,42,.786,118,39,83,.470,28,56,.500,11,27,.407,22,26,.846,111
387,BRK,2016-12-12,118,@,HOU,L 118-122,240,42,80,.525,35,60,.583,7,20,.350,27,36,.750,118,42,91,.462,25,48,.521,17,43,.395,21,36,.583,122
388,NYK,2016-12-11,118,@,LAL,W 118-112,240,41,84,.488,31,62,.500,10,22,.455,26,31,.839,118,42,88,.477,32,60,.533,10,28,.357,18,22,.818,112
389,IND,2016-12-10,118,,POR,W 118-111,240,40,83,.482,25,54,.463,15,29,.517,23,28,.821,118,40,82,.488,24,45,.533,16,37,.432,15,16,.938,111
390,WAS,2016-12-05,118,@,BRK,W 118-113,240,45,92,.489,31,58,.534,14,34,.412,14,18,.778,118,40,81,.494,29,54,.537,11,27,.407,22,30,.733,113
391,NYK,2016-12-02,118,,MIN,W 118-114,240,41,86,.477,29,55,.527,12,31,.387,24,30,.800,118,41,88,.466,31,60,.517,10,28,.357,22,24,.917,114
392,MIL,2016-11-29,118,,CLE,W 118-101,240,46,86,.535,39,67,.582,7,19,.368,19,23,.826,118,32,75,.427,18,36,.500,14,39,.359,23,31,.742,101
393,IND,2016-11-25,118,,BRK,W 118-97,240,48,87,.552,37,61,.607,11,26,.423,11,16,.688,118,36,79,.456,25,45,.556,11,34,.324,14,23,.609,97
394,CHI,2016-11-20,118,@,LAL,W 118-110,240,45,87,.517,37,65,.569,8,22,.364,20,28,.714,118,41,93,.441,28,62,.452,13,31,.419,15,21,.714,110
395,BRK,2016-11-15,118,@,LAL,L 118-125,240,45,99,.455,33,58,.569,12,41,.293,16,20,.800,118,41,92,.446,32,64,.500,9,28,.321,34,43,.791,125
396,TOR,2016-11-12,118,,NYK,W 118-107,240,39,83,.470,32,61,.525,7,22,.318,33,38,.868,118,44,97,.454,37,74,.500,7,23,.304,12,16,.750,107
397,WAS,2016-11-09,118,,BOS,W 118-93,240,46,92,.500,36,71,.507,10,21,.476,16,20,.800,118,35,81,.432,25,50,.500,10,31,.323,13,22,.591,93
398,PHO,2016-11-02,118,,POR,W 118-115 (OT),265,44,103,.427,39,87,.448,5,16,.313,25,30,.833,118,42,101,.416,30,68,.441,12,33,.364,19,21,.905,115
399,HOU,2016-11-02,118,@,NYK,W 118-99,240,42,89,.472,27,49,.551,15,40,.375,19,27,.704,118,37,85,.435,29,65,.446,8,20,.400,17,25,.680,99
400,CHI,2016-10-31,118,@,BRK,W 118-88,240,45,89,.506,34,62,.548,11,27,.407,17,18,.944,118,33,96,.344,28,65,.431,5,31,.161,17,21,.810,88
401,CHI,2016-10-29,118,,IND,W 118-101,240,45,86,.523,36,65,.554,9,21,.429,19,21,.905,118,43,88,.489,36,70,.514,7,18,.389,8,9,.889,101
402,CHI,2017-04-02,117,@,NOP,W 117-110,240,45,92,.489,32,66,.485,13,26,.500,14,18,.778,117,33,81,.407,23,51,.451,10,30,.333,34,35,.971,110
403,PHO,2017-04-01,117,@,POR,L 117-130,240,44,84,.524,41,74,.554,3,10,.300,26,32,.813,117,43,92,.467,28,55,.509,15,37,.405,29,31,.935,130
404,MIN,2017-04-01,117,,SAC,L 117-123,240,39,87,.448,30,60,.500,9,27,.333,30,38,.789,117,44,78,.564,33,59,.559,11,19,.579,24,33,.727,123
405,NOP,2017-03-31,117,,SAC,W 117-89,240,46,95,.484,36,62,.581,10,33,.303,15,19,.789,117,35,90,.389,29,70,.414,6,20,.300,13,17,.765,89
406,BOS,2017-03-31,117,,ORL,W 117-116,240,38,84,.452,26,51,.510,12,33,.364,29,34,.853,117,40,98,.408,28,68,.412,12,30,.400,24,25,.960,116
407,POR,2017-03-30,117,,HOU,W 117-107,240,43,90,.478,30,57,.526,13,33,.394,18,22,.818,117,40,91,.440,32,57,.561,8,34,.235,19,23,.826,107
408,HOU,2017-03-24,117,,NOP,W 117-107,240,44,93,.473,30,54,.556,14,39,.359,15,20,.750,117,41,91,.451,27,53,.509,14,38,.368,11,14,.786,107
409,PHI,2017-03-24,117,@,CHI,W 117-107,240,46,83,.554,38,58,.655,8,25,.320,17,23,.739,117,37,91,.407,27,67,.403,10,24,.417,23,31,.742,107
410,IND,2017-03-24,117,,DEN,L 117-125,240,48,95,.505,35,71,.493,13,24,.542,8,11,.727,117,39,82,.476,32,55,.582,7,27,.259,40,43,.930,125
411,CHI,2017-03-22,117,,DET,W 117-95,240,47,80,.588,36,57,.632,11,23,.478,12,19,.632,117,39,88,.443,32,68,.471,7,20,.350,10,17,.588,95
412,GSW,2017-03-18,117,,MIL,W 117-92,240,45,75,.600,33,52,.635,12,23,.522,15,19,.789,117,36,89,.404,27,62,.435,9,27,.333,11,14,.786,92
413,BOS,2017-03-15,117,,MIN,W 117-104,240,43,79,.544,30,46,.652,13,33,.394,18,21,.857,117,40,91,.440,32,64,.500,8,27,.296,16,20,.800,104
414,HOU,2017-03-12,117,,CLE,W 117-112,240,41,96,.427,25,51,.490,16,45,.356,19,28,.679,117,42,80,.525,25,37,.676,17,43,.395,11,13,.846,112
415,IND,2017-02-27,117,@,HOU,W 117-108,240,41,91,.451,28,61,.459,13,30,.433,22,25,.880,117,32,88,.364,22,43,.512,10,45,.222,34,42,.810,108
416,CHI,2017-02-25,117,@,CLE,W 117-99,240,46,93,.495,31,63,.492,15,30,.500,10,16,.625,117,37,80,.463,23,43,.535,14,37,.378,11,15,.733,99
417,MIA,2017-02-15,117,@,HOU,W 117-109,240,44,84,.524,31,49,.633,13,35,.371,16,24,.667,117,36,87,.414,23,47,.489,13,40,.325,24,31,.774,109
418,MIN,2017-02-12,117,,CHI,W 117-89,240,44,81,.543,38,57,.667,6,24,.250,23,26,.885,117,35,84,.417,25,59,.424,10,25,.400,9,13,.692,89
419,PHI,2017-02-11,117,,MIA,W 117-109,240,39,86,.453,30,61,.492,9,25,.360,30,38,.789,117,39,85,.459,32,61,.525,7,24,.292,24,28,.857,109
420,ATL,2017-02-08,117,,DEN,W 117-106,240,47,93,.505,39,66,.591,8,27,.296,15,18,.833,117,40,100,.400,27,56,.482,13,44,.295,13,21,.619,106
421,IND,2017-02-08,117,,CLE,L 117-132,240,41,82,.500,28,57,.491,13,25,.520,22,26,.846,117,46,84,.548,30,48,.625,16,36,.444,24,26,.923,132
422,CHI,2017-02-03,117,@,HOU,L 117-121 (OT),265,48,100,.480,40,75,.533,8,25,.320,13,18,.722,117,44,98,.449,28,55,.509,16,43,.372,17,25,.680,121
423,MIL,2017-02-03,117,@,DEN,L 117-121,240,45,83,.542,36,59,.610,9,24,.375,18,23,.783,117,40,89,.449,31,61,.508,9,28,.321,32,44,.727,121
424,WAS,2017-01-31,117,,NYK,W 117-101,240,49,88,.557,42,66,.636,7,22,.318,12,15,.800,117,34,93,.366,29,69,.420,5,24,.208,28,35,.800,101
425,NYK,2017-01-18,117,@,BOS,W 117-106,240,46,91,.505,36,66,.545,10,25,.400,15,18,.833,117,35,91,.385,26,58,.448,9,33,.273,27,29,.931,106
426,BOS,2017-01-11,117,,WAS,W 117-108,240,43,85,.506,26,44,.591,17,41,.415,14,18,.778,117,45,105,.429,35,79,.443,10,26,.385,8,12,.667,108
427,ATL,2017-01-10,117,@,BRK,W 117-97,240,44,92,.478,37,69,.536,7,23,.304,22,38,.579,117,35,87,.402,25,58,.431,10,29,.345,17,23,.739,97
428,GSW,2017-01-08,117,@,SAC,W 117-106,240,45,89,.506,35,60,.583,10,29,.345,17,20,.850,117,36,74,.486,25,46,.543,11,28,.393,23,29,.793,106
429,BOS,2017-01-07,117,,NOP,W 117-108,240,40,93,.430,22,57,.386,18,36,.500,19,21,.905,117,40,85,.471,30,54,.556,10,31,.323,18,23,.783,108
430,POR,2017-01-04,117,@,GSW,L 117-125,240,40,89,.449,28,63,.444,12,26,.462,25,28,.893,117,44,87,.506,31,51,.608,13,36,.361,24,29,.828,125
431,IND,2017-01-01,117,,ORL,W 117-104,240,43,86,.500,34,64,.531,9,22,.409,22,24,.917,117,42,97,.433,32,59,.542,10,38,.263,10,11,.909,104
432,BOS,2016-12-30,117,,MIA,W 117-114,240,38,74,.514,21,42,.500,17,32,.531,24,29,.828,117,48,90,.533,37,62,.597,11,28,.393,7,10,.700,114
433,OKC,2016-12-23,117,@,BOS,W 117-112,240,41,80,.513,30,54,.556,11,26,.423,24,36,.667,117,41,93,.441,32,65,.492,9,28,.321,21,26,.808,112
434,GSW,2016-12-22,117,@,BRK,W 117-101,240,47,104,.452,35,67,.522,12,37,.324,11,14,.786,117,38,86,.442,25,51,.490,13,35,.371,12,16,.750,101
435,CHO,2016-12-20,117,,LAL,W 117-113,240,43,94,.457,32,69,.464,11,25,.440,20,24,.833,117,44,90,.489,28,57,.491,16,33,.485,9,11,.818,113
436,DEN,2016-12-19,117,,DAL,W 117-107,240,45,80,.563,32,55,.582,13,25,.520,14,18,.778,117,43,80,.538,29,55,.527,14,25,.560,7,9,.778,107
437,WAS,2016-12-18,117,,LAC,W 117-110,240,43,81,.531,33,62,.532,10,19,.526,21,30,.700,117,43,87,.494,36,63,.571,7,24,.292,17,24,.708,110
438,DET,2016-12-09,117,@,MIN,W 117-90,240,42,84,.500,28,55,.509,14,29,.483,19,23,.826,117,37,78,.474,34,62,.548,3,16,.188,13,20,.650,90
439,BOS,2016-12-07,117,@,ORL,W 117-87,240,43,84,.512,36,58,.621,7,26,.269,24,29,.828,117,30,81,.370,19,55,.345,11,26,.423,16,24,.667,87
440,HOU,2016-11-25,117,@,SAC,W 117-104,240,40,85,.471,19,35,.543,21,50,.420,16,20,.800,117,39,80,.488,30,48,.625,9,32,.281,17,21,.810,104
441,NOP,2016-11-23,117,,MIN,W 117-96,240,45,83,.542,36,59,.610,9,24,.375,18,23,.783,117,33,86,.384,30,69,.435,3,17,.176,27,33,.818,96
442,TOR,2016-11-15,117,@,CLE,L 117-121,240,46,96,.479,33,67,.493,13,29,.448,12,18,.667,117,44,83,.530,31,50,.620,13,33,.394,20,28,.714,121
443,OKC,2016-11-13,117,,ORL,L 117-119,240,47,92,.511,40,67,.597,7,25,.280,16,26,.615,117,46,86,.535,35,62,.565,11,24,.458,16,20,.800,119
444,ATL,2016-11-12,117,,PHI,W 117-96,240,48,95,.505,35,63,.556,13,32,.406,8,14,.571,117,36,83,.434,25,54,.463,11,29,.379,13,20,.650,96
445,MIL,2016-11-05,117,,SAC,W 117-91,240,41,82,.500,27,49,.551,14,33,.424,21,25,.840,117,33,84,.393,23,56,.411,10,28,.357,15,19,.789,91
446,LAL,2016-11-04,117,,GSW,W 117-97,240,45,95,.474,37,65,.569,8,30,.267,19,21,.905,117,39,86,.453,34,54,.630,5,32,.156,14,20,.700,97
447,NYK,2016-11-04,117,@,CHI,W 117-104,240,46,89,.517,37,68,.544,9,21,.429,16,21,.762,117,37,84,.440,29,61,.475,8,23,.348,22,27,.815,104
448,MIL,2016-11-01,117,@,NOP,W 117-113,240,44,91,.484,34,59,.576,10,32,.313,19,21,.905,117,36,82,.439,27,56,.482,9,26,.346,32,41,.780,113
449,BRK,2016-10-26,117,@,BOS,L 117-122,240,43,97,.443,28,53,.528,15,44,.341,16,20,.800,117,48,89,.539,37,57,.649,11,32,.344,15,18,.833,122
450,CLE,2016-10-25,117,,NYK,W 117-88,240,45,94,.479,32,59,.542,13,35,.371,14,19,.737,117,32,87,.368,23,60,.383,9,27,.333,15,20,.750,88
451,BOS,2017-04-06,116,@,ATL,L 116-123,240,37,90,.411,22,47,.468,15,43,.349,27,34,.794,116,44,89,.494,33,66,.500,11,23,.478,24,34,.706,123
452,DEN,2017-04-02,116,@,MIA,W 116-113,240,44,87,.506,39,67,.582,5,20,.250,23,27,.852,116,42,87,.483,29,60,.483,13,27,.481,16,21,.762,113
453,PHO,2017-04-02,116,,HOU,L 116-123,240,42,100,.420,34,66,.515,8,34,.235,24,29,.828,116,47,100,.470,33,62,.532,14,38,.368,15,23,.652,123
454,ORL,2017-03-31,116,@,BOS,L 116-117,240,40,98,.408,28,68,.412,12,30,.400,24,25,.960,116,38,84,.452,26,51,.510,12,33,.364,29,34,.853,117
455,MIL,2017-03-22,116,@,SAC,W 116-98,240,43,81,.531,27,46,.587,16,35,.457,14,19,.737,116,41,84,.488,31,58,.534,10,26,.385,6,10,.600,98
456,TOR,2017-03-19,116,,IND,W 116-91,240,45,91,.495,33,64,.516,12,27,.444,14,16,.875,116,33,80,.413,27,57,.474,6,23,.261,19,26,.731,91
457,PHI,2017-03-17,116,,DAL,W 116-74,240,42,80,.525,30,51,.588,12,29,.414,20,23,.870,116,30,87,.345,25,64,.391,5,23,.217,9,17,.529,74
458,LAL,2017-03-12,116,,PHI,L 116-118,240,44,88,.500,40,68,.588,4,20,.200,24,28,.857,116,41,79,.519,31,55,.564,10,24,.417,26,32,.813,118
459,CLE,2017-03-11,116,@,ORL,W 116-104,240,43,86,.500,28,47,.596,15,39,.385,15,25,.600,116,38,96,.396,34,75,.453,4,21,.190,24,28,.857,104
460,LAC,2017-03-06,116,,BOS,W 116-102,240,39,73,.534,30,53,.566,9,20,.450,29,47,.617,116,34,83,.410,24,48,.500,10,35,.286,24,29,.828,102
461,BRK,2017-03-04,116,@,POR,L 116-130,240,45,86,.523,31,56,.554,14,30,.467,12,17,.706,116,49,86,.570,33,61,.541,16,25,.640,16,22,.727,130
462,SAC,2017-02-23,116,,DEN,W 116-100,240,46,88,.523,39,74,.527,7,14,.500,17,19,.895,116,39,88,.443,27,53,.509,12,35,.343,10,14,.714,100
463,BOS,2017-02-15,116,,PHI,W 116-108,240,38,80,.475,25,52,.481,13,28,.464,27,36,.750,116,44,93,.473,36,62,.581,8,31,.258,12,18,.667,108
464,OKC,2017-02-15,116,,NYK,W 116-105,240,41,88,.466,29,65,.446,12,23,.522,22,31,.710,116,41,86,.477,30,65,.462,11,21,.524,12,14,.857,105
465,CLE,2017-02-14,116,@,MIN,W 116-108,240,44,86,.512,31,47,.660,13,39,.333,15,22,.682,116,42,86,.488,33,63,.524,9,23,.391,15,19,.789,108
466,ORL,2017-02-13,116,@,MIA,W 116-107,240,44,90,.489,36,76,.474,8,14,.571,20,29,.690,116,39,83,.470,33,61,.541,6,22,.273,23,27,.852,107
467,MIL,2017-02-11,116,@,IND,W 116-100,240,35,73,.479,18,42,.429,17,31,.548,29,37,.784,116,35,73,.479,25,51,.490,10,22,.455,20,24,.833,100
468,DET,2017-02-03,116,,MIN,W 116-108,240,44,98,.449,33,72,.458,11,26,.423,17,22,.773,116,44,89,.494,39,72,.542,5,17,.294,15,19,.789,108
469,WAS,2017-02-02,116,,LAL,W 116-108,240,44,96,.458,32,63,.508,12,33,.364,16,21,.762,116,40,87,.460,28,48,.583,12,39,.308,16,22,.727,108
470,MIA,2017-02-01,116,,ATL,W 116-93,240,45,93,.484,33,61,.541,12,32,.375,14,19,.737,116,34,86,.395,27,60,.450,7,26,.269,18,21,.857,93
471,DEN,2017-01-31,116,@,LAL,L 116-120,240,41,99,.414,26,72,.361,15,27,.556,19,23,.826,116,47,89,.528,35,63,.556,12,26,.462,14,18,.778,120
472,MIA,2017-01-28,116,,DET,W 116-103,240,42,80,.525,28,52,.538,14,28,.500,18,23,.783,116,46,89,.517,42,77,.545,4,12,.333,7,12,.583,103
473,BRK,2017-01-27,116,@,CLE,L 116-124,240,43,87,.494,27,54,.500,16,33,.485,14,16,.875,116,49,92,.533,36,56,.643,13,36,.361,13,20,.650,124
474,SAC,2017-01-25,116,@,CLE,W 116-112 (OT),265,43,95,.453,32,64,.500,11,31,.355,19,22,.864,116,40,82,.488,25,44,.568,15,38,.395,17,34,.500,112
475,TOR,2017-01-15,116,,NYK,W 116-101,240,44,89,.494,36,67,.537,8,22,.364,20,23,.870,116,35,84,.417,23,55,.418,12,29,.414,19,27,.704,101
476,MIL,2017-01-13,116,,MIA,W 116-108,240,40,80,.500,31,65,.477,9,15,.600,27,31,.871,116,41,83,.494,29,51,.569,12,32,.375,14,18,.778,108
477,PHO,2017-01-08,116,,CLE,L 116-120,240,46,87,.529,37,60,.617,9,27,.333,15,19,.789,116,44,82,.537,29,48,.604,15,34,.441,17,19,.895,120
478,NYK,2017-01-06,116,@,MIL,W 116-111,240,41,83,.494,28,60,.467,13,23,.565,21,27,.778,116,39,78,.500,27,56,.482,12,22,.545,21,28,.750,111
479,CLE,2017-01-06,116,@,BRK,W 116-108,240,38,88,.432,29,55,.527,9,33,.273,31,43,.721,116,41,91,.451,32,61,.525,9,30,.300,17,19,.895,108
480,OKC,2017-01-05,116,@,HOU,L 116-118,240,41,91,.451,29,61,.475,12,30,.400,22,27,.815,116,41,86,.477,26,47,.553,15,39,.385,21,30,.700,118
481,LAL,2017-01-03,116,,MEM,W 116-102,240,42,82,.512,25,49,.510,17,33,.515,15,28,.536,116,30,77,.390,20,46,.435,10,31,.323,32,35,.914,102
482,DET,2017-01-03,116,,IND,L 116-121,240,48,97,.495,38,68,.559,10,29,.345,10,12,.833,116,43,74,.581,34,58,.586,9,16,.563,26,30,.867,121
483,MIL,2016-12-31,116,@,CHI,W 116-96,240,43,76,.566,34,61,.557,9,15,.600,21,27,.778,116,33,83,.398,23,56,.411,10,27,.370,20,28,.714,96
484,MIN,2016-12-30,116,,MIL,W 116-99,240,43,77,.558,30,52,.577,13,25,.520,17,21,.810,116,40,74,.541,32,56,.571,8,18,.444,11,17,.647,99
485,LAC,2016-12-30,116,@,HOU,L 116-140,240,45,96,.469,32,63,.508,13,33,.394,13,16,.813,116,45,81,.556,31,41,.756,14,40,.350,36,43,.837,140
486,PHI,2016-12-23,116,@,PHO,L 116-123,240,42,83,.506,29,52,.558,13,31,.419,19,22,.864,116,42,79,.532,30,53,.566,12,26,.462,27,37,.730,123
487,TOR,2016-12-20,116,,BRK,W 116-104,240,42,91,.462,34,73,.466,8,18,.444,24,31,.774,116,36,91,.396,26,56,.464,10,35,.286,22,28,.786,104
488,SAC,2016-12-12,116,,LAL,W 116-92,240,47,84,.560,37,61,.607,10,23,.435,12,21,.571,116,33,84,.393,23,61,.377,10,23,.435,16,21,.762,92
489,GSW,2016-12-11,116,@,MIN,W 116-108,240,38,83,.458,25,51,.490,13,32,.406,27,30,.900,116,36,81,.444,27,57,.474,9,24,.375,27,36,.750,108
490,CLE,2016-12-10,116,,CHO,W 116-105,240,42,73,.575,29,42,.690,13,31,.419,19,28,.679,116,39,86,.453,29,59,.492,10,27,.370,17,24,.708,105
491,BRK,2016-12-07,116,,DEN,W 116-111,240,41,85,.482,32,59,.542,9,26,.346,25,31,.806,116,42,105,.400,31,68,.456,11,37,.297,16,21,.762,111
492,WAS,2016-12-06,116,,ORL,L 116-124,240,44,93,.473,33,70,.471,11,23,.478,17,24,.708,116,43,83,.518,31,57,.544,12,26,.462,26,36,.722,124
493,CLE,2016-12-05,116,@,TOR,W 116-112,240,40,84,.476,26,52,.500,14,32,.438,22,27,.815,116,38,88,.432,25,56,.446,13,32,.406,23,27,.852,112
494,SAC,2016-11-23,116,,OKC,W 116-101,240,44,94,.468,32,66,.485,12,28,.429,16,17,.941,116,32,76,.421,25,51,.490,7,25,.280,30,38,.789,101
495,CHO,2016-11-19,116,@,NOP,L 116-121 (OT),265,40,97,.412,25,54,.463,15,43,.349,21,28,.750,116,43,98,.439,29,62,.468,14,36,.389,21,25,.840,121
496,SAS,2016-11-18,116,@,LAL,W 116-107,240,44,78,.564,34,54,.630,10,24,.417,18,19,.947,116,39,87,.448,27,62,.435,12,25,.480,17,21,.810,107
497,PHO,2016-11-18,116,@,IND,W 116-96,240,46,97,.474,37,71,.521,9,26,.346,15,18,.833,116,36,76,.474,35,69,.507,1,7,.143,23,29,.793,96
498,GSW,2016-11-09,116,,DAL,W 116-95,240,43,74,.581,26,41,.634,17,33,.515,13,22,.591,116,34,86,.395,28,58,.483,6,28,.214,21,28,.750,95
499,GSW,2016-11-07,116,,NOP,W 116-106,240,45,90,.500,29,55,.527,16,35,.457,10,12,.833,116,39,80,.488,32,59,.542,7,21,.333,21,27,.778,106
500,LAC,2016-11-05,116,@,SAS,W 116-92,240,47,91,.516,38,68,.559,9,23,.391,13,14,.929,116,30,74,.405,20,49,.408,10,25,.400,22,25,.880,92
501,ATL,2016-11-02,116,,LAL,L 116-123,240,41,85,.482,30,53,.566,11,32,.344,23,29,.793,116,48,90,.533,39,68,.574,9,22,.409,18,20,.900,123
502,MIN,2016-11-01,116,,MEM,W 116-80,240,43,78,.551,31,58,.534,12,20,.600,18,23,.783,116,27,75,.360,23,51,.451,4,24,.167,22,29,.759,80
503,LAC,2016-10-31,116,,PHO,W 116-98,240,40,80,.500,34,64,.531,6,16,.375,30,38,.789,116,35,84,.417,30,69,.435,5,15,.333,23,31,.742,98
504,LAC,2017-04-12,115,,SAC,W 115-95,240,43,83,.518,33,55,.600,10,28,.357,19,25,.760,115,40,81,.494,35,70,.500,5,11,.455,10,14,.714,95
505,ORL,2017-04-06,115,,BRK,W 115-107,240,42,90,.467,33,65,.508,9,25,.360,22,26,.846,115,40,87,.460,29,57,.509,11,30,.367,16,22,.727,107
506,WAS,2017-04-02,115,@,GSW,L 115-139,240,43,92,.467,33,65,.508,10,27,.370,19,25,.760,115,50,88,.568,34,52,.654,16,36,.444,23,26,.885,139
507,LAC,2017-04-01,115,,LAL,W 115-104,240,38,69,.551,27,44,.614,11,25,.440,28,34,.824,115,39,90,.433,33,67,.493,6,23,.261,20,30,.667,104
508,MIN,2017-03-28,115,@,IND,W 115-114,240,37,78,.474,28,58,.483,9,20,.450,32,37,.865,115,40,81,.494,35,63,.556,5,18,.278,29,35,.829,114
509,NOP,2017-03-26,115,@,DEN,W 115-90,240,48,97,.495,39,70,.557,9,27,.333,10,12,.833,115,36,95,.379,30,70,.429,6,25,.240,12,14,.857,90
510,CLE,2017-03-25,115,,WAS,L 115-127,240,41,83,.494,29,50,.580,12,33,.364,21,27,.778,115,49,82,.598,41,64,.641,8,18,.444,21,26,.808,127
511,ORL,2017-03-24,115,,DET,W 115-87,240,47,91,.516,35,65,.538,12,26,.462,9,13,.692,115,34,96,.354,32,74,.432,2,22,.091,17,20,.850,87
512,POR,2017-03-19,115,@,MIA,W 115-104,240,42,83,.506,29,57,.509,13,26,.500,18,24,.750,115,41,88,.466,32,58,.552,9,30,.300,13,20,.650,104
513,ORL,2017-03-13,115,@,SAC,L 115-120,240,45,98,.459,32,64,.500,13,34,.382,12,12,1.000,115,44,82,.537,28,52,.538,16,30,.533,16,21,.762,120
514,CHI,2017-03-13,115,@,CHO,W 115-109,240,41,92,.446,27,52,.519,14,40,.350,19,22,.864,115,43,93,.462,36,64,.563,7,29,.241,16,19,.842,109
515,HOU,2017-03-10,115,@,CHI,W 115-94,240,37,89,.416,22,42,.524,15,47,.319,26,32,.813,115,38,98,.388,29,59,.492,9,39,.231,9,12,.750,94
516,IND,2017-03-08,115,,DET,W 115-98,240,44,88,.500,33,65,.508,11,23,.478,16,19,.842,115,39,89,.438,32,63,.508,7,26,.269,13,22,.591,98
517,UTA,2017-03-08,115,@,HOU,W 115-108,240,41,76,.539,29,45,.644,12,31,.387,21,24,.875,115,35,79,.443,27,47,.574,8,32,.250,30,40,.750,108
518,WAS,2017-03-05,115,,ORL,W 115-114,240,39,81,.481,25,55,.455,14,26,.538,23,25,.920,115,44,89,.494,30,54,.556,14,35,.400,12,19,.632,114
519,BOS,2017-03-03,115,@,LAL,W 115-95,240,43,84,.512,33,51,.647,10,33,.303,19,25,.760,115,37,87,.425,31,63,.492,6,24,.250,15,20,.750,95
520,PHO,2017-02-10,115,,CHI,W 115-97,240,48,95,.505,40,76,.526,8,19,.421,11,13,.846,115,37,86,.430,32,67,.478,5,19,.263,18,22,.818,97
521,NYK,2017-02-08,115,,LAC,L 115-119,240,46,92,.500,38,65,.585,8,27,.296,15,18,.833,115,45,92,.489,35,67,.522,10,25,.400,19,28,.679,119
522,MIA,2017-02-06,115,@,MIN,W 115-113,240,45,86,.523,30,58,.517,15,28,.536,10,14,.714,115,43,80,.538,38,69,.551,5,11,.455,22,28,.786,113
523,POR,2017-01-31,115,,CHO,W 115-98,240,42,93,.452,31,62,.500,11,31,.355,20,23,.870,115,33,83,.398,22,52,.423,11,31,.355,21,25,.840,98
524,MEM,2017-01-30,115,@,PHO,W 115-96,240,39,80,.488,23,52,.442,16,28,.571,21,24,.875,115,31,74,.419,26,55,.473,5,19,.263,29,39,.744,96
525,IND,2017-01-27,115,,SAC,W 115-111 (OT),265,38,78,.487,28,50,.560,10,28,.357,29,33,.879,115,35,70,.500,22,45,.489,13,25,.520,28,36,.778,111
526,LAC,2017-01-23,115,@,ATL,W 115-105,240,42,84,.500,28,60,.467,14,24,.583,17,22,.773,115,37,88,.420,28,59,.475,9,29,.310,22,26,.846,105
527,PHO,2017-01-22,115,@,TOR,W 115-103,240,40,79,.506,31,57,.544,9,22,.409,26,28,.929,115,33,83,.398,26,56,.464,7,27,.259,30,35,.857,103
528,CLE,2017-01-21,115,,SAS,L 115-118 (OT),265,45,91,.495,32,57,.561,13,34,.382,12,22,.545,115,48,96,.500,38,70,.543,10,26,.385,12,14,.857,118
529,ORL,2017-01-13,115,@,POR,W 115-109,240,41,83,.494,31,65,.477,10,18,.556,23,26,.885,115,39,97,.402,29,63,.460,10,34,.294,21,25,.840,109
530,DET,2017-01-05,115,,CHO,W 115-114,240,39,97,.402,29,69,.420,10,28,.357,27,32,.844,115,37,91,.407,27,65,.415,10,26,.385,30,34,.882,114
531,LAC,2017-01-04,115,,MEM,W 115-106,240,37,73,.507,28,50,.560,9,23,.391,32,45,.711,115,38,88,.432,27,60,.450,11,28,.393,19,25,.760,106
532,BOS,2017-01-03,115,,UTA,W 115-104,240,41,74,.554,24,43,.558,17,31,.548,16,17,.941,115,38,82,.463,27,56,.482,11,26,.423,17,21,.810,104
533,ORL,2017-01-02,115,@,NYK,W 115-103,240,45,91,.495,30,60,.500,15,31,.484,10,14,.714,115,39,83,.470,31,62,.500,8,21,.381,17,24,.708,103
534,PHO,2016-12-26,115,@,HOU,L 115-131,240,43,101,.426,36,71,.507,7,30,.233,22,27,.815,115,46,92,.500,31,49,.633,15,43,.349,24,30,.800,131
535,MEM,2016-12-23,115,,HOU,W 115-109,240,41,81,.506,28,56,.500,13,25,.520,20,25,.800,115,38,89,.427,18,37,.486,20,52,.385,13,15,.867,109
536,MIA,2016-12-22,115,,LAL,W 115-107,240,45,84,.536,34,62,.548,11,22,.500,14,21,.667,115,40,90,.444,26,52,.500,14,38,.368,13,15,.867,107
537,MIN,2016-12-19,115,,PHO,W 115-108,240,42,86,.488,35,67,.522,7,19,.368,24,25,.960,115,37,82,.451,28,61,.459,9,21,.429,25,35,.714,108
538,LAL,2016-12-09,115,,PHO,L 115-119,240,40,87,.460,31,61,.508,9,26,.346,26,34,.765,115,45,95,.474,32,65,.492,13,30,.433,16,21,.762,119
539,GSW,2016-12-07,115,@,LAC,W 115-98,240,42,89,.472,35,58,.603,7,31,.226,24,29,.828,115,36,92,.391,28,66,.424,8,26,.308,18,24,.750,98
540,MIL,2016-12-07,115,,POR,W 115-107,240,40,77,.519,30,53,.566,10,24,.417,25,37,.676,115,37,85,.435,20,45,.444,17,40,.425,16,19,.842,107
541,WAS,2016-11-30,115,@,OKC,L 115-126 (OT),265,44,98,.449,34,70,.486,10,28,.357,17,26,.654,115,46,95,.484,34,65,.523,12,30,.400,22,31,.710,126
542,GSW,2016-11-26,115,,MIN,W 115-102,240,45,81,.556,34,59,.576,11,22,.500,14,17,.824,115,41,89,.461,31,54,.574,10,35,.286,10,12,.833,102
543,TOR,2016-11-23,115,@,HOU,W 115-102,240,43,88,.489,31,65,.477,12,23,.522,17,21,.810,115,38,78,.487,24,36,.667,14,42,.333,12,12,1.000,102
544,TOR,2016-11-21,115,@,LAC,L 115-123,240,40,80,.500,32,61,.525,8,19,.421,27,32,.844,115,39,74,.527,29,49,.592,10,25,.400,35,42,.833,123
545,IND,2016-11-20,115,@,OKC,W 115-111 (OT),265,40,89,.449,29,67,.433,11,22,.500,24,31,.774,115,44,101,.436,34,65,.523,10,36,.278,13,18,.722,111
546,SAC,2016-11-18,115,,LAC,L 115-121,240,38,86,.442,28,60,.467,10,26,.385,29,35,.829,115,40,76,.526,27,47,.574,13,29,.448,28,34,.824,121
547,CHO,2016-11-15,115,@,MIN,W 115-108,240,43,80,.538,32,56,.571,11,24,.458,18,22,.818,115,38,89,.427,23,54,.426,15,35,.429,17,21,.810,108
548,HOU,2016-11-14,115,,PHI,W 115-88,240,44,91,.484,27,51,.529,17,40,.425,10,17,.588,115,34,90,.378,29,68,.426,5,22,.227,15,17,.882,88
549,BOS,2016-11-11,115,,NYK,W 115-87,240,35,90,.389,24,63,.381,11,27,.407,34,43,.791,115,33,94,.351,27,71,.380,6,23,.261,15,17,.882,87
550,PHI,2016-11-09,115,@,IND,L 115-122 (OT),265,46,95,.484,32,59,.542,14,36,.389,9,19,.474,115,49,90,.544,40,71,.563,9,19,.474,15,20,.750,122
551,ATL,2016-11-09,115,,CHI,W 115-107,240,42,83,.506,33,63,.524,9,20,.450,22,27,.815,115,41,91,.451,32,64,.500,9,27,.333,16,21,.762,107
552,POR,2016-11-02,115,@,PHO,L 115-118 (OT),265,42,101,.416,30,68,.441,12,33,.364,19,21,.905,115,44,103,.427,39,87,.448,5,16,.313,25,30,.833,118
553,IND,2016-11-01,115,,LAL,W 115-108,240,41,87,.471,31,59,.525,10,28,.357,23,29,.793,115,40,89,.449,34,61,.557,6,28,.214,22,25,.880,108
554,POR,2016-10-29,115,@,DEN,W 115-113 (OT),265,45,98,.459,35,66,.530,10,32,.313,15,21,.714,115,38,100,.380,32,77,.416,6,23,.261,31,39,.795,113
555,NYK,2017-04-12,114,,PHI,W 114-113,240,41,83,.494,32,61,.525,9,22,.409,23,32,.719,114,46,93,.495,39,70,.557,7,23,.304,14,20,.700,113
556,BOS,2017-04-10,114,,BRK,W 114-105,240,41,91,.451,27,53,.509,14,38,.368,18,21,.857,114,31,86,.360,23,55,.418,8,31,.258,35,39,.897,105
557,CHO,2017-04-08,114,,BOS,L 114-121,240,38,84,.452,29,56,.518,9,28,.321,29,32,.906,114,45,87,.517,28,48,.583,17,39,.436,14,17,.824,121
558,ATL,2017-04-07,114,@,CLE,W 114-100,240,45,89,.506,29,52,.558,16,37,.432,8,8,1.000,114,39,81,.481,30,45,.667,9,36,.250,13,17,.765,100
559,DET,2017-04-07,114,@,HOU,W 114-109,240,46,108,.426,37,82,.451,9,26,.346,13,16,.813,114,36,87,.414,20,36,.556,16,51,.314,21,28,.750,109
560,CLE,2017-04-05,114,@,BOS,W 114-91,240,43,92,.467,32,56,.571,11,36,.306,17,18,.944,114,33,81,.407,26,48,.542,7,33,.212,18,29,.621,91
561,DEN,2017-03-31,114,@,CHO,L 114-122,240,45,90,.500,29,57,.509,16,33,.485,8,11,.727,114,40,86,.465,23,50,.460,17,36,.472,25,30,.833,122
562,OKC,2017-03-29,114,@,ORL,W 114-106 (OT),265,43,102,.422,33,69,.478,10,33,.303,18,28,.643,114,39,97,.402,30,67,.448,9,30,.300,19,27,.704,106
563,IND,2017-03-28,114,,MIN,L 114-115,240,40,81,.494,35,63,.556,5,18,.278,29,35,.829,114,37,78,.474,28,58,.483,9,20,.450,32,37,.865,115
564,GSW,2017-03-24,114,,SAC,W 114-100,240,44,89,.494,34,58,.586,10,31,.323,16,18,.889,114,40,83,.482,30,62,.484,10,21,.476,10,13,.769,100
565,LAC,2017-03-20,114,,NYK,W 114-105,240,43,87,.494,33,56,.589,10,31,.323,18,24,.750,114,40,89,.449,34,65,.523,6,24,.250,19,24,.792,105
566,LAC,2017-03-16,114,@,DEN,L 114-129,240,44,84,.524,28,52,.538,16,32,.500,10,15,.667,114,46,86,.535,31,58,.534,15,28,.536,22,26,.846,129
567,UTA,2017-03-13,114,,LAC,W 114-108,240,41,78,.526,27,57,.474,14,21,.667,18,22,.818,114,39,78,.500,27,48,.563,12,30,.400,18,23,.783,108
568,POR,2017-03-09,114,,PHI,W 114-108 (OT),265,40,88,.455,34,67,.507,6,21,.286,28,33,.848,114,41,94,.436,30,65,.462,11,29,.379,15,20,.750,108
569,LAC,2017-03-09,114,@,MEM,W 114-98,240,40,78,.513,29,48,.604,11,30,.367,23,28,.821,114,37,83,.446,30,63,.476,7,20,.350,17,22,.773,98
570,SAS,2017-03-08,114,,SAC,W 114-104,240,42,84,.500,28,55,.509,14,29,.483,16,21,.762,114,42,86,.488,35,67,.522,7,19,.368,13,16,.813,104
571,ORL,2017-03-05,114,@,WAS,L 114-115,240,44,89,.494,30,54,.556,14,35,.400,12,19,.632,114,39,81,.481,25,55,.455,14,26,.538,23,25,.920,115
572,TOR,2017-03-03,114,@,WAS,W 114-106,240,41,81,.506,30,56,.536,11,25,.440,21,27,.778,114,34,92,.370,24,62,.387,10,30,.333,28,32,.875,106
573,POR,2017-03-02,114,,OKC,W 114-109,240,39,79,.494,29,54,.537,10,25,.400,26,35,.743,114,34,86,.395,23,57,.404,11,29,.379,30,32,.938,109
574,ATL,2017-02-27,114,@,BOS,W 114-98,240,46,95,.484,40,70,.571,6,25,.240,16,20,.800,114,34,87,.391,24,53,.453,10,34,.294,20,25,.800,98
575,DET,2017-02-23,114,,CHO,W 114-108 (OT),265,44,107,.411,29,70,.414,15,37,.405,11,12,.917,114,38,92,.413,31,62,.500,7,30,.233,25,26,.962,108
576,OKC,2017-02-11,114,,GSW,L 114-130,240,40,83,.482,34,59,.576,6,24,.250,28,36,.778,114,46,87,.529,33,56,.589,13,31,.419,25,35,.714,130
577,MIL,2017-02-10,114,,LAL,L 114-122,240,40,76,.526,32,48,.667,8,28,.286,26,31,.839,114,39,75,.520,24,44,.545,15,31,.484,29,35,.829,122
578,WAS,2017-02-08,114,@,BRK,W 114-110 (OT),265,40,97,.412,31,72,.431,9,25,.360,25,33,.758,114,38,91,.418,29,58,.500,9,33,.273,25,36,.694,110
579,POR,2017-02-07,114,@,DAL,W 114-113,240,42,86,.488,31,58,.534,11,28,.393,19,24,.792,114,37,75,.493,25,47,.532,12,28,.429,27,32,.844,113
580,OKC,2017-02-03,114,,MEM,W 114-102,240,38,80,.475,25,54,.463,13,26,.500,25,33,.758,114,40,83,.482,37,64,.578,3,19,.158,19,22,.864,102
581,PHO,2017-02-01,114,,LAC,L 114-124,240,39,96,.406,32,76,.421,7,20,.350,29,35,.829,114,44,85,.518,39,66,.591,5,19,.263,31,38,.816,124
582,ORL,2017-01-29,114,@,TOR,W 114-113,240,42,79,.532,32,56,.571,10,23,.435,20,26,.769,114,36,79,.456,24,51,.471,12,28,.429,29,36,.806,113
583,CHI,2017-01-25,114,,ATL,L 114-119,240,43,94,.457,35,67,.522,8,27,.296,20,26,.769,114,43,83,.518,26,53,.491,17,30,.567,16,19,.842,119
584,PHI,2017-01-25,114,@,MIL,W 114-109,240,40,75,.533,28,49,.571,12,26,.462,22,25,.880,114,42,91,.462,35,63,.556,7,28,.250,18,23,.783,109
585,OKC,2017-01-25,114,@,NOP,W 114-105,240,42,91,.462,32,64,.500,10,27,.370,20,28,.714,114,41,96,.427,30,69,.435,11,27,.407,12,19,.632,105
586,HOU,2017-01-23,114,@,MIL,L 114-127,240,39,77,.506,25,42,.595,14,35,.400,22,28,.786,114,47,80,.588,36,57,.632,11,23,.478,22,27,.815,127
587,NOP,2017-01-20,114,,BRK,L 114-143,240,43,105,.410,32,71,.451,11,34,.324,17,23,.739,114,48,83,.578,33,53,.623,15,30,.500,32,35,.914,143
588,MIN,2017-01-17,114,@,SAS,L 114-122,240,36,73,.493,30,60,.500,6,13,.462,36,41,.878,114,43,84,.512,35,66,.530,8,18,.444,28,35,.800,122
589,UTA,2017-01-14,114,,ORL,W 114-107,240,41,83,.494,34,57,.596,7,26,.269,25,36,.694,114,38,82,.463,26,48,.542,12,34,.353,19,27,.704,107
590,TOR,2017-01-10,114,,BOS,W 114-106,240,41,87,.471,31,65,.477,10,22,.455,22,27,.815,114,40,85,.471,31,58,.534,9,27,.333,17,20,.850,106
591,CHO,2017-01-10,114,@,HOU,L 114-121,240,44,92,.478,25,49,.510,19,43,.442,7,9,.778,114,40,82,.488,23,43,.535,17,39,.436,24,33,.727,121
592,CHO,2017-01-05,114,@,DET,L 114-115,240,37,91,.407,27,65,.415,10,26,.385,30,34,.882,114,39,97,.402,29,69,.420,10,28,.357,27,32,.844,115
593,LAL,2017-01-01,114,,TOR,L 114-123,240,37,92,.402,22,60,.367,15,32,.469,25,31,.806,114,42,75,.560,32,58,.552,10,17,.588,29,32,.906,123
594,ATL,2017-01-01,114,,SAS,W 114-112 (OT),265,42,92,.457,28,64,.438,14,28,.500,16,27,.593,114,42,90,.467,33,63,.524,9,27,.333,19,22,.864,112
595,OKC,2016-12-31,114,,LAC,W 114-88,240,37,78,.474,27,49,.551,10,29,.345,30,35,.857,114,31,75,.413,23,45,.511,8,30,.267,18,21,.857,88
596,MIA,2016-12-30,114,@,BOS,L 114-117,240,48,90,.533,37,62,.597,11,28,.393,7,10,.700,114,38,74,.514,21,42,.500,17,32,.531,24,29,.828,117
597,MEM,2016-12-29,114,,OKC,W 114-80,240,43,82,.524,30,60,.500,13,22,.591,15,20,.750,114,25,74,.338,21,52,.404,4,22,.182,26,38,.684,80
598,NYK,2016-12-25,114,,BOS,L 114-119,240,41,87,.471,33,64,.516,8,23,.348,24,27,.889,114,45,93,.484,31,57,.544,14,36,.389,15,20,.750,119
599,CLE,2016-12-20,114,@,MIL,W 114-108 (OT),265,37,91,.407,20,51,.392,17,40,.425,23,27,.852,114,40,87,.460,33,60,.550,7,27,.259,21,29,.724,108
600,OKC,2016-12-17,114,,PHO,W 114-101,240,41,81,.506,34,65,.523,7,16,.438,25,34,.735,114,39,90,.433,31,68,.456,8,22,.364,15,20,.750,101
601,NYK,2016-12-17,114,@,DEN,L 114-127,240,35,80,.438,27,57,.474,8,23,.348,36,39,.923,114,50,90,.556,40,63,.635,10,27,.370,17,29,.586,127
602,PHI,2016-12-14,114,,TOR,L 114-123,240,43,86,.500,34,57,.596,9,29,.310,19,25,.760,114,41,87,.471,31,58,.534,10,29,.345,31,36,.861,123
603,POR,2016-12-13,114,,OKC,W 114-95,240,43,80,.538,35,57,.614,8,23,.348,20,27,.741,114,33,87,.379,25,60,.417,8,27,.296,21,28,.750,95
604,CLE,2016-12-09,114,,MIA,W 114-84,240,46,83,.554,37,59,.627,9,24,.375,13,19,.684,114,31,90,.344,25,63,.397,6,27,.222,16,21,.762,84
605,ATL,2016-12-09,114,@,MIL,W 114-110,240,40,84,.476,28,50,.560,12,34,.353,22,29,.759,114,44,94,.468,32,66,.485,12,28,.429,10,14,.714,110
606,NYK,2016-12-06,114,@,MIA,W 114-103,240,48,98,.490,41,73,.562,7,25,.280,11,16,.688,114,38,89,.427,27,64,.422,11,25,.440,16,27,.593,103
607,MIN,2016-12-02,114,@,NYK,L 114-118,240,41,88,.466,31,60,.517,10,28,.357,22,24,.917,114,41,86,.477,29,55,.527,12,31,.387,24,30,.800,118
608,LAC,2016-12-02,114,@,NOP,W 114-96,240,45,88,.511,35,64,.547,10,24,.417,14,16,.875,114,39,85,.459,34,65,.523,5,20,.250,13,21,.619,96
609,BOS,2016-11-30,114,,DET,L 114-121,240,40,91,.440,25,49,.510,15,42,.357,19,20,.950,114,48,87,.552,39,67,.582,9,20,.450,16,21,.762,121
610,PHO,2016-11-27,114,,DEN,L 114-120,240,36,89,.404,25,64,.391,11,25,.440,31,36,.861,114,39,89,.438,26,60,.433,13,29,.448,29,32,.906,120
611,POR,2016-11-27,114,,HOU,L 114-130,240,40,83,.482,28,50,.560,12,33,.364,22,29,.759,114,46,82,.561,29,46,.630,17,36,.472,21,28,.750,130
612,CHO,2016-11-23,114,,SAS,L 114-119,240,45,89,.506,34,69,.493,11,20,.550,13,18,.722,114,44,86,.512,31,55,.564,13,31,.419,18,20,.900,119
613,MIA,2016-11-19,114,@,WAS,W 114-111,240,43,85,.506,30,58,.517,13,27,.481,15,26,.577,114,42,89,.472,31,62,.500,11,27,.407,16,22,.727,111
614,HOU,2016-11-07,114,@,WAS,W 114-106,240,41,79,.519,24,42,.571,17,37,.459,15,18,.833,114,39,94,.415,29,67,.433,10,27,.370,18,20,.900,106
615,LAC,2016-11-07,114,,DET,W 114-82,240,41,76,.539,28,51,.549,13,25,.520,19,22,.864,114,30,82,.366,26,70,.371,4,12,.333,18,26,.692,82
616,UTA,2016-11-06,114,@,NYK,W 114-109,240,38,75,.507,30,50,.600,8,25,.320,30,35,.857,114,42,83,.506,34,63,.540,8,20,.400,17,19,.895,109
617,NOP,2016-10-28,114,,GSW,L 114-122,240,47,100,.470,42,78,.538,5,22,.227,15,23,.652,114,44,91,.484,35,63,.556,9,28,.321,25,28,.893,122
618,LAC,2016-10-27,114,@,POR,W 114-106,240,37,91,.407,29,62,.468,8,29,.276,32,46,.696,114,39,85,.459,35,67,.522,4,18,.222,24,32,.750,106
619,ATL,2016-10-27,114,,WAS,W 114-99,240,44,88,.500,32,62,.516,12,26,.462,14,18,.778,114,40,94,.426,34,74,.459,6,20,.300,13,18,.722,99
620,HOU,2016-10-26,114,@,LAL,L 114-120,240,44,86,.512,37,57,.649,7,29,.241,19,27,.704,114,45,89,.506,33,54,.611,12,35,.343,18,22,.818,120
621,ORL,2017-04-12,113,,DET,W 113-109,240,42,87,.483,29,62,.468,13,25,.520,16,17,.941,113,41,106,.387,30,70,.429,11,36,.306,16,28,.571,109
622,PHI,2017-04-12,113,@,NYK,L 113-114,240,46,93,.495,39,70,.557,7,23,.304,14,20,.700,113,41,83,.494,32,61,.525,9,22,.409,23,32,.719,114
623,MIN,2017-04-07,113,@,UTA,L 113-120,240,39,79,.494,32,63,.508,7,16,.438,28,28,1.000,113,45,75,.600,31,50,.620,14,25,.560,16,22,.727,120
624,TOR,2017-04-02,113,,PHI,W 113-105,240,46,85,.541,40,66,.606,6,19,.316,15,19,.789,113,36,80,.450,25,44,.568,11,36,.306,22,25,.880,105
625,MIA,2017-04-02,113,,DEN,L 113-116,240,42,87,.483,29,60,.483,13,27,.481,16,21,.762,113,44,87,.506,39,67,.582,5,20,.250,23,27,.852,116
626,CHO,2017-04-02,113,@,OKC,W 113-101,240,37,77,.481,26,47,.553,11,30,.367,28,32,.875,113,39,84,.464,27,53,.509,12,31,.387,11,12,.917,101
627,DEN,2017-03-28,113,@,POR,L 113-122,240,44,94,.468,35,64,.547,9,30,.300,16,20,.800,113,45,91,.495,37,64,.578,8,27,.296,24,33,.727,122
628,GSW,2017-03-28,113,@,HOU,W 113-106,240,45,88,.511,34,47,.723,11,41,.268,12,16,.750,113,33,85,.388,28,54,.519,5,31,.161,35,39,.897,106
629,CLE,2017-03-22,113,@,DEN,L 113-126,240,43,85,.506,28,48,.583,15,37,.405,12,14,.857,113,51,96,.531,40,70,.571,11,26,.423,13,13,1.000,126
630,POR,2017-03-18,113,@,ATL,W 113-97,240,44,87,.506,36,69,.522,8,18,.444,17,19,.895,113,32,88,.364,25,62,.403,7,26,.269,26,32,.813,97
631,MEM,2017-03-13,113,,MIL,W 113-93,240,41,79,.519,27,52,.519,14,27,.519,17,23,.739,113,31,67,.463,17,41,.415,14,26,.538,17,20,.850,93
632,DEN,2017-03-08,113,,WAS,L 113-123,240,46,87,.529,33,59,.559,13,28,.464,8,17,.471,113,50,88,.568,39,62,.629,11,26,.423,12,19,.632,123
633,NYK,2017-03-06,113,@,ORL,W 113-105,240,40,86,.465,34,72,.472,6,14,.429,27,28,.964,113,40,85,.471,31,53,.585,9,32,.281,16,24,.667,105
634,POR,2017-02-28,113,@,DET,L 113-120 (OT),265,44,84,.524,34,59,.576,10,25,.400,15,22,.682,113,45,104,.433,38,79,.481,7,25,.280,23,31,.742,120
635,MIA,2017-02-25,113,,IND,W 113-95,240,38,78,.487,25,47,.532,13,31,.419,24,31,.774,113,34,85,.400,30,73,.411,4,12,.333,23,26,.885,95
636,LAC,2017-02-23,113,@,GSW,L 113-123,240,38,93,.409,27,65,.415,11,28,.393,26,37,.703,113,43,81,.531,30,56,.536,13,25,.520,24,26,.923,123
637,CLE,2017-02-15,113,,IND,W 113-104,240,39,82,.476,21,43,.488,18,39,.462,17,19,.895,113,40,86,.465,28,62,.452,12,24,.500,12,14,.857,104
638,DAL,2017-02-07,113,,POR,L 113-114,240,37,75,.493,25,47,.532,12,28,.429,27,32,.844,113,42,86,.488,31,58,.534,11,28,.393,19,24,.792,114
639,MIN,2017-02-06,113,,MIA,L 113-115,240,43,80,.538,38,69,.551,5,11,.455,22,28,.786,113,45,86,.523,30,58,.517,15,28,.536,10,14,.714,115
640,DET,2017-02-06,113,,PHI,W 113-96,240,46,99,.465,41,77,.532,5,22,.227,16,17,.941,113,36,85,.424,31,57,.544,5,28,.179,19,28,.679,96
641,ATL,2017-02-04,113,,ORL,W 113-86,240,41,78,.526,31,50,.620,10,28,.357,21,27,.778,113,27,78,.346,20,51,.392,7,27,.259,25,28,.893,86
642,BOS,2017-02-03,113,,LAL,W 113-107,240,39,82,.476,26,47,.553,13,35,.371,22,28,.786,113,37,94,.394,23,56,.411,14,38,.368,19,26,.731,107
643,ATL,2017-02-02,113,@,HOU,W 113-108,240,44,85,.518,36,55,.655,8,30,.267,17,23,.739,113,35,93,.376,22,42,.524,13,51,.255,25,33,.758,108
644,DAL,2017-02-01,113,,PHI,W 113-95,240,40,86,.465,30,60,.500,10,26,.385,23,28,.821,113,35,77,.455,29,55,.527,6,22,.273,19,26,.731,95
645,BOS,2017-01-30,113,,DET,W 113-109,240,36,82,.439,23,50,.460,13,32,.406,28,33,.848,113,43,97,.443,40,70,.571,3,27,.111,20,29,.690,109
646,TOR,2017-01-29,113,,ORL,L 113-114,240,36,79,.456,24,51,.471,12,28,.429,29,36,.806,113,42,79,.532,32,56,.571,10,23,.435,20,26,.769,114
647,GSW,2017-01-29,113,@,POR,W 113-111,240,36,79,.456,28,53,.528,8,26,.308,33,39,.846,113,46,93,.495,36,66,.545,10,27,.370,9,12,.750,111
648,GSW,2017-01-25,113,@,CHO,W 113-103,240,39,82,.476,28,54,.519,11,28,.393,24,27,.889,113,38,92,.413,31,69,.449,7,23,.304,20,21,.952,103
649,DET,2017-01-21,113,,WAS,W 113-112,240,43,87,.494,32,59,.542,11,28,.393,16,22,.727,113,39,91,.429,31,65,.477,8,26,.308,26,33,.788,112
650,CHO,2017-01-20,113,,TOR,W 113-78,240,40,80,.500,28,55,.509,12,25,.480,21,25,.840,113,29,86,.337,22,56,.393,7,30,.233,13,14,.929,78
651,WAS,2017-01-19,113,@,NYK,W 113-110,240,44,88,.500,31,56,.554,13,32,.406,12,14,.857,113,42,90,.467,35,66,.530,7,24,.292,19,22,.864,110
652,PHI,2017-01-16,113,@,MIL,W 113-104,240,35,78,.449,21,41,.512,14,37,.378,29,36,.806,113,42,89,.472,37,75,.493,5,14,.357,15,22,.682,104
653,LAC,2017-01-14,113,,LAL,W 113-97,240,48,92,.522,38,64,.594,10,28,.357,7,8,.875,113,36,80,.450,26,59,.441,10,21,.476,15,27,.556,97
654,BRK,2017-01-13,113,@,TOR,L 113-132,240,40,86,.465,23,50,.460,17,36,.472,16,20,.800,113,52,97,.536,41,69,.594,11,28,.393,17,21,.810,132
655,DAL,2017-01-12,113,@,PHO,W 113-108,240,43,89,.483,28,55,.509,15,34,.441,12,17,.706,113,38,78,.487,28,60,.467,10,18,.556,22,27,.815,108
656,DEN,2017-01-03,113,,SAC,L 113-120,240,41,82,.500,23,44,.523,18,38,.474,13,13,1.000,113,46,88,.523,35,59,.593,11,29,.379,17,18,.944,120
657,DAL,2017-01-03,113,,WAS,W 113-105,240,37,78,.474,20,46,.435,17,32,.531,22,24,.917,113,41,92,.446,30,62,.484,11,30,.367,12,14,.857,105
658,BOS,2016-12-27,113,,MEM,W 113-103,240,41,85,.482,29,54,.537,12,31,.387,19,21,.905,113,37,88,.420,28,58,.483,9,30,.300,20,29,.690,103
659,DET,2016-12-23,113,,GSW,L 113-119,240,43,85,.506,33,56,.589,10,29,.345,17,28,.607,113,43,77,.558,32,50,.640,11,27,.407,22,24,.917,119
660,CLE,2016-12-21,113,,MIL,W 113-102,240,43,87,.494,28,60,.467,15,27,.556,12,19,.632,113,36,77,.468,27,55,.491,9,22,.409,21,29,.724,102
661,LAL,2016-12-20,113,@,CHO,L 113-117,240,44,90,.489,28,57,.491,16,33,.485,9,11,.818,113,43,94,.457,32,69,.464,11,25,.440,20,24,.833,117
662,CHI,2016-12-19,113,,DET,W 113-82,240,49,82,.598,41,66,.621,8,16,.500,7,7,1.000,113,34,83,.410,31,60,.517,3,23,.130,11,13,.846,82
663,SAS,2016-12-18,113,,NOP,W 113-100,240,42,86,.488,31,64,.484,11,22,.500,18,22,.818,113,41,89,.461,31,63,.492,10,26,.385,8,14,.571,100
664,LAC,2016-12-14,113,@,ORL,W 113-108,240,37,74,.500,24,49,.490,13,25,.520,26,37,.703,113,42,89,.472,28,56,.500,14,33,.424,10,20,.500,108
665,PHO,2016-12-13,113,,NYK,W 113-111 (OT),265,38,93,.409,29,63,.460,9,30,.300,28,33,.848,113,38,97,.392,31,77,.403,7,20,.350,28,38,.737,111
666,GSW,2016-12-13,113,@,NOP,W 113-109,240,42,95,.442,28,61,.459,14,34,.412,15,19,.789,113,39,82,.476,25,47,.532,14,35,.400,17,21,.810,109
667,ORL,2016-12-10,113,,DEN,L 113-121,240,43,88,.489,32,61,.525,11,27,.407,16,24,.667,113,47,83,.566,39,64,.609,8,19,.421,19,25,.760,121
668,BRK,2016-12-05,113,,WAS,L 113-118,240,40,81,.494,29,54,.537,11,27,.407,22,30,.733,113,45,92,.489,31,58,.534,14,34,.412,14,18,.778,118
669,TOR,2016-12-02,113,,LAL,W 113-80,240,45,83,.542,33,54,.611,12,29,.414,11,13,.846,113,32,93,.344,26,67,.388,6,26,.231,10,17,.588,80
670,LAC,2016-12-01,113,@,CLE,W 113-94,240,42,89,.472,29,58,.500,13,31,.419,16,24,.667,113,28,69,.406,19,45,.422,9,24,.375,29,39,.744,94
671,NYK,2016-11-25,113,,CHO,W 113-111 (OT),265,45,97,.464,34,69,.493,11,28,.393,12,13,.923,113,43,93,.462,35,64,.547,8,29,.276,17,27,.630,111
672,TOR,2016-11-18,113,@,DEN,W 113-111 (OT),265,43,94,.457,35,71,.493,8,23,.348,19,31,.613,113,39,83,.470,35,58,.603,4,25,.160,29,39,.744,111
673,NOP,2016-11-18,113,,POR,W 113-101,240,45,82,.549,36,58,.621,9,24,.375,14,20,.700,113,33,88,.375,21,54,.389,12,34,.353,23,26,.885,101
674,CHI,2016-11-15,113,@,POR,W 113-88,240,41,98,.418,34,78,.436,7,20,.350,24,28,.857,113,34,95,.358,25,61,.410,9,34,.265,11,18,.611,88
675,TOR,2016-11-11,113,@,CHO,W 113-111,240,43,90,.478,37,68,.544,6,22,.273,21,22,.955,113,38,93,.409,21,52,.404,17,41,.415,18,24,.750,111
676,TOR,2016-11-02,113,@,WAS,W 113-103,240,43,77,.558,33,52,.635,10,25,.400,17,25,.680,113,42,72,.583,39,62,.629,3,10,.300,16,24,.667,103
677,NOP,2016-11-01,113,,MIL,L 113-117,240,36,82,.439,27,56,.482,9,26,.346,32,41,.780,113,44,91,.484,34,59,.576,10,32,.313,19,21,.905,117
678,OKC,2016-10-30,113,,LAL,W 113-96,240,45,95,.474,36,69,.522,9,26,.346,14,17,.824,113,35,87,.402,28,55,.509,7,32,.219,19,24,.792,96
679,DEN,2016-10-29,113,,POR,L 113-115 (OT),265,38,100,.380,32,77,.416,6,23,.261,31,39,.795,113,45,98,.459,35,66,.530,10,32,.313,15,21,.714,115
680,OKC,2016-10-28,113,,PHO,W 113-110 (OT),265,40,96,.417,35,75,.467,5,21,.238,28,38,.737,113,42,94,.447,37,66,.561,5,28,.179,21,32,.656,110
681,SAC,2016-10-26,113,@,PHO,W 113-94,240,44,86,.512,38,65,.585,6,21,.286,19,26,.731,113,36,77,.468,32,61,.525,4,16,.250,18,27,.667,94
682,POR,2016-10-25,113,,UTA,W 113-104,240,39,75,.520,26,56,.464,13,19,.684,22,22,1.000,113,40,82,.488,32,58,.552,8,24,.333,16,16,1.000,104
683,CHI,2017-04-12,112,,BRK,W 112-73,240,41,95,.432,27,65,.415,14,30,.467,16,21,.762,112,28,86,.326,25,53,.472,3,33,.091,14,18,.778,73
684,BOS,2017-04-12,112,,MIL,W 112-94,240,41,91,.451,29,54,.537,12,37,.324,18,26,.692,112,37,84,.440,31,61,.508,6,23,.261,14,17,.824,94
685,ORL,2017-04-08,112,,IND,L 112-127,240,41,84,.488,27,54,.500,14,30,.467,16,22,.727,112,51,86,.593,40,64,.625,11,22,.500,14,19,.737,127
686,MIA,2017-04-05,112,@,CHO,W 112-99,240,40,84,.476,19,44,.432,21,40,.525,11,12,.917,112,35,78,.449,27,53,.509,8,25,.320,21,24,.875,99
687,LAC,2017-04-05,112,,DAL,W 112-101,240,38,75,.507,26,44,.591,12,31,.387,24,31,.774,112,38,86,.442,27,55,.491,11,31,.355,14,18,.778,101
688,UTA,2017-03-29,112,@,SAC,W 112-82,240,42,79,.532,29,48,.604,13,31,.419,15,19,.789,112,34,75,.453,32,60,.533,2,15,.133,12,18,.667,82
689,ORL,2017-03-27,112,@,TOR,L 112-131,240,43,88,.489,39,68,.574,4,20,.200,22,28,.786,112,49,83,.590,39,68,.574,10,15,.667,23,35,.657,131
690,BOS,2017-03-26,112,,MIA,W 112-108,240,41,77,.532,33,53,.623,8,24,.333,22,25,.880,112,41,91,.451,34,62,.548,7,29,.241,19,24,.792,108
691,POR,2017-03-25,112,,MIN,W 112-100,240,45,71,.634,34,49,.694,11,22,.500,11,17,.647,112,37,76,.487,35,66,.530,2,10,.200,24,32,.750,100
692,CLE,2017-03-24,112,@,CHO,W 112-105,240,41,74,.554,32,49,.653,9,25,.360,21,24,.875,112,38,90,.422,28,52,.538,10,38,.263,19,24,.792,105
693,GSW,2017-03-21,112,@,DAL,W 112-87,240,43,78,.551,30,48,.625,13,30,.433,13,16,.813,112,33,92,.359,22,58,.379,11,34,.324,10,12,.833,87
694,MIA,2017-03-21,112,,PHO,W 112-97,240,42,96,.438,31,69,.449,11,27,.407,17,23,.739,112,36,82,.439,32,66,.485,4,16,.250,21,29,.724,97
695,ORL,2017-03-20,112,,PHI,W 112-109 (OT),265,35,94,.372,31,71,.437,4,23,.174,38,46,.826,112,39,102,.382,30,68,.441,9,34,.265,22,24,.917,109
696,DET,2017-03-19,112,,PHO,W 112-95,240,40,92,.435,28,67,.418,12,25,.480,20,30,.667,112,35,99,.354,29,77,.377,6,22,.273,19,30,.633,95
697,WAS,2017-03-17,112,,CHI,W 112-107,240,46,101,.455,36,75,.480,10,26,.385,10,12,.833,112,44,88,.500,37,61,.607,7,27,.259,12,18,.667,107
698,HOU,2017-03-17,112,@,NOP,L 112-128,240,37,91,.407,24,51,.471,13,40,.325,25,32,.781,112,49,92,.533,37,58,.638,12,34,.353,18,24,.750,128
699,DAL,2017-03-15,112,@,WAS,W 112-107,240,40,79,.506,26,47,.553,14,32,.438,18,25,.720,112,40,82,.488,28,52,.538,12,30,.400,15,21,.714,107
700,NOP,2017-03-15,112,@,MIA,L 112-120,240,42,88,.477,33,66,.500,9,22,.409,19,28,.679,112,44,87,.506,28,52,.538,16,35,.457,16,19,.842,120
701,NYK,2017-03-12,112,@,BRK,L 112-120,240,39,94,.415,31,71,.437,8,23,.348,26,32,.813,112,40,87,.460,21,49,.429,19,38,.500,21,29,.724,120
702,CLE,2017-03-12,112,@,HOU,L 112-117,240,42,80,.525,25,37,.676,17,43,.395,11,13,.846,112,41,96,.427,25,51,.490,16,45,.356,19,28,.679,117
703,OKC,2017-03-11,112,,UTA,W 112-104,240,43,86,.500,35,63,.556,8,23,.348,18,24,.750,112,36,75,.480,27,55,.491,9,20,.450,23,28,.821,104
704,LAC,2017-03-11,112,,PHI,W 112-100,240,40,81,.494,32,56,.571,8,25,.320,24,29,.828,112,40,84,.476,30,54,.556,10,30,.333,10,14,.714,100
705,DET,2017-03-11,112,,NYK,W 112-92,240,46,96,.479,37,69,.536,9,27,.333,11,19,.579,112,36,82,.439,23,52,.442,13,30,.433,7,11,.636,92
706,MIL,2017-03-06,112,@,PHI,W 112-98,240,41,83,.494,27,50,.540,14,33,.424,16,20,.800,112,39,89,.438,31,59,.525,8,30,.267,12,19,.632,98
707,SAS,2017-03-06,112,,HOU,W 112-110,240,40,88,.455,29,60,.483,11,28,.393,21,23,.913,112,41,88,.466,27,49,.551,14,39,.359,14,17,.824,110
708,GSW,2017-03-05,112,@,NYK,W 112-105,240,40,88,.455,27,53,.509,13,35,.371,19,23,.826,112,39,83,.470,32,61,.525,7,22,.318,20,25,.800,105
709,CHO,2017-03-04,112,@,DEN,W 112-102,240,41,90,.456,25,63,.397,16,27,.593,14,17,.824,112,36,80,.450,27,50,.540,9,30,.300,21,25,.840,102
710,UTA,2017-03-03,112,,BRK,W 112-97,240,38,74,.514,26,48,.542,12,26,.462,24,34,.706,112,36,89,.404,29,59,.492,7,30,.233,18,24,.750,97
711,MIL,2017-03-03,112,,LAC,W 112-101,240,44,80,.550,34,55,.618,10,25,.400,14,15,.933,112,36,64,.563,28,45,.622,8,19,.421,21,36,.583,101
712,PHO,2017-02-28,112,@,MEM,L 112-130,240,43,83,.518,36,62,.581,7,21,.333,19,24,.792,112,48,86,.558,36,61,.590,12,25,.480,22,29,.759,130
713,WAS,2017-02-28,112,,GSW,W 112-108,240,41,91,.451,29,63,.460,12,28,.429,18,20,.900,112,39,84,.464,31,55,.564,8,29,.276,22,27,.815,108
714,TOR,2017-02-26,112,,POR,W 112-106,240,42,78,.538,35,58,.603,7,20,.350,21,27,.778,112,35,79,.443,26,58,.448,9,21,.429,27,35,.771,106
715,GSW,2017-02-25,112,,BRK,W 112-95,240,42,100,.420,31,69,.449,11,31,.355,17,22,.773,112,38,94,.404,30,66,.455,8,28,.286,11,17,.647,95
716,WAS,2017-02-24,112,@,PHI,L 112-120,240,38,90,.422,33,66,.500,5,24,.208,31,40,.775,112,43,87,.494,33,58,.569,10,29,.345,24,30,.800,120
717,POR,2017-02-23,112,@,ORL,W 112-103,240,41,81,.506,32,63,.508,9,18,.500,21,27,.778,112,34,86,.395,27,64,.422,7,22,.318,28,39,.718,103
718,MIN,2017-02-15,112,@,DEN,W 112-99,240,41,86,.477,35,68,.515,6,18,.333,24,28,.857,112,38,94,.404,27,60,.450,11,34,.324,12,18,.667,99
719,MEM,2017-02-13,112,@,BRK,W 112-103,240,39,77,.506,30,55,.545,9,22,.409,25,27,.926,112,38,82,.463,26,45,.578,12,37,.324,15,18,.833,103
720,BOS,2017-02-11,112,@,UTA,W 112-104,240,42,71,.592,29,41,.707,13,30,.433,15,23,.652,112,35,86,.407,27,55,.491,8,31,.258,26,30,.867,104
721,DAL,2017-02-11,112,,ORL,W 112-80,240,45,91,.495,28,56,.500,17,35,.486,5,6,.833,112,32,82,.390,29,59,.492,3,23,.130,13,18,.722,80
722,WAS,2017-02-10,112,,IND,W 112-107,240,41,88,.466,31,59,.525,10,29,.345,20,30,.667,112,45,92,.489,41,71,.577,4,21,.190,13,15,.867,107
723,DAL,2017-02-09,112,,UTA,W 112-105 (OT),265,44,87,.506,39,67,.582,5,20,.250,19,25,.760,112,39,85,.459,26,56,.464,13,29,.448,14,17,.824,105
724,PHI,2017-02-09,112,@,ORL,W 112-111,240,40,95,.421,29,67,.433,11,28,.393,21,27,.778,112,41,84,.488,31,63,.492,10,21,.476,19,24,.792,111
725,MIN,2017-02-08,112,,TOR,W 112-109,240,39,80,.488,32,61,.525,7,19,.368,27,30,.900,112,42,79,.532,31,51,.608,11,28,.393,14,20,.700,109
726,CHI,2017-02-06,112,@,SAC,W 112-107,240,43,81,.531,37,62,.597,6,19,.316,20,31,.645,112,41,79,.519,30,51,.588,11,28,.393,14,16,.875,107
727,PHO,2017-02-04,112,,MIL,L 112-137,240,38,91,.418,27,63,.429,11,28,.393,25,30,.833,112,52,82,.634,45,65,.692,7,17,.412,26,35,.743,137
728,BOS,2017-01-28,112,@,MIL,W 112-108 (OT),265,37,89,.416,23,48,.479,14,41,.341,24,30,.800,112,37,87,.425,28,66,.424,9,21,.429,25,32,.781,108
729,PHO,2017-01-28,112,,DEN,L 112-123,240,41,91,.451,35,70,.500,6,21,.286,24,32,.750,112,39,80,.488,31,55,.564,8,25,.320,37,42,.881,123
730,WAS,2017-01-27,112,@,ATL,W 112-86,240,43,89,.483,30,58,.517,13,31,.419,13,19,.684,112,30,83,.361,21,52,.404,9,31,.290,17,25,.680,86
731,POR,2017-01-27,112,,MEM,W 112-109,240,38,81,.469,22,46,.478,16,35,.457,20,21,.952,112,37,77,.481,28,51,.549,9,26,.346,26,33,.788,109
732,CLE,2017-01-25,112,,SAC,L 112-116 (OT),265,40,82,.488,25,44,.568,15,38,.395,17,34,.500,112,43,95,.453,32,64,.500,11,31,.355,19,22,.864,116
733,MIN,2017-01-24,112,@,PHO,W 112-111,240,44,84,.524,38,67,.567,6,17,.353,18,24,.750,112,38,86,.442,31,67,.463,7,19,.368,28,32,.875,111
734,SAS,2017-01-23,112,@,BRK,W 112-86,240,45,95,.474,36,73,.493,9,22,.409,13,16,.813,112,32,81,.395,27,56,.482,5,25,.200,17,18,.944,86
735,CHO,2017-01-21,112,,BRK,W 112-105,240,39,82,.476,25,52,.481,14,30,.467,20,22,.909,112,38,88,.432,21,47,.447,17,41,.415,12,15,.800,105
736,WAS,2017-01-21,112,@,DET,L 112-113,240,39,91,.429,31,65,.477,8,26,.308,26,33,.788,112,43,87,.494,32,59,.542,11,28,.393,16,22,.727,113
737,UTA,2017-01-20,112,@,DAL,W 112-107 (OT),265,38,83,.458,30,60,.500,8,23,.348,28,39,.718,112,39,87,.448,31,64,.484,8,23,.348,21,28,.750,107
738,ORL,2017-01-20,112,,MIL,W 112-96,240,40,87,.460,32,59,.542,8,28,.286,24,31,.774,112,34,83,.410,24,58,.414,10,25,.400,18,26,.692,96
739,ORL,2017-01-16,112,@,DEN,L 112-125,240,45,88,.511,37,63,.587,8,25,.320,14,18,.778,112,52,89,.584,43,62,.694,9,27,.333,12,15,.800,125
740,BRK,2017-01-15,112,,HOU,L 112-137,240,41,93,.441,26,49,.531,15,44,.341,15,19,.789,112,46,92,.500,25,48,.521,21,44,.477,24,32,.750,137
741,IND,2017-01-12,112,@,DEN,L 112-140,240,44,94,.468,32,65,.492,12,29,.414,12,13,.923,112,52,90,.578,37,58,.638,15,32,.469,21,23,.913,140
742,WAS,2017-01-06,112,,MIN,W 112-105,240,46,79,.582,34,57,.596,12,22,.545,8,9,.889,112,42,88,.477,35,70,.500,7,18,.389,14,17,.824,105
743,OKC,2017-01-04,112,@,CHO,L 112-123,240,42,96,.438,33,66,.500,9,30,.300,19,23,.826,112,37,80,.463,28,56,.500,9,24,.375,40,49,.816,123
744,SAS,2017-01-01,112,@,ATL,L 112-114 (OT),265,42,90,.467,33,63,.524,9,27,.333,19,22,.864,112,42,92,.457,28,64,.438,14,28,.500,16,27,.593,114
745,MEM,2016-12-31,112,@,SAC,W 112-98,240,44,87,.506,27,52,.519,17,35,.486,7,9,.778,112,31,72,.431,20,44,.455,11,28,.393,25,28,.893,98
746,ORL,2016-12-26,112,,MEM,W 112-102,240,44,86,.512,31,60,.517,13,26,.500,11,16,.688,112,35,76,.461,25,51,.490,10,25,.400,22,28,.786,102
747,OKC,2016-12-25,112,,MIN,W 112-100,240,42,82,.512,34,58,.586,8,24,.333,20,24,.833,112,39,83,.470,35,71,.493,4,12,.333,18,23,.783,100
748,BOS,2016-12-23,112,,OKC,L 112-117,240,41,93,.441,32,65,.492,9,28,.321,21,26,.808,112,41,80,.513,30,54,.556,11,26,.423,24,36,.667,117
749,BOS,2016-12-20,112,@,MEM,W 112-109 (OT),265,33,81,.407,21,44,.477,12,37,.324,34,38,.895,112,38,94,.404,26,64,.406,12,30,.400,21,26,.808,109
750,MIA,2016-12-12,112,,WAS,W 112-101,240,45,88,.511,36,62,.581,9,26,.346,13,19,.684,112,39,84,.464,34,61,.557,5,23,.217,18,22,.818,101
751,DAL,2016-12-12,112,,DEN,W 112-92,240,45,77,.584,33,51,.647,12,26,.462,10,12,.833,112,35,83,.422,28,58,.483,7,25,.280,15,18,.833,92
752,LAL,2016-12-11,112,,NYK,L 112-118,240,42,88,.477,32,60,.533,10,28,.357,18,22,.818,112,41,84,.488,31,62,.500,10,22,.455,26,31,.839,118
753,UTA,2016-12-06,112,,PHO,W 112-105,240,36,73,.493,24,46,.522,12,27,.444,28,32,.875,112,39,84,.464,33,66,.500,6,18,.333,21,25,.840,105
754,POR,2016-12-05,112,@,CHI,W 112-110,240,45,93,.484,36,69,.522,9,24,.375,13,18,.722,112,35,83,.422,28,60,.467,7,23,.304,33,38,.868,110
755,TOR,2016-12-05,112,,CLE,L 112-116,240,38,88,.432,25,56,.446,13,32,.406,23,27,.852,112,40,84,.476,26,52,.500,14,32,.438,22,27,.815,116
756,MIL,2016-12-03,112,,BRK,W 112-103,240,40,85,.471,34,61,.557,6,24,.250,26,36,.722,112,34,91,.374,23,50,.460,11,41,.268,24,33,.727,103
757,DET,2016-11-29,112,@,CHO,W 112-89,240,45,92,.489,33,64,.516,12,28,.429,10,11,.909,112,31,78,.397,22,51,.431,9,27,.333,18,21,.857,89
758,BOS,2016-11-28,112,@,MIA,W 112-104,240,40,83,.482,29,56,.518,11,27,.407,21,26,.808,112,38,80,.475,32,50,.640,6,30,.200,22,32,.688,104
759,OKC,2016-11-28,112,@,NYK,W 112-103,240,46,92,.500,38,70,.543,8,22,.364,12,18,.667,112,36,91,.396,30,72,.417,6,19,.316,25,28,.893,103
760,UTA,2016-11-28,112,@,MIN,W 112-103,240,40,79,.506,36,61,.590,4,18,.222,28,34,.824,112,36,81,.444,29,62,.468,7,19,.368,24,25,.960,103
761,CLE,2016-11-27,112,@,PHI,W 112-108,240,38,92,.413,26,52,.500,12,40,.300,24,28,.857,112,43,92,.467,28,58,.483,15,34,.441,7,10,.700,108
762,SAS,2016-11-26,112,@,WAS,W 112-100,240,40,75,.533,31,51,.608,9,24,.375,23,29,.793,112,42,88,.477,36,66,.545,6,22,.273,10,14,.714,100
763,NOP,2016-11-22,112,@,ATL,W 112-94,240,45,86,.523,34,61,.557,11,25,.440,11,12,.917,112,39,85,.459,29,56,.518,10,29,.345,6,10,.600,94
764,NYK,2016-11-17,112,@,WAS,L 112-119,240,41,86,.477,29,57,.509,12,29,.414,18,20,.900,112,44,81,.543,29,56,.518,15,25,.600,16,18,.889,119
765,POR,2016-11-13,112,,DEN,W 112-105,240,39,99,.394,31,70,.443,8,29,.276,26,32,.813,112,36,91,.396,25,62,.403,11,29,.379,22,29,.759,105
766,NOP,2016-11-10,112,@,MIL,W 112-106,240,39,89,.438,30,64,.469,9,25,.360,25,27,.926,112,40,91,.440,34,73,.466,6,18,.333,20,25,.800,106
767,TOR,2016-11-09,112,@,OKC,W 112-102,240,43,83,.518,32,57,.561,11,26,.423,15,22,.682,112,31,74,.419,19,40,.475,12,34,.353,28,31,.903,102
768,CHI,2016-11-07,112,,ORL,W 112-80,240,42,89,.472,39,70,.557,3,19,.158,25,31,.806,112,33,85,.388,24,55,.436,9,30,.300,5,6,.833,80
769,OKC,2016-11-05,112,,MIN,W 112-92,240,45,86,.523,38,70,.543,7,16,.438,15,24,.625,112,33,84,.393,29,65,.446,4,19,.211,22,29,.759,92
770,ATL,2016-11-05,112,,HOU,W 112-97,240,45,85,.529,37,65,.569,8,20,.400,14,24,.583,112,37,85,.435,25,49,.510,12,36,.333,11,13,.846,97
771,PHO,2016-11-04,112,@,NOP,W 112-111 (OT),265,40,93,.430,32,69,.464,8,24,.333,24,28,.857,112,43,94,.457,33,64,.516,10,30,.333,15,28,.536,111
772,MEM,2016-10-30,112,,WAS,W 112-103 (OT),265,39,88,.443,24,57,.421,15,31,.484,19,26,.731,112,38,86,.442,33,61,.541,5,25,.200,22,25,.880,103
773,DEN,2017-04-12,111,@,OKC,W 111-105,240,39,85,.459,32,60,.533,7,25,.280,26,32,.813,111,43,101,.426,35,76,.461,8,25,.320,11,17,.647,105
774,PHI,2017-04-10,111,,IND,L 111-120,240,35,75,.467,22,42,.524,13,33,.394,28,31,.903,111,49,85,.576,44,69,.638,5,16,.313,17,21,.810,120
775,DAL,2017-04-09,111,@,PHO,L 111-124,240,41,97,.423,25,52,.481,16,45,.356,13,19,.684,111,44,80,.550,36,61,.590,8,19,.421,28,32,.875,124
776,PHO,2017-04-05,111,,GSW,L 111-120,240,43,103,.417,36,76,.474,7,27,.259,18,26,.692,111,45,89,.506,32,59,.542,13,30,.433,17,24,.708,120
777,CHO,2017-04-04,111,@,WAS,L 111-118,240,40,79,.506,28,45,.622,12,34,.353,19,22,.864,111,43,85,.506,26,51,.510,17,34,.500,15,18,.833,118
778,ORL,2017-04-01,111,@,BRK,L 111-121,240,45,91,.495,35,66,.530,10,25,.400,11,15,.733,111,50,94,.532,42,63,.667,8,31,.258,13,16,.813,121
779,TOR,2017-03-31,111,,IND,W 111-100,240,37,82,.451,23,55,.418,14,27,.519,23,35,.657,111,36,87,.414,25,61,.410,11,26,.423,17,21,.810,100
780,GSW,2017-03-20,111,@,OKC,W 111-95,240,40,83,.482,25,50,.500,15,33,.455,16,21,.762,111,37,87,.425,33,66,.500,4,21,.190,17,31,.548,95
781,DAL,2017-03-19,111,@,BRK,W 111-104,240,41,76,.539,31,51,.608,10,25,.400,19,25,.760,111,31,72,.431,18,41,.439,13,31,.419,29,38,.763,104
782,LAL,2017-03-07,111,@,DAL,L 111-122,240,42,90,.467,31,60,.517,11,30,.367,16,22,.727,111,45,83,.542,28,52,.538,17,31,.548,15,19,.789,122
783,ATL,2017-03-06,111,,GSW,L 111-119,240,38,82,.463,25,54,.463,13,28,.464,22,31,.710,111,41,87,.471,21,43,.488,20,44,.455,17,22,.773,119
784,OKC,2017-03-03,111,@,PHO,L 111-118,240,37,87,.425,28,52,.538,9,35,.257,28,35,.800,111,44,89,.494,39,68,.574,5,21,.238,25,31,.806,118
785,WAS,2017-02-16,111,@,IND,W 111-98,240,43,83,.518,28,54,.519,15,29,.517,10,15,.667,111,40,80,.500,36,62,.581,4,18,.222,14,18,.778,98
786,UTA,2017-02-15,111,,POR,W 111-88,240,42,81,.519,31,59,.525,11,22,.500,16,23,.696,111,32,79,.405,23,57,.404,9,22,.409,15,20,.750,88
787,BOS,2017-02-13,111,@,DAL,W 111-98,240,40,81,.494,24,47,.511,16,34,.471,15,18,.833,111,35,77,.455,26,50,.520,9,27,.333,19,25,.760,98
788,ORL,2017-02-09,111,,PHI,L 111-112,240,41,84,.488,31,63,.492,10,21,.476,19,24,.792,111,40,95,.421,29,67,.433,11,28,.393,21,27,.778,112
789,POR,2017-02-09,111,,BOS,L 111-120,240,39,77,.506,30,51,.588,9,26,.346,24,31,.774,111,44,91,.484,34,61,.557,10,30,.333,22,27,.815,120
790,SAS,2017-02-08,111,@,PHI,W 111-103,240,39,74,.527,28,52,.538,11,22,.500,22,25,.880,111,34,84,.405,21,50,.420,13,34,.382,22,29,.759,103
791,CHO,2017-02-07,111,,BRK,W 111-107,240,40,102,.392,33,76,.434,7,26,.269,24,29,.828,111,39,86,.453,27,50,.540,12,36,.333,17,21,.810,107
792,NOP,2017-02-06,111,,PHO,W 111-106,240,42,92,.457,33,66,.500,9,26,.346,18,22,.818,111,40,93,.430,35,66,.530,5,27,.185,21,25,.840,106
793,CLE,2017-02-04,111,@,NYK,W 111-104,240,41,84,.488,25,44,.568,16,40,.400,13,18,.722,111,39,86,.453,27,55,.491,12,31,.387,14,28,.500,104
794,CHO,2017-02-01,111,@,GSW,L 111-126,240,39,88,.443,30,57,.526,9,31,.290,24,26,.923,111,47,96,.490,26,48,.542,21,48,.438,11,14,.786,126
795,MIN,2017-01-30,111,,ORL,W 111-105 (OT),265,40,91,.440,28,62,.452,12,29,.414,19,26,.731,111,41,96,.427,31,61,.508,10,35,.286,13,19,.684,105
796,POR,2017-01-29,111,,GSW,L 111-113,240,46,93,.495,36,66,.545,10,27,.370,9,12,.750,111,36,79,.456,28,53,.528,8,26,.308,33,39,.846,113
797,SAC,2017-01-27,111,@,IND,L 111-115 (OT),265,35,70,.500,22,45,.489,13,25,.520,28,36,.778,111,38,78,.487,28,50,.560,10,28,.357,29,33,.879,115
798,PHO,2017-01-24,111,,MIN,L 111-112,240,38,86,.442,31,67,.463,7,19,.368,28,32,.875,111,44,84,.524,38,67,.567,6,17,.353,18,24,.750,112
799,MIN,2017-01-22,111,,DEN,W 111-108,240,45,85,.529,39,70,.557,6,15,.400,15,21,.714,111,42,82,.512,35,58,.603,7,24,.292,17,21,.810,108
800,HOU,2017-01-18,111,,MIL,W 111-92,240,43,95,.453,29,51,.569,14,44,.318,11,15,.733,111,37,93,.398,30,65,.462,7,28,.250,11,14,.786,92
801,ATL,2017-01-15,111,,MIL,W 111-98,240,42,80,.525,29,54,.537,13,26,.500,14,18,.778,111,39,79,.494,33,60,.550,6,19,.316,14,18,.778,98
802,LAL,2017-01-08,111,,ORL,W 111-95,240,42,87,.483,34,55,.618,8,32,.250,19,24,.792,111,34,90,.378,27,64,.422,7,26,.269,20,29,.690,95
803,MIL,2017-01-06,111,,NYK,L 111-116,240,39,78,.500,27,56,.482,12,22,.545,21,28,.750,111,41,83,.494,28,60,.467,13,23,.565,21,27,.778,116
804,ATL,2017-01-04,111,@,ORL,W 111-92,240,44,81,.543,34,62,.548,10,19,.526,13,18,.722,111,37,86,.430,28,58,.483,9,28,.321,9,10,.900,92
805,CHO,2017-01-02,111,@,CHI,L 111-118,240,41,83,.494,32,64,.500,9,19,.474,20,22,.909,111,42,90,.467,35,67,.522,7,23,.304,27,29,.931,118
806,IND,2016-12-30,111,,CHI,W 111-101,240,39,81,.481,32,62,.516,7,19,.368,26,30,.867,111,35,84,.417,29,61,.475,6,23,.261,25,31,.806,101
807,TOR,2016-12-28,111,@,GSW,L 111-121,240,40,103,.388,27,68,.397,13,35,.371,18,22,.818,111,46,81,.568,32,58,.552,14,23,.609,15,18,.833,121
808,WAS,2016-12-28,111,,IND,W 111-105,240,38,78,.487,30,56,.536,8,22,.364,27,37,.730,111,35,79,.443,24,51,.471,11,28,.393,24,29,.828,105
809,NOP,2016-12-26,111,,DAL,W 111-104,240,37,70,.529,25,45,.556,12,25,.480,25,30,.833,111,37,75,.493,24,43,.558,13,32,.406,17,22,.773,104
810,LAL,2016-12-25,111,,LAC,W 111-102,240,40,84,.476,32,59,.542,8,25,.320,23,30,.767,111,37,85,.435,27,56,.482,10,29,.345,18,22,.818,102
811,PHO,2016-12-21,111,,HOU,L 111-125,240,44,93,.473,35,68,.515,9,25,.360,14,20,.700,111,46,86,.535,28,48,.583,18,38,.474,15,26,.577,125
812,IND,2016-12-20,111,@,NYK,L 111-118,240,39,91,.429,33,68,.485,6,23,.261,27,33,.818,111,44,88,.500,31,65,.477,13,23,.565,17,21,.810,118
813,HOU,2016-12-17,111,@,MIN,W 111-109 (OT),265,39,96,.406,22,45,.489,17,51,.333,16,20,.800,111,41,92,.446,34,71,.479,7,21,.333,20,27,.741,109
814,BRK,2016-12-16,111,@,ORL,L 111-118,240,39,83,.470,28,56,.500,11,27,.407,22,26,.846,111,39,97,.402,32,68,.471,7,29,.241,33,42,.786,118
815,NYK,2016-12-13,111,@,PHO,L 111-113 (OT),265,38,97,.392,31,77,.403,7,20,.350,28,38,.737,111,38,93,.409,29,63,.460,9,30,.300,28,33,.848,113
816,POR,2016-12-10,111,@,IND,L 111-118,240,40,82,.488,24,45,.533,16,37,.432,15,16,.938,111,40,83,.482,25,54,.463,15,29,.517,23,28,.821,118
817,DAL,2016-12-09,111,,IND,W 111-103,240,39,80,.488,24,48,.500,15,32,.469,18,24,.750,111,32,69,.464,18,44,.409,14,25,.560,25,26,.962,103
818,DEN,2016-12-07,111,@,BRK,L 111-116,240,42,105,.400,31,68,.456,11,37,.297,16,21,.762,111,41,85,.482,32,59,.542,9,26,.346,25,31,.806,116
819,IND,2016-12-04,111,@,LAC,W 111-102,240,39,79,.494,34,65,.523,5,14,.357,28,35,.800,111,36,81,.444,26,51,.510,10,30,.333,20,28,.714,102
820,CHI,2016-12-02,111,,CLE,W 111-105,240,47,96,.490,44,78,.564,3,18,.167,14,17,.824,111,45,83,.542,35,57,.614,10,26,.385,5,10,.500,105
821,MIL,2016-12-01,111,@,BRK,W 111-93,240,36,80,.450,21,46,.457,15,34,.441,24,29,.828,111,34,89,.382,22,49,.449,12,40,.300,13,16,.813,93
822,MIA,2016-12-01,111,@,UTA,W 111-110,240,44,86,.512,36,67,.537,8,19,.421,15,19,.789,111,40,73,.548,23,43,.535,17,30,.567,13,17,.765,110
823,CHO,2016-11-25,111,@,NYK,L 111-113 (OT),265,43,93,.462,35,64,.547,8,29,.276,17,27,.630,111,45,97,.464,34,69,.493,11,28,.393,12,13,.923,113
824,BOS,2016-11-23,111,@,BRK,W 111-92,240,45,98,.459,30,60,.500,15,38,.395,6,8,.750,111,34,86,.395,24,55,.436,10,31,.323,14,22,.636,92
825,LAL,2016-11-22,111,,OKC,W 111-109,240,42,83,.506,28,56,.500,14,27,.519,13,16,.813,111,45,92,.489,34,65,.523,11,27,.407,8,11,.727,109
826,OKC,2016-11-20,111,,IND,L 111-115 (OT),265,44,101,.436,34,65,.523,10,36,.278,13,18,.722,111,40,89,.449,29,67,.433,11,22,.500,24,31,.774,115
827,HOU,2016-11-19,111,,UTA,W 111-102,240,42,94,.447,30,62,.484,12,32,.375,15,20,.750,111,39,76,.513,27,49,.551,12,27,.444,12,17,.706,102
828,WAS,2016-11-19,111,,MIA,L 111-114,240,42,89,.472,31,62,.500,11,27,.407,16,22,.727,111,43,85,.506,30,58,.517,13,27,.481,15,26,.577,114
829,DEN,2016-11-18,111,,TOR,L 111-113 (OT),265,39,83,.470,35,58,.603,4,25,.160,29,39,.744,111,43,94,.457,35,71,.493,8,23,.348,19,31,.613,113
830,MEM,2016-11-16,111,@,LAC,W 111-107,240,40,82,.488,25,56,.446,15,26,.577,16,19,.842,111,37,81,.457,28,56,.500,9,25,.360,24,34,.706,107
831,CHO,2016-11-11,111,,TOR,L 111-113,240,38,93,.409,21,52,.404,17,41,.415,18,24,.750,111,43,90,.478,37,68,.544,6,22,.273,21,22,.955,113
832,LAC,2016-11-09,111,,POR,W 111-80,240,38,87,.437,27,55,.491,11,32,.344,24,33,.727,111,31,88,.352,25,58,.431,6,30,.200,12,14,.857,80
833,IND,2016-11-05,111,,CHI,W 111-94,240,46,86,.535,34,60,.567,12,26,.462,7,12,.583,111,34,79,.430,28,61,.459,6,18,.333,20,25,.800,94
834,NOP,2016-11-04,111,,PHO,L 111-112 (OT),265,43,94,.457,33,64,.516,10,30,.333,15,28,.536,111,40,93,.430,32,69,.464,8,24,.333,24,28,.857,112
835,NYK,2016-10-29,111,,MEM,W 111-104,240,40,76,.526,34,55,.618,6,21,.286,25,39,.641,111,37,86,.430,28,61,.459,9,25,.360,21,26,.808,104
836,MIA,2017-04-12,110,,WAS,W 110-102,240,46,88,.523,38,64,.594,8,24,.333,10,12,.833,110,42,87,.483,35,61,.574,7,26,.269,11,14,.786,102
837,TOR,2017-04-09,110,@,NYK,W 110-97,240,40,77,.519,30,46,.652,10,31,.323,20,23,.870,110,37,82,.451,28,54,.519,9,28,.321,14,15,.933,97
838,LAL,2017-04-09,110,,MIN,W 110-109,240,42,86,.488,32,59,.542,10,27,.370,16,20,.800,110,40,80,.500,37,65,.569,3,15,.200,26,31,.839,109
839,HOU,2017-04-05,110,,DEN,W 110-104,240,37,87,.425,27,53,.509,10,34,.294,26,38,.684,110,41,104,.394,34,66,.515,7,38,.184,15,18,.833,104
840,OKC,2017-04-04,110,,MIL,W 110-79,240,40,84,.476,31,56,.554,9,28,.321,21,25,.840,110,29,81,.358,26,63,.413,3,18,.167,18,26,.692,79
841,MIN,2017-04-03,110,,POR,W 110-109,240,41,84,.488,37,75,.493,4,9,.444,24,28,.857,110,38,86,.442,27,54,.500,11,32,.344,22,25,.880,109
842,BOS,2017-04-02,110,@,NYK,W 110-94,240,40,72,.556,28,35,.800,12,37,.324,18,26,.692,110,33,85,.388,26,60,.433,7,25,.280,21,25,.840,94
843,NOP,2017-04-02,110,,CHI,L 110-117,240,33,81,.407,23,51,.451,10,30,.333,34,35,.971,110,45,92,.489,32,66,.485,13,26,.500,14,18,.778,117
844,GSW,2017-03-29,110,@,SAS,W 110-98,240,43,85,.506,30,59,.508,13,26,.500,11,11,1.000,110,34,83,.410,25,59,.424,9,24,.375,21,26,.808,98
845,CHO,2017-03-29,110,@,TOR,W 110-106,240,39,86,.453,23,54,.426,16,32,.500,16,21,.762,110,38,83,.458,27,52,.519,11,31,.355,19,24,.792,106
846,MEM,2017-03-29,110,,IND,W 110-97,240,41,88,.466,29,56,.518,12,32,.375,16,18,.889,110,37,85,.435,27,60,.450,10,25,.400,13,15,.867,97
847,POR,2017-03-23,110,,NYK,W 110-95,240,39,80,.488,28,59,.475,11,21,.524,21,29,.724,110,36,88,.409,31,66,.470,5,22,.227,18,20,.900,95
848,BOS,2017-03-20,110,,WAS,W 110-102,240,40,93,.430,30,60,.500,10,33,.303,20,28,.714,110,37,86,.430,29,51,.569,8,35,.229,20,26,.769,102
849,OKC,2017-03-18,110,,SAC,W 110-94,240,41,82,.500,31,56,.554,10,26,.385,18,25,.720,110,35,85,.412,30,64,.469,5,21,.238,19,23,.826,94
850,NYK,2017-03-16,110,,BRK,L 110-121,240,41,88,.466,38,70,.543,3,18,.167,25,26,.962,110,41,86,.477,31,54,.574,10,32,.313,29,35,.829,121
851,POR,2017-03-15,110,@,SAS,W 110-106,240,38,80,.475,29,58,.500,9,22,.409,25,28,.893,110,42,88,.477,31,62,.500,11,26,.423,11,15,.733,106
852,POR,2017-03-12,110,@,PHO,W 110-101,240,43,86,.500,36,64,.563,7,22,.318,17,25,.680,110,41,93,.441,36,79,.456,5,14,.357,14,20,.700,101
853,PHO,2017-03-09,110,,LAL,L 110-122,240,42,91,.462,36,72,.500,6,19,.316,20,25,.800,110,47,98,.480,35,71,.493,12,27,.444,16,24,.667,122
854,ATL,2017-03-08,110,,BRK,W 110-105,240,41,95,.432,37,75,.493,4,20,.200,24,32,.750,110,37,80,.463,26,47,.553,11,33,.333,20,25,.800,105
855,HOU,2017-03-06,110,@,SAS,L 110-112,240,41,88,.466,27,49,.551,14,39,.359,14,17,.824,110,40,88,.455,29,60,.483,11,28,.393,21,23,.913,112
856,UTA,2017-03-05,110,@,SAC,W 110-109 (OT),265,41,90,.456,31,57,.544,10,33,.303,18,27,.667,110,43,83,.518,35,66,.530,8,17,.471,15,20,.750,109
857,ORL,2017-03-03,110,,MIA,W 110-99,240,45,90,.500,40,73,.548,5,17,.294,15,19,.789,110,35,91,.385,27,63,.429,8,28,.286,21,25,.840,99
858,DEN,2017-03-01,110,@,MIL,W 110-98,240,41,84,.488,31,51,.608,10,33,.303,18,20,.900,110,38,83,.458,29,65,.446,9,18,.500,13,15,.867,98
859,NOP,2017-02-26,110,@,OKC,L 110-118,240,36,80,.450,28,59,.475,8,21,.381,30,37,.811,110,42,88,.477,36,67,.537,6,21,.286,28,37,.757,118
860,NYK,2017-02-25,110,,PHI,W 110-109,240,43,91,.473,37,70,.529,6,21,.286,18,23,.783,110,40,95,.421,33,64,.516,7,31,.226,22,27,.815,109
861,OKC,2017-02-24,110,,LAL,W 110-93,240,44,97,.454,34,73,.466,10,24,.417,12,17,.706,110,40,101,.396,33,66,.500,7,35,.200,6,14,.429,93
862,NOP,2017-02-13,110,@,PHO,W 110-108,240,37,78,.474,29,50,.580,8,28,.286,28,35,.800,110,40,93,.430,32,70,.457,8,23,.348,20,24,.833,108
863,GSW,2017-02-13,110,@,DEN,L 110-132,240,45,92,.489,37,60,.617,8,32,.250,12,13,.923,110,48,88,.545,24,47,.511,24,41,.585,12,16,.750,132
864,SAS,2017-02-13,110,@,IND,W 110-106,240,40,87,.460,33,72,.458,7,15,.467,23,27,.852,110,38,78,.487,29,58,.500,9,20,.450,21,30,.700,106
865,BRK,2017-02-08,110,,WAS,L 110-114 (OT),265,38,91,.418,29,58,.500,9,33,.273,25,36,.694,110,40,97,.412,31,72,.431,9,25,.360,25,33,.758,114
866,MEM,2017-02-08,110,,PHO,W 110-91,240,35,72,.486,21,48,.438,14,24,.583,26,34,.765,110,29,87,.333,24,64,.375,5,23,.217,28,34,.824,91
867,DEN,2017-02-06,110,,DAL,W 110-87,240,42,84,.500,31,56,.554,11,28,.393,15,16,.938,110,34,79,.430,26,53,.491,8,26,.308,11,17,.647,87
868,NYK,2017-01-27,110,,CHO,W 110-107,240,46,96,.479,37,69,.536,9,27,.333,9,13,.692,110,40,90,.444,27,53,.509,13,37,.351,14,15,.933,107
869,LAC,2017-01-24,110,@,PHI,L 110-121,240,33,71,.465,15,37,.405,18,34,.529,26,41,.634,110,45,90,.500,35,61,.574,10,29,.345,21,22,.955,121
870,ATL,2017-01-21,110,,PHI,W 110-93,240,45,91,.495,38,71,.535,7,20,.350,13,23,.565,110,33,78,.423,21,49,.429,12,29,.414,15,18,.833,93
871,NYK,2017-01-19,110,,WAS,L 110-113,240,42,90,.467,35,66,.530,7,24,.292,19,22,.864,110,44,88,.500,31,56,.554,13,32,.406,12,14,.857,113
872,UTA,2017-01-13,110,,DET,W 110-77,240,43,80,.538,27,49,.551,16,31,.516,8,13,.615,110,30,76,.395,24,59,.407,6,17,.353,11,16,.688,77
873,MEM,2017-01-13,110,@,HOU,W 110-105,240,41,76,.539,31,49,.633,10,27,.370,18,27,.667,110,33,82,.402,23,41,.561,10,41,.244,29,36,.806,105
874,NOP,2017-01-09,110,@,NYK,W 110-96,240,41,84,.488,29,57,.509,12,27,.444,16,19,.842,110,36,85,.424,25,56,.446,11,29,.379,13,16,.813,96
875,BOS,2017-01-06,110,,PHI,W 110-106,240,35,87,.402,16,47,.340,19,40,.475,21,25,.840,110,37,79,.468,28,51,.549,9,28,.321,23,26,.885,106
876,SAS,2017-01-03,110,,TOR,W 110-82,240,43,78,.551,30,54,.556,13,24,.542,11,15,.733,110,31,83,.373,27,65,.415,4,18,.222,16,22,.727,82
877,SAS,2016-12-30,110,,POR,W 110-94,240,39,78,.500,28,56,.500,11,22,.500,21,25,.840,110,35,77,.455,29,57,.509,6,20,.300,18,21,.857,94
878,SAS,2016-12-23,110,@,POR,W 110-90,240,39,78,.500,27,58,.466,12,20,.600,20,21,.952,110,35,79,.443,23,49,.469,12,30,.400,8,16,.500,90
879,NOP,2016-12-21,110,,OKC,L 110-121,240,42,88,.477,34,68,.500,8,20,.400,18,23,.783,110,45,88,.511,34,60,.567,11,28,.393,20,24,.833,121
880,ATL,2016-12-19,110,@,OKC,W 110-108,240,41,75,.547,32,52,.615,9,23,.391,19,24,.792,110,39,87,.448,29,52,.558,10,35,.286,20,26,.769,108
881,LAC,2016-12-18,110,@,WAS,L 110-117,240,43,87,.494,36,63,.571,7,24,.292,17,24,.708,110,43,81,.531,33,62,.532,10,19,.526,21,30,.700,117
882,IND,2016-12-12,110,,CHO,W 110-94,240,43,88,.489,26,52,.500,17,36,.472,7,10,.700,110,28,84,.333,18,58,.310,10,26,.385,28,32,.875,94
883,MEM,2016-12-10,110,,GSW,W 110-89,240,38,87,.437,30,61,.492,8,26,.308,26,29,.897,110,34,77,.442,25,50,.500,9,27,.333,12,20,.600,89
884,WAS,2016-12-10,110,,MIL,W 110-105,240,40,88,.455,32,67,.478,8,21,.381,22,28,.786,110,40,79,.506,27,54,.500,13,25,.520,12,15,.800,105
885,MIL,2016-12-09,110,,ATL,L 110-114,240,44,94,.468,32,66,.485,12,28,.429,10,14,.714,110,40,84,.476,28,50,.560,12,34,.353,22,29,.759,114
886,MIN,2016-12-08,110,@,TOR,L 110-124,240,45,88,.511,36,60,.600,9,28,.321,11,15,.733,110,43,87,.494,31,60,.517,12,27,.444,26,33,.788,124
887,MEM,2016-12-05,110,@,NOP,W 110-108 (2OT),290,42,104,.404,29,70,.414,13,34,.382,13,21,.619,110,39,99,.394,29,67,.433,10,32,.313,20,21,.952,108
888,CHI,2016-12-05,110,,POR,L 110-112,240,35,83,.422,28,60,.467,7,23,.304,33,38,.868,110,45,93,.484,36,69,.522,9,24,.375,13,18,.722,112
889,DEN,2016-12-02,110,,HOU,L 110-128,240,46,104,.442,37,73,.507,9,31,.290,9,16,.563,110,45,88,.511,28,51,.549,17,37,.459,21,25,.840,128
890,UTA,2016-12-01,110,,MIA,L 110-111,240,40,73,.548,23,43,.535,17,30,.567,13,17,.765,110,44,86,.512,36,67,.537,8,19,.421,15,19,.789,111
891,MEM,2016-11-26,110,@,MIA,W 110-107,240,37,73,.507,28,48,.583,9,25,.360,27,33,.818,110,40,81,.494,29,50,.580,11,31,.355,16,24,.667,107
892,DEN,2016-11-22,110,,CHI,W 110-107,240,43,100,.430,33,78,.423,10,22,.455,14,17,.824,110,43,95,.453,37,77,.481,6,18,.333,15,18,.833,107
893,LAL,2016-11-20,110,,CHI,L 110-118,240,41,93,.441,28,62,.452,13,31,.419,15,21,.714,110,45,87,.517,37,65,.569,8,22,.364,20,28,.714,118
894,MIN,2016-11-17,110,,PHI,W 110-86,240,43,84,.512,37,59,.627,6,25,.240,18,20,.900,110,31,83,.373,22,51,.431,9,32,.281,15,19,.789,86
895,SAS,2016-11-16,110,@,SAC,W 110-105,240,43,88,.489,32,58,.552,11,30,.367,13,17,.765,110,36,76,.474,27,56,.482,9,20,.450,24,31,.774,105
896,LAC,2016-11-11,110,@,OKC,W 110-108,240,39,86,.453,28,59,.475,11,27,.407,21,35,.600,110,38,88,.432,22,60,.367,16,28,.571,16,19,.842,108
897,NYK,2016-11-09,110,,BRK,W 110-96,240,44,92,.478,34,62,.548,10,30,.333,12,17,.706,110,33,79,.418,22,46,.478,11,33,.333,19,27,.704,96
898,MIN,2016-11-08,110,@,BRK,L 110-119,240,39,92,.424,27,64,.422,12,28,.429,20,28,.714,110,42,76,.553,30,43,.698,12,33,.364,23,26,.885,119
899,ATL,2016-11-08,110,@,CLE,W 110-106,240,41,81,.506,30,52,.577,11,29,.379,17,24,.708,110,37,99,.374,26,57,.456,11,42,.262,21,25,.840,106
900,MIL,2016-10-29,110,,BRK,W 110-108,240,41,88,.466,33,66,.500,8,22,.364,20,24,.833,110,37,84,.440,26,50,.520,11,34,.324,23,28,.821,108
901,PHO,2016-10-28,110,@,OKC,L 110-113 (OT),265,42,94,.447,37,66,.561,5,28,.179,21,32,.656,110,40,96,.417,35,75,.467,5,21,.238,28,38,.737,113
902,DET,2017-04-12,109,@,ORL,L 109-113,240,41,106,.387,30,70,.429,11,36,.306,16,28,.571,109,42,87,.483,29,62,.468,13,25,.520,16,17,.941,113
903,GSW,2017-04-12,109,,LAL,W 109-94,240,41,90,.456,29,54,.537,12,36,.333,15,22,.682,109,41,93,.441,37,76,.487,4,17,.235,8,14,.571,94
904,DEN,2017-04-11,109,@,DAL,W 109-91,240,41,84,.488,23,42,.548,18,42,.429,9,14,.643,109,35,88,.398,23,48,.479,12,40,.300,9,11,.818,91
905,MIN,2017-04-09,109,@,LAL,L 109-110,240,40,80,.500,37,65,.569,3,15,.200,26,31,.839,109,42,86,.488,32,59,.542,10,27,.370,16,20,.800,110
906,HOU,2017-04-07,109,,DET,L 109-114,240,36,87,.414,20,36,.556,16,51,.314,21,28,.750,109,46,108,.426,37,82,.451,9,26,.346,13,16,.813,114
907,POR,2017-04-03,109,@,MIN,L 109-110,240,38,86,.442,27,54,.500,11,32,.344,22,25,.880,109,41,84,.488,37,75,.493,4,9,.444,24,28,.857,110
908,DAL,2017-04-02,109,@,MIL,W 109-105,240,38,73,.521,24,37,.649,14,36,.389,19,20,.950,109,39,77,.506,27,43,.628,12,34,.353,15,18,.833,105
909,SAS,2017-04-02,109,,UTA,W 109-103,240,40,77,.519,30,58,.517,10,19,.526,19,22,.864,109,43,89,.483,34,65,.523,9,24,.375,8,13,.615,103
910,NYK,2017-03-27,109,,DET,W 109-95,240,45,84,.536,38,63,.603,7,21,.333,12,13,.923,109,36,84,.429,27,61,.443,9,23,.391,14,21,.667,95
911,CHI,2017-03-26,109,@,MIL,W 109-94,240,46,85,.541,36,64,.563,10,21,.476,7,10,.700,109,37,84,.440,30,61,.492,7,23,.304,13,17,.765,94
912,CHO,2017-03-22,109,@,ORL,W 109-102,240,42,90,.467,33,63,.524,9,27,.333,16,18,.889,109,40,88,.455,26,48,.542,14,40,.350,8,10,.800,102
913,BOS,2017-03-22,109,,IND,W 109-100,240,43,84,.512,32,57,.561,11,27,.407,12,14,.857,109,38,87,.437,27,59,.458,11,28,.393,13,19,.684,100
914,LAL,2017-03-21,109,,LAC,L 109-133,240,43,92,.467,37,72,.514,6,20,.300,17,27,.630,109,45,84,.536,30,51,.588,15,33,.455,28,32,.875,133
915,PHI,2017-03-20,109,@,ORL,L 109-112 (OT),265,39,102,.382,30,68,.441,9,34,.265,22,24,.917,109,35,94,.372,31,71,.437,4,23,.174,38,46,.826,112
916,MIN,2017-03-19,109,@,NOP,L 109-123,240,44,86,.512,35,61,.574,9,25,.360,12,17,.706,109,49,90,.544,35,60,.583,14,30,.467,11,15,.733,123
917,HOU,2017-03-18,109,@,DEN,W 109-105,240,38,83,.458,33,59,.559,5,24,.208,28,35,.800,109,38,89,.427,28,58,.483,10,31,.323,19,30,.633,105
918,ORL,2017-03-17,109,@,PHO,W 109-103,240,42,96,.438,35,73,.479,7,23,.304,18,21,.857,109,38,87,.437,36,73,.493,2,14,.143,25,30,.833,103
919,CHO,2017-03-13,109,,CHI,L 109-115,240,43,93,.462,36,64,.563,7,29,.241,16,19,.842,109,41,92,.446,27,52,.519,14,40,.350,19,22,.864,115
920,DET,2017-03-06,109,,CHI,W 109-95,240,45,92,.489,39,71,.549,6,21,.286,13,20,.650,109,34,83,.410,26,55,.473,8,28,.286,19,21,.905,95
921,MEM,2017-03-06,109,,BRK,L 109-122,240,34,77,.442,24,52,.462,10,25,.400,31,39,.795,109,39,73,.534,25,43,.581,14,30,.467,30,38,.789,122
922,PHO,2017-03-05,109,,BOS,W 109-106,240,42,94,.447,38,74,.514,4,20,.200,21,26,.808,109,32,85,.376,19,48,.396,13,37,.351,29,40,.725,106
923,SAC,2017-03-05,109,,UTA,L 109-110 (OT),265,43,83,.518,35,66,.530,8,17,.471,15,20,.750,109,41,90,.456,31,57,.544,10,33,.303,18,27,.667,110
924,OKC,2017-03-02,109,@,POR,L 109-114,240,34,86,.395,23,57,.404,11,29,.379,30,32,.938,109,39,79,.494,29,54,.537,10,25,.400,26,35,.743,114
925,BRK,2017-03-01,109,@,SAC,W 109-100,240,34,74,.459,23,46,.500,11,28,.393,30,36,.833,109,35,81,.432,24,59,.407,11,22,.500,19,22,.864,100
926,NOP,2017-03-01,109,,DET,W 109-86,240,39,78,.500,30,53,.566,9,25,.360,22,23,.957,109,40,103,.388,37,80,.463,3,23,.130,3,17,.176,86
927,CHO,2017-02-28,109,@,LAL,W 109-104,240,38,85,.447,22,46,.478,16,39,.410,17,24,.708,109,41,84,.488,29,52,.558,12,32,.375,10,13,.769,104
928,OKC,2017-02-28,109,,UTA,W 109-106,240,39,76,.513,24,54,.444,15,22,.682,16,23,.696,109,43,93,.462,34,71,.479,9,22,.409,11,13,.846,106
929,PHI,2017-02-25,109,@,NYK,L 109-110,240,40,95,.421,33,64,.516,7,31,.226,22,27,.815,109,43,91,.473,37,70,.529,6,21,.286,18,23,.783,110
930,BRK,2017-02-24,109,@,DEN,L 109-129,240,41,83,.494,31,53,.585,10,30,.333,17,31,.548,109,49,97,.505,35,66,.530,14,31,.452,17,24,.708,129
931,UTA,2017-02-24,109,@,MIL,W 109-95,240,37,74,.500,29,51,.569,8,23,.348,27,30,.900,109,32,74,.432,25,56,.446,7,18,.389,24,29,.828,95
932,GSW,2017-02-15,109,,SAC,W 109-86,240,41,84,.488,28,48,.583,13,36,.361,14,21,.667,109,33,89,.371,26,65,.400,7,24,.292,13,17,.765,86
933,HOU,2017-02-15,109,,MIA,L 109-117,240,36,87,.414,23,47,.489,13,40,.325,24,31,.774,109,44,84,.524,31,49,.633,13,35,.371,16,24,.667,117
934,ATL,2017-02-13,109,@,POR,W 109-104 (OT),265,32,83,.386,24,55,.436,8,28,.286,37,48,.771,109,37,103,.359,21,61,.344,16,42,.381,14,25,.560,104
935,DEN,2017-02-11,109,@,CLE,L 109-125,240,39,97,.402,27,60,.450,12,37,.324,19,22,.864,109,46,84,.548,31,54,.574,15,30,.500,18,22,.818,125
936,MIA,2017-02-11,109,@,PHI,L 109-117,240,39,85,.459,32,61,.525,7,24,.292,24,28,.857,109,39,86,.453,30,61,.492,9,25,.360,30,38,.789,117
937,CLE,2017-02-09,109,@,OKC,L 109-118,240,38,79,.481,28,58,.483,10,21,.476,23,30,.767,109,50,106,.472,42,79,.532,8,27,.296,10,13,.769,118
938,TOR,2017-02-08,109,@,MIN,L 109-112,240,42,79,.532,31,51,.608,11,28,.393,14,20,.700,109,39,80,.488,32,61,.525,7,19,.368,27,30,.900,112
939,LAC,2017-02-06,109,@,TOR,L 109-118,240,42,90,.467,29,55,.527,13,35,.371,12,18,.667,109,41,84,.488,31,60,.517,10,24,.417,26,29,.897,118
940,SAC,2017-02-04,109,,GSW,W 109-106 (OT),265,43,88,.489,36,65,.554,7,23,.304,16,19,.842,109,36,87,.414,21,43,.488,15,44,.341,19,24,.792,106
941,BOS,2017-02-01,109,,TOR,W 109-104,240,36,87,.414,24,51,.471,12,36,.333,25,30,.833,109,41,78,.526,33,47,.702,8,31,.258,14,25,.560,104
942,DET,2017-01-30,109,@,BOS,L 109-113,240,43,97,.443,40,70,.571,3,27,.111,20,29,.690,109,36,82,.439,23,50,.460,13,32,.406,28,33,.848,113
943,BRK,2017-01-28,109,@,MIN,L 109-129,240,41,85,.482,34,64,.531,7,21,.333,20,25,.800,109,47,93,.505,38,73,.521,9,20,.450,26,32,.813,129
944,SAC,2017-01-28,109,@,CHO,W 109-106,240,41,79,.519,30,52,.577,11,27,.407,16,26,.615,109,36,75,.480,24,38,.632,12,37,.324,22,24,.917,106
945,MEM,2017-01-27,109,@,POR,L 109-112,240,37,77,.481,28,51,.549,9,26,.346,26,33,.788,109,38,81,.469,22,46,.478,16,35,.457,20,21,.952,112
946,OKC,2017-01-26,109,,DAL,W 109-98,240,37,72,.514,28,50,.560,9,22,.409,26,36,.722,109,38,84,.452,27,58,.466,11,26,.423,11,13,.846,98
947,IND,2017-01-26,109,@,MIN,W 109-103,240,42,81,.519,32,63,.508,10,18,.556,15,17,.882,109,36,81,.444,26,54,.481,10,27,.370,21,27,.778,103
948,HOU,2017-01-25,109,@,BOS,L 109-120,240,36,77,.468,26,46,.565,10,31,.323,27,38,.711,109,47,91,.516,36,59,.610,11,32,.344,15,16,.938,120
949,MIA,2017-01-25,109,@,BRK,W 109-106,240,40,83,.482,29,60,.483,11,23,.478,18,25,.720,109,35,80,.438,22,45,.489,13,35,.371,23,26,.885,106
950,MIL,2017-01-25,109,,PHI,L 109-114,240,42,91,.462,35,63,.556,7,28,.250,18,23,.783,109,40,75,.533,28,49,.571,12,26,.462,22,25,.880,114
951,SAC,2017-01-23,109,@,DET,W 109-104,240,40,82,.488,31,61,.508,9,21,.429,20,26,.769,109,41,82,.500,31,54,.574,10,28,.357,12,17,.706,104
952,WAS,2017-01-23,109,@,CHO,W 109-99,240,43,80,.538,33,55,.600,10,25,.400,13,17,.765,109,35,90,.389,27,58,.466,8,32,.250,21,25,.840,99
953,NYK,2017-01-23,109,@,IND,W 109-103,240,35,76,.461,27,54,.500,8,22,.364,31,35,.886,109,38,86,.442,31,60,.517,7,26,.269,20,25,.800,103
954,UTA,2017-01-21,109,,IND,W 109-100,240,39,84,.464,33,60,.550,6,24,.250,25,32,.781,109,39,77,.506,29,57,.509,10,20,.500,12,17,.706,100
955,MIA,2017-01-21,109,,MIL,W 109-97,240,41,77,.532,28,47,.596,13,30,.433,14,22,.636,109,33,79,.418,27,61,.443,6,18,.333,25,32,.781,97
956,BRK,2017-01-17,109,,TOR,L 109-119,240,40,89,.449,33,63,.524,7,26,.269,22,24,.917,109,48,92,.522,38,73,.521,10,19,.526,13,16,.813,119
957,MIA,2017-01-17,109,,HOU,W 109-103,240,42,90,.467,33,61,.541,9,29,.310,16,24,.667,109,36,90,.400,27,51,.529,9,39,.231,22,28,.786,103
958,WAS,2017-01-14,109,,PHI,W 109-93,240,44,91,.484,36,74,.486,8,17,.471,13,18,.722,109,36,87,.414,26,56,.464,10,31,.323,11,21,.524,93
959,POR,2017-01-13,109,,ORL,L 109-115,240,39,97,.402,29,63,.460,10,34,.294,21,25,.840,109,41,83,.494,31,65,.477,10,18,.556,23,26,.885,115
960,MIL,2017-01-10,109,@,SAS,W 109-107,240,44,84,.524,34,65,.523,10,19,.526,11,13,.846,109,42,88,.477,30,58,.517,12,30,.400,11,14,.786,107
961,OKC,2017-01-09,109,@,CHI,W 109-94,240,47,83,.566,40,59,.678,7,24,.292,8,11,.727,109,34,83,.410,27,64,.422,7,19,.368,19,22,.864,94
962,NYK,2017-01-07,109,@,IND,L 109-123,240,40,87,.460,28,56,.500,12,31,.387,17,24,.708,109,43,86,.500,32,62,.516,11,24,.458,26,28,.929,123
963,BRK,2017-01-05,109,@,IND,L 109-121,240,41,90,.456,24,52,.462,17,38,.447,10,13,.769,109,48,93,.516,38,71,.535,10,22,.455,15,19,.789,121
964,LAL,2017-01-05,109,@,POR,L 109-118,240,36,86,.419,26,55,.473,10,31,.323,27,33,.818,109,43,81,.531,31,48,.646,12,33,.364,20,30,.667,118
965,LAC,2017-01-02,109,,PHO,W 109-98,240,37,80,.463,30,64,.469,7,16,.438,28,38,.737,109,39,102,.382,37,87,.425,2,15,.133,18,22,.818,98
966,CHO,2016-12-31,109,,CLE,L 109-121,240,40,78,.513,31,54,.574,9,24,.375,20,23,.870,109,43,85,.506,29,54,.537,14,31,.452,21,25,.840,121
967,CLE,2016-12-25,109,,GSW,W 109-108,240,37,95,.389,25,60,.417,12,35,.343,23,32,.719,109,37,77,.481,28,47,.596,9,30,.300,25,29,.862,108
968,ATL,2016-12-23,109,@,DEN,W 109-108,240,37,86,.430,29,61,.475,8,25,.320,27,33,.818,109,37,78,.474,29,53,.547,8,25,.320,26,35,.743,108
969,SAC,2016-12-23,109,@,MIN,W 109-105,240,42,80,.525,27,51,.529,15,29,.517,10,14,.714,109,36,79,.456,24,47,.511,12,32,.375,21,26,.808,105
970,HOU,2016-12-23,109,@,MEM,L 109-115,240,38,89,.427,18,37,.486,20,52,.385,13,15,.867,109,41,81,.506,28,56,.500,13,25,.520,20,25,.800,115
971,ORL,2016-12-23,109,,LAL,W 109-90,240,45,89,.506,34,62,.548,11,27,.407,8,14,.571,109,31,87,.356,23,64,.359,8,23,.348,20,24,.833,90
972,BOS,2016-12-22,109,@,IND,W 109-102,240,38,92,.413,28,53,.528,10,39,.256,23,27,.852,109,35,82,.427,28,59,.475,7,23,.304,25,29,.862,102
973,MEM,2016-12-20,109,,BOS,L 109-112 (OT),265,38,94,.404,26,64,.406,12,30,.400,21,26,.808,109,33,81,.407,21,44,.477,12,37,.324,34,38,.895,112
974,TOR,2016-12-18,109,@,ORL,W 109-79,240,43,87,.494,36,60,.600,7,27,.259,16,21,.762,109,34,83,.410,31,62,.500,3,21,.143,8,9,.889,79
975,MIN,2016-12-17,109,,HOU,L 109-111 (OT),265,41,92,.446,34,71,.479,7,21,.333,20,27,.741,109,39,96,.406,22,45,.489,17,51,.333,16,20,.800,111
976,WAS,2016-12-14,109,,CHO,W 109-106,240,45,87,.517,40,69,.580,5,18,.278,14,17,.824,109,38,74,.514,24,41,.585,14,33,.424,16,21,.762,106
977,UTA,2016-12-14,109,,OKC,W 109-89,240,42,72,.583,29,49,.592,13,23,.565,12,15,.800,109,30,82,.366,24,63,.381,6,19,.316,23,27,.852,89
978,NOP,2016-12-13,109,,GSW,L 109-113,240,39,82,.476,25,47,.532,14,35,.400,17,21,.810,109,42,95,.442,28,61,.459,14,34,.412,15,19,.789,113
979,HOU,2016-12-10,109,,DAL,W 109-87,240,37,74,.500,18,37,.486,19,37,.514,16,22,.727,109,32,79,.405,21,45,.467,11,34,.324,12,14,.857,87
980,CHO,2016-12-09,109,,ORL,W 109-88,240,41,85,.482,32,63,.508,9,22,.409,18,23,.783,109,34,91,.374,25,57,.439,9,34,.265,11,14,.786,88
981,IND,2016-12-07,109,@,PHO,W 109-94,240,35,78,.449,28,55,.509,7,23,.304,32,41,.780,109,34,85,.400,25,52,.481,9,33,.273,17,18,.944,94
982,CHO,2016-12-05,109,@,DAL,W 109-101,240,40,79,.506,37,61,.607,3,18,.167,26,28,.929,109,37,89,.416,24,53,.453,13,36,.361,14,18,.778,101
983,PHO,2016-12-03,109,@,GSW,L 109-138,240,41,91,.451,30,59,.508,11,32,.344,16,21,.762,109,49,78,.628,35,57,.614,14,21,.667,26,34,.765,138
984,PHO,2016-11-30,109,,ATL,W 109-107,240,40,89,.449,30,68,.441,10,21,.476,19,25,.760,109,45,89,.506,36,64,.563,9,25,.360,8,10,.800,107
985,IND,2016-11-30,109,@,POR,L 109-131,240,36,72,.500,30,58,.517,6,14,.429,31,35,.886,109,51,94,.543,39,62,.629,12,32,.375,17,19,.895,131
986,LAL,2016-11-27,109,,ATL,W 109-94,240,42,95,.442,34,75,.453,8,20,.400,17,20,.850,109,39,88,.443,27,53,.509,12,35,.343,4,10,.400,94
987,SAS,2016-11-25,109,@,BOS,W 109-103,240,38,81,.469,27,57,.474,11,24,.458,22,25,.880,109,42,91,.462,30,57,.526,12,34,.353,7,9,.778,103
988,GSW,2016-11-25,109,@,LAL,W 109-85,240,43,83,.518,32,55,.582,11,28,.393,12,17,.706,109,32,90,.356,27,68,.397,5,22,.227,16,23,.696,85
989,OKC,2016-11-22,109,@,LAL,L 109-111,240,45,92,.489,34,65,.523,11,27,.407,8,11,.727,109,42,83,.506,28,56,.500,14,27,.519,13,16,.813,111
990,BRK,2016-11-20,109,,POR,L 109-129,240,37,93,.398,27,58,.466,10,35,.286,25,31,.806,109,49,85,.576,34,49,.694,15,36,.417,16,21,.762,129
991,POR,2016-11-17,109,@,HOU,L 109-126,240,41,90,.456,31,62,.500,10,28,.357,17,21,.810,109,46,95,.484,32,63,.508,14,32,.438,20,25,.800,126
992,PHI,2016-11-16,109,,WAS,W 109-102,240,42,77,.545,32,49,.653,10,28,.357,15,22,.682,109,38,91,.418,30,68,.441,8,23,.348,18,25,.720,102
993,PHI,2016-11-11,109,,IND,W 109-105 (OT),265,36,86,.419,25,54,.463,11,32,.344,26,31,.839,109,39,88,.443,34,69,.493,5,19,.263,22,23,.957,105
994,DAL,2016-11-08,109,@,LAL,W 109-97,240,43,82,.524,33,59,.559,10,23,.435,13,15,.867,109,38,78,.487,28,52,.538,10,26,.385,11,14,.786,97
995,UTA,2016-11-07,109,@,PHI,W 109-84,240,43,85,.506,32,66,.485,11,19,.579,12,20,.600,109,31,77,.403,24,56,.429,7,21,.333,15,22,.682,84
996,NYK,2016-11-06,109,,UTA,L 109-114,240,42,83,.506,34,63,.540,8,20,.400,17,19,.895,109,38,75,.507,30,50,.600,8,25,.320,30,35,.857,114
997,CHO,2016-11-02,109,,PHI,W 109-93,240,39,79,.494,26,45,.578,13,34,.382,18,26,.692,109,34,86,.395,22,48,.458,12,38,.316,13,15,.867,93
998,BRK,2016-11-02,109,,DET,W 109-101,240,41,76,.539,28,49,.571,13,27,.481,14,17,.824,109,37,88,.420,28,63,.444,9,25,.360,18,21,.857,101
999,TOR,2016-10-26,109,,DET,W 109-91,240,41,86,.477,38,68,.559,3,18,.167,24,29,.828,109,35,84,.417,31,62,.500,4,22,.182,17,22,.773,91
1000,LAL,2017-04-11,108,,NOP,W 108-96,240,42,88,.477,34,66,.515,8,22,.364,16,23,.696,108,37,79,.468,30,57,.526,7,22,.318,15,20,.750,96
1001,IND,2017-04-04,108,,TOR,W 108-90,240,39,89,.438,27,64,.422,12,25,.480,18,18,1.000,108,34,76,.447,29,53,.547,5,23,.217,17,19,.895,90
1002,LAL,2017-04-02,108,,MEM,W 108-103,240,40,85,.471,33,66,.500,7,19,.368,21,27,.778,108,40,80,.500,27,50,.540,13,30,.433,10,14,.714,103
1003,MIL,2017-03-31,108,,DET,W 108-105 (OT),265,35,84,.417,21,48,.438,14,36,.389,24,34,.706,108,44,97,.454,37,67,.552,7,30,.233,10,16,.625,105
1004,CHO,2017-03-28,108,,MIL,L 108-118,240,39,80,.488,32,52,.615,7,28,.250,23,29,.793,108,46,74,.622,32,44,.727,14,30,.467,12,17,.706,118
1005,LAL,2017-03-28,108,,WAS,L 108-119,240,43,85,.506,35,63,.556,8,22,.364,14,16,.875,108,48,94,.511,42,71,.592,6,23,.261,17,25,.680,119
1006,UTA,2017-03-27,108,,NOP,W 108-100,240,41,85,.482,26,58,.448,15,27,.556,11,18,.611,108,37,80,.463,27,55,.491,10,25,.400,16,24,.667,100
1007,MIA,2017-03-26,108,@,BOS,L 108-112,240,41,91,.451,34,62,.548,7,29,.241,19,24,.792,108,41,77,.532,33,53,.623,8,24,.333,22,25,.880,112
1008,LAC,2017-03-25,108,,UTA,W 108-95,240,38,84,.452,31,57,.544,7,27,.259,25,28,.893,108,37,86,.430,29,60,.483,8,26,.308,13,18,.722,95
1009,BRK,2017-03-24,108,@,WAS,L 108-129,240,43,82,.524,40,67,.597,3,15,.200,19,26,.731,108,49,97,.505,39,71,.549,10,26,.385,21,22,.955,129
1010,UTA,2017-03-22,108,,NYK,W 108-101,240,41,90,.456,34,62,.548,7,28,.250,19,29,.655,108,38,80,.475,29,59,.492,9,21,.429,16,18,.889,101
1011,LAC,2017-03-18,108,,CLE,W 108-78,240,40,78,.513,32,52,.615,8,26,.308,20,29,.690,108,32,83,.386,27,56,.482,5,27,.185,9,13,.692,78
1012,LAC,2017-03-13,108,@,UTA,L 108-114,240,39,78,.500,27,48,.563,12,30,.400,18,23,.783,108,41,78,.526,27,57,.474,14,21,.667,18,22,.818,114
1013,PHI,2017-03-09,108,@,POR,L 108-114 (OT),265,41,94,.436,30,65,.462,11,29,.379,15,20,.750,108,40,88,.455,34,67,.507,6,21,.286,28,33,.848,114
1014,MIA,2017-03-08,108,,CHO,W 108-101,240,37,85,.435,20,44,.455,17,41,.415,17,24,.708,108,37,80,.463,30,59,.508,7,21,.333,20,21,.952,101
1015,HOU,2017-03-08,108,,UTA,L 108-115,240,35,79,.443,27,47,.574,8,32,.250,30,40,.750,108,41,76,.539,29,45,.644,12,31,.387,21,24,.875,115
1016,DEN,2017-03-06,108,,SAC,W 108-96,240,37,74,.500,24,44,.545,13,30,.433,21,28,.750,108,36,83,.434,30,67,.448,6,16,.375,18,21,.857,96
1017,MEM,2017-03-04,108,@,HOU,L 108-123,240,43,97,.443,35,69,.507,8,28,.286,14,21,.667,108,39,78,.500,21,36,.583,18,42,.429,27,36,.750,123
1018,GSW,2017-02-28,108,@,WAS,L 108-112,240,39,84,.464,31,55,.564,8,29,.276,22,27,.815,108,41,91,.451,29,63,.460,12,28,.429,18,20,.900,112
1019,PHI,2017-02-27,108,,GSW,L 108-119,240,37,82,.451,27,48,.563,10,34,.294,24,27,.889,108,40,89,.449,34,60,.567,6,29,.207,33,39,.846,119
1020,HOU,2017-02-27,108,,IND,L 108-117,240,32,88,.364,22,43,.512,10,45,.222,34,42,.810,108,41,91,.451,28,61,.459,13,30,.433,22,25,.880,117
1021,MIA,2017-02-24,108,@,ATL,W 108-90,240,40,99,.404,23,62,.371,17,37,.459,11,13,.846,108,30,79,.380,24,59,.407,6,20,.300,24,36,.667,90
1022,CHO,2017-02-23,108,@,DET,L 108-114 (OT),265,38,92,.413,31,62,.500,7,30,.233,25,26,.962,108,44,107,.411,29,70,.414,15,37,.405,11,12,.917,114
1023,PHI,2017-02-15,108,@,BOS,L 108-116,240,44,93,.473,36,62,.581,8,31,.258,12,18,.667,108,38,80,.475,25,52,.481,13,28,.464,27,36,.750,116
1024,MIN,2017-02-14,108,,CLE,L 108-116,240,42,86,.488,33,63,.524,9,23,.391,15,19,.789,108,44,86,.512,31,47,.660,13,39,.333,15,22,.682,116
1025,PHO,2017-02-13,108,,NOP,L 108-110,240,40,93,.430,32,70,.457,8,23,.348,20,24,.833,108,37,78,.474,29,50,.580,8,28,.286,28,35,.800,110
1026,MIA,2017-02-10,108,@,BRK,W 108-99,240,41,92,.446,34,69,.493,7,23,.304,19,21,.905,108,35,81,.432,27,61,.443,8,20,.400,21,28,.750,99
1027,SAC,2017-02-10,108,,ATL,W 108-107,240,38,80,.475,20,44,.455,18,36,.500,14,21,.667,108,36,71,.507,25,41,.610,11,30,.367,24,31,.774,107
1028,SAC,2017-02-08,108,,BOS,W 108-92,240,42,84,.500,32,59,.542,10,25,.400,14,15,.933,108,29,73,.397,19,41,.463,10,32,.313,24,27,.889,92
1029,DAL,2017-02-03,108,@,POR,W 108-104,240,36,76,.474,19,45,.422,17,31,.548,19,23,.826,108,40,88,.455,31,58,.534,9,30,.300,15,20,.750,104
1030,MIN,2017-02-03,108,@,DET,L 108-116,240,44,89,.494,39,72,.542,5,17,.294,15,19,.789,108,44,98,.449,33,72,.458,11,26,.423,17,22,.773,116
1031,HOU,2017-02-02,108,,ATL,L 108-113,240,35,93,.376,22,42,.524,13,51,.255,25,33,.758,108,44,85,.518,36,55,.655,8,30,.267,17,23,.739,113
1032,LAL,2017-02-02,108,@,WAS,L 108-116,240,40,87,.460,28,48,.583,12,39,.308,16,22,.727,108,44,96,.458,32,63,.508,12,33,.364,16,21,.762,116
1033,SAS,2017-01-31,108,,OKC,W 108-94,240,37,86,.430,30,65,.462,7,21,.333,27,38,.711,108,30,85,.353,23,57,.404,7,28,.250,27,32,.844,94
1034,TOR,2017-01-31,108,,NOP,W 108-106 (OT),265,43,94,.457,33,63,.524,10,31,.323,12,15,.800,108,40,94,.426,28,64,.438,12,30,.400,14,19,.737,106
1035,PHI,2017-01-29,108,@,CHI,L 108-121,240,44,99,.444,34,71,.479,10,28,.357,10,14,.714,108,45,89,.506,37,75,.493,8,14,.571,23,28,.821,121
1036,MIL,2017-01-28,108,,BOS,L 108-112 (OT),265,37,87,.425,28,66,.424,9,21,.429,25,32,.781,108,37,89,.416,23,48,.479,14,41,.341,24,30,.800,112
1037,SAS,2017-01-24,108,@,TOR,W 108-106,240,38,85,.447,31,61,.508,7,24,.292,25,33,.758,108,38,84,.452,32,59,.542,6,25,.240,24,28,.857,106
1038,BOS,2017-01-24,108,@,WAS,L 108-123,240,38,84,.452,28,51,.549,10,33,.303,22,24,.917,108,48,84,.571,39,64,.609,9,20,.450,18,21,.857,123
1039,DEN,2017-01-22,108,@,MIN,L 108-111,240,42,82,.512,35,58,.603,7,24,.292,17,21,.810,108,45,85,.529,39,70,.557,6,15,.400,15,21,.714,111
1040,HOU,2017-01-20,108,,GSW,L 108-125,240,43,96,.448,36,61,.590,7,35,.200,15,18,.833,108,47,89,.528,32,51,.627,15,38,.395,16,21,.762,125
1041,LAL,2017-01-20,108,,IND,W 108-95,240,41,87,.471,27,54,.500,14,33,.424,12,15,.800,108,34,80,.425,25,57,.439,9,23,.391,18,25,.720,95
1042,BOS,2017-01-16,108,,CHO,W 108-98,240,42,84,.500,27,45,.600,15,39,.385,9,10,.900,108,38,86,.442,30,61,.492,8,25,.320,14,17,.824,98
1043,ATL,2017-01-16,108,@,NYK,W 108-107,240,40,87,.460,28,55,.509,12,32,.375,16,23,.696,108,42,85,.494,34,59,.576,8,26,.308,15,23,.652,107
1044,CHI,2017-01-15,108,@,MEM,W 108-104,240,40,78,.513,36,61,.590,4,17,.235,24,35,.686,108,40,95,.421,29,63,.460,11,32,.344,13,13,1.000,104
1045,PHO,2017-01-14,108,,SAS,W 108-105,240,39,85,.459,31,64,.484,8,21,.381,22,24,.917,108,36,71,.507,27,51,.529,9,20,.450,24,34,.706,105
1046,MIA,2017-01-13,108,@,MIL,L 108-116,240,41,83,.494,29,51,.569,12,32,.375,14,18,.778,108,40,80,.500,31,65,.477,9,15,.600,27,31,.871,116
1047,SAC,2017-01-13,108,,CLE,L 108-120,240,42,80,.525,33,55,.600,9,25,.360,15,19,.789,108,44,87,.506,29,50,.580,15,37,.405,17,22,.773,120
1048,PHO,2017-01-12,108,,DAL,L 108-113,240,38,78,.487,28,60,.467,10,18,.556,22,27,.815,108,43,89,.483,28,55,.509,15,34,.441,12,17,.706,113
1049,WAS,2017-01-11,108,@,BOS,L 108-117,240,45,105,.429,35,79,.443,10,26,.385,8,12,.667,108,43,85,.506,26,44,.591,17,41,.415,14,18,.778,117
1050,POR,2017-01-10,108,@,LAL,W 108-87,240,43,85,.506,36,64,.563,7,21,.333,15,20,.750,108,32,83,.386,23,59,.390,9,24,.375,14,26,.538,87
1051,NOP,2017-01-07,108,@,BOS,L 108-117,240,40,85,.471,30,54,.556,10,31,.323,18,23,.783,108,40,93,.430,22,57,.386,18,36,.500,19,21,.905,117
1052,BRK,2017-01-06,108,,CLE,L 108-116,240,41,91,.451,32,61,.525,9,30,.300,17,19,.895,108,38,88,.432,29,55,.527,9,33,.273,31,43,.721,116
1053,GSW,2016-12-30,108,,DAL,W 108-99,240,42,84,.500,31,51,.608,11,33,.333,13,15,.867,108,39,93,.419,31,61,.508,8,32,.250,13,15,.867,99
1054,GSW,2016-12-25,108,@,CLE,L 108-109,240,37,77,.481,28,47,.596,9,30,.300,25,29,.862,108,37,95,.389,25,60,.417,12,35,.343,23,32,.719,109
1055,DEN,2016-12-23,108,,ATL,L 108-109,240,37,78,.474,29,53,.547,8,25,.320,26,35,.743,108,37,86,.430,29,61,.475,8,25,.320,27,33,.818,109
1056,NOP,2016-12-20,108,@,PHI,W 108-93,240,40,93,.430,30,76,.395,10,17,.588,18,26,.692,108,33,82,.402,22,49,.449,11,33,.333,16,21,.762,93
1057,MIL,2016-12-20,108,,CLE,L 108-114 (OT),265,40,87,.460,33,60,.550,7,27,.259,21,29,.724,108,37,91,.407,20,51,.392,17,40,.425,23,27,.852,114
1058,OKC,2016-12-19,108,,ATL,L 108-110,240,39,87,.448,29,52,.558,10,35,.286,20,26,.769,108,41,75,.547,32,52,.615,9,23,.391,19,24,.792,110
1059,PHO,2016-12-19,108,@,MIN,L 108-115,240,37,82,.451,28,61,.459,9,21,.429,25,35,.714,108,42,86,.488,35,67,.522,7,19,.368,24,25,.960,115
1060,PHI,2016-12-18,108,,BRK,W 108-107,240,38,88,.432,26,60,.433,12,28,.429,20,23,.870,108,36,81,.444,24,47,.511,12,34,.353,23,31,.742,107
1061,LAL,2016-12-17,108,@,CLE,L 108-119,240,41,86,.477,25,49,.510,16,37,.432,10,13,.769,108,46,89,.517,31,56,.554,15,33,.455,12,18,.667,119
1062,DET,2016-12-16,108,@,WAS,L 108-122,240,42,86,.488,32,58,.552,10,28,.357,14,21,.667,108,44,77,.571,32,52,.615,12,25,.480,22,27,.815,122
1063,MIL,2016-12-15,108,,CHI,W 108-97,240,45,95,.474,34,75,.453,11,20,.550,7,13,.538,108,35,74,.473,30,54,.556,5,20,.250,22,29,.759,97
1064,ORL,2016-12-14,108,,LAC,L 108-113,240,42,89,.472,28,56,.500,14,33,.424,10,20,.500,108,37,74,.500,24,49,.490,13,25,.520,26,37,.703,113
1065,SAS,2016-12-14,108,,BOS,W 108-101,240,44,80,.550,36,58,.621,8,22,.364,12,14,.857,108,37,84,.440,27,53,.509,10,31,.323,17,20,.850,101
1066,MIN,2016-12-11,108,,GSW,L 108-116,240,36,81,.444,27,57,.474,9,24,.375,27,36,.750,108,38,83,.458,25,51,.490,13,32,.406,27,30,.900,116
1067,NOP,2016-12-05,108,,MEM,L 108-110 (2OT),290,39,99,.394,29,67,.433,10,32,.313,20,21,.952,108,42,104,.404,29,70,.414,13,34,.382,13,21,.619,110
1068,PHI,2016-11-27,108,,CLE,L 108-112,240,43,92,.467,28,58,.483,15,34,.441,7,10,.700,108,38,92,.413,26,52,.500,12,40,.300,24,28,.857,112
1069,DET,2016-11-25,108,,LAC,W 108-97,240,47,90,.522,38,71,.535,9,19,.474,5,7,.714,108,35,73,.479,28,52,.538,7,21,.333,20,26,.769,97
1070,UTA,2016-11-23,108,,DEN,W 108-83,240,39,79,.494,31,53,.585,8,26,.308,22,31,.710,108,28,88,.318,19,61,.311,9,27,.333,18,31,.581,83
1071,MIN,2016-11-15,108,,CHO,L 108-115,240,38,89,.427,23,54,.426,15,35,.429,17,21,.810,108,43,80,.538,32,56,.571,11,24,.458,18,22,.818,115
1072,OKC,2016-11-11,108,,LAC,L 108-110,240,38,88,.432,22,60,.367,16,28,.571,16,19,.842,108,39,86,.453,28,59,.475,11,27,.407,21,35,.600,110
1073,MEM,2016-11-08,108,,DEN,W 108-107,240,44,86,.512,37,62,.597,7,24,.292,13,19,.684,108,35,70,.500,25,46,.543,10,24,.417,27,34,.794,107
1074,PHO,2016-11-06,108,@,LAL,L 108-119,240,40,91,.440,34,71,.479,6,20,.300,22,28,.786,108,41,90,.456,31,67,.463,10,23,.435,27,35,.771,119
1075,LAL,2016-11-01,108,@,IND,L 108-115,240,40,89,.449,34,61,.557,6,28,.214,22,25,.880,108,41,87,.471,31,59,.525,10,28,.357,23,29,.793,115
1076,MIA,2016-11-01,108,,SAC,W 108-96 (OT),265,37,86,.430,24,57,.421,13,29,.448,21,29,.724,108,34,89,.382,29,66,.439,5,23,.217,23,27,.852,96
1077,BRK,2016-10-29,108,@,MIL,L 108-110,240,37,84,.440,26,50,.520,11,34,.324,23,28,.821,108,41,88,.466,33,66,.500,8,22,.364,20,24,.833,110
1078,DET,2016-10-28,108,,ORL,W 108-82,240,48,95,.505,41,76,.539,7,19,.368,5,6,.833,108,33,95,.347,25,69,.362,8,26,.308,8,12,.667,82
1079,MIA,2016-10-26,108,@,ORL,W 108-96,240,47,97,.485,43,81,.531,4,16,.250,10,16,.625,108,34,89,.382,28,71,.394,6,18,.333,22,28,.786,96
1080,BRK,2017-04-08,107,,CHI,W 107-106,240,39,92,.424,29,61,.475,10,31,.323,19,24,.792,107,40,90,.444,29,66,.439,11,24,.458,15,17,.882,106
1081,BRK,2017-04-06,107,@,ORL,L 107-115,240,40,87,.460,29,57,.509,11,30,.367,16,22,.727,107,42,90,.467,33,65,.508,9,25,.360,22,26,.846,115
1082,MIN,2017-04-04,107,@,GSW,L 107-121,240,41,96,.427,37,77,.481,4,19,.211,21,26,.808,107,44,84,.524,30,52,.577,14,32,.438,19,24,.792,121
1083,GSW,2017-03-31,107,,HOU,W 107-98,240,43,95,.453,32,63,.508,11,32,.344,10,14,.714,107,34,91,.374,22,54,.407,12,37,.324,18,23,.783,98
1084,HOU,2017-03-30,107,@,POR,L 107-117,240,40,91,.440,32,57,.561,8,34,.235,19,23,.826,107,43,90,.478,30,57,.526,13,33,.394,18,22,.818,117
1085,BRK,2017-03-26,107,@,ATL,W 107-92,240,38,86,.442,32,64,.500,6,22,.273,25,30,.833,107,34,98,.347,29,71,.408,5,27,.185,19,32,.594,92
1086,IND,2017-03-26,107,,PHI,W 107-94,240,38,89,.427,31,72,.431,7,17,.412,24,29,.828,107,35,88,.398,21,47,.447,14,41,.341,10,14,.714,94
1087,CHI,2017-03-24,107,,PHI,L 107-117,240,37,91,.407,27,67,.403,10,24,.417,23,31,.742,107,46,83,.554,38,58,.655,8,25,.320,17,23,.739,117
1088,NOP,2017-03-24,107,@,HOU,L 107-117,240,41,91,.451,27,53,.509,14,38,.368,11,14,.786,107,44,93,.473,30,54,.556,14,39,.359,15,20,.750,117
1089,IND,2017-03-20,107,,UTA,W 107-100,240,38,87,.437,28,67,.418,10,20,.500,21,23,.913,107,40,88,.455,34,63,.540,6,25,.240,14,20,.700,100
1090,MIL,2017-03-17,107,@,LAL,W 107-103,240,40,82,.488,36,58,.621,4,24,.167,23,30,.767,107,38,84,.452,27,55,.491,11,29,.379,16,26,.615,103
1091,CHI,2017-03-17,107,@,WAS,L 107-112,240,44,88,.500,37,61,.607,7,27,.259,12,18,.667,107,46,101,.455,36,75,.480,10,26,.385,10,12,.833,112
1092,WAS,2017-03-15,107,,DAL,L 107-112,240,40,82,.488,28,52,.538,12,30,.400,15,21,.714,107,40,79,.506,26,47,.553,14,32,.438,18,25,.720,112
1093,SAC,2017-03-15,107,@,PHO,W 107-101,240,38,79,.481,32,65,.492,6,14,.429,25,34,.735,107,43,107,.402,37,82,.451,6,25,.240,9,14,.643,101
1094,SAS,2017-03-13,107,,ATL,W 107-99,240,39,81,.481,23,47,.489,16,34,.471,13,17,.765,107,37,81,.457,31,59,.525,6,22,.273,19,30,.633,99
1095,SAS,2017-03-11,107,,GSW,W 107-85,240,40,77,.519,28,50,.560,12,27,.444,15,18,.833,107,33,92,.359,28,75,.373,5,17,.294,14,23,.609,85
1096,ATL,2017-03-11,107,@,MEM,W 107-90,240,36,72,.500,21,42,.500,15,30,.500,20,26,.769,107,34,90,.378,29,61,.475,5,29,.172,17,23,.739,90
1097,MIN,2017-03-08,107,,LAC,W 107-91,240,42,86,.488,37,66,.561,5,20,.250,18,20,.900,107,35,83,.422,26,59,.441,9,24,.375,12,18,.667,91
1098,MIN,2017-03-01,107,@,UTA,W 107-80,240,39,78,.500,31,62,.500,8,16,.500,21,26,.808,107,35,90,.389,31,71,.437,4,19,.211,6,11,.545,80
1099,CHI,2017-02-28,107,,DEN,L 107-125,240,44,96,.458,34,70,.486,10,26,.385,9,10,.900,107,45,80,.563,32,50,.640,13,30,.433,22,24,.917,125
1100,TOR,2017-02-24,107,,BOS,W 107-97,240,40,81,.494,35,66,.530,5,15,.333,22,29,.759,107,33,78,.423,21,40,.525,12,38,.316,19,22,.864,97
1101,SAS,2017-02-15,107,@,ORL,W 107-79,240,42,89,.472,34,58,.586,8,31,.258,15,19,.789,107,30,76,.395,26,58,.448,4,18,.222,15,19,.789,79
1102,MIA,2017-02-13,107,,ORL,L 107-116,240,39,83,.470,33,61,.541,6,22,.273,23,27,.852,107,44,90,.489,36,76,.474,8,14,.571,20,29,.690,116
1103,LAC,2017-02-11,107,@,CHO,W 107-102,240,40,85,.471,26,51,.510,14,34,.412,13,20,.650,107,37,85,.435,24,48,.500,13,37,.351,15,20,.750,102
1104,MEM,2017-02-10,107,,GSW,L 107-122,240,34,87,.391,25,61,.410,9,26,.346,30,37,.811,107,39,77,.506,24,44,.545,15,33,.455,29,38,.763,122
1105,ATL,2017-02-10,107,@,SAC,L 107-108,240,36,71,.507,25,41,.610,11,30,.367,24,31,.774,107,38,80,.475,20,44,.455,18,36,.500,14,21,.667,108
1106,IND,2017-02-10,107,@,WAS,L 107-112,240,45,92,.489,41,71,.577,4,21,.190,13,15,.867,107,41,88,.466,31,59,.525,10,29,.345,20,30,.667,112
1107,HOU,2017-02-09,107,@,CHO,W 107-95,240,39,87,.448,26,47,.553,13,40,.325,16,20,.800,107,37,85,.435,29,59,.492,8,26,.308,13,14,.929,95
1108,BRK,2017-02-07,107,@,CHO,L 107-111,240,39,86,.453,27,50,.540,12,36,.333,17,21,.810,107,40,102,.392,33,76,.434,7,26,.269,24,29,.828,111
1109,NYK,2017-02-06,107,,LAL,L 107-121,240,37,82,.451,30,61,.492,7,21,.333,26,33,.788,107,44,102,.431,36,74,.486,8,28,.286,25,31,.806,121
1110,SAC,2017-02-06,107,,CHI,L 107-112,240,41,79,.519,30,51,.588,11,28,.393,14,16,.875,107,43,81,.531,37,62,.597,6,19,.316,20,31,.645,112
1111,BOS,2017-02-05,107,,LAC,W 107-102,240,37,88,.420,21,36,.583,16,52,.308,17,20,.850,107,35,84,.417,25,55,.455,10,29,.345,22,28,.786,102
1112,MEM,2017-02-04,107,@,MIN,W 107-99,240,32,77,.416,22,49,.449,10,28,.357,33,39,.846,107,35,84,.417,25,58,.431,10,26,.385,19,24,.792,99
1113,LAL,2017-02-03,107,@,BOS,L 107-113,240,37,94,.394,23,56,.411,14,38,.368,19,26,.731,107,39,82,.476,26,47,.553,13,35,.371,22,28,.786,113
1114,WAS,2017-01-29,107,@,NOP,W 107-94,240,45,89,.506,35,68,.515,10,21,.476,7,10,.700,107,38,84,.452,28,52,.538,10,32,.313,8,15,.533,94
1115,CLE,2017-01-29,107,,OKC,W 107-91,240,41,92,.446,33,63,.524,8,29,.276,17,22,.773,107,37,100,.370,31,74,.419,6,26,.231,11,16,.688,91
1116,CHO,2017-01-27,107,@,NYK,L 107-110,240,40,90,.444,27,53,.509,13,37,.351,14,15,.933,107,46,96,.479,37,69,.536,9,27,.333,9,13,.692,110
1117,PHO,2017-01-21,107,@,NYK,W 107-105,240,37,85,.435,28,61,.459,9,24,.375,24,27,.889,107,40,89,.449,29,68,.426,11,21,.524,14,16,.875,105
1118,MEM,2017-01-20,107,,SAC,W 107-91,240,38,83,.458,27,55,.491,11,28,.393,20,25,.800,107,31,76,.408,25,47,.532,6,29,.207,23,32,.719,91
1119,DAL,2017-01-20,107,,UTA,L 107-112 (OT),265,39,87,.448,31,64,.484,8,23,.348,21,28,.750,107,38,83,.458,30,60,.500,8,23,.348,28,39,.718,112
1120,CHO,2017-01-18,107,,POR,W 107-85,240,41,87,.471,30,61,.492,11,26,.423,14,17,.824,107,33,94,.351,25,63,.397,8,31,.258,11,11,1.000,85
1121,NYK,2017-01-16,107,,ATL,L 107-108,240,42,85,.494,34,59,.576,8,26,.308,15,23,.652,107,40,87,.460,28,55,.509,12,32,.375,16,23,.696,108
1122,CHI,2017-01-14,107,,NOP,W 107-99,240,43,101,.426,35,81,.432,8,20,.400,13,23,.565,107,39,84,.464,32,61,.525,7,23,.304,14,21,.667,99
1123,ORL,2017-01-14,107,@,UTA,L 107-114,240,38,82,.463,26,48,.542,12,34,.353,19,27,.704,107,41,83,.494,34,57,.596,7,26,.269,25,36,.694,114
1124,DET,2017-01-12,107,@,GSW,L 107-127,240,43,88,.489,37,60,.617,6,28,.214,15,20,.750,107,50,89,.562,35,60,.583,15,29,.517,12,18,.667,127
1125,SAS,2017-01-10,107,,MIL,L 107-109,240,42,88,.477,30,58,.517,12,30,.400,11,14,.786,107,44,84,.524,34,65,.523,10,19,.526,11,13,.846,109
1126,GSW,2017-01-10,107,,MIA,W 107-95,240,39,86,.453,28,59,.475,11,27,.407,18,22,.818,107,38,90,.422,32,60,.533,6,30,.200,13,17,.765,95
1127,WAS,2017-01-08,107,@,MIL,W 107-101,240,41,84,.488,31,52,.596,10,32,.313,15,18,.833,107,37,80,.463,28,57,.491,9,23,.391,18,20,.900,101
1128,MIA,2017-01-04,107,@,SAC,W 107-102,240,35,72,.486,23,44,.523,12,28,.429,25,29,.862,107,40,78,.513,32,58,.552,8,20,.400,14,17,.824,102
1129,DET,2017-01-01,107,@,MIA,W 107-98,240,42,86,.488,33,64,.516,9,22,.409,14,22,.636,107,35,77,.455,21,51,.412,14,26,.538,14,18,.778,98
1130,DAL,2016-12-27,107,,HOU,L 107-123,240,36,87,.414,21,49,.429,15,38,.395,20,25,.800,107,41,78,.526,24,46,.522,17,32,.531,24,28,.857,123
1131,WAS,2016-12-26,107,,MIL,W 107-102,240,40,79,.506,28,50,.560,12,29,.414,15,20,.750,107,40,87,.460,34,67,.507,6,20,.300,16,23,.696,102
1132,LAL,2016-12-22,107,@,MIA,L 107-115,240,40,90,.444,26,52,.500,14,38,.368,13,15,.867,107,45,84,.536,34,62,.548,11,22,.500,14,21,.667,115
1133,WAS,2016-12-21,107,@,CHI,W 107-97,240,43,82,.524,40,64,.625,3,18,.167,18,25,.720,107,38,95,.400,32,74,.432,6,21,.286,15,19,.789,97
1134,IND,2016-12-19,107,,WAS,W 107-105,240,41,87,.471,34,66,.515,7,21,.333,18,21,.857,107,38,88,.432,30,55,.545,8,33,.242,21,26,.808,105
1135,DAL,2016-12-19,107,@,DEN,L 107-117,240,43,80,.538,29,55,.527,14,25,.560,7,9,.778,107,45,80,.563,32,55,.582,13,25,.520,14,18,.778,117
1136,BRK,2016-12-18,107,@,PHI,L 107-108,240,36,81,.444,24,47,.511,12,34,.353,23,31,.742,107,38,88,.432,26,60,.433,12,28,.429,20,23,.870,108
1137,CHO,2016-12-17,107,@,ATL,W 107-99,240,43,88,.489,31,61,.508,12,27,.444,9,13,.692,107,40,86,.465,30,60,.500,10,26,.385,9,16,.563,99
1138,SAS,2016-12-15,107,@,PHO,W 107-92,240,39,74,.527,34,58,.586,5,16,.313,24,26,.923,107,34,85,.400,24,58,.414,10,27,.370,14,18,.778,92
1139,BRK,2016-12-14,107,,LAL,W 107-97,240,33,86,.384,22,51,.431,11,35,.314,30,40,.750,107,35,91,.385,29,64,.453,6,27,.222,21,34,.618,97
1140,POR,2016-12-07,107,@,MIL,L 107-115,240,37,85,.435,20,45,.444,17,40,.425,16,19,.842,107,40,77,.519,30,53,.566,10,24,.417,25,37,.676,115
1141,UTA,2016-12-05,107,@,LAL,W 107-101,240,38,80,.475,25,48,.521,13,32,.406,18,29,.621,107,39,87,.448,34,73,.466,5,14,.357,18,23,.783,101
1142,HOU,2016-12-05,107,,BOS,W 107-106,240,34,76,.447,22,38,.579,12,38,.316,27,31,.871,107,42,99,.424,31,67,.463,11,32,.344,11,12,.917,106
1143,BOS,2016-12-03,107,@,PHI,W 107-106,240,38,76,.500,30,50,.600,8,26,.308,23,29,.793,107,35,76,.461,20,43,.465,15,33,.455,21,26,.808,106
1144,DAL,2016-12-03,107,,CHI,W 107-82,240,40,87,.460,27,56,.482,13,31,.419,14,18,.778,107,32,71,.451,29,58,.500,3,13,.231,15,21,.714,82
1145,SAS,2016-12-02,107,,WAS,W 107-105,240,39,80,.488,31,60,.517,8,20,.400,21,33,.636,107,41,81,.506,34,70,.486,7,11,.636,16,18,.889,105
1146,ATL,2016-11-30,107,@,PHO,L 107-109,240,45,89,.506,36,64,.563,9,25,.360,8,10,.800,107,40,89,.449,30,68,.441,10,21,.476,19,25,.760,109
1147,CHO,2016-11-26,107,,NYK,W 107-102,240,35,80,.438,27,58,.466,8,22,.364,29,42,.690,107,37,99,.374,25,67,.373,12,32,.375,16,20,.800,102
1148,MIA,2016-11-26,107,,MEM,L 107-110,240,40,81,.494,29,50,.580,11,31,.355,16,24,.667,107,37,73,.507,28,48,.583,9,25,.360,27,33,.818,110
1149,DET,2016-11-23,107,,MIA,W 107-84,240,40,81,.494,34,62,.548,6,19,.316,21,25,.840,107,27,75,.360,20,49,.408,7,26,.269,23,30,.767,84
1150,NYK,2016-11-22,107,,POR,W 107-103,240,45,96,.469,36,67,.537,9,29,.310,8,8,1.000,107,38,86,.442,32,64,.500,6,22,.273,21,26,.808,103
1151,CHI,2016-11-22,107,@,DEN,L 107-110,240,43,95,.453,37,77,.481,6,18,.333,15,18,.833,107,43,100,.430,33,78,.423,10,22,.455,14,17,.824,110
1152,LAL,2016-11-18,107,,SAS,L 107-116,240,39,87,.448,27,62,.435,12,25,.480,17,21,.810,107,44,78,.564,34,54,.630,10,24,.417,18,19,.947,116
1153,ATL,2016-11-16,107,,MIL,W 107-100,240,35,72,.486,25,40,.625,10,32,.313,27,31,.871,107,39,98,.398,31,66,.470,8,32,.250,14,18,.778,100
1154,LAC,2016-11-16,107,,MEM,L 107-111,240,37,81,.457,28,56,.500,9,25,.360,24,34,.706,107,40,82,.488,25,56,.446,15,26,.577,16,19,.842,111
1155,NYK,2016-11-12,107,@,TOR,L 107-118,240,44,97,.454,37,74,.500,7,23,.304,12,16,.750,107,39,83,.470,32,61,.525,7,22,.318,33,38,.868,118
1156,CHI,2016-11-09,107,@,ATL,L 107-115,240,41,91,.451,32,64,.500,9,27,.333,16,21,.762,107,42,83,.506,33,63,.524,9,20,.450,22,27,.815,115
1157,PHO,2016-11-09,107,,DET,W 107-100,240,38,84,.452,30,62,.484,8,22,.364,23,30,.767,107,32,89,.360,23,67,.343,9,22,.409,27,32,.844,100
1158,ORL,2016-11-09,107,,MIN,L 107-123,240,38,85,.447,30,61,.492,8,24,.333,23,30,.767,107,45,87,.517,32,64,.500,13,23,.565,20,26,.769,123
1159,DEN,2016-11-08,107,@,MEM,L 107-108,240,35,70,.500,25,46,.543,10,24,.417,27,34,.794,107,44,86,.512,37,62,.597,7,24,.292,13,19,.684,108
1160,BOS,2016-11-06,107,,DEN,L 107-123,240,41,90,.456,33,65,.508,8,25,.320,17,21,.810,107,44,84,.524,33,61,.541,11,23,.478,24,31,.774,123
1161,IND,2016-11-03,107,@,MIL,L 107-125,240,38,81,.469,28,58,.483,10,23,.435,21,27,.778,107,47,82,.573,35,55,.636,12,27,.444,19,24,.792,125
1162,BOS,2016-11-02,107,,CHI,W 107-100,240,41,87,.471,27,55,.491,14,32,.438,11,17,.647,107,35,81,.432,28,61,.459,7,20,.350,23,31,.742,100
1163,CHO,2016-10-26,107,@,MIL,W 107-96,240,40,89,.449,33,66,.500,7,23,.304,20,24,.833,107,39,92,.424,36,76,.474,3,16,.188,15,20,.750,96
1164,DEN,2016-10-26,107,@,NOP,W 107-102,240,37,83,.446,29,59,.492,8,24,.333,25,33,.758,107,38,92,.413,35,73,.479,3,19,.158,23,26,.885,102
1165,OKC,2017-04-09,106,@,DEN,W 106-105,240,40,96,.417,34,71,.479,6,25,.240,20,22,.909,106,40,84,.476,29,50,.580,11,34,.324,14,15,.933,105
1166,CHI,2017-04-08,106,@,BRK,L 106-107,240,40,90,.444,29,66,.439,11,24,.458,15,17,.882,106,39,92,.424,29,61,.475,10,31,.323,19,24,.792,107
1167,MIA,2017-04-08,106,@,WAS,W 106-103,240,37,80,.463,30,62,.484,7,18,.389,25,36,.694,106,39,81,.481,31,59,.525,8,22,.364,17,22,.773,103
1168,NOP,2017-04-07,106,@,DEN,L 106-122,240,47,99,.475,44,76,.579,3,23,.130,9,13,.692,106,43,78,.551,30,46,.652,13,32,.406,23,32,.719,122
1169,WAS,2017-04-06,106,@,NYK,W 106-103,240,36,74,.486,22,40,.550,14,34,.412,20,28,.714,106,40,95,.421,33,75,.440,7,20,.350,16,21,.762,103
1170,UTA,2017-04-04,106,,POR,W 106-87,240,39,74,.527,26,51,.510,13,23,.565,15,19,.789,106,33,83,.398,27,57,.474,6,26,.231,15,17,.882,87
1171,CHI,2017-04-01,106,,ATL,W 106-104,240,40,85,.471,28,55,.509,12,30,.400,14,14,1.000,106,40,90,.444,29,62,.468,11,28,.393,13,17,.765,104
1172,TOR,2017-03-29,106,,CHO,L 106-110,240,38,83,.458,27,52,.519,11,31,.355,19,24,.792,106,39,86,.453,23,54,.426,16,32,.500,16,21,.762,110
1173,ORL,2017-03-29,106,,OKC,L 106-114 (OT),265,39,97,.402,30,67,.448,9,30,.300,19,27,.704,106,43,102,.422,33,69,.478,10,33,.303,18,28,.643,114
1174,PHI,2017-03-28,106,@,BRK,W 106-101,240,39,91,.429,29,58,.500,10,33,.303,18,21,.857,106,38,94,.404,29,62,.468,9,32,.281,16,24,.667,101
1175,HOU,2017-03-28,106,,GSW,L 106-113,240,33,85,.388,28,54,.519,5,31,.161,35,39,.897,106,45,88,.511,34,47,.723,11,41,.268,12,16,.750,113
1176,PHO,2017-03-26,106,@,CHO,L 106-120,240,41,81,.506,35,65,.538,6,16,.375,18,22,.818,106,42,87,.483,28,57,.491,14,30,.467,22,24,.917,120
1177,GSW,2017-03-26,106,,MEM,W 106-94,240,39,71,.549,22,40,.550,17,31,.548,11,15,.733,106,38,85,.447,30,56,.536,8,29,.276,10,15,.667,94
1178,SAS,2017-03-25,106,,NYK,W 106-98,240,45,99,.455,35,74,.473,10,25,.400,6,8,.750,106,41,87,.471,38,77,.494,3,10,.300,13,15,.867,98
1179,SAS,2017-03-15,106,,POR,L 106-110,240,42,88,.477,31,62,.500,11,26,.423,11,15,.733,106,38,80,.475,29,58,.500,9,22,.409,25,28,.893,110
1180,GSW,2017-03-14,106,,PHI,W 106-104,240,32,88,.364,18,56,.321,14,32,.438,28,35,.800,106,39,89,.438,31,62,.500,8,27,.296,18,27,.667,104
1181,DET,2017-03-09,106,,CLE,W 106-101,240,41,88,.466,32,62,.516,9,26,.346,15,19,.789,106,39,84,.464,28,45,.622,11,39,.282,12,19,.632,101
1182,MIA,2017-03-06,106,@,CLE,W 106-98,240,39,91,.429,23,56,.411,16,35,.457,12,14,.857,106,35,78,.449,26,51,.510,9,27,.333,19,29,.655,98
1183,BOS,2017-03-05,106,@,PHO,L 106-109,240,32,85,.376,19,48,.396,13,37,.351,29,40,.725,106,42,94,.447,38,74,.514,4,20,.200,21,26,.808,109
1184,PHI,2017-03-04,106,,DET,L 106-136,240,43,88,.489,29,54,.537,14,34,.412,6,7,.857,106,54,95,.568,44,72,.611,10,23,.435,18,21,.857,136
1185,WAS,2017-03-03,106,,TOR,L 106-114,240,34,92,.370,24,62,.387,10,30,.333,28,32,.875,106,41,81,.506,30,56,.536,11,25,.440,21,27,.778,114
1186,UTA,2017-02-28,106,@,OKC,L 106-109,240,43,93,.462,34,71,.479,9,22,.409,11,13,.846,106,39,76,.513,24,54,.444,15,22,.682,16,23,.696,109
1187,POR,2017-02-26,106,@,TOR,L 106-112,240,35,79,.443,26,58,.448,9,21,.429,27,35,.771,106,42,78,.538,35,58,.603,7,20,.350,21,27,.778,112
1188,IND,2017-02-13,106,,SAS,L 106-110,240,38,78,.487,29,58,.500,9,20,.450,21,30,.700,106,40,87,.460,33,72,.458,7,15,.467,23,27,.852,110
1189,MIN,2017-02-10,106,,NOP,L 106-122,240,38,82,.463,32,55,.582,6,27,.222,24,32,.750,106,45,75,.600,33,50,.660,12,25,.480,20,27,.741,122
1190,DEN,2017-02-08,106,@,ATL,L 106-117,240,40,100,.400,27,56,.482,13,44,.295,13,21,.619,106,47,93,.505,39,66,.591,8,27,.296,15,18,.833,117
1191,MIA,2017-02-08,106,@,MIL,W 106-88,240,41,86,.477,30,53,.566,11,33,.333,13,18,.722,106,33,71,.465,27,56,.482,6,15,.400,16,28,.571,88
1192,PHO,2017-02-06,106,@,NOP,L 106-111,240,40,93,.430,35,66,.530,5,27,.185,21,25,.840,106,42,92,.457,33,66,.500,9,26,.346,18,22,.818,111
1193,GSW,2017-02-04,106,@,SAC,L 106-109 (OT),265,36,87,.414,21,43,.488,15,44,.341,19,24,.792,106,43,88,.489,36,65,.554,7,23,.304,16,19,.842,109
1194,IND,2017-02-03,106,@,BRK,W 106-97,240,37,86,.430,29,66,.439,8,20,.400,24,31,.774,106,32,86,.372,21,58,.362,11,28,.393,22,23,.957,97
1195,NOP,2017-01-31,106,@,TOR,L 106-108 (OT),265,40,94,.426,28,64,.438,12,30,.400,14,19,.737,106,43,94,.457,33,63,.524,10,31,.323,12,15,.800,108
1196,CHO,2017-01-28,106,,SAC,L 106-109,240,36,75,.480,24,38,.632,12,37,.324,22,24,.917,106,41,79,.519,30,52,.577,11,27,.407,16,26,.615,109
1197,BRK,2017-01-25,106,,MIA,L 106-109,240,35,80,.438,22,45,.489,13,35,.371,23,26,.885,106,40,83,.482,29,60,.483,11,23,.478,18,25,.720,109
1198,TOR,2017-01-24,106,,SAS,L 106-108,240,38,84,.452,32,59,.542,6,25,.240,24,28,.857,106,38,85,.447,31,61,.508,7,24,.292,25,33,.758,108
1199,BOS,2017-01-18,106,,NYK,L 106-117,240,35,91,.385,26,58,.448,9,33,.273,27,29,.931,106,46,91,.505,36,66,.545,10,25,.400,15,18,.833,117
1200,IND,2017-01-18,106,@,SAC,W 106-100,240,39,75,.520,32,54,.593,7,21,.333,21,25,.840,106,35,72,.486,26,51,.510,9,21,.429,21,27,.778,100
1201,UTA,2017-01-16,106,@,PHO,W 106-101,240,41,89,.461,33,66,.500,8,23,.348,16,24,.667,106,40,81,.494,35,59,.593,5,22,.227,16,17,.941,101
1202,BOS,2017-01-10,106,@,TOR,L 106-114,240,40,85,.471,31,58,.534,9,27,.333,17,20,.850,106,41,87,.471,31,65,.477,10,22,.455,22,27,.815,114
1203,SAC,2017-01-08,106,,GSW,L 106-117,240,36,74,.486,25,46,.543,11,28,.393,23,29,.793,106,45,89,.506,35,60,.583,10,29,.345,17,20,.850,117
1204,DEN,2017-01-07,106,@,OKC,L 106-121,240,40,99,.404,31,75,.413,9,24,.375,17,24,.708,106,43,89,.483,31,53,.585,12,36,.333,23,29,.793,121
1205,LAC,2017-01-06,106,@,SAC,W 106-98,240,39,84,.464,26,53,.491,13,31,.419,15,21,.714,106,36,87,.414,27,57,.474,9,30,.300,17,22,.773,98
1206,PHI,2017-01-06,106,@,BOS,L 106-110,240,37,79,.468,28,51,.549,9,28,.321,23,26,.885,106,35,87,.402,16,47,.340,19,40,.475,21,25,.840,110
1207,CHI,2017-01-04,106,@,CLE,W 106-94,240,41,85,.482,28,55,.509,13,30,.433,11,15,.733,106,34,83,.410,26,58,.448,8,25,.320,18,24,.750,94
1208,MEM,2017-01-04,106,@,LAC,L 106-115,240,38,88,.432,27,60,.450,11,28,.393,19,25,.760,106,37,73,.507,28,50,.560,9,23,.391,32,45,.711,115
1209,OKC,2016-12-27,106,@,MIA,W 106-94,240,42,82,.512,37,63,.587,5,19,.263,17,25,.680,106,36,82,.439,29,60,.483,7,22,.318,15,21,.714,94
1210,DEN,2016-12-26,106,@,LAC,W 106-102,240,36,82,.439,25,51,.490,11,31,.355,23,28,.821,106,39,84,.464,30,59,.508,9,25,.360,15,20,.750,102
1211,DET,2016-12-26,106,,CLE,W 106-90,240,41,92,.446,25,64,.391,16,28,.571,8,15,.533,106,30,79,.380,19,51,.373,11,28,.393,19,23,.826,90
1212,LAC,2016-12-22,106,,SAS,W 106-101,240,39,83,.470,28,55,.509,11,28,.393,17,22,.773,106,37,92,.402,31,73,.425,6,19,.316,21,25,.840,101
1213,NYK,2016-12-22,106,,ORL,W 106-95,240,41,96,.427,32,76,.421,9,20,.450,15,17,.882,106,39,90,.433,34,63,.540,5,27,.185,12,16,.750,95
1214,CHO,2016-12-14,106,@,WAS,L 106-109,240,38,74,.514,24,41,.585,14,33,.424,16,21,.762,106,45,87,.517,40,69,.580,5,18,.278,14,17,.824,109
1215,GSW,2016-12-08,106,@,UTA,W 106-99,240,39,80,.488,27,51,.529,12,29,.414,16,23,.696,106,37,89,.416,27,51,.529,10,38,.263,15,21,.714,99
1216,DEN,2016-12-05,106,@,PHI,W 106-98,240,35,76,.461,25,49,.510,10,27,.370,26,34,.765,106,35,86,.407,24,55,.436,11,31,.355,17,23,.739,98
1217,BOS,2016-12-05,106,@,HOU,L 106-107,240,42,99,.424,31,67,.463,11,32,.344,11,12,.917,106,34,76,.447,22,38,.579,12,38,.316,27,31,.871,107
1218,IND,2016-12-05,106,@,GSW,L 106-142,240,35,85,.412,32,70,.457,3,15,.200,33,35,.943,106,54,104,.519,40,67,.597,14,37,.378,20,26,.769,142
1219,NYK,2016-12-04,106,,SAC,W 106-98,240,39,88,.443,28,59,.475,11,29,.379,17,24,.708,106,31,97,.320,22,69,.319,9,28,.321,27,31,.871,98
1220,PHI,2016-12-03,106,,BOS,L 106-107,240,35,76,.461,20,43,.465,15,33,.455,21,26,.808,106,38,76,.500,30,50,.600,8,26,.308,23,29,.793,107
1221,NYK,2016-11-30,106,@,MIN,W 106-104,240,41,91,.451,28,59,.475,13,32,.406,11,15,.733,106,34,77,.442,30,58,.517,4,19,.211,32,39,.821,104
1222,MIA,2016-11-30,106,@,DEN,W 106-98,240,41,93,.441,32,69,.464,9,24,.375,15,26,.577,106,38,91,.418,31,69,.449,7,22,.318,15,24,.625,98
1223,OKC,2016-11-26,106,,DET,W 106-88,240,42,83,.506,34,60,.567,8,23,.348,14,26,.538,106,37,82,.451,36,63,.571,1,19,.053,13,17,.765,88
1224,LAL,2016-11-23,106,@,GSW,L 106-149,240,40,93,.430,32,73,.438,8,20,.400,18,22,.818,106,53,86,.616,34,50,.680,19,36,.528,24,35,.686,149
1225,WAS,2016-11-21,106,,PHO,W 106-101,240,37,91,.407,27,63,.429,10,28,.357,22,34,.647,106,39,91,.429,28,64,.438,11,27,.407,12,15,.800,101
1226,NOP,2016-11-14,106,,BOS,W 106-105,240,35,79,.443,29,58,.500,6,21,.286,30,36,.833,106,38,95,.400,26,54,.481,12,41,.293,17,20,.850,105
1227,MIL,2016-11-12,106,,MEM,W 106-96,240,36,68,.529,29,50,.580,7,18,.389,27,36,.750,106,35,78,.449,29,48,.604,6,30,.200,20,21,.952,96
1228,SAS,2016-11-12,106,@,HOU,W 106-100,240,41,76,.539,36,58,.621,5,18,.278,19,24,.792,106,34,89,.382,19,42,.452,15,47,.319,17,21,.810,100
1229,CHI,2016-11-12,106,,WAS,W 106-95,240,39,97,.402,34,82,.415,5,15,.333,23,25,.920,106,38,91,.418,34,78,.436,4,13,.308,15,18,.833,95
1230,DET,2016-11-12,106,@,DEN,W 106-95,240,46,90,.511,42,72,.583,4,18,.222,10,14,.714,106,36,84,.429,27,59,.458,9,25,.360,14,19,.737,95
1231,MIL,2016-11-10,106,,NOP,L 106-112,240,40,91,.440,34,73,.466,6,18,.333,20,25,.800,106,39,89,.438,30,64,.469,9,25,.360,25,27,.926,112
1232,CLE,2016-11-08,106,,ATL,L 106-110,240,37,99,.374,26,57,.456,11,42,.262,21,25,.840,106,41,81,.506,30,52,.577,11,29,.379,17,24,.708,110
1233,NOP,2016-11-07,106,@,GSW,L 106-116,240,39,80,.488,32,59,.542,7,21,.333,21,27,.778,106,45,90,.500,29,55,.527,16,35,.457,10,12,.833,116
1234,WAS,2016-11-07,106,,HOU,L 106-114,240,39,94,.415,29,67,.433,10,27,.370,18,20,.900,106,41,79,.519,24,42,.571,17,37,.459,15,18,.833,114
1235,UTA,2016-11-01,106,@,SAS,W 106-91,240,38,76,.500,23,45,.511,15,31,.484,15,18,.833,106,33,76,.434,27,56,.482,6,20,.300,19,21,.905,91
1236,ATL,2016-10-31,106,,SAC,W 106-95,240,33,79,.418,22,49,.449,11,30,.367,29,47,.617,106,36,75,.480,26,52,.500,10,23,.435,13,19,.684,95
1237,SAS,2016-10-30,106,@,MIA,W 106-99,240,37,82,.451,27,64,.422,10,18,.556,22,26,.846,106,37,80,.463,30,60,.500,7,20,.350,18,26,.692,99
1238,GSW,2016-10-30,106,@,PHO,W 106-100,240,35,83,.422,27,54,.500,8,29,.276,28,33,.848,106,37,90,.411,29,67,.433,8,23,.348,18,25,.720,100
1239,SAC,2016-10-29,106,,MIN,W 106-103,240,39,85,.459,30,59,.508,9,26,.346,19,25,.760,106,37,70,.529,30,48,.625,7,22,.318,22,31,.710,103
1240,HOU,2016-10-28,106,@,DAL,W 106-98,240,33,70,.471,18,38,.474,15,32,.469,25,31,.806,106,35,80,.438,27,51,.529,8,29,.276,20,24,.833,98
1241,POR,2016-10-27,106,,LAC,L 106-114,240,39,85,.459,35,67,.522,4,18,.222,24,32,.750,106,37,91,.407,29,62,.468,8,29,.276,32,46,.696,114
1242,OKC,2017-04-12,105,,DEN,L 105-111,240,43,101,.426,35,76,.461,8,25,.320,11,17,.647,105,39,85,.459,32,60,.533,7,25,.280,26,32,.813,111
1243,WAS,2017-04-10,105,@,DET,W 105-101,240,42,83,.506,35,64,.547,7,19,.368,14,16,.875,105,43,94,.457,33,68,.485,10,26,.385,5,5,1.000,101
1244,UTA,2017-04-10,105,@,GSW,W 105-99,240,41,92,.446,28,57,.491,13,35,.371,10,15,.667,105,39,80,.488,30,55,.545,9,25,.360,12,17,.706,99
1245,BRK,2017-04-10,105,@,BOS,L 105-114,240,31,86,.360,23,55,.418,8,31,.258,35,39,.897,105,41,91,.451,27,53,.509,14,38,.368,18,21,.857,114
1246,DEN,2017-04-09,105,,OKC,L 105-106,240,40,84,.476,29,50,.580,11,34,.324,14,15,.933,105,40,96,.417,34,71,.479,6,25,.240,20,22,.909,106
1247,POR,2017-04-06,105,,MIN,W 105-98,240,35,81,.432,21,48,.438,14,33,.424,21,26,.808,105,38,87,.437,34,69,.493,4,18,.222,18,20,.900,98
1248,TOR,2017-04-05,105,@,DET,W 105-102,240,41,87,.471,31,57,.544,10,30,.333,13,15,.867,105,42,81,.519,35,60,.583,7,21,.333,11,18,.611,102
1249,MIL,2017-04-02,105,,DAL,L 105-109,240,39,77,.506,27,43,.628,12,34,.353,15,18,.833,105,38,73,.521,24,37,.649,14,36,.389,19,20,.950,109
1250,PHI,2017-04-02,105,@,TOR,L 105-113,240,36,80,.450,25,44,.568,11,36,.306,22,25,.880,105,46,85,.541,40,66,.606,6,19,.316,15,19,.789,113
1251,PHI,2017-03-31,105,@,CLE,L 105-122,240,40,82,.488,29,49,.592,11,33,.333,14,19,.737,105,50,95,.526,37,66,.561,13,29,.448,9,16,.563,122
1252,DET,2017-03-31,105,@,MIL,L 105-108 (OT),265,44,97,.454,37,67,.552,7,30,.233,10,16,.625,105,35,84,.417,21,48,.438,14,36,.389,24,34,.706,108
1253,MIA,2017-03-29,105,@,NYK,W 105-88,240,40,84,.476,28,59,.475,12,25,.480,13,17,.765,105,33,89,.371,28,64,.438,5,25,.200,17,21,.810,88
1254,CHO,2017-03-24,105,,CLE,L 105-112,240,38,90,.422,28,52,.538,10,38,.263,19,24,.792,105,41,74,.554,32,49,.653,9,25,.360,21,24,.875,112
1255,CHO,2017-03-20,105,,ATL,W 105-90,240,40,80,.500,28,50,.560,12,30,.400,13,20,.650,105,37,84,.440,25,47,.532,12,37,.324,4,10,.400,90
1256,NYK,2017-03-20,105,@,LAC,L 105-114,240,40,89,.449,34,65,.523,6,24,.250,19,24,.792,105,43,87,.494,33,56,.589,10,31,.323,18,24,.750,114
1257,PHI,2017-03-19,105,,BOS,W 105-99,240,41,88,.466,29,55,.527,12,33,.364,11,15,.733,105,34,84,.405,28,55,.509,6,29,.207,25,29,.862,99
1258,DEN,2017-03-18,105,,HOU,L 105-109,240,38,89,.427,28,58,.483,10,31,.323,19,30,.633,105,38,83,.458,33,59,.559,5,24,.208,28,35,.800,109
1259,MIN,2017-03-17,105,@,MIA,L 105-123,240,41,82,.500,39,70,.557,2,12,.167,21,22,.955,105,50,85,.588,42,59,.712,8,26,.308,15,19,.789,123
1260,DEN,2017-03-11,105,@,SAC,W 105-92,240,40,85,.471,31,51,.608,9,34,.265,16,18,.889,105,36,82,.439,28,59,.475,8,23,.348,12,20,.600,92
1261,ATL,2017-03-10,105,,TOR,W 105-99,240,39,75,.520,31,53,.585,8,22,.364,19,29,.655,105,37,92,.402,33,67,.493,4,25,.160,21,27,.778,99
1262,DAL,2017-03-10,105,,BRK,W 105-96,240,33,78,.423,19,45,.422,14,33,.424,25,28,.893,105,34,78,.436,25,47,.532,9,31,.290,19,23,.826,96
1263,BRK,2017-03-08,105,@,ATL,L 105-110,240,37,80,.463,26,47,.553,11,33,.333,20,25,.800,105,41,95,.432,37,75,.493,4,20,.200,24,32,.750,110
1264,ORL,2017-03-06,105,,NYK,L 105-113,240,40,85,.471,31,53,.585,9,32,.281,16,24,.667,105,40,86,.465,34,72,.472,6,14,.429,27,28,.964,113
1265,NOP,2017-03-05,105,@,LAL,W 105-97,240,36,89,.404,27,65,.415,9,24,.375,24,35,.686,105,38,83,.458,28,55,.509,10,28,.357,11,15,.733,97
1266,NYK,2017-03-05,105,,GSW,L 105-112,240,39,83,.470,32,61,.525,7,22,.318,20,25,.800,105,40,88,.455,27,53,.509,13,35,.371,19,23,.826,112
1267,PHI,2017-03-03,105,,NYK,W 105-102,240,36,83,.434,27,55,.491,9,28,.321,24,31,.774,105,33,84,.393,26,63,.413,7,21,.333,29,33,.879,102
1268,WAS,2017-03-01,105,@,TOR,W 105-96,240,40,84,.476,31,59,.525,9,25,.360,16,19,.842,105,33,90,.367,26,70,.371,7,20,.350,23,26,.885,96
1269,MEM,2017-02-26,105,@,DEN,W 105-98,240,36,80,.450,25,47,.532,11,33,.333,22,25,.880,105,37,84,.440,26,50,.520,11,34,.324,13,17,.765,98
1270,ORL,2017-02-25,105,,ATL,W 105-86,240,37,81,.457,29,54,.537,8,27,.296,23,24,.958,105,32,85,.376,24,60,.400,8,25,.320,14,26,.538,86
1271,SAS,2017-02-24,105,@,LAC,W 105-97,240,35,82,.427,26,56,.464,9,26,.346,26,30,.867,105,35,79,.443,28,56,.500,7,23,.304,20,24,.833,97
1272,NYK,2017-02-15,105,@,OKC,L 105-116,240,41,86,.477,30,65,.462,11,21,.524,12,14,.857,105,41,88,.466,29,65,.446,12,23,.522,22,31,.710,116
1273,CHI,2017-02-14,105,,TOR,W 105-94,240,35,73,.479,28,56,.500,7,17,.412,28,35,.800,105,35,77,.455,30,57,.526,5,20,.250,19,24,.792,94
1274,PHI,2017-02-13,105,@,CHO,W 105-99,240,41,86,.477,29,53,.547,12,33,.364,11,17,.647,105,34,78,.436,23,47,.489,11,31,.355,20,26,.769,99
1275,SAC,2017-02-12,105,,NOP,W 105-99,240,35,78,.449,24,47,.511,11,31,.355,24,27,.889,105,34,82,.415,21,51,.412,13,31,.419,18,21,.857,99
1276,UTA,2017-02-09,105,@,DAL,L 105-112 (OT),265,39,85,.459,26,56,.464,13,29,.448,14,17,.824,105,44,87,.506,39,67,.582,5,20,.250,19,25,.760,112
1277,OKC,2017-02-05,105,,POR,W 105-99,240,40,98,.408,36,80,.450,4,18,.222,21,28,.750,105,35,87,.402,25,59,.424,10,28,.357,19,21,.905,99
1278,IND,2017-02-04,105,,DET,W 105-84,240,44,91,.484,37,67,.552,7,24,.292,10,15,.667,105,31,75,.413,25,58,.431,6,17,.353,16,20,.800,84
1279,WAS,2017-02-04,105,,NOP,W 105-91,240,38,83,.458,28,52,.538,10,31,.323,19,22,.864,105,37,84,.440,32,67,.478,5,17,.294,12,22,.545,91
1280,UTA,2017-02-04,105,,CHO,W 105-98,240,38,81,.469,25,48,.521,13,33,.394,16,24,.667,105,35,82,.427,22,49,.449,13,33,.394,15,18,.833,98
1281,PHO,2017-02-03,105,@,SAC,W 105-103,240,32,77,.416,20,48,.417,12,29,.414,29,35,.829,105,38,85,.447,28,58,.483,10,27,.370,17,22,.773,103
1282,HOU,2017-01-31,105,,SAC,W 105-83,240,38,85,.447,24,40,.600,14,45,.311,15,22,.682,105,30,86,.349,22,57,.386,8,29,.276,15,26,.577,83
1283,ORL,2017-01-30,105,@,MIN,L 105-111 (OT),265,41,96,.427,31,61,.508,10,35,.286,13,19,.684,105,40,91,.440,28,62,.452,12,29,.414,19,26,.731,111
1284,DAL,2017-01-29,105,@,SAS,W 105-101,240,39,87,.448,27,53,.509,12,34,.353,15,16,.938,105,39,83,.470,31,61,.508,8,22,.364,15,23,.652,101
1285,NOP,2017-01-25,105,,OKC,L 105-114,240,41,96,.427,30,69,.435,11,27,.407,12,19,.632,105,42,91,.462,32,64,.500,10,27,.370,20,28,.714,114
1286,POR,2017-01-25,105,,LAL,W 105-98,240,43,90,.478,39,75,.520,4,15,.267,15,20,.750,105,37,94,.394,26,64,.406,11,30,.367,13,14,.929,98
1287,ATL,2017-01-23,105,,LAC,L 105-115,240,37,88,.420,28,59,.475,9,29,.310,22,26,.846,105,42,84,.500,28,60,.467,14,24,.583,17,22,.773,115
1288,MIA,2017-01-23,105,,GSW,W 105-102,240,38,86,.442,25,56,.446,13,30,.433,16,27,.593,105,41,88,.466,33,58,.569,8,30,.267,12,20,.600,102
1289,BRK,2017-01-21,105,@,CHO,L 105-112,240,38,88,.432,21,47,.447,17,41,.415,12,15,.800,105,39,82,.476,25,52,.481,14,30,.467,20,22,.909,112
1290,NYK,2017-01-21,105,,PHO,L 105-107,240,40,89,.449,29,68,.426,11,21,.524,14,16,.875,105,37,85,.435,28,61,.459,9,24,.375,24,27,.889,107
1291,SAS,2017-01-14,105,@,PHO,L 105-108,240,36,71,.507,27,51,.529,9,20,.450,24,34,.706,105,39,85,.459,31,64,.484,8,21,.381,22,24,.917,108
1292,HOU,2017-01-13,105,,MEM,L 105-110,240,33,82,.402,23,41,.561,10,41,.244,29,36,.806,105,41,76,.539,31,49,.633,10,27,.370,18,27,.667,110
1293,LAC,2017-01-11,105,,ORL,W 105-96,240,39,76,.513,30,50,.600,9,26,.346,18,26,.692,105,39,92,.424,33,65,.508,6,27,.222,12,18,.667,96
1294,HOU,2017-01-11,105,@,MIN,L 105-119,240,36,87,.414,21,45,.467,15,42,.357,18,22,.818,105,44,81,.543,36,58,.621,8,23,.348,23,25,.920,119
1295,PHI,2017-01-08,105,@,BRK,W 105-95,240,37,94,.394,29,67,.433,8,27,.296,23,27,.852,105,36,78,.462,26,51,.510,10,27,.370,13,17,.765,95
1296,MIN,2017-01-06,105,@,WAS,L 105-112,240,42,88,.477,35,70,.500,7,18,.389,14,17,.824,105,46,79,.582,34,57,.596,12,22,.545,8,9,.889,112
1297,MIL,2017-01-04,105,@,NYK,W 105-104,240,37,78,.474,28,50,.560,9,28,.321,22,31,.710,105,42,94,.447,29,66,.439,13,28,.464,7,12,.583,104
1298,WAS,2017-01-03,105,@,DAL,L 105-113,240,41,92,.446,30,62,.484,11,30,.367,12,14,.857,105,37,78,.474,20,46,.435,17,32,.531,22,24,.917,113
1299,ATL,2016-12-30,105,,DET,W 105-98,240,39,88,.443,31,62,.500,8,26,.308,19,25,.760,105,35,84,.417,26,53,.491,9,31,.290,19,21,.905,98
1300,DEN,2016-12-28,105,,MIN,W 105-103,240,42,81,.519,32,53,.604,10,28,.357,11,14,.786,105,42,94,.447,35,69,.507,7,25,.280,12,17,.706,103
1301,IND,2016-12-28,105,@,WAS,L 105-111,240,35,79,.443,24,51,.471,11,28,.393,24,29,.828,105,38,78,.487,30,56,.536,8,22,.364,27,37,.730,111
1302,MIN,2016-12-23,105,,SAC,L 105-109,240,36,79,.456,24,47,.511,12,32,.375,21,26,.808,105,42,80,.525,27,51,.529,15,29,.517,10,14,.714,109
1303,WAS,2016-12-19,105,@,IND,L 105-107,240,38,88,.432,30,55,.545,8,33,.242,21,26,.808,105,41,87,.471,34,66,.515,7,21,.333,18,21,.857,107
1304,BOS,2016-12-18,105,@,MIA,W 105-95,240,41,90,.456,32,62,.516,9,28,.321,14,19,.737,105,36,69,.522,27,45,.600,9,24,.375,14,25,.560,95
1305,IND,2016-12-17,105,@,DET,W 105-90,240,40,83,.482,34,64,.531,6,19,.316,19,25,.760,105,32,84,.381,22,54,.407,10,30,.333,16,22,.727,90
1306,MIL,2016-12-10,105,@,WAS,L 105-110,240,40,79,.506,27,54,.500,13,25,.520,12,15,.800,105,40,88,.455,32,67,.478,8,21,.381,22,28,.786,110
1307,CHO,2016-12-10,105,@,CLE,L 105-116,240,39,86,.453,29,59,.492,10,27,.370,17,24,.708,105,42,73,.575,29,42,.690,13,31,.419,19,28,.679,116
1308,NOP,2016-12-10,105,@,LAC,L 105-133,240,40,83,.482,32,64,.500,8,19,.421,17,26,.654,105,54,94,.574,37,58,.638,17,36,.472,8,9,.889,133
1309,CHI,2016-12-10,105,,MIA,W 105-100,240,38,84,.452,37,76,.487,1,8,.125,28,31,.903,105,42,91,.462,37,71,.521,5,20,.250,11,18,.611,100
1310,PHO,2016-12-06,105,@,UTA,L 105-112,240,39,84,.464,33,66,.500,6,18,.333,21,25,.840,105,36,73,.493,24,46,.522,12,27,.444,28,32,.875,112
1311,SAS,2016-12-06,105,@,MIN,W 105-91,240,39,74,.527,28,50,.560,11,24,.458,16,19,.842,105,36,82,.439,29,62,.468,7,20,.350,12,18,.667,91
1312,UTA,2016-12-03,105,,DEN,W 105-98,240,35,78,.449,26,53,.491,9,25,.360,26,28,.929,105,37,83,.446,24,59,.407,13,24,.542,11,14,.786,98
1313,WAS,2016-12-02,105,@,SAS,L 105-107,240,41,81,.506,34,70,.486,7,11,.636,16,18,.889,105,39,80,.488,31,60,.517,8,20,.400,21,33,.636,107
1314,ORL,2016-12-02,105,@,PHI,W 105-88,240,37,78,.474,24,52,.462,13,26,.500,18,26,.692,105,36,95,.379,27,63,.429,9,32,.281,7,10,.700,88
1315,CLE,2016-12-02,105,@,CHI,L 105-111,240,45,83,.542,35,57,.614,10,26,.385,5,10,.500,105,47,96,.490,44,78,.564,3,18,.167,14,17,.824,111
1316,MEM,2016-11-30,105,@,TOR,L 105-120,240,36,82,.439,25,55,.455,11,27,.407,22,26,.846,105,38,69,.551,22,37,.595,16,32,.500,28,33,.848,120
1317,NOP,2016-11-29,105,,LAL,W 105-88,240,38,88,.432,30,57,.526,8,31,.258,21,25,.840,105,37,87,.425,32,57,.561,5,30,.167,9,18,.500,88
1318,GSW,2016-11-28,105,,ATL,W 105-100,240,37,85,.435,25,50,.500,12,35,.343,19,24,.792,105,36,85,.424,29,56,.518,7,29,.241,21,30,.700,100
1319,BRK,2016-11-27,105,,SAC,L 105-122,240,38,87,.437,22,47,.468,16,40,.400,13,14,.929,105,46,86,.535,33,63,.524,13,23,.565,17,22,.773,122
1320,TOR,2016-11-25,105,@,MIL,W 105-99,240,38,82,.463,24,50,.480,14,32,.438,15,19,.789,105,40,79,.506,28,50,.560,12,29,.414,7,12,.583,99
1321,CHI,2016-11-25,105,@,PHI,W 105-89,240,40,90,.444,34,69,.493,6,21,.286,19,26,.731,105,31,78,.397,22,56,.393,9,22,.409,18,22,.818,89
1322,MEM,2016-11-21,105,@,CHO,W 105-90,240,40,84,.476,28,58,.483,12,26,.462,13,17,.765,105,30,73,.411,21,42,.500,9,31,.290,21,33,.636,90
1323,DEN,2016-11-20,105,,UTA,W 105-91,240,42,86,.488,34,64,.531,8,22,.364,13,30,.433,105,33,85,.388,26,58,.448,7,27,.259,18,23,.783,91
1324,PHO,2016-11-19,105,@,PHI,L 105-120,240,39,92,.424,33,71,.465,6,21,.286,21,34,.618,105,45,86,.523,28,51,.549,17,35,.486,13,20,.650,120
1325,BRK,2016-11-18,105,@,OKC,L 105-124,240,35,83,.422,24,54,.444,11,29,.379,24,30,.800,105,49,89,.551,42,63,.667,7,26,.269,19,24,.792,124
1326,NYK,2016-11-16,105,,DET,W 105-102,240,42,93,.452,33,68,.485,9,25,.360,12,19,.632,105,42,85,.494,34,62,.548,8,23,.348,10,12,.833,102
1327,SAC,2016-11-16,105,,SAS,L 105-110,240,36,76,.474,27,56,.482,9,20,.450,24,31,.774,105,43,88,.489,32,58,.552,11,30,.367,13,17,.765,110
1328,OKC,2016-11-16,105,,HOU,W 105-103,240,40,84,.476,28,59,.475,12,25,.480,13,14,.929,105,40,92,.435,26,52,.500,14,40,.350,9,14,.643,103
1329,BOS,2016-11-14,105,@,NOP,L 105-106,240,38,95,.400,26,54,.481,12,41,.293,17,20,.850,105,35,79,.443,29,58,.500,6,21,.286,30,36,.833,106
1330,DEN,2016-11-13,105,@,POR,L 105-112,240,36,91,.396,25,62,.403,11,29,.379,22,29,.759,105,39,99,.394,31,70,.443,8,29,.276,26,32,.813,112
1331,BOS,2016-11-12,105,@,IND,W 105-99,240,35,80,.438,27,55,.491,8,25,.320,27,33,.818,105,36,86,.419,30,59,.508,6,27,.222,21,28,.750,99
1332,MIN,2016-11-12,105,,LAC,L 105-119,240,40,89,.449,32,67,.478,8,22,.364,17,21,.810,105,40,76,.526,29,52,.558,11,24,.458,28,37,.757,119
1333,IND,2016-11-11,105,@,PHI,L 105-109 (OT),265,39,88,.443,34,69,.493,5,19,.263,22,23,.957,105,36,86,.419,25,54,.463,11,32,.344,26,31,.839,109
1334,CLE,2016-11-11,105,@,WAS,W 105-94,240,36,86,.419,22,53,.415,14,33,.424,19,26,.731,105,38,87,.437,35,72,.486,3,15,.200,15,19,.789,94
1335,POR,2016-11-04,105,@,DAL,W 105-95,240,36,80,.450,24,49,.490,12,31,.387,21,26,.808,105,34,83,.410,24,55,.436,10,28,.357,17,20,.850,95
1336,TOR,2016-10-31,105,,DEN,W 105-102,240,41,88,.466,37,72,.514,4,16,.250,19,25,.760,105,33,81,.407,24,59,.407,9,22,.409,27,35,.771,102
1337,CLE,2016-10-29,105,,ORL,W 105-99,240,36,88,.409,25,51,.490,11,37,.297,22,30,.733,105,38,84,.452,30,56,.536,8,28,.286,15,26,.577,99
1338,CHI,2016-10-27,105,,BOS,W 105-99,240,36,92,.391,25,67,.373,11,25,.440,22,30,.733,105,38,76,.500,30,53,.566,8,23,.348,15,24,.625,99
1339,IND,2017-04-12,104,,ATL,W 104-86,240,39,82,.476,29,58,.500,10,24,.417,16,19,.842,104,30,72,.417,19,43,.442,11,29,.379,15,19,.789,86
1340,PHO,2017-04-11,104,@,SAC,L 104-129,240,41,109,.376,33,79,.418,8,30,.267,14,24,.583,104,43,83,.518,34,64,.531,9,19,.474,34,43,.791,129
1341,IND,2017-04-06,104,,MIL,W 104-89,240,38,80,.475,30,55,.545,8,25,.320,20,26,.769,104,33,71,.465,22,47,.468,11,24,.458,12,14,.857,89
1342,DEN,2017-04-05,104,@,HOU,L 104-110,240,41,104,.394,34,66,.515,7,38,.184,15,18,.833,104,37,87,.425,27,53,.509,10,34,.294,26,38,.684,110
1343,LAL,2017-04-01,104,@,LAC,L 104-115,240,39,90,.433,33,67,.493,6,23,.261,20,30,.667,104,38,69,.551,27,44,.614,11,25,.440,28,34,.824,115
1344,ATL,2017-04-01,104,@,CHI,L 104-106,240,40,90,.444,29,62,.468,11,28,.393,13,17,.765,104,40,85,.471,28,55,.509,12,30,.400,14,14,1.000,106
1345,LAL,2017-03-30,104,@,MIN,L 104-119,240,40,84,.476,31,57,.544,9,27,.333,15,16,.938,104,43,89,.483,33,68,.485,10,21,.476,23,30,.767,119
1346,WAS,2017-03-22,104,,ATL,W 104-100,240,38,95,.400,27,61,.443,11,34,.324,17,23,.739,104,34,86,.395,26,61,.426,8,25,.320,24,29,.828,100
1347,BRK,2017-03-19,104,,DAL,L 104-111,240,31,72,.431,18,41,.439,13,31,.419,29,38,.763,104,41,76,.539,31,51,.608,10,25,.400,19,25,.760,111
1348,MIA,2017-03-19,104,,POR,L 104-115,240,41,88,.466,32,58,.552,9,30,.300,13,20,.650,104,42,83,.506,29,57,.509,13,26,.500,18,24,.750,115
1349,MEM,2017-03-18,104,,SAS,W 104-96,240,32,76,.421,19,46,.413,13,30,.433,27,31,.871,104,33,75,.440,24,47,.511,9,28,.321,21,22,.955,96
1350,MIN,2017-03-15,104,@,BOS,L 104-117,240,40,91,.440,32,64,.500,8,27,.296,16,20,.800,104,43,79,.544,30,46,.652,13,33,.394,18,21,.857,117
1351,BRK,2017-03-14,104,,OKC,L 104-122,240,33,71,.465,21,47,.447,12,24,.500,26,30,.867,104,44,89,.494,34,67,.507,10,22,.455,24,34,.706,122
1352,PHI,2017-03-14,104,@,GSW,L 104-106,240,39,89,.438,31,62,.500,8,27,.296,18,27,.667,104,32,88,.364,18,56,.321,14,32,.438,28,35,.800,106
1353,WAS,2017-03-13,104,@,MIN,L 104-119,240,36,84,.429,29,58,.500,7,26,.269,25,31,.806,104,45,86,.523,35,65,.538,10,21,.476,19,22,.864,119
1354,UTA,2017-03-11,104,@,OKC,L 104-112,240,36,75,.480,27,55,.491,9,20,.450,23,28,.821,104,43,86,.500,35,63,.556,8,23,.348,18,24,.750,112
1355,MIA,2017-03-11,104,,TOR,W 104-89,240,35,72,.486,24,44,.545,11,28,.393,23,33,.697,104,33,88,.375,31,73,.425,2,15,.133,21,25,.840,89
1356,ORL,2017-03-11,104,,CLE,L 104-116,240,38,96,.396,34,75,.453,4,21,.190,24,28,.857,104,43,86,.500,28,47,.596,15,39,.385,15,25,.600,116
1357,SAC,2017-03-08,104,@,SAS,L 104-114,240,42,86,.488,35,67,.522,7,19,.368,13,16,.813,104,42,84,.500,28,55,.509,14,29,.483,16,21,.762,114
1358,MIL,2017-03-08,104,,NYK,W 104-93,240,37,86,.430,29,60,.483,8,26,.308,22,28,.786,104,39,84,.464,32,63,.508,7,21,.333,8,12,.667,93
1359,DAL,2017-03-05,104,,OKC,W 104-89,240,42,86,.488,35,61,.574,7,25,.280,13,16,.813,104,33,82,.402,31,60,.517,2,22,.091,21,30,.700,89
1360,DAL,2017-03-03,104,,MEM,W 104-100,240,39,82,.476,34,55,.618,5,27,.185,21,27,.778,104,38,82,.463,29,54,.537,9,28,.321,15,22,.682,100
1361,LAL,2017-02-28,104,,CHO,L 104-109,240,41,84,.488,29,52,.558,12,32,.375,10,13,.769,104,38,85,.447,22,46,.478,16,39,.410,17,24,.708,109
1362,BOS,2017-02-26,104,@,DET,W 104-98,240,34,85,.400,22,50,.440,12,35,.343,24,30,.800,104,35,81,.432,23,48,.479,12,33,.364,16,35,.457,98
1363,NYK,2017-02-23,104,@,CLE,L 104-119,240,42,101,.416,34,75,.453,8,26,.308,12,17,.706,104,46,87,.529,31,49,.633,15,38,.395,12,15,.800,119
1364,CHI,2017-02-16,104,,BOS,W 104-103,240,38,90,.422,32,65,.492,6,25,.240,22,22,1.000,104,36,77,.468,22,40,.550,14,37,.378,17,20,.850,103
1365,IND,2017-02-15,104,@,CLE,L 104-113,240,40,86,.465,28,62,.452,12,24,.500,12,14,.857,104,39,82,.476,21,43,.488,18,39,.462,17,19,.895,113
1366,POR,2017-02-13,104,,ATL,L 104-109 (OT),265,37,103,.359,21,61,.344,16,42,.381,14,25,.560,104,32,83,.386,24,55,.436,8,28,.286,37,48,.771,109
1367,UTA,2017-02-11,104,,BOS,L 104-112,240,35,86,.407,27,55,.491,8,31,.258,26,30,.867,104,42,71,.592,29,41,.707,13,30,.433,15,23,.652,112
1368,ORL,2017-02-07,104,@,HOU,L 104-128,240,42,88,.477,36,63,.571,6,25,.240,14,20,.700,104,44,89,.494,28,51,.549,16,38,.421,24,36,.667,128
1369,NYK,2017-02-04,104,,CLE,L 104-111,240,39,86,.453,27,55,.491,12,31,.387,14,28,.500,104,41,84,.488,25,44,.568,16,40,.400,13,18,.722,111
1370,POR,2017-02-03,104,,DAL,L 104-108,240,40,88,.455,31,58,.534,9,30,.300,15,20,.750,104,36,76,.474,19,45,.422,17,31,.548,19,23,.826,108
1371,UTA,2017-02-01,104,,MIL,W 104-88,240,36,78,.462,25,49,.510,11,29,.379,21,27,.778,104,32,73,.438,23,50,.460,9,23,.391,15,25,.600,88
1372,TOR,2017-02-01,104,@,BOS,L 104-109,240,41,78,.526,33,47,.702,8,31,.258,14,25,.560,104,36,87,.414,24,51,.471,12,36,.333,25,30,.833,109
1373,DAL,2017-01-30,104,,CLE,W 104-97,240,39,86,.453,30,54,.556,9,32,.281,17,18,.944,104,35,75,.467,23,43,.535,12,32,.375,15,21,.714,97
1374,MIA,2017-01-30,104,,BRK,W 104-96,240,39,82,.476,28,56,.500,11,26,.423,15,23,.652,104,37,87,.425,33,61,.541,4,26,.154,18,22,.818,96
1375,DET,2017-01-23,104,,SAC,L 104-109,240,41,82,.500,31,54,.574,10,28,.357,12,17,.706,104,40,82,.488,31,61,.508,9,21,.429,20,26,.769,109
1376,MIN,2017-01-19,104,@,LAC,W 104-101,240,40,84,.476,35,68,.515,5,16,.313,19,25,.760,104,42,87,.483,38,65,.585,4,22,.182,13,24,.542,101
1377,DEN,2017-01-19,104,@,SAS,L 104-118,240,37,91,.407,27,60,.450,10,31,.323,20,26,.769,104,44,86,.512,35,64,.547,9,22,.409,21,25,.840,118
1378,WAS,2017-01-18,104,,MEM,W 104-101,240,36,80,.450,28,51,.549,8,29,.276,24,26,.923,104,33,83,.398,25,58,.431,8,25,.320,27,34,.794,101
1379,MIL,2017-01-16,104,,PHI,L 104-113,240,42,89,.472,37,75,.493,5,14,.357,15,22,.682,104,35,78,.449,21,41,.512,14,37,.378,29,36,.806,113
1380,MEM,2017-01-15,104,,CHI,L 104-108,240,40,95,.421,29,63,.460,11,32,.344,13,13,1.000,104,40,78,.513,36,61,.590,4,17,.235,24,35,.686,108
1381,NYK,2017-01-12,104,,CHI,W 104-89,240,44,92,.478,37,69,.536,7,23,.304,9,11,.818,104,35,89,.393,32,71,.451,3,18,.167,16,21,.762,89
1382,NOP,2017-01-12,104,@,BRK,W 104-95,240,38,90,.422,27,58,.466,11,32,.344,17,25,.680,104,40,97,.412,31,55,.564,9,42,.214,6,11,.545,95
1383,NYK,2017-01-04,104,,MIL,L 104-105,240,42,94,.447,29,66,.439,13,28,.464,7,12,.583,104,37,78,.474,28,50,.560,9,28,.321,22,31,.710,105
1384,UTA,2017-01-03,104,@,BOS,L 104-115,240,38,82,.463,27,56,.482,11,26,.423,17,21,.810,104,41,74,.554,24,43,.558,17,31,.548,16,17,.941,115
1385,ORL,2017-01-01,104,@,IND,L 104-117,240,42,97,.433,32,59,.542,10,38,.263,10,11,.909,104,43,86,.500,34,64,.531,9,22,.409,22,24,.917,117
1386,NOP,2016-12-30,104,,NYK,W 104-92,240,38,85,.447,26,56,.464,12,29,.414,16,17,.941,104,35,93,.376,28,70,.400,7,23,.304,15,16,.938,92
1387,MIN,2016-12-26,104,,ATL,W 104-90,240,37,82,.451,22,51,.431,15,31,.484,15,18,.833,104,35,83,.422,27,51,.529,8,32,.250,12,17,.706,90
1388,DAL,2016-12-26,104,@,NOP,L 104-111,240,37,75,.493,24,43,.558,13,32,.406,17,22,.773,104,37,70,.529,25,45,.556,12,25,.480,25,30,.833,111
1389,TOR,2016-12-23,104,@,UTA,W 104-98,240,43,81,.531,35,60,.583,8,21,.381,10,15,.667,104,35,79,.443,25,52,.481,10,27,.370,18,21,.857,98
1390,GSW,2016-12-20,104,,UTA,W 104-74,240,40,90,.444,31,67,.463,9,23,.391,15,17,.882,104,27,76,.355,18,46,.391,9,30,.300,11,20,.550,74
1391,BRK,2016-12-20,104,@,TOR,L 104-116,240,36,91,.396,26,56,.464,10,35,.286,22,28,.786,104,42,91,.462,34,73,.466,8,18,.444,24,31,.774,116
1392,UTA,2016-12-10,104,,SAC,W 104-84,240,37,77,.481,24,48,.500,13,29,.448,17,18,.944,104,34,90,.378,25,64,.391,9,26,.346,7,13,.538,84
1393,MIN,2016-11-30,104,,NYK,L 104-106,240,34,77,.442,30,58,.517,4,19,.211,32,39,.821,104,41,91,.451,28,59,.475,13,32,.406,11,15,.733,106
1394,CHO,2016-11-28,104,@,MEM,W 104-85,240,36,82,.439,27,56,.482,9,26,.346,23,31,.742,104,36,89,.404,29,60,.483,7,29,.241,6,13,.462,85
1395,MIA,2016-11-28,104,,BOS,L 104-112,240,38,80,.475,32,50,.640,6,30,.200,22,32,.688,104,40,83,.482,29,56,.518,11,27,.407,21,26,.808,112
1396,MIL,2016-11-27,104,@,ORL,W 104-96,240,41,86,.477,33,62,.532,8,24,.333,14,20,.700,104,38,92,.413,31,64,.484,7,28,.250,13,17,.765,96
1397,SAC,2016-11-25,104,,HOU,L 104-117,240,39,80,.488,30,48,.625,9,32,.281,17,21,.810,104,40,85,.471,19,35,.543,21,50,.420,16,20,.800,117
1398,NOP,2016-11-25,104,@,POR,L 104-119,240,36,76,.474,23,53,.434,13,23,.565,19,29,.655,104,47,100,.470,35,68,.515,12,32,.375,13,17,.765,119
1399,DAL,2016-11-23,104,,LAC,L 104-124,240,38,84,.452,27,60,.450,11,24,.458,17,18,.944,104,43,85,.506,28,53,.528,15,32,.469,23,31,.742,124
1400,MEM,2016-11-23,104,@,PHI,W 104-99 (2OT),290,38,99,.384,28,70,.400,10,29,.345,18,24,.750,104,35,93,.376,23,57,.404,12,36,.333,17,23,.739,99
1401,NYK,2016-11-20,104,,ATL,W 104-94,240,42,88,.477,32,61,.525,10,27,.370,10,14,.714,104,34,85,.400,28,64,.438,6,21,.286,20,29,.690,94
1402,CLE,2016-11-18,104,,DET,W 104-81,240,40,83,.482,29,58,.500,11,25,.440,13,14,.929,104,29,93,.312,23,74,.311,6,19,.316,17,20,.850,81
1403,GSW,2016-11-18,104,@,BOS,W 104-88,240,44,90,.489,35,62,.565,9,28,.321,7,12,.583,104,31,83,.373,20,51,.392,11,32,.344,15,19,.789,88
1404,PHO,2016-11-16,104,@,DEN,L 104-120,240,39,79,.494,31,59,.525,8,20,.400,18,29,.621,104,45,93,.484,37,76,.487,8,17,.471,22,24,.917,120
1405,DET,2016-11-14,104,,OKC,W 104-88,240,43,92,.467,38,76,.500,5,16,.313,13,16,.813,104,33,88,.375,28,61,.459,5,27,.185,17,22,.773,88
1406,PHO,2016-11-12,104,,BRK,L 104-122,240,40,107,.374,32,74,.432,8,33,.242,16,21,.762,104,40,84,.476,24,47,.511,16,37,.432,26,30,.867,122
1407,CHO,2016-11-09,104,,UTA,W 104-98,240,38,82,.463,30,56,.536,8,26,.308,20,29,.690,104,38,82,.463,30,48,.625,8,34,.235,14,18,.778,98
1408,CHI,2016-11-04,104,,NYK,L 104-117,240,37,84,.440,29,61,.475,8,23,.348,22,27,.815,104,46,89,.517,37,68,.544,9,21,.429,16,21,.762,117
1409,POR,2016-11-01,104,,GSW,L 104-127,240,37,86,.430,23,47,.489,14,39,.359,16,21,.762,104,50,89,.562,40,63,.635,10,26,.385,17,23,.739,127
1410,BOS,2016-10-29,104,@,CHO,W 104-98,240,39,81,.481,24,50,.480,15,31,.484,11,17,.647,104,32,79,.405,23,47,.489,9,32,.281,25,33,.758,98
1411,ATL,2016-10-29,104,@,PHI,W 104-72,240,42,85,.494,37,65,.569,5,20,.250,15,23,.652,104,28,80,.350,23,62,.371,5,18,.278,11,15,.733,72
1412,MEM,2016-10-29,104,@,NYK,L 104-111,240,37,86,.430,28,61,.459,9,25,.360,21,26,.808,104,40,76,.526,34,55,.618,6,21,.286,25,39,.641,111
1413,UTA,2016-10-25,104,@,POR,L 104-113,240,40,82,.488,32,58,.552,8,24,.333,16,16,1.000,104,39,75,.520,26,56,.464,13,19,.684,22,22,1.000,113
1414,NOP,2017-04-12,103,@,POR,W 103-100,240,40,90,.444,32,66,.485,8,24,.333,15,21,.714,103,41,85,.482,28,55,.509,13,30,.433,5,13,.385,100
1415,ATL,2017-04-11,103,,CHO,W 103-76,240,41,79,.519,34,52,.654,7,27,.259,14,18,.778,103,29,88,.330,26,65,.400,3,23,.130,15,19,.789,76
1416,DET,2017-04-09,103,@,MEM,W 103-90,240,39,82,.476,25,54,.463,14,28,.500,11,16,.688,103,36,75,.480,27,54,.500,9,21,.429,9,13,.692,90
1417,WAS,2017-04-08,103,,MIA,L 103-106,240,39,81,.481,31,59,.525,8,22,.364,17,22,.773,103,37,80,.463,30,62,.484,7,18,.389,25,36,.694,106
1418,NYK,2017-04-06,103,,WAS,L 103-106,240,40,95,.421,33,75,.440,7,20,.350,16,21,.762,103,36,74,.486,22,40,.550,14,34,.412,20,28,.714,106
1419,OKC,2017-04-05,103,@,MEM,W 103-100,240,37,85,.435,23,54,.426,14,31,.452,15,24,.625,103,37,78,.474,28,52,.538,9,26,.346,17,21,.810,100
1420,MEM,2017-04-02,103,@,LAL,L 103-108,240,40,80,.500,27,50,.540,13,30,.433,10,14,.714,103,40,85,.471,33,66,.500,7,19,.368,21,27,.778,108
1421,UTA,2017-04-02,103,@,SAS,L 103-109,240,43,89,.483,34,65,.523,9,24,.375,8,13,.615,103,40,77,.519,30,58,.517,10,19,.526,19,22,.864,109
1422,MIL,2017-03-29,103,@,BOS,W 103-100,240,41,78,.526,33,56,.589,8,22,.364,13,17,.765,103,35,88,.398,23,51,.451,12,37,.324,18,23,.783,100
1423,SAS,2017-03-27,103,,CLE,W 103-74,240,41,86,.477,34,60,.567,7,26,.269,14,17,.824,103,31,83,.373,27,57,.474,4,26,.154,8,13,.615,74
1424,PHO,2017-03-17,103,,ORL,L 103-109,240,38,87,.437,36,73,.493,2,14,.143,25,30,.833,103,42,96,.438,35,73,.479,7,23,.304,18,21,.857,109
1425,LAL,2017-03-17,103,,MIL,L 103-107,240,38,84,.452,27,55,.491,11,29,.379,16,26,.615,103,40,82,.488,36,58,.621,4,24,.167,23,30,.767,107
1426,MEM,2017-03-16,103,@,ATL,W 103-91,240,39,92,.424,29,64,.453,10,28,.357,15,18,.833,103,29,71,.408,21,44,.477,8,27,.296,25,34,.735,91
1427,MIN,2017-03-10,103,,GSW,W 103-102,240,39,88,.443,35,74,.473,4,14,.286,21,27,.778,103,41,88,.466,34,64,.531,7,24,.292,13,17,.765,102
1428,CHO,2017-03-02,103,@,PHO,L 103-120,240,35,89,.393,25,55,.455,10,34,.294,23,28,.821,103,46,77,.597,39,58,.672,7,19,.368,21,25,.840,120
1429,LAC,2017-03-01,103,,HOU,L 103-122,240,42,94,.447,30,60,.500,12,34,.353,7,13,.538,103,37,87,.425,17,35,.486,20,52,.385,28,33,.848,122
1430,BOS,2017-03-01,103,,CLE,W 103-99,240,36,78,.462,23,47,.489,13,31,.419,18,23,.783,103,37,91,.407,27,58,.466,10,33,.303,15,22,.682,99
1431,ORL,2017-02-23,103,,POR,L 103-112,240,34,86,.395,27,64,.422,7,22,.318,28,39,.718,103,41,81,.506,32,63,.508,9,18,.500,21,27,.778,112
1432,BOS,2017-02-16,103,@,CHI,L 103-104,240,36,77,.468,22,40,.550,14,37,.378,17,20,.850,103,38,90,.422,32,65,.492,6,25,.240,22,22,1.000,104
1433,BRK,2017-02-13,103,,MEM,L 103-112,240,38,82,.463,26,45,.578,12,37,.324,15,18,.833,103,39,77,.506,30,55,.545,9,22,.409,25,27,.926,112
1434,SAS,2017-02-10,103,@,DET,W 103-92,240,41,82,.500,32,63,.508,9,19,.474,12,15,.800,103,39,92,.424,34,75,.453,5,17,.294,9,13,.692,92
1435,PHI,2017-02-08,103,,SAS,L 103-111,240,34,84,.405,21,50,.420,13,34,.382,22,29,.759,103,39,74,.527,28,52,.538,11,22,.500,22,25,.880,111
1436,TOR,2017-02-05,103,@,BRK,W 103-95,240,40,87,.460,35,68,.515,5,19,.263,18,20,.900,103,32,76,.421,19,42,.452,13,34,.382,18,21,.857,95
1437,SAC,2017-02-03,103,,PHO,L 103-105,240,38,85,.447,28,58,.483,10,27,.370,17,22,.773,103,32,77,.416,20,48,.417,12,29,.414,29,35,.829,105
1438,DET,2017-01-28,103,@,MIA,L 103-116,240,46,89,.517,42,77,.545,4,12,.333,7,12,.583,103,42,80,.525,28,52,.538,14,28,.500,18,23,.783,116
1439,SAS,2017-01-27,103,@,NOP,L 103-119,240,33,85,.388,21,57,.368,12,28,.429,25,29,.862,103,48,93,.516,35,63,.556,13,30,.433,10,14,.714,119
1440,MIN,2017-01-26,103,,IND,L 103-109,240,36,81,.444,26,54,.481,10,27,.370,21,27,.778,103,42,81,.519,32,63,.508,10,18,.556,15,17,.882,109
1441,CHO,2017-01-25,103,,GSW,L 103-113,240,38,92,.413,31,69,.449,7,23,.304,20,21,.952,103,39,82,.476,28,54,.519,11,28,.393,24,27,.889,113
1442,DAL,2017-01-25,103,,NYK,W 103-95,240,39,83,.470,33,57,.579,6,26,.231,19,24,.792,103,39,92,.424,32,69,.464,7,23,.304,10,12,.833,95
1443,DEN,2017-01-24,103,,UTA,W 103-93,240,35,76,.461,25,50,.500,10,26,.385,23,31,.742,103,35,85,.412,28,63,.444,7,22,.318,16,21,.762,93
1444,IND,2017-01-23,103,,NYK,L 103-109,240,38,86,.442,31,60,.517,7,26,.269,20,25,.800,103,35,76,.461,27,54,.500,8,22,.364,31,35,.886,109
1445,TOR,2017-01-22,103,,PHO,L 103-115,240,33,83,.398,26,56,.464,7,27,.259,30,35,.857,103,40,79,.506,31,57,.544,9,22,.409,26,28,.929,115
1446,PHO,2017-01-19,103,@,CLE,L 103-118,240,37,85,.435,33,66,.500,4,19,.211,25,31,.806,103,43,85,.506,24,43,.558,19,42,.452,13,19,.684,118
1447,HOU,2017-01-17,103,@,MIA,L 103-109,240,36,90,.400,27,51,.529,9,39,.231,22,28,.786,103,42,90,.467,33,61,.541,9,29,.310,16,24,.667,109
1448,BOS,2017-01-13,103,@,ATL,W 103-101,240,36,83,.434,19,39,.487,17,44,.386,14,19,.737,103,36,84,.429,25,54,.463,11,30,.367,18,21,.857,101
1449,OKC,2017-01-11,103,,MEM,W 103-95,240,36,81,.444,28,55,.509,8,26,.308,23,29,.793,103,38,92,.413,31,68,.456,7,24,.292,12,21,.571,95
1450,NYK,2017-01-02,103,,ORL,L 103-115,240,39,83,.470,31,62,.500,8,21,.381,17,24,.708,103,45,91,.495,30,60,.500,15,31,.484,10,14,.714,115
1451,MIN,2016-12-28,103,@,DEN,L 103-105,240,42,94,.447,35,69,.507,7,25,.280,12,17,.706,103,42,81,.519,32,53,.604,10,28,.357,11,14,.786,105
1452,MEM,2016-12-27,103,@,BOS,L 103-113,240,37,88,.420,28,58,.483,9,30,.300,20,29,.690,103,41,85,.482,29,54,.537,12,31,.387,19,21,.905,113
1453,CHO,2016-12-23,103,,CHI,W 103-91,240,37,84,.440,32,66,.485,5,18,.278,24,28,.857,103,38,96,.396,31,74,.419,7,22,.318,8,10,.800,91
1454,UTA,2016-12-16,103,,DAL,W 103-100,240,37,65,.569,29,43,.674,8,22,.364,21,27,.778,103,35,77,.455,23,49,.469,12,28,.429,18,21,.857,100
1455,GSW,2016-12-15,103,,NYK,W 103-90,240,45,96,.469,36,64,.563,9,32,.281,4,8,.500,103,38,93,.409,33,72,.458,5,21,.238,9,19,.474,90
1456,CLE,2016-12-13,103,,MEM,W 103-86,240,37,81,.457,25,50,.500,12,31,.387,17,23,.739,103,35,86,.407,31,64,.484,4,22,.182,12,15,.800,86
1457,NYK,2016-12-09,103,@,SAC,W 103-100,240,36,84,.429,26,55,.473,10,29,.345,21,25,.840,103,35,87,.402,28,59,.475,7,28,.250,23,27,.852,100
1458,IND,2016-12-09,103,@,DAL,L 103-111,240,32,69,.464,18,44,.409,14,25,.560,25,26,.962,103,39,80,.488,24,48,.500,15,32,.469,18,24,.750,111
1459,ATL,2016-12-07,103,,MIA,W 103-95,240,43,88,.489,39,69,.565,4,19,.211,13,15,.867,103,34,80,.425,23,53,.434,11,27,.407,16,20,.800,95
1460,MIA,2016-12-06,103,,NYK,L 103-114,240,38,89,.427,27,64,.422,11,25,.440,16,27,.593,103,48,98,.490,41,73,.562,7,25,.280,11,16,.688,114
1461,MEM,2016-12-03,103,,LAL,W 103-100,240,41,88,.466,31,58,.534,10,30,.333,11,15,.733,103,35,81,.432,28,60,.467,7,21,.333,23,29,.793,100
1462,BRK,2016-12-03,103,@,MIL,L 103-112,240,34,91,.374,23,50,.460,11,41,.268,24,33,.727,103,40,85,.471,34,61,.557,6,24,.250,26,36,.722,112
1463,NYK,2016-11-28,103,,OKC,L 103-112,240,36,91,.396,30,72,.417,6,19,.316,25,28,.893,103,46,92,.500,38,70,.543,8,22,.364,12,18,.667,112
1464,MIN,2016-11-28,103,,UTA,L 103-112,240,36,81,.444,29,62,.468,7,19,.368,24,25,.960,103,40,79,.506,36,61,.590,4,18,.222,28,34,.824,112
1465,BOS,2016-11-25,103,,SAS,L 103-109,240,42,91,.462,30,57,.526,12,34,.353,7,9,.778,103,38,81,.469,27,57,.474,11,24,.458,22,25,.880,109
1466,POR,2016-11-22,103,@,NYK,L 103-107,240,38,86,.442,32,64,.500,6,22,.273,21,26,.808,103,45,96,.469,36,67,.537,9,29,.310,8,8,1.000,107
1467,IND,2016-11-16,103,,CLE,W 103-93,240,43,86,.500,33,58,.569,10,28,.357,7,11,.636,103,35,86,.407,24,56,.429,11,30,.367,12,20,.600,93
1468,HOU,2016-11-16,103,@,OKC,L 103-105,240,40,92,.435,26,52,.500,14,40,.350,9,14,.643,103,40,84,.476,28,59,.475,12,25,.480,13,14,.929,105
1469,DET,2016-11-05,103,,DEN,W 103-86,240,40,84,.476,33,64,.516,7,20,.350,16,22,.727,103,31,94,.330,24,69,.348,7,25,.280,17,20,.850,86
1470,WAS,2016-11-02,103,,TOR,L 103-113,240,42,72,.583,39,62,.629,3,10,.300,16,24,.667,103,43,77,.558,33,52,.635,10,25,.400,17,25,.680,113
1471,ORL,2016-11-01,103,@,PHI,W 103-101,240,42,93,.452,36,68,.529,6,25,.240,13,17,.765,103,40,81,.494,31,61,.508,9,20,.450,12,16,.750,101
1472,WAS,2016-10-30,103,@,MEM,L 103-112 (OT),265,38,86,.442,33,61,.541,5,25,.200,22,25,.880,103,39,88,.443,24,57,.421,15,31,.484,19,26,.731,112
1473,MIN,2016-10-29,103,@,SAC,L 103-106,240,37,70,.529,30,48,.625,7,22,.318,22,31,.710,103,39,85,.459,30,59,.508,9,26,.346,19,25,.760,106
1474,BRK,2016-10-28,103,,IND,W 103-94,240,38,87,.437,28,54,.519,10,33,.303,17,20,.850,103,37,98,.378,30,74,.405,7,24,.292,13,20,.650,94
1475,OKC,2016-10-26,103,@,PHI,W 103-97,240,39,94,.415,33,72,.458,6,22,.273,19,26,.731,103,36,84,.429,29,60,.483,7,24,.292,18,25,.720,97
1476,WAS,2017-04-12,102,@,MIA,L 102-110,240,42,87,.483,35,61,.574,7,26,.269,11,14,.786,102,46,88,.523,38,64,.594,8,24,.333,10,12,.833,110
1477,SAS,2017-04-07,102,@,DAL,W 102-89,240,40,96,.417,31,68,.456,9,28,.321,13,22,.591,102,38,88,.432,30,62,.484,8,26,.308,5,8,.625,89
1478,CHI,2017-04-06,102,@,PHI,W 102-90,240,39,91,.429,31,66,.470,8,25,.320,16,17,.941,102,33,91,.363,26,58,.448,7,33,.212,17,22,.773,90
1479,LAL,2017-04-05,102,@,SAS,W 102-95,240,42,86,.488,35,72,.486,7,14,.500,11,14,.786,102,39,89,.438,26,54,.481,13,35,.371,4,6,.667,95
1480,DET,2017-04-05,102,,TOR,L 102-105,240,42,81,.519,35,60,.583,7,21,.333,11,18,.611,102,41,87,.471,31,57,.544,10,30,.333,13,15,.867,105
1481,ORL,2017-04-04,102,@,CLE,L 102-122,240,33,86,.384,22,53,.415,11,33,.333,25,26,.962,102,44,82,.537,26,46,.565,18,36,.500,16,21,.762,122
1482,ORL,2017-03-22,102,,CHO,L 102-109,240,40,88,.455,26,48,.542,14,40,.350,8,10,.800,102,42,90,.467,33,63,.524,9,27,.333,16,18,.889,109
1483,WAS,2017-03-20,102,@,BOS,L 102-110,240,37,86,.430,29,51,.569,8,35,.229,20,26,.769,102,40,93,.430,30,60,.500,10,33,.303,20,28,.714,110
1484,SAC,2017-03-19,102,@,SAS,L 102-118,240,41,83,.494,34,73,.466,7,10,.700,13,17,.765,102,43,87,.494,32,59,.542,11,28,.393,21,27,.778,118
1485,TOR,2017-03-16,102,,OKC,L 102-123,240,37,81,.457,32,61,.525,5,20,.250,23,30,.767,102,47,88,.534,33,63,.524,14,25,.560,15,19,.789,123
1486,IND,2017-03-12,102,,MIA,W 102-98,240,35,82,.427,30,67,.448,5,15,.333,27,32,.844,102,39,94,.415,30,62,.484,9,32,.281,11,16,.688,98
1487,MIL,2017-03-11,102,,MIN,W 102-95,240,37,80,.463,29,60,.483,8,20,.400,20,23,.870,102,37,81,.457,32,68,.471,5,13,.385,16,21,.762,95
1488,GSW,2017-03-10,102,@,MIN,L 102-103,240,41,88,.466,34,64,.531,7,24,.292,13,17,.765,102,39,88,.443,35,74,.473,4,14,.286,21,27,.778,103
1489,OKC,2017-03-09,102,,SAS,W 102-92,240,41,89,.461,35,69,.507,6,20,.300,14,21,.667,102,35,84,.417,29,65,.446,6,19,.316,16,20,.800,92
1490,BOS,2017-03-06,102,@,LAC,L 102-116,240,34,83,.410,24,48,.500,10,35,.286,24,29,.828,102,39,73,.534,30,53,.566,9,20,.450,29,47,.617,116
1491,DEN,2017-03-04,102,,CHO,L 102-112,240,36,80,.450,27,50,.540,9,30,.300,21,25,.840,102,41,90,.456,25,63,.397,16,27,.593,14,17,.824,112
1492,NYK,2017-03-03,102,@,PHI,L 102-105,240,33,84,.393,26,63,.413,7,21,.333,29,33,.879,102,36,83,.434,27,55,.491,9,28,.321,24,31,.774,105
1493,MIN,2017-02-27,102,@,SAC,W 102-88,240,40,95,.421,32,72,.444,8,23,.348,14,20,.700,102,36,82,.439,30,65,.462,6,17,.353,10,15,.667,88
1494,CLE,2017-02-27,102,,MIL,W 102-95,240,35,70,.500,25,42,.595,10,28,.357,22,26,.846,102,37,83,.446,26,53,.491,11,30,.367,10,16,.625,95
1495,UTA,2017-02-26,102,@,WAS,W 102-92,240,34,72,.472,23,48,.479,11,24,.458,23,32,.719,102,37,87,.425,29,65,.446,8,22,.364,10,13,.769,92
1496,IND,2017-02-24,102,,MEM,W 102-92,240,40,78,.513,29,52,.558,11,26,.423,11,11,1.000,102,35,84,.417,26,57,.456,9,27,.333,13,23,.565,92
1497,MIL,2017-02-13,102,,DET,W 102-89,240,40,79,.506,34,58,.586,6,21,.286,16,16,1.000,102,34,78,.436,27,57,.474,7,21,.333,14,19,.737,89
1498,DET,2017-02-12,102,@,TOR,W 102-101,240,36,84,.429,28,53,.528,8,31,.258,22,29,.759,102,38,75,.507,30,59,.508,8,16,.500,17,25,.680,101
1499,CHO,2017-02-11,102,,LAC,L 102-107,240,37,85,.435,24,48,.500,13,37,.351,15,20,.750,102,40,85,.471,26,51,.510,14,34,.412,13,20,.650,107
1500,PHO,2017-02-11,102,@,HOU,L 102-133,240,37,94,.394,29,72,.403,8,22,.364,20,26,.769,102,42,85,.494,24,49,.490,18,36,.500,31,39,.795,133
1501,LAL,2017-02-08,102,@,DET,L 102-121,240,37,86,.430,31,63,.492,6,23,.261,22,26,.846,102,51,97,.526,47,81,.580,4,16,.250,15,24,.625,121
1502,LAC,2017-02-05,102,@,BOS,L 102-107,240,35,84,.417,25,55,.455,10,29,.345,22,28,.786,102,37,88,.420,21,36,.583,16,52,.308,17,20,.850,107
1503,PHI,2017-02-04,102,@,MIA,L 102-125,240,35,84,.417,29,61,.475,6,23,.261,26,31,.839,102,48,82,.585,36,60,.600,12,22,.545,17,23,.739,125
1504,MEM,2017-02-03,102,@,OKC,L 102-114,240,40,83,.482,37,64,.578,3,19,.158,19,22,.864,102,38,80,.475,25,54,.463,13,26,.500,25,33,.758,114
1505,ORL,2017-02-03,102,,TOR,W 102-94,240,37,80,.463,32,66,.485,5,14,.357,23,32,.719,102,34,87,.391,24,59,.407,10,28,.357,16,21,.762,94
1506,SAS,2017-02-02,102,,PHI,W 102-86,240,38,89,.427,32,68,.471,6,21,.286,20,27,.741,102,30,88,.341,21,63,.333,9,25,.360,17,23,.739,86
1507,MEM,2017-01-28,102,@,UTA,W 102-95,240,41,80,.513,30,54,.556,11,26,.423,9,10,.900,102,29,62,.468,19,37,.514,10,25,.400,27,29,.931,95
1508,TOR,2017-01-27,102,,MIL,W 102-86,240,37,84,.440,27,59,.458,10,25,.400,18,23,.783,102,31,80,.388,24,57,.421,7,23,.304,17,24,.708,86
1509,GSW,2017-01-23,102,@,MIA,L 102-105,240,41,88,.466,33,58,.569,8,30,.267,12,20,.600,102,38,86,.442,25,56,.446,13,30,.433,16,27,.593,105
1510,CHI,2017-01-21,102,,SAC,W 102-99,240,34,83,.410,28,66,.424,6,17,.353,28,33,.848,102,37,84,.440,28,58,.483,9,26,.346,16,21,.762,99
1511,ATL,2017-01-20,102,,CHI,W 102-93,240,39,82,.476,30,60,.500,9,22,.409,15,19,.789,102,34,81,.420,27,53,.509,7,28,.250,18,19,.947,93
1512,DET,2017-01-15,102,@,LAL,W 102-97,240,41,95,.432,32,70,.457,9,25,.360,11,16,.688,102,36,83,.434,30,57,.526,6,26,.231,19,24,.792,97
1513,PHI,2017-01-13,102,,CHO,W 102-93,240,36,76,.474,22,38,.579,14,38,.368,16,20,.800,102,28,85,.329,22,62,.355,6,23,.261,31,32,.969,93
1514,POR,2017-01-11,102,,CLE,W 102-86,240,40,93,.430,30,63,.476,10,30,.333,12,16,.750,102,28,82,.341,19,52,.365,9,30,.300,21,28,.750,86
1515,SAS,2017-01-07,102,,CHO,W 102-85,240,36,89,.404,23,55,.418,13,34,.382,17,20,.850,102,30,75,.400,26,54,.481,4,21,.190,21,25,.840,85
1516,PHO,2017-01-05,102,@,DAL,W 102-95,240,38,85,.447,31,68,.456,7,17,.412,19,22,.864,102,36,79,.456,27,50,.540,9,29,.310,14,17,.824,95
1517,SAC,2017-01-04,102,,MIA,L 102-107,240,40,78,.513,32,58,.552,8,20,.400,14,17,.824,102,35,72,.486,23,44,.523,12,28,.429,25,29,.862,107
1518,MEM,2017-01-03,102,@,LAL,L 102-116,240,30,77,.390,20,46,.435,10,31,.323,32,35,.914,102,42,82,.512,25,49,.510,17,33,.515,15,28,.536,116
1519,POR,2016-12-28,102,,SAC,W 102-89,240,35,74,.473,23,49,.469,12,25,.480,20,22,.909,102,31,79,.392,22,51,.431,9,28,.321,18,23,.783,89
1520,ATL,2016-12-28,102,,NYK,W 102-98 (OT),265,37,101,.366,30,74,.405,7,27,.259,21,27,.778,102,35,93,.376,28,66,.424,7,27,.259,21,26,.808,98
1521,NOP,2016-12-28,102,,LAC,W 102-98,240,40,87,.460,30,58,.517,10,29,.345,12,21,.571,102,37,94,.394,26,57,.456,11,37,.297,13,18,.722,98
1522,UTA,2016-12-27,102,@,LAL,W 102-100,240,38,75,.507,29,49,.592,9,26,.346,17,24,.708,102,39,83,.470,35,67,.522,4,16,.250,18,22,.818,100
1523,SAC,2016-12-26,102,,PHI,W 102-100,240,39,87,.448,32,62,.516,7,25,.280,17,21,.810,102,39,79,.494,30,54,.556,9,25,.360,13,18,.722,100
1524,MEM,2016-12-26,102,@,ORL,L 102-112,240,35,76,.461,25,51,.490,10,25,.400,22,28,.786,102,44,86,.512,31,60,.517,13,26,.500,11,16,.688,112
1525,MIL,2016-12-26,102,@,WAS,L 102-107,240,40,87,.460,34,67,.507,6,20,.300,16,23,.696,102,40,79,.506,28,50,.560,12,29,.414,15,20,.750,107
1526,LAC,2016-12-26,102,,DEN,L 102-106,240,39,84,.464,30,59,.508,9,25,.360,15,20,.750,102,36,82,.439,25,51,.490,11,31,.355,23,28,.821,106
1527,LAC,2016-12-25,102,@,LAL,L 102-111,240,37,85,.435,27,56,.482,10,29,.345,18,22,.818,102,40,84,.476,32,59,.542,8,25,.320,23,30,.767,111
1528,IND,2016-12-22,102,,BOS,L 102-109,240,35,82,.427,28,59,.475,7,23,.304,25,29,.862,102,38,92,.413,28,53,.528,10,39,.256,23,27,.852,109
1529,MIL,2016-12-21,102,@,CLE,L 102-113,240,36,77,.468,27,55,.491,9,22,.409,21,29,.724,102,43,87,.494,28,60,.467,15,27,.556,12,19,.632,113
1530,DEN,2016-12-20,102,@,LAC,L 102-119,240,39,90,.433,28,51,.549,11,39,.282,13,20,.650,102,47,86,.547,31,50,.620,16,36,.444,9,13,.692,119
1531,SAS,2016-12-20,102,@,HOU,W 102-100,240,36,77,.468,24,54,.444,12,23,.522,18,25,.720,102,35,92,.380,29,54,.537,6,38,.158,24,27,.889,100
1532,LAC,2016-12-16,102,@,MIA,W 102-98,240,36,83,.434,29,58,.500,7,25,.280,23,29,.793,102,38,93,.409,32,66,.485,6,27,.222,16,25,.640,98
1533,NOP,2016-12-15,102,,IND,W 102-95,240,36,85,.424,26,58,.448,10,27,.370,20,28,.714,102,36,87,.414,33,66,.500,3,21,.143,20,24,.833,95
1534,HOU,2016-12-09,102,@,OKC,W 102-99,240,36,92,.391,25,50,.500,11,42,.262,19,30,.633,102,34,81,.420,27,53,.509,7,28,.250,24,31,.774,99
1535,DET,2016-12-06,102,,CHI,W 102-91,240,40,88,.455,32,67,.478,8,21,.381,14,21,.667,102,33,75,.440,31,60,.517,2,15,.133,23,32,.719,91
1536,OKC,2016-12-05,102,@,ATL,W 102-99,240,37,80,.463,27,49,.551,10,31,.323,18,28,.643,102,34,77,.442,27,55,.491,7,22,.318,24,32,.750,99
1537,LAC,2016-12-04,102,,IND,L 102-111,240,36,81,.444,26,51,.510,10,30,.333,20,28,.714,102,39,79,.494,34,65,.523,5,14,.357,28,35,.800,111
1538,NYK,2016-11-26,102,@,CHO,L 102-107,240,37,99,.374,25,67,.373,12,32,.375,16,20,.800,102,35,80,.438,27,58,.466,8,22,.364,29,42,.690,107
1539,MIN,2016-11-26,102,@,GSW,L 102-115,240,41,89,.461,31,54,.574,10,35,.286,10,12,.833,102,45,81,.556,34,59,.576,11,22,.500,14,17,.824,115
1540,HOU,2016-11-23,102,,TOR,L 102-115,240,38,78,.487,24,36,.667,14,42,.333,12,12,1.000,102,43,88,.489,31,65,.477,12,23,.522,17,21,.810,115
1541,SAC,2016-11-20,102,,TOR,W 102-99,240,36,81,.444,25,54,.463,11,27,.407,19,25,.760,102,34,85,.400,25,61,.410,9,24,.375,22,24,.917,99
1542,UTA,2016-11-19,102,@,HOU,L 102-111,240,39,76,.513,27,49,.551,12,27,.444,12,17,.706,102,42,94,.447,30,62,.484,12,32,.375,15,20,.750,111
1543,LAC,2016-11-19,102,,CHI,W 102-95,240,36,77,.468,25,50,.500,11,27,.407,19,23,.826,102,33,77,.429,24,47,.511,9,30,.300,20,24,.833,95
1544,WAS,2016-11-16,102,@,PHI,L 102-109,240,38,91,.418,30,68,.441,8,23,.348,18,25,.720,102,42,77,.545,32,49,.653,10,28,.357,15,22,.682,109
1545,DET,2016-11-16,102,@,NYK,L 102-105,240,42,85,.494,34,62,.548,8,23,.348,10,12,.833,102,42,93,.452,33,68,.485,9,25,.360,12,19,.632,105
1546,MEM,2016-11-14,102,@,UTA,W 102-96,240,36,76,.474,28,55,.509,8,21,.381,22,26,.846,102,35,73,.479,27,45,.600,8,28,.286,18,22,.818,96
1547,UTA,2016-11-12,102,@,MIA,W 102-91,240,40,81,.494,34,61,.557,6,20,.300,16,19,.842,102,38,81,.469,33,64,.516,5,17,.294,10,19,.526,91
1548,OKC,2016-11-09,102,,TOR,L 102-112,240,31,74,.419,19,40,.475,12,34,.353,28,31,.903,102,43,83,.518,32,57,.561,11,26,.423,15,22,.682,112
1549,SAC,2016-11-08,102,,NOP,W 102-94,240,39,81,.481,31,56,.554,8,25,.320,16,20,.800,102,38,84,.452,33,63,.524,5,21,.238,13,18,.722,94
1550,CLE,2016-11-05,102,@,PHI,W 102-101,240,37,91,.407,23,53,.434,14,38,.368,14,18,.778,102,40,87,.460,26,49,.531,14,38,.368,7,12,.583,101
1551,ORL,2016-11-03,102,,SAC,W 102-94,240,38,84,.452,28,54,.519,10,30,.333,16,23,.696,102,38,80,.475,31,62,.500,7,18,.389,11,17,.647,94
1552,DEN,2016-11-03,102,@,MIN,W 102-99,240,39,81,.481,33,59,.559,6,22,.273,18,25,.720,102,35,88,.398,26,66,.394,9,22,.409,20,25,.800,99
1553,DET,2016-11-01,102,,NYK,W 102-89,240,41,89,.461,33,76,.434,8,13,.615,12,21,.571,102,35,86,.407,28,64,.438,7,22,.318,12,15,.800,89
1554,DEN,2016-10-31,102,@,TOR,L 102-105,240,33,81,.407,24,59,.407,9,22,.409,27,35,.771,102,41,88,.466,37,72,.514,4,16,.250,19,25,.760,105
1555,SAS,2016-10-27,102,@,SAC,W 102-94,240,36,79,.456,30,61,.492,6,18,.333,24,27,.889,102,28,70,.400,22,50,.440,6,20,.300,32,38,.842,94
1556,MEM,2016-10-26,102,,MIN,W 102-98,240,36,80,.450,25,56,.446,11,24,.458,19,27,.704,102,36,86,.419,30,68,.441,6,18,.333,20,29,.690,98
1557,NOP,2016-10-26,102,,DEN,L 102-107,240,38,92,.413,35,73,.479,3,19,.158,23,26,.885,102,37,83,.446,29,59,.492,8,24,.333,25,33,.758,107
1558,UTA,2017-04-12,101,,SAS,W 101-97,240,39,77,.506,29,51,.569,10,26,.385,13,20,.650,101,39,86,.453,31,65,.477,8,21,.381,11,13,.846,97
1559,DET,2017-04-10,101,,WAS,L 101-105,240,43,94,.457,33,68,.485,10,26,.385,5,5,1.000,101,42,83,.506,35,64,.547,7,19,.368,14,16,.875,105
1560,POR,2017-04-08,101,,UTA,W 101-86,240,37,91,.407,24,61,.393,13,30,.433,14,16,.875,101,31,78,.397,25,59,.424,6,19,.316,18,24,.750,86
1561,NOP,2017-04-08,101,@,GSW,L 101-123,240,42,86,.488,37,65,.569,5,21,.238,12,19,.632,101,49,96,.510,39,63,.619,10,33,.303,15,16,.938,123
1562,MEM,2017-04-07,101,,NYK,W 101-88,240,38,75,.507,23,48,.479,15,27,.556,10,12,.833,101,38,88,.432,32,60,.533,6,28,.214,6,13,.462,88
1563,DAL,2017-04-05,101,@,LAC,L 101-112,240,38,86,.442,27,55,.491,11,31,.355,14,18,.778,101,38,75,.507,26,44,.591,12,31,.387,24,31,.774,112
1564,OKC,2017-04-02,101,,CHO,L 101-113,240,39,84,.464,27,53,.509,12,31,.387,11,12,.917,101,37,77,.481,26,47,.553,11,30,.367,28,32,.875,113
1565,BRK,2017-03-28,101,,PHI,L 101-106,240,38,94,.404,29,62,.468,9,32,.281,16,24,.667,101,39,91,.429,29,58,.500,10,33,.303,18,21,.857,106
1566,TOR,2017-03-23,101,@,MIA,W 101-84,240,35,79,.443,29,56,.518,6,23,.261,25,32,.781,101,32,82,.390,26,59,.441,6,23,.261,14,23,.609,84
1567,NYK,2017-03-22,101,@,UTA,L 101-108,240,38,80,.475,29,59,.492,9,21,.429,16,18,.889,101,41,90,.456,34,62,.548,7,28,.250,19,29,.655,108
1568,PHO,2017-03-15,101,,SAC,L 101-107,240,43,107,.402,37,82,.451,6,25,.240,9,14,.643,101,38,79,.481,32,65,.492,6,14,.429,25,34,.735,107
1569,LAL,2017-03-13,101,@,DEN,L 101-129,240,42,97,.433,36,77,.468,6,20,.300,11,19,.579,101,45,84,.536,28,46,.609,17,38,.447,22,25,.880,129
1570,PHO,2017-03-12,101,,POR,L 101-110,240,41,93,.441,36,79,.456,5,14,.357,14,20,.700,101,43,86,.500,36,64,.563,7,22,.318,17,25,.680,110
1571,CLE,2017-03-09,101,@,DET,L 101-106,240,39,84,.464,28,45,.622,11,39,.282,12,19,.632,101,41,88,.466,32,62,.516,9,26,.346,15,19,.789,106
1572,CHO,2017-03-08,101,@,MIA,L 101-108,240,37,80,.463,30,59,.508,7,21,.333,20,21,.952,101,37,85,.435,20,44,.455,17,41,.415,17,24,.708,108
1573,LAC,2017-03-04,101,@,CHI,W 101-91,240,41,85,.482,35,60,.583,6,25,.240,13,16,.813,101,35,83,.422,29,66,.439,6,17,.353,15,20,.750,91
1574,MIL,2017-03-04,101,,TOR,W 101-94,240,38,87,.437,32,60,.533,6,27,.222,19,23,.826,101,35,75,.467,28,54,.519,7,21,.333,17,20,.850,94
1575,LAC,2017-03-03,101,@,MIL,L 101-112,240,36,64,.563,28,45,.622,8,19,.421,21,36,.583,101,44,80,.550,34,55,.618,10,25,.400,14,15,.933,112
1576,SAS,2017-03-03,101,@,NOP,W 101-98 (OT),265,40,95,.421,34,68,.500,6,27,.222,15,25,.600,101,35,91,.385,27,66,.409,8,25,.320,20,24,.833,98
1577,NYK,2017-03-01,101,@,ORL,W 101-90,240,34,81,.420,26,52,.500,8,29,.276,25,31,.806,101,34,83,.410,29,58,.500,5,25,.200,17,22,.773,90
1578,LAL,2017-02-15,101,@,PHO,L 101-137,240,35,93,.376,26,67,.388,9,26,.346,22,28,.786,101,49,88,.557,39,64,.609,10,24,.417,29,34,.853,137
1579,TOR,2017-02-12,101,,DET,L 101-102,240,38,75,.507,30,59,.508,8,16,.500,17,25,.680,101,36,84,.429,28,53,.528,8,31,.258,22,29,.759,102
1580,NYK,2017-01-31,101,@,WAS,L 101-117,240,34,93,.366,29,69,.420,5,24,.208,28,35,.800,101,49,88,.557,42,66,.636,7,22,.318,12,15,.800,117
1581,HOU,2017-01-29,101,@,IND,L 101-120,240,34,83,.410,23,44,.523,11,39,.282,22,25,.880,101,47,87,.540,42,66,.636,5,21,.238,21,26,.808,120
1582,SAS,2017-01-29,101,,DAL,L 101-105,240,39,83,.470,31,61,.508,8,22,.364,15,23,.652,101,39,87,.448,27,53,.509,12,34,.353,15,16,.938,105
1583,MEM,2017-01-25,101,,TOR,W 101-99,240,36,78,.462,26,56,.464,10,22,.455,19,25,.760,101,39,92,.424,29,58,.500,10,34,.294,11,19,.579,99
1584,LAC,2017-01-19,101,,MIN,L 101-104,240,42,87,.483,38,65,.585,4,22,.182,13,24,.542,101,40,84,.476,35,68,.515,5,16,.313,19,25,.760,104
1585,MEM,2017-01-18,101,@,WAS,L 101-104,240,33,83,.398,25,58,.431,8,25,.320,27,34,.794,101,36,80,.450,28,51,.549,8,29,.276,24,26,.923,104
1586,POR,2017-01-16,101,@,WAS,L 101-120,240,37,88,.420,29,62,.468,8,26,.308,19,25,.760,101,42,86,.488,29,63,.460,13,23,.565,23,25,.920,120
1587,PHO,2017-01-16,101,,UTA,L 101-106,240,40,81,.494,35,59,.593,5,22,.227,16,17,.941,101,41,89,.461,33,66,.500,8,23,.348,16,24,.667,106
1588,NYK,2017-01-15,101,@,TOR,L 101-116,240,35,84,.417,23,55,.418,12,29,.414,19,27,.704,101,44,89,.494,36,67,.537,8,22,.364,20,23,.870,116
1589,ATL,2017-01-13,101,,BOS,L 101-103,240,36,84,.429,25,54,.463,11,30,.367,18,21,.857,101,36,83,.434,19,39,.487,17,44,.386,14,19,.737,103
1590,WAS,2017-01-10,101,,CHI,W 101-99,240,42,83,.506,31,61,.508,11,22,.500,6,9,.667,101,35,88,.398,25,61,.410,10,27,.370,19,21,.905,99
1591,MIN,2017-01-09,101,,DAL,W 101-92,240,40,71,.563,34,55,.618,6,16,.375,15,21,.714,101,36,78,.462,23,50,.460,13,28,.464,7,9,.778,92
1592,MIL,2017-01-08,101,,WAS,L 101-107,240,37,80,.463,28,57,.491,9,23,.391,18,20,.900,101,41,84,.488,31,52,.596,10,32,.313,15,18,.833,107
1593,TOR,2017-01-05,101,,UTA,W 101-93,240,36,91,.396,28,70,.400,8,21,.381,21,28,.750,101,34,73,.466,27,53,.509,7,20,.350,18,21,.857,93
1594,HOU,2017-01-02,101,,WAS,W 101-91,240,37,86,.430,25,47,.532,12,39,.308,15,21,.714,101,38,87,.437,32,61,.525,6,26,.231,9,12,.750,91
1595,UTA,2017-01-02,101,@,BRK,W 101-89,240,39,93,.419,32,69,.464,7,24,.292,16,20,.800,101,33,78,.423,27,51,.529,6,27,.222,17,23,.739,89
1596,CHI,2016-12-30,101,@,IND,L 101-111,240,35,84,.417,29,61,.475,6,23,.261,25,31,.806,101,39,81,.481,32,62,.516,7,19,.368,26,30,.867,111
1597,DAL,2016-12-29,101,@,LAL,W 101-89,240,38,77,.494,24,46,.522,14,31,.452,11,14,.786,101,32,68,.471,25,49,.510,7,19,.368,18,25,.720,89
1598,ORL,2016-12-28,101,,CHO,L 101-120,240,42,86,.488,33,52,.635,9,34,.265,8,10,.800,101,46,84,.548,36,60,.600,10,24,.417,18,19,.947,120
1599,CHI,2016-12-28,101,,BRK,W 101-99,240,35,88,.398,32,75,.427,3,13,.231,28,29,.966,101,37,86,.430,24,54,.444,13,32,.406,12,16,.750,99
1600,SAS,2016-12-22,101,@,LAC,L 101-106,240,37,92,.402,31,73,.425,6,19,.316,21,25,.840,101,39,83,.470,28,55,.509,11,28,.393,17,22,.773,106
1601,SAS,2016-12-22,101,@,LAC,L 101-106,240,37,92,.402,31,73,.425,6,19,.316,21,25,.840,101,39,83,.470,28,55,.509,11,28,.393,17,22,.773,106
1602,PHO,2016-12-17,101,@,OKC,L 101-114,240,39,90,.433,31,68,.456,8,22,.364,15,20,.750,101,41,81,.506,34,65,.523,7,16,.438,25,34,.735,114
1603,BOS,2016-12-14,101,@,SAS,L 101-108,240,37,84,.440,27,53,.509,10,31,.323,17,20,.850,101,44,80,.550,36,58,.621,8,22,.364,12,14,.857,108
1604,WAS,2016-12-12,101,@,MIA,L 101-112,240,39,84,.464,34,61,.557,5,23,.217,18,22,.818,101,45,88,.511,36,62,.581,9,26,.346,13,19,.684,112
1605,BRK,2016-12-10,101,@,SAS,L 101-130,240,36,87,.414,29,60,.483,7,27,.259,22,25,.880,101,50,94,.532,36,68,.529,14,26,.538,16,18,.889,130
1606,TOR,2016-12-09,101,@,BOS,W 101-94,240,34,82,.415,25,62,.403,9,20,.450,24,27,.889,101,31,83,.373,14,41,.341,17,42,.405,15,22,.682,94
1607,DAL,2016-12-05,101,,CHO,L 101-109,240,37,89,.416,24,53,.453,13,36,.361,14,18,.778,101,40,79,.506,37,61,.607,3,18,.167,26,28,.929,109
1608,LAL,2016-12-05,101,,UTA,L 101-107,240,39,87,.448,34,73,.466,5,14,.357,18,23,.783,101,38,80,.475,25,48,.521,13,32,.406,18,29,.621,107
1609,OKC,2016-12-04,101,,NOP,W 101-92,240,41,89,.461,35,61,.574,6,28,.214,13,26,.500,101,36,98,.367,30,70,.429,6,28,.214,14,19,.737,92
1610,CLE,2016-11-29,101,@,MIL,L 101-118,240,32,75,.427,18,36,.500,14,39,.359,23,31,.742,101,46,86,.535,39,67,.582,7,19,.368,19,23,.826,118
1611,HOU,2016-11-29,101,@,UTA,L 101-120,240,37,91,.407,26,61,.426,11,30,.367,16,22,.727,101,41,74,.554,26,46,.565,15,28,.536,23,27,.852,120
1612,WAS,2016-11-28,101,,SAC,W 101-95 (OT),265,35,85,.412,25,60,.417,10,25,.400,21,26,.808,101,38,93,.409,35,72,.486,3,21,.143,16,26,.615,95
1613,OKC,2016-11-23,101,@,SAC,L 101-116,240,32,76,.421,25,51,.490,7,25,.280,30,38,.789,101,44,94,.468,32,66,.485,12,28,.429,16,17,.941,116
1614,PHI,2016-11-21,101,,MIA,W 101-94,240,37,78,.474,26,52,.500,11,26,.423,16,20,.800,101,34,88,.386,27,57,.474,7,31,.226,19,28,.679,94
1615,PHO,2016-11-21,101,@,WAS,L 101-106,240,39,91,.429,28,64,.438,11,27,.407,12,15,.800,101,37,91,.407,27,63,.429,10,28,.357,22,34,.647,106
1616,POR,2016-11-18,101,@,NOP,L 101-113,240,33,88,.375,21,54,.389,12,34,.353,23,26,.885,101,45,82,.549,36,58,.621,9,24,.375,14,20,.700,113
1617,LAL,2016-11-10,101,@,SAC,W 101-91,240,38,74,.514,29,47,.617,9,27,.333,16,22,.727,101,34,85,.400,26,64,.406,8,21,.381,15,20,.750,91
1618,DEN,2016-11-10,101,,GSW,L 101-125,240,38,94,.404,25,58,.431,13,36,.361,12,17,.706,101,46,85,.541,32,55,.582,14,30,.467,19,20,.950,125
1619,HOU,2016-11-09,101,@,SAS,W 101-99,240,37,78,.474,27,48,.563,10,30,.333,17,22,.773,101,33,84,.393,26,61,.426,7,23,.304,26,30,.867,99
1620,PHI,2016-11-05,101,,CLE,L 101-102,240,40,87,.460,26,49,.531,14,38,.368,7,12,.583,101,37,91,.407,23,53,.434,14,38,.368,14,18,.778,102
1621,DET,2016-11-02,101,@,BRK,L 101-109,240,37,88,.420,28,63,.444,9,25,.360,18,21,.857,101,41,76,.539,28,49,.571,13,27,.481,14,17,.824,109
1622,PHI,2016-11-01,101,,ORL,L 101-103,240,40,81,.494,31,61,.508,9,20,.450,12,16,.750,101,42,93,.452,36,68,.529,6,25,.240,13,17,.765,103
1623,IND,2016-10-29,101,@,CHI,L 101-118,240,43,88,.489,36,70,.514,7,18,.389,8,9,.889,101,45,86,.523,36,65,.554,9,21,.429,19,21,.905,118
1624,DAL,2017-04-12,100,@,MEM,W 100-93,240,33,75,.440,24,41,.585,9,34,.265,25,31,.806,100,33,84,.393,25,59,.424,8,25,.320,19,22,.864,93
1625,POR,2017-04-12,100,,NOP,L 100-103,240,41,85,.482,28,55,.509,13,30,.433,5,13,.385,100,40,90,.444,32,66,.485,8,24,.333,15,21,.714,103
1626,OKC,2017-04-11,100,@,MIN,W 100-98,240,37,86,.430,30,64,.469,7,22,.318,19,25,.760,100,38,86,.442,33,66,.500,5,20,.250,17,25,.680,98
1627,CLE,2017-04-07,100,,ATL,L 100-114,240,39,81,.481,30,45,.667,9,36,.250,13,17,.765,100,45,89,.506,29,52,.558,16,37,.432,8,8,1.000,114
1628,MEM,2017-04-05,100,,OKC,L 100-103,240,37,78,.474,28,52,.538,9,26,.346,17,21,.810,100,37,85,.435,23,54,.426,14,31,.452,15,24,.625,103
1629,NYK,2017-04-04,100,,CHI,W 100-91,240,42,89,.472,36,66,.545,6,23,.261,10,16,.625,100,32,85,.376,26,58,.448,6,27,.222,21,23,.913,91
1630,SAS,2017-03-31,100,@,OKC,W 100-95,240,37,85,.435,28,58,.483,9,27,.333,17,27,.630,100,33,81,.407,27,60,.450,6,21,.286,23,27,.852,95
1631,IND,2017-03-31,100,@,TOR,L 100-111,240,36,87,.414,25,61,.410,11,26,.423,17,21,.810,100,37,82,.451,23,55,.418,14,27,.519,23,35,.657,111
1632,BOS,2017-03-29,100,,MIL,L 100-103,240,35,88,.398,23,51,.451,12,37,.324,18,23,.783,100,41,78,.526,33,56,.589,8,22,.364,13,17,.765,103
1633,NOP,2017-03-27,100,@,UTA,L 100-108,240,37,80,.463,27,55,.491,10,25,.400,16,24,.667,100,41,85,.482,26,58,.448,15,27,.556,11,18,.611,108
1634,MIN,2017-03-25,100,@,POR,L 100-112,240,37,76,.487,35,66,.530,2,10,.200,24,32,.750,100,45,71,.634,34,49,.694,11,22,.500,11,17,.647,112
1635,MIL,2017-03-24,100,,ATL,W 100-97,240,39,88,.443,31,61,.508,8,27,.296,14,16,.875,100,34,83,.410,26,61,.426,8,22,.364,21,24,.875,97
1636,SAC,2017-03-24,100,@,GSW,L 100-114,240,40,83,.482,30,62,.484,10,21,.476,10,13,.769,100,44,89,.494,34,58,.586,10,31,.323,16,18,.889,114
1637,ATL,2017-03-22,100,@,WAS,L 100-104,240,34,86,.395,26,61,.426,8,25,.320,24,29,.828,100,38,95,.400,27,61,.443,11,34,.324,17,23,.739,104
1638,IND,2017-03-22,100,@,BOS,L 100-109,240,38,87,.437,27,59,.458,11,28,.393,13,19,.684,100,43,84,.512,32,57,.561,11,27,.407,12,14,.857,109
1639,SAS,2017-03-21,100,@,MIN,W 100-93,240,37,77,.481,29,53,.547,8,24,.333,18,22,.818,100,32,72,.444,25,57,.439,7,15,.467,22,25,.880,93
1640,UTA,2017-03-20,100,@,IND,L 100-107,240,40,88,.455,34,63,.540,6,25,.240,14,20,.700,100,38,87,.437,28,67,.418,10,20,.500,21,23,.913,107
1641,LAL,2017-03-15,100,@,HOU,L 100-139,240,42,91,.462,39,66,.591,3,25,.120,13,18,.722,100,50,91,.549,32,48,.667,18,43,.419,21,32,.656,139
1642,NOP,2017-03-14,100,,POR,W 100-77,240,38,80,.475,32,59,.542,6,21,.286,18,30,.600,100,23,76,.303,12,44,.273,11,32,.344,20,26,.769,77
1643,TOR,2017-03-13,100,,DAL,W 100-78,240,37,78,.474,28,53,.528,9,25,.360,17,18,.944,100,31,85,.365,24,60,.400,7,25,.280,9,13,.692,78
1644,BOS,2017-03-12,100,,CHI,W 100-80,240,40,86,.465,24,49,.490,16,37,.432,4,4,1.000,100,33,87,.379,26,62,.419,7,25,.280,7,9,.778,80
1645,PHO,2017-03-11,100,@,DAL,W 100-98,240,38,83,.458,32,62,.516,6,21,.286,18,20,.900,100,28,74,.378,19,48,.396,9,26,.346,33,36,.917,98
1646,PHI,2017-03-11,100,@,LAC,L 100-112,240,40,84,.476,30,54,.556,10,30,.333,10,14,.714,100,40,81,.494,32,56,.571,8,25,.320,24,29,.828,112
1647,CHO,2017-03-06,100,,IND,W 100-88,240,35,86,.407,24,55,.436,11,31,.355,19,21,.905,100,37,81,.457,25,51,.490,12,30,.400,2,3,.667,88
1648,MEM,2017-03-03,100,@,DAL,L 100-104,240,38,82,.463,29,54,.537,9,28,.321,15,22,.682,100,39,82,.476,34,55,.618,5,27,.185,21,27,.778,104
1649,SAC,2017-03-01,100,,BRK,L 100-109,240,35,81,.432,24,59,.407,11,22,.500,19,22,.864,100,34,74,.459,23,46,.500,11,28,.393,30,36,.833,109
1650,ATL,2017-03-01,100,,DAL,W 100-95,240,36,64,.563,26,43,.605,10,21,.476,18,24,.750,100,35,77,.455,21,44,.477,14,33,.424,11,13,.846,95
1651,SAS,2017-03-01,100,,IND,W 100-99,240,35,74,.473,26,45,.578,9,29,.310,21,24,.875,100,37,81,.457,30,58,.517,7,23,.304,18,25,.720,99
1652,MIL,2017-02-26,100,,PHO,W 100-96,240,39,76,.513,33,56,.589,6,20,.300,16,18,.889,100,40,83,.482,35,69,.507,5,14,.357,11,16,.688,96
1653,DEN,2017-02-23,100,@,SAC,L 100-116,240,39,88,.443,27,53,.509,12,35,.343,10,14,.714,100,46,88,.523,39,74,.527,7,14,.500,17,19,.895,116
1654,IND,2017-02-11,100,,MIL,L 100-116,240,35,73,.479,25,51,.490,10,22,.455,20,24,.833,100,35,73,.479,18,42,.429,17,31,.548,29,37,.784,116
1655,OKC,2017-02-01,100,,CHI,L 100-128,240,38,100,.380,28,63,.444,10,37,.270,14,17,.824,100,49,81,.605,43,66,.652,6,15,.400,24,30,.800,128
1656,MIA,2017-01-27,100,@,CHI,W 100-88,240,41,89,.461,32,65,.492,9,24,.375,9,11,.818,100,33,78,.423,30,65,.462,3,13,.231,19,25,.760,88
1657,CHI,2017-01-24,100,@,ORL,W 100-92,240,35,77,.455,28,55,.509,7,22,.318,23,30,.767,100,35,85,.412,28,63,.444,7,22,.318,15,20,.750,92
1658,IND,2017-01-21,100,@,UTA,L 100-109,240,39,77,.506,29,57,.509,10,20,.500,12,17,.706,100,39,84,.464,33,60,.550,6,24,.250,25,32,.781,109
1659,OKC,2017-01-18,100,@,GSW,L 100-121,240,38,90,.422,30,62,.484,8,28,.286,16,19,.842,100,46,85,.541,36,64,.563,10,21,.476,19,27,.704,121
1660,SAC,2017-01-18,100,,IND,L 100-106,240,35,72,.486,26,51,.510,9,21,.429,21,27,.778,100,39,75,.520,32,54,.593,7,21,.333,21,25,.840,106
1661,SAC,2017-01-10,100,,DET,W 100-94,240,32,73,.438,19,50,.380,13,23,.565,23,29,.793,100,36,82,.439,24,55,.436,12,27,.444,10,16,.625,94
1662,UTA,2017-01-10,100,,CLE,W 100-92,240,38,79,.481,25,45,.556,13,34,.382,11,19,.579,100,31,85,.365,22,54,.407,9,31,.290,21,25,.840,92
1663,MIA,2017-01-06,100,@,LAL,L 100-127,240,38,92,.413,30,60,.500,8,32,.250,16,27,.593,100,48,96,.500,38,68,.559,10,28,.357,21,29,.724,127
1664,HOU,2017-01-06,100,@,ORL,W 100-93,240,39,86,.453,24,37,.649,15,49,.306,7,12,.583,100,38,91,.418,30,68,.441,8,23,.348,9,13,.692,93
1665,UTA,2016-12-29,100,,PHI,W 100-83,240,35,73,.479,20,47,.426,15,26,.577,15,28,.536,100,35,87,.402,29,63,.460,6,24,.250,7,8,.875,83
1666,LAL,2016-12-27,100,,UTA,L 100-102,240,39,83,.470,35,67,.522,4,16,.250,18,22,.818,100,38,75,.507,29,49,.592,9,26,.346,17,24,.708,102
1667,PHI,2016-12-26,100,@,SAC,L 100-102,240,39,79,.494,30,54,.556,9,25,.360,13,18,.722,100,39,87,.448,32,62,.516,7,25,.280,17,21,.810,102
1668,CHI,2016-12-25,100,@,SAS,L 100-119,240,39,86,.453,32,68,.471,7,18,.389,15,20,.750,100,48,85,.565,39,67,.582,9,18,.500,14,19,.737,119
1669,MIN,2016-12-25,100,@,OKC,L 100-112,240,39,83,.470,35,71,.493,4,12,.333,18,23,.783,100,42,82,.512,34,58,.586,8,24,.333,20,24,.833,112
1670,HOU,2016-12-20,100,,SAS,L 100-102,240,35,92,.380,29,54,.537,6,38,.158,24,27,.889,100,36,77,.468,24,54,.444,12,23,.522,18,25,.720,102
1671,NOP,2016-12-18,100,@,SAS,L 100-113,240,41,89,.461,31,63,.492,10,26,.385,8,14,.571,100,42,86,.488,31,64,.484,11,22,.500,18,22,.818,113
1672,NOP,2016-12-16,100,@,HOU,L 100-122,240,40,98,.408,31,71,.437,9,27,.333,11,20,.550,100,42,94,.447,18,33,.545,24,61,.393,14,19,.737,122
1673,DAL,2016-12-16,100,@,UTA,L 100-103,240,35,77,.455,23,49,.469,12,28,.429,18,21,.857,100,37,65,.569,29,43,.674,8,22,.364,21,27,.778,103
1674,LAL,2016-12-16,100,@,PHI,W 100-89,240,36,79,.456,27,49,.551,9,30,.300,19,22,.864,100,32,88,.364,26,57,.456,6,31,.194,19,24,.792,89
1675,MIL,2016-12-12,100,@,TOR,L 100-122,240,42,89,.472,38,65,.585,4,24,.167,12,17,.706,100,42,81,.519,28,56,.500,14,25,.560,24,28,.857,122
1676,MIA,2016-12-10,100,@,CHI,L 100-105,240,42,91,.462,37,71,.521,5,20,.250,11,18,.611,100,38,84,.452,37,76,.487,1,8,.125,28,31,.903,105
1677,SAC,2016-12-09,100,,NYK,L 100-103,240,35,87,.402,28,59,.475,7,28,.250,23,27,.852,100,36,84,.429,26,55,.473,10,29,.345,21,25,.840,103
1678,LAL,2016-12-03,100,@,MEM,L 100-103,240,35,81,.432,28,60,.467,7,21,.333,23,29,.793,100,41,88,.466,31,58,.534,10,30,.333,11,15,.733,103
1679,ATL,2016-11-28,100,@,GSW,L 100-105,240,36,85,.424,29,56,.518,7,29,.241,21,30,.700,100,37,85,.435,25,50,.500,12,35,.343,19,24,.792,105
1680,WAS,2016-11-26,100,,SAS,L 100-112,240,42,88,.477,36,66,.545,6,22,.273,10,14,.714,100,40,75,.533,31,51,.608,9,24,.375,23,29,.793,112
1681,CHO,2016-11-18,100,,ATL,W 100-96,240,37,90,.411,27,61,.443,10,29,.345,16,24,.667,100,39,84,.464,32,56,.571,7,28,.250,11,17,.647,96
1682,MIL,2016-11-16,100,@,ATL,L 100-107,240,39,98,.398,31,66,.470,8,32,.250,14,18,.778,100,35,72,.486,25,40,.625,10,32,.313,27,31,.871,107
1683,CLE,2016-11-13,100,,CHO,W 100-93,240,39,92,.424,25,54,.463,14,38,.368,8,15,.533,100,36,95,.379,25,66,.379,11,29,.379,10,12,.833,93
1684,HOU,2016-11-12,100,,SAS,L 100-106,240,34,89,.382,19,42,.452,15,47,.319,17,21,.810,100,41,76,.539,36,58,.621,5,18,.278,19,24,.792,106
1685,DET,2016-11-09,100,@,PHO,L 100-107,240,32,89,.360,23,67,.343,9,22,.409,27,32,.844,100,38,84,.452,30,62,.484,8,22,.364,23,30,.767,107
1686,IND,2016-11-07,100,@,CHO,L 100-122,240,40,94,.426,31,61,.508,9,33,.273,11,15,.733,100,41,84,.488,29,52,.558,12,32,.375,28,32,.875,122
1687,POR,2016-11-06,100,@,MEM,W 100-94,240,32,71,.451,18,38,.474,14,33,.424,22,27,.815,100,31,81,.383,25,55,.455,6,26,.231,26,32,.813,94
1688,SAS,2016-11-04,100,@,UTA,W 100-86,240,37,83,.446,31,63,.492,6,20,.300,20,22,.909,100,30,80,.375,19,54,.352,11,26,.423,15,24,.625,86
1689,CHI,2016-11-02,100,@,BOS,L 100-107,240,35,81,.432,28,61,.459,7,20,.350,23,31,.742,100,41,87,.471,27,55,.491,14,32,.438,11,17,.647,107
1690,PHO,2016-10-30,100,,GSW,L 100-106,240,37,90,.411,29,67,.433,8,23,.348,18,25,.720,100,35,83,.422,27,54,.500,8,29,.276,28,33,.848,106
1691,GSW,2016-10-25,100,,SAS,L 100-129,240,40,85,.471,33,52,.635,7,33,.212,13,18,.722,100,47,98,.480,35,74,.473,12,24,.500,23,26,.885,129
1692,POR,2017-04-10,99,,SAS,W 99-98,240,37,89,.416,25,62,.403,12,27,.444,13,15,.867,99,38,83,.458,30,62,.484,8,21,.381,14,20,.700,98
1693,GSW,2017-04-10,99,,UTA,L 99-105,240,39,80,.488,30,55,.545,9,25,.360,12,17,.706,99,41,92,.446,28,57,.491,13,35,.371,10,15,.667,105
1694,OKC,2017-04-07,99,@,PHO,L 99-120,240,34,92,.370,27,62,.435,7,30,.233,24,33,.727,99,43,83,.518,35,65,.538,8,18,.444,26,31,.839,120
1695,CHO,2017-04-05,99,,MIA,L 99-112,240,35,78,.449,27,53,.509,8,25,.320,21,24,.875,99,40,84,.476,19,44,.432,21,40,.525,11,12,.917,112
1696,MEM,2017-03-31,99,,DAL,W 99-90,240,35,75,.467,24,48,.500,11,27,.407,18,20,.900,99,29,76,.382,17,42,.405,12,34,.353,20,25,.800,90
1697,CHI,2017-03-30,99,,CLE,W 99-93,240,38,90,.422,26,65,.400,12,25,.480,11,18,.611,99,37,83,.446,27,56,.482,10,27,.370,9,16,.563,93
1698,ATL,2017-03-29,99,@,PHI,W 99-92,240,34,80,.425,25,62,.403,9,18,.500,22,26,.846,99,36,87,.414,25,48,.521,11,39,.282,9,11,.818,92
1699,BOS,2017-03-19,99,@,PHI,L 99-105,240,34,84,.405,28,55,.509,6,29,.207,25,29,.862,99,41,88,.466,29,55,.527,12,33,.364,11,15,.733,105
1700,ATL,2017-03-13,99,@,SAS,L 99-107,240,37,81,.457,31,59,.525,6,22,.273,19,30,.633,99,39,81,.481,23,47,.489,16,34,.471,13,17,.765,107
1701,TOR,2017-03-10,99,@,ATL,L 99-105,240,37,92,.402,33,67,.493,4,25,.160,21,27,.778,99,39,75,.520,31,53,.585,8,22,.364,19,29,.655,105
1702,BOS,2017-03-10,99,@,DEN,L 99-119,240,34,81,.420,22,48,.458,12,33,.364,19,23,.826,99,45,85,.529,33,54,.611,12,31,.387,17,22,.773,119
1703,MIL,2017-03-10,99,,IND,W 99-85,240,33,64,.516,26,47,.553,7,17,.412,26,30,.867,99,33,75,.440,31,57,.544,2,18,.111,17,22,.773,85
1704,BOS,2017-03-08,99,@,GSW,W 99-86,240,37,84,.440,27,55,.491,10,29,.345,15,19,.789,99,37,84,.440,31,54,.574,6,30,.200,6,9,.667,86
1705,MIA,2017-03-03,99,@,ORL,L 99-110,240,35,91,.385,27,63,.429,8,28,.286,21,25,.840,99,45,90,.500,40,73,.548,5,17,.294,15,19,.789,110
1706,CLE,2017-03-01,99,@,BOS,L 99-103,240,37,91,.407,27,58,.466,10,33,.303,15,22,.682,99,36,78,.462,23,47,.489,13,31,.419,18,23,.783,103
1707,IND,2017-03-01,99,@,SAS,L 99-100,240,37,81,.457,30,58,.517,7,23,.304,18,25,.720,99,35,74,.473,26,45,.578,9,29,.310,21,24,.875,100
1708,CLE,2017-02-25,99,,CHI,L 99-117,240,37,80,.463,23,43,.535,14,37,.378,11,15,.733,99,46,93,.495,31,63,.492,15,30,.500,10,16,.625,117
1709,CHO,2017-02-25,99,@,SAC,W 99-85,240,34,85,.400,20,47,.426,14,38,.368,17,18,.944,99,31,79,.392,20,51,.392,11,28,.393,12,15,.800,85
1710,NOP,2017-02-23,99,,HOU,L 99-129,240,36,86,.419,30,55,.545,6,31,.194,21,26,.808,99,45,91,.495,25,40,.625,20,51,.392,19,24,.792,129
1711,LAC,2017-02-15,99,,ATL,W 99-84,240,37,79,.468,23,42,.548,14,37,.378,11,12,.917,99,32,79,.405,25,53,.472,7,26,.269,13,19,.684,84
1712,DEN,2017-02-15,99,,MIN,L 99-112,240,38,94,.404,27,60,.450,11,34,.324,12,18,.667,99,41,86,.477,35,68,.515,6,18,.333,24,28,.857,112
1713,CHO,2017-02-13,99,,PHI,L 99-105,240,34,78,.436,23,47,.489,11,31,.355,20,26,.769,99,41,86,.477,29,53,.547,12,33,.364,11,17,.647,105
1714,NOP,2017-02-12,99,@,SAC,L 99-105,240,34,82,.415,21,51,.412,13,31,.419,18,21,.857,99,35,78,.449,24,47,.511,11,31,.355,24,27,.889,105
1715,BRK,2017-02-10,99,,MIA,L 99-108,240,35,81,.432,27,61,.443,8,20,.400,21,28,.750,99,41,92,.446,34,69,.493,7,23,.304,19,21,.905,108
1716,POR,2017-02-05,99,@,OKC,L 99-105,240,35,87,.402,25,59,.424,10,28,.357,19,21,.905,99,40,98,.408,36,80,.450,4,18,.222,21,28,.750,105
1717,MIN,2017-02-04,99,,MEM,L 99-107,240,35,84,.417,25,58,.431,10,26,.385,19,24,.792,99,32,77,.416,22,49,.449,10,28,.357,33,39,.846,107
1718,DEN,2017-02-01,99,,MEM,L 99-119,240,32,80,.400,23,55,.418,9,25,.360,26,35,.743,99,45,92,.489,31,62,.500,14,30,.467,15,20,.750,119
1719,TOR,2017-01-25,99,@,MEM,L 99-101,240,39,92,.424,29,58,.500,10,34,.294,11,19,.579,99,36,78,.462,26,56,.464,10,22,.455,19,25,.760,101
1720,CHO,2017-01-23,99,,WAS,L 99-109,240,35,90,.389,27,58,.466,8,32,.250,21,25,.840,99,43,80,.538,33,55,.600,10,25,.400,13,17,.765,109
1721,SAC,2017-01-21,99,@,CHI,L 99-102,240,37,84,.440,28,58,.483,9,26,.346,16,21,.762,99,34,83,.410,28,66,.424,6,17,.353,28,33,.848,102
1722,MIA,2017-01-19,99,,DAL,W 99-95,240,35,73,.479,26,53,.491,9,20,.450,20,29,.690,99,37,82,.451,23,46,.500,14,36,.389,7,11,.636,95
1723,DAL,2017-01-17,99,@,CHI,W 99-98,240,37,78,.474,26,50,.520,11,28,.393,14,18,.778,99,37,82,.451,31,68,.456,6,14,.429,18,22,.818,98
1724,NOP,2017-01-14,99,@,CHI,L 99-107,240,39,84,.464,32,61,.525,7,23,.304,14,21,.667,99,43,101,.426,35,81,.432,8,20,.400,13,23,.565,107
1725,CHI,2017-01-10,99,@,WAS,L 99-101,240,35,88,.398,25,61,.410,10,27,.370,19,21,.905,99,42,83,.506,31,61,.508,11,22,.500,6,9,.667,101
1726,ATL,2017-01-05,99,@,NOP,W 99-94,240,38,90,.422,29,67,.433,9,23,.391,14,17,.824,99,34,93,.366,19,58,.328,15,35,.429,11,14,.786,94
1727,DEN,2017-01-05,99,,SAS,L 99-127,240,39,86,.453,32,61,.525,7,25,.280,14,17,.824,99,51,90,.567,39,66,.591,12,24,.500,13,17,.765,127
1728,PHO,2017-01-03,99,,MIA,W 99-90,240,36,77,.468,27,54,.500,9,23,.391,18,22,.818,99,36,91,.396,30,68,.441,6,23,.261,12,16,.750,90
1729,DAL,2016-12-30,99,@,GSW,L 99-108,240,39,93,.419,31,61,.508,8,32,.250,13,15,.867,99,42,84,.500,31,51,.608,11,33,.333,13,15,.867,108
1730,MIL,2016-12-30,99,@,MIN,L 99-116,240,40,74,.541,32,56,.571,8,18,.444,11,17,.647,99,43,77,.558,30,52,.577,13,25,.520,17,21,.810,116
1731,PHO,2016-12-29,99,,TOR,W 99-91,240,37,83,.446,28,62,.452,9,21,.429,16,23,.696,99,30,75,.400,23,48,.479,7,27,.259,24,29,.828,91
1732,BRK,2016-12-28,99,@,CHI,L 99-101,240,37,86,.430,24,54,.444,13,32,.406,12,16,.750,99,35,88,.398,32,75,.427,3,13,.231,28,29,.966,101
1733,BRK,2016-12-23,99,@,CLE,L 99-119,240,38,85,.447,30,55,.545,8,30,.267,15,18,.833,99,45,99,.455,37,64,.578,8,35,.229,21,24,.875,119
1734,DAL,2016-12-18,99,,SAC,W 99-79,240,34,77,.442,21,44,.477,13,33,.394,18,22,.818,99,30,76,.395,22,45,.489,8,31,.258,11,17,.647,79
1735,ATL,2016-12-17,99,,CHO,L 99-107,240,40,86,.465,30,60,.500,10,26,.385,9,16,.563,99,43,88,.489,31,61,.508,12,27,.444,9,13,.692,107
1736,MIN,2016-12-13,99,@,CHI,W 99-94,240,38,86,.442,32,65,.492,6,21,.286,17,22,.773,99,38,87,.437,34,72,.472,4,15,.267,14,19,.737,94
1737,OKC,2016-12-11,99,,BOS,W 99-96,240,41,83,.494,38,62,.613,3,21,.143,14,27,.519,99,40,90,.444,29,58,.500,11,32,.344,5,8,.625,96
1738,OKC,2016-12-09,99,,HOU,L 99-102,240,34,81,.420,27,53,.509,7,28,.250,24,31,.774,99,36,92,.391,25,50,.500,11,42,.262,19,30,.633,102
1739,PHI,2016-12-08,99,@,NOP,W 99-88,240,39,91,.429,27,51,.529,12,40,.300,9,13,.692,99,33,84,.393,26,59,.441,7,25,.280,15,22,.682,88
1740,UTA,2016-12-08,99,,GSW,L 99-106,240,37,89,.416,27,51,.529,10,38,.263,15,21,.714,99,39,80,.488,27,51,.529,12,29,.414,16,23,.696,106
1741,ATL,2016-12-05,99,,OKC,L 99-102,240,34,77,.442,27,55,.491,7,22,.318,24,32,.750,99,37,80,.463,27,49,.551,10,31,.323,18,28,.643,102
1742,POR,2016-12-03,99,,MIA,W 99-92,240,36,89,.404,27,65,.415,9,24,.375,18,24,.750,99,38,86,.442,32,64,.500,6,22,.273,10,15,.667,92
1743,MIL,2016-11-25,99,,TOR,L 99-105,240,40,79,.506,28,50,.560,12,29,.414,7,12,.583,99,38,82,.463,24,50,.480,14,32,.438,15,19,.789,105
1744,PHI,2016-11-23,99,,MEM,L 99-104 (2OT),290,35,93,.376,23,57,.404,12,36,.333,17,23,.739,99,38,99,.384,28,70,.400,10,29,.345,18,24,.750,104
1745,HOU,2016-11-21,99,@,DET,W 99-96,240,35,78,.449,25,47,.532,10,31,.323,19,27,.704,99,36,87,.414,29,70,.414,7,17,.412,17,24,.708,96
1746,BOS,2016-11-21,99,@,MIN,W 99-93,240,38,84,.452,26,46,.565,12,38,.316,11,14,.786,99,36,86,.419,32,62,.516,4,24,.167,17,25,.680,93
1747,TOR,2016-11-20,99,@,SAC,L 99-102,240,34,85,.400,25,61,.410,9,24,.375,22,24,.917,99,36,81,.444,25,54,.463,11,27,.407,19,25,.760,102
1748,LAL,2016-11-13,99,@,MIN,L 99-125,240,33,71,.465,25,47,.532,8,24,.333,25,30,.833,99,42,80,.525,29,53,.547,13,27,.481,28,42,.667,125
1749,IND,2016-11-12,99,,BOS,L 99-105,240,36,86,.419,30,59,.508,6,27,.222,21,28,.750,99,35,80,.438,27,55,.491,8,25,.320,27,33,.818,105
1750,NOP,2016-11-12,99,,LAL,L 99-126,240,39,90,.433,33,70,.471,6,20,.300,15,19,.789,99,52,94,.553,36,64,.563,16,30,.533,6,7,.857,126
1751,SAS,2016-11-09,99,,HOU,L 99-101,240,33,84,.393,26,61,.426,7,23,.304,26,30,.867,99,37,78,.474,27,48,.563,10,30,.333,17,22,.773,101
1752,LAC,2016-11-04,99,@,MEM,W 99-88,240,32,85,.376,24,58,.414,8,27,.296,27,33,.818,99,31,84,.369,22,58,.379,9,26,.346,17,22,.773,88
1753,CHO,2016-11-04,99,@,BRK,W 99-95,240,36,86,.419,26,56,.464,10,30,.333,17,24,.708,99,35,87,.402,26,51,.510,9,36,.250,16,21,.762,95
1754,MIN,2016-11-03,99,,DEN,L 99-102,240,35,88,.398,26,66,.394,9,22,.409,20,25,.800,99,39,81,.481,33,59,.559,6,22,.273,18,25,.720,102
1755,NYK,2016-11-02,99,,HOU,L 99-118,240,37,85,.435,29,65,.446,8,20,.400,17,25,.680,99,42,89,.472,27,49,.551,15,40,.375,19,27,.704,118
1756,MIA,2016-10-30,99,,SAS,L 99-106,240,37,80,.463,30,60,.500,7,20,.350,18,26,.692,99,37,82,.451,27,64,.422,10,18,.556,22,26,.846,106
1757,ORL,2016-10-29,99,@,CLE,L 99-105,240,38,84,.452,30,56,.536,8,28,.286,15,26,.577,99,36,88,.409,25,51,.490,11,37,.297,22,30,.733,105
1758,WAS,2016-10-27,99,@,ATL,L 99-114,240,40,94,.426,34,74,.459,6,20,.300,13,18,.722,99,44,88,.500,32,62,.516,12,26,.462,14,18,.778,114
1759,BOS,2016-10-27,99,@,CHI,L 99-105,240,38,76,.500,30,53,.566,8,23,.348,15,24,.625,99,36,92,.391,25,67,.373,11,25,.440,22,30,.733,105
1760,TOR,2017-04-12,98,@,CLE,W 98-83,240,40,86,.465,32,60,.533,8,26,.308,10,16,.625,98,28,76,.368,18,39,.462,10,37,.270,17,24,.708,83
1761,MIN,2017-04-11,98,,OKC,L 98-100,240,38,86,.442,33,66,.500,5,20,.250,17,25,.680,98,37,86,.430,30,64,.469,7,22,.318,19,25,.760,100
1762,SAS,2017-04-10,98,@,POR,L 98-99,240,38,83,.458,30,62,.484,8,21,.381,14,20,.700,98,37,89,.416,25,62,.403,12,27,.444,13,15,.867,99
1763,LAC,2017-04-08,98,@,SAS,W 98-87,240,42,84,.500,36,62,.581,6,22,.273,8,14,.571,98,34,80,.425,26,58,.448,8,22,.364,11,14,.786,87
1764,LAL,2017-04-07,98,,SAC,W 98-94,240,38,86,.442,34,62,.548,4,24,.167,18,25,.720,98,38,75,.507,30,55,.545,8,20,.400,10,13,.769,94
1765,MIN,2017-04-06,98,@,POR,L 98-105,240,38,87,.437,34,69,.493,4,18,.222,18,20,.900,98,35,81,.432,21,48,.438,14,33,.424,21,26,.808,105
1766,SAC,2017-04-04,98,,DAL,W 98-87,240,36,81,.444,24,59,.407,12,22,.545,14,17,.824,98,32,80,.400,20,37,.541,12,43,.279,11,14,.786,87
1767,NYK,2017-03-31,98,@,MIA,W 98-94,240,38,80,.475,32,64,.500,6,16,.375,16,17,.941,98,34,83,.410,26,50,.520,8,33,.242,18,25,.720,94
1768,HOU,2017-03-31,98,@,GSW,L 98-107,240,34,91,.374,22,54,.407,12,37,.324,18,23,.783,98,43,95,.453,32,63,.508,11,32,.344,10,14,.714,107
1769,SAS,2017-03-29,98,,GSW,L 98-110,240,34,83,.410,25,59,.424,9,24,.375,21,26,.808,98,43,85,.506,30,59,.508,13,26,.500,11,11,1.000,110
1770,SAC,2017-03-26,98,@,LAC,W 98-97,240,38,84,.452,25,56,.446,13,28,.464,9,13,.692,98,32,78,.410,22,49,.449,10,29,.345,23,28,.821,97
1771,NYK,2017-03-25,98,@,SAS,L 98-106,240,41,87,.471,38,77,.494,3,10,.300,13,15,.867,98,45,99,.455,35,74,.473,10,25,.400,6,8,.750,106
1772,PHO,2017-03-23,98,@,BRK,L 98-126,240,34,93,.366,27,68,.397,7,25,.280,23,34,.676,98,43,95,.453,35,66,.530,8,29,.276,32,42,.762,126
1773,SAC,2017-03-22,98,,MIL,L 98-116,240,41,84,.488,31,58,.534,10,26,.385,6,10,.600,98,43,81,.531,27,46,.587,16,35,.457,14,19,.737,116
1774,BRK,2017-03-21,98,,DET,W 98-96,240,38,88,.432,28,59,.475,10,29,.345,12,19,.632,98,40,92,.435,35,69,.507,5,23,.217,11,16,.688,96
1775,CHO,2017-03-18,98,,WAS,W 98-93,240,35,82,.427,26,58,.448,9,24,.375,19,27,.704,98,29,79,.367,18,46,.391,11,33,.333,24,31,.774,93
1776,BOS,2017-03-17,98,@,BRK,W 98-95,240,34,85,.400,27,56,.482,7,29,.241,23,29,.793,98,30,83,.361,19,48,.396,11,35,.314,24,30,.800,95
1777,IND,2017-03-15,98,,CHO,W 98-77,240,39,73,.534,27,45,.600,12,28,.429,8,9,.889,98,32,80,.400,29,57,.509,3,23,.130,10,13,.769,77
1778,MEM,2017-03-15,98,@,CHI,W 98-91,240,36,85,.424,25,54,.463,11,31,.355,15,18,.833,98,34,91,.374,23,63,.365,11,28,.393,12,15,.800,91
1779,MIA,2017-03-12,98,@,IND,L 98-102,240,39,94,.415,30,62,.484,9,32,.281,11,16,.688,98,35,82,.427,30,67,.448,5,15,.333,27,32,.844,102
1780,DAL,2017-03-11,98,,PHO,L 98-100,240,28,74,.378,19,48,.396,9,26,.346,33,36,.917,98,38,83,.458,32,62,.516,6,21,.286,18,20,.900,100
1781,MEM,2017-03-09,98,,LAC,L 98-114,240,37,83,.446,30,63,.476,7,20,.350,17,22,.773,98,40,78,.513,29,48,.604,11,30,.367,23,28,.821,114
1782,ORL,2017-03-08,98,,CHI,W 98-91,240,37,89,.416,30,64,.469,7,25,.280,17,21,.810,98,36,81,.444,24,53,.453,12,28,.429,7,11,.636,91
1783,DET,2017-03-08,98,@,IND,L 98-115,240,39,89,.438,32,63,.508,7,26,.269,13,22,.591,98,44,88,.500,33,65,.508,11,23,.478,16,19,.842,115
1784,PHI,2017-03-06,98,,MIL,L 98-112,240,39,89,.438,31,59,.525,8,30,.267,12,19,.632,98,41,83,.494,27,50,.540,14,33,.424,16,20,.800,112
1785,CLE,2017-03-06,98,,MIA,L 98-106,240,35,78,.449,26,51,.510,9,27,.333,19,29,.655,98,39,91,.429,23,56,.411,16,35,.457,12,14,.857,106
1786,NOP,2017-03-03,98,,SAS,L 98-101 (OT),265,35,91,.385,27,66,.409,8,25,.320,20,24,.833,98,40,95,.421,34,68,.500,6,27,.222,15,25,.600,101
1787,MIL,2017-03-01,98,,DEN,L 98-110,240,38,83,.458,29,65,.446,9,18,.500,13,15,.867,98,41,84,.488,31,51,.608,10,33,.303,18,20,.900,110
1788,PHI,2017-03-01,98,@,MIA,L 98-125,240,37,85,.435,31,68,.456,6,17,.353,18,22,.818,98,49,90,.544,36,60,.600,13,30,.433,14,21,.667,125
1789,BOS,2017-02-27,98,,ATL,L 98-114,240,34,87,.391,24,53,.453,10,34,.294,20,25,.800,98,46,95,.484,40,70,.571,6,25,.240,16,20,.800,114
1790,DEN,2017-02-26,98,,MEM,L 98-105,240,37,84,.440,26,50,.520,11,34,.324,13,17,.765,98,36,80,.450,25,47,.532,11,33,.333,22,25,.880,105
1791,DET,2017-02-26,98,,BOS,L 98-104,240,35,81,.432,23,48,.479,12,33,.364,16,35,.457,98,34,85,.400,22,50,.440,12,35,.343,24,30,.800,104
1792,LAL,2017-02-26,98,,SAS,L 98-119,240,40,87,.460,33,65,.508,7,22,.318,11,18,.611,98,49,94,.521,39,73,.534,10,21,.476,11,13,.846,119
1793,IND,2017-02-16,98,,WAS,L 98-111,240,40,80,.500,36,62,.581,4,18,.222,14,18,.778,98,43,83,.518,28,54,.519,15,29,.517,10,15,.667,111
1794,DET,2017-02-15,98,,DAL,W 98-91,240,36,82,.439,30,63,.476,6,19,.316,20,22,.909,98,35,92,.380,25,55,.455,10,37,.270,11,11,1.000,91
1795,DAL,2017-02-13,98,,BOS,L 98-111,240,35,77,.455,26,50,.520,9,27,.333,19,25,.760,98,40,81,.494,24,47,.511,16,34,.471,15,18,.833,111
1796,OKC,2017-02-13,98,@,WAS,L 98-120,240,34,96,.354,27,62,.435,7,34,.206,23,30,.767,98,42,73,.575,29,53,.547,13,20,.650,23,28,.821,120
1797,CHO,2017-02-04,98,@,UTA,L 98-105,240,35,82,.427,22,49,.449,13,33,.394,15,18,.833,98,38,81,.469,25,48,.521,13,33,.394,16,24,.667,105
1798,IND,2017-02-01,98,@,ORL,W 98-88,240,33,69,.478,24,49,.490,9,20,.450,23,26,.885,98,31,77,.403,25,53,.472,6,24,.250,20,28,.714,88
1799,NOP,2017-02-01,98,@,DET,L 98-118,240,41,82,.500,36,61,.590,5,21,.238,11,14,.786,98,48,88,.545,38,62,.613,10,26,.385,12,17,.706,118
1800,CHO,2017-01-31,98,@,POR,L 98-115,240,33,83,.398,22,52,.423,11,31,.355,21,25,.840,98,42,93,.452,31,62,.500,11,31,.355,20,23,.870,115
1801,LAC,2017-01-28,98,@,GSW,L 98-144,240,36,82,.439,24,54,.444,12,28,.429,14,22,.636,98,57,92,.620,40,58,.690,17,34,.500,13,16,.813,144
1802,ORL,2017-01-27,98,@,BOS,L 98-128,240,38,87,.437,29,62,.468,9,25,.360,13,18,.722,98,50,89,.562,34,55,.618,16,34,.471,12,15,.800,128
1803,DAL,2017-01-26,98,@,OKC,L 98-109,240,38,84,.452,27,58,.466,11,26,.423,11,13,.846,98,37,72,.514,28,50,.560,9,22,.409,26,36,.722,109
1804,LAL,2017-01-25,98,@,POR,L 98-105,240,37,94,.394,26,64,.406,11,30,.367,13,14,.929,98,43,90,.478,39,75,.520,4,15,.267,15,20,.750,105
1805,ORL,2017-01-22,98,,GSW,L 98-118,240,42,96,.438,35,68,.515,7,28,.250,7,16,.438,98,42,89,.472,23,47,.489,19,42,.452,15,19,.789,118
1806,LAC,2017-01-21,98,@,DEN,L 98-123,240,40,96,.417,30,64,.469,10,32,.313,8,8,1.000,98,46,87,.529,36,63,.571,10,24,.417,21,26,.808,123
1807,ORL,2017-01-18,98,@,NOP,L 98-118,240,39,88,.443,28,56,.500,11,32,.344,9,11,.818,98,46,93,.495,31,57,.544,15,36,.417,11,15,.733,118
1808,CHI,2017-01-17,98,,DAL,L 98-99,240,37,82,.451,31,68,.456,6,14,.429,18,22,.818,98,37,78,.474,26,50,.520,11,28,.393,14,18,.778,99
1809,CHO,2017-01-16,98,@,BOS,L 98-108,240,38,86,.442,30,61,.492,8,25,.320,14,17,.824,98,42,84,.500,27,45,.600,15,39,.385,9,10,.900,108
1810,OKC,2017-01-16,98,@,LAC,L 98-120,240,36,85,.424,26,55,.473,10,30,.333,16,19,.842,98,45,82,.549,33,54,.611,12,28,.429,18,22,.818,120
1811,IND,2017-01-16,98,,NOP,W 98-95,240,41,81,.506,36,62,.581,5,19,.263,11,16,.688,98,36,83,.434,26,58,.448,10,25,.400,13,18,.722,95
1812,MIL,2017-01-15,98,@,ATL,L 98-111,240,39,79,.494,33,60,.550,6,19,.316,14,18,.778,98,42,80,.525,29,54,.537,13,26,.500,14,18,.778,111
1813,DAL,2017-01-15,98,,MIN,W 98-87,240,36,77,.468,24,48,.500,12,29,.414,14,19,.737,98,35,80,.438,30,59,.508,5,21,.238,12,18,.667,87
1814,PHI,2017-01-11,98,,NYK,W 98-97,240,37,95,.389,30,67,.448,7,28,.250,17,21,.810,98,42,86,.488,38,64,.594,4,22,.182,9,10,.900,97
1815,LAC,2017-01-08,98,,MIA,W 98-86,240,36,86,.419,27,56,.482,9,30,.300,17,25,.680,98,31,84,.369,24,57,.421,7,27,.259,17,21,.810,86
1816,SAC,2017-01-06,98,,LAC,L 98-106,240,36,87,.414,27,57,.474,9,30,.300,17,22,.773,98,39,84,.464,26,53,.491,13,31,.419,15,21,.714,106
1817,PHO,2017-01-02,98,@,LAC,L 98-109,240,39,102,.382,37,87,.425,2,15,.133,18,22,.818,98,37,80,.463,30,64,.469,7,16,.438,28,38,.737,109
1818,MIL,2017-01-02,98,,OKC,W 98-94,240,38,79,.481,31,60,.517,7,19,.368,15,24,.625,98,36,78,.462,27,51,.529,9,27,.333,13,19,.684,94
1819,MIA,2017-01-01,98,,DET,L 98-107,240,35,77,.455,21,51,.412,14,26,.538,14,18,.778,98,42,86,.488,33,64,.516,9,22,.409,14,22,.636,107
1820,SAC,2016-12-31,98,,MEM,L 98-112,240,31,72,.431,20,44,.455,11,28,.393,25,28,.893,98,44,87,.506,27,52,.519,17,35,.486,7,9,.778,112
1821,DET,2016-12-30,98,@,ATL,L 98-105,240,35,84,.417,26,53,.491,9,31,.290,19,21,.905,98,39,88,.443,31,62,.500,8,26,.308,19,25,.760,105
1822,LAC,2016-12-28,98,@,NOP,L 98-102,240,37,94,.394,26,57,.456,11,37,.297,13,18,.722,98,40,87,.460,30,58,.517,10,29,.345,12,21,.571,102
1823,PHO,2016-12-28,98,@,SAS,L 98-119,240,36,74,.486,29,58,.500,7,16,.438,19,24,.792,98,47,87,.540,42,70,.600,5,17,.294,20,25,.800,119
1824,NYK,2016-12-28,98,@,ATL,L 98-102 (OT),265,35,93,.376,28,66,.424,7,27,.259,21,26,.808,98,37,101,.366,30,74,.405,7,27,.259,21,27,.778,102
1825,UTA,2016-12-23,98,,TOR,L 98-104,240,35,79,.443,25,52,.481,10,27,.370,18,21,.857,98,43,81,.531,35,60,.583,8,21,.381,10,15,.667,104
1826,MEM,2016-12-21,98,@,DET,W 98-86,240,35,82,.427,23,52,.442,12,30,.400,16,19,.842,98,26,72,.361,20,49,.408,6,23,.261,28,37,.757,86
1827,MIA,2016-12-16,98,,LAC,L 98-102,240,38,93,.409,32,66,.485,6,27,.222,16,25,.640,98,36,83,.434,29,58,.500,7,25,.280,23,29,.793,102
1828,SAC,2016-12-14,98,@,HOU,L 98-132,240,39,92,.424,28,60,.467,11,32,.344,9,11,.818,98,50,85,.588,28,43,.651,22,42,.524,10,16,.625,132
1829,LAC,2016-12-07,98,,GSW,L 98-115,240,36,92,.391,28,66,.424,8,26,.308,18,24,.750,98,42,89,.472,35,58,.603,7,31,.226,24,29,.828,115
1830,PHI,2016-12-05,98,,DEN,L 98-106,240,35,86,.407,24,55,.436,11,31,.355,17,23,.739,98,35,76,.461,25,49,.510,10,27,.370,26,34,.765,106
1831,ORL,2016-12-04,98,@,DET,W 98-92,240,42,79,.532,35,56,.625,7,23,.304,7,14,.500,98,38,86,.442,28,59,.475,10,27,.370,6,13,.462,92
1832,SAC,2016-12-04,98,@,NYK,L 98-106,240,31,97,.320,22,69,.319,9,28,.321,27,31,.871,98,39,88,.443,28,59,.475,11,29,.379,17,24,.708,106
1833,DEN,2016-12-03,98,@,UTA,L 98-105,240,37,83,.446,24,59,.407,13,24,.542,11,14,.786,98,35,78,.449,26,53,.491,9,25,.360,26,28,.929,105
1834,DEN,2016-11-30,98,,MIA,L 98-106,240,38,91,.418,31,69,.449,7,22,.318,15,24,.625,98,41,93,.441,32,69,.464,9,24,.375,15,26,.577,106
1835,MIN,2016-11-25,98,@,PHO,W 98-85,240,34,85,.400,27,63,.429,7,22,.318,23,25,.920,98,32,79,.405,26,53,.491,6,26,.231,15,21,.714,85
1836,CHI,2016-11-10,98,@,MIA,W 98-95,240,37,89,.416,31,73,.425,6,16,.375,18,20,.900,98,36,88,.409,23,59,.390,13,29,.448,10,15,.667,95
1837,UTA,2016-11-09,98,@,CHO,L 98-104,240,38,82,.463,30,48,.625,8,34,.235,14,18,.778,98,38,82,.463,30,56,.536,8,26,.308,20,29,.690,104
1838,PHO,2016-10-31,98,@,LAC,L 98-116,240,35,84,.417,30,69,.435,5,15,.333,23,31,.742,98,40,80,.500,34,64,.531,6,16,.375,30,38,.789,116
1839,DET,2016-10-30,98,,MIL,W 98-83,240,39,88,.443,34,68,.500,5,20,.250,15,20,.750,98,34,87,.391,30,70,.429,4,17,.235,11,14,.786,83
1840,CHO,2016-10-29,98,,BOS,L 98-104,240,32,79,.405,23,47,.489,9,32,.281,25,33,.758,98,39,81,.481,24,50,.480,15,31,.484,11,17,.647,104
1841,SAS,2016-10-29,98,,NOP,W 98-79,240,35,83,.422,25,59,.424,10,24,.417,18,23,.783,98,32,86,.372,28,64,.438,4,22,.182,11,15,.733,79
1842,DAL,2016-10-28,98,,HOU,L 98-106,240,35,80,.438,27,51,.529,8,29,.276,20,24,.833,98,33,70,.471,18,38,.474,15,32,.469,25,31,.806,106
1843,MIN,2016-10-26,98,@,MEM,L 98-102,240,36,86,.419,30,68,.441,6,18,.333,20,29,.690,98,36,80,.450,25,56,.446,11,24,.458,19,27,.704,102
1844,SAS,2017-04-12,97,@,UTA,L 97-101,240,39,86,.453,31,65,.477,8,21,.381,11,13,.846,97,39,77,.506,29,51,.569,10,26,.385,13,20,.650,101
1845,NYK,2017-04-09,97,,TOR,L 97-110,240,37,82,.451,28,54,.519,9,28,.321,14,15,.933,97,40,77,.519,30,46,.652,10,31,.323,20,23,.870,110
1846,IND,2017-03-29,97,@,MEM,L 97-110,240,37,85,.435,27,60,.450,10,25,.400,13,15,.867,97,41,88,.466,29,56,.518,12,32,.375,16,18,.889,110
1847,MIA,2017-03-28,97,@,DET,W 97-96,240,36,79,.456,31,58,.534,5,21,.238,20,28,.714,97,36,85,.424,28,58,.483,8,27,.296,16,21,.762,96
1848,LAC,2017-03-26,97,,SAC,L 97-98,240,32,78,.410,22,49,.449,10,29,.345,23,28,.821,97,38,84,.452,25,56,.446,13,28,.464,9,13,.692,98
1849,POR,2017-03-26,97,@,LAL,W 97-81,240,36,89,.404,24,61,.393,12,28,.429,13,18,.722,97,33,84,.393,28,63,.444,5,21,.238,10,17,.588,81
1850,ATL,2017-03-24,97,@,MIL,L 97-100,240,34,83,.410,26,61,.426,8,22,.364,21,24,.875,97,39,88,.443,31,61,.508,8,27,.296,14,16,.875,100
1851,DAL,2017-03-23,97,,LAC,W 97-95,240,38,82,.463,29,56,.518,9,26,.346,12,18,.667,97,36,80,.450,27,53,.509,9,27,.333,14,21,.667,95
1852,SAS,2017-03-23,97,,MEM,W 97-90,240,37,77,.481,29,51,.569,8,26,.308,15,23,.652,97,34,78,.436,24,49,.490,10,29,.345,12,15,.800,90
1853,PHI,2017-03-22,97,@,OKC,L 97-122,240,37,87,.425,29,62,.468,8,25,.320,15,17,.882,97,48,88,.545,44,72,.611,4,16,.250,22,30,.733,122
1854,PHO,2017-03-21,97,@,MIA,L 97-112,240,36,82,.439,32,66,.485,4,16,.250,21,29,.724,97,42,96,.438,31,69,.449,11,27,.407,17,23,.739,112
1855,ATL,2017-03-18,97,,POR,L 97-113,240,32,88,.364,25,62,.403,7,26,.269,26,32,.813,97,44,87,.506,36,69,.522,8,18,.444,17,19,.895,113
1856,MIL,2017-03-15,97,@,LAC,W 97-96,240,34,76,.447,24,47,.511,10,29,.345,19,25,.760,97,35,75,.467,30,51,.588,5,24,.208,21,29,.724,96
1857,UTA,2017-03-15,97,@,DET,W 97-83,240,36,77,.468,23,49,.469,13,28,.464,12,16,.750,97,36,86,.419,33,73,.452,3,13,.231,8,12,.667,83
1858,LAL,2017-03-05,97,,NOP,L 97-105,240,38,83,.458,28,55,.509,10,28,.357,11,15,.733,97,36,89,.404,27,65,.415,9,24,.375,24,35,.686,105
1859,IND,2017-03-05,97,@,ATL,W 97-96,240,35,78,.449,20,45,.444,15,33,.455,12,21,.571,97,34,77,.442,25,50,.500,9,27,.333,19,31,.613,96
1860,SAS,2017-03-04,97,,MIN,W 97-90 (OT),265,38,94,.404,32,70,.457,6,24,.250,15,24,.625,97,35,89,.393,31,73,.425,4,16,.250,16,22,.727,90
1861,BRK,2017-03-03,97,@,UTA,L 97-112,240,36,89,.404,29,59,.492,7,30,.233,18,24,.750,97,38,74,.514,26,48,.542,12,26,.462,24,34,.706,112
1862,LAC,2017-02-24,97,,SAS,L 97-105,240,35,79,.443,28,56,.500,7,23,.304,20,24,.833,97,35,82,.427,26,56,.464,9,26,.346,26,30,.867,105
1863,BOS,2017-02-24,97,@,TOR,L 97-107,240,33,78,.423,21,40,.525,12,38,.316,19,22,.864,97,40,81,.494,35,66,.530,5,15,.333,22,29,.759,107
1864,MIN,2017-02-24,97,,DAL,W 97-84,240,41,78,.526,36,65,.554,5,13,.385,10,14,.714,97,35,83,.422,27,50,.540,8,33,.242,6,9,.667,84
1865,SAC,2017-02-14,97,@,LAL,W 97-96,240,36,73,.493,29,49,.592,7,24,.292,18,25,.720,97,38,83,.458,26,54,.481,12,29,.414,8,15,.533,96
1866,CHI,2017-02-10,97,@,PHO,L 97-115,240,37,86,.430,32,67,.478,5,19,.263,18,22,.818,97,48,95,.505,40,76,.526,8,19,.421,11,13,.846,115
1867,DEN,2017-02-04,97,@,SAS,L 97-121,240,41,92,.446,31,66,.470,10,26,.385,5,10,.500,97,45,79,.570,35,58,.603,10,21,.476,21,26,.808,121
1868,BRK,2017-02-03,97,,IND,L 97-106,240,32,86,.372,21,58,.362,11,28,.393,22,23,.957,97,37,86,.430,29,66,.439,8,20,.400,24,31,.774,106
1869,MIN,2017-02-01,97,@,CLE,L 97-125,240,41,94,.436,34,73,.466,7,21,.333,8,10,.800,97,48,89,.539,33,52,.635,15,37,.405,14,22,.636,125
1870,CLE,2017-01-30,97,@,DAL,L 97-104,240,35,75,.467,23,43,.535,12,32,.375,15,21,.714,97,39,86,.453,30,54,.556,9,32,.281,17,18,.944,104
1871,OKC,2017-01-23,97,@,UTA,W 97-95,240,36,83,.434,30,63,.476,6,20,.300,19,25,.760,97,36,84,.429,31,63,.492,5,21,.238,18,26,.692,95
1872,MIL,2017-01-21,97,@,MIA,L 97-109,240,33,79,.418,27,61,.443,6,18,.333,25,32,.781,97,41,77,.532,28,47,.596,13,30,.433,14,22,.636,109
1873,LAL,2017-01-15,97,,DET,L 97-102,240,36,83,.434,30,57,.526,6,26,.231,19,24,.792,97,41,95,.432,32,70,.457,9,25,.360,11,16,.688,102
1874,LAL,2017-01-14,97,@,LAC,L 97-113,240,36,80,.450,26,59,.441,10,21,.476,15,27,.556,97,48,92,.522,38,64,.594,10,28,.357,7,8,.875,113
1875,NYK,2017-01-11,97,@,PHI,L 97-98,240,42,86,.488,38,64,.594,4,22,.182,9,10,.900,97,37,95,.389,30,67,.448,7,28,.250,17,21,.810,98
1876,BRK,2017-01-10,97,,ATL,L 97-117,240,35,87,.402,25,58,.431,10,29,.345,17,23,.739,97,44,92,.478,37,69,.536,7,23,.304,22,38,.579,117
1877,ATL,2017-01-07,97,@,DAL,W 97-82,240,30,74,.405,19,52,.365,11,22,.500,26,32,.813,97,32,82,.390,23,46,.500,9,36,.250,9,10,.900,82
1878,CHI,2016-12-21,97,,WAS,L 97-107,240,38,95,.400,32,74,.432,6,21,.286,15,19,.789,97,43,82,.524,40,64,.625,3,18,.167,18,25,.720,107
1879,CHI,2016-12-15,97,@,MIL,L 97-108,240,35,74,.473,30,54,.556,5,20,.250,22,29,.759,97,45,95,.474,34,75,.453,11,20,.550,7,13,.538,108
1880,LAL,2016-12-14,97,@,BRK,L 97-107,240,35,91,.385,29,64,.453,6,27,.222,21,34,.618,97,33,86,.384,22,51,.431,11,35,.314,30,40,.750,107
1881,PHI,2016-12-11,97,@,DET,W 97-79,240,38,68,.559,31,51,.608,7,17,.412,14,17,.824,97,32,82,.390,27,63,.429,5,19,.263,10,14,.714,79
1882,SAS,2016-12-05,97,@,MIL,W 97-96,240,40,93,.430,32,65,.492,8,28,.286,9,14,.643,97,30,73,.411,24,49,.490,6,24,.250,30,34,.882,96
1883,BOS,2016-12-02,97,,SAC,W 97-92,240,36,88,.409,25,60,.417,11,28,.393,14,15,.933,97,33,88,.375,27,62,.435,6,26,.231,20,25,.800,92
1884,CHO,2016-12-01,97,,DAL,W 97-87,240,35,74,.473,30,56,.536,5,18,.278,22,31,.710,97,32,86,.372,23,55,.418,9,31,.290,14,18,.778,87
1885,BRK,2016-11-25,97,@,IND,L 97-118,240,36,79,.456,25,45,.556,11,34,.324,14,23,.609,97,48,87,.552,37,61,.607,11,26,.423,11,16,.688,118
1886,LAC,2016-11-25,97,@,DET,L 97-108,240,35,73,.479,28,52,.538,7,21,.333,20,26,.769,97,47,90,.522,38,71,.535,9,19,.474,5,7,.714,108
1887,LAL,2016-11-08,97,,DAL,L 97-109,240,38,78,.487,28,52,.538,10,26,.385,11,14,.786,97,43,82,.524,33,59,.559,10,23,.435,13,15,.867,109
1888,OKC,2016-11-07,97,,MIA,W 97-85,240,37,85,.435,28,57,.491,9,28,.321,14,17,.824,97,31,84,.369,27,67,.403,4,17,.235,19,22,.864,85
1889,HOU,2016-11-05,97,@,ATL,L 97-112,240,37,85,.435,25,49,.510,12,36,.333,11,13,.846,97,45,85,.529,37,65,.569,8,20,.400,14,24,.583,112
1890,GSW,2016-11-04,97,@,LAL,L 97-117,240,39,86,.453,34,54,.630,5,32,.156,14,20,.700,97,45,95,.474,37,65,.569,8,30,.267,19,21,.905,117
1891,UTA,2016-11-02,97,,DAL,W 97-81,240,35,77,.455,23,52,.442,12,25,.480,15,26,.577,97,33,77,.429,26,51,.510,7,26,.269,8,10,.800,81
1892,CHO,2016-10-28,97,@,MIA,W 97-91,240,35,92,.380,28,70,.400,7,22,.318,20,24,.833,97,32,86,.372,18,52,.346,14,34,.412,13,20,.650,91
1893,PHI,2016-10-26,97,,OKC,L 97-103,240,36,84,.429,29,60,.483,7,24,.292,18,25,.720,97,39,94,.415,33,72,.458,6,22,.273,19,26,.731,103
1894,NOP,2017-04-11,96,@,LAL,L 96-108,240,37,79,.468,30,57,.526,7,22,.318,15,20,.750,96,42,88,.477,34,66,.515,8,22,.364,16,23,.696,108
1895,HOU,2017-04-10,96,@,LAC,L 96-125,240,33,84,.393,24,44,.545,9,40,.225,21,27,.778,96,46,91,.505,36,65,.554,10,26,.385,23,28,.821,125
1896,TOR,2017-04-07,96,,MIA,W 96-94,240,35,85,.412,26,65,.400,9,20,.450,17,24,.708,96,33,83,.398,25,60,.417,8,23,.348,20,29,.690,94
1897,DET,2017-03-28,96,,MIA,L 96-97,240,36,85,.424,28,58,.483,8,27,.296,16,21,.762,96,36,79,.456,31,58,.534,5,21,.238,20,28,.714,97
1898,DET,2017-03-21,96,@,BRK,L 96-98,240,40,92,.435,35,69,.507,5,23,.217,11,16,.688,96,38,88,.432,28,59,.475,10,29,.345,12,19,.632,98
1899,SAS,2017-03-18,96,@,MEM,L 96-104,240,33,75,.440,24,47,.511,9,28,.321,21,22,.955,96,32,76,.421,19,46,.413,13,30,.433,27,31,.871,104
1900,LAC,2017-03-15,96,,MIL,L 96-97,240,35,75,.467,30,51,.588,5,24,.208,21,29,.724,96,34,76,.447,24,47,.511,10,29,.345,19,25,.760,97
1901,DET,2017-03-14,96,@,CLE,L 96-128,240,37,99,.374,33,80,.413,4,19,.211,18,19,.947,96,46,77,.597,27,47,.574,19,30,.633,17,23,.739,128
1902,BRK,2017-03-10,96,@,DAL,L 96-105,240,34,78,.436,25,47,.532,9,31,.290,19,23,.826,96,33,78,.423,19,45,.422,14,33,.424,25,28,.893,105
1903,SAC,2017-03-06,96,@,DEN,L 96-108,240,36,83,.434,30,67,.448,6,16,.375,18,21,.857,96,37,74,.500,24,44,.545,13,30,.433,21,28,.750,108
1904,ATL,2017-03-05,96,,IND,L 96-97,240,34,77,.442,25,50,.500,9,27,.333,19,31,.613,96,35,78,.449,20,45,.444,15,33,.455,12,21,.571,97
1905,TOR,2017-03-01,96,,WAS,L 96-105,240,33,90,.367,26,70,.371,7,20,.350,23,26,.885,96,40,84,.476,31,59,.525,9,25,.360,16,19,.842,105
1906,DAL,2017-02-27,96,,MIA,W 96-89,240,33,76,.434,24,58,.414,9,18,.500,21,23,.913,96,37,83,.446,28,57,.491,9,26,.346,6,13,.462,89
1907,PHO,2017-02-26,96,@,MIL,L 96-100,240,40,83,.482,35,69,.507,5,14,.357,11,16,.688,96,39,76,.513,33,56,.589,6,20,.300,16,18,.889,100
1908,DAL,2017-02-25,96,,NOP,W 96-83,240,36,78,.462,24,52,.462,12,26,.462,12,16,.750,96,31,78,.397,26,54,.481,5,24,.208,16,25,.640,83
1909,LAL,2017-02-14,96,,SAC,L 96-97,240,38,83,.458,26,54,.481,12,29,.414,8,15,.533,96,36,73,.493,29,49,.592,7,24,.292,18,25,.720,97
1910,PHI,2017-02-06,96,@,DET,L 96-113,240,36,85,.424,31,57,.544,5,28,.179,19,28,.679,96,46,99,.465,41,77,.532,5,22,.227,16,17,.941,113
1911,BRK,2017-01-30,96,@,MIA,L 96-104,240,37,87,.425,33,61,.541,4,26,.154,18,22,.818,96,39,82,.476,28,56,.500,11,26,.423,15,23,.652,104
1912,PHO,2017-01-30,96,,MEM,L 96-115,240,31,74,.419,26,55,.473,5,19,.263,29,39,.744,96,39,80,.488,23,52,.442,16,28,.571,21,24,.875,115
1913,UTA,2017-01-26,96,,LAL,W 96-88,240,33,81,.407,27,55,.491,6,26,.231,24,28,.857,96,36,84,.429,32,70,.457,4,14,.286,12,13,.923,88
1914,MIL,2017-01-20,96,@,ORL,L 96-112,240,34,83,.410,24,58,.414,10,25,.400,18,26,.692,96,40,87,.460,32,59,.542,8,28,.286,24,31,.774,112
1915,MIN,2017-01-13,96,,OKC,W 96-86,240,39,86,.453,34,68,.500,5,18,.278,13,14,.929,96,33,85,.388,30,65,.462,3,20,.150,17,21,.810,86
1916,ORL,2017-01-11,96,@,LAC,L 96-105,240,39,92,.424,33,65,.508,6,27,.222,12,18,.667,96,39,76,.513,30,50,.600,9,26,.346,18,26,.692,105
1917,NYK,2017-01-09,96,,NOP,L 96-110,240,36,85,.424,25,56,.446,11,29,.379,13,16,.813,96,41,84,.488,29,57,.509,12,27,.444,16,19,.842,110
1918,CHI,2016-12-31,96,,MIL,L 96-116,240,33,83,.398,23,56,.411,10,27,.370,20,28,.714,96,43,76,.566,34,61,.557,9,15,.600,21,27,.778,116
1919,WAS,2016-12-23,96,@,MIL,L 96-123,240,37,79,.468,30,55,.545,7,24,.292,15,18,.833,96,45,80,.563,36,55,.655,9,25,.360,24,27,.889,123
1920,DAL,2016-12-21,96,@,POR,W 96-95,240,35,83,.422,28,52,.538,7,31,.226,19,23,.826,96,32,72,.444,22,45,.489,10,27,.370,21,28,.750,95
1921,BOS,2016-12-16,96,,CHO,W 96-88,240,34,78,.436,25,50,.500,9,28,.321,19,26,.731,96,32,97,.330,24,67,.358,8,30,.267,16,19,.842,88
1922,SAC,2016-12-16,96,@,MEM,W 96-92,240,31,80,.388,24,56,.429,7,24,.292,27,37,.730,96,29,77,.377,24,52,.462,5,25,.200,29,36,.806,92
1923,BOS,2016-12-11,96,@,OKC,L 96-99,240,40,90,.444,29,58,.500,11,32,.344,5,8,.625,96,41,83,.494,38,62,.613,3,21,.143,14,27,.519,99
1924,MEM,2016-12-06,96,,PHI,W 96-91,240,33,86,.384,31,69,.449,2,17,.118,28,35,.800,96,32,82,.390,18,41,.439,14,41,.341,13,26,.500,91
1925,MIL,2016-12-05,96,,SAS,L 96-97,240,30,73,.411,24,49,.490,6,24,.250,30,34,.882,96,40,93,.430,32,65,.492,8,28,.286,9,14,.643,97
1926,NOP,2016-12-02,96,,LAC,L 96-114,240,39,85,.459,34,65,.523,5,20,.250,13,21,.619,96,45,88,.511,35,64,.547,10,24,.417,14,16,.875,114
1927,LAL,2016-11-30,96,@,CHI,W 96-90,240,33,81,.407,31,73,.425,2,8,.250,28,41,.683,96,32,91,.352,28,70,.400,4,21,.190,22,29,.759,90
1928,ORL,2016-11-27,96,,MIL,L 96-104,240,38,92,.413,31,64,.484,7,28,.250,13,17,.765,96,41,86,.477,33,62,.532,8,24,.333,14,20,.700,104
1929,ATL,2016-11-23,96,@,IND,W 96-85,240,36,85,.424,31,65,.477,5,20,.250,19,22,.864,96,34,84,.405,27,57,.474,7,27,.259,10,14,.714,85
1930,MIN,2016-11-23,96,@,NOP,L 96-117,240,33,86,.384,30,69,.435,3,17,.176,27,33,.818,96,45,83,.542,36,59,.610,9,24,.375,18,23,.783,117
1931,DET,2016-11-21,96,,HOU,L 96-99,240,36,87,.414,29,70,.414,7,17,.412,17,24,.708,96,35,78,.449,25,47,.532,10,31,.323,19,27,.704,99
1932,SAS,2016-11-21,96,,DAL,W 96-91,240,35,75,.467,27,55,.491,8,20,.400,18,25,.720,96,35,74,.473,27,47,.574,8,27,.296,13,20,.650,91
1933,ATL,2016-11-18,96,@,CHO,L 96-100,240,39,84,.464,32,56,.571,7,28,.250,11,17,.647,96,37,90,.411,27,61,.443,10,29,.345,16,24,.667,100
1934,IND,2016-11-18,96,,PHO,L 96-116,240,36,76,.474,35,69,.507,1,7,.143,23,29,.793,96,46,97,.474,37,71,.521,9,26,.346,15,18,.833,116
1935,MIA,2016-11-17,96,,MIL,W 96-73,240,39,97,.402,32,67,.478,7,30,.233,11,21,.524,96,28,85,.329,21,62,.339,7,23,.304,10,13,.769,73
1936,UTA,2016-11-14,96,,MEM,L 96-102,240,35,73,.479,27,45,.600,8,28,.286,18,22,.818,96,36,76,.474,28,55,.509,8,21,.381,22,26,.846,102
1937,MEM,2016-11-12,96,@,MIL,L 96-106,240,35,78,.449,29,48,.604,6,30,.200,20,21,.952,96,36,68,.529,29,50,.580,7,18,.389,27,36,.750,106
1938,PHI,2016-11-12,96,@,ATL,L 96-117,240,36,83,.434,25,54,.463,11,29,.379,13,20,.650,96,48,95,.505,35,63,.556,13,32,.406,8,14,.571,117
1939,SAS,2016-11-11,96,,DET,W 96-86,240,36,81,.444,27,61,.443,9,20,.450,15,19,.789,96,32,76,.421,27,51,.529,5,25,.200,17,21,.810,86
1940,BRK,2016-11-09,96,@,NYK,L 96-110,240,33,79,.418,22,46,.478,11,33,.333,19,27,.704,96,44,92,.478,34,62,.548,10,30,.333,12,17,.706,110
1941,SAC,2016-11-06,96,@,TOR,W 96-91,240,34,78,.436,29,62,.468,5,16,.313,23,31,.742,96,30,84,.357,23,54,.426,7,30,.233,24,31,.774,91
1942,TOR,2016-11-04,96,,MIA,W 96-87,240,37,84,.440,31,59,.525,6,25,.240,16,18,.889,96,34,88,.386,25,60,.417,9,28,.321,10,15,.667,87
1943,OKC,2016-11-03,96,@,GSW,L 96-122,240,35,87,.402,25,60,.417,10,27,.370,16,28,.571,96,46,89,.517,32,59,.542,14,30,.467,16,20,.800,122
1944,SAC,2016-11-01,96,@,MIA,L 96-108 (OT),265,34,89,.382,29,66,.439,5,23,.217,23,27,.852,96,37,86,.430,24,57,.421,13,29,.448,21,29,.724,108
1945,LAL,2016-10-30,96,@,OKC,L 96-113,240,35,87,.402,28,55,.509,7,32,.219,19,24,.792,96,45,95,.474,36,69,.522,9,26,.346,14,17,.824,113
1946,UTA,2016-10-28,96,,LAL,W 96-89,240,31,75,.413,25,50,.500,6,25,.240,28,40,.700,96,32,84,.381,23,61,.377,9,23,.391,16,21,.762,89
1947,MIL,2016-10-26,96,,CHO,L 96-107,240,39,92,.424,36,76,.474,3,16,.188,15,20,.750,96,40,89,.449,33,66,.500,7,23,.304,20,24,.833,107
1948,ORL,2016-10-26,96,,MIA,L 96-108,240,34,89,.382,28,71,.394,6,18,.333,22,28,.786,96,47,97,.485,43,81,.531,4,16,.250,10,16,.625,108
1949,SAC,2017-04-12,95,@,LAC,L 95-115,240,40,81,.494,35,70,.500,5,11,.455,10,14,.714,95,43,83,.518,33,55,.600,10,28,.357,19,25,.760,115
1950,SAS,2017-04-05,95,,LAL,L 95-102,240,39,89,.438,26,54,.481,13,35,.371,4,6,.667,95,42,86,.488,35,72,.486,7,14,.500,11,14,.786,102
1951,SAS,2017-04-04,95,,MEM,W 95-89 (OT),265,35,80,.438,24,59,.407,11,21,.524,14,18,.778,95,35,89,.393,27,64,.422,8,25,.320,11,18,.611,89
1952,UTA,2017-03-31,95,,WAS,W 95-88,240,33,72,.458,23,47,.489,10,25,.400,19,31,.613,95,35,87,.402,30,70,.429,5,17,.294,13,16,.813,88
1953,OKC,2017-03-31,95,,SAS,L 95-100,240,33,81,.407,27,60,.450,6,21,.286,23,27,.852,95,37,85,.435,28,58,.483,9,27,.333,17,27,.630,100
1954,ATL,2017-03-28,95,,PHO,W 95-91,240,34,85,.400,28,58,.483,6,27,.222,21,29,.724,95,35,96,.365,28,65,.431,7,31,.226,14,24,.583,91
1955,DET,2017-03-27,95,@,NYK,L 95-109,240,36,84,.429,27,61,.443,9,23,.391,14,21,.667,95,45,84,.536,38,63,.603,7,21,.333,12,13,.923,109
1956,UTA,2017-03-25,95,@,LAC,L 95-108,240,37,86,.430,29,60,.483,8,26,.308,13,18,.722,95,38,84,.452,31,57,.544,7,27,.259,25,28,.893,108
1957,NYK,2017-03-23,95,@,POR,L 95-110,240,36,88,.409,31,66,.470,5,22,.227,18,20,.900,95,39,80,.488,28,59,.475,11,21,.524,21,29,.724,110
1958,LAC,2017-03-23,95,@,DAL,L 95-97,240,36,80,.450,27,53,.509,9,27,.333,14,21,.667,95,38,82,.463,29,56,.518,9,26,.346,12,18,.667,97
1959,DET,2017-03-22,95,@,CHI,L 95-117,240,39,88,.443,32,68,.471,7,20,.350,10,17,.588,95,47,80,.588,36,57,.632,11,23,.478,12,19,.632,117
1960,NOP,2017-03-21,95,,MEM,W 95-82,240,35,88,.398,26,59,.441,9,29,.310,16,19,.842,95,32,79,.405,23,44,.523,9,35,.257,9,13,.692,82
1961,OKC,2017-03-20,95,,GSW,L 95-111,240,37,87,.425,33,66,.500,4,21,.190,17,31,.548,95,40,83,.482,25,50,.500,15,33,.455,16,21,.762,111
1962,PHO,2017-03-19,95,@,DET,L 95-112,240,35,99,.354,29,77,.377,6,22,.273,19,30,.633,95,40,92,.435,28,67,.418,12,25,.480,20,30,.667,112
1963,CHI,2017-03-18,95,,UTA,W 95-86,240,38,80,.475,31,61,.508,7,19,.368,12,14,.857,95,31,81,.383,24,56,.429,7,25,.280,17,25,.680,86
1964,BRK,2017-03-17,95,,BOS,L 95-98,240,30,83,.361,19,48,.396,11,35,.314,24,30,.800,95,34,85,.400,27,56,.482,7,29,.241,23,29,.793,98
1965,MIN,2017-03-11,95,@,MIL,L 95-102,240,37,81,.457,32,68,.471,5,13,.385,16,21,.762,95,37,80,.463,29,60,.483,8,20,.400,20,23,.870,102
1966,CHI,2017-03-06,95,@,DET,L 95-109,240,34,83,.410,26,55,.473,8,28,.286,19,21,.905,95,45,92,.489,39,71,.549,6,21,.286,13,20,.650,109
1967,LAL,2017-03-03,95,,BOS,L 95-115,240,37,87,.425,31,63,.492,6,24,.250,15,20,.750,95,43,84,.512,33,51,.647,10,33,.303,19,25,.760,115
1968,DAL,2017-03-01,95,@,ATL,L 95-100,240,35,77,.455,21,44,.477,14,33,.424,11,13,.846,95,36,64,.563,26,43,.605,10,21,.476,18,24,.750,100
1969,MIL,2017-02-27,95,@,CLE,L 95-102,240,37,83,.446,26,53,.491,11,30,.367,10,16,.625,95,35,70,.500,25,42,.595,10,28,.357,22,26,.846,102
1970,IND,2017-02-25,95,@,MIA,L 95-113,240,34,85,.400,30,73,.411,4,12,.333,23,26,.885,95,38,78,.487,25,47,.532,13,31,.419,24,31,.774,113
1971,BRK,2017-02-25,95,@,GSW,L 95-112,240,38,94,.404,30,66,.455,8,28,.286,11,17,.647,95,42,100,.420,31,69,.449,11,31,.355,17,22,.773,112
1972,MIL,2017-02-24,95,,UTA,L 95-109,240,32,74,.432,25,56,.446,7,18,.389,24,29,.828,95,37,74,.500,29,51,.569,8,23,.348,27,30,.900,109
1973,NOP,2017-02-15,95,@,MEM,W 95-91,240,37,75,.493,29,57,.509,8,18,.444,13,22,.591,95,33,89,.371,27,56,.482,6,33,.182,19,25,.760,91
1974,CHO,2017-02-09,95,,HOU,L 95-107,240,37,85,.435,29,59,.492,8,26,.308,13,14,.929,95,39,87,.448,26,47,.553,13,40,.325,16,20,.800,107
1975,ATL,2017-02-06,95,,UTA,L 95-120,240,33,74,.446,27,57,.474,6,17,.353,23,32,.719,95,49,80,.613,39,54,.722,10,26,.385,12,18,.667,120
1976,BRK,2017-02-05,95,,TOR,L 95-103,240,32,76,.421,19,42,.452,13,34,.382,18,21,.857,95,40,87,.460,35,68,.515,5,19,.263,18,20,.900,103
1977,NYK,2017-02-01,95,@,BRK,W 95-90,240,35,99,.354,29,72,.403,6,27,.222,19,31,.613,95,37,88,.420,32,63,.508,5,25,.200,11,16,.688,90
1978,PHI,2017-02-01,95,@,DAL,L 95-113,240,35,77,.455,29,55,.527,6,22,.273,19,26,.731,95,40,86,.465,30,60,.500,10,26,.385,23,28,.821,113
1979,UTA,2017-01-28,95,,MEM,L 95-102,240,29,62,.468,19,37,.514,10,25,.400,27,29,.931,95,41,80,.513,30,54,.556,11,26,.423,9,10,.900,102
1980,NYK,2017-01-25,95,@,DAL,L 95-103,240,39,92,.424,32,69,.464,7,23,.304,10,12,.833,95,39,83,.470,33,57,.579,6,26,.231,19,24,.792,103
1981,UTA,2017-01-23,95,,OKC,L 95-97,240,36,84,.429,31,63,.492,5,21,.238,18,26,.692,95,36,83,.434,30,63,.476,6,20,.300,19,25,.760,97
1982,MEM,2017-01-21,95,,HOU,L 95-119,240,33,89,.371,24,55,.436,9,34,.265,20,28,.714,95,41,80,.513,25,38,.658,16,42,.381,21,25,.840,119
1983,IND,2017-01-20,95,@,LAL,L 95-108,240,34,80,.425,25,57,.439,9,23,.391,18,25,.720,95,41,87,.471,27,54,.500,14,33,.424,12,15,.800,108
1984,DAL,2017-01-19,95,@,MIA,L 95-99,240,37,82,.451,23,46,.500,14,36,.389,7,11,.636,95,35,73,.479,26,53,.491,9,20,.450,20,29,.690,99
1985,ATL,2017-01-18,95,@,DET,L 95-118,240,30,78,.385,24,53,.453,6,25,.240,29,37,.784,95,45,91,.495,35,66,.530,10,25,.400,18,28,.643,118
1986,NOP,2017-01-16,95,@,IND,L 95-98,240,36,83,.434,26,58,.448,10,25,.400,13,18,.722,95,41,81,.506,36,62,.581,5,19,.263,11,16,.688,98
1987,BRK,2017-01-12,95,,NOP,L 95-104,240,40,97,.412,31,55,.564,9,42,.214,6,11,.545,95,38,90,.422,27,58,.466,11,32,.344,17,25,.680,104
1988,MEM,2017-01-11,95,@,OKC,L 95-103,240,38,92,.413,31,68,.456,7,24,.292,12,21,.571,95,36,81,.444,28,55,.509,8,26,.308,23,29,.793,103
1989,MIA,2017-01-10,95,@,GSW,L 95-107,240,38,90,.422,32,60,.533,6,30,.200,13,17,.765,95,39,86,.453,28,59,.475,11,27,.407,18,22,.818,107
1990,BRK,2017-01-08,95,,PHI,L 95-105,240,36,78,.462,26,51,.510,10,27,.370,13,17,.765,95,37,94,.394,29,67,.433,8,27,.296,23,27,.852,105
1991,ORL,2017-01-08,95,@,LAL,L 95-111,240,34,90,.378,27,64,.422,7,26,.269,20,29,.690,95,42,87,.483,34,55,.618,8,32,.250,19,24,.792,111
1992,DAL,2017-01-05,95,,PHO,L 95-102,240,36,79,.456,27,50,.540,9,29,.310,14,17,.824,95,38,85,.447,31,68,.456,7,17,.412,19,22,.864,102
1993,POR,2017-01-01,95,@,MIN,W 95-89,240,36,73,.493,30,51,.588,6,22,.273,17,28,.607,95,35,87,.402,28,64,.438,7,23,.304,12,18,.667,89
1994,BRK,2016-12-30,95,@,WAS,L 95-118,240,32,74,.432,22,49,.449,10,25,.400,21,25,.840,95,47,83,.566,36,61,.590,11,22,.500,13,14,.929,118
1995,TOR,2016-12-26,95,@,POR,W 95-91,240,32,95,.337,20,61,.328,12,34,.353,19,24,.792,95,35,83,.422,27,60,.450,8,23,.348,13,18,.722,91
1996,ORL,2016-12-22,95,@,NYK,L 95-106,240,39,90,.433,34,63,.540,5,27,.185,12,16,.750,95,41,96,.427,32,76,.421,9,20,.450,15,17,.882,106
1997,POR,2016-12-21,95,,DAL,L 95-96,240,32,72,.444,22,45,.489,10,27,.370,21,28,.750,95,35,83,.422,28,52,.538,7,31,.226,19,23,.826,96
1998,MIA,2016-12-18,95,,BOS,L 95-105,240,36,69,.522,27,45,.600,9,24,.375,14,25,.560,95,41,90,.456,32,62,.516,9,28,.321,14,19,.737,105
1999,MIL,2016-12-16,95,@,CHI,W 95-69,240,38,82,.463,28,57,.491,10,25,.400,9,13,.692,95,28,92,.304,23,71,.324,5,21,.238,8,15,.533,69
2000,IND,2016-12-15,95,@,NOP,L 95-102,240,36,87,.414,33,66,.500,3,21,.143,20,24,.833,95,36,85,.424,26,58,.448,10,27,.370,20,28,.714,102
2001,DET,2016-12-14,95,@,DAL,W 95-85,240,36,71,.507,31,54,.574,5,17,.294,18,22,.818,95,32,78,.410,24,53,.453,8,25,.320,13,16,.813,85
2002,MIA,2016-12-14,95,,IND,W 95-89,240,37,82,.451,30,57,.526,7,25,.280,14,25,.560,95,33,89,.371,24,62,.387,9,27,.333,14,17,.824,89
2003,OKC,2016-12-13,95,@,POR,L 95-114,240,33,87,.379,25,60,.417,8,27,.296,21,28,.750,95,43,80,.538,35,57,.614,8,23,.348,20,27,.741,114
2004,CHI,2016-12-08,95,,SAS,W 95-91,240,35,80,.438,31,63,.492,4,17,.235,21,27,.778,95,39,97,.402,30,69,.435,9,28,.321,4,5,.800,91
2005,MIA,2016-12-07,95,@,ATL,L 95-103,240,34,80,.425,23,53,.434,11,27,.407,16,20,.800,95,43,88,.489,39,69,.565,4,19,.211,13,15,.867,103
2006,LAL,2016-12-07,95,@,HOU,L 95-134,240,34,87,.391,29,67,.433,5,20,.250,22,27,.815,95,51,94,.543,36,58,.621,15,36,.417,17,21,.810,134
2007,MEM,2016-12-01,95,,ORL,W 95-94,240,33,79,.418,26,61,.426,7,18,.389,22,28,.786,95,33,74,.446,27,50,.540,6,24,.250,22,31,.710,94
2008,ORL,2016-11-29,95,@,SAS,W 95-83,240,39,86,.453,33,71,.465,6,15,.400,11,12,.917,95,28,76,.368,23,56,.411,5,20,.250,22,26,.846,83
2009,PHI,2016-11-28,95,@,TOR,L 95-122,240,36,86,.419,22,52,.423,14,34,.412,9,13,.692,95,42,77,.545,29,58,.500,13,19,.684,25,31,.806,122
2010,SAC,2016-11-28,95,@,WAS,L 95-101 (OT),265,38,93,.409,35,72,.486,3,21,.143,16,26,.615,95,35,85,.412,25,60,.417,10,25,.400,21,26,.808,101
2011,UTA,2016-11-25,95,,ATL,W 95-68,240,35,80,.438,25,46,.543,10,34,.294,15,18,.833,95,26,83,.313,18,58,.310,8,25,.320,8,12,.667,68
2012,ORL,2016-11-19,95,,DAL,W 95-87,240,34,78,.436,26,57,.456,8,21,.381,19,22,.864,95,26,77,.338,13,49,.265,13,28,.464,22,27,.815,87
2013,CHI,2016-11-19,95,@,LAC,L 95-102,240,33,77,.429,24,47,.511,9,30,.300,20,24,.833,95,36,77,.468,25,50,.500,11,27,.407,19,23,.826,102
2014,BRK,2016-11-14,95,@,LAC,L 95-127,240,34,77,.442,24,44,.545,10,33,.303,17,22,.773,95,48,90,.533,34,65,.523,14,25,.560,17,21,.810,127
2015,WAS,2016-11-12,95,@,CHI,L 95-106,240,38,91,.418,34,78,.436,4,13,.308,15,18,.833,95,39,97,.402,34,82,.415,5,15,.333,23,25,.920,106
2016,DEN,2016-11-12,95,,DET,L 95-106,240,36,84,.429,27,59,.458,9,25,.360,14,19,.737,95,46,90,.511,42,72,.583,4,18,.222,10,14,.714,106
2017,MIA,2016-11-10,95,,CHI,L 95-98,240,36,88,.409,23,59,.390,13,29,.448,10,15,.667,95,37,89,.416,31,73,.425,6,16,.375,18,20,.900,98
2018,DAL,2016-11-09,95,@,GSW,L 95-116,240,34,86,.395,28,58,.483,6,28,.214,21,28,.750,95,43,74,.581,26,41,.634,17,33,.515,13,22,.591,116
2019,WAS,2016-11-04,95,,ATL,W 95-92,240,31,80,.388,26,60,.433,5,20,.250,28,35,.800,95,32,83,.386,27,58,.466,5,25,.200,23,36,.639,92
2020,BRK,2016-11-04,95,,CHO,L 95-99,240,35,87,.402,26,51,.510,9,36,.250,16,21,.762,95,36,86,.419,26,56,.464,10,30,.333,17,24,.708,99
2021,DAL,2016-11-04,95,,POR,L 95-105,240,34,83,.410,24,55,.436,10,28,.357,17,20,.850,95,36,80,.450,24,49,.490,12,31,.387,21,26,.808,105
2022,SAC,2016-10-31,95,@,ATL,L 95-106,240,36,75,.480,26,52,.500,10,23,.435,13,19,.684,95,33,79,.418,22,49,.449,11,30,.367,29,47,.617,106
2023,LAL,2017-04-12,94,@,GSW,L 94-109,240,41,93,.441,37,76,.487,4,17,.235,8,14,.571,94,41,90,.456,29,54,.537,12,36,.333,15,22,.682,109
2024,MIL,2017-04-12,94,@,BOS,L 94-112,240,37,84,.440,31,61,.508,6,23,.261,14,17,.824,94,41,91,.451,29,54,.537,12,37,.324,18,26,.692,112
2025,SAC,2017-04-07,94,@,LAL,L 94-98,240,38,75,.507,30,55,.545,8,20,.400,10,13,.769,94,38,86,.442,34,62,.548,4,24,.167,18,25,.720,98
2026,MIA,2017-04-07,94,@,TOR,L 94-96,240,33,83,.398,25,60,.417,8,23,.348,20,29,.690,94,35,85,.412,26,65,.400,9,20,.450,17,24,.708,96
2027,NYK,2017-04-02,94,,BOS,L 94-110,240,33,85,.388,26,60,.433,7,25,.280,21,25,.840,94,40,72,.556,28,35,.800,12,37,.324,18,26,.692,110
2028,MIA,2017-03-31,94,,NYK,L 94-98,240,34,83,.410,26,50,.520,8,33,.242,18,25,.720,94,38,80,.475,32,64,.500,6,16,.375,16,17,.941,98
2029,MEM,2017-03-26,94,@,GSW,L 94-106,240,38,85,.447,30,56,.536,8,29,.276,10,15,.667,94,39,71,.549,22,40,.550,17,31,.548,11,15,.733,106
2030,PHI,2017-03-26,94,@,IND,L 94-107,240,35,88,.398,21,47,.447,14,41,.341,10,14,.714,94,38,89,.427,31,72,.431,7,17,.412,24,29,.828,107
2031,MIL,2017-03-26,94,,CHI,L 94-109,240,37,84,.440,30,61,.492,7,23,.304,13,17,.765,94,46,85,.541,36,64,.563,10,21,.476,7,10,.700,109
2032,TOR,2017-03-25,94,@,DAL,W 94-86,240,39,81,.481,30,60,.500,9,21,.429,7,9,.778,94,31,82,.378,24,54,.444,7,28,.250,17,20,.850,86
2033,SAC,2017-03-18,94,@,OKC,L 94-110,240,35,85,.412,30,64,.469,5,21,.238,19,23,.826,94,41,82,.500,31,56,.554,10,26,.385,18,25,.720,110
2034,CHI,2017-03-10,94,,HOU,L 94-115,240,38,98,.388,29,59,.492,9,39,.231,9,12,.750,94,37,89,.416,22,42,.524,15,47,.319,26,32,.813,115
2035,TOR,2017-03-08,94,@,NOP,W 94-87,240,36,76,.474,28,55,.509,8,21,.381,14,23,.609,94,34,80,.425,25,51,.490,9,29,.310,10,13,.769,87
2036,TOR,2017-03-04,94,@,MIL,L 94-101,240,35,75,.467,28,54,.519,7,21,.333,17,20,.850,94,38,87,.437,32,60,.533,6,27,.222,19,23,.826,101
2037,CHI,2017-03-02,94,,GSW,W 94-87,240,36,82,.439,31,63,.492,5,19,.263,17,21,.810,94,34,88,.386,28,58,.483,6,30,.200,13,14,.929,87
2038,TOR,2017-02-14,94,@,CHI,L 94-105,240,35,77,.455,30,57,.526,5,20,.250,19,24,.792,94,35,73,.479,28,56,.500,7,17,.412,28,35,.800,105
2039,NYK,2017-02-12,94,,SAS,W 94-90,240,34,68,.500,25,54,.463,9,14,.643,17,21,.810,94,33,91,.363,27,62,.435,6,29,.207,18,22,.818,90
2040,NOP,2017-02-08,94,,UTA,L 94-127,240,35,77,.455,30,53,.566,5,24,.208,19,25,.760,94,48,88,.545,34,56,.607,14,32,.438,17,21,.810,127
2041,TOR,2017-02-03,94,@,ORL,L 94-102,240,34,87,.391,24,59,.407,10,28,.357,16,21,.762,94,37,80,.463,32,66,.485,5,14,.357,23,32,.719,102
2042,OKC,2017-01-31,94,@,SAS,L 94-108,240,30,85,.353,23,57,.404,7,28,.250,27,32,.844,94,37,86,.430,30,65,.462,7,21,.333,27,38,.711,108
2043,NOP,2017-01-29,94,,WAS,L 94-107,240,38,84,.452,28,52,.538,10,32,.313,8,15,.533,94,45,89,.506,35,68,.515,10,21,.476,7,10,.700,107
2044,PHI,2017-01-18,94,,TOR,W 94-89,240,31,69,.449,23,45,.511,8,24,.333,24,32,.750,94,34,86,.395,28,62,.452,6,24,.250,15,23,.652,89
2045,LAL,2017-01-12,94,@,SAS,L 94-134,240,35,85,.412,29,65,.446,6,20,.300,18,25,.720,94,49,81,.605,39,60,.650,10,21,.476,26,29,.897,134
2046,DET,2017-01-10,94,@,SAC,L 94-100,240,36,82,.439,24,55,.436,12,27,.444,10,16,.625,94,32,73,.438,19,50,.380,13,23,.565,23,29,.793,100
2047,CHI,2017-01-09,94,,OKC,L 94-109,240,34,83,.410,27,64,.422,7,19,.368,19,22,.864,94,47,83,.566,40,59,.678,7,24,.292,8,11,.727,109
2048,UTA,2017-01-07,94,@,MIN,W 94-92,240,32,77,.416,24,54,.444,8,23,.348,22,28,.786,94,35,80,.438,28,60,.467,7,20,.350,15,21,.714,92
2049,NOP,2017-01-05,94,,ATL,L 94-99,240,34,93,.366,19,58,.328,15,35,.429,11,14,.786,94,38,90,.422,29,67,.433,9,23,.391,14,17,.824,99
2050,CLE,2017-01-04,94,,CHI,L 94-106,240,34,83,.410,26,58,.448,8,25,.320,18,24,.750,94,41,85,.482,28,55,.509,13,30,.433,11,15,.733,106
2051,OKC,2017-01-02,94,@,MIL,L 94-98,240,36,78,.462,27,51,.529,9,27,.333,13,19,.684,94,38,79,.481,31,60,.517,7,19,.368,15,24,.625,98
2052,POR,2016-12-30,94,@,SAS,L 94-110,240,35,77,.455,29,57,.509,6,20,.300,18,21,.857,94,39,78,.500,28,56,.500,11,22,.500,21,25,.840,110
2053,DET,2016-12-28,94,,MIL,L 94-119,240,39,88,.443,33,64,.516,6,24,.250,10,16,.625,94,48,84,.571,37,62,.597,11,22,.500,12,16,.750,119
2054,MIA,2016-12-27,94,,OKC,L 94-106,240,36,82,.439,29,60,.483,7,22,.318,15,21,.714,94,42,82,.512,37,63,.587,5,19,.263,17,25,.680,106
2055,SAC,2016-12-21,94,@,UTA,W 94-93,240,34,74,.459,24,53,.453,10,21,.476,16,24,.667,94,33,74,.446,24,47,.511,9,27,.333,18,22,.818,93
2056,CHI,2016-12-13,94,,MIN,L 94-99,240,38,87,.437,34,72,.472,4,15,.267,14,19,.737,94,38,86,.442,32,65,.492,6,21,.286,17,22,.773,99
2057,CHO,2016-12-12,94,@,IND,L 94-110,240,28,84,.333,18,58,.310,10,26,.385,28,32,.875,94,43,88,.489,26,52,.500,17,36,.472,7,10,.700,110
2058,BOS,2016-12-09,94,,TOR,L 94-101,240,31,83,.373,14,41,.341,17,42,.405,15,22,.682,94,34,82,.415,25,62,.403,9,20,.450,24,27,.889,101
2059,PHO,2016-12-07,94,,IND,L 94-109,240,34,85,.400,25,52,.481,9,33,.273,17,18,.944,94,35,78,.449,28,55,.509,7,23,.304,32,41,.780,109
2060,NYK,2016-12-07,94,,CLE,L 94-126,240,35,87,.402,24,56,.429,11,31,.355,13,15,.867,94,39,80,.488,17,40,.425,22,40,.550,26,31,.839,126
2061,ORL,2016-12-01,94,@,MEM,L 94-95,240,33,74,.446,27,50,.540,6,24,.250,22,31,.710,94,33,79,.418,26,61,.426,7,18,.389,22,28,.786,95
2062,CLE,2016-12-01,94,,LAC,L 94-113,240,28,69,.406,19,45,.422,9,24,.375,29,39,.744,94,42,89,.472,29,58,.500,13,31,.419,16,24,.667,113
2063,SAS,2016-11-30,94,@,DAL,W 94-87,240,33,71,.465,22,52,.423,11,19,.579,17,24,.708,94,33,77,.429,23,47,.489,10,30,.333,11,14,.786,87
2064,ATL,2016-11-27,94,@,LAL,L 94-109,240,39,88,.443,27,53,.509,12,35,.343,4,10,.400,94,42,95,.442,34,75,.453,8,20,.400,17,20,.850,109
2065,WAS,2016-11-25,94,@,ORL,W 94-91,240,40,88,.455,34,59,.576,6,29,.207,8,10,.800,94,35,80,.438,28,57,.491,7,23,.304,14,20,.700,91
2066,ATL,2016-11-22,94,,NOP,L 94-112,240,39,85,.459,29,56,.518,10,29,.345,6,10,.600,94,45,86,.523,34,61,.557,11,25,.440,11,12,.917,112
2067,MIA,2016-11-21,94,@,PHI,L 94-101,240,34,88,.386,27,57,.474,7,31,.226,19,28,.679,94,37,78,.474,26,52,.500,11,26,.423,16,20,.800,101
2068,ATL,2016-11-20,94,@,NYK,L 94-104,240,34,85,.400,28,64,.438,6,21,.286,20,29,.690,94,42,88,.477,32,61,.525,10,27,.370,10,14,.714,104
2069,BOS,2016-11-19,94,@,DET,W 94-92,240,33,82,.402,21,51,.412,12,31,.387,16,17,.941,94,37,86,.430,30,66,.455,7,20,.350,11,16,.688,92
2070,SAS,2016-11-14,94,,MIA,W 94-90,240,33,82,.402,25,67,.373,8,15,.533,20,27,.741,94,37,84,.440,33,69,.478,4,15,.267,12,21,.571,90
2071,WAS,2016-11-11,94,,CLE,L 94-105,240,38,87,.437,35,72,.486,3,15,.200,15,19,.789,94,36,86,.419,22,53,.415,14,33,.424,19,26,.731,105
2072,NOP,2016-11-08,94,@,SAC,L 94-102,240,38,84,.452,33,63,.524,5,21,.238,13,18,.722,94,39,81,.481,31,56,.554,8,25,.320,16,20,.800,102
2073,MEM,2016-11-06,94,,POR,L 94-100,240,31,81,.383,25,55,.455,6,26,.231,26,32,.813,94,32,71,.451,18,38,.474,14,33,.424,22,27,.815,100
2074,CHI,2016-11-05,94,@,IND,L 94-111,240,34,79,.430,28,61,.459,6,18,.333,20,25,.800,94,46,86,.535,34,60,.567,12,26,.462,7,12,.583,111
2075,SAC,2016-11-03,94,@,ORL,L 94-102,240,38,80,.475,31,62,.500,7,18,.389,11,17,.647,94,38,84,.452,28,54,.519,10,30,.333,16,23,.696,102
2076,IND,2016-10-28,94,@,BRK,L 94-103,240,37,98,.378,30,74,.405,7,24,.292,13,20,.650,94,38,87,.437,28,54,.519,10,33,.303,17,20,.850,103
2077,CLE,2016-10-28,94,@,TOR,W 94-91,240,33,79,.418,21,47,.447,12,32,.375,16,22,.727,94,35,90,.389,31,74,.419,4,16,.250,17,18,.944,91
2078,SAC,2016-10-27,94,,SAS,L 94-102,240,28,70,.400,22,50,.440,6,20,.300,32,38,.842,94,36,79,.456,30,61,.492,6,18,.333,24,27,.889,102
2079,PHO,2016-10-26,94,,SAC,L 94-113,240,36,77,.468,32,61,.525,4,16,.250,18,27,.667,94,44,86,.512,38,65,.585,6,21,.286,19,26,.731,113
2080,MEM,2017-04-12,93,,DAL,L 93-100,240,33,84,.393,25,59,.424,8,25,.320,19,22,.864,93,33,75,.440,24,41,.585,9,34,.265,25,31,.806,100
2081,CLE,2017-03-30,93,@,CHI,L 93-99,240,37,83,.446,27,56,.482,10,27,.370,9,16,.563,93,38,90,.422,26,65,.400,12,25,.480,11,18,.611,99
2082,MIN,2017-03-21,93,,SAS,L 93-100,240,32,72,.444,25,57,.439,7,15,.467,22,25,.880,93,37,77,.481,29,53,.547,8,24,.333,18,22,.818,100
2083,MIL,2017-03-21,93,@,POR,W 93-90,240,38,90,.422,31,74,.419,7,16,.438,10,12,.833,93,35,83,.422,31,62,.500,4,21,.190,16,26,.615,90
2084,WAS,2017-03-18,93,@,CHO,L 93-98,240,29,79,.367,18,46,.391,11,33,.333,24,31,.774,93,35,82,.427,26,58,.448,9,24,.375,19,27,.704,98
2085,MIL,2017-03-13,93,@,MEM,L 93-113,240,31,67,.463,17,41,.415,14,26,.538,17,20,.850,93,41,79,.519,27,52,.519,14,27,.519,17,23,.739,113
2086,NYK,2017-03-08,93,@,MIL,L 93-104,240,39,84,.464,32,63,.508,7,21,.333,8,12,.667,93,37,86,.430,29,60,.483,8,26,.308,22,28,.786,104
2087,LAL,2017-02-24,93,@,OKC,L 93-110,240,40,101,.396,33,66,.500,7,35,.200,6,14,.429,93,44,97,.454,34,73,.466,10,24,.417,12,17,.706,110
2088,IND,2017-02-06,93,,OKC,W 93-90,240,33,87,.379,25,61,.410,8,26,.308,19,29,.655,93,34,88,.386,27,60,.450,7,28,.250,15,21,.714,90
2089,ATL,2017-02-01,93,@,MIA,L 93-116,240,34,86,.395,27,60,.450,7,26,.269,18,21,.857,93,45,93,.484,33,61,.541,12,32,.375,14,19,.737,116
2090,UTA,2017-01-24,93,@,DEN,L 93-103,240,35,85,.412,28,63,.444,7,22,.318,16,21,.762,93,35,76,.461,25,50,.500,10,26,.385,23,31,.742,103
2091,PHI,2017-01-21,93,@,ATL,L 93-110,240,33,78,.423,21,49,.429,12,29,.414,15,18,.833,93,45,91,.495,38,71,.535,7,20,.350,13,23,.565,110
2092,CHI,2017-01-20,93,@,ATL,L 93-102,240,34,81,.420,27,53,.509,7,28,.250,18,19,.947,93,39,82,.476,30,60,.500,9,22,.409,15,19,.789,102
2093,PHI,2017-01-20,93,,POR,W 93-92,240,36,92,.391,24,63,.381,12,29,.414,9,16,.563,93,33,89,.371,27,70,.386,6,19,.316,20,28,.714,92
2094,PHI,2017-01-14,93,@,WAS,L 93-109,240,36,87,.414,26,56,.464,10,31,.323,11,21,.524,93,44,91,.484,36,74,.486,8,17,.471,13,18,.722,109
2095,CHO,2017-01-13,93,@,PHI,L 93-102,240,28,85,.329,22,62,.355,6,23,.261,31,32,.969,93,36,76,.474,22,38,.579,14,38,.368,16,20,.800,102
2096,ORL,2017-01-06,93,,HOU,L 93-100,240,38,91,.418,30,68,.441,8,23,.348,9,13,.692,93,39,86,.453,24,37,.649,15,49,.306,7,12,.583,100
2097,UTA,2017-01-05,93,@,TOR,L 93-101,240,34,73,.466,27,53,.509,7,20,.350,18,21,.857,93,36,91,.396,28,70,.400,8,21,.381,21,28,.750,101
2098,PHI,2017-01-03,93,,MIN,W 93-91,240,33,85,.388,26,53,.491,7,32,.219,20,25,.800,93,33,82,.402,26,58,.448,7,24,.292,18,20,.900,91
2099,UTA,2016-12-21,93,,SAC,L 93-94,240,33,74,.446,24,47,.511,9,27,.333,18,22,.818,93,34,74,.459,24,53,.453,10,21,.476,16,24,.667,94
2100,PHI,2016-12-20,93,,NOP,L 93-108,240,33,82,.402,22,49,.449,11,33,.333,16,21,.762,93,40,93,.430,30,76,.395,10,17,.588,18,26,.692,108
2101,MEM,2016-12-14,93,,CLE,W 93-85,240,35,81,.432,23,58,.397,12,23,.522,11,16,.688,93,28,75,.373,19,50,.380,9,25,.360,20,31,.645,85
2102,BRK,2016-12-01,93,,MIL,L 93-111,240,34,89,.382,22,49,.449,12,40,.300,13,16,.813,93,36,80,.450,21,46,.457,15,34,.441,24,29,.828,111
2103,MIN,2016-11-21,93,,BOS,L 93-99,240,36,86,.419,32,62,.516,4,24,.167,17,25,.680,93,38,84,.452,26,46,.565,12,38,.316,11,14,.786,99
2104,MIL,2016-11-21,93,,ORL,W 93-89,240,35,86,.407,27,57,.474,8,29,.276,15,21,.714,93,32,77,.416,25,52,.481,7,25,.280,18,24,.750,89
2105,MEM,2016-11-19,93,,MIN,W 93-71,240,29,76,.382,27,58,.466,2,18,.111,33,38,.868,93,25,64,.391,18,42,.429,7,22,.318,14,22,.636,71
2106,CLE,2016-11-16,93,@,IND,L 93-103,240,35,86,.407,24,56,.429,11,30,.367,12,20,.600,93,43,86,.500,33,58,.569,10,28,.357,7,11,.636,103
2107,ATL,2016-11-15,93,@,MIA,W 93-90,240,37,80,.463,31,63,.492,6,17,.353,13,19,.684,93,36,89,.404,29,66,.439,7,23,.304,11,14,.786,90
2108,NYK,2016-11-14,93,,DAL,W 93-77,240,34,78,.436,25,53,.472,9,25,.360,16,18,.889,93,32,84,.381,27,57,.474,5,27,.185,8,11,.727,77
2109,CHO,2016-11-13,93,@,CLE,L 93-100,240,36,95,.379,25,66,.379,11,29,.379,10,12,.833,93,39,92,.424,25,54,.463,14,38,.368,8,15,.533,100
2110,BOS,2016-11-09,93,@,WAS,L 93-118,240,35,81,.432,25,50,.500,10,31,.323,13,22,.591,93,46,92,.500,36,71,.507,10,21,.476,16,20,.800,118
2111,PHI,2016-11-02,93,@,CHO,L 93-109,240,34,86,.395,22,48,.458,12,38,.316,13,15,.867,93,39,79,.494,26,45,.578,13,34,.382,18,26,.692,109
2112,HOU,2016-10-30,93,,DAL,W 93-92,240,34,81,.420,23,50,.460,11,31,.355,14,21,.667,93,32,86,.372,21,55,.382,11,31,.355,17,20,.850,92
2113,PHI,2017-03-29,92,,ATL,L 92-99,240,36,87,.414,25,48,.521,11,39,.282,9,11,.818,92,34,80,.425,25,62,.403,9,18,.500,22,26,.846,99
2114,OKC,2017-03-27,92,@,DAL,W 92-91,240,37,85,.435,31,62,.500,6,23,.261,12,14,.857,92,33,80,.413,23,51,.451,10,29,.345,15,19,.789,91
2115,ATL,2017-03-26,92,,BRK,L 92-107,240,34,98,.347,29,71,.408,5,27,.185,19,32,.594,92,38,86,.442,32,64,.500,6,22,.273,25,30,.833,107
2116,MIL,2017-03-18,92,@,GSW,L 92-117,240,36,89,.404,27,62,.435,9,27,.333,11,14,.786,92,45,75,.600,33,52,.635,12,23,.522,15,19,.789,117
2117,ORL,2017-03-16,92,@,GSW,L 92-122,240,35,94,.372,28,67,.418,7,27,.259,15,21,.714,92,50,87,.575,40,61,.656,10,26,.385,12,23,.522,122
2118,NYK,2017-03-11,92,@,DET,L 92-112,240,36,82,.439,23,52,.442,13,30,.433,7,11,.636,92,46,96,.479,37,69,.536,9,27,.333,11,19,.579,112
2119,SAC,2017-03-11,92,,DEN,L 92-105,240,36,82,.439,28,59,.475,8,23,.348,12,20,.600,92,40,85,.471,31,51,.608,9,34,.265,16,18,.889,105
2120,SAS,2017-03-09,92,@,OKC,L 92-102,240,35,84,.417,29,65,.446,6,19,.316,16,20,.800,92,41,89,.461,35,69,.507,6,20,.300,14,21,.667,102
2121,CLE,2017-03-04,92,@,MIA,L 92-120,240,35,73,.479,24,46,.522,11,27,.407,11,18,.611,92,46,88,.523,28,54,.519,18,34,.529,10,12,.833,120
2122,TOR,2017-02-27,92,@,NYK,W 92-91,240,33,78,.423,26,52,.500,7,26,.269,19,23,.826,92,33,73,.452,24,49,.490,9,24,.375,16,19,.842,91
2123,WAS,2017-02-26,92,,UTA,L 92-102,240,37,87,.425,29,65,.446,8,22,.364,10,13,.769,92,34,72,.472,23,48,.479,11,24,.458,23,32,.719,102
2124,MEM,2017-02-24,92,@,IND,L 92-102,240,35,84,.417,26,57,.456,9,27,.333,13,23,.565,92,40,78,.513,29,52,.558,11,26,.423,11,11,1.000,102
2125,DET,2017-02-10,92,,SAS,L 92-103,240,39,92,.424,34,75,.453,5,17,.294,9,13,.692,92,41,82,.500,32,63,.508,9,19,.474,12,15,.800,103
2126,CHI,2017-02-08,92,@,GSW,L 92-123,240,37,92,.402,33,68,.485,4,24,.167,14,19,.737,92,48,85,.565,33,57,.579,15,28,.536,12,13,.923,123
2127,BOS,2017-02-08,92,@,SAC,L 92-108,240,29,73,.397,19,41,.463,10,32,.313,24,27,.889,92,42,84,.500,32,59,.542,10,25,.400,14,15,.933,108
2128,ORL,2017-01-24,92,,CHI,L 92-100,240,35,85,.412,28,63,.444,7,22,.318,15,20,.750,92,35,77,.455,28,55,.509,7,22,.318,23,30,.767,100
2129,POR,2017-01-20,92,@,PHI,L 92-93,240,33,89,.371,27,70,.386,6,19,.316,20,28,.714,92,36,92,.391,24,63,.381,12,29,.414,9,16,.563,93
2130,MIL,2017-01-18,92,@,HOU,L 92-111,240,37,93,.398,30,65,.462,7,28,.250,11,14,.786,92,43,95,.453,29,51,.569,14,44,.318,11,15,.733,111
2131,CLE,2017-01-10,92,@,UTA,L 92-100,240,31,85,.365,22,54,.407,9,31,.290,21,25,.840,92,38,79,.481,25,45,.556,13,34,.382,11,19,.579,100
2132,DAL,2017-01-09,92,@,MIN,L 92-101,240,36,78,.462,23,50,.460,13,28,.464,7,9,.778,92,40,71,.563,34,55,.618,6,16,.375,15,21,.714,101
2133,MIN,2017-01-07,92,,UTA,L 92-94,240,35,80,.438,28,60,.467,7,20,.350,15,21,.714,92,32,77,.416,24,54,.444,8,23,.348,22,28,.786,94
2134,ORL,2017-01-04,92,,ATL,L 92-111,240,37,86,.430,28,58,.483,9,28,.321,9,10,.900,92,44,81,.543,34,62,.548,10,19,.526,13,18,.722,111
2135,NYK,2016-12-30,92,@,NOP,L 92-104,240,35,93,.376,28,70,.400,7,23,.304,15,16,.938,92,38,85,.447,26,56,.464,12,29,.414,16,17,.941,104
2136,MIN,2016-12-21,92,@,ATL,W 92-84,240,35,83,.422,26,54,.481,9,29,.310,13,14,.929,92,34,82,.415,27,56,.482,7,26,.269,9,13,.692,84
2137,MEM,2016-12-16,92,,SAC,L 92-96,240,29,77,.377,24,52,.462,5,25,.200,29,36,.806,92,31,80,.388,24,56,.429,7,24,.292,27,37,.730,96
2138,PHO,2016-12-15,92,,SAS,L 92-107,240,34,85,.400,24,58,.414,10,27,.370,14,18,.778,92,39,74,.527,34,58,.586,5,16,.313,24,26,.923,107
2139,DEN,2016-12-12,92,@,DAL,L 92-112,240,35,83,.422,28,58,.483,7,25,.280,15,18,.833,92,45,77,.584,33,51,.647,12,26,.462,10,12,.833,112
2140,LAL,2016-12-12,92,@,SAC,L 92-116,240,33,84,.393,23,61,.377,10,23,.435,16,21,.762,92,47,84,.560,37,61,.607,10,23,.435,12,21,.571,116
2141,WAS,2016-12-08,92,,DEN,W 92-85,240,35,78,.449,29,59,.492,6,19,.316,16,17,.941,92,31,76,.408,24,44,.545,7,32,.219,16,24,.667,85
2142,NOP,2016-12-04,92,@,OKC,L 92-101,240,36,98,.367,30,70,.429,6,28,.214,14,19,.737,92,41,89,.461,35,61,.574,6,28,.214,13,26,.500,101
2143,DET,2016-12-04,92,,ORL,L 92-98,240,38,86,.442,28,59,.475,10,27,.370,6,13,.462,92,42,79,.532,35,56,.625,7,23,.304,7,14,.500,98
2144,MIA,2016-12-03,92,@,POR,L 92-99,240,38,86,.442,32,64,.500,6,22,.273,10,15,.667,92,36,89,.404,27,65,.415,9,24,.375,18,24,.750,99
2145,SAC,2016-12-02,92,@,BOS,L 92-97,240,33,88,.375,27,62,.435,6,26,.231,20,25,.800,92,36,88,.409,25,60,.417,11,28,.393,14,15,.933,97
2146,BRK,2016-11-23,92,,BOS,L 92-111,240,34,86,.395,24,55,.436,10,31,.323,14,22,.636,92,45,98,.459,30,60,.500,15,38,.395,6,8,.750,111
2147,PHO,2016-11-23,92,@,ORL,W 92-87,240,33,73,.452,24,51,.471,9,22,.409,17,22,.773,92,33,91,.363,26,66,.394,7,25,.280,14,23,.609,87
2148,DET,2016-11-19,92,,BOS,L 92-94,240,37,86,.430,30,66,.455,7,20,.350,11,16,.688,92,33,82,.402,21,51,.412,12,31,.387,16,17,.941,94
2149,SAS,2016-11-05,92,,LAC,L 92-116,240,30,74,.405,20,49,.408,10,25,.400,22,25,.880,92,47,91,.516,38,68,.559,9,23,.391,13,14,.929,116
2150,MIN,2016-11-05,92,@,OKC,L 92-112,240,33,84,.393,29,65,.446,4,19,.211,22,29,.759,92,45,86,.523,38,70,.543,7,16,.438,15,24,.625,112
2151,ATL,2016-11-04,92,@,WAS,L 92-95,240,32,83,.386,27,58,.466,5,25,.200,23,36,.639,92,31,80,.388,26,60,.433,5,20,.250,28,35,.800,95
2152,DAL,2016-10-30,92,@,HOU,L 92-93,240,32,86,.372,21,55,.382,11,31,.355,17,20,.850,92,34,81,.420,23,50,.460,11,31,.355,14,21,.667,93
2153,DAL,2017-04-11,91,,DEN,L 91-109,240,35,88,.398,23,48,.479,12,40,.300,9,11,.818,91,41,84,.488,23,42,.548,18,42,.429,9,14,.643,109
2154,BOS,2017-04-05,91,,CLE,L 91-114,240,33,81,.407,26,48,.542,7,33,.212,18,29,.621,91,43,92,.467,32,56,.571,11,36,.306,17,18,.944,114
2155,CHI,2017-04-04,91,@,NYK,L 91-100,240,32,85,.376,26,58,.448,6,27,.222,21,23,.913,91,42,89,.472,36,66,.545,6,23,.261,10,16,.625,100
2156,BRK,2017-04-02,91,,ATL,W 91-82,240,32,82,.390,22,49,.449,10,33,.303,17,20,.850,91,30,80,.375,23,56,.411,7,24,.292,15,23,.652,82
2157,PHO,2017-03-28,91,@,ATL,L 91-95,240,35,96,.365,28,65,.431,7,31,.226,14,24,.583,91,34,85,.400,28,58,.483,6,27,.222,21,29,.724,95
2158,DAL,2017-03-27,91,,OKC,L 91-92,240,33,80,.413,23,51,.451,10,29,.345,15,19,.789,91,37,85,.435,31,62,.500,6,23,.261,12,14,.857,92
2159,SAC,2017-03-27,91,,MEM,W 91-90,240,31,67,.463,25,42,.595,6,25,.240,23,30,.767,91,31,90,.344,26,64,.406,5,26,.192,23,29,.793,90
2160,IND,2017-03-19,91,@,TOR,L 91-116,240,33,80,.413,27,57,.474,6,23,.261,19,26,.731,91,45,91,.495,33,64,.516,12,27,.444,14,16,.875,116
2161,CLE,2017-03-16,91,,UTA,W 91-83,240,36,86,.419,27,53,.509,9,33,.273,10,19,.526,91,34,82,.415,29,61,.475,5,21,.238,10,14,.714,83
2162,ATL,2017-03-16,91,,MEM,L 91-103,240,29,71,.408,21,44,.477,8,27,.296,25,34,.735,91,39,92,.424,29,64,.453,10,28,.357,15,18,.833,103
2163,CHI,2017-03-15,91,,MEM,L 91-98,240,34,91,.374,23,63,.365,11,28,.393,12,15,.800,91,36,85,.424,25,54,.463,11,31,.355,15,18,.833,98
2164,LAC,2017-03-08,91,@,MIN,L 91-107,240,35,83,.422,26,59,.441,9,24,.375,12,18,.667,91,42,86,.488,37,66,.561,5,20,.250,18,20,.900,107
2165,CHI,2017-03-08,91,@,ORL,L 91-98,240,36,81,.444,24,53,.453,12,28,.429,7,11,.636,91,37,89,.416,30,64,.469,7,25,.280,17,21,.810,98
2166,CHI,2017-03-04,91,,LAC,L 91-101,240,35,83,.422,29,66,.439,6,17,.353,15,20,.750,91,41,85,.482,35,60,.583,6,25,.240,13,16,.813,101
2167,NYK,2017-02-27,91,,TOR,L 91-92,240,33,73,.452,24,49,.490,9,24,.375,16,19,.842,91,33,78,.423,26,52,.500,7,26,.269,19,23,.826,92
2168,MEM,2017-02-15,91,,NOP,L 91-95,240,33,89,.371,27,56,.482,6,33,.182,19,25,.760,91,37,75,.493,29,57,.509,8,18,.444,13,22,.591,95
2169,DAL,2017-02-15,91,@,DET,L 91-98,240,35,92,.380,25,55,.455,10,37,.270,11,11,1.000,91,36,82,.439,30,63,.476,6,19,.316,20,22,.909,98
2170,PHO,2017-02-08,91,@,MEM,L 91-110,240,29,87,.333,24,64,.375,5,23,.217,28,34,.824,91,35,72,.486,21,48,.438,14,24,.583,26,34,.765,110
2171,NOP,2017-02-04,91,@,WAS,L 91-105,240,37,84,.440,32,67,.478,5,17,.294,12,22,.545,91,38,83,.458,28,52,.538,10,31,.323,19,22,.864,105
2172,OKC,2017-01-29,91,@,CLE,L 91-107,240,37,100,.370,31,74,.419,6,26,.231,11,16,.688,91,41,92,.446,33,63,.524,8,29,.276,17,22,.773,107
2173,SAC,2017-01-20,91,@,MEM,L 91-107,240,31,76,.408,25,47,.532,6,29,.207,23,32,.719,91,38,83,.458,27,55,.491,11,28,.393,20,25,.800,107
2174,CLE,2017-01-16,91,@,GSW,L 91-126,240,31,88,.352,22,54,.407,9,34,.265,20,27,.741,91,46,91,.505,31,57,.544,15,34,.441,19,24,.792,126
2175,MIN,2017-01-03,91,@,PHI,L 91-93,240,33,82,.402,26,58,.448,7,24,.292,18,20,.900,91,33,85,.388,26,53,.491,7,32,.219,20,25,.800,93
2176,WAS,2017-01-02,91,@,HOU,L 91-101,240,38,87,.437,32,61,.525,6,26,.231,9,12,.750,91,37,86,.430,25,47,.532,12,39,.308,15,21,.714,101
2177,UTA,2016-12-31,91,,PHO,W 91-86,240,35,73,.479,27,53,.509,8,20,.400,13,20,.650,91,36,87,.414,29,70,.414,7,17,.412,7,10,.700,86
2178,TOR,2016-12-29,91,@,PHO,L 91-99,240,30,75,.400,23,48,.479,7,27,.259,24,29,.828,91,37,83,.446,28,62,.452,9,21,.429,16,23,.696,99
2179,CHO,2016-12-29,91,,MIA,W 91-82,240,36,93,.387,31,67,.463,5,26,.192,14,18,.778,91,33,82,.402,23,54,.426,10,28,.357,6,13,.462,82
2180,POR,2016-12-26,91,,TOR,L 91-95,240,35,83,.422,27,60,.450,8,23,.348,13,18,.722,91,32,95,.337,20,61,.328,12,34,.353,19,24,.792,95
2181,CHI,2016-12-23,91,@,CHO,L 91-103,240,38,96,.396,31,74,.419,7,22,.318,8,10,.800,91,37,84,.440,32,66,.485,5,18,.278,24,28,.857,103
2182,NOP,2016-12-23,91,,MIA,W 91-87,240,33,89,.371,22,61,.361,11,28,.393,14,21,.667,91,36,87,.414,28,67,.418,8,20,.400,7,13,.538,87
2183,SAS,2016-12-08,91,@,CHI,L 91-95,240,39,97,.402,30,69,.435,9,28,.321,4,5,.800,91,35,80,.438,31,63,.492,4,17,.235,21,27,.778,95
2184,MIN,2016-12-06,91,,SAS,L 91-105,240,36,82,.439,29,62,.468,7,20,.350,12,18,.667,91,39,74,.527,28,50,.560,11,24,.458,16,19,.842,105
2185,CHI,2016-12-06,91,@,DET,L 91-102,240,33,75,.440,31,60,.517,2,15,.133,23,32,.719,91,40,88,.455,32,67,.478,8,21,.381,14,21,.667,102
2186,PHI,2016-12-06,91,@,MEM,L 91-96,240,32,82,.390,18,41,.439,14,41,.341,13,26,.500,91,33,86,.384,31,69,.449,2,17,.118,28,35,.800,96
2187,DAL,2016-11-27,91,,NOP,W 91-81,240,32,77,.416,22,50,.440,10,27,.370,17,20,.850,91,30,77,.390,25,57,.439,5,20,.250,16,18,.889,81
2188,IND,2016-11-27,91,,LAC,W 91-70,240,40,92,.435,35,73,.479,5,19,.263,6,7,.857,91,22,70,.314,18,46,.391,4,24,.167,22,27,.815,70
2189,ORL,2016-11-25,91,,WAS,L 91-94,240,35,80,.438,28,57,.491,7,23,.304,14,20,.700,91,40,88,.455,34,59,.576,6,29,.207,8,10,.800,94
2190,DAL,2016-11-21,91,@,SAS,L 91-96,240,35,74,.473,27,47,.574,8,27,.296,13,20,.650,91,35,75,.467,27,55,.491,8,20,.400,18,25,.720,96
2191,UTA,2016-11-20,91,@,DEN,L 91-105,240,33,85,.388,26,58,.448,7,27,.259,18,23,.783,91,42,86,.488,34,64,.531,8,22,.364,13,30,.433,105
2192,MIA,2016-11-12,91,,UTA,L 91-102,240,38,81,.469,33,64,.516,5,17,.294,10,19,.526,91,40,81,.494,34,61,.557,6,20,.300,16,19,.842,102
2193,SAC,2016-11-10,91,,LAL,L 91-101,240,34,85,.400,26,64,.406,8,21,.381,15,20,.750,91,38,74,.514,29,47,.617,9,27,.333,16,22,.727,101
2194,TOR,2016-11-06,91,,SAC,L 91-96,240,30,84,.357,23,54,.426,7,30,.233,24,31,.774,91,34,78,.436,29,62,.468,5,16,.313,23,31,.742,96
2195,SAC,2016-11-05,91,@,MIL,L 91-117,240,33,84,.393,23,56,.411,10,28,.357,15,19,.789,91,41,82,.500,27,49,.551,14,33,.424,21,25,.840,117
2196,SAS,2016-11-01,91,,UTA,L 91-106,240,33,76,.434,27,56,.482,6,20,.300,19,21,.905,91,38,76,.500,23,45,.511,15,31,.484,15,18,.833,106
2197,MIA,2016-10-28,91,,CHO,L 91-97,240,32,86,.372,18,52,.346,14,34,.412,13,20,.650,91,35,92,.380,28,70,.400,7,22,.318,20,24,.833,97
2198,TOR,2016-10-28,91,,CLE,L 91-94,240,35,90,.389,31,74,.419,4,16,.250,17,18,.944,91,33,79,.418,21,47,.447,12,32,.375,16,22,.727,94
2199,DET,2016-10-26,91,@,TOR,L 91-109,240,35,84,.417,31,62,.500,4,22,.182,17,22,.773,91,41,86,.477,38,68,.559,3,18,.167,24,29,.828,109
2200,MEM,2017-04-09,90,,DET,L 90-103,240,36,75,.480,27,54,.500,9,21,.429,9,13,.692,90,39,82,.476,25,54,.463,14,28,.500,11,16,.688,103
2201,MIL,2017-04-08,90,@,PHI,W 90-82,240,35,79,.443,29,52,.558,6,27,.222,14,20,.700,90,27,77,.351,19,46,.413,8,31,.258,20,23,.870,82
2202,PHI,2017-04-06,90,,CHI,L 90-102,240,33,91,.363,26,58,.448,7,33,.212,17,22,.773,90,39,91,.429,31,66,.470,8,25,.320,16,17,.941,102
2203,TOR,2017-04-04,90,@,IND,L 90-108,240,34,76,.447,29,53,.547,5,23,.217,17,19,.895,90,39,89,.438,27,64,.422,12,25,.480,18,18,1.000,108
2204,DAL,2017-03-31,90,@,MEM,L 90-99,240,29,76,.382,17,42,.405,12,34,.353,20,25,.800,90,35,75,.467,24,48,.500,11,27,.407,18,20,.900,99
2205,DET,2017-03-30,90,,BRK,W 90-89,240,36,86,.419,29,68,.426,7,18,.389,11,17,.647,90,35,92,.380,25,61,.410,10,31,.323,9,12,.750,89
2206,MEM,2017-03-27,90,@,SAC,L 90-91,240,31,90,.344,26,64,.406,5,26,.192,23,29,.793,90,31,67,.463,25,42,.595,6,25,.240,23,30,.767,91
2207,DEN,2017-03-26,90,,NOP,L 90-115,240,36,95,.379,30,70,.429,6,25,.240,12,14,.857,90,48,97,.495,39,70,.557,9,27,.333,10,12,.833,115
2208,MEM,2017-03-23,90,@,SAS,L 90-97,240,34,78,.436,24,49,.490,10,29,.345,12,15,.800,90,37,77,.481,29,51,.569,8,26,.308,15,23,.652,97
2209,POR,2017-03-21,90,,MIL,L 90-93,240,35,83,.422,31,62,.500,4,21,.190,16,26,.615,90,38,90,.422,31,74,.419,7,16,.438,10,12,.833,93
2210,ATL,2017-03-20,90,@,CHO,L 90-105,240,37,84,.440,25,47,.532,12,37,.324,4,10,.400,90,40,80,.500,28,50,.560,12,30,.400,13,20,.650,105
2211,MEM,2017-03-11,90,,ATL,L 90-107,240,34,90,.378,29,61,.475,5,29,.172,17,23,.739,90,36,72,.500,21,42,.500,15,30,.500,20,26,.769,107
2212,MIN,2017-03-04,90,@,SAS,L 90-97 (OT),265,35,89,.393,31,73,.425,4,16,.250,16,22,.727,90,38,94,.404,32,70,.457,6,24,.250,15,24,.625,97
2213,ORL,2017-03-01,90,,NYK,L 90-101,240,34,83,.410,29,58,.500,5,25,.200,17,22,.773,90,34,81,.420,26,52,.500,8,29,.276,25,31,.806,101
2214,ATL,2017-02-24,90,,MIA,L 90-108,240,30,79,.380,24,59,.407,6,20,.300,24,36,.667,90,40,99,.404,23,62,.371,17,37,.459,11,13,.846,108
2215,TOR,2017-02-15,90,,CHO,W 90-85,240,32,84,.381,20,52,.385,12,32,.375,14,19,.737,90,32,76,.421,19,38,.500,13,38,.342,8,9,.889,85
2216,SAS,2017-02-12,90,@,NYK,L 90-94,240,33,91,.363,27,62,.435,6,29,.207,18,22,.818,90,34,68,.500,25,54,.463,9,14,.643,17,21,.810,94
2217,OKC,2017-02-06,90,@,IND,L 90-93,240,34,88,.386,27,60,.450,7,28,.250,15,21,.714,90,33,87,.379,25,61,.410,8,26,.308,19,29,.655,93
2218,BRK,2017-02-01,90,,NYK,L 90-95,240,37,88,.420,32,63,.508,5,25,.200,11,16,.688,90,35,99,.354,29,72,.403,6,27,.222,19,31,.613,95
2219,MIA,2017-01-03,90,@,PHO,L 90-99,240,36,91,.396,30,68,.441,6,23,.261,12,16,.750,90,36,77,.468,27,54,.500,9,23,.391,18,22,.818,99
2220,CLE,2017-01-02,90,,NOP,W 90-82,240,34,90,.378,28,59,.475,6,31,.194,16,22,.727,90,32,88,.364,21,62,.339,11,26,.423,7,10,.700,82
2221,CLE,2016-12-26,90,@,DET,L 90-106,240,30,79,.380,19,51,.373,11,28,.393,19,23,.826,90,41,92,.446,25,64,.391,16,28,.571,8,15,.533,106
2222,ATL,2016-12-26,90,@,MIN,L 90-104,240,35,83,.422,27,51,.529,8,32,.250,12,17,.706,90,37,82,.451,22,51,.431,15,31,.484,15,18,.833,104
2223,CHI,2016-12-26,90,,IND,W 90-85,240,32,83,.386,26,58,.448,6,25,.240,20,28,.714,90,34,81,.420,25,56,.446,9,25,.360,8,10,.800,85
2224,LAL,2016-12-23,90,@,ORL,L 90-109,240,31,87,.356,23,64,.359,8,23,.348,20,24,.833,90,45,89,.506,34,62,.548,11,27,.407,8,14,.571,109
2225,POR,2016-12-23,90,,SAS,L 90-110,240,35,79,.443,23,49,.469,12,30,.400,8,16,.500,90,39,78,.500,27,58,.466,12,20,.600,20,21,.952,110
2226,DAL,2016-12-23,90,@,LAC,W 90-88,240,37,87,.425,30,58,.517,7,29,.241,9,15,.600,90,34,74,.459,21,45,.467,13,29,.448,7,11,.636,88
2227,POR,2016-12-17,90,@,GSW,L 90-135,240,34,86,.395,26,58,.448,8,28,.286,14,20,.700,90,51,87,.586,37,59,.627,14,28,.500,19,26,.731,135
2228,DET,2016-12-17,90,,IND,L 90-105,240,32,84,.381,22,54,.407,10,30,.333,16,22,.727,90,40,83,.482,34,64,.531,6,19,.316,19,25,.760,105
2229,NYK,2016-12-15,90,@,GSW,L 90-103,240,38,93,.409,33,72,.458,5,21,.238,9,19,.474,90,45,96,.469,36,64,.563,9,32,.281,4,8,.500,103
2230,MIN,2016-12-09,90,,DET,L 90-117,240,37,78,.474,34,62,.548,3,16,.188,13,20,.650,90,42,84,.500,28,55,.509,14,29,.483,19,23,.826,117
2231,CHI,2016-11-30,90,,LAL,L 90-96,240,32,91,.352,28,70,.400,4,21,.190,22,29,.759,90,33,81,.407,31,73,.425,2,8,.250,28,41,.683,96
2232,DAL,2016-11-25,90,@,CLE,L 90-128,240,37,91,.407,29,56,.518,8,35,.229,8,12,.667,90,43,85,.506,23,42,.548,20,43,.465,22,24,.917,128
2233,MIA,2016-11-25,90,@,MEM,W 90-81,240,33,85,.388,21,54,.389,12,31,.387,12,18,.667,90,29,82,.354,25,63,.397,4,19,.211,19,23,.826,81
2234,CHO,2016-11-21,90,,MEM,L 90-105,240,30,73,.411,21,42,.500,9,31,.290,21,33,.636,90,40,84,.476,28,58,.483,12,26,.462,13,17,.765,105
2235,BOS,2016-11-16,90,,DAL,W 90-83,240,33,76,.434,26,55,.473,7,21,.333,17,23,.739,90,34,83,.410,26,60,.433,8,23,.348,7,10,.700,83
2236,MIA,2016-11-15,90,,ATL,L 90-93,240,36,89,.404,29,66,.439,7,23,.304,11,14,.786,90,37,80,.463,31,63,.492,6,17,.353,13,19,.684,93
2237,MIA,2016-11-14,90,@,SAS,L 90-94,240,37,84,.440,33,69,.478,4,15,.267,12,21,.571,90,33,82,.402,25,67,.373,8,15,.533,20,27,.741,94
2238,MIL,2017-04-10,89,,CHO,W 89-79,240,35,78,.449,19,51,.373,16,27,.593,3,5,.600,89,33,81,.407,28,63,.444,5,18,.278,8,13,.615,79
2239,DAL,2017-04-07,89,,SAS,L 89-102,240,38,88,.432,30,62,.484,8,26,.308,5,8,.625,89,40,96,.417,31,68,.456,9,28,.321,13,22,.591,102
2240,MIL,2017-04-06,89,@,IND,L 89-104,240,33,71,.465,22,47,.468,11,24,.458,12,14,.857,89,38,80,.475,30,55,.545,8,25,.320,20,26,.769,104
2241,MEM,2017-04-04,89,@,SAS,L 89-95 (OT),265,35,89,.393,27,64,.422,8,25,.320,11,18,.611,89,35,80,.438,24,59,.407,11,21,.524,14,18,.778,95
2242,SAC,2017-03-31,89,@,NOP,L 89-117,240,35,90,.389,29,70,.414,6,20,.300,13,17,.765,89,46,95,.484,36,62,.581,10,33,.303,15,19,.789,117
2243,BRK,2017-03-30,89,@,DET,L 89-90,240,35,92,.380,25,61,.410,10,31,.323,9,12,.750,89,36,86,.419,29,68,.426,7,18,.389,11,17,.647,90
2244,TOR,2017-03-11,89,@,MIA,L 89-104,240,33,88,.375,31,73,.425,2,15,.133,21,25,.840,89,35,72,.486,24,44,.545,11,28,.393,23,33,.697,104
2245,OKC,2017-03-05,89,@,DAL,L 89-104,240,33,82,.402,31,60,.517,2,22,.091,21,30,.700,89,42,86,.488,35,61,.574,7,25,.280,13,16,.813,104
2246,MIA,2017-02-27,89,@,DAL,L 89-96,240,37,83,.446,28,57,.491,9,26,.346,6,13,.462,89,33,76,.434,24,58,.414,9,18,.500,21,23,.913,96
2247,DET,2017-02-13,89,@,MIL,L 89-102,240,34,78,.436,27,57,.474,7,21,.333,14,19,.737,89,40,79,.506,34,58,.586,6,21,.286,16,16,1.000,102
2248,CHI,2017-02-12,89,@,MIN,L 89-117,240,35,84,.417,25,59,.424,10,25,.400,9,13,.692,89,44,81,.543,38,57,.667,6,24,.250,23,26,.885,117
2249,MEM,2017-02-06,89,,SAS,W 89-74,240,32,81,.395,28,62,.452,4,19,.211,21,25,.840,89,30,82,.366,26,63,.413,4,19,.211,10,18,.556,74
2250,TOR,2017-01-18,89,@,PHI,L 89-94,240,34,86,.395,28,62,.452,6,24,.250,15,23,.652,89,31,69,.449,23,45,.511,8,24,.333,24,32,.750,94
2251,CHI,2017-01-12,89,@,NYK,L 89-104,240,35,89,.393,32,71,.451,3,18,.167,16,21,.762,89,44,92,.478,37,69,.536,7,23,.304,9,11,.818,104
2252,BRK,2017-01-02,89,,UTA,L 89-101,240,33,78,.423,27,51,.529,6,27,.222,17,23,.739,89,39,93,.419,32,69,.464,7,24,.292,16,20,.800,101
2253,MIN,2017-01-01,89,,POR,L 89-95,240,35,87,.402,28,64,.438,7,23,.304,12,18,.667,89,36,73,.493,30,51,.588,6,22,.273,17,28,.607,95
2254,LAL,2016-12-29,89,,DAL,L 89-101,240,32,68,.471,25,49,.510,7,19,.368,18,25,.720,89,38,77,.494,24,46,.522,14,31,.452,11,14,.786,101
2255,SAC,2016-12-28,89,@,POR,L 89-102,240,31,79,.392,22,51,.431,9,28,.321,18,23,.783,89,35,74,.473,23,49,.469,12,25,.480,20,22,.909,102
2256,PHI,2016-12-16,89,,LAL,L 89-100,240,32,88,.364,26,57,.456,6,31,.194,19,24,.792,89,36,79,.456,27,49,.551,9,30,.300,19,22,.864,100
2257,OKC,2016-12-14,89,@,UTA,L 89-109,240,30,82,.366,24,63,.381,6,19,.316,23,27,.852,89,42,72,.583,29,49,.592,13,23,.565,12,15,.800,109
2258,IND,2016-12-14,89,@,MIA,L 89-95,240,33,89,.371,24,62,.387,9,27,.333,14,17,.824,89,37,82,.451,30,57,.526,7,25,.280,14,25,.560,95
2259,GSW,2016-12-10,89,@,MEM,L 89-110,240,34,77,.442,25,50,.500,9,27,.333,12,20,.600,89,38,87,.437,30,61,.492,8,26,.308,26,29,.897,110
2260,DAL,2016-12-07,89,,SAC,L 89-120,240,32,78,.410,22,48,.458,10,30,.333,15,20,.750,89,47,84,.560,37,62,.597,10,22,.455,16,21,.762,120
2261,CHO,2016-11-29,89,,DET,L 89-112,240,31,78,.397,22,51,.431,9,27,.333,18,21,.857,89,45,92,.489,33,64,.516,12,28,.429,10,11,.909,112
2262,PHI,2016-11-25,89,,CHI,L 89-105,240,31,78,.397,22,56,.393,9,22,.409,18,22,.818,89,40,90,.444,34,69,.493,6,21,.286,19,26,.731,105
2263,ORL,2016-11-21,89,@,MIL,L 89-93,240,32,77,.416,25,52,.481,7,25,.280,18,24,.750,89,35,86,.407,27,57,.474,8,29,.276,15,21,.714,93
2264,ORL,2016-11-16,89,,NOP,W 89-82,240,34,88,.386,24,61,.393,10,27,.370,11,19,.579,89,30,82,.366,23,61,.377,7,21,.333,15,19,.789,82
2265,MEM,2016-11-02,89,,NOP,W 89-83 (OT),265,33,94,.351,25,67,.373,8,27,.296,15,20,.750,89,30,81,.370,19,47,.404,11,34,.324,12,16,.750,83
2266,NYK,2016-11-01,89,@,DET,L 89-102,240,35,86,.407,28,64,.438,7,22,.318,12,15,.800,89,41,89,.461,33,76,.434,8,13,.615,12,21,.571,102
2267,LAL,2016-10-28,89,@,UTA,L 89-96,240,32,84,.381,23,61,.377,9,23,.391,16,21,.762,89,31,75,.413,25,50,.500,6,25,.240,28,40,.700,96
2268,NYK,2017-04-07,88,@,MEM,L 88-101,240,38,88,.432,32,60,.533,6,28,.214,6,13,.462,88,38,75,.507,23,48,.479,15,27,.556,10,12,.833,101
2269,WAS,2017-03-31,88,@,UTA,L 88-95,240,35,87,.402,30,70,.429,5,17,.294,13,16,.813,88,33,72,.458,23,47,.489,10,25,.400,19,31,.613,95
2270,NYK,2017-03-29,88,,MIA,L 88-105,240,33,89,.371,28,64,.438,5,25,.200,17,21,.810,88,40,84,.476,28,59,.475,12,25,.480,13,17,.765,105
2271,IND,2017-03-06,88,@,CHO,L 88-100,240,37,81,.457,25,51,.490,12,30,.400,2,3,.667,88,35,86,.407,24,55,.436,11,31,.355,19,21,.905,100
2272,UTA,2017-03-06,88,,NOP,W 88-83,240,33,81,.407,23,54,.426,10,27,.370,12,15,.800,88,30,84,.357,20,51,.392,10,33,.303,13,18,.722,83
2273,SAC,2017-02-27,88,,MIN,L 88-102,240,36,82,.439,30,65,.462,6,17,.353,10,15,.667,88,40,95,.421,32,72,.444,8,23,.348,14,20,.700,102
2274,POR,2017-02-15,88,@,UTA,L 88-111,240,32,79,.405,23,57,.404,9,22,.409,15,20,.750,88,42,81,.519,31,59,.525,11,22,.500,16,23,.696,111
2275,LAC,2017-02-13,88,@,UTA,W 88-72,240,36,81,.444,27,56,.482,9,25,.360,7,11,.636,88,28,87,.322,24,64,.375,4,23,.174,12,18,.667,72
2276,MIL,2017-02-08,88,,MIA,L 88-106,240,33,71,.465,27,56,.482,6,15,.400,16,28,.571,88,41,86,.477,30,53,.566,11,33,.333,13,18,.722,106
2277,MIL,2017-02-01,88,@,UTA,L 88-104,240,32,73,.438,23,50,.460,9,23,.391,15,25,.600,88,36,78,.462,25,49,.510,11,29,.379,21,27,.778,104
2278,ORL,2017-02-01,88,,IND,L 88-98,240,31,77,.403,25,53,.472,6,24,.250,20,28,.714,88,33,69,.478,24,49,.490,9,20,.450,23,26,.885,98
2279,CHI,2017-01-27,88,,MIA,L 88-100,240,33,78,.423,30,65,.462,3,13,.231,19,25,.760,88,41,89,.461,32,65,.492,9,24,.375,9,11,.818,100
2280,LAL,2017-01-26,88,@,UTA,L 88-96,240,36,84,.429,32,70,.457,4,14,.286,12,13,.923,88,33,81,.407,27,55,.491,6,26,.231,24,28,.857,96
2281,MEM,2017-01-08,88,,UTA,W 88-79,240,34,78,.436,25,54,.463,9,24,.375,11,14,.786,88,28,72,.389,19,49,.388,9,23,.391,14,23,.609,79
2282,LAC,2016-12-31,88,@,OKC,L 88-114,240,31,75,.413,23,45,.511,8,30,.267,18,21,.857,88,37,78,.474,27,49,.551,10,29,.345,30,35,.857,114
2283,LAC,2016-12-23,88,,DAL,L 88-90,240,34,74,.459,21,45,.467,13,29,.448,7,11,.636,88,37,87,.425,30,58,.517,7,29,.241,9,15,.600,90
2284,CHO,2016-12-16,88,@,BOS,L 88-96,240,32,97,.330,24,67,.358,8,30,.267,16,19,.842,88,34,78,.436,25,50,.500,9,28,.321,19,26,.731,96
2285,ORL,2016-12-09,88,@,CHO,L 88-109,240,34,91,.374,25,57,.439,9,34,.265,11,14,.786,88,41,85,.482,32,63,.508,9,22,.409,18,23,.783,109
2286,NOP,2016-12-08,88,,PHI,L 88-99,240,33,84,.393,26,59,.441,7,25,.280,15,22,.682,88,39,91,.429,27,51,.529,12,40,.300,9,13,.692,99
2287,MEM,2016-12-08,88,,POR,W 88-86,240,31,87,.356,25,67,.373,6,20,.300,20,30,.667,88,25,82,.305,18,54,.333,7,28,.250,29,40,.725,86
2288,PHI,2016-12-02,88,,ORL,L 88-105,240,36,95,.379,27,63,.429,9,32,.281,7,10,.700,88,37,78,.474,24,52,.462,13,26,.500,18,26,.692,105
2289,LAL,2016-11-29,88,@,NOP,L 88-105,240,37,87,.425,32,57,.561,5,30,.167,9,18,.500,88,38,88,.432,30,57,.526,8,31,.258,21,25,.840,105
2290,DET,2016-11-26,88,@,OKC,L 88-106,240,37,82,.451,36,63,.571,1,19,.053,13,17,.765,88,42,83,.506,34,60,.567,8,23,.348,14,26,.538,106
2291,BOS,2016-11-18,88,,GSW,L 88-104,240,31,83,.373,20,51,.392,11,32,.344,15,19,.789,88,44,90,.489,35,62,.565,9,28,.321,7,12,.583,104
2292,POR,2016-11-15,88,,CHI,L 88-113,240,34,95,.358,25,61,.410,9,34,.265,11,18,.611,88,41,98,.418,34,78,.436,7,20,.350,24,28,.857,113
2293,PHI,2016-11-14,88,@,HOU,L 88-115,240,34,90,.378,29,68,.426,5,22,.227,15,17,.882,88,44,91,.484,27,51,.529,17,40,.425,10,17,.588,115
2294,IND,2016-11-14,88,,ORL,W 88-69,240,35,90,.389,27,65,.415,8,25,.320,10,10,1.000,88,27,84,.321,22,59,.373,5,25,.200,10,13,.769,69
2295,OKC,2016-11-14,88,@,DET,L 88-104,240,33,88,.375,28,61,.459,5,27,.185,17,22,.773,88,43,92,.467,38,76,.500,5,16,.313,13,16,.813,104
2296,ORL,2016-11-05,88,,WAS,W 88-86,240,31,78,.397,22,50,.440,9,28,.321,17,27,.630,88,34,86,.395,28,69,.406,6,17,.353,12,17,.706,86
2297,MEM,2016-11-04,88,,LAC,L 88-99,240,31,84,.369,22,58,.379,9,26,.346,17,22,.773,88,32,85,.376,24,58,.414,8,27,.296,27,33,.818,99
2298,BRK,2016-10-31,88,,CHI,L 88-118,240,33,96,.344,28,65,.431,5,31,.161,17,21,.810,88,45,89,.506,34,62,.548,11,27,.407,17,18,.944,118
2299,LAC,2016-10-30,88,,UTA,W 88-75,240,34,83,.410,28,56,.500,6,27,.222,14,20,.700,88,29,73,.397,22,54,.407,7,19,.368,10,13,.769,75
2300,NYK,2016-10-25,88,@,CLE,L 88-117,240,32,87,.368,23,60,.383,9,27,.333,15,20,.750,88,45,94,.479,32,59,.542,13,35,.371,14,19,.737,117
2301,SAS,2017-04-08,87,,LAC,L 87-98,240,34,80,.425,26,58,.448,8,22,.364,11,14,.786,87,42,84,.500,36,62,.581,6,22,.273,8,14,.571,98
2302,DAL,2017-04-04,87,@,SAC,L 87-98,240,32,80,.400,20,37,.541,12,43,.279,11,14,.786,87,36,81,.444,24,59,.407,12,22,.545,14,17,.824,98
2303,POR,2017-04-04,87,@,UTA,L 87-106,240,33,83,.398,27,57,.474,6,26,.231,15,17,.882,87,39,74,.527,26,51,.510,13,23,.565,15,19,.789,106
2304,DET,2017-03-24,87,@,ORL,L 87-115,240,34,96,.354,32,74,.432,2,22,.091,17,20,.850,87,47,91,.516,35,65,.538,12,26,.462,9,13,.692,115
2305,DAL,2017-03-21,87,,GSW,L 87-112,240,33,92,.359,22,58,.379,11,34,.324,10,12,.833,87,43,78,.551,30,48,.625,13,30,.433,13,16,.813,112
2306,TOR,2017-03-17,87,@,DET,W 87-75,240,30,78,.385,21,51,.412,9,27,.333,18,20,.900,87,29,83,.349,26,63,.413,3,20,.150,14,21,.667,75
2307,NYK,2017-03-14,87,,IND,W 87-81,240,35,83,.422,26,55,.473,9,28,.321,8,13,.615,87,32,87,.368,24,58,.414,8,29,.276,9,15,.600,81
2308,NOP,2017-03-08,87,,TOR,L 87-94,240,34,80,.425,25,51,.490,9,29,.310,10,13,.769,87,36,76,.474,28,55,.509,8,21,.381,14,23,.609,94
2309,GSW,2017-03-02,87,@,CHI,L 87-94,240,34,88,.386,28,58,.483,6,30,.200,13,14,.929,87,36,82,.439,31,63,.492,5,19,.263,17,21,.810,94
2310,DAL,2017-02-06,87,@,DEN,L 87-110,240,34,79,.430,26,53,.491,8,26,.308,11,17,.647,87,42,84,.500,31,56,.554,11,28,.393,15,16,.938,110
2311,MIN,2017-01-15,87,@,DAL,L 87-98,240,35,80,.438,30,59,.508,5,21,.238,12,18,.667,87,36,77,.468,24,48,.500,12,29,.414,14,19,.737,98
2312,LAL,2017-01-10,87,,POR,L 87-108,240,32,83,.386,23,59,.390,9,24,.375,14,26,.538,87,43,85,.506,36,64,.563,7,21,.333,15,20,.750,108
2313,MIA,2016-12-23,87,@,NOP,L 87-91,240,36,87,.414,28,67,.418,8,20,.400,7,13,.538,87,33,89,.371,22,61,.361,11,28,.393,14,21,.667,91
2314,DAL,2016-12-10,87,@,HOU,L 87-109,240,32,79,.405,21,45,.467,11,34,.324,12,14,.857,87,37,74,.500,18,37,.486,19,37,.514,16,22,.727,109
2315,CHO,2016-12-07,87,,DET,W 87-77,240,30,88,.341,24,67,.358,6,21,.286,21,29,.724,87,34,89,.382,30,62,.484,4,27,.148,5,8,.625,77
2316,ORL,2016-12-07,87,,BOS,L 87-117,240,30,81,.370,19,55,.345,11,26,.423,16,24,.667,87,43,84,.512,36,58,.621,7,26,.269,24,29,.828,117
2317,DAL,2016-12-01,87,@,CHO,L 87-97,240,32,86,.372,23,55,.418,9,31,.290,14,18,.778,87,35,74,.473,30,56,.536,5,18,.278,22,31,.710,97
2318,DAL,2016-11-30,87,,SAS,L 87-94,240,33,77,.429,23,47,.489,10,30,.333,11,14,.786,87,33,71,.465,22,52,.423,11,19,.579,17,24,.708,94
2319,ORL,2016-11-23,87,,PHO,L 87-92,240,33,91,.363,26,66,.394,7,25,.280,14,23,.609,87,33,73,.452,24,51,.471,9,22,.409,17,22,.773,92
2320,DAL,2016-11-19,87,@,ORL,L 87-95,240,26,77,.338,13,49,.265,13,28,.464,22,27,.815,87,34,78,.436,26,57,.456,8,21,.381,19,22,.864,95
2321,UTA,2016-11-11,87,@,ORL,W 87-74,240,33,81,.407,26,53,.491,7,28,.250,14,16,.875,87,26,78,.333,18,58,.310,8,20,.400,14,19,.737,74
2322,NYK,2016-11-11,87,@,BOS,L 87-115,240,33,94,.351,27,71,.380,6,23,.261,15,17,.882,87,35,90,.389,24,63,.381,11,27,.407,34,43,.791,115
2323,MIA,2016-11-04,87,@,TOR,L 87-96,240,34,88,.386,25,60,.417,9,28,.321,10,15,.667,87,37,84,.440,31,59,.525,6,25,.240,16,18,.889,96
2324,ATL,2017-04-12,86,@,IND,L 86-104,240,30,72,.417,19,43,.442,11,29,.379,15,19,.789,86,39,82,.476,29,58,.500,10,24,.417,16,19,.842,104
2325,UTA,2017-04-08,86,@,POR,L 86-101,240,31,78,.397,25,59,.424,6,19,.316,18,24,.750,86,37,91,.407,24,61,.393,13,30,.433,14,16,.875,101
2326,DAL,2017-03-25,86,,TOR,L 86-94,240,31,82,.378,24,54,.444,7,28,.250,17,20,.850,86,39,81,.481,30,60,.500,9,21,.429,7,9,.778,94
2327,UTA,2017-03-18,86,@,CHI,L 86-95,240,31,81,.383,24,56,.429,7,25,.280,17,25,.680,86,38,80,.475,31,61,.508,7,19,.368,12,14,.857,95
2328,GSW,2017-03-08,86,,BOS,L 86-99,240,37,84,.440,31,54,.574,6,30,.200,6,9,.667,86,37,84,.440,27,55,.491,10,29,.345,15,19,.789,99
2329,DET,2017-03-01,86,@,NOP,L 86-109,240,40,103,.388,37,80,.463,3,23,.130,3,17,.176,86,39,78,.500,30,53,.566,9,25,.360,22,23,.957,109
2330,ATL,2017-02-25,86,@,ORL,L 86-105,240,32,85,.376,24,60,.400,8,25,.320,14,26,.538,86,37,81,.457,29,54,.537,8,27,.296,23,24,.958,105
2331,SAC,2017-02-15,86,@,GSW,L 86-109,240,33,89,.371,26,65,.400,7,24,.292,13,17,.765,86,41,84,.488,28,48,.583,13,36,.361,14,21,.667,109
2332,ORL,2017-02-04,86,@,ATL,L 86-113,240,27,78,.346,20,51,.392,7,27,.259,25,28,.893,86,41,78,.526,31,50,.620,10,28,.357,21,27,.778,113
2333,PHI,2017-02-02,86,@,SAS,L 86-102,240,30,88,.341,21,63,.333,9,25,.360,17,23,.739,86,38,89,.427,32,68,.471,6,21,.286,20,27,.741,102
2334,MIL,2017-01-27,86,@,TOR,L 86-102,240,31,80,.388,24,57,.421,7,23,.304,17,24,.708,86,37,84,.440,27,59,.458,10,25,.400,18,23,.783,102
2335,ATL,2017-01-27,86,,WAS,L 86-112,240,30,83,.361,21,52,.404,9,31,.290,17,25,.680,86,43,89,.483,30,58,.517,13,31,.419,13,19,.684,112
2336,BRK,2017-01-23,86,,SAS,L 86-112,240,32,81,.395,27,56,.482,5,25,.200,17,18,.944,86,45,95,.474,36,73,.493,9,22,.409,13,16,.813,112
2337,OKC,2017-01-13,86,@,MIN,L 86-96,240,33,85,.388,30,65,.462,3,20,.150,17,21,.810,86,39,86,.453,34,68,.500,5,18,.278,13,14,.929,96
2338,CLE,2017-01-11,86,@,POR,L 86-102,240,28,82,.341,19,52,.365,9,30,.300,21,28,.750,86,40,93,.430,30,63,.476,10,30,.333,12,16,.750,102
2339,MIA,2017-01-08,86,@,LAC,L 86-98,240,31,84,.369,24,57,.421,7,27,.259,17,21,.810,86,36,86,.419,27,56,.482,9,30,.300,17,25,.680,98
2340,PHO,2016-12-31,86,@,UTA,L 86-91,240,36,87,.414,29,70,.414,7,17,.412,7,10,.700,86,35,73,.479,27,53,.509,8,20,.400,13,20,.650,91
2341,DET,2016-12-21,86,,MEM,L 86-98,240,26,72,.361,20,49,.408,6,23,.261,28,37,.757,86,35,82,.427,23,52,.442,12,30,.400,16,19,.842,98
2342,MEM,2016-12-13,86,@,CLE,L 86-103,240,35,86,.407,31,64,.484,4,22,.182,12,15,.800,86,37,81,.457,25,50,.500,12,31,.387,17,23,.739,103
2343,POR,2016-12-08,86,@,MEM,L 86-88,240,25,82,.305,18,54,.333,7,28,.250,29,40,.725,86,31,87,.356,25,67,.373,6,20,.300,20,30,.667,88
2344,PHI,2016-11-17,86,@,MIN,L 86-110,240,31,83,.373,22,51,.431,9,32,.281,15,19,.789,86,43,84,.512,37,59,.627,6,25,.240,18,20,.900,110
2345,DET,2016-11-11,86,@,SAS,L 86-96,240,32,76,.421,27,51,.529,5,25,.200,17,21,.810,86,36,81,.444,27,61,.443,9,20,.450,15,19,.789,96
2346,DAL,2016-11-06,86,,MIL,W 86-75 (OT),265,33,88,.375,24,50,.480,9,38,.237,11,12,.917,86,30,82,.366,24,53,.453,6,29,.207,9,12,.750,75
2347,DEN,2016-11-05,86,@,DET,L 86-103,240,31,94,.330,24,69,.348,7,25,.280,17,20,.850,86,40,84,.476,33,64,.516,7,20,.350,16,22,.727,103
2348,WAS,2016-11-05,86,@,ORL,L 86-88,240,34,86,.395,28,69,.406,6,17,.353,12,17,.706,86,31,78,.397,22,50,.440,9,28,.321,17,27,.630,88
2349,UTA,2016-11-04,86,,SAS,L 86-100,240,30,80,.375,19,54,.352,11,26,.423,15,24,.625,86,37,83,.446,31,63,.492,6,20,.300,20,22,.909,100
2350,GSW,2017-03-11,85,@,SAS,L 85-107,240,33,92,.359,28,75,.373,5,17,.294,14,23,.609,85,40,77,.519,28,50,.560,12,27,.444,15,18,.833,107
2351,IND,2017-03-10,85,@,MIL,L 85-99,240,33,75,.440,31,57,.544,2,18,.111,17,22,.773,85,33,64,.516,26,47,.553,7,17,.412,26,30,.867,99
2352,SAC,2017-02-25,85,,CHO,L 85-99,240,31,79,.392,20,51,.392,11,28,.393,12,15,.800,85,34,85,.400,20,47,.426,14,38,.368,17,18,.944,99
2353,CHO,2017-02-15,85,@,TOR,L 85-90,240,32,76,.421,19,38,.500,13,38,.342,8,9,.889,85,32,84,.381,20,52,.385,12,32,.375,14,19,.737,90
2354,POR,2017-01-18,85,@,CHO,L 85-107,240,33,94,.351,25,63,.397,8,31,.258,11,11,1.000,85,41,87,.471,30,61,.492,11,26,.423,14,17,.824,107
2355,CHO,2017-01-07,85,@,SAS,L 85-102,240,30,75,.400,26,54,.481,4,21,.190,21,25,.840,85,36,89,.404,23,55,.418,13,34,.382,17,20,.850,102
2356,IND,2016-12-26,85,@,CHI,L 85-90,240,34,81,.420,25,56,.446,9,25,.360,8,10,.800,85,32,83,.386,26,58,.448,6,25,.240,20,28,.714,90
2357,DAL,2016-12-14,85,,DET,L 85-95,240,32,78,.410,24,53,.453,8,25,.320,13,16,.813,85,36,71,.507,31,54,.574,5,17,.294,18,22,.818,95
2358,CLE,2016-12-14,85,@,MEM,L 85-93,240,28,75,.373,19,50,.380,9,25,.360,20,31,.645,85,35,81,.432,23,58,.397,12,23,.522,11,16,.688,93
2359,DEN,2016-12-08,85,@,WAS,L 85-92,240,31,76,.408,24,44,.545,7,32,.219,16,24,.667,85,35,78,.449,29,59,.492,6,19,.316,16,17,.941,92
2360,ATL,2016-12-02,85,,DET,L 85-121,240,32,88,.364,26,64,.406,6,24,.250,15,20,.750,85,48,89,.539,31,60,.517,17,29,.586,8,12,.667,121
2361,MEM,2016-11-28,85,,CHO,L 85-104,240,36,89,.404,29,60,.483,7,29,.241,6,13,.462,85,36,82,.439,27,56,.482,9,26,.346,23,31,.742,104
2362,LAL,2016-11-25,85,,GSW,L 85-109,240,32,90,.356,27,68,.397,5,22,.227,16,23,.696,85,43,83,.518,32,55,.582,11,28,.393,12,17,.706,109
2363,PHO,2016-11-25,85,,MIN,L 85-98,240,32,79,.405,26,53,.491,6,26,.231,15,21,.714,85,34,85,.400,27,63,.429,7,22,.318,23,25,.920,98
2364,IND,2016-11-23,85,,ATL,L 85-96,240,34,84,.405,27,57,.474,7,27,.259,10,14,.714,85,36,85,.424,31,65,.477,5,20,.250,19,22,.864,96
2365,CHI,2016-11-17,85,@,UTA,W 85-77,240,33,90,.367,28,73,.384,5,17,.294,14,16,.875,85,30,78,.385,25,53,.472,5,25,.200,12,14,.857,77
2366,MIA,2016-11-07,85,@,OKC,L 85-97,240,31,84,.369,27,67,.403,4,17,.235,19,22,.864,85,37,85,.435,28,57,.491,9,28,.321,14,17,.824,97
2367,OKC,2016-11-02,85,@,LAC,W 85-83,240,34,84,.405,29,64,.453,5,20,.250,12,20,.600,85,34,87,.391,27,65,.415,7,22,.318,8,18,.444,83
2368,MIA,2017-03-23,84,,TOR,L 84-101,240,32,82,.390,26,59,.441,6,23,.261,14,23,.609,84,35,79,.443,29,56,.518,6,23,.261,25,32,.781,101
2369,DAL,2017-02-24,84,@,MIN,L 84-97,240,35,83,.422,27,50,.540,8,33,.242,6,9,.667,84,41,78,.526,36,65,.554,5,13,.385,10,14,.714,97
2370,ATL,2017-02-15,84,@,LAC,L 84-99,240,32,79,.405,25,53,.472,7,26,.269,13,19,.684,84,37,79,.468,23,42,.548,14,37,.378,11,12,.917,99
2371,DET,2017-02-04,84,@,IND,L 84-105,240,31,75,.413,25,58,.431,6,17,.353,16,20,.800,84,44,91,.484,37,67,.552,7,24,.292,10,15,.667,105
2372,ATL,2016-12-21,84,,MIN,L 84-92,240,34,82,.415,27,56,.482,7,26,.269,9,13,.692,84,35,83,.422,26,54,.481,9,29,.310,13,14,.929,92
2373,SAC,2016-12-10,84,@,UTA,L 84-104,240,34,90,.378,25,64,.391,9,26,.346,7,13,.538,84,37,77,.481,24,48,.500,13,29,.448,17,18,.944,104
2374,MIA,2016-12-09,84,@,CLE,L 84-114,240,31,90,.344,25,63,.397,6,27,.222,16,21,.762,84,46,83,.554,37,59,.627,9,24,.375,13,19,.684,114
2375,ATL,2016-12-03,84,@,TOR,L 84-128,240,35,88,.398,28,60,.467,7,28,.250,7,14,.500,84,53,92,.576,40,68,.588,13,24,.542,9,11,.818,128
2376,MIA,2016-11-23,84,@,DET,L 84-107,240,27,75,.360,20,49,.408,7,26,.269,23,30,.767,84,40,81,.494,34,62,.548,6,19,.316,21,25,.840,107
2377,PHI,2016-11-07,84,,UTA,L 84-109,240,31,77,.403,24,56,.429,7,21,.333,15,22,.682,84,43,85,.506,32,66,.485,11,19,.579,12,20,.600,109
2378,CLE,2017-04-12,83,,TOR,L 83-98,240,28,76,.368,18,39,.462,10,37,.270,17,24,.708,83,40,86,.465,32,60,.533,8,26,.308,10,16,.625,98
2379,UTA,2017-03-16,83,@,CLE,L 83-91,240,34,82,.415,29,61,.475,5,21,.238,10,14,.714,83,36,86,.419,27,53,.509,9,33,.273,10,19,.526,91
2380,DET,2017-03-15,83,,UTA,L 83-97,240,36,86,.419,33,73,.452,3,13,.231,8,12,.667,83,36,77,.468,23,49,.469,13,28,.464,12,16,.750,97
2381,NOP,2017-03-06,83,@,UTA,L 83-88,240,30,84,.357,20,51,.392,10,33,.303,13,18,.722,83,33,81,.407,23,54,.426,10,27,.370,12,15,.800,88
2382,NOP,2017-02-25,83,@,DAL,L 83-96,240,31,78,.397,26,54,.481,5,24,.208,16,25,.640,83,36,78,.462,24,52,.462,12,26,.462,12,16,.750,96
2383,SAC,2017-01-31,83,@,HOU,L 83-105,240,30,86,.349,22,57,.386,8,29,.276,15,26,.577,83,38,85,.447,24,40,.600,14,45,.311,15,22,.682,105
2384,PHI,2016-12-29,83,@,UTA,L 83-100,240,35,87,.402,29,63,.460,6,24,.250,7,8,.875,83,35,73,.479,20,47,.426,15,26,.577,15,28,.536,100
2385,SAS,2016-11-29,83,,ORL,L 83-95,240,28,76,.368,23,56,.411,5,20,.250,22,26,.846,83,39,86,.453,33,71,.465,6,15,.400,11,12,.917,95
2386,DEN,2016-11-23,83,@,UTA,L 83-108,240,28,88,.318,19,61,.311,9,27,.333,18,31,.581,83,39,79,.494,31,53,.585,8,26,.308,22,31,.710,108
2387,IND,2016-11-21,83,,GSW,L 83-120,240,33,103,.320,27,80,.338,6,23,.261,11,12,.917,83,40,90,.444,27,54,.500,13,36,.361,27,32,.844,120
2388,DAL,2016-11-16,83,@,BOS,L 83-90,240,34,83,.410,26,60,.433,8,23,.348,7,10,.700,83,33,76,.434,26,55,.473,7,21,.333,17,23,.739,90
2389,LAC,2016-11-02,83,,OKC,L 83-85,240,34,87,.391,27,65,.415,7,22,.318,8,18,.444,83,34,84,.405,29,64,.453,5,20,.250,12,20,.600,85
2390,NOP,2016-11-02,83,@,MEM,L 83-89 (OT),265,30,81,.370,19,47,.404,11,34,.324,12,16,.750,83,33,94,.351,25,67,.373,8,27,.296,15,20,.750,89
2391,MIL,2016-10-30,83,@,DET,L 83-98,240,34,87,.391,30,70,.429,4,17,.235,11,14,.786,83,39,88,.443,34,68,.500,5,20,.250,15,20,.750,98
2392,PHI,2017-04-08,82,,MIL,L 82-90,240,27,77,.351,19,46,.413,8,31,.258,20,23,.870,82,35,79,.443,29,52,.558,6,27,.222,14,20,.700,90
2393,ATL,2017-04-02,82,@,BRK,L 82-91,240,30,80,.375,23,56,.411,7,24,.292,15,23,.652,82,32,82,.390,22,49,.449,10,33,.303,17,20,.850,91
2394,SAC,2017-03-29,82,,UTA,L 82-112,240,34,75,.453,32,60,.533,2,15,.133,12,18,.667,82,42,79,.532,29,48,.604,13,31,.419,15,19,.789,112
2395,MEM,2017-03-21,82,@,NOP,L 82-95,240,32,79,.405,23,44,.523,9,35,.257,9,13,.692,82,35,88,.398,26,59,.441,9,29,.310,16,19,.842,95
2396,DAL,2017-01-07,82,,ATL,L 82-97,240,32,82,.390,23,46,.500,9,36,.250,9,10,.900,82,30,74,.405,19,52,.365,11,22,.500,26,32,.813,97
2397,TOR,2017-01-03,82,@,SAS,L 82-110,240,31,83,.373,27,65,.415,4,18,.222,16,22,.727,82,43,78,.551,30,54,.556,13,24,.542,11,15,.733,110
2398,NOP,2017-01-02,82,@,CLE,L 82-90,240,32,88,.364,21,62,.339,11,26,.423,7,10,.700,82,34,90,.378,28,59,.475,6,31,.194,16,22,.727,90
2399,MIA,2016-12-29,82,@,CHO,L 82-91,240,33,82,.402,23,54,.426,10,28,.357,6,13,.462,82,36,93,.387,31,67,.463,5,26,.192,14,18,.778,91
2400,DET,2016-12-19,82,@,CHI,L 82-113,240,34,83,.410,31,60,.517,3,23,.130,11,13,.846,82,49,82,.598,41,66,.621,8,16,.500,7,7,1.000,113
2401,UTA,2016-12-18,82,@,MEM,W 82-73,240,30,66,.455,22,39,.564,8,27,.296,14,25,.560,82,28,93,.301,26,70,.371,2,23,.087,15,18,.833,73
2402,CHI,2016-12-03,82,@,DAL,L 82-107,240,32,71,.451,29,58,.500,3,13,.231,15,21,.714,82,40,87,.460,27,56,.482,13,31,.419,14,18,.778,107
2403,NOP,2016-11-16,82,@,ORL,L 82-89,240,30,82,.366,23,61,.377,7,21,.333,15,19,.789,82,34,88,.386,24,61,.393,10,27,.370,11,19,.579,89
2404,DET,2016-11-07,82,@,LAC,L 82-114,240,30,82,.366,26,70,.371,4,12,.333,18,26,.692,82,41,76,.539,28,51,.549,13,25,.520,19,22,.864,114
2405,ORL,2016-10-28,82,@,DET,L 82-108,240,33,95,.347,25,69,.362,8,26,.308,8,12,.667,82,48,95,.505,41,76,.539,7,19,.368,5,6,.833,108
2406,LAL,2017-03-26,81,,POR,L 81-97,240,33,84,.393,28,63,.444,5,21,.238,10,17,.588,81,36,89,.404,24,61,.393,12,28,.429,13,18,.722,97
2407,IND,2017-03-14,81,@,NYK,L 81-87,240,32,87,.368,24,58,.414,8,29,.276,9,15,.600,81,35,83,.422,26,55,.473,9,28,.321,8,13,.615,87
2408,ORL,2017-03-10,81,@,CHO,L 81-121,240,31,76,.408,26,49,.531,5,27,.185,14,22,.636,81,47,79,.595,37,58,.638,10,21,.476,17,20,.850,121
2409,NOP,2016-11-27,81,@,DAL,L 81-91,240,30,77,.390,25,57,.439,5,20,.250,16,18,.889,81,32,77,.416,22,50,.440,10,27,.370,17,20,.850,91
2410,MEM,2016-11-25,81,,MIA,L 81-90,240,29,82,.354,25,63,.397,4,19,.211,19,23,.826,81,33,85,.388,21,54,.389,12,31,.387,12,18,.667,90
2411,DET,2016-11-18,81,@,CLE,L 81-104,240,29,93,.312,23,74,.311,6,19,.316,17,20,.850,81,40,83,.482,29,58,.500,11,25,.440,13,14,.929,104
2412,DAL,2016-11-02,81,@,UTA,L 81-97,240,33,77,.429,26,51,.510,7,26,.269,8,10,.800,81,35,77,.455,23,52,.442,12,25,.480,15,26,.577,97
2413,CHI,2017-03-12,80,@,BOS,L 80-100,240,33,87,.379,26,62,.419,7,25,.280,7,9,.778,80,40,86,.465,24,49,.490,16,37,.432,4,4,1.000,100
2414,UTA,2017-03-01,80,,MIN,L 80-107,240,35,90,.389,31,71,.437,4,19,.211,6,11,.545,80,39,78,.500,31,62,.500,8,16,.500,21,26,.808,107
2415,ORL,2017-02-11,80,@,DAL,L 80-112,240,32,82,.390,29,59,.492,3,23,.130,13,18,.722,80,45,91,.495,28,56,.500,17,35,.486,5,6,.833,112
2416,OKC,2016-12-29,80,@,MEM,L 80-114,240,25,74,.338,21,52,.404,4,22,.182,26,38,.684,80,43,82,.524,30,60,.500,13,22,.591,15,20,.750,114
2417,LAL,2016-12-02,80,@,TOR,L 80-113,240,32,93,.344,26,67,.388,6,26,.231,10,17,.588,80,45,83,.542,33,54,.611,12,29,.414,11,13,.846,113
2418,MEM,2016-11-18,80,@,DAL,W 80-64,240,31,77,.403,22,52,.423,9,25,.360,9,12,.750,80,21,73,.288,16,48,.333,5,25,.200,17,22,.773,64
2419,POR,2016-11-09,80,@,LAC,L 80-111,240,31,88,.352,25,58,.431,6,30,.200,12,14,.857,80,38,87,.437,27,55,.491,11,32,.344,24,33,.727,111
2420,ORL,2016-11-07,80,@,CHI,L 80-112,240,33,85,.388,24,55,.436,9,30,.300,5,6,.833,80,42,89,.472,39,70,.557,3,19,.158,25,31,.806,112
2421,MEM,2016-11-01,80,@,MIN,L 80-116,240,27,75,.360,23,51,.451,4,24,.167,22,29,.759,80,43,78,.551,31,58,.534,12,20,.600,18,23,.783,116
2422,CHO,2017-04-10,79,@,MIL,L 79-89,240,33,81,.407,28,63,.444,5,18,.278,8,13,.615,79,35,78,.449,19,51,.373,16,27,.593,3,5,.600,89
2423,MIL,2017-04-04,79,@,OKC,L 79-110,240,29,81,.358,26,63,.413,3,18,.167,18,26,.692,79,40,84,.476,31,56,.554,9,28,.321,21,25,.840,110
2424,ORL,2017-02-15,79,,SAS,L 79-107,240,30,76,.395,26,58,.448,4,18,.222,15,19,.789,79,42,89,.472,34,58,.586,8,31,.258,15,19,.789,107
2425,UTA,2017-01-08,79,@,MEM,L 79-88,240,28,72,.389,19,49,.388,9,23,.391,14,23,.609,79,34,78,.436,25,54,.463,9,24,.375,11,14,.786,88
2426,SAC,2016-12-18,79,@,DAL,L 79-99,240,30,76,.395,22,45,.489,8,31,.258,11,17,.647,79,34,77,.442,21,44,.477,13,33,.394,18,22,.818,99
2427,ORL,2016-12-18,79,,TOR,L 79-109,240,34,83,.410,31,62,.500,3,21,.143,8,9,.889,79,43,87,.494,36,60,.600,7,27,.259,16,21,.762,109
2428,DET,2016-12-11,79,,PHI,L 79-97,240,32,82,.390,27,63,.429,5,19,.263,10,14,.714,79,38,68,.559,31,51,.608,7,17,.412,14,17,.824,97
2429,NOP,2016-10-29,79,@,SAS,L 79-98,240,32,86,.372,28,64,.438,4,22,.182,11,15,.733,79,35,83,.422,25,59,.424,10,24,.417,18,23,.783,98
2430,CLE,2017-03-18,78,@,LAC,L 78-108,240,32,83,.386,27,56,.482,5,27,.185,9,13,.692,78,40,78,.513,32,52,.615,8,26,.308,20,29,.690,108
2431,DAL,2017-03-13,78,@,TOR,L 78-100,240,31,85,.365,24,60,.400,7,25,.280,9,13,.692,78,37,78,.474,28,53,.528,9,25,.360,17,18,.944,100
2432,TOR,2017-01-20,78,@,CHO,L 78-113,240,29,86,.337,22,56,.393,7,30,.233,13,14,.929,78,40,80,.500,28,55,.509,12,25,.480,21,25,.840,113
2433,CHO,2017-03-15,77,@,IND,L 77-98,240,32,80,.400,29,57,.509,3,23,.130,10,13,.769,77,39,73,.534,27,45,.600,12,28,.429,8,9,.889,98
2434,POR,2017-03-14,77,@,NOP,L 77-100,240,23,76,.303,12,44,.273,11,32,.344,20,26,.769,77,38,80,.475,32,59,.542,6,21,.286,18,30,.600,100
2435,DET,2017-01-13,77,@,UTA,L 77-110,240,30,76,.395,24,59,.407,6,17,.353,11,16,.688,77,43,80,.538,27,49,.551,16,31,.516,8,13,.615,110
2436,DET,2016-12-07,77,@,CHO,L 77-87,240,34,89,.382,30,62,.484,4,27,.148,5,8,.625,77,30,88,.341,24,67,.358,6,21,.286,21,29,.724,87
2437,UTA,2016-11-17,77,,CHI,L 77-85,240,30,78,.385,25,53,.472,5,25,.200,12,14,.857,77,33,90,.367,28,73,.384,5,17,.294,14,16,.875,85
2438,DAL,2016-11-14,77,@,NYK,L 77-93,240,32,84,.381,27,57,.474,5,27,.185,8,11,.727,77,34,78,.436,25,53,.472,9,25,.360,16,18,.889,93
2439,CHO,2017-04-11,76,@,ATL,L 76-103,240,29,88,.330,26,65,.400,3,23,.130,15,19,.789,76,41,79,.519,34,52,.654,7,27,.259,14,18,.778,103
2440,ORL,2017-04-10,75,@,CHI,L 75-122,240,29,84,.345,24,57,.421,5,27,.185,12,16,.750,75,48,89,.539,36,63,.571,12,26,.462,14,16,.875,122
2441,DET,2017-03-17,75,,TOR,L 75-87,240,29,83,.349,26,63,.413,3,20,.150,14,21,.667,75,30,78,.385,21,51,.412,9,27,.333,18,20,.900,87
2442,MIL,2016-11-06,75,@,DAL,L 75-86 (OT),265,30,82,.366,24,53,.453,6,29,.207,9,12,.750,75,33,88,.375,24,50,.480,9,38,.237,11,12,.917,86
2443,UTA,2016-10-30,75,@,LAC,L 75-88,240,29,73,.397,22,54,.407,7,19,.368,10,13,.769,75,34,83,.410,28,56,.500,6,27,.222,14,20,.700,88
2444,CLE,2017-03-27,74,@,SAS,L 74-103,240,31,83,.373,27,57,.474,4,26,.154,8,13,.615,74,41,86,.477,34,60,.567,7,26,.269,14,17,.824,103
2445,DAL,2017-03-17,74,@,PHI,L 74-116,240,30,87,.345,25,64,.391,5,23,.217,9,17,.529,74,42,80,.525,30,51,.588,12,29,.414,20,23,.870,116
2446,SAS,2017-02-06,74,@,MEM,L 74-89,240,30,82,.366,26,63,.413,4,19,.211,10,18,.556,74,32,81,.395,28,62,.452,4,19,.211,21,25,.840,89
2447,UTA,2016-12-20,74,@,GSW,L 74-104,240,27,76,.355,18,46,.391,9,30,.300,11,20,.550,74,40,90,.444,31,67,.463,9,23,.391,15,17,.882,104
2448,ORL,2016-11-11,74,,UTA,L 74-87,240,26,78,.333,18,58,.310,8,20,.400,14,19,.737,74,33,81,.407,26,53,.491,7,28,.250,14,16,.875,87
2449,BRK,2017-04-12,73,@,CHI,L 73-112,240,28,86,.326,25,53,.472,3,33,.091,14,18,.778,73,41,95,.432,27,65,.415,14,30,.467,16,21,.762,112
2450,LAL,2017-01-22,73,@,DAL,L 73-122,240,28,73,.384,25,52,.481,3,21,.143,14,17,.824,73,43,87,.494,26,48,.542,17,39,.436,19,19,1.000,122
2451,MEM,2016-12-18,73,,UTA,L 73-82,240,28,93,.301,26,70,.371,2,23,.087,15,18,.833,73,30,66,.455,22,39,.564,8,27,.296,14,25,.560,82
2452,MIL,2016-11-17,73,@,MIA,L 73-96,240,28,85,.329,21,62,.339,7,23,.304,10,13,.769,73,39,97,.402,32,67,.478,7,30,.233,11,21,.524,96
2453,UTA,2017-02-13,72,,LAC,L 72-88,240,28,87,.322,24,64,.375,4,23,.174,12,18,.667,72,36,81,.444,27,56,.482,9,25,.360,7,11,.636,88
2454,PHI,2016-10-29,72,,ATL,L 72-104,240,28,80,.350,23,62,.371,5,18,.278,11,15,.733,72,42,85,.494,37,65,.569,5,20,.250,15,23,.652,104
2455,MIN,2016-11-19,71,@,MEM,L 71-93,240,25,64,.391,18,42,.429,7,22,.318,14,22,.636,71,29,76,.382,27,58,.466,2,18,.111,33,38,.868,93
2456,LAC,2016-11-27,70,@,IND,L 70-91,240,22,70,.314,18,46,.391,4,24,.167,22,27,.815,70,40,92,.435,35,73,.479,5,19,.263,6,7,.857,91
2457,CHI,2016-12-16,69,,MIL,L 69-95,240,28,92,.304,23,71,.324,5,21,.238,8,15,.533,69,38,82,.463,28,57,.491,10,25,.400,9,13,.692,95
2458,ORL,2016-11-14,69,@,IND,L 69-88,240,27,84,.321,22,59,.373,5,25,.200,10,13,.769,69,35,90,.389,27,65,.415,8,25,.320,10,10,1.000,88
2459,ATL,2016-11-25,68,@,UTA,L 68-95,240,26,83,.313,18,58,.310,8,25,.320,8,12,.667,68,35,80,.438,25,46,.543,10,34,.294,15,18,.833,95
2460,DAL,2016-11-18,64,,MEM,L 64-80,240,21,73,.288,16,48,.333,5,25,.200,17,22,.773,64,31,77,.403,22,52,.423,9,25,.360,9,12,.750,80