Rk,Team,Date,PTS,,Opp,Result,MP,FG,FGA,FG%,2P,2PA,2P%,3P,3PA,3P%,FT,FTA,FT%,PTS,FG,FGA,FG%,2P,2PA,2P%,3P,3PA,3P%,FT,FTA,FT%,PTS
1,WAS,2021-05-03,154,,IND,W 154-141,240,63,103,.612,54,81,.667,9,22,.409,19,24,.792,154,53,107,.495,39,80,.488,14,27,.519,21,25,.840,141
2,UTA,2021-04-28,154,@,SAC,W 154-105,240,55,86,.640,31,45,.689,24,41,.585,20,21,.952,154,42,87,.483,35,66,.530,7,21,.333,14,17,.824,105
3,IND,2021-05-01,152,@,OKC,W 152-95,240,57,87,.655,36,54,.667,21,33,.636,17,22,.773,152,38,111,.342,30,73,.411,8,38,.211,11,23,.478,95
4,WAS,2021-01-31,149,,BRK,W 149-146,240,56,108,.519,44,69,.638,12,39,.308,25,32,.781,149,50,88,.568,31,52,.596,19,36,.528,27,33,.818,146
5,GSW,2021-04-14,147,@,OKC,W 147-109,240,52,95,.547,28,48,.583,24,47,.511,19,23,.826,147,44,92,.478,37,65,.569,7,27,.259,14,25,.560,109
6,GSW,2021-02-04,147,@,DAL,W 147-116,240,51,89,.573,29,46,.630,22,43,.512,23,27,.852,147,38,92,.413,18,42,.429,20,50,.400,20,23,.870,116
7,BRK,2021-01-29,147,@,OKC,W 147-125,240,57,100,.570,38,55,.691,19,45,.422,14,16,.875,147,40,86,.465,24,48,.500,16,38,.421,29,34,.853,125
8,CLE,2021-01-20,147,,BRK,W 147-135 (2OT),290,56,109,.514,36,69,.522,20,40,.500,15,21,.714,147,48,106,.453,33,65,.508,15,41,.366,24,27,.889,135
9,SAS,2021-05-10,146,,MIL,W 146-125,240,56,94,.596,39,65,.600,17,29,.586,17,21,.810,146,47,94,.500,34,53,.642,13,41,.317,18,23,.783,125
10,SAS,2021-04-26,146,@,WAS,W 146-143 (OT),265,55,103,.534,49,86,.570,6,17,.353,30,35,.857,146,58,109,.532,52,89,.584,6,20,.300,21,25,.840,143
11,BRK,2021-01-31,146,@,WAS,L 146-149,240,50,88,.568,31,52,.596,19,36,.528,27,33,.818,146,56,108,.519,44,69,.638,12,39,.308,25,32,.781,149
12,BOS,2021-04-09,145,,MIN,W 145-136 (OT),265,47,87,.540,28,45,.622,19,42,.452,32,34,.941,145,47,96,.490,32,54,.593,15,42,.357,27,30,.900,136
13,BRK,2020-12-30,145,,ATL,W 145-141,240,54,100,.540,35,59,.593,19,41,.463,18,23,.783,145,47,99,.475,29,53,.547,18,46,.391,29,35,.829,141
14,NOP,2021-02-16,144,@,MEM,W 144-113,240,56,91,.615,37,53,.698,19,38,.500,13,17,.765,144,42,88,.477,29,57,.509,13,31,.419,16,18,.889,113
15,TOR,2021-01-08,144,@,SAC,W 144-123,240,53,91,.582,33,52,.635,20,39,.513,18,22,.818,144,46,81,.568,31,47,.660,15,34,.441,16,28,.571,123
16,MIL,2020-12-29,144,@,MIA,W 144-97,240,51,92,.554,22,41,.537,29,51,.569,13,15,.867,144,37,79,.468,26,42,.619,11,37,.297,12,18,.667,97
17,BOS,2021-04-30,143,,SAS,W 143-140 (OT),265,49,105,.467,31,67,.463,18,38,.474,27,36,.750,143,49,92,.533,38,68,.559,11,24,.458,31,38,.816,140
18,HOU,2021-04-29,143,,MIL,W 143-136,240,49,98,.500,24,52,.462,25,46,.543,20,24,.833,143,49,93,.527,33,54,.611,16,39,.410,22,25,.880,136
19,WAS,2021-04-26,143,,SAS,L 143-146 (OT),265,58,109,.532,52,89,.584,6,20,.300,21,25,.840,143,55,103,.534,49,86,.570,6,17,.353,30,35,.857,146
20,DAL,2021-02-12,143,,NOP,W 143-130,240,51,88,.580,26,43,.605,25,45,.556,16,21,.762,143,48,90,.533,31,53,.585,17,37,.459,17,23,.739,130
21,MIL,2021-05-13,142,@,IND,W 142-133,240,54,94,.574,43,64,.672,11,30,.367,23,31,.742,142,50,110,.455,29,67,.433,21,43,.488,12,15,.800,133
22,MIL,2021-05-07,141,,HOU,W 141-133,240,51,95,.537,32,49,.653,19,46,.413,20,23,.870,141,48,96,.500,23,43,.535,25,53,.472,12,18,.667,133
23,POR,2021-05-05,141,@,CLE,W 141-105,240,53,92,.576,37,59,.627,16,33,.485,19,25,.760,141,37,92,.402,24,54,.444,13,38,.342,18,26,.692,105
24,IND,2021-05-03,141,@,WAS,L 141-154,240,53,107,.495,39,80,.488,14,27,.519,21,25,.840,141,63,103,.612,54,81,.667,9,22,.409,19,24,.792,154
25,IND,2021-04-07,141,,MIN,W 141-137,240,55,93,.591,41,65,.631,14,28,.500,17,19,.895,141,48,91,.527,38,63,.603,10,28,.357,31,40,.775,137
26,SAC,2021-03-25,141,,GSW,W 141-119,240,53,89,.596,34,51,.667,19,38,.500,16,19,.842,141,45,88,.511,28,56,.500,17,32,.531,12,12,1.000,119
27,BOS,2021-01-24,141,,CLE,W 141-103,240,52,93,.559,38,65,.585,14,28,.500,23,27,.852,141,34,85,.400,24,52,.462,10,33,.303,25,34,.735,103
28,PHI,2021-01-06,141,,WAS,W 141-136,240,50,81,.617,32,52,.615,18,29,.621,23,33,.697,141,47,94,.500,31,57,.544,16,37,.432,26,35,.743,136
29,ATL,2020-12-30,141,@,BRK,L 141-145,240,47,99,.475,29,53,.547,18,46,.391,29,35,.829,141,54,100,.540,35,59,.593,19,41,.463,18,23,.783,145
30,PHO,2021-05-15,140,@,SAS,W 140-103,240,52,94,.553,37,61,.607,15,33,.455,21,22,.955,140,39,88,.443,35,62,.565,4,26,.154,21,24,.875,103
31,POR,2021-05-10,140,,HOU,W 140-129,240,47,92,.511,29,52,.558,18,40,.450,28,35,.800,140,42,85,.494,24,47,.511,18,38,.474,27,28,.964,129
32,NOP,2021-05-01,140,@,MIN,W 140-136 (OT),265,47,92,.511,33,56,.589,14,36,.389,32,46,.696,140,48,106,.453,33,58,.569,15,48,.313,25,32,.781,136
33,SAS,2021-04-30,140,@,BOS,L 140-143 (OT),265,49,92,.533,38,68,.559,11,24,.458,31,38,.816,140,49,105,.467,31,67,.463,18,38,.474,27,36,.750,143
34,PHO,2021-04-02,140,,OKC,W 140-103,240,54,90,.600,39,57,.684,15,33,.455,17,21,.810,140,35,89,.393,20,51,.392,15,38,.395,18,23,.783,103
35,MIL,2021-03-22,140,,IND,W 140-113,240,53,94,.564,29,55,.527,24,39,.615,10,15,.667,140,45,111,.405,33,61,.541,12,50,.240,11,12,.917,113
36,NYK,2021-02-25,140,,SAC,W 140-121,240,51,87,.586,32,51,.627,19,36,.528,19,21,.905,140,42,85,.494,30,50,.600,12,35,.343,25,33,.758,121
37,MEM,2021-05-05,139,@,MIN,W 139-135,240,52,97,.536,38,68,.559,14,29,.483,21,28,.750,139,49,94,.521,30,55,.545,19,39,.487,18,22,.818,135
38,DEN,2021-04-19,139,,MEM,W 139-137 (2OT),290,51,102,.500,36,63,.571,15,39,.385,22,26,.846,139,51,107,.477,34,67,.507,17,40,.425,18,24,.750,137
39,BRK,2021-04-07,139,,NOP,W 139-111,240,51,92,.554,32,51,.627,19,41,.463,18,22,.818,139,38,89,.427,32,62,.516,6,27,.222,29,39,.744,111
40,IND,2021-04-03,139,@,SAS,W 139-133 (OT),265,52,94,.553,40,65,.615,12,29,.414,23,26,.885,139,48,99,.485,38,70,.543,10,29,.345,27,32,.844,133
41,MIL,2021-02-23,139,,MIN,W 139-112,240,53,99,.535,33,57,.579,20,42,.476,13,18,.722,139,42,98,.429,23,44,.523,19,54,.352,9,9,1.000,112
42,UTA,2021-02-05,138,@,CHO,W 138-121,240,48,87,.552,22,37,.595,26,50,.520,16,18,.889,138,48,104,.462,37,69,.536,11,35,.314,14,17,.824,121
43,LAC,2021-01-15,138,@,SAC,W 138-100,240,52,89,.584,34,54,.630,18,35,.514,16,20,.800,138,40,85,.471,32,59,.542,8,26,.308,12,17,.706,100
44,LAL,2020-12-25,138,,DAL,W 138-115,240,51,91,.560,32,52,.615,19,39,.487,17,24,.708,138,41,83,.494,28,51,.549,13,32,.406,20,26,.769,115
45,MIL,2020-12-25,138,,GSW,W 138-99,240,50,90,.556,30,54,.556,20,36,.556,18,26,.692,138,34,99,.343,24,54,.444,10,45,.222,21,25,.840,99
46,NYK,2021-04-21,137,,ATL,W 137-127 (OT),265,49,91,.538,30,56,.536,19,35,.543,20,25,.800,137,49,102,.480,37,68,.544,12,34,.353,17,24,.708,127
47,MEM,2021-04-19,137,@,DEN,L 137-139 (2OT),290,51,107,.477,34,67,.507,17,40,.425,18,24,.750,137,51,102,.500,36,63,.571,15,39,.385,22,26,.846,139
48,MIN,2021-04-07,137,@,IND,L 137-141,240,48,91,.527,38,63,.603,10,28,.357,31,40,.775,137,55,93,.591,41,65,.631,14,28,.500,17,19,.895,141
49,UTA,2021-04-03,137,,ORL,W 137-91,240,51,92,.554,25,37,.676,26,55,.473,9,12,.750,137,32,87,.368,30,64,.469,2,23,.087,25,31,.806,91
50,IND,2021-03-19,137,@,MIA,W 137-110,240,52,89,.584,32,53,.604,20,36,.556,13,19,.684,137,41,92,.446,32,58,.552,9,34,.265,19,20,.950,110
51,LAL,2021-03-16,137,,MIN,W 137-121,240,50,87,.575,37,61,.607,13,26,.500,24,28,.857,137,47,90,.522,36,55,.655,11,35,.314,16,22,.727,121
52,TOR,2021-02-10,137,@,WAS,W 137-115,240,49,93,.527,30,61,.492,19,32,.594,20,23,.870,137,42,93,.452,30,52,.577,12,41,.293,19,23,.826,115
53,PHI,2021-01-12,137,,MIA,W 137-134 (OT),265,50,102,.490,31,47,.660,19,55,.345,18,25,.720,137,48,104,.462,29,48,.604,19,56,.339,19,24,.792,134
54,GSW,2021-01-04,137,,SAC,W 137-106,240,51,97,.526,28,54,.519,23,43,.535,12,14,.857,137,34,90,.378,24,55,.436,10,35,.286,28,39,.718,106
55,GSW,2021-01-03,137,,POR,W 137-122,240,49,88,.557,36,54,.667,13,34,.382,26,34,.765,137,41,98,.418,27,55,.491,14,43,.326,26,33,.788,122
56,MIN,2021-05-16,136,,DAL,W 136-121,240,49,90,.544,32,50,.640,17,40,.425,21,25,.840,136,44,91,.484,28,53,.528,16,38,.421,17,20,.850,121
57,GSW,2021-05-08,136,,OKC,W 136-97,240,47,81,.580,20,27,.741,27,54,.500,15,18,.833,136,38,94,.404,29,57,.509,9,37,.243,12,20,.600,97
58,MIN,2021-05-01,136,,NOP,L 136-140 (OT),265,48,106,.453,33,58,.569,15,48,.313,25,32,.781,136,47,92,.511,33,56,.589,14,36,.389,32,46,.696,140
59,MIL,2021-04-29,136,@,HOU,L 136-143,240,49,93,.527,33,54,.611,16,39,.410,22,25,.880,136,49,98,.500,24,52,.462,25,46,.543,20,24,.833,143
60,MIN,2021-04-09,136,@,BOS,L 136-145 (OT),265,47,96,.490,32,54,.593,15,42,.357,27,30,.900,136,47,87,.540,28,45,.622,19,42,.452,32,34,.941,145
61,BRK,2021-02-15,136,@,SAC,W 136-125,240,51,89,.573,24,42,.571,27,47,.574,7,12,.583,136,51,96,.531,39,63,.619,12,33,.364,11,13,.846,125
62,HOU,2021-02-01,136,@,OKC,W 136-106,240,49,102,.480,21,50,.420,28,52,.538,10,11,.909,136,39,89,.438,26,55,.473,13,34,.382,15,19,.789,106
63,WAS,2021-01-06,136,@,PHI,L 136-141,240,47,94,.500,31,57,.544,16,37,.432,26,35,.743,136,50,81,.617,32,52,.615,18,29,.621,23,33,.697,141
64,ATL,2021-05-05,135,,PHO,W 135-103,240,53,84,.631,40,58,.690,13,26,.500,16,18,.889,135,33,79,.418,21,47,.447,12,32,.375,25,29,.862,103
65,MIL,2021-05-05,135,,WAS,W 135-134,240,48,89,.539,30,52,.577,18,37,.486,21,28,.750,135,47,96,.490,39,74,.527,8,22,.364,32,43,.744,134
66,MIN,2021-05-05,135,,MEM,L 135-139,240,49,94,.521,30,55,.545,19,39,.487,18,22,.818,135,52,97,.536,38,68,.559,14,29,.483,21,28,.750,139
67,PHI,2021-05-05,135,@,HOU,W 135-115,240,50,94,.532,35,59,.593,15,35,.429,20,22,.909,135,42,93,.452,25,48,.521,17,45,.378,14,18,.778,115
68,NOP,2021-04-22,135,@,ORL,W 135-100,240,50,90,.556,38,62,.613,12,28,.429,23,26,.885,135,36,98,.367,23,62,.371,13,36,.361,15,19,.789,100
69,TOR,2021-04-10,135,@,CLE,W 135-115,240,53,86,.616,36,54,.667,17,32,.531,12,14,.857,135,39,86,.453,24,51,.471,15,35,.429,22,26,.846,115
70,TOR,2021-03-24,135,,DEN,W 135-111,240,45,89,.506,21,41,.512,24,48,.500,21,23,.913,135,41,98,.418,27,55,.491,14,43,.326,15,18,.833,111
71,NOP,2021-03-14,135,,LAC,W 135-115,240,53,81,.654,41,55,.745,12,26,.462,17,21,.810,135,42,92,.457,27,49,.551,15,43,.349,16,19,.842,115
72,MIN,2021-03-11,135,@,NOP,W 135-105,240,51,95,.537,32,55,.582,19,40,.475,14,16,.875,135,43,100,.430,37,68,.544,6,32,.188,13,24,.542,105
73,CHO,2021-03-03,135,@,MIN,W 135-102,240,51,98,.520,34,59,.576,17,39,.436,16,21,.762,135,39,96,.406,30,56,.536,9,40,.225,15,18,.833,102
74,LAC,2021-02-23,135,,WAS,W 135-116,240,54,94,.574,35,56,.625,19,38,.500,8,13,.615,135,47,88,.534,36,68,.529,11,20,.550,11,16,.688,116
75,LAL,2021-02-06,135,,DET,W 135-129 (2OT),290,51,91,.560,42,72,.583,9,19,.474,24,28,.857,135,45,94,.479,29,52,.558,16,42,.381,23,28,.821,129
76,BRK,2021-01-20,135,@,CLE,L 135-147 (2OT),290,48,106,.453,33,65,.508,15,41,.366,24,27,.889,135,56,109,.514,36,69,.522,20,40,.500,15,21,.714,147
77,POR,2021-01-07,135,,MIN,W 135-117,240,49,90,.544,31,49,.633,18,41,.439,19,23,.826,135,39,93,.419,25,52,.481,14,41,.341,25,33,.758,117
78,WAS,2021-05-05,134,@,MIL,L 134-135,240,47,96,.490,39,74,.527,8,22,.364,32,43,.744,134,48,89,.539,30,52,.577,18,37,.486,21,28,.750,135
79,PHO,2021-05-04,134,@,CLE,W 134-118 (OT),265,55,105,.524,43,74,.581,12,31,.387,12,13,.923,134,41,90,.456,28,61,.459,13,29,.448,23,27,.852,118
80,BRK,2021-04-20,134,@,NOP,W 134-129,240,49,89,.551,35,52,.673,14,37,.378,22,28,.786,134,51,91,.560,39,58,.672,12,33,.364,15,24,.625,129
81,MIN,2021-04-20,134,@,SAC,W 134-120,240,51,90,.567,33,47,.702,18,43,.419,14,19,.737,134,44,97,.454,26,55,.473,18,42,.429,14,16,.875,120
82,PHO,2021-04-10,134,,WAS,W 134-106,240,55,107,.514,38,64,.594,17,43,.395,7,7,1.000,134,39,84,.464,30,59,.508,9,25,.360,19,28,.679,106
83,DEN,2021-04-06,134,,DET,W 134-119,240,56,94,.596,42,63,.667,14,31,.452,8,9,.889,134,44,81,.543,29,46,.630,15,35,.429,16,20,.800,119
84,ATL,2021-04-01,134,@,SAS,W 134-129 (2OT),290,50,100,.500,37,76,.487,13,24,.542,21,26,.808,134,49,110,.445,36,70,.514,13,40,.325,18,24,.750,129
85,LAC,2021-03-24,134,@,SAS,W 134-101,240,49,88,.557,32,55,.582,17,33,.515,19,30,.633,134,39,85,.459,32,63,.508,7,22,.318,16,19,.842,101
86,BOS,2021-03-14,134,@,HOU,W 134-107,240,51,92,.554,33,55,.600,18,37,.486,14,21,.667,134,35,91,.385,19,41,.463,16,50,.320,21,31,.677,107
87,PHI,2021-03-14,134,,SAS,W 134-99,240,56,98,.571,41,69,.594,15,29,.517,7,11,.636,134,36,85,.424,32,64,.500,4,21,.190,23,31,.742,99
88,MIL,2021-03-11,134,,NYK,W 134-101,240,50,87,.575,32,49,.653,18,38,.474,16,17,.941,134,37,88,.420,24,51,.471,13,37,.351,14,21,.667,101
89,IND,2021-02-17,134,@,MIN,W 134-128 (OT),265,49,97,.505,36,71,.507,13,26,.500,23,27,.852,134,45,107,.421,30,67,.448,15,40,.375,23,25,.920,128
90,UTA,2021-02-15,134,,PHI,W 134-123,240,45,86,.523,27,41,.659,18,45,.400,26,31,.839,134,47,94,.500,39,71,.549,8,23,.348,21,24,.875,123
91,BRK,2021-02-13,134,@,GSW,W 134-117,240,50,93,.538,34,54,.630,16,39,.410,18,20,.900,134,44,90,.489,35,56,.625,9,34,.265,20,25,.800,117
92,DAL,2021-02-06,134,,GSW,W 134-132,240,44,96,.458,23,49,.469,21,47,.447,25,30,.833,134,46,86,.535,26,41,.634,20,45,.444,20,23,.870,132
93,IND,2021-02-02,134,,MEM,W 134-116,240,49,82,.598,33,53,.623,16,29,.552,20,29,.690,134,42,93,.452,33,68,.485,9,25,.360,23,24,.958,116
94,MIL,2021-02-01,134,,POR,W 134-106,240,53,96,.552,32,54,.593,21,42,.500,7,12,.583,134,39,104,.375,24,62,.387,15,42,.357,13,13,1.000,106
95,MIA,2021-01-12,134,@,PHI,L 134-137 (OT),265,48,104,.462,29,48,.604,19,56,.339,19,24,.792,134,50,102,.490,31,47,.660,19,55,.345,18,25,.720,137
96,IND,2021-05-13,133,,MIL,L 133-142,240,50,110,.455,29,67,.433,21,43,.488,12,15,.800,133,54,94,.574,43,64,.672,11,30,.367,23,31,.742,142
97,MEM,2021-05-11,133,,DAL,W 133-104,240,51,89,.573,35,56,.625,16,33,.485,15,16,.938,133,37,88,.420,25,50,.500,12,38,.316,18,19,.947,104
98,WAS,2021-05-08,133,@,IND,W 133-132 (OT),265,49,110,.445,40,78,.513,9,32,.281,26,30,.867,133,50,104,.481,43,75,.573,7,29,.241,25,30,.833,132
99,HOU,2021-05-07,133,@,MIL,L 133-141,240,48,96,.500,23,43,.535,25,53,.472,12,18,.667,133,51,95,.537,32,49,.653,19,46,.413,20,23,.870,141
100,IND,2021-05-06,133,,ATL,W 133-126,240,54,87,.621,46,67,.687,8,20,.400,17,19,.895,133,48,94,.511,33,57,.579,15,37,.405,15,18,.833,126
101,DAL,2021-04-27,133,@,GSW,W 133-103,240,48,92,.522,30,57,.526,18,35,.514,19,22,.864,133,34,84,.405,18,41,.439,16,43,.372,19,24,.792,103
102,POR,2021-04-27,133,@,IND,W 133-112,240,50,106,.472,30,71,.423,20,35,.571,13,16,.813,133,40,86,.465,30,56,.536,10,30,.333,22,28,.786,112
103,NYK,2021-04-09,133,,MEM,W 133-129 (OT),265,45,96,.469,31,64,.484,14,32,.438,29,33,.879,133,47,94,.500,33,64,.516,14,30,.467,21,34,.618,129
104,LAC,2021-04-06,133,,POR,W 133-116,240,46,89,.517,30,48,.625,16,41,.390,25,30,.833,133,37,92,.402,26,56,.464,11,36,.306,31,37,.838,116
105,PHO,2021-04-05,133,@,HOU,W 133-130,240,44,86,.512,26,49,.531,18,37,.486,27,31,.871,133,43,79,.544,26,46,.565,17,33,.515,27,33,.818,130
106,SAS,2021-04-03,133,,IND,L 133-139 (OT),265,48,99,.485,38,70,.543,10,29,.345,27,32,.844,133,52,94,.553,40,65,.615,12,29,.414,23,26,.885,139
107,POR,2021-04-03,133,,OKC,W 133-85,240,51,104,.490,31,58,.534,20,46,.435,11,14,.786,133,30,85,.353,22,51,.431,8,34,.235,17,24,.708,85
108,MIL,2021-03-15,133,@,WAS,W 133-122,240,52,94,.553,41,66,.621,11,28,.393,18,19,.947,133,44,87,.506,28,49,.571,16,38,.421,18,24,.750,122
109,MEM,2021-02-28,133,@,HOU,W 133-84,240,50,94,.532,40,64,.625,10,30,.333,23,28,.821,133,23,83,.277,19,38,.500,4,45,.089,34,41,.829,84
110,CHI,2021-02-24,133,,MIN,W 133-126 (OT),265,55,93,.591,45,68,.662,10,25,.400,13,16,.813,133,47,104,.452,35,66,.530,12,38,.316,20,21,.952,126
111,DEN,2021-02-10,133,,CLE,W 133-95,240,51,85,.600,35,49,.714,16,36,.444,15,21,.714,133,36,94,.383,28,57,.491,8,37,.216,15,20,.750,95
112,MEM,2021-02-01,133,@,SAS,W 133-102,240,52,93,.559,37,63,.587,15,30,.500,14,18,.778,133,37,89,.416,24,52,.462,13,37,.351,15,22,.682,102
113,HOU,2021-01-23,133,@,DAL,W 133-108,240,47,86,.547,31,49,.633,16,37,.432,23,29,.793,133,37,83,.446,32,58,.552,5,25,.200,29,40,.725,108
114,CHI,2020-12-31,133,@,WAS,W 133-130,240,50,92,.543,36,56,.643,14,36,.389,19,25,.760,133,42,84,.500,28,55,.509,14,29,.483,32,41,.780,130
115,POR,2021-05-16,132,,DEN,W 132-116,240,46,87,.529,28,44,.636,18,43,.419,22,26,.846,132,44,98,.449,30,61,.492,14,37,.378,14,15,.933,116
116,IND,2021-05-08,132,,WAS,L 132-133 (OT),265,50,104,.481,43,75,.573,7,29,.241,25,30,.833,132,49,110,.445,40,78,.513,9,32,.281,26,30,.867,133
117,BOS,2021-05-05,132,@,ORL,W 132-96,240,51,96,.531,30,51,.588,21,45,.467,9,12,.750,132,33,85,.388,27,60,.450,6,25,.240,24,28,.857,96
118,MIL,2021-04-24,132,,PHI,W 132-94,240,49,95,.516,31,55,.564,18,40,.450,16,24,.667,132,31,82,.378,24,51,.471,7,31,.226,25,34,.735,94
119,IND,2021-04-14,132,@,HOU,W 132-124,240,50,94,.532,35,58,.603,15,36,.417,17,22,.773,132,48,104,.462,38,70,.543,10,34,.294,18,22,.818,124
120,IND,2021-04-11,132,@,MEM,W 132-125,240,52,99,.525,39,62,.629,13,37,.351,15,17,.882,132,53,115,.461,47,95,.495,6,20,.300,13,19,.684,125
121,DET,2021-04-05,132,@,OKC,W 132-108,240,49,95,.516,36,67,.537,13,28,.464,21,24,.875,132,41,97,.423,36,70,.514,5,27,.185,21,25,.840,108
122,SAC,2021-03-29,132,@,SAS,W 132-115,240,47,84,.560,29,48,.604,18,36,.500,20,25,.800,132,47,93,.505,37,66,.561,10,27,.370,11,14,.786,115
123,WAS,2021-03-29,132,,IND,W 132-124,240,55,99,.556,45,80,.563,10,19,.526,12,18,.667,132,44,93,.473,32,63,.508,12,30,.400,24,33,.727,124
124,MEM,2021-03-22,132,,BOS,W 132-126 (OT),265,55,110,.500,43,75,.573,12,35,.343,10,15,.667,132,47,90,.522,30,55,.545,17,35,.486,15,24,.625,126
125,DAL,2021-03-21,132,@,POR,W 132-92,240,48,86,.558,29,49,.592,19,37,.514,17,20,.850,132,34,89,.382,25,48,.521,9,41,.220,15,19,.789,92
126,BOS,2021-03-04,132,,TOR,W 132-125,240,45,74,.608,32,45,.711,13,29,.448,29,40,.725,132,45,91,.495,24,41,.585,21,50,.420,14,17,.824,125
127,BRK,2021-03-03,132,@,HOU,W 132-114,240,49,85,.576,32,50,.640,17,35,.486,17,24,.708,132,38,91,.418,20,48,.417,18,43,.419,20,28,.714,114
128,PHO,2021-02-22,132,,POR,W 132-100,240,50,99,.505,34,66,.515,16,33,.485,16,18,.889,132,37,84,.440,25,45,.556,12,39,.308,14,19,.737,100
129,UTA,2021-02-22,132,,CHO,W 132-110,240,45,85,.529,17,30,.567,28,55,.509,14,17,.824,132,41,89,.461,30,53,.566,11,36,.306,17,21,.810,110
130,PHO,2021-02-19,132,@,NOP,W 132-114,240,51,88,.580,29,49,.592,22,39,.564,8,12,.667,132,42,82,.512,31,50,.620,11,32,.344,19,24,.792,114
131,GSW,2021-02-06,132,@,DAL,L 132-134,240,46,86,.535,26,41,.634,20,45,.444,20,23,.870,132,44,96,.458,23,49,.469,21,47,.447,25,30,.833,134
132,ATL,2021-02-06,132,,TOR,W 132-121,240,42,74,.568,23,38,.605,19,36,.528,29,33,.879,132,41,97,.423,28,59,.475,13,38,.342,26,34,.765,121
133,POR,2021-02-02,132,@,WAS,W 132-121,240,44,95,.463,23,49,.469,21,46,.457,23,23,1.000,132,46,83,.554,30,43,.698,16,40,.400,13,17,.765,121
134,BRK,2021-01-27,132,@,ATL,W 132-128 (OT),265,52,98,.531,41,66,.621,11,32,.344,17,20,.850,132,45,94,.479,32,61,.525,13,33,.394,25,28,.893,128
135,POR,2021-01-13,132,@,SAC,W 132-126,240,44,90,.489,21,42,.500,23,48,.479,21,27,.778,132,44,84,.524,25,46,.543,19,38,.500,19,26,.731,126
136,HOU,2021-01-08,132,,ORL,W 132-90,240,51,91,.560,29,44,.659,22,47,.468,8,11,.727,132,34,89,.382,26,60,.433,8,29,.276,14,16,.875,90
137,WAS,2021-05-06,131,@,TOR,W 131-129 (OT),265,41,94,.436,28,64,.438,13,30,.433,36,43,.837,131,47,105,.448,33,67,.493,14,38,.368,21,27,.778,129
138,IND,2021-04-25,131,@,ORL,W 131-112,240,50,91,.549,35,59,.593,15,32,.469,16,18,.889,131,40,101,.396,30,69,.435,10,32,.313,22,28,.786,112
139,LAC,2021-04-11,131,,DET,W 131-124,240,50,80,.625,35,53,.660,15,27,.556,16,21,.762,131,46,87,.529,31,55,.564,15,32,.469,17,19,.895,124
140,MEM,2021-04-07,131,@,ATL,W 131-113,240,48,89,.539,31,49,.633,17,40,.425,18,21,.857,131,45,101,.446,35,73,.479,10,28,.357,13,15,.867,113
141,WAS,2021-04-07,131,@,ORL,W 131-116,240,49,85,.576,30,49,.612,19,36,.528,14,16,.875,131,44,93,.473,32,62,.516,12,31,.387,16,23,.696,116
142,NYK,2021-03-23,131,,WAS,W 131-113,240,47,92,.511,31,62,.500,16,30,.533,21,24,.875,131,38,79,.481,29,56,.518,9,23,.391,28,35,.800,113
143,DEN,2021-03-19,131,,CHI,W 131-127 (OT),265,48,91,.527,34,57,.596,14,34,.412,21,27,.778,131,47,90,.522,30,55,.545,17,35,.486,16,23,.696,127
144,WAS,2021-03-18,131,,UTA,W 131-122,240,47,86,.547,40,69,.580,7,17,.412,30,38,.789,131,44,96,.458,26,48,.542,18,48,.375,16,28,.571,122
145,GSW,2021-03-14,131,,UTA,W 131-119,240,50,89,.562,34,58,.586,16,31,.516,15,18,.833,131,41,93,.441,26,49,.531,15,44,.341,22,29,.759,119
146,PHI,2021-03-03,131,,UTA,W 131-123 (OT),265,48,93,.516,40,68,.588,8,25,.320,27,35,.771,131,44,100,.440,23,56,.411,21,44,.477,14,19,.737,123
147,WAS,2021-02-15,131,,HOU,W 131-119,240,48,92,.522,36,62,.581,12,30,.400,23,31,.742,131,43,91,.473,35,54,.648,8,37,.216,25,34,.735,119
148,NOP,2021-01-29,131,,MIL,W 131-126,240,45,96,.469,24,48,.500,21,48,.438,20,28,.714,131,48,96,.500,35,61,.574,13,35,.371,17,22,.773,126
149,UTA,2021-01-08,131,@,MIL,W 131-118,240,49,97,.505,24,44,.545,25,53,.472,8,13,.615,131,44,98,.449,31,56,.554,13,42,.310,17,21,.810,118
150,SAS,2020-12-23,131,@,MEM,W 131-119,240,48,95,.505,38,70,.543,10,25,.400,25,29,.862,131,49,95,.516,39,68,.574,10,27,.370,11,18,.611,119
151,MIA,2021-05-09,130,@,BOS,W 130-124,240,47,82,.573,31,47,.660,16,35,.457,20,22,.909,130,45,83,.542,31,45,.689,14,38,.368,20,25,.800,124
152,BRK,2021-04-29,130,@,IND,W 130-113,240,47,89,.528,35,54,.648,12,35,.343,24,28,.857,130,41,96,.427,30,57,.526,11,39,.282,20,21,.952,113
153,POR,2021-04-28,130,@,MEM,W 130-109,240,45,92,.489,30,52,.577,15,40,.375,25,28,.893,130,37,88,.420,28,56,.500,9,32,.281,26,30,.867,109
154,MEM,2021-04-23,130,@,POR,W 130-128,240,52,98,.531,43,68,.632,9,30,.300,17,22,.773,130,46,96,.479,32,61,.525,14,35,.400,22,27,.815,128
155,BRK,2021-04-16,130,,CHO,W 130-115,240,47,85,.553,26,44,.591,21,41,.512,15,16,.938,130,44,83,.530,32,49,.653,12,34,.353,15,20,.750,115
156,MIL,2021-04-14,130,@,MIN,W 130-105,240,46,98,.469,27,58,.466,19,40,.475,19,23,.826,130,34,92,.370,19,51,.373,15,41,.366,22,31,.710,105
157,HOU,2021-04-05,130,,PHO,L 130-133,240,43,79,.544,26,46,.565,17,33,.515,27,33,.818,130,44,86,.512,26,49,.531,18,37,.486,27,31,.871,133
158,TOR,2021-04-02,130,,GSW,W 130-77,240,47,88,.534,32,53,.604,15,35,.429,21,25,.840,130,26,79,.329,15,45,.333,11,34,.324,14,18,.778,77
159,LAC,2021-03-11,130,,GSW,W 130-104,240,44,96,.458,26,55,.473,18,41,.439,24,29,.828,130,38,88,.432,29,52,.558,9,36,.250,19,27,.704,104
160,DAL,2021-03-01,130,@,ORL,W 130-124,240,47,90,.522,30,44,.682,17,46,.370,19,23,.826,130,47,95,.495,27,54,.500,20,41,.488,10,14,.714,124
161,PHI,2021-03-01,130,,IND,W 130-114,240,50,88,.568,35,53,.660,15,35,.429,15,16,.938,130,44,91,.484,36,62,.581,8,29,.276,18,21,.857,114
162,GSW,2021-02-26,130,,CHO,W 130-121,240,48,79,.608,37,55,.673,11,24,.458,23,25,.920,130,41,89,.461,24,48,.500,17,41,.415,22,32,.688,121
163,WAS,2021-02-17,130,,DEN,W 130-128,240,44,86,.512,29,53,.547,15,33,.455,27,34,.794,130,48,92,.522,31,54,.574,17,38,.447,15,18,.833,128
164,NOP,2021-02-12,130,@,DAL,L 130-143,240,48,90,.533,31,53,.585,17,37,.459,17,23,.739,130,51,88,.580,26,43,.605,25,45,.556,16,21,.762,143
165,MEM,2021-02-10,130,,CHO,W 130-114,240,47,94,.500,24,45,.533,23,49,.469,13,18,.722,130,45,82,.549,31,53,.585,14,29,.483,10,12,.833,114
166,NOP,2021-02-09,130,,HOU,W 130-101,240,47,92,.511,35,61,.574,12,31,.387,24,28,.857,130,38,91,.418,25,48,.521,13,43,.302,12,21,.571,101
167,MIL,2021-02-03,130,,IND,W 130-110,240,48,102,.471,27,54,.500,21,48,.438,13,14,.929,130,43,95,.453,32,61,.525,11,34,.324,13,15,.867,110
168,GSW,2021-01-25,130,,MIN,W 130-108,240,44,89,.494,30,59,.508,14,30,.467,28,37,.757,130,39,94,.415,31,70,.443,8,24,.333,22,25,.880,108
169,DEN,2021-01-22,130,@,PHO,W 130-126 (OT),265,53,103,.515,47,77,.610,6,26,.231,18,19,.947,130,47,94,.500,30,50,.600,17,44,.386,15,15,1.000,126
170,LAC,2021-01-10,130,,CHI,W 130-127,240,45,92,.489,25,54,.463,20,38,.526,20,25,.800,130,47,77,.610,29,44,.659,18,33,.545,15,17,.882,127
171,MIL,2021-01-06,130,,DET,W 130-115,240,49,90,.544,30,47,.638,19,43,.442,13,21,.619,130,38,97,.392,25,56,.446,13,41,.317,26,30,.867,115
172,BRK,2021-01-05,130,,UTA,W 130-96,240,52,93,.559,38,57,.667,14,36,.389,12,16,.750,130,33,86,.384,22,52,.423,11,34,.324,19,27,.704,96
173,UTA,2021-01-03,130,@,SAS,W 130-109,240,49,89,.551,28,48,.583,21,41,.512,11,19,.579,130,44,105,.419,38,86,.442,6,19,.316,15,21,.714,109
174,WAS,2021-01-01,130,@,MIN,W 130-109,240,49,89,.551,33,56,.589,16,33,.485,16,21,.762,130,42,88,.477,29,52,.558,13,36,.361,12,21,.571,109
175,WAS,2020-12-31,130,,CHI,L 130-133,240,42,84,.500,28,55,.509,14,29,.483,32,41,.780,130,50,92,.543,36,56,.643,14,36,.389,19,25,.760,133
176,NYK,2020-12-27,130,,MIL,W 130-110,240,46,85,.541,30,58,.517,16,27,.593,22,27,.815,130,41,95,.432,34,57,.596,7,38,.184,21,29,.724,110
177,ORL,2020-12-26,130,@,WAS,W 130-120,240,48,95,.505,37,64,.578,11,31,.355,23,29,.793,130,46,95,.484,33,58,.569,13,37,.351,15,28,.536,120
178,MIA,2021-05-11,129,@,BOS,W 129-121,240,48,81,.593,32,51,.627,16,30,.533,17,22,.773,129,46,88,.523,28,51,.549,18,37,.486,11,17,.647,121
179,HOU,2021-05-10,129,@,POR,L 129-140,240,42,85,.494,24,47,.511,18,38,.474,27,28,.964,129,47,92,.511,29,52,.558,18,40,.450,28,35,.800,140
180,TOR,2021-05-06,129,,WAS,L 129-131 (OT),265,47,105,.448,33,67,.493,14,38,.368,21,27,.778,129,41,94,.436,28,64,.438,13,30,.433,36,43,.837,131
181,POR,2021-05-02,129,@,BOS,W 129-119,240,44,85,.518,25,47,.532,19,38,.500,22,26,.846,129,43,89,.483,23,50,.460,20,39,.513,13,15,.867,119
182,DEN,2021-04-24,129,,HOU,W 129-116,240,50,84,.595,34,47,.723,16,37,.432,13,16,.813,129,41,82,.500,26,42,.619,15,40,.375,19,28,.679,116
183,WAS,2021-04-23,129,@,OKC,W 129-109,240,48,93,.516,30,61,.492,18,32,.563,15,16,.938,129,39,93,.419,29,60,.483,10,33,.303,21,25,.840,109
184,NOP,2021-04-20,129,,BRK,L 129-134,240,51,91,.560,39,58,.672,12,33,.364,15,24,.625,129,49,89,.551,35,52,.673,14,37,.378,22,28,.786,134
185,ATL,2021-04-18,129,,IND,W 129-117,240,45,92,.489,32,60,.533,13,32,.406,26,34,.765,129,45,92,.489,35,60,.583,10,32,.313,17,20,.850,117
186,MEM,2021-04-09,129,@,NYK,L 129-133 (OT),265,47,94,.500,33,64,.516,14,30,.467,21,34,.618,129,45,96,.469,31,64,.484,14,32,.438,29,33,.879,133
187,CLE,2021-04-08,129,@,OKC,W 129-102,240,48,94,.511,35,57,.614,13,37,.351,20,24,.833,129,40,89,.449,27,57,.474,13,32,.406,9,13,.692,102
188,MIL,2021-04-03,129,@,SAC,W 129-128,240,50,93,.538,39,62,.629,11,31,.355,18,20,.900,129,49,99,.495,32,60,.533,17,39,.436,13,13,1.000,128
189,SAS,2021-04-01,129,,ATL,L 129-134 (2OT),290,49,110,.445,36,70,.514,13,40,.325,18,24,.750,129,50,100,.500,37,76,.487,13,24,.542,21,26,.808,134
190,LAC,2021-03-29,129,,MIL,W 129-105,240,51,95,.537,32,61,.525,19,34,.559,8,10,.800,129,38,81,.469,27,51,.529,11,30,.367,18,21,.857,105
191,HOU,2021-03-27,129,@,MIN,W 129-107,240,50,92,.543,32,53,.604,18,39,.462,11,13,.846,129,36,85,.424,23,45,.511,13,40,.325,22,28,.786,107
192,PHI,2021-03-20,129,,SAC,W 129-105,240,48,86,.558,37,63,.587,11,23,.478,22,29,.759,129,39,85,.459,29,57,.509,10,28,.357,17,27,.630,105
193,DEN,2021-03-17,129,,CHO,W 129-104,240,52,90,.578,36,46,.783,16,44,.364,9,13,.692,129,36,80,.450,24,42,.571,12,38,.316,20,28,.714,104
194,DET,2021-03-03,129,@,TOR,W 129-105,240,48,91,.527,28,50,.560,20,41,.488,13,21,.619,129,34,77,.442,22,41,.537,12,36,.333,25,30,.833,105
195,NOP,2021-03-01,129,,UTA,W 129-124,240,52,92,.565,45,81,.556,7,11,.636,18,23,.783,129,46,101,.455,29,58,.500,17,43,.395,15,18,.833,124
196,BRK,2021-02-25,129,,ORL,W 129-92,240,49,92,.533,29,47,.617,20,45,.444,11,14,.786,129,35,87,.402,26,51,.510,9,36,.250,13,15,.867,92
197,MIL,2021-02-25,129,,NOP,W 129-125,240,52,96,.542,39,65,.600,13,31,.419,12,16,.750,129,51,102,.500,38,63,.603,13,39,.333,10,14,.714,125
198,GSW,2021-02-15,129,,CLE,W 129-98,240,46,88,.523,29,51,.569,17,37,.459,20,21,.952,129,37,95,.389,29,65,.446,8,30,.267,16,20,.800,98
199,UTA,2021-02-12,129,,MIL,W 129-115,240,43,82,.524,29,44,.659,14,38,.368,29,34,.853,129,42,92,.457,30,59,.508,12,33,.364,19,27,.704,115
200,POR,2021-02-12,129,,CLE,W 129-110,240,43,83,.518,30,48,.625,13,35,.371,30,33,.909,129,38,87,.437,30,64,.469,8,23,.348,26,37,.703,110
201,CHI,2021-02-10,129,,NOP,W 129-116,240,48,81,.593,23,34,.676,25,47,.532,8,11,.727,129,41,81,.506,28,45,.622,13,36,.361,21,26,.808,116
202,DET,2021-02-06,129,@,LAL,L 129-135 (2OT),290,45,94,.479,29,52,.558,16,42,.381,23,28,.821,129,51,91,.560,42,72,.583,9,19,.474,24,28,.857,135
203,CHO,2021-02-01,129,@,MIA,W 129-121 (OT),265,43,95,.453,22,54,.407,21,41,.512,22,26,.846,129,43,91,.473,24,45,.533,19,46,.413,16,25,.640,121
204,LAC,2021-01-31,129,@,NYK,W 129-115,240,44,81,.543,27,43,.628,17,38,.447,24,28,.857,129,41,85,.482,31,58,.534,10,27,.370,23,28,.821,115
205,MEM,2021-01-30,129,@,SAS,W 129-112,240,51,91,.560,34,56,.607,17,35,.486,10,15,.667,129,39,83,.470,26,54,.481,13,29,.448,21,26,.808,112
206,IND,2021-01-25,129,,TOR,W 129-114,240,40,78,.513,28,49,.571,12,29,.414,37,45,.822,129,38,93,.409,24,55,.436,14,38,.368,24,27,.889,114
207,MIL,2021-01-24,129,,ATL,W 129-115,240,50,91,.549,40,60,.667,10,31,.323,19,27,.704,129,42,83,.506,28,44,.636,14,39,.359,17,22,.773,115
208,UTA,2021-01-21,129,,NOP,W 129-118,240,44,88,.500,27,49,.551,17,39,.436,24,25,.960,129,42,85,.494,31,60,.517,11,25,.440,23,30,.767,118
209,LAC,2021-01-17,129,,IND,W 129-96,240,48,87,.552,29,48,.604,19,39,.487,14,20,.700,129,37,89,.416,26,51,.510,11,38,.289,11,16,.688,96
210,OKC,2021-01-10,129,@,BRK,W 129-116,240,49,90,.544,34,51,.667,15,39,.385,16,17,.941,129,43,85,.506,33,51,.647,10,34,.294,20,24,.833,116
211,GSW,2020-12-27,129,@,CHI,W 129-128,240,42,104,.404,24,57,.421,18,47,.383,27,30,.900,129,44,86,.512,27,45,.600,17,41,.415,23,31,.742,128
212,PHI,2021-05-16,128,,ORL,W 128-117,240,46,94,.489,27,54,.500,19,40,.475,17,23,.739,128,36,76,.474,26,48,.542,10,28,.357,35,41,.854,117
213,BRK,2021-05-12,128,,SAS,W 128-116,240,48,79,.608,36,51,.706,12,28,.429,20,27,.741,128,43,101,.426,35,70,.500,8,31,.258,22,27,.815,116
214,MIN,2021-05-09,128,@,ORL,W 128-96,240,47,97,.485,31,52,.596,16,45,.356,18,24,.750,128,36,91,.396,27,55,.491,9,36,.250,15,22,.682,96
215,PHO,2021-05-07,128,,NYK,W 128-105,240,43,92,.467,25,51,.490,18,41,.439,24,25,.960,128,38,84,.452,27,52,.519,11,32,.344,18,23,.783,105
216,POR,2021-04-30,128,@,BRK,W 128-109,240,47,91,.516,31,55,.564,16,36,.444,18,20,.900,128,40,95,.421,27,54,.500,13,41,.317,16,19,.842,109
217,BRK,2021-04-25,128,,PHO,W 128-119,240,46,87,.529,33,59,.559,13,28,.464,23,27,.852,128,43,90,.478,31,56,.554,12,34,.353,21,25,.840,119
218,POR,2021-04-23,128,,MEM,L 128-130,240,46,96,.479,32,61,.525,14,35,.400,22,27,.815,128,52,98,.531,43,68,.632,9,30,.300,17,22,.773,130
219,SAC,2021-04-21,128,,MIN,W 128-125,240,43,74,.581,26,41,.634,17,33,.515,25,31,.806,128,46,87,.529,31,53,.585,15,34,.441,18,22,.818,125
220,PHO,2021-04-19,128,@,MIL,W 128-127 (OT),265,51,106,.481,34,64,.531,17,42,.405,9,10,.900,128,49,102,.480,38,68,.559,11,34,.324,18,19,.947,127
221,MEM,2021-04-17,128,@,MIL,W 128-115,240,51,93,.548,36,53,.679,15,40,.375,11,12,.917,128,39,91,.429,23,44,.523,16,47,.340,21,27,.778,115
222,DEN,2021-04-16,128,@,HOU,W 128-99,240,46,94,.489,37,63,.587,9,31,.290,27,31,.871,128,38,86,.442,27,51,.529,11,35,.314,12,18,.667,99
223,UTA,2021-04-10,128,,SAC,W 128-112,240,40,88,.455,22,38,.579,18,50,.360,30,35,.857,128,42,88,.477,28,46,.609,14,42,.333,14,22,.636,112
224,SAC,2021-04-03,128,,MIL,L 128-129,240,49,99,.495,32,60,.533,17,39,.436,13,13,1.000,128,50,93,.538,39,62,.629,11,31,.355,18,20,.900,129
225,DAL,2021-03-24,128,@,MIN,W 128-108,240,48,99,.485,32,55,.582,16,44,.364,16,22,.727,128,38,86,.442,26,48,.542,12,38,.316,20,26,.769,108
226,NOP,2021-03-23,128,,LAL,W 128-111,240,47,90,.522,37,61,.607,10,29,.345,24,26,.923,128,36,85,.424,18,48,.375,18,37,.486,21,30,.700,111
227,LAL,2021-03-15,128,@,GSW,W 128-97,240,49,78,.628,38,51,.745,11,27,.407,19,25,.760,128,34,79,.430,21,42,.500,13,37,.351,16,24,.667,97
228,OKC,2021-03-14,128,,MEM,W 128-122,240,42,73,.575,26,42,.619,16,31,.516,28,34,.824,128,47,92,.511,40,70,.571,7,22,.318,21,29,.724,122
229,CHI,2021-03-03,128,@,NOP,W 128-124,240,48,94,.511,36,66,.545,12,28,.429,20,22,.909,128,46,83,.554,40,61,.656,6,22,.273,26,38,.684,124
230,DEN,2021-03-02,128,@,MIL,W 128-97,240,53,95,.558,42,65,.646,11,30,.367,11,12,.917,128,32,79,.405,21,39,.538,11,40,.275,22,31,.710,97
231,WAS,2021-02-27,128,,MIN,W 128-112,240,44,98,.449,31,65,.477,13,33,.394,27,34,.794,128,41,95,.432,30,60,.500,11,35,.314,19,29,.655,112
232,NOP,2021-02-24,128,,DET,W 128-118,240,50,90,.556,40,67,.597,10,23,.435,18,29,.621,128,47,89,.528,34,53,.642,13,36,.361,11,16,.688,118
233,MIL,2021-02-21,128,,SAC,W 128-115,240,44,90,.489,33,62,.532,11,28,.393,29,36,.806,128,44,100,.440,32,67,.478,12,33,.364,15,20,.750,115
234,PHO,2021-02-20,128,@,MEM,W 128-97,240,46,86,.535,22,40,.550,24,46,.522,12,13,.923,128,36,93,.387,31,60,.517,5,33,.152,20,23,.870,97
235,MIN,2021-02-17,128,,IND,L 128-134 (OT),265,45,107,.421,30,67,.448,15,40,.375,23,25,.920,128,49,97,.505,36,71,.507,13,26,.500,23,27,.852,134
236,DEN,2021-02-17,128,@,WAS,L 128-130,240,48,92,.522,31,54,.574,17,38,.447,15,18,.833,128,44,86,.512,29,53,.547,15,33,.455,27,34,.794,130
237,BRK,2021-02-16,128,@,PHO,W 128-124,240,47,82,.573,27,42,.643,20,40,.500,14,15,.933,128,48,88,.545,32,51,.627,16,37,.432,12,12,1.000,124
238,LAC,2021-02-14,128,,CLE,W 128-111,240,42,88,.477,29,58,.500,13,30,.433,31,36,.861,128,43,93,.462,36,68,.529,7,25,.280,18,25,.720,111
239,TOR,2021-02-08,128,@,MEM,W 128-113,240,42,77,.545,22,40,.550,20,37,.541,24,26,.923,128,37,87,.425,24,48,.500,13,39,.333,26,29,.897,113
240,DEN,2021-01-31,128,,UTA,W 128-117,240,47,87,.540,29,59,.492,18,28,.643,16,19,.842,128,32,75,.427,12,28,.429,20,47,.426,33,39,.846,117
241,ATL,2021-01-27,128,,BRK,L 128-132 (OT),265,45,94,.479,32,61,.525,13,33,.394,25,28,.893,128,52,98,.531,41,66,.621,11,32,.344,17,20,.850,132
242,BRK,2021-01-23,128,,MIA,W 128-124,240,44,83,.530,25,46,.543,19,37,.514,21,26,.808,128,42,89,.472,29,43,.674,13,46,.283,27,32,.844,124
243,NOP,2021-01-17,128,@,SAC,W 128-123,240,45,85,.529,34,63,.540,11,22,.500,27,34,.794,128,47,91,.516,34,52,.654,13,39,.333,16,18,.889,123
244,LAL,2021-01-13,128,@,OKC,W 128-99,240,47,95,.495,30,58,.517,17,37,.459,17,22,.773,128,37,86,.430,27,55,.491,10,31,.323,15,19,.789,99
245,WAS,2021-01-11,128,,PHO,W 128-107,240,48,92,.522,33,58,.569,15,34,.441,17,28,.607,128,39,87,.448,35,60,.583,4,27,.148,25,30,.833,107
246,MIA,2021-01-09,128,@,WAS,W 128-124,240,46,93,.495,30,50,.600,16,43,.372,20,26,.769,128,44,99,.444,29,59,.492,15,40,.375,21,28,.750,124
247,SAC,2021-01-06,128,,CHI,W 128-124,240,47,91,.516,33,54,.611,14,37,.378,20,27,.741,128,49,93,.527,35,53,.660,14,40,.350,12,15,.800,124
248,LAC,2020-12-30,128,,POR,W 128-105,240,47,95,.495,29,57,.509,18,38,.474,16,22,.727,128,32,76,.421,20,38,.526,12,38,.316,29,34,.853,105
249,ATL,2020-12-28,128,,DET,W 128-120,240,40,82,.488,20,40,.500,20,42,.476,28,32,.875,128,43,98,.439,30,57,.526,13,41,.317,21,24,.875,120
250,CHI,2020-12-27,128,,GSW,L 128-129,240,44,86,.512,27,45,.600,17,41,.415,23,31,.742,128,42,104,.404,24,57,.421,18,47,.383,27,30,.900,129
251,CLE,2020-12-26,128,@,DET,W 128-119 (2OT),290,48,99,.485,35,69,.507,13,30,.433,19,30,.633,128,40,98,.408,24,53,.453,16,45,.356,23,32,.719,119
252,POR,2020-12-26,128,,HOU,W 128-126 (OT),265,47,102,.461,28,57,.491,19,45,.422,15,23,.652,128,45,87,.517,34,52,.654,11,35,.314,25,32,.781,126
253,UTA,2021-05-07,127,,DEN,W 127-120,240,43,89,.483,22,43,.512,21,46,.457,20,23,.870,127,43,83,.518,26,45,.578,17,38,.447,17,20,.850,120
254,DAL,2021-05-04,127,@,MIA,W 127-113,240,46,87,.529,24,39,.615,22,48,.458,13,18,.722,127,39,84,.464,21,43,.488,18,41,.439,17,21,.810,113
255,PHI,2021-04-28,127,,ATL,W 127-83,240,48,89,.539,32,53,.604,16,36,.444,15,22,.682,127,27,81,.333,21,62,.339,6,19,.316,23,29,.793,83
256,DAL,2021-04-21,127,,DET,W 127-117,240,46,92,.500,30,49,.612,16,43,.372,19,26,.731,127,40,79,.506,27,47,.574,13,32,.406,24,31,.774,117
257,ATL,2021-04-21,127,@,NYK,L 127-137 (OT),265,49,102,.480,37,68,.544,12,34,.353,17,24,.708,127,49,91,.538,30,56,.536,19,35,.543,20,25,.800,137
258,MIL,2021-04-19,127,,PHO,L 127-128 (OT),265,49,102,.480,38,68,.559,11,34,.324,18,19,.947,127,51,106,.481,34,64,.531,17,42,.405,9,10,.900,128
259,LAL,2021-04-17,127,,UTA,W 127-115 (OT),265,48,93,.516,37,60,.617,11,33,.333,20,23,.870,127,42,101,.416,19,42,.452,23,59,.390,8,8,1.000,115
260,BRK,2021-04-13,127,@,MIN,W 127-97,240,46,91,.505,31,55,.564,15,36,.417,20,24,.833,127,30,87,.345,17,38,.447,13,49,.265,24,33,.727,97
261,CHO,2021-04-09,127,@,MIL,W 127-119,240,44,91,.484,25,41,.610,19,50,.380,20,22,.909,127,44,98,.449,30,60,.500,14,38,.368,17,23,.739,119
262,MIL,2021-04-02,127,@,POR,W 127-109,240,49,90,.544,37,51,.725,12,39,.308,17,19,.895,127,36,99,.364,15,45,.333,21,54,.389,16,22,.727,109
263,DAL,2021-03-29,127,@,OKC,W 127-106,240,51,96,.531,35,52,.673,16,44,.364,9,13,.692,127,38,81,.469,29,55,.527,9,26,.346,21,33,.636,106
264,CHI,2021-03-19,127,@,DEN,L 127-131 (OT),265,47,90,.522,30,55,.545,17,35,.486,16,23,.696,127,48,91,.527,34,57,.596,14,34,.412,21,27,.778,131
265,PHI,2021-03-12,127,@,WAS,W 127-101,240,49,90,.544,38,69,.551,11,21,.524,18,18,1.000,127,40,82,.488,32,58,.552,8,24,.333,13,22,.591,101
266,PHI,2021-03-11,127,@,CHI,W 127-105,240,53,103,.515,43,70,.614,10,33,.303,11,15,.733,127,39,83,.470,25,54,.463,14,29,.483,13,16,.813,105
267,PHO,2021-03-11,127,@,POR,W 127-121,240,49,83,.590,36,59,.610,13,24,.542,16,19,.842,127,43,94,.457,25,51,.490,18,43,.419,17,19,.895,121
268,MEM,2021-03-10,127,,WAS,W 127-112,240,50,99,.505,42,76,.553,8,23,.348,19,29,.655,127,38,95,.400,27,59,.458,11,36,.306,25,27,.926,112
269,CHO,2021-02-28,127,@,SAC,W 127-126,240,45,83,.542,34,53,.642,11,30,.367,26,27,.963,127,50,92,.543,34,56,.607,16,36,.444,10,17,.588,126
270,ATL,2021-02-24,127,,BOS,W 127-112,240,45,85,.529,22,43,.512,23,42,.548,14,17,.824,127,42,95,.442,34,64,.531,8,31,.258,20,23,.870,112
271,BRK,2021-02-23,127,,SAC,W 127-118,240,44,89,.494,27,49,.551,17,40,.425,22,31,.710,127,45,87,.517,30,56,.536,15,31,.484,13,19,.684,118
272,WAS,2021-02-22,127,@,LAL,W 127-124 (OT),265,47,96,.490,38,71,.535,9,25,.360,24,33,.727,127,49,104,.471,34,60,.567,15,44,.341,11,17,.647,124
273,DAL,2021-02-08,127,,MIN,W 127-122,240,45,87,.517,33,53,.623,12,34,.353,25,30,.833,127,42,91,.462,24,49,.490,18,42,.429,20,28,.714,122
274,UTA,2021-01-23,127,,GSW,W 127-108,240,45,94,.479,25,44,.568,20,50,.400,17,22,.773,127,42,93,.452,28,54,.519,14,39,.359,10,15,.667,108
275,OKC,2021-01-15,127,,CHI,W 127-125 (OT),265,48,105,.457,33,60,.550,15,45,.333,16,24,.667,127,43,91,.473,22,45,.489,21,46,.457,18,25,.720,125
276,SAC,2021-01-11,127,,IND,W 127-122,240,47,84,.560,32,52,.615,15,32,.469,18,23,.783,127,47,97,.485,34,58,.586,13,39,.333,15,18,.833,122
277,CHI,2021-01-10,127,@,LAC,L 127-130,240,47,77,.610,29,44,.659,18,33,.545,15,17,.882,127,45,92,.489,25,54,.463,20,38,.526,20,25,.800,130
278,PHI,2021-01-02,127,,CHO,W 127-112,240,47,79,.595,31,44,.705,16,35,.457,17,24,.708,127,38,92,.413,25,57,.439,13,35,.371,23,26,.885,112
279,LAL,2020-12-27,127,,MIN,W 127-91,240,50,90,.556,37,55,.673,13,35,.371,14,18,.778,127,38,103,.369,32,68,.471,6,35,.171,9,14,.643,91
280,SAC,2021-05-09,126,,OKC,W 126-98,240,45,85,.529,29,49,.592,16,36,.444,20,24,.833,126,34,87,.391,23,50,.460,11,37,.297,19,29,.655,98
281,ATL,2021-05-06,126,@,IND,L 126-133,240,48,94,.511,33,57,.579,15,37,.405,15,18,.833,126,54,87,.621,46,67,.687,8,20,.400,17,19,.895,133
282,UTA,2021-05-05,126,,SAS,W 126-94,240,49,88,.557,31,47,.660,18,41,.439,10,14,.714,126,37,92,.402,30,69,.435,7,23,.304,13,20,.650,94
283,PHI,2021-04-30,126,,ATL,W 126-104,240,47,101,.465,37,73,.507,10,28,.357,22,26,.846,126,36,82,.439,26,54,.481,10,28,.357,22,28,.786,104
284,MIN,2021-04-29,126,,GSW,W 126-114,240,43,94,.457,23,53,.434,20,41,.488,20,29,.690,126,42,85,.494,27,47,.574,15,38,.395,15,21,.714,114
285,MEM,2021-04-16,126,@,CHI,W 126-115,240,45,86,.523,28,46,.609,17,40,.425,19,24,.792,126,45,96,.469,32,62,.516,13,34,.382,12,15,.800,115
286,LAC,2021-04-13,126,@,IND,W 126-115,240,48,89,.539,35,61,.574,13,28,.464,17,19,.895,126,44,96,.458,35,56,.625,9,40,.225,18,22,.818,115
287,PHO,2021-04-12,126,,HOU,W 126-120,240,45,94,.479,20,49,.408,25,45,.556,11,18,.611,126,44,87,.506,27,45,.600,17,42,.405,15,19,.789,120
288,LAL,2021-04-10,126,@,BRK,W 126-101,240,47,93,.505,28,59,.475,19,34,.559,13,20,.650,126,35,80,.438,30,53,.566,5,27,.185,26,30,.867,101
289,LAC,2021-04-09,126,,HOU,W 126-109,240,48,88,.545,29,51,.569,19,37,.514,11,13,.846,126,39,83,.470,27,46,.587,12,37,.324,19,27,.704,109
290,ATL,2021-04-02,126,@,NOP,W 126-103,240,49,87,.563,36,58,.621,13,29,.448,15,21,.714,126,38,88,.432,30,59,.508,8,29,.276,19,23,.826,103
291,DEN,2021-03-28,126,,ATL,W 126-102,240,50,92,.543,35,56,.625,15,36,.417,11,16,.688,126,36,76,.474,24,42,.571,12,34,.353,18,21,.857,102
292,UTA,2021-03-27,126,,MEM,W 126-110,240,46,92,.500,27,47,.574,19,45,.422,15,20,.750,126,39,97,.402,30,64,.469,9,33,.273,23,30,.767,110
293,BOS,2021-03-22,126,@,MEM,L 126-132 (OT),265,47,90,.522,30,55,.545,17,35,.486,15,24,.625,126,55,110,.500,43,75,.573,12,35,.343,10,15,.667,132
294,SAC,2021-02-28,126,,CHO,L 126-127,240,50,92,.543,34,56,.607,16,36,.444,10,17,.588,126,45,83,.542,34,53,.642,11,30,.367,26,27,.963,127
295,DEN,2021-02-27,126,@,OKC,W 126-96,240,49,89,.551,34,58,.586,15,31,.484,13,16,.813,126,37,88,.420,26,41,.634,11,47,.234,11,15,.733,96
296,MIN,2021-02-24,126,@,CHI,L 126-133 (OT),265,47,104,.452,35,66,.530,12,38,.316,20,21,.952,126,55,93,.591,45,68,.662,10,25,.400,13,16,.813,133
297,POR,2021-02-17,126,@,NOP,W 126-124,240,46,90,.511,28,49,.571,18,41,.439,16,18,.889,126,43,89,.483,28,57,.491,15,32,.469,23,29,.793,124
298,HOU,2021-01-30,126,@,NOP,W 126-112,240,45,92,.489,25,46,.543,20,46,.435,16,20,.800,126,41,91,.451,29,50,.580,12,41,.293,18,29,.621,112
299,CHO,2021-01-30,126,,MIL,W 126-114,240,44,92,.478,23,48,.479,21,44,.477,17,20,.850,126,40,82,.488,22,37,.595,18,45,.400,16,24,.667,114
300,MIL,2021-01-29,126,@,NOP,L 126-131,240,48,96,.500,35,61,.574,13,35,.371,17,22,.773,126,45,96,.469,24,48,.500,21,48,.438,20,28,.714,131
301,SAC,2021-01-29,126,@,TOR,W 126-124,240,43,78,.551,27,42,.643,16,36,.444,24,31,.774,126,42,86,.488,29,54,.537,13,32,.406,27,33,.818,124
302,PHO,2021-01-22,126,,DEN,L 126-130 (OT),265,47,94,.500,30,50,.600,17,44,.386,15,15,1.000,126,53,103,.515,47,77,.610,6,26,.231,18,19,.947,130
303,SAC,2021-01-13,126,,POR,L 126-132,240,44,84,.524,25,46,.543,19,38,.500,19,26,.731,126,44,90,.489,21,42,.500,23,48,.479,21,27,.778,132
304,BOS,2021-01-04,126,@,TOR,W 126-114,240,41,84,.488,26,55,.473,15,29,.517,29,34,.853,126,36,90,.400,23,53,.434,13,37,.351,29,38,.763,114
305,MIL,2021-01-01,126,,CHI,W 126-96,240,42,85,.494,20,40,.500,22,45,.489,20,30,.667,126,38,87,.437,32,61,.525,6,26,.231,14,20,.700,96
306,BOS,2020-12-30,126,,MEM,W 126-107,240,49,91,.538,33,52,.635,16,39,.410,12,14,.857,126,40,93,.430,31,60,.517,9,33,.273,18,25,.720,107
307,HOU,2020-12-26,126,@,POR,L 126-128 (OT),265,45,87,.517,34,52,.654,11,35,.314,25,32,.781,126,47,102,.461,28,57,.491,19,45,.422,15,23,.652,128
308,IND,2021-05-16,125,@,TOR,W 125-113,240,48,95,.505,33,58,.569,15,37,.405,14,18,.778,125,39,97,.402,27,59,.458,12,38,.316,23,29,.793,113
309,GSW,2021-05-14,125,,NOP,W 125-122,240,42,87,.483,25,48,.521,17,39,.436,24,30,.800,125,46,99,.465,35,72,.486,11,27,.407,19,28,.679,122
310,DAL,2021-05-12,125,,NOP,W 125-107,240,47,96,.490,32,51,.627,15,45,.333,16,20,.800,125,36,87,.414,29,59,.492,7,28,.250,28,38,.737,107
311,MIL,2021-05-10,125,@,SAS,L 125-146,240,47,94,.500,34,53,.642,13,41,.317,18,23,.783,125,56,94,.596,39,65,.600,17,29,.586,17,21,.810,146
312,ATL,2021-05-10,125,,WAS,W 125-124,240,46,96,.479,36,66,.545,10,30,.333,23,26,.885,125,51,100,.510,38,74,.514,13,26,.500,9,11,.818,124
313,BRK,2021-05-08,125,@,DEN,W 125-119,240,41,66,.621,25,35,.714,16,31,.516,27,33,.818,125,42,92,.457,28,51,.549,14,41,.341,21,23,.913,119
314,DAL,2021-05-01,125,,WAS,W 125-124,240,47,87,.540,30,49,.612,17,38,.447,14,22,.636,125,47,91,.516,41,72,.569,6,19,.316,24,31,.774,124
315,CHO,2021-04-25,125,,BOS,W 125-104,240,47,93,.505,26,50,.520,21,43,.488,10,11,.909,125,34,88,.386,20,47,.426,14,41,.341,22,26,.846,104
316,MIN,2021-04-21,125,@,SAC,L 125-128,240,46,87,.529,31,53,.585,15,34,.441,18,22,.818,125,43,74,.581,26,41,.634,17,33,.515,25,31,.806,128
317,WAS,2021-04-12,125,@,UTA,W 125-121,240,47,90,.522,38,71,.535,9,19,.474,22,28,.786,125,41,85,.482,26,49,.531,15,36,.417,24,31,.774,121
318,MEM,2021-04-11,125,,IND,L 125-132,240,53,115,.461,47,95,.495,6,20,.300,13,19,.684,125,52,99,.525,39,62,.629,13,37,.351,15,17,.882,132
319,GSW,2021-04-10,125,,HOU,W 125-109,240,49,91,.538,35,56,.625,14,35,.400,13,16,.813,125,41,88,.466,28,51,.549,13,37,.351,14,20,.700,109
320,CLE,2021-04-05,125,@,SAS,W 125-101,240,45,86,.523,33,52,.635,12,34,.353,23,27,.852,125,35,83,.422,30,57,.526,5,26,.192,26,32,.813,101
321,NYK,2021-04-03,125,@,DET,W 125-81,240,43,79,.544,24,40,.600,19,39,.487,20,27,.741,125,29,82,.354,20,54,.370,9,28,.321,14,20,.700,81
322,POR,2021-03-25,125,@,MIA,W 125-122,240,44,92,.478,24,46,.522,20,46,.435,17,19,.895,125,47,84,.560,31,50,.620,16,34,.471,12,13,.923,122
323,LAC,2021-03-20,125,,CHO,W 125-98,240,45,86,.523,33,52,.635,12,34,.353,23,23,1.000,125,31,80,.388,16,39,.410,15,41,.366,21,28,.750,98
324,POR,2021-03-19,125,,DAL,W 125-119,240,44,93,.473,22,46,.478,22,47,.468,15,17,.882,125,44,81,.543,25,39,.641,19,42,.452,12,13,.923,119
325,POR,2021-03-16,125,,NOP,W 125-124,240,38,73,.521,20,30,.667,18,43,.419,31,31,1.000,125,46,88,.523,30,55,.545,16,33,.485,16,20,.800,124
326,MIL,2021-03-13,125,@,WAS,W 125-119,240,43,99,.434,26,54,.481,17,45,.378,22,25,.880,125,43,94,.457,27,53,.509,16,41,.390,17,22,.773,119
327,POR,2021-03-13,125,@,MIN,W 125-121,240,43,89,.483,30,49,.612,13,40,.325,26,30,.867,125,44,86,.512,34,60,.567,10,26,.385,23,31,.742,121
328,SAC,2021-03-11,125,,HOU,W 125-105,240,45,92,.489,34,59,.576,11,33,.333,24,28,.857,125,41,99,.414,30,54,.556,11,45,.244,12,17,.706,105
329,TOR,2021-03-04,125,@,BOS,L 125-132,240,45,91,.495,24,41,.585,21,50,.420,14,17,.824,125,45,74,.608,32,45,.711,13,29,.448,29,40,.725,132
330,MEM,2021-03-02,125,@,WAS,W 125-111,240,47,95,.495,34,66,.515,13,29,.448,18,23,.783,125,41,81,.506,30,50,.600,11,31,.355,18,25,.720,111
331,NOP,2021-02-25,125,@,MIL,L 125-129,240,51,102,.500,38,63,.603,13,39,.333,10,14,.714,125,52,96,.542,39,65,.600,13,31,.419,12,16,.750,129
332,LAC,2021-02-15,125,,MIA,W 125-118,240,47,85,.553,32,53,.604,15,32,.469,16,20,.800,125,46,91,.505,38,55,.691,8,36,.222,18,22,.818,118
333,SAC,2021-02-15,125,,BRK,L 125-136,240,51,96,.531,39,63,.619,12,33,.364,11,13,.846,125,51,89,.573,24,42,.571,27,47,.574,7,12,.583,136
334,IND,2021-02-13,125,@,ATL,W 125-113,240,45,89,.506,33,58,.569,12,31,.387,23,27,.852,125,43,90,.478,34,59,.576,9,31,.290,18,23,.783,113
335,SAS,2021-02-12,125,@,ATL,W 125-114,240,45,85,.529,33,54,.611,12,31,.387,23,28,.821,125,39,90,.433,28,58,.483,11,32,.344,25,33,.758,114
336,LAC,2021-02-12,125,@,CHI,W 125-106,240,50,86,.581,37,56,.661,13,30,.433,12,15,.800,125,40,85,.471,28,53,.528,12,32,.375,14,15,.933,106
337,PHO,2021-02-10,125,,MIL,W 125-124,240,46,87,.529,31,56,.554,15,31,.484,18,25,.720,125,43,85,.506,27,48,.563,16,37,.432,22,30,.733,124
338,MIL,2021-02-08,125,@,DEN,W 125-112,240,45,89,.506,29,49,.592,16,40,.400,19,22,.864,125,41,94,.436,26,58,.448,15,36,.417,15,16,.938,112
339,OKC,2021-01-29,125,,BRK,L 125-147,240,40,86,.465,24,48,.500,16,38,.421,29,34,.853,125,57,100,.570,38,55,.691,19,45,.422,14,16,.875,147
340,OKC,2021-01-25,125,@,POR,W 125-122,240,43,84,.512,25,44,.568,18,40,.450,21,35,.600,125,46,98,.469,32,57,.561,14,41,.341,16,21,.762,122
341,CLE,2021-01-22,125,,BRK,W 125-113,240,45,87,.517,37,62,.597,8,25,.320,27,32,.844,125,42,87,.483,28,44,.636,14,43,.326,15,17,.882,113
342,SAS,2021-01-18,125,@,POR,W 125-104,240,48,90,.533,33,57,.579,15,33,.455,14,16,.875,125,39,90,.433,29,55,.527,10,35,.286,16,19,.842,104
343,BRK,2021-01-18,125,,MIL,W 125-123,240,46,84,.548,31,53,.585,15,31,.484,18,21,.857,125,46,105,.438,35,67,.522,11,38,.289,20,24,.833,123
344,CHI,2021-01-18,125,,HOU,W 125-120,240,43,92,.467,23,47,.489,20,45,.444,19,21,.905,125,46,88,.523,29,48,.604,17,40,.425,11,17,.647,120
345,CHI,2021-01-15,125,@,OKC,L 125-127 (OT),265,43,91,.473,22,45,.489,21,46,.457,18,25,.720,125,48,105,.457,33,60,.550,15,45,.333,16,24,.667,127
346,PHI,2021-01-14,125,,MIA,W 125-108,240,44,82,.537,27,45,.600,17,37,.459,20,24,.833,125,40,81,.494,28,47,.596,12,34,.353,16,26,.615,108
347,POR,2021-01-09,125,@,SAC,W 125-99,240,44,100,.440,27,59,.458,17,41,.415,20,23,.870,125,33,81,.407,25,51,.490,8,30,.267,25,35,.714,99
348,SAS,2021-01-09,125,@,MIN,W 125-122 (OT),265,44,101,.436,31,69,.449,13,32,.406,24,29,.828,125,48,96,.500,33,66,.500,15,30,.500,11,17,.647,122
349,PHO,2021-01-09,125,@,IND,W 125-117,240,46,94,.489,30,53,.566,16,41,.390,17,17,1.000,125,44,92,.478,32,63,.508,12,29,.414,17,24,.708,117
350,MIL,2021-01-04,125,,DET,W 125-115,240,49,85,.576,35,51,.686,14,34,.412,13,16,.813,125,43,98,.439,26,58,.448,17,40,.425,12,12,1.000,115
351,SAC,2020-12-29,125,,DEN,W 125-115,240,46,94,.489,30,61,.492,16,33,.485,17,22,.773,125,44,81,.543,33,53,.623,11,28,.393,16,20,.800,115
352,IND,2020-12-26,125,@,CHI,W 125-106,240,52,93,.559,43,67,.642,9,26,.346,12,19,.632,125,34,91,.374,18,52,.346,16,39,.410,22,25,.880,106
353,BRK,2020-12-22,125,,GSW,W 125-99,240,42,92,.457,27,57,.474,15,35,.429,26,32,.813,125,37,99,.374,27,66,.409,10,33,.303,15,23,.652,99
354,ATL,2021-05-16,124,,HOU,W 124-95,240,49,90,.544,42,69,.609,7,21,.333,19,26,.731,124,31,92,.337,13,29,.448,18,63,.286,15,20,.750,95
355,BOS,2021-05-15,124,@,MIN,W 124-108,240,46,95,.484,28,53,.528,18,42,.429,14,18,.778,124,39,95,.411,34,58,.586,5,37,.135,25,34,.735,108
356,LAL,2021-05-12,124,,HOU,W 124-122,240,52,91,.571,45,71,.634,7,20,.350,13,22,.591,124,43,85,.506,25,43,.581,18,42,.429,18,27,.667,122
357,WAS,2021-05-10,124,@,ATL,L 124-125,240,51,100,.510,38,74,.514,13,26,.500,9,11,.818,124,46,96,.479,36,66,.545,10,30,.333,23,26,.885,125
358,DAL,2021-05-09,124,@,CLE,W 124-97,240,50,93,.538,35,54,.648,15,39,.385,9,11,.818,124,33,86,.384,22,55,.400,11,31,.355,20,31,.645,97
359,BOS,2021-05-09,124,,MIA,L 124-130,240,45,83,.542,31,45,.689,14,38,.368,20,25,.800,124,47,82,.573,31,47,.660,16,35,.457,20,22,.909,130
360,UTA,2021-05-08,124,,HOU,W 124-116,240,45,85,.529,30,47,.638,15,38,.395,19,21,.905,124,43,98,.439,25,47,.532,18,51,.353,12,17,.706,116
361,POR,2021-05-08,124,,SAS,W 124-102,240,45,97,.464,33,63,.524,12,34,.353,22,30,.733,124,37,93,.398,29,63,.460,8,30,.267,20,23,.870,102
362,MIL,2021-05-04,124,,BRK,W 124-118,240,44,98,.449,30,61,.492,14,37,.378,22,27,.815,124,41,84,.488,21,41,.512,20,43,.465,16,26,.615,118
363,MIA,2021-05-01,124,@,CLE,W 124-107,240,47,87,.540,29,51,.569,18,36,.500,12,15,.800,124,37,74,.500,17,34,.500,20,40,.500,13,17,.765,107
364,WAS,2021-05-01,124,@,DAL,L 124-125,240,47,91,.516,41,72,.569,6,19,.316,24,31,.774,124,47,87,.540,30,49,.612,17,38,.447,14,22,.636,125
365,MIL,2021-04-22,124,,PHI,W 124-117,240,45,81,.556,25,41,.610,20,40,.500,14,23,.609,124,46,91,.505,34,64,.531,12,27,.444,13,18,.722,117
366,LAC,2021-04-18,124,,MIN,W 124-105,240,45,89,.506,24,47,.511,21,42,.500,13,17,.765,124,36,88,.409,19,43,.442,17,45,.378,16,21,.762,105
367,HOU,2021-04-14,124,,IND,L 124-132,240,48,104,.462,38,70,.543,10,34,.294,18,22,.818,124,50,94,.532,35,58,.603,15,36,.417,17,22,.773,132
368,MIL,2021-04-11,124,@,ORL,W 124-87,240,46,94,.489,27,54,.500,19,40,.475,13,15,.867,124,32,86,.372,24,50,.480,8,36,.222,15,19,.789,87
369,DET,2021-04-11,124,@,LAC,L 124-131,240,46,87,.529,31,55,.564,15,32,.469,17,19,.895,124,50,80,.625,35,53,.660,15,27,.556,16,21,.762,131
370,MEM,2021-04-06,124,@,MIA,W 124-112,240,46,84,.548,29,43,.674,17,41,.415,15,20,.750,124,44,82,.537,31,49,.633,13,33,.394,11,18,.611,112
371,POR,2021-03-31,124,@,DET,W 124-101,240,42,82,.512,26,52,.500,16,30,.533,24,26,.923,124,40,86,.465,31,59,.525,9,27,.333,12,17,.706,101
372,IND,2021-03-29,124,@,WAS,L 124-132,240,44,93,.473,32,63,.508,12,30,.400,24,33,.727,124,55,99,.556,45,80,.563,10,19,.526,12,18,.667,132
373,ATL,2021-03-26,124,@,GSW,W 124-108,240,46,84,.548,33,51,.647,13,33,.394,19,24,.792,124,39,79,.494,27,51,.529,12,28,.429,18,26,.692,108
374,BRK,2021-03-17,124,@,IND,W 124-115,240,42,87,.483,33,60,.550,9,27,.333,31,40,.775,124,43,84,.512,34,52,.654,9,32,.281,20,25,.800,115
375,NOP,2021-03-16,124,@,POR,L 124-125,240,46,88,.523,30,55,.545,16,33,.485,16,20,.800,124,38,73,.521,20,30,.667,18,43,.419,31,31,1.000,125
376,NOP,2021-03-03,124,,CHI,L 124-128,240,46,83,.554,40,61,.656,6,22,.273,26,38,.684,124,48,94,.511,36,66,.545,12,28,.429,20,22,.909,128
377,ORL,2021-03-01,124,,DAL,L 124-130,240,47,95,.495,27,54,.500,20,41,.488,10,14,.714,124,47,90,.522,30,44,.682,17,46,.370,19,23,.826,130
378,UTA,2021-03-01,124,@,NOP,L 124-129,240,46,101,.455,29,58,.500,17,43,.395,15,18,.833,124,52,92,.565,45,81,.556,7,11,.636,18,23,.783,129
379,BRK,2021-03-01,124,@,SAS,W 124-113 (OT),265,47,100,.470,30,59,.508,17,41,.415,13,17,.765,124,44,97,.454,29,62,.468,15,35,.429,10,15,.667,113
380,UTA,2021-02-27,124,@,ORL,W 124-109,240,45,85,.529,28,40,.700,17,45,.378,17,24,.708,124,44,96,.458,30,62,.484,14,34,.412,7,8,.875,109
381,MIA,2021-02-26,124,,UTA,W 124-116,240,44,86,.512,30,55,.545,14,31,.452,22,25,.880,124,40,94,.426,25,48,.521,15,46,.326,21,23,.913,116
382,CHO,2021-02-24,124,@,PHO,W 124-121,240,43,88,.489,30,52,.577,13,36,.361,25,27,.926,124,44,87,.506,30,49,.612,14,38,.368,19,27,.704,121
383,LAL,2021-02-22,124,,WAS,L 124-127 (OT),265,49,104,.471,34,60,.567,15,44,.341,11,17,.647,124,47,96,.490,38,71,.535,9,25,.360,24,33,.727,127
384,ORL,2021-02-19,124,,GSW,W 124-120,240,46,94,.489,28,51,.549,18,43,.419,14,17,.824,124,46,97,.474,27,55,.491,19,42,.452,9,15,.600,120
385,NOP,2021-02-17,124,,POR,L 124-126,240,43,89,.483,28,57,.491,15,32,.469,23,29,.793,124,46,90,.511,28,49,.571,18,41,.439,16,18,.889,126
386,PHO,2021-02-16,124,,BRK,L 124-128,240,48,88,.545,32,51,.627,16,37,.432,12,12,1.000,124,47,82,.573,27,42,.643,20,40,.500,14,15,.933,128
387,TOR,2021-02-16,124,@,MIL,W 124-113,240,46,91,.505,29,48,.604,17,43,.395,15,21,.714,124,40,83,.482,26,46,.565,14,37,.378,19,25,.760,113
388,MEM,2021-02-14,124,@,SAC,W 124-110,240,50,94,.532,41,73,.562,9,21,.429,15,19,.789,124,41,82,.500,33,49,.673,8,33,.242,20,26,.769,110
389,MIL,2021-02-10,124,@,PHO,L 124-125,240,43,85,.506,27,48,.563,16,37,.432,22,30,.733,124,46,87,.529,31,56,.554,15,31,.484,18,25,.720,125
390,MIL,2021-02-06,124,@,CLE,W 124-99,240,47,86,.547,31,52,.596,16,34,.471,14,23,.609,124,39,86,.453,33,58,.569,6,28,.214,15,21,.714,99
391,PHI,2021-02-06,124,,BRK,W 124-108,240,48,94,.511,38,67,.567,10,27,.370,18,22,.818,124,39,88,.443,24,47,.511,15,41,.366,15,17,.882,108
392,BRK,2021-02-02,124,,LAC,W 124-120,240,45,79,.570,32,48,.667,13,31,.419,21,26,.808,124,45,99,.455,30,63,.476,15,36,.417,15,17,.882,120
393,TOR,2021-01-29,124,,SAC,L 124-126,240,42,86,.488,29,54,.537,13,32,.406,27,33,.818,124,43,78,.551,27,42,.643,16,36,.444,24,31,.774,126
394,NOP,2021-01-27,124,,WAS,W 124-106,240,46,89,.517,29,46,.630,17,43,.395,15,24,.625,124,37,92,.402,24,54,.444,13,38,.342,19,21,.905,106
395,MIA,2021-01-23,124,@,BRK,L 124-128,240,42,89,.472,29,43,.674,13,46,.283,27,32,.844,124,44,83,.530,25,46,.543,19,37,.514,21,26,.808,128
396,DAL,2021-01-20,124,@,IND,W 124-112,240,51,97,.526,43,70,.614,8,27,.296,14,17,.824,124,41,92,.446,25,53,.472,16,39,.410,14,21,.667,112
397,BOS,2021-01-15,124,,ORL,W 124-97,240,45,88,.511,28,46,.609,17,42,.405,17,19,.895,124,38,94,.404,31,66,.470,7,28,.250,14,22,.636,97
398,WAS,2021-01-09,124,,MIA,L 124-128,240,44,99,.444,29,59,.492,15,40,.375,21,28,.750,124,46,93,.495,30,50,.600,16,43,.372,20,26,.769,128
399,DAL,2021-01-07,124,@,DEN,W 124-117 (OT),265,42,87,.483,26,47,.553,16,40,.400,24,31,.774,124,43,97,.443,28,53,.528,15,44,.341,16,21,.762,117
400,CHI,2021-01-06,124,@,SAC,L 124-128,240,49,93,.527,35,53,.660,14,40,.350,12,15,.800,124,47,91,.516,33,54,.611,14,37,.378,20,27,.741,128
401,DEN,2021-01-03,124,@,MIN,W 124-109,240,45,92,.489,26,47,.553,19,45,.422,15,21,.714,124,44,85,.518,34,54,.630,10,31,.323,11,16,.688,109
402,LAC,2020-12-29,124,,MIN,W 124-101,240,47,88,.534,31,57,.544,16,31,.516,14,16,.875,124,37,89,.416,24,51,.471,13,38,.342,14,17,.824,101
403,DEN,2020-12-28,124,,HOU,W 124-111,240,46,87,.529,32,56,.571,14,31,.452,18,32,.563,124,39,86,.453,23,47,.489,16,39,.410,17,23,.739,111
404,DAL,2020-12-27,124,@,LAC,W 124-73,240,43,87,.494,29,46,.630,14,41,.341,24,27,.889,124,26,76,.342,22,43,.512,4,33,.121,17,20,.850,73
405,ATL,2020-12-23,124,@,CHI,W 124-104,240,43,80,.538,29,45,.644,14,35,.400,24,29,.828,124,36,87,.414,28,52,.538,8,35,.229,24,28,.857,104
406,SAC,2020-12-23,124,@,DEN,W 124-122 (OT),265,45,102,.441,35,71,.493,10,31,.323,24,31,.774,124,47,98,.480,39,69,.565,8,29,.276,20,24,.833,122
407,PHO,2021-05-16,123,@,SAS,W 123-121,240,53,104,.510,40,69,.580,13,35,.371,4,4,1.000,123,50,98,.510,43,74,.581,7,24,.292,14,19,.737,121
408,BRK,2021-05-16,123,,CLE,W 123-109,240,47,83,.566,31,53,.585,16,30,.533,13,17,.765,123,38,85,.447,26,46,.565,12,39,.308,21,31,.677,109
409,LAL,2021-05-09,123,,PHO,W 123-110,240,39,80,.488,26,50,.520,13,30,.433,32,41,.780,123,39,73,.534,28,48,.583,11,25,.440,21,25,.840,110
410,GSW,2021-05-03,123,@,NOP,W 123-108,240,47,88,.534,30,44,.682,17,44,.386,12,14,.857,123,39,90,.433,34,65,.523,5,25,.200,25,32,.781,108
411,ATL,2021-05-03,123,,POR,W 123-114,240,44,84,.524,24,43,.558,20,41,.488,15,18,.833,123,43,95,.453,26,54,.481,17,41,.415,11,14,.786,114
412,PHO,2021-05-02,123,@,OKC,W 123-120,240,45,84,.536,33,53,.623,12,31,.387,21,27,.778,123,45,92,.489,32,62,.516,13,30,.433,17,24,.708,120
413,WAS,2021-04-14,123,@,SAC,W 123-111,240,47,90,.522,40,66,.606,7,24,.292,22,27,.815,123,42,91,.462,33,64,.516,9,27,.333,18,24,.750,111
414,DEN,2021-04-14,123,,MIA,W 123-106,240,48,89,.539,31,53,.585,17,36,.472,10,13,.769,123,39,79,.494,26,47,.553,13,32,.406,15,18,.833,106
415,PHI,2021-04-14,123,,BRK,W 123-117,240,45,87,.517,32,59,.542,13,28,.464,20,25,.800,123,43,83,.518,39,62,.629,4,21,.190,27,30,.900,117
416,ATL,2021-04-06,123,,NOP,W 123-107,240,44,88,.500,24,57,.421,20,31,.645,15,22,.682,123,37,91,.407,25,53,.472,12,38,.316,21,28,.750,107
417,MIN,2021-03-18,123,@,PHO,W 123-119,240,44,93,.473,33,59,.559,11,34,.324,24,35,.686,123,45,85,.529,30,49,.612,15,36,.417,14,19,.737,119
418,CHI,2021-03-16,123,,OKC,W 123-102,240,48,94,.511,36,58,.621,12,36,.333,15,18,.833,123,42,90,.467,35,70,.500,7,20,.350,11,13,.846,102
419,POR,2021-03-04,123,,SAC,W 123-119,240,42,88,.477,27,50,.540,15,38,.395,24,25,.960,123,49,103,.476,38,74,.514,11,29,.379,10,16,.625,119
420,UTA,2021-03-03,123,@,PHI,L 123-131 (OT),265,44,100,.440,23,56,.411,21,44,.477,14,19,.737,123,48,93,.516,40,68,.588,8,25,.320,27,35,.771,131
421,SAC,2021-03-03,123,,LAL,W 123-120,240,48,80,.600,36,55,.655,12,25,.480,15,19,.789,123,49,93,.527,37,66,.561,12,27,.444,10,14,.714,120
422,POR,2021-03-01,123,,CHO,W 123-111,240,46,86,.535,22,40,.550,24,46,.522,7,10,.700,123,43,88,.489,28,54,.519,15,34,.441,10,17,.588,111
423,ATL,2021-02-21,123,,DEN,W 123-115,240,42,81,.519,30,47,.638,12,34,.353,27,33,.818,123,43,84,.512,27,48,.563,16,36,.444,13,16,.813,115
424,NYK,2021-02-15,123,,ATL,W 123-112,240,42,83,.506,25,49,.510,17,34,.500,22,27,.815,123,36,85,.424,25,52,.481,11,33,.333,29,32,.906,112
425,PHI,2021-02-15,123,@,UTA,L 123-134,240,47,94,.500,39,71,.549,8,23,.348,21,24,.875,123,45,86,.523,27,41,.659,18,45,.400,26,31,.839,134
426,DET,2021-02-14,123,,NOP,W 123-112,240,45,84,.536,28,49,.571,17,35,.486,16,20,.800,123,40,90,.444,31,55,.564,9,35,.257,23,28,.821,112
427,ORL,2021-02-12,123,@,SAC,W 123-112,240,46,91,.505,31,57,.544,15,34,.441,16,20,.800,123,43,83,.518,31,50,.620,12,33,.364,14,19,.737,112
428,ORL,2021-02-05,123,,CHI,W 123-119,240,42,81,.519,31,54,.574,11,27,.407,28,37,.757,123,46,96,.479,37,66,.561,9,30,.300,18,20,.900,119
429,TOR,2021-02-05,123,@,BRK,W 123-117,240,49,97,.505,36,65,.554,13,32,.406,12,14,.857,123,39,80,.488,22,38,.579,17,42,.405,22,29,.759,117
430,MIL,2021-02-05,123,@,CLE,W 123-105,240,50,97,.515,43,75,.573,7,22,.318,16,22,.727,123,41,92,.446,30,60,.500,11,32,.344,12,16,.750,105
431,NOP,2021-02-03,123,,PHO,W 123-101,240,46,90,.511,32,57,.561,14,33,.424,17,21,.810,123,38,82,.463,30,47,.638,8,35,.229,17,20,.850,101
432,TOR,2021-02-02,123,@,ORL,W 123-108,240,40,83,.482,20,38,.526,20,45,.444,23,25,.920,123,41,89,.461,27,51,.529,14,38,.368,12,14,.857,108
433,POR,2021-01-30,123,@,CHI,W 123-122,240,45,88,.511,28,46,.609,17,42,.405,16,19,.842,123,43,85,.506,22,40,.550,21,45,.467,15,15,1.000,122
434,GSW,2021-01-27,123,,MIN,W 123-111,240,45,85,.529,30,51,.588,15,34,.441,18,23,.783,123,37,87,.425,23,51,.451,14,36,.389,23,33,.697,111
435,CHI,2021-01-22,123,@,CHO,W 123-110,240,49,96,.510,34,53,.642,15,43,.349,10,12,.833,123,42,85,.494,35,53,.660,7,32,.219,19,25,.760,110
436,ATL,2021-01-20,123,,DET,W 123-115 (OT),265,44,100,.440,35,77,.455,9,23,.391,26,38,.684,123,44,97,.454,34,66,.515,10,31,.323,17,19,.895,115
437,MIL,2021-01-18,123,@,BRK,L 123-125,240,46,105,.438,35,67,.522,11,38,.289,20,24,.833,123,46,84,.548,31,53,.585,15,31,.484,18,21,.857,125
438,SAC,2021-01-17,123,,NOP,L 123-128,240,47,91,.516,34,52,.654,13,39,.333,16,18,.889,123,45,85,.529,34,63,.540,11,22,.500,27,34,.794,128
439,SAC,2021-01-08,123,,TOR,L 123-144,240,46,81,.568,31,47,.660,15,34,.441,16,28,.571,123,53,91,.582,33,52,.635,20,39,.513,18,22,.818,144
440,PHO,2021-01-06,123,,TOR,W 123-115,240,40,83,.482,19,43,.442,21,40,.525,22,24,.917,123,39,79,.494,25,44,.568,14,35,.400,23,32,.719,115
441,DEN,2021-01-05,123,,MIN,W 123-116,240,41,79,.519,33,54,.611,8,25,.320,33,45,.733,123,42,91,.462,31,57,.544,11,34,.324,21,27,.778,116
442,WAS,2021-01-03,123,@,BRK,W 123-122,240,43,104,.413,31,71,.437,12,33,.364,25,34,.735,123,40,81,.494,26,49,.531,14,32,.438,28,31,.903,122
443,POR,2021-01-01,123,@,GSW,W 123-98,240,40,92,.435,20,49,.408,20,43,.465,23,30,.767,123,31,79,.392,24,44,.545,7,35,.200,29,33,.879,98
444,BRK,2020-12-25,123,@,BOS,W 123-95,240,41,76,.539,26,47,.553,15,29,.517,26,31,.839,123,37,98,.378,29,71,.408,8,27,.296,13,19,.684,95
445,MIL,2021-05-15,122,,MIA,W 122-108,240,46,86,.535,33,51,.647,13,35,.371,17,24,.708,122,40,96,.417,18,47,.383,22,49,.449,6,8,.750,108
446,LAL,2021-05-15,122,@,IND,W 122-115,240,41,86,.477,30,57,.526,11,29,.379,29,36,.806,122,46,89,.517,37,56,.661,9,33,.273,14,19,.737,115
447,PHI,2021-05-14,122,,ORL,W 122-97,240,44,93,.473,28,59,.475,16,34,.471,18,19,.947,122,33,83,.398,23,53,.434,10,30,.333,21,28,.750,97
448,HOU,2021-05-14,122,,LAC,W 122-115,240,46,86,.535,32,49,.653,14,37,.378,16,22,.727,122,45,93,.484,34,58,.586,11,35,.314,14,15,.933,115
449,NOP,2021-05-14,122,@,GSW,L 122-125,240,46,99,.465,35,72,.486,11,27,.407,19,28,.679,122,42,87,.483,25,48,.521,17,39,.436,24,30,.800,125
450,HOU,2021-05-12,122,@,LAL,L 122-124,240,43,85,.506,25,43,.581,18,42,.429,18,27,.667,122,52,91,.571,45,71,.634,7,20,.350,13,22,.591,124
451,SAC,2021-05-11,122,,OKC,W 122-106,240,44,86,.512,25,47,.532,19,39,.487,15,19,.789,122,39,84,.464,30,61,.492,9,23,.391,19,28,.679,106
452,GSW,2021-05-11,122,,PHO,W 122-116,240,47,95,.495,36,55,.655,11,40,.275,17,20,.850,122,41,79,.519,25,42,.595,16,37,.432,18,20,.900,116
453,CHO,2021-05-07,122,,ORL,W 122-112,240,44,89,.494,35,56,.625,9,33,.273,25,33,.758,122,41,98,.418,32,68,.471,9,30,.300,21,28,.750,112
454,NYK,2021-05-02,122,@,HOU,W 122-97,240,45,86,.523,27,51,.529,18,35,.514,14,16,.875,122,34,79,.430,26,44,.591,8,35,.229,21,32,.656,97
455,WAS,2021-04-30,122,@,CLE,W 122-93,240,46,92,.500,38,74,.514,8,18,.444,22,26,.846,122,34,82,.415,27,49,.551,7,33,.212,18,28,.643,93
456,IND,2021-04-21,122,,OKC,W 122-116,240,46,101,.455,32,61,.525,14,40,.350,16,20,.800,122,48,104,.462,39,75,.520,9,29,.310,11,16,.688,116
457,NYK,2021-04-18,122,,NOP,W 122-112 (OT),265,45,95,.474,34,66,.515,11,29,.379,21,24,.875,122,41,101,.406,35,74,.473,6,27,.222,24,30,.800,112
458,PHO,2021-04-15,122,,SAC,W 122-114,240,48,86,.558,34,48,.708,14,38,.368,12,14,.857,122,43,78,.551,29,48,.604,14,30,.467,14,19,.737,114
459,UTA,2021-04-08,122,,POR,W 122-103,240,43,95,.453,31,53,.585,12,42,.286,24,27,.889,122,38,96,.396,25,48,.521,13,48,.271,14,18,.778,103
460,CHI,2021-04-08,122,@,TOR,W 122-113,240,47,87,.540,35,57,.614,12,30,.400,16,18,.889,122,42,97,.433,31,63,.492,11,34,.324,18,22,.818,113
461,GSW,2021-04-06,122,,MIL,W 122-121,240,46,96,.479,31,56,.554,15,40,.375,15,17,.882,122,44,86,.512,30,54,.556,14,32,.438,19,22,.864,121
462,NOP,2021-04-04,122,@,HOU,W 122-115,240,42,91,.462,26,54,.481,16,37,.432,22,35,.629,122,41,89,.461,25,49,.510,16,40,.400,17,24,.708,115
463,PHI,2021-04-03,122,,MIN,W 122-113,240,41,81,.506,29,53,.547,12,28,.429,28,37,.757,122,35,78,.449,23,42,.548,12,36,.333,31,36,.861,113
464,POR,2021-03-28,122,@,TOR,W 122-117,240,46,97,.474,36,63,.571,10,34,.294,20,24,.833,122,39,87,.448,25,45,.556,14,42,.333,25,33,.758,117
465,LAC,2021-03-27,122,,PHI,W 122-112,240,45,85,.529,34,59,.576,11,26,.423,21,27,.778,122,39,77,.506,29,51,.569,10,26,.385,24,33,.727,112
466,BOS,2021-03-26,122,@,MIL,W 122-114,240,43,88,.489,21,41,.512,22,47,.468,14,16,.875,122,44,99,.444,25,52,.481,19,47,.404,7,11,.636,114
467,MIA,2021-03-25,122,,POR,L 122-125,240,47,84,.560,31,50,.620,16,34,.471,12,13,.923,122,44,92,.478,24,46,.522,20,46,.435,17,19,.895,125
468,CHO,2021-03-24,122,@,HOU,W 122-97,240,41,80,.513,23,42,.548,18,38,.474,22,29,.759,122,33,86,.384,17,37,.459,16,49,.327,15,22,.682,97
469,UTA,2021-03-18,122,@,WAS,L 122-131,240,44,96,.458,26,48,.542,18,48,.375,16,28,.571,122,47,86,.547,40,69,.580,7,17,.412,30,38,.789,131
470,PHO,2021-03-15,122,,MEM,W 122-99,240,47,83,.566,35,53,.660,12,30,.400,16,18,.889,122,38,87,.437,33,64,.516,5,23,.217,18,26,.692,99
471,CHO,2021-03-15,122,,SAC,W 122-116,240,45,94,.479,33,64,.516,12,30,.400,20,25,.800,122,48,86,.558,39,55,.709,9,31,.290,11,17,.647,116
472,WAS,2021-03-15,122,,MIL,L 122-133,240,44,87,.506,28,49,.571,16,38,.421,18,24,.750,122,52,94,.553,41,66,.621,11,28,.393,18,19,.947,133
473,MEM,2021-03-14,122,@,OKC,L 122-128,240,47,92,.511,40,70,.571,7,22,.318,21,29,.724,122,42,73,.575,26,42,.619,16,31,.516,28,34,.824,128
474,IND,2021-03-13,122,@,PHO,W 122-111,240,46,87,.529,33,59,.559,13,28,.464,17,21,.810,122,43,91,.473,31,60,.517,12,31,.387,13,17,.765,111
475,TOR,2021-02-26,122,,HOU,W 122-111,240,40,89,.449,24,48,.500,16,41,.390,26,27,.963,122,39,91,.429,23,44,.523,16,47,.340,17,20,.850,111
476,MEM,2021-02-25,122,,LAC,W 122-94,240,50,92,.543,39,73,.534,11,19,.579,11,16,.688,122,34,84,.405,22,50,.440,12,34,.353,14,16,.875,94
477,CHI,2021-02-20,122,,SAC,W 122-114,240,49,82,.598,38,59,.644,11,23,.478,13,15,.867,122,44,98,.449,36,69,.522,8,29,.276,18,22,.818,114
478,ATL,2021-02-17,122,@,BOS,W 122-114,240,44,77,.571,36,53,.679,8,24,.333,26,31,.839,122,40,86,.465,30,55,.545,10,31,.323,24,27,.889,114
479,MEM,2021-02-17,122,,OKC,W 122-113,240,42,83,.506,30,57,.526,12,26,.462,26,33,.788,122,35,78,.449,16,37,.432,19,41,.463,24,28,.857,113
480,DEN,2021-02-14,122,,LAL,W 122-105,240,39,85,.459,20,38,.526,19,47,.404,25,34,.735,122,40,87,.460,34,59,.576,6,28,.214,19,29,.655,105
481,SAS,2021-02-14,122,@,CHO,W 122-110,240,48,96,.500,38,62,.613,10,34,.294,16,19,.842,122,45,95,.474,33,61,.541,12,34,.353,8,11,.727,110
482,DET,2021-02-09,122,,BRK,W 122-111,240,47,84,.560,34,55,.618,13,29,.448,15,21,.714,122,43,86,.500,32,56,.571,11,30,.367,14,16,.875,111
483,UTA,2021-02-09,122,,BOS,W 122-108,240,40,84,.476,22,36,.611,18,48,.375,24,27,.889,122,38,86,.442,25,57,.439,13,29,.448,19,23,.826,108
484,MIN,2021-02-08,122,@,DAL,L 122-127,240,42,91,.462,24,49,.490,18,42,.429,20,28,.714,122,45,87,.517,33,53,.623,12,34,.353,25,30,.833,127
485,MIA,2021-02-05,122,,WAS,W 122-95,240,43,86,.500,27,50,.540,16,36,.444,20,23,.870,122,33,89,.371,25,56,.446,8,33,.242,21,24,.875,95
486,DAL,2021-02-03,122,@,ATL,W 122-116,240,43,93,.462,30,53,.566,13,40,.325,23,25,.920,122,45,90,.500,31,52,.596,14,38,.368,12,17,.706,116
487,CHI,2021-01-30,122,,POR,L 122-123,240,43,85,.506,22,40,.550,21,45,.467,15,15,1.000,122,45,88,.511,28,46,.609,17,42,.405,16,19,.842,123
488,CLE,2021-01-27,122,,DET,W 122-107,240,47,87,.540,36,66,.545,11,21,.524,17,23,.739,122,37,82,.451,26,55,.473,11,27,.407,22,29,.759,107
489,POR,2021-01-25,122,,OKC,L 122-125,240,46,98,.469,32,57,.561,14,41,.341,16,21,.762,122,43,84,.512,25,44,.568,18,40,.450,21,35,.600,125
490,PHI,2021-01-22,122,,BOS,W 122-110,240,45,81,.556,33,53,.623,12,28,.429,20,24,.833,122,41,90,.456,29,60,.483,12,30,.400,16,20,.800,110
491,DAL,2021-01-22,122,@,SAS,W 122-117,240,45,93,.484,31,54,.574,14,39,.359,18,20,.900,122,41,89,.461,29,61,.475,12,28,.429,23,30,.767,117
492,BRK,2021-01-16,122,,ORL,W 122-115,240,42,78,.538,26,43,.605,16,35,.457,22,25,.880,122,44,95,.463,30,49,.612,14,46,.304,13,16,.813,115
493,BRK,2021-01-12,122,,DEN,W 122-116,240,48,79,.608,32,47,.681,16,32,.500,10,15,.667,122,44,88,.500,26,51,.510,18,37,.486,10,16,.625,116
494,IND,2021-01-11,122,@,SAC,L 122-127,240,47,97,.485,34,58,.586,13,39,.333,15,18,.833,122,47,84,.560,32,52,.615,15,32,.469,18,23,.783,127
495,MIN,2021-01-09,122,,SAS,L 122-125 (OT),265,48,96,.500,33,66,.500,15,30,.500,11,17,.647,122,44,101,.436,31,69,.449,13,32,.406,24,29,.828,125
496,BRK,2021-01-07,122,,PHI,W 122-109,240,44,97,.454,29,60,.483,15,37,.405,19,29,.655,122,41,87,.471,32,61,.525,9,26,.346,18,20,.900,109
497,BRK,2021-01-03,122,,WAS,L 122-123,240,40,81,.494,26,49,.531,14,32,.438,28,31,.903,122,43,104,.413,31,71,.437,12,33,.364,25,34,.735,123
498,BOS,2021-01-03,122,@,DET,W 122-120,240,49,87,.563,34,54,.630,15,33,.455,9,13,.692,122,41,86,.477,25,50,.500,16,36,.444,22,25,.880,120
499,POR,2021-01-03,122,@,GSW,L 122-137,240,41,98,.418,27,55,.491,14,43,.326,26,33,.788,122,49,88,.557,36,54,.667,13,34,.382,26,34,.765,137
500,HOU,2020-12-31,122,,SAC,W 122-119,240,45,86,.523,32,50,.640,13,36,.361,19,25,.760,122,45,96,.469,34,63,.540,11,33,.333,18,24,.750,119
501,ATL,2020-12-26,122,@,MEM,W 122-112,240,38,89,.427,25,53,.472,13,36,.361,33,38,.868,122,37,93,.398,24,50,.480,13,43,.302,25,29,.862,112
502,DEN,2020-12-23,122,,SAC,L 122-124 (OT),265,47,98,.480,39,69,.565,8,29,.276,20,24,.833,122,45,102,.441,35,71,.493,10,31,.323,24,31,.774,124
503,BOS,2020-12-23,122,,MIL,W 122-121,240,48,101,.475,30,61,.492,18,40,.450,8,11,.727,122,46,90,.511,32,55,.582,14,35,.400,15,18,.833,121
504,DAL,2021-05-16,121,@,MIN,L 121-136,240,44,91,.484,28,53,.528,16,38,.421,17,20,.850,121,49,90,.544,32,50,.640,17,40,.425,21,25,.840,136
505,SAS,2021-05-16,121,,PHO,L 121-123,240,50,98,.510,43,74,.581,7,24,.292,14,19,.737,121,53,104,.510,40,69,.580,13,35,.371,4,4,1.000,123
506,UTA,2021-05-16,121,@,SAC,W 121-99,240,41,86,.477,23,47,.489,18,39,.462,21,25,.840,121,42,90,.467,33,60,.550,9,30,.300,6,10,.600,99
507,BOS,2021-05-11,121,,MIA,L 121-129,240,46,88,.523,28,51,.549,18,37,.486,11,17,.647,121,48,81,.593,32,51,.627,16,30,.533,17,22,.773,129
508,CHI,2021-05-07,121,,BOS,W 121-99,240,43,99,.434,25,59,.424,18,40,.450,17,18,.944,121,35,86,.407,24,47,.511,11,39,.282,18,23,.783,99
509,MIA,2021-05-07,121,,MIN,W 121-112,240,44,87,.506,31,55,.564,13,32,.406,20,27,.741,121,41,85,.482,31,48,.646,10,37,.270,20,30,.667,112
510,TOR,2021-05-02,121,@,LAL,W 121-114,240,42,94,.447,27,56,.482,15,38,.395,22,31,.710,121,41,85,.482,30,56,.536,11,29,.379,21,31,.677,114
511,MIA,2021-05-02,121,@,CHO,W 121-111,240,45,88,.511,34,50,.680,11,38,.289,20,27,.741,121,40,81,.494,26,48,.542,14,33,.424,17,22,.773,111
512,PHO,2021-04-30,121,,UTA,W 121-100,240,48,88,.545,37,55,.673,11,33,.333,14,19,.737,121,35,80,.438,21,41,.512,14,39,.359,16,18,.889,100
513,DEN,2021-04-29,121,,TOR,W 121-111,240,44,93,.473,32,58,.552,12,35,.343,21,26,.808,121,40,83,.482,24,51,.471,16,32,.500,15,18,.833,111
514,PHI,2021-04-26,121,,OKC,W 121-90,240,47,86,.547,33,55,.600,14,31,.452,13,18,.722,121,35,78,.449,28,48,.583,7,30,.233,13,23,.565,90
515,CLE,2021-04-21,121,,CHI,W 121-105,240,45,88,.511,29,52,.558,16,36,.444,15,19,.789,121,39,79,.494,26,42,.619,13,37,.351,14,18,.778,105
516,SAC,2021-04-18,121,@,DAL,W 121-107,240,44,89,.494,33,65,.508,11,24,.458,22,25,.880,121,39,87,.448,23,39,.590,16,48,.333,13,20,.650,107
517,WAS,2021-04-17,121,,DET,W 121-100,240,50,94,.532,41,78,.526,9,16,.563,12,19,.632,121,37,84,.440,28,57,.491,9,27,.333,17,23,.739,100
518,BOS,2021-04-15,121,@,LAL,W 121-113,240,48,85,.565,34,53,.642,14,32,.438,11,13,.846,121,44,98,.449,32,61,.525,12,37,.324,13,19,.684,113
519,UTA,2021-04-12,121,,WAS,L 121-125,240,41,85,.482,26,49,.531,15,36,.417,24,31,.774,121,47,90,.522,38,71,.535,9,19,.474,22,28,.786,125
520,MIN,2021-04-11,121,,CHI,W 121-117,240,40,81,.494,24,45,.533,16,36,.444,25,25,1.000,121,47,92,.511,32,54,.593,15,38,.395,8,13,.615,117
521,DEN,2021-04-09,121,,SAS,W 121-119,240,43,79,.544,29,52,.558,14,27,.519,21,23,.913,121,43,93,.462,34,66,.515,9,27,.333,24,28,.857,119
522,MIL,2021-04-06,121,@,GSW,L 121-122,240,44,86,.512,30,54,.556,14,32,.438,19,22,.864,121,46,96,.479,31,56,.554,15,40,.375,15,17,.882,122
523,PHO,2021-03-31,121,,CHI,W 121-116,240,46,81,.568,35,56,.625,11,25,.440,18,24,.750,121,43,99,.434,32,66,.485,11,33,.333,19,21,.905,116
524,MIL,2021-03-24,121,,BOS,W 121-119,240,45,90,.500,28,53,.528,17,37,.459,14,20,.700,121,45,94,.479,26,47,.553,19,47,.404,10,10,1.000,119
525,ORL,2021-03-19,121,,BRK,W 121-113,240,43,84,.512,22,44,.500,21,40,.525,14,20,.700,121,43,91,.473,33,54,.611,10,37,.270,17,23,.739,113
526,SAC,2021-03-17,121,@,WAS,W 121-119,240,41,93,.441,31,60,.517,10,33,.303,29,35,.829,121,46,94,.489,42,69,.609,4,25,.160,23,28,.821,119
527,MIN,2021-03-16,121,@,LAL,L 121-137,240,47,90,.522,36,55,.655,11,35,.314,16,22,.727,121,50,87,.575,37,61,.607,13,26,.500,24,28,.857,137
528,DEN,2021-03-15,121,,IND,W 121-106,240,45,97,.464,30,69,.435,15,28,.536,16,19,.842,121,39,90,.433,22,48,.458,17,42,.405,11,13,.846,106
529,ATL,2021-03-13,121,,SAC,W 121-106,240,43,84,.512,31,51,.608,12,33,.364,23,33,.697,121,43,98,.439,36,62,.581,7,36,.194,13,16,.813,106
530,MIN,2021-03-13,121,,POR,L 121-125,240,44,86,.512,34,60,.567,10,26,.385,23,31,.742,121,43,89,.483,30,49,.612,13,40,.325,26,30,.867,125
531,ATL,2021-03-11,121,@,TOR,W 121-120,240,39,90,.433,24,48,.500,15,42,.357,28,35,.800,121,42,96,.438,25,59,.424,17,37,.459,19,23,.826,120
532,POR,2021-03-11,121,,PHO,L 121-127,240,43,94,.457,25,51,.490,18,43,.419,17,19,.895,121,49,83,.590,36,59,.610,13,24,.542,16,19,.842,127
533,BRK,2021-03-11,121,,BOS,W 121-109,240,42,88,.477,23,46,.500,19,42,.452,18,22,.818,121,41,91,.451,28,51,.549,13,40,.325,14,22,.636,109
534,CHO,2021-02-26,121,@,GSW,L 121-130,240,41,89,.461,24,48,.500,17,41,.415,22,32,.688,121,48,79,.608,37,55,.673,11,24,.458,23,25,.920,130
535,SAC,2021-02-25,121,@,NYK,L 121-140,240,42,85,.494,30,50,.600,12,35,.343,25,33,.758,121,51,87,.586,32,51,.627,19,36,.528,19,21,.905,140
536,PHO,2021-02-24,121,,CHO,L 121-124,240,44,87,.506,30,49,.612,14,38,.368,19,27,.704,121,43,88,.489,30,52,.577,13,36,.361,25,27,.926,124
537,BOS,2021-02-19,121,,ATL,W 121-109,240,50,90,.556,36,55,.655,14,35,.400,7,10,.700,121,38,90,.422,28,60,.467,10,30,.333,23,25,.920,109
538,POR,2021-02-14,121,@,DAL,W 121-118,240,45,85,.529,27,45,.600,18,40,.450,13,19,.684,121,40,81,.494,26,40,.650,14,41,.341,24,25,.960,118
539,NYK,2021-02-13,121,,HOU,W 121-99,240,45,86,.523,33,58,.569,12,28,.429,19,23,.826,121,33,88,.375,25,45,.556,8,43,.186,25,30,.833,99
540,TOR,2021-02-06,121,@,ATL,L 121-132,240,41,97,.423,28,59,.475,13,38,.342,26,34,.765,121,42,74,.568,23,38,.605,19,36,.528,29,33,.879,132
541,CHO,2021-02-05,121,,UTA,L 121-138,240,48,104,.462,37,69,.536,11,35,.314,14,17,.824,121,48,87,.552,22,37,.595,26,50,.520,16,18,.889,138
542,POR,2021-02-04,121,@,PHI,W 121-105,240,45,98,.459,32,67,.478,13,31,.419,18,23,.783,121,39,81,.481,32,54,.593,7,27,.259,20,24,.833,105
543,LAC,2021-02-03,121,@,CLE,W 121-99,240,44,79,.557,24,45,.533,20,34,.588,13,17,.765,121,41,92,.446,37,82,.451,4,10,.400,13,17,.765,99
544,WAS,2021-02-02,121,,POR,L 121-132,240,46,83,.554,30,43,.698,16,40,.400,13,17,.765,121,44,95,.463,23,49,.469,21,46,.457,23,23,1.000,132
545,MIA,2021-02-01,121,,CHO,L 121-129 (OT),265,43,91,.473,24,45,.533,19,46,.413,16,25,.640,121,43,95,.453,22,54,.407,21,41,.512,22,26,.846,129
546,SAC,2021-01-27,121,@,ORL,W 121-107,240,45,92,.489,31,59,.525,14,33,.424,17,26,.654,121,40,96,.417,30,70,.429,10,26,.385,17,18,.944,107
547,SAS,2021-01-24,121,,WAS,W 121-101,240,48,96,.500,33,65,.508,15,31,.484,10,11,.909,121,39,92,.424,25,50,.500,14,42,.333,9,14,.643,101
548,GSW,2021-01-20,121,,SAS,W 121-99,240,46,91,.505,31,53,.585,15,38,.395,14,20,.700,121,35,94,.372,31,61,.508,4,33,.121,25,31,.806,99
549,MIL,2021-01-11,121,@,ORL,W 121-99,240,46,91,.505,33,56,.589,13,35,.371,16,20,.800,121,39,91,.429,28,60,.467,11,31,.355,10,13,.769,99
550,LAL,2020-12-30,121,@,SAS,W 121-107,240,46,82,.561,32,56,.571,14,26,.538,15,20,.750,121,40,87,.460,30,63,.476,10,24,.417,17,23,.739,107
551,LAC,2020-12-25,121,@,DEN,W 121-108,240,41,74,.554,22,36,.611,19,38,.500,20,24,.833,121,37,81,.457,26,45,.578,11,36,.306,23,31,.742,108
552,MIL,2020-12-23,121,@,BOS,L 121-122,240,46,90,.511,32,55,.582,14,35,.400,15,18,.833,121,48,101,.475,30,61,.492,18,40,.450,8,11,.727,122
553,IND,2020-12-23,121,,NYK,W 121-107,240,46,94,.489,38,60,.633,8,34,.235,21,29,.724,121,39,85,.459,27,57,.474,12,28,.429,17,23,.739,107
554,CLE,2020-12-23,121,,CHO,W 121-114,240,46,87,.529,32,57,.561,14,30,.467,15,20,.750,121,45,90,.500,29,46,.630,16,44,.364,8,15,.533,114
555,MIA,2021-05-16,120,@,DET,W 120-107,240,47,84,.560,34,50,.680,13,34,.382,13,20,.650,120,40,86,.465,29,51,.569,11,35,.314,16,22,.727,107
556,WAS,2021-05-14,120,,CLE,W 120-105,240,41,89,.461,34,64,.531,7,25,.280,31,37,.838,120,39,84,.464,29,48,.604,10,36,.278,17,21,.810,105
557,ATL,2021-05-12,120,,WAS,W 120-116,240,44,86,.512,34,53,.642,10,33,.303,22,28,.786,120,45,101,.446,35,72,.486,10,29,.345,16,19,.842,116
558,DEN,2021-05-07,120,@,UTA,L 120-127,240,43,83,.518,26,45,.578,17,38,.447,17,20,.850,120,43,89,.483,22,43,.512,21,46,.457,20,23,.870,127
559,CHI,2021-05-06,120,@,CHO,W 120-99,240,46,91,.505,28,54,.519,18,37,.486,10,17,.588,120,38,90,.422,22,55,.400,16,35,.457,7,18,.389,99
560,OKC,2021-05-02,120,,PHO,L 120-123,240,45,92,.489,32,62,.516,13,30,.433,17,24,.708,120,45,84,.536,33,53,.623,12,31,.387,21,27,.778,123
561,BOS,2021-04-28,120,,CHO,W 120-111,240,44,92,.478,29,52,.558,15,40,.375,17,22,.773,120,37,87,.425,24,52,.462,13,35,.371,24,32,.750,111
562,DEN,2021-04-26,120,,MEM,W 120-96,240,45,94,.479,34,61,.557,11,33,.333,19,22,.864,120,34,81,.420,30,49,.612,4,32,.125,24,31,.774,96
563,NOP,2021-04-26,120,,LAC,W 120-103,240,44,82,.537,29,53,.547,15,29,.517,17,26,.654,120,36,90,.400,22,45,.489,14,45,.311,17,17,1.000,103
564,MEM,2021-04-25,120,@,POR,W 120-113,240,42,91,.462,30,68,.441,12,23,.522,24,28,.857,120,39,105,.371,25,67,.373,14,38,.368,21,25,.840,113
565,NYK,2021-04-24,120,,TOR,W 120-103,240,42,75,.560,26,44,.591,16,31,.516,20,24,.833,120,36,83,.434,19,39,.487,17,44,.386,14,19,.737,103
566,SAC,2021-04-20,120,,MIN,L 120-134,240,44,97,.454,26,55,.473,18,42,.429,14,16,.875,120,51,90,.567,33,47,.702,18,43,.419,14,19,.737,134
567,MIL,2021-04-15,120,@,ATL,W 120-109,240,46,95,.484,30,52,.577,16,43,.372,12,17,.706,120,39,86,.453,25,52,.481,14,34,.412,17,19,.895,109
568,HOU,2021-04-12,120,@,PHO,L 120-126,240,44,87,.506,27,45,.600,17,42,.405,15,19,.789,120,45,94,.479,20,49,.408,25,45,.556,11,18,.611,126
569,SAS,2021-04-12,120,@,ORL,W 120-97,240,48,93,.516,38,68,.559,10,25,.400,14,18,.778,120,36,80,.450,31,60,.517,5,20,.250,20,32,.625,97
570,ATL,2021-04-09,120,,CHI,W 120-108,240,47,84,.560,40,57,.702,7,27,.259,19,23,.826,120,41,86,.477,28,53,.528,13,33,.394,13,14,.929,108
571,MEM,2021-04-02,120,,MIN,W 120-108,240,42,95,.442,23,56,.411,19,39,.487,17,25,.680,120,38,85,.447,26,52,.500,12,33,.364,20,23,.870,108
572,DET,2021-04-01,120,,WAS,W 120-91,240,45,94,.479,33,65,.508,12,29,.414,18,22,.818,120,40,85,.471,35,66,.530,5,19,.263,6,19,.316,91
573,SAS,2021-03-31,120,,SAC,W 120-106,240,43,92,.467,33,66,.500,10,26,.385,24,34,.706,120,39,92,.424,28,57,.491,11,35,.314,17,19,.895,106
574,BRK,2021-03-31,120,,HOU,W 120-108,240,44,90,.489,31,54,.574,13,36,.361,19,19,1.000,120,39,78,.500,26,38,.684,13,40,.325,17,24,.708,108
575,MEM,2021-03-29,120,@,HOU,W 120-110,240,46,85,.541,35,54,.648,11,31,.355,17,24,.708,120,40,94,.426,29,52,.558,11,42,.262,19,22,.864,110
576,SAS,2021-03-27,120,,CHI,W 120-104,240,46,85,.541,36,60,.600,10,25,.400,18,28,.643,120,41,95,.432,33,61,.541,8,34,.235,14,18,.778,104
577,UTA,2021-03-22,120,@,CHI,W 120-95,240,45,92,.489,28,53,.528,17,39,.436,13,15,.867,120,39,96,.406,33,70,.471,6,26,.231,11,12,.917,95
578,MIL,2021-03-20,120,,SAS,W 120-113,240,45,92,.489,31,54,.574,14,38,.368,16,18,.889,120,46,96,.479,34,63,.540,12,33,.364,9,10,.900,113
579,TOR,2021-03-11,120,,ATL,L 120-121,240,42,96,.438,25,59,.424,17,37,.459,19,23,.826,120,39,90,.433,24,48,.500,15,42,.357,28,35,.800,121
580,PHO,2021-03-04,120,,GSW,W 120-98,240,49,96,.510,37,66,.561,12,30,.400,10,13,.769,120,38,88,.432,26,53,.491,12,35,.343,10,16,.625,98
581,LAL,2021-03-03,120,@,SAC,L 120-123,240,49,93,.527,37,66,.561,12,27,.444,10,14,.714,120,48,80,.600,36,55,.655,12,25,.480,15,19,.789,123
582,CHI,2021-02-22,120,@,HOU,W 120-100,240,49,91,.538,34,55,.618,15,36,.417,7,10,.700,120,37,96,.385,24,56,.429,13,40,.325,13,19,.684,100
583,NOP,2021-02-21,120,,BOS,W 120-115 (OT),265,42,94,.447,31,58,.534,11,36,.306,25,37,.676,120,39,98,.398,29,61,.475,10,37,.270,27,34,.794,115
584,DEN,2021-02-19,120,@,CLE,W 120-103,240,46,80,.575,31,49,.633,15,31,.484,13,17,.765,120,39,83,.470,27,52,.519,12,31,.387,13,21,.619,103
585,GSW,2021-02-19,120,@,ORL,L 120-124,240,46,97,.474,27,55,.491,19,42,.452,9,15,.600,120,46,94,.489,28,51,.549,18,43,.419,14,17,.824,124
586,GSW,2021-02-17,120,,MIA,W 120-112 (OT),265,43,95,.453,25,43,.581,18,52,.346,16,21,.762,120,44,97,.454,31,61,.508,13,36,.361,11,12,.917,112
587,CHI,2021-02-15,120,@,IND,W 120-112 (OT),265,44,102,.431,31,69,.449,13,33,.394,19,22,.864,120,39,92,.424,30,59,.508,9,33,.273,25,31,.806,112
588,PHO,2021-02-13,120,,PHI,W 120-111,240,48,79,.608,38,54,.704,10,25,.400,14,17,.824,120,38,73,.521,31,56,.554,7,17,.412,28,33,.848,111
589,CHO,2021-02-12,120,,MIN,W 120-114,240,44,90,.489,31,54,.574,13,36,.361,19,19,1.000,120,45,99,.455,29,58,.500,16,41,.390,8,14,.571,114
590,BOS,2021-02-11,120,,TOR,W 120-106,240,39,86,.453,19,47,.404,20,39,.513,22,28,.786,120,41,83,.494,32,55,.582,9,28,.321,15,19,.789,106
591,OKC,2021-02-06,120,,MIN,W 120-118,240,46,90,.511,34,57,.596,12,33,.364,16,20,.800,120,47,93,.505,35,57,.614,12,36,.333,12,22,.545,118
592,LAC,2021-02-02,120,@,BRK,L 120-124,240,45,99,.455,30,63,.476,15,36,.417,15,17,.882,120,45,79,.570,32,48,.667,13,31,.419,21,26,.808,124
593,UTA,2021-01-29,120,,DAL,W 120-101,240,38,87,.437,18,39,.462,20,48,.417,24,26,.923,120,37,86,.430,28,53,.528,9,33,.273,18,27,.667,101
594,MIN,2021-01-23,120,,NOP,W 120-110,240,39,91,.429,27,57,.474,12,34,.353,30,37,.811,120,40,87,.460,30,54,.556,10,33,.303,20,28,.714,110
595,DEN,2021-01-23,120,@,PHO,W 120-112 (2OT),290,40,97,.412,25,61,.410,15,36,.417,25,32,.781,120,41,102,.402,25,49,.510,16,53,.302,14,18,.778,112
596,IND,2021-01-22,120,,ORL,W 120-118 (OT),265,46,93,.495,34,59,.576,12,34,.353,16,18,.889,120,43,94,.457,26,57,.456,17,37,.459,15,24,.625,118
597,LAC,2021-01-22,120,,OKC,W 120-106,240,43,84,.512,33,51,.647,10,33,.303,24,25,.960,120,41,87,.471,27,45,.600,14,42,.333,10,13,.769,106
598,HOU,2021-01-18,120,@,CHI,L 120-125,240,46,88,.523,29,48,.604,17,40,.425,11,17,.647,120,43,92,.467,23,47,.489,20,45,.444,19,21,.905,125
599,DET,2021-01-16,120,@,MIA,W 120-100,240,46,91,.505,28,45,.622,18,46,.391,10,15,.667,120,32,67,.478,20,38,.526,12,29,.414,24,27,.889,100
600,LAL,2021-01-10,120,@,HOU,W 120-102,240,46,91,.505,36,62,.581,10,29,.345,18,24,.750,120,37,90,.411,25,49,.510,12,41,.293,16,23,.696,102
601,DET,2021-01-03,120,,BOS,L 120-122,240,41,86,.477,25,50,.500,16,36,.444,22,25,.880,120,49,87,.563,34,54,.630,15,33,.455,9,13,.692,122
602,NOP,2021-01-02,120,,TOR,W 120-116,240,35,83,.422,21,45,.467,14,38,.368,36,47,.766,120,38,91,.418,24,43,.558,14,48,.292,26,27,.963,116
603,DET,2020-12-28,120,@,ATL,L 120-128,240,43,98,.439,30,57,.526,13,41,.317,21,24,.875,120,40,82,.488,20,40,.500,20,42,.476,28,32,.875,128
604,ORL,2020-12-27,120,@,WAS,W 120-113,240,37,85,.435,28,60,.467,9,25,.360,37,38,.974,120,47,97,.485,39,65,.600,8,32,.250,11,13,.846,113
605,WAS,2020-12-26,120,,ORL,L 120-130,240,46,95,.484,33,58,.569,13,37,.351,15,28,.536,120,48,95,.505,37,64,.578,11,31,.355,23,29,.793,130
606,UTA,2020-12-23,120,@,POR,W 120-100,240,43,94,.457,24,44,.545,19,50,.380,15,19,.789,120,37,92,.402,25,59,.424,12,33,.364,14,17,.824,100
607,MIN,2021-05-11,119,@,DET,W 119-100,240,45,98,.459,31,50,.620,14,48,.292,15,21,.714,119,35,75,.467,25,52,.481,10,23,.435,20,26,.769,100
608,GSW,2021-05-10,119,,UTA,W 119-116,240,41,88,.466,27,46,.587,14,42,.333,23,25,.920,119,41,91,.451,28,47,.596,13,44,.295,21,24,.875,116
609,DEN,2021-05-08,119,,BRK,L 119-125,240,42,92,.457,28,51,.549,14,41,.341,21,23,.913,119,41,66,.621,25,35,.714,16,31,.516,27,33,.818,125
610,ORL,2021-05-03,119,@,DET,W 119-112,240,45,88,.511,35,65,.538,10,23,.435,19,25,.760,119,44,93,.473,33,58,.569,11,35,.314,13,18,.722,112
611,BOS,2021-05-02,119,,POR,L 119-129,240,43,89,.483,23,50,.460,20,39,.513,13,15,.867,119,44,85,.518,25,47,.532,19,38,.500,22,26,.846,129
612,OKC,2021-04-27,119,@,BOS,W 119-115,240,39,81,.481,26,51,.510,13,30,.433,28,36,.778,119,41,97,.423,30,48,.625,11,49,.224,22,25,.880,115
613,WAS,2021-04-25,119,,CLE,W 119-110,240,43,89,.483,31,58,.534,12,31,.387,21,26,.808,119,40,78,.513,30,51,.588,10,27,.370,20,25,.800,110
614,PHO,2021-04-25,119,@,BRK,L 119-128,240,43,90,.478,31,56,.554,12,34,.353,21,25,.840,119,46,87,.529,33,59,.559,13,28,.464,23,27,.852,128
615,WAS,2021-04-19,119,,OKC,W 119-107,240,46,91,.505,36,60,.600,10,31,.323,17,29,.586,119,36,83,.434,23,50,.460,13,33,.394,22,27,.815,107
616,BOS,2021-04-17,119,,GSW,W 119-114,240,44,94,.468,29,48,.604,15,46,.326,16,20,.800,119,41,80,.513,24,40,.600,17,40,.425,15,20,.750,114
617,MIN,2021-04-16,119,,MIA,W 119-111,240,42,81,.519,27,45,.600,15,36,.417,20,29,.690,119,39,80,.488,25,46,.543,14,34,.412,19,26,.731,111
618,UTA,2021-04-16,119,,IND,W 119-111,240,42,87,.483,26,45,.578,16,42,.381,19,24,.792,119,41,105,.390,28,66,.424,13,39,.333,16,17,.941,111
619,GSW,2021-04-15,119,@,CLE,W 119-101,240,47,92,.511,30,46,.652,17,46,.370,8,10,.800,119,35,81,.432,25,50,.500,10,31,.323,21,27,.778,101
620,SAS,2021-04-11,119,@,DAL,W 119-117,240,45,83,.542,37,62,.597,8,21,.381,21,27,.778,119,45,94,.479,32,52,.615,13,42,.310,14,15,.933,117
621,SAS,2021-04-09,119,@,DEN,L 119-121,240,43,93,.462,34,66,.515,9,27,.333,24,28,.857,119,43,79,.544,29,52,.558,14,27,.519,21,23,.913,121
622,MIL,2021-04-09,119,,CHO,L 119-127,240,44,98,.449,30,60,.500,14,38,.368,17,23,.739,119,44,91,.484,25,41,.610,19,50,.380,20,22,.909,127
623,DET,2021-04-06,119,@,DEN,L 119-134,240,44,81,.543,29,46,.630,15,35,.429,16,20,.800,119,56,94,.596,42,63,.667,14,31,.452,8,9,.889,134
624,DEN,2021-04-04,119,,ORL,W 119-109,240,43,88,.489,34,59,.576,9,29,.310,24,31,.774,119,42,89,.472,29,54,.537,13,35,.371,12,17,.706,109
625,GSW,2021-03-25,119,@,SAC,L 119-141,240,45,88,.511,28,56,.500,17,32,.531,12,12,1.000,119,53,89,.596,34,51,.667,19,38,.500,16,19,.842,141
626,BOS,2021-03-24,119,@,MIL,L 119-121,240,45,94,.479,26,47,.553,19,47,.404,10,10,1.000,119,45,90,.500,28,53,.528,17,37,.459,14,20,.700,121
627,SAC,2021-03-22,119,@,CLE,W 119-105,240,49,90,.544,36,60,.600,13,30,.433,8,12,.667,119,41,96,.427,37,79,.468,4,17,.235,19,23,.826,105
628,LAC,2021-03-22,119,,ATL,W 119-110,240,42,85,.494,25,47,.532,17,38,.447,18,20,.900,119,43,95,.453,31,61,.508,12,34,.353,12,16,.750,110
629,DAL,2021-03-19,119,@,POR,L 119-125,240,44,81,.543,25,39,.641,19,42,.452,12,13,.923,119,44,93,.473,22,46,.478,22,47,.468,15,17,.882,125
630,PHO,2021-03-18,119,,MIN,L 119-123,240,45,85,.529,30,49,.612,15,36,.417,14,19,.737,119,44,93,.473,33,59,.559,11,34,.324,24,35,.686,123
631,WAS,2021-03-17,119,,SAC,L 119-121,240,46,94,.489,42,69,.609,4,25,.160,23,28,.821,119,41,93,.441,31,60,.517,10,33,.303,29,35,.829,121
632,ATL,2021-03-16,119,@,HOU,W 119-107,240,44,86,.512,27,49,.551,17,37,.459,14,16,.875,119,42,88,.477,29,54,.537,13,34,.382,10,13,.769,107
633,UTA,2021-03-14,119,@,GSW,L 119-131,240,41,93,.441,26,49,.531,15,44,.341,22,29,.759,119,50,89,.562,34,58,.586,16,31,.516,15,18,.833,131
634,NYK,2021-03-13,119,@,OKC,W 119-97,240,44,90,.489,30,55,.545,14,35,.400,17,22,.773,119,37,76,.487,29,44,.659,8,32,.250,15,21,.714,97
635,WAS,2021-03-13,119,,MIL,L 119-125,240,43,94,.457,27,53,.509,16,41,.390,17,22,.773,119,43,99,.434,26,54,.481,17,45,.378,22,25,.880,125
636,WAS,2021-03-04,119,,LAC,W 119-117,240,40,88,.455,31,65,.477,9,23,.391,30,42,.714,119,38,82,.463,22,47,.468,16,35,.457,25,27,.926,117
637,SAC,2021-03-04,119,@,POR,L 119-123,240,49,103,.476,38,74,.514,11,29,.379,10,16,.625,119,42,88,.477,27,50,.540,15,38,.395,24,25,.960,123
638,SAS,2021-03-02,119,,NYK,W 119-93,240,43,89,.483,25,47,.532,18,42,.429,15,21,.714,119,33,81,.407,18,45,.400,15,36,.417,12,15,.800,93
639,LAC,2021-02-26,119,@,MEM,W 119-99,240,44,80,.550,30,45,.667,14,35,.400,17,18,.944,119,39,97,.402,30,69,.435,9,28,.321,12,16,.750,99
640,HOU,2021-02-15,119,@,WAS,L 119-131,240,43,91,.473,35,54,.648,8,37,.216,25,34,.735,119,48,92,.522,36,62,.581,12,30,.400,23,31,.742,131
641,LAC,2021-02-10,119,@,MIN,W 119-112,240,41,82,.500,29,59,.492,12,23,.522,25,29,.862,119,41,95,.432,26,54,.481,15,41,.366,15,19,.789,112
642,PHI,2021-02-09,119,@,SAC,W 119-111,240,41,85,.482,32,65,.492,9,20,.450,28,35,.800,119,43,99,.434,29,57,.509,14,42,.333,11,19,.579,111
643,PHO,2021-02-08,119,,CLE,W 119-113,240,47,90,.522,36,66,.545,11,24,.458,14,19,.737,119,44,86,.512,36,62,.581,8,24,.333,17,25,.680,113
644,CHO,2021-02-08,119,,HOU,W 119-94,240,44,90,.489,25,49,.510,19,41,.463,12,13,.923,119,35,86,.407,22,39,.564,13,47,.277,11,16,.688,94
645,LAL,2021-02-08,119,,OKC,W 119-112 (OT),265,44,95,.463,35,57,.614,9,38,.237,22,29,.759,119,43,110,.391,31,72,.431,12,38,.316,14,19,.737,112
646,CHO,2021-02-07,119,,WAS,W 119-97,240,42,99,.424,27,63,.429,15,36,.417,20,26,.769,119,34,90,.378,25,50,.500,9,40,.225,20,28,.714,97
647,SAC,2021-02-06,119,,DEN,W 119-114,240,44,91,.484,30,56,.536,14,35,.400,17,24,.708,119,45,97,.464,32,62,.516,13,35,.371,11,14,.786,114
648,BOS,2021-02-05,119,@,LAC,W 119-115,240,43,90,.478,27,52,.519,16,38,.421,17,21,.810,119,42,81,.519,28,49,.571,14,32,.438,17,21,.810,115
649,CHI,2021-02-05,119,@,ORL,L 119-123,240,46,96,.479,37,66,.561,9,30,.300,18,20,.900,119,42,81,.519,31,54,.574,11,27,.407,28,37,.757,123
650,PHI,2021-01-31,119,@,IND,W 119-110,240,45,92,.489,37,66,.561,8,26,.308,21,31,.677,119,41,84,.488,31,56,.554,10,28,.357,18,22,.818,110
651,SAS,2021-01-29,119,,DEN,W 119-109,240,44,81,.543,34,58,.586,10,23,.435,21,26,.808,119,41,78,.526,27,47,.574,14,31,.452,13,20,.650,109
652,BOS,2021-01-25,119,@,CHI,W 119-103,240,44,87,.506,29,58,.500,15,29,.517,16,20,.800,119,41,88,.466,24,49,.490,17,39,.436,4,10,.400,103
653,DET,2021-01-25,119,,PHI,W 119-104,240,35,70,.500,18,32,.563,17,38,.447,32,38,.842,119,40,94,.426,31,66,.470,9,28,.321,15,20,.750,104
654,NYK,2021-01-21,119,@,GSW,W 119-104,240,38,82,.463,27,58,.466,11,24,.458,32,41,.780,119,33,86,.384,24,48,.500,9,38,.237,29,39,.744,104
655,DEN,2021-01-19,119,,OKC,W 119-101,240,46,105,.438,32,63,.508,14,42,.333,13,14,.929,119,36,86,.419,22,43,.512,14,43,.326,15,23,.652,101
656,IND,2020-12-31,119,,CLE,W 119-99,240,42,87,.483,26,52,.500,16,35,.457,19,24,.792,119,37,82,.451,25,59,.424,12,23,.522,13,24,.542,99
657,SAC,2020-12-31,119,@,HOU,L 119-122,240,45,96,.469,34,63,.540,11,33,.333,18,24,.750,119,45,86,.523,32,50,.640,13,36,.361,19,25,.760,122
658,MIA,2020-12-30,119,,MIL,W 119-108,240,40,82,.488,25,43,.581,15,39,.385,24,29,.828,119,40,102,.392,24,61,.393,16,41,.390,12,13,.923,108
659,SAS,2020-12-26,119,,TOR,W 119-114,240,47,100,.470,33,66,.500,14,34,.412,11,16,.688,119,44,96,.458,29,55,.527,15,41,.366,11,15,.733,114
660,DET,2020-12-26,119,,CLE,L 119-128 (2OT),290,40,98,.408,24,53,.453,16,45,.356,23,32,.719,119,48,99,.485,35,69,.507,13,30,.433,19,30,.633,128
661,MEM,2020-12-23,119,,SAS,L 119-131,240,49,95,.516,39,68,.574,10,27,.370,11,18,.611,119,48,95,.505,38,70,.543,10,25,.400,25,29,.862,131
662,CHI,2021-05-16,118,,MIL,W 118-112,240,45,87,.517,31,55,.564,14,32,.438,14,19,.737,118,38,90,.422,26,53,.491,12,37,.324,24,32,.750,112
663,NYK,2021-05-15,118,,CHO,W 118-109 (OT),265,45,88,.511,29,51,.569,16,37,.432,12,15,.800,118,39,102,.382,26,53,.491,13,49,.265,18,24,.750,109
664,PHO,2021-05-13,118,,POR,W 118-117,240,41,88,.466,28,56,.500,13,32,.406,23,26,.885,118,44,81,.543,29,48,.604,15,33,.455,14,18,.778,117
665,PHI,2021-05-08,118,,DET,W 118-104,240,41,84,.488,32,54,.593,9,30,.300,27,31,.871,118,41,84,.488,30,50,.600,11,34,.324,11,16,.688,104
666,GSW,2021-05-06,118,,OKC,W 118-97,240,42,86,.488,23,39,.590,19,47,.404,15,18,.833,118,36,88,.409,27,49,.551,9,39,.231,16,20,.800,97
667,LAC,2021-05-06,118,,LAL,W 118-94,240,41,77,.532,28,46,.609,13,31,.419,23,26,.885,118,33,87,.379,23,51,.451,10,36,.278,18,29,.621,94
668,CLE,2021-05-04,118,,PHO,L 118-134 (OT),265,41,90,.456,28,61,.459,13,29,.448,23,27,.852,118,55,105,.524,43,74,.581,12,31,.387,12,13,.923,134
669,BRK,2021-05-04,118,@,MIL,L 118-124,240,41,84,.488,21,41,.512,20,43,.465,16,26,.615,118,44,98,.449,30,61,.492,14,37,.378,22,27,.815,124
670,NYK,2021-05-03,118,@,MEM,W 118-104,240,45,89,.506,31,62,.500,14,27,.519,14,18,.778,118,34,86,.395,18,45,.400,16,41,.390,20,24,.833,104
671,PHO,2021-04-26,118,@,NYK,W 118-110,240,45,83,.542,31,49,.633,14,34,.412,14,17,.824,118,45,87,.517,33,58,.569,12,29,.414,8,10,.800,110
672,ATL,2021-04-23,118,,MIA,W 118-103,240,43,80,.538,28,45,.622,15,35,.429,17,19,.895,118,38,79,.481,25,42,.595,13,37,.351,14,16,.875,103
673,GSW,2021-04-23,118,,DEN,W 118-97,240,45,84,.536,30,45,.667,15,39,.385,13,18,.722,118,34,88,.386,21,42,.500,13,46,.283,16,20,.800,97
674,WAS,2021-04-21,118,,GSW,W 118-114,240,38,91,.418,28,63,.444,10,28,.357,32,38,.842,118,40,101,.396,25,56,.446,15,45,.333,19,21,.905,114
675,POR,2021-04-10,118,,DET,W 118-103,240,43,90,.478,30,61,.492,13,29,.448,19,24,.792,118,37,83,.446,28,57,.491,9,26,.346,20,28,.714,103
676,BOS,2021-04-02,118,,HOU,W 118-102,240,46,88,.523,29,47,.617,17,41,.415,9,12,.750,118,37,86,.430,25,50,.500,12,36,.333,16,26,.615,102
677,DET,2021-03-29,118,,TOR,W 118-104,240,38,75,.507,23,45,.511,15,30,.500,27,34,.794,118,35,86,.407,24,50,.480,11,36,.306,23,28,.821,104
678,UTA,2021-03-24,118,,BRK,W 118-88,240,41,91,.451,18,36,.500,23,55,.418,13,14,.929,118,35,97,.361,28,62,.452,7,35,.200,11,15,.733,88
679,CHI,2021-03-14,118,,TOR,W 118-95,240,44,97,.454,32,53,.604,12,44,.273,18,23,.783,118,34,90,.378,22,45,.489,12,45,.267,15,21,.714,95
680,DEN,2021-03-01,118,@,CHI,W 118-112,240,46,87,.529,36,60,.600,10,27,.370,16,20,.800,118,42,94,.447,30,56,.536,12,38,.316,16,22,.727,112
681,PHO,2021-02-28,118,@,MIN,W 118-99,240,44,89,.494,37,62,.597,7,27,.259,23,24,.958,118,35,93,.376,27,58,.466,8,35,.229,21,24,.875,99
682,OKC,2021-02-26,118,,ATL,W 118-109,240,46,88,.523,30,46,.652,16,42,.381,10,16,.625,118,43,97,.443,31,57,.544,12,40,.300,11,17,.647,109
683,BOS,2021-02-26,118,,IND,W 118-112,240,42,82,.512,33,60,.550,9,22,.409,25,29,.862,118,35,89,.393,20,43,.465,15,46,.326,27,29,.931,112
684,DET,2021-02-24,118,@,NOP,L 118-128,240,47,89,.528,34,53,.642,13,36,.361,11,16,.688,118,50,90,.556,40,67,.597,10,23,.435,18,29,.621,128
685,SAC,2021-02-23,118,@,BRK,L 118-127,240,45,87,.517,30,56,.536,15,31,.484,13,19,.684,118,44,89,.494,27,49,.551,17,40,.425,22,31,.710,127
686,WAS,2021-02-20,118,@,POR,W 118-111,240,45,89,.506,39,63,.619,6,26,.231,22,29,.759,118,37,103,.359,18,48,.375,19,55,.345,18,25,.720,111
687,MIA,2021-02-18,118,@,SAC,W 118-110,240,49,95,.516,37,61,.607,12,34,.353,8,10,.800,118,43,93,.462,28,52,.538,15,41,.366,9,16,.563,110
688,PHI,2021-02-17,118,,HOU,W 118-113,240,39,81,.481,27,55,.491,12,26,.462,28,32,.875,118,42,92,.457,27,45,.600,15,47,.319,14,18,.778,113
689,MIA,2021-02-15,118,@,LAC,L 118-125,240,46,91,.505,38,55,.691,8,36,.222,18,22,.818,118,47,85,.553,32,53,.604,15,32,.469,16,20,.800,125
690,DAL,2021-02-14,118,,POR,L 118-121,240,40,81,.494,26,40,.650,14,41,.341,24,25,.960,118,45,85,.529,27,45,.600,18,40,.450,13,19,.684,121
691,POR,2021-02-11,118,,PHI,W 118-114,240,40,93,.430,23,55,.418,17,38,.447,21,23,.913,118,42,86,.488,36,59,.610,6,27,.222,24,29,.828,114
692,DAL,2021-02-10,118,,ATL,W 118-117,240,43,84,.512,29,49,.592,14,35,.400,18,20,.900,118,40,88,.455,26,49,.531,14,39,.359,23,28,.821,117
693,MIN,2021-02-06,118,@,OKC,L 118-120,240,47,93,.505,35,57,.614,12,36,.333,12,22,.545,118,46,90,.511,34,57,.596,12,33,.364,16,20,.800,120
694,CHI,2021-02-06,118,@,ORL,W 118-92,240,47,91,.516,32,61,.525,15,30,.500,9,13,.692,118,37,95,.389,31,68,.456,6,27,.222,12,12,1.000,92
695,NOP,2021-02-06,118,,MEM,W 118-109,240,45,87,.517,30,54,.556,15,33,.455,13,21,.619,118,40,90,.444,27,51,.529,13,39,.333,16,19,.842,109
696,PHI,2021-02-03,118,@,CHO,W 118-111,240,41,79,.519,31,55,.564,10,24,.417,26,32,.813,118,39,87,.448,25,50,.500,14,37,.378,19,23,.826,111
697,SAC,2021-02-01,118,@,NOP,W 118-109,240,42,88,.477,28,45,.622,14,43,.326,20,26,.769,118,40,101,.396,31,71,.437,9,30,.300,20,24,.833,109
698,GSW,2021-01-30,118,,DET,W 118-91,240,47,89,.528,30,53,.566,17,36,.472,7,10,.700,118,29,77,.377,20,41,.488,9,36,.250,24,32,.750,91
699,PHI,2021-01-29,118,@,MIN,W 118-94,240,39,87,.448,31,71,.437,8,16,.500,32,38,.842,118,35,82,.427,25,49,.510,10,33,.303,14,18,.778,94
700,ORL,2021-01-22,118,@,IND,L 118-120 (OT),265,43,94,.457,26,57,.456,17,37,.459,15,24,.625,118,46,93,.495,34,59,.576,12,34,.353,16,18,.889,120
701,NOP,2021-01-21,118,@,UTA,L 118-129,240,42,85,.494,31,60,.517,11,25,.440,23,30,.767,118,44,88,.500,27,49,.551,17,39,.436,24,25,.960,129
702,UTA,2021-01-19,118,,NOP,W 118-102,240,43,85,.506,22,38,.579,21,47,.447,11,17,.647,118,43,95,.453,37,69,.536,6,26,.231,10,15,.667,102
703,MEM,2021-01-13,118,@,MIN,W 118-107,240,50,106,.472,42,81,.519,8,25,.320,10,13,.769,118,39,90,.433,30,53,.566,9,37,.243,20,24,.833,107
704,CHO,2021-01-08,118,@,NOP,W 118-110,240,41,87,.471,25,45,.556,16,42,.381,20,25,.800,118,38,77,.494,23,39,.590,15,38,.395,19,26,.731,110
705,MIL,2021-01-08,118,,UTA,L 118-131,240,44,98,.449,31,56,.554,13,42,.310,17,21,.810,118,49,97,.505,24,44,.545,25,53,.472,8,13,.615,131
706,SAS,2021-01-07,118,@,LAL,W 118-109,240,43,92,.467,27,57,.474,16,35,.457,16,17,.941,118,43,86,.500,33,56,.589,10,30,.333,13,21,.619,109
707,MIA,2021-01-04,118,,OKC,W 118-90,240,46,81,.568,30,47,.638,16,34,.471,10,18,.556,118,29,79,.367,16,31,.516,13,48,.271,19,27,.704,90
708,IND,2021-01-04,118,@,NOP,W 118-116 (OT),265,45,93,.484,26,48,.542,19,45,.422,9,13,.692,118,44,101,.436,35,74,.473,9,27,.333,19,24,.792,116
709,PHI,2021-01-04,118,,CHO,W 118-101,240,46,95,.484,35,63,.556,11,32,.344,15,23,.652,118,36,86,.419,23,47,.489,13,39,.333,16,22,.727,101
710,CHI,2021-01-03,118,,DAL,W 118-108,240,39,85,.459,26,48,.542,13,37,.351,27,30,.900,118,39,89,.438,28,47,.596,11,42,.262,19,27,.704,108
711,CHO,2020-12-30,118,@,DAL,W 118-99,240,43,84,.512,28,50,.560,15,34,.441,17,21,.810,118,34,87,.391,22,45,.489,12,42,.286,19,33,.576,99
712,ORL,2020-12-29,118,@,OKC,W 118-107,240,49,96,.510,42,74,.568,7,22,.318,13,16,.813,118,43,87,.494,32,53,.604,11,34,.324,10,19,.526,107
713,CLE,2020-12-27,118,,PHI,W 118-94,240,48,91,.527,39,68,.574,9,23,.391,13,16,.813,118,33,79,.418,21,42,.500,12,37,.324,16,22,.727,94
714,OKC,2021-05-16,117,,LAC,W 117-112,240,50,94,.532,42,68,.618,8,26,.308,9,16,.563,117,45,106,.425,35,63,.556,10,43,.233,12,15,.800,112
715,ORL,2021-05-16,117,@,PHI,L 117-128,240,36,76,.474,26,48,.542,10,28,.357,35,41,.854,117,46,94,.489,27,54,.500,19,40,.475,17,23,.739,128
716,POR,2021-05-13,117,@,PHO,L 117-118,240,44,81,.543,29,48,.604,15,33,.455,14,18,.778,117,41,88,.466,28,56,.500,13,32,.406,23,26,.885,118
717,DEN,2021-05-11,117,@,CHO,W 117-112,240,41,83,.494,28,50,.560,13,33,.394,22,26,.846,117,42,91,.462,31,52,.596,11,39,.282,17,20,.850,112
718,MIL,2021-05-02,117,,BRK,W 117-114,240,48,98,.490,33,61,.541,15,37,.405,6,12,.500,117,41,96,.427,24,54,.444,17,42,.405,15,17,.882,114
719,GSW,2021-04-25,117,,SAC,W 117-113,240,46,95,.484,32,59,.542,14,36,.389,11,15,.733,117,41,86,.477,27,49,.551,14,37,.378,17,22,.773,113
720,PHI,2021-04-22,117,@,MIL,L 117-124,240,46,91,.505,34,64,.531,12,27,.444,13,18,.722,117,45,81,.556,25,41,.610,20,40,.500,14,23,.609,124
721,DET,2021-04-21,117,@,DAL,L 117-127,240,40,79,.506,27,47,.574,13,32,.406,24,31,.774,117,46,92,.500,30,49,.612,16,43,.372,19,26,.731,127
722,LAC,2021-04-21,117,,MEM,W 117-105,240,38,84,.452,24,57,.421,14,27,.519,27,36,.750,117,38,84,.452,25,54,.463,13,30,.433,16,23,.696,105
723,IND,2021-04-18,117,@,ATL,L 117-129,240,45,92,.489,35,60,.583,10,32,.313,17,20,.850,117,45,92,.489,32,60,.533,13,32,.406,26,34,.765,129
724,WAS,2021-04-16,117,,NOP,W 117-115 (OT),265,45,96,.469,41,69,.594,4,27,.148,23,32,.719,117,40,97,.412,33,69,.478,7,28,.250,28,33,.848,115
725,NYK,2021-04-16,117,@,DAL,W 117-109,240,44,86,.512,30,58,.517,14,28,.500,15,21,.714,117,40,91,.440,25,46,.543,15,45,.333,14,19,.737,109
726,BRK,2021-04-14,117,@,PHI,L 117-123,240,43,83,.518,39,62,.629,4,21,.190,27,30,.900,117,45,87,.517,32,59,.542,13,28,.464,20,25,.800,123
727,TOR,2021-04-14,117,,SAS,W 117-112,240,41,88,.466,27,58,.466,14,30,.467,21,25,.840,117,38,89,.427,21,50,.420,17,39,.436,19,27,.704,112
728,NOP,2021-04-12,117,,SAC,W 117-110,240,42,77,.545,36,58,.621,6,19,.316,27,39,.692,117,39,90,.433,29,55,.527,10,35,.286,22,37,.595,110
729,DAL,2021-04-11,117,,SAS,L 117-119,240,45,94,.479,32,52,.615,13,42,.310,14,15,.933,117,45,83,.542,37,62,.597,8,21,.381,21,27,.778,119
730,CHI,2021-04-11,117,@,MIN,L 117-121,240,47,92,.511,32,54,.593,15,38,.395,8,13,.615,117,40,81,.494,24,45,.533,16,36,.444,25,25,1.000,121
731,PHI,2021-04-10,117,@,OKC,W 117-93,240,44,94,.468,32,56,.571,12,38,.316,17,25,.680,117,38,76,.500,30,56,.536,8,20,.400,9,19,.474,93
732,PHO,2021-04-07,117,,UTA,W 117-113 (OT),265,45,101,.446,34,67,.507,11,34,.324,16,20,.800,117,46,103,.447,35,59,.593,11,44,.250,10,15,.667,113
733,ATL,2021-04-04,117,,GSW,W 117-111,240,35,81,.432,23,49,.469,12,32,.375,35,45,.778,117,43,92,.467,33,52,.635,10,40,.250,15,21,.714,111
734,PHO,2021-03-30,117,,ATL,W 117-110,240,45,88,.511,33,56,.589,12,32,.375,15,18,.833,117,41,85,.482,28,53,.528,13,32,.406,15,21,.714,110
735,TOR,2021-03-28,117,,POR,L 117-122,240,39,87,.448,25,45,.556,14,42,.333,25,33,.758,117,46,97,.474,36,63,.571,10,34,.294,20,24,.833,122
736,UTA,2021-03-26,117,,MEM,W 117-114,240,45,98,.459,33,65,.508,12,33,.364,15,18,.833,117,44,97,.454,32,67,.478,12,30,.400,14,18,.778,114
737,HOU,2021-03-22,117,,TOR,W 117-99,240,41,90,.456,27,54,.500,14,36,.389,21,26,.808,117,37,87,.425,27,47,.574,10,40,.250,15,19,.789,99
738,CLE,2021-03-17,117,,BOS,W 117-110,240,40,74,.541,30,51,.588,10,23,.435,27,33,.818,117,40,88,.455,30,50,.600,10,38,.263,20,29,.690,110
739,UTA,2021-03-16,117,@,BOS,W 117-109,240,38,80,.475,19,37,.514,19,43,.442,22,24,.917,117,48,98,.490,38,69,.551,10,29,.345,3,4,.750,109
740,BRK,2021-03-15,117,,NYK,W 117-112,240,44,76,.579,32,47,.681,12,29,.414,17,22,.773,117,37,92,.402,22,50,.440,15,42,.357,23,27,.852,112
741,LAC,2021-03-04,117,@,WAS,L 117-119,240,38,82,.463,22,47,.468,16,35,.457,25,27,.926,117,40,88,.455,31,65,.477,9,23,.391,30,42,.714,119
742,BOS,2021-03-02,117,,LAC,W 117-112,240,42,86,.488,26,54,.481,16,32,.500,17,23,.739,117,43,87,.494,25,49,.510,18,38,.474,8,9,.889,112
743,LAL,2021-02-28,117,,GSW,W 117-91,240,40,85,.471,29,54,.537,11,31,.355,26,38,.684,117,35,86,.407,27,52,.519,8,34,.235,13,19,.684,91
744,SAS,2021-02-27,117,,NOP,W 117-114,240,41,86,.477,29,54,.537,12,32,.375,23,28,.821,117,40,91,.440,31,59,.525,9,32,.281,25,31,.806,114
745,OKC,2021-02-21,117,@,CLE,W 117-101,240,43,79,.544,30,51,.588,13,28,.464,18,24,.750,117,39,84,.464,31,49,.633,8,35,.229,15,20,.750,101
746,GSW,2021-02-13,117,,BRK,L 117-134,240,44,90,.489,35,56,.625,9,34,.265,20,25,.800,117,50,93,.538,34,54,.630,16,39,.410,18,20,.900,134
747,ATL,2021-02-10,117,@,DAL,L 117-118,240,40,88,.455,26,49,.531,14,39,.359,23,28,.821,117,43,84,.512,29,49,.592,14,35,.400,18,20,.900,118
748,BRK,2021-02-05,117,,TOR,L 117-123,240,39,80,.488,22,38,.579,17,42,.405,22,29,.759,117,49,97,.505,36,65,.554,13,32,.406,12,14,.857,123
749,UTA,2021-02-02,117,,DET,W 117-105,240,38,82,.463,22,40,.550,16,42,.381,25,29,.862,117,39,93,.419,30,66,.455,9,27,.333,18,20,.900,105
750,UTA,2021-01-31,117,@,DEN,L 117-128,240,32,75,.427,12,28,.429,20,47,.426,33,39,.846,117,47,87,.540,29,59,.492,18,28,.643,16,19,.842,128
751,ORL,2021-01-25,117,,CHO,W 117-108,240,42,88,.477,23,51,.451,19,37,.514,14,22,.636,117,39,89,.438,28,51,.549,11,38,.289,19,27,.704,108
752,DEN,2021-01-25,117,@,DAL,W 117-113,240,40,79,.506,25,44,.568,15,35,.429,22,28,.786,117,41,84,.488,30,52,.577,11,32,.344,20,24,.833,113
753,SAS,2021-01-22,117,,DAL,L 117-122,240,41,89,.461,29,61,.475,12,28,.429,23,30,.767,117,45,93,.484,31,54,.574,14,39,.359,18,20,.900,122
754,PHI,2021-01-20,117,,BOS,W 117-109,240,36,78,.462,27,51,.529,9,27,.333,36,45,.800,117,42,89,.472,30,56,.536,12,33,.364,13,20,.650,109
755,CHI,2021-01-17,117,@,DAL,W 117-101,240,43,85,.506,36,60,.600,7,25,.280,24,33,.727,117,41,93,.441,33,62,.532,8,31,.258,11,19,.579,101
756,UTA,2021-01-12,117,@,CLE,W 117-87,240,42,84,.500,18,39,.462,24,45,.533,9,12,.750,117,35,90,.389,27,59,.458,8,31,.258,9,14,.643,87
757,LAL,2021-01-12,117,@,HOU,W 117-100,240,42,84,.500,28,52,.538,14,32,.438,19,27,.704,117,38,97,.392,26,57,.456,12,40,.300,12,16,.750,100
758,IND,2021-01-09,117,,PHO,L 117-125,240,44,92,.478,32,63,.508,12,29,.414,17,24,.708,117,46,94,.489,30,53,.566,16,41,.390,17,17,1.000,125
759,LAL,2021-01-08,117,,CHI,W 117-115,240,41,81,.506,29,52,.558,12,29,.414,23,27,.852,117,46,91,.505,36,65,.554,10,26,.385,13,14,.929,115
760,MIN,2021-01-07,117,@,POR,L 117-135,240,39,93,.419,25,52,.481,14,41,.341,25,33,.758,117,49,90,.544,31,49,.633,18,41,.439,19,23,.826,135
761,DEN,2021-01-07,117,,DAL,L 117-124 (OT),265,43,97,.443,28,53,.528,15,44,.341,16,21,.762,117,42,87,.483,26,47,.553,16,40,.400,24,31,.774,124
762,DEN,2021-05-16,116,@,POR,L 116-132,240,44,98,.449,30,61,.492,14,37,.378,14,15,.933,116,46,87,.529,28,44,.636,18,43,.419,22,26,.846,132
763,MEM,2021-05-13,116,,SAC,W 116-110,240,45,90,.500,34,57,.596,11,33,.333,15,18,.833,116,42,96,.438,25,55,.455,17,41,.415,9,14,.643,110
764,ATL,2021-05-13,116,,ORL,W 116-93,240,41,94,.436,27,58,.466,14,36,.389,20,24,.833,116,36,94,.383,25,58,.431,11,36,.306,10,15,.667,93
765,WAS,2021-05-12,116,@,ATL,L 116-120,240,45,101,.446,35,72,.486,10,29,.345,16,19,.842,116,44,86,.512,34,53,.642,10,33,.303,22,28,.786,120
766,SAS,2021-05-12,116,@,BRK,L 116-128,240,43,101,.426,35,70,.500,8,31,.258,22,27,.815,116,48,79,.608,36,51,.706,12,28,.429,20,27,.741,128
767,PHO,2021-05-11,116,@,GSW,L 116-122,240,41,79,.519,25,42,.595,16,37,.432,18,20,.900,116,47,95,.495,36,55,.655,11,40,.275,17,20,.850,122
768,UTA,2021-05-10,116,@,GSW,L 116-119,240,41,91,.451,28,47,.596,13,44,.295,21,24,.875,116,41,88,.466,27,46,.587,14,42,.333,23,25,.920,119
769,HOU,2021-05-08,116,@,UTA,L 116-124,240,43,98,.439,25,47,.532,18,51,.353,12,17,.706,116,45,85,.529,30,47,.638,15,38,.395,19,21,.905,124
770,WAS,2021-04-28,116,,LAL,W 116-107,240,47,90,.522,41,72,.569,6,18,.333,16,21,.762,116,42,96,.438,32,62,.516,10,34,.294,13,21,.619,107
771,MIA,2021-04-28,116,,SAS,W 116-111,240,43,85,.506,34,60,.567,9,25,.360,21,24,.875,116,41,88,.466,31,56,.554,10,32,.313,19,24,.792,111
772,BRK,2021-04-27,116,@,TOR,W 116-103,240,40,83,.482,22,38,.579,18,45,.400,18,18,1.000,116,36,91,.396,21,48,.438,15,43,.349,16,19,.842,103
773,HOU,2021-04-24,116,@,DEN,L 116-129,240,41,82,.500,26,42,.619,15,40,.375,19,28,.679,116,50,84,.595,34,47,.723,16,37,.432,13,16,.813,129
774,PHO,2021-04-21,116,@,PHI,W 116-113,240,41,86,.477,26,44,.591,15,42,.357,19,21,.905,116,41,80,.513,28,55,.509,13,25,.520,18,26,.692,113
775,OKC,2021-04-21,116,@,IND,L 116-122,240,48,104,.462,39,75,.520,9,29,.310,11,16,.688,116,46,101,.455,32,61,.525,14,40,.350,16,20,.800,122
776,NYK,2021-04-14,116,@,NOP,W 116-106,240,44,97,.454,27,64,.422,17,33,.515,11,13,.846,116,40,88,.455,34,60,.567,6,28,.214,20,24,.833,106
777,BOS,2021-04-13,116,@,POR,W 116-115,240,42,90,.467,27,55,.491,15,35,.429,17,24,.708,116,43,90,.478,26,47,.553,17,43,.395,12,17,.706,115
778,GSW,2021-04-12,116,,DEN,W 116-107,240,39,81,.481,21,37,.568,18,44,.409,20,22,.909,116,39,83,.470,31,57,.544,8,26,.308,21,25,.840,107
779,NOP,2021-04-11,116,@,CLE,W 116-109,240,44,86,.512,37,62,.597,7,24,.292,21,26,.808,116,41,85,.482,28,45,.622,13,40,.325,14,17,.824,109
780,DAL,2021-04-08,116,,MIL,W 116-101,240,43,97,.443,26,52,.500,17,45,.378,13,18,.722,116,38,100,.380,26,67,.388,12,33,.364,13,16,.813,101
781,ORL,2021-04-07,116,,WAS,L 116-131,240,44,93,.473,32,62,.516,12,31,.387,16,23,.696,116,49,85,.576,30,49,.612,19,36,.528,14,16,.875,131
782,POR,2021-04-06,116,@,LAC,L 116-133,240,37,92,.402,26,56,.464,11,36,.306,31,37,.838,116,46,89,.517,30,48,.625,16,41,.390,25,30,.833,133
783,MIN,2021-04-05,116,,SAC,W 116-106,240,38,91,.418,26,59,.441,12,32,.375,28,33,.848,116,39,88,.443,30,52,.577,9,36,.250,19,24,.792,106
784,MEM,2021-04-04,116,@,PHI,W 116-100,240,44,89,.494,28,51,.549,16,38,.421,12,15,.800,116,37,89,.416,29,55,.527,8,34,.235,18,28,.643,100
785,BOS,2021-04-04,116,,CHO,W 116-86,240,43,94,.457,22,40,.550,21,54,.389,9,11,.818,116,32,80,.400,22,49,.449,10,31,.323,12,20,.600,86
786,MIA,2021-04-01,116,,GSW,W 116-109,240,39,82,.476,26,43,.605,13,39,.333,25,30,.833,116,36,82,.439,21,45,.467,15,37,.405,22,25,.880,109
787,CHI,2021-03-31,116,@,PHO,L 116-121,240,43,99,.434,32,66,.485,11,33,.333,19,21,.905,116,46,81,.568,35,56,.625,11,25,.440,18,24,.750,121
788,GSW,2021-03-29,116,,CHI,W 116-102,240,46,92,.500,30,54,.556,16,38,.421,8,9,.889,116,44,84,.524,38,60,.633,6,24,.250,8,11,.727,102
789,MEM,2021-03-24,116,@,OKC,W 116-107,240,47,99,.475,36,69,.522,11,30,.367,11,13,.846,116,43,95,.453,33,60,.550,10,35,.286,11,17,.647,107
790,IND,2021-03-24,116,,DET,W 116-111,240,45,97,.464,30,63,.476,15,34,.441,11,14,.786,116,44,83,.530,33,55,.600,11,28,.393,12,19,.632,111
791,BRK,2021-03-23,116,@,POR,W 116-112,240,43,87,.494,34,57,.596,9,30,.300,21,27,.778,116,36,90,.400,17,35,.486,19,55,.345,21,23,.913,112
792,CLE,2021-03-21,116,,TOR,W 116-105,240,39,77,.506,22,44,.500,17,33,.515,21,28,.750,116,37,95,.389,22,49,.449,15,46,.326,16,19,.842,105
793,SAS,2021-03-19,116,@,CLE,W 116-110,240,41,88,.466,34,70,.486,7,18,.389,27,33,.818,116,39,89,.438,32,62,.516,7,27,.259,25,32,.781,110
794,GSW,2021-03-19,116,@,MEM,W 116-103,240,44,91,.484,29,50,.580,15,41,.366,13,18,.722,116,39,84,.464,31,58,.534,8,26,.308,17,21,.810,103
795,ATL,2021-03-18,116,,OKC,W 116-93,240,47,87,.540,36,54,.667,11,33,.333,11,13,.846,116,34,93,.366,21,59,.356,13,34,.382,12,16,.750,93
796,LAL,2021-03-18,116,,CHO,W 116-105,240,44,92,.478,31,53,.585,13,39,.333,15,20,.750,116,41,83,.494,30,54,.556,11,29,.379,12,20,.600,105
797,DET,2021-03-17,116,,TOR,W 116-112,240,38,75,.507,26,46,.565,12,29,.414,28,32,.875,116,37,86,.430,25,46,.543,12,40,.300,26,34,.765,112
798,SAC,2021-03-15,116,@,CHO,L 116-122,240,48,86,.558,39,55,.709,9,31,.290,11,17,.647,116,45,94,.479,33,64,.516,12,30,.400,20,25,.800,122
799,DAL,2021-03-13,116,@,DEN,W 116-103,240,42,86,.488,24,40,.600,18,46,.391,14,16,.875,116,37,90,.411,21,49,.429,16,41,.390,13,18,.722,103
800,NOP,2021-03-12,116,,CLE,W 116-82,240,47,101,.465,41,77,.532,6,24,.250,16,19,.842,116,30,88,.341,23,56,.411,7,32,.219,15,20,.750,82
801,OKC,2021-03-11,116,,DAL,W 116-108,240,41,91,.451,25,59,.424,16,32,.500,18,20,.900,116,35,82,.427,20,48,.417,15,34,.441,23,33,.697,108
802,UTA,2021-02-26,116,@,MIA,L 116-124,240,40,94,.426,25,48,.521,15,46,.326,21,23,.913,116,44,86,.512,30,55,.545,14,31,.452,22,25,.880,124
803,MIA,2021-02-24,116,,TOR,W 116-108,240,37,80,.463,20,42,.476,17,38,.447,25,29,.862,116,37,74,.500,17,30,.567,20,44,.455,14,17,.824,108
804,WAS,2021-02-23,116,@,LAC,L 116-135,240,47,88,.534,36,68,.529,11,20,.550,11,16,.688,116,54,94,.574,35,56,.625,19,38,.500,8,13,.615,135
805,LAC,2021-02-19,116,,UTA,W 116-112,240,43,89,.483,33,59,.559,10,30,.333,20,22,.909,116,41,86,.477,29,52,.558,12,34,.353,18,21,.857,112
806,MIN,2021-02-14,116,@,TOR,W 116-112,240,43,82,.524,27,43,.628,16,39,.410,14,19,.737,116,38,91,.418,28,58,.483,10,33,.303,26,31,.839,112
807,NOP,2021-02-10,116,@,CHI,L 116-129,240,41,81,.506,28,45,.622,13,36,.361,21,26,.808,116,48,81,.593,23,34,.676,25,47,.532,8,11,.727,129
808,DAL,2021-02-04,116,,GSW,L 116-147,240,38,92,.413,18,42,.429,20,50,.400,20,23,.870,116,51,89,.573,29,46,.630,22,43,.512,23,27,.852,147
809,SAC,2021-02-03,116,,BOS,W 116-111,240,42,92,.457,29,55,.527,13,37,.351,19,23,.826,116,39,86,.453,28,53,.528,11,33,.333,22,29,.759,111
810,ATL,2021-02-03,116,,DAL,L 116-122,240,45,90,.500,31,52,.596,14,38,.368,12,17,.706,116,43,93,.462,30,53,.566,13,40,.325,23,25,.920,122
811,MEM,2021-02-02,116,@,IND,L 116-134,240,42,93,.452,33,68,.485,9,25,.360,23,24,.958,116,49,82,.598,33,53,.623,16,29,.552,20,29,.690,134
812,LAC,2021-01-29,116,@,ORL,W 116-90,240,46,94,.489,33,57,.579,13,37,.351,11,11,1.000,116,32,89,.360,22,56,.393,10,33,.303,16,18,.889,90
813,ATL,2021-01-29,116,@,WAS,W 116-100,240,39,87,.448,27,50,.540,12,37,.324,26,34,.765,116,31,85,.365,24,57,.421,7,28,.250,31,38,.816,100
814,UTA,2021-01-27,116,,DAL,W 116-104,240,42,91,.462,26,50,.520,16,41,.390,16,21,.762,116,42,91,.462,30,56,.536,12,35,.343,8,9,.889,104
815,IND,2021-01-27,116,@,CHO,W 116-106,240,45,88,.511,29,48,.604,16,40,.400,10,12,.833,116,37,90,.411,24,52,.462,13,38,.342,19,21,.905,106
816,POR,2021-01-24,116,,NYK,W 116-113,240,39,83,.470,22,37,.595,17,46,.370,21,23,.913,116,39,86,.453,27,57,.474,12,29,.414,23,25,.920,113
817,ATL,2021-01-22,116,@,MIN,W 116-98,240,38,83,.458,23,48,.479,15,35,.429,25,30,.833,116,40,93,.430,32,61,.525,8,32,.250,10,12,.833,98
818,TOR,2021-01-18,116,,DAL,W 116-93,240,44,88,.500,32,55,.582,12,33,.364,16,18,.889,116,31,82,.378,22,46,.478,9,36,.250,22,27,.815,93
819,TOR,2021-01-16,116,,CHO,W 116-113,240,36,86,.419,15,37,.405,21,49,.429,23,26,.885,116,38,87,.437,23,51,.451,15,36,.417,22,29,.759,113
820,UTA,2021-01-15,116,,ATL,W 116-92,240,43,92,.467,23,48,.479,20,44,.455,10,14,.714,116,38,92,.413,33,64,.516,5,28,.179,11,15,.733,92
821,BRK,2021-01-13,116,@,NYK,W 116-109,240,44,91,.484,28,51,.549,16,40,.400,12,17,.706,116,44,92,.478,33,64,.516,11,28,.393,10,12,.833,109
822,DEN,2021-01-12,116,@,BRK,L 116-122,240,44,88,.500,26,51,.510,18,37,.486,10,16,.625,116,48,79,.608,32,47,.681,16,32,.500,10,15,.667,122
823,BRK,2021-01-10,116,,OKC,L 116-129,240,43,85,.506,33,51,.647,10,34,.294,20,24,.833,116,49,90,.544,34,51,.667,15,39,.385,16,17,.941,129
824,BOS,2021-01-08,116,,WAS,W 116-107,240,41,86,.477,29,54,.537,12,32,.375,22,30,.733,116,41,88,.466,30,59,.508,11,29,.379,14,16,.875,107
825,MIN,2021-01-05,116,@,DEN,L 116-123,240,42,91,.462,31,57,.544,11,34,.324,21,27,.778,116,41,79,.519,33,54,.611,8,25,.320,33,45,.733,123
826,SAS,2021-01-05,116,@,LAC,W 116-113,240,44,96,.458,24,56,.429,20,40,.500,8,11,.727,116,43,86,.500,28,51,.549,15,35,.429,12,13,.923,113
827,NOP,2021-01-04,116,,IND,L 116-118 (OT),265,44,101,.436,35,74,.473,9,27,.333,19,24,.792,116,45,93,.484,26,48,.542,19,45,.422,9,13,.692,118
828,TOR,2021-01-02,116,@,NOP,L 116-120,240,38,91,.418,24,43,.558,14,48,.292,26,27,.963,116,35,83,.422,21,45,.467,14,38,.368,36,47,.766,120
829,PHI,2020-12-31,116,@,ORL,W 116-92,240,44,91,.484,29,58,.500,15,33,.455,13,15,.867,116,33,95,.347,26,67,.388,7,28,.250,19,21,.905,92
830,BOS,2020-12-29,116,@,IND,W 116-111,240,40,80,.500,31,58,.534,9,22,.409,27,37,.730,116,43,84,.512,31,51,.608,12,33,.364,13,16,.813,111
831,GSW,2020-12-29,116,@,DET,W 116-106,240,38,76,.500,24,43,.558,14,33,.424,26,36,.722,116,35,92,.380,22,57,.386,13,35,.371,23,29,.793,106
832,MEM,2020-12-28,116,@,BRK,W 116-111 (OT),265,42,98,.429,32,69,.464,10,29,.345,22,29,.759,116,41,100,.410,27,58,.466,14,42,.333,15,17,.882,111
833,PHO,2020-12-27,116,@,SAC,W 116-100,240,46,94,.489,32,59,.542,14,35,.400,10,11,.909,116,36,76,.474,26,53,.491,10,23,.435,18,25,.720,100
834,MIN,2020-12-26,116,@,UTA,W 116-111,240,45,101,.446,32,72,.444,13,29,.448,13,18,.722,116,36,94,.383,26,60,.433,10,34,.294,29,37,.784,111
835,LAC,2020-12-22,116,@,LAL,W 116-109,240,44,93,.473,30,53,.566,14,40,.350,14,19,.737,116,38,81,.469,29,52,.558,9,29,.310,24,31,.774,109
836,WAS,2021-05-16,115,,CHO,W 115-110,240,44,91,.484,34,60,.567,10,31,.323,17,21,.810,115,37,94,.394,23,49,.469,14,45,.311,22,24,.917,110
837,IND,2021-05-15,115,,LAL,L 115-122,240,46,89,.517,37,56,.661,9,33,.273,14,19,.737,115,41,86,.477,30,57,.526,11,29,.379,29,36,.806,122
838,LAC,2021-05-14,115,@,HOU,L 115-122,240,45,93,.484,34,58,.586,11,35,.314,14,15,.933,115,46,86,.535,32,49,.653,14,37,.378,16,22,.727,122
839,BRK,2021-05-11,115,@,CHI,W 115-107,240,42,89,.472,30,56,.536,12,33,.364,19,25,.760,115,39,96,.406,21,52,.404,18,44,.409,11,14,.786,107
840,LAC,2021-05-11,115,@,TOR,W 115-96,240,39,78,.500,28,46,.609,11,32,.344,26,26,1.000,115,35,86,.407,25,49,.510,10,37,.270,16,19,.842,96
841,MEM,2021-05-10,115,,NOP,W 115-110,240,45,91,.495,36,61,.590,9,30,.300,16,27,.593,115,43,97,.443,33,74,.446,10,23,.435,14,21,.667,110
842,HOU,2021-05-05,115,,PHI,L 115-135,240,42,93,.452,25,48,.521,17,45,.378,14,18,.778,115,50,94,.532,35,59,.593,15,35,.429,20,22,.909,135
843,DAL,2021-04-29,115,@,DET,W 115-105,240,40,89,.449,27,59,.458,13,30,.433,22,23,.957,115,36,71,.507,26,42,.619,10,29,.345,23,34,.676,105
844,BOS,2021-04-27,115,,OKC,L 115-119,240,41,97,.423,30,48,.625,11,49,.224,22,25,.880,115,39,81,.481,26,51,.510,13,30,.433,28,36,.778,119
845,IND,2021-04-24,115,,DET,W 115-109,240,40,96,.417,30,64,.469,10,32,.313,25,35,.714,115,39,96,.406,29,62,.468,10,34,.294,21,26,.808,109
846,DAL,2021-04-22,115,,LAL,W 115-110,240,40,82,.488,31,58,.534,9,24,.375,26,36,.722,115,43,90,.478,33,60,.550,10,30,.333,14,17,.824,110
847,UTA,2021-04-17,115,@,LAL,L 115-127 (OT),265,42,101,.416,19,42,.452,23,59,.390,8,8,1.000,115,48,93,.516,37,60,.617,11,33,.333,20,23,.870,127
848,MIL,2021-04-17,115,,MEM,L 115-128,240,39,91,.429,23,44,.523,16,47,.340,21,27,.778,115,51,93,.548,36,53,.679,15,40,.375,11,12,.917,128
849,CHI,2021-04-16,115,,MEM,L 115-126,240,45,96,.469,32,62,.516,13,34,.382,12,15,.800,115,45,86,.523,28,46,.609,17,40,.425,19,24,.792,126
850,NOP,2021-04-16,115,@,WAS,L 115-117 (OT),265,40,97,.412,33,69,.478,7,28,.250,28,33,.848,115,45,96,.469,41,69,.594,4,27,.148,23,32,.719,117
851,CHO,2021-04-16,115,@,BRK,L 115-130,240,44,83,.530,32,49,.653,12,34,.353,15,20,.750,115,47,85,.553,26,44,.591,21,41,.512,15,16,.938,130
852,ORL,2021-04-14,115,@,CHI,W 115-106,240,44,89,.494,32,62,.516,12,27,.444,15,20,.750,115,41,86,.477,24,49,.490,17,37,.459,7,9,.778,106
853,IND,2021-04-13,115,,LAC,L 115-126,240,44,96,.458,35,56,.625,9,40,.225,18,22,.818,115,48,89,.539,35,61,.574,13,28,.464,17,19,.895,126
854,POR,2021-04-13,115,,BOS,L 115-116,240,43,90,.478,26,47,.553,17,43,.395,12,17,.706,115,42,90,.467,27,55,.491,15,35,.429,17,24,.708,116
855,CLE,2021-04-10,115,,TOR,L 115-135,240,39,86,.453,24,51,.471,15,35,.429,22,26,.846,115,53,86,.616,36,54,.667,17,32,.531,12,14,.857,135
856,HOU,2021-04-04,115,,NOP,L 115-122,240,41,89,.461,25,49,.510,16,40,.400,17,24,.708,115,42,91,.462,26,54,.481,16,37,.432,22,35,.629,122
857,CHI,2021-04-04,115,,BRK,W 115-107,240,43,78,.551,35,56,.625,8,22,.364,21,30,.700,115,45,93,.484,34,65,.523,11,28,.393,6,7,.857,107
858,MIA,2021-04-03,115,,CLE,W 115-101,240,44,82,.537,29,44,.659,15,38,.395,12,16,.750,115,35,74,.473,25,43,.581,10,31,.323,21,25,.840,101
859,LAL,2021-04-02,115,@,SAC,W 115-94,240,43,91,.473,26,58,.448,17,33,.515,12,20,.600,115,36,85,.424,26,50,.520,10,35,.286,12,16,.750,94
860,ORL,2021-04-01,115,@,NOP,W 115-110 (OT),265,45,106,.425,40,81,.494,5,25,.200,20,23,.870,115,41,93,.441,29,64,.453,12,29,.414,16,19,.842,110
861,SAS,2021-03-29,115,,SAC,L 115-132,240,47,93,.505,37,66,.561,10,27,.370,11,14,.786,115,47,84,.560,29,48,.604,18,36,.500,20,25,.800,132
862,NOP,2021-03-29,115,@,BOS,W 115-109,240,41,82,.500,25,51,.490,16,31,.516,17,30,.567,115,40,93,.430,26,50,.520,14,43,.326,15,19,.789,109
863,UTA,2021-03-19,115,@,TOR,W 115-112,240,34,74,.459,22,37,.595,12,37,.324,35,41,.854,115,40,83,.482,19,39,.487,21,44,.477,11,14,.786,112
864,IND,2021-03-17,115,,BRK,L 115-124,240,43,84,.512,34,52,.654,9,32,.281,20,25,.800,115,42,87,.483,33,60,.550,9,27,.333,31,40,.775,124
865,LAC,2021-03-14,115,@,NOP,L 115-135,240,42,92,.457,27,49,.551,15,43,.349,16,19,.842,115,53,81,.654,41,55,.745,12,26,.462,17,21,.810,135
866,DAL,2021-03-10,115,,SAS,W 115-104,240,43,83,.518,30,43,.698,13,40,.325,16,19,.842,115,38,83,.458,26,55,.473,12,28,.429,16,20,.800,104
867,ATL,2021-03-03,115,@,ORL,W 115-112,240,38,85,.447,17,40,.425,21,45,.467,18,19,.947,115,36,84,.429,23,49,.469,13,35,.371,27,27,1.000,112
868,DAL,2021-02-27,115,@,BRK,W 115-98,240,45,86,.523,31,50,.620,14,36,.389,11,17,.647,115,35,86,.407,21,42,.500,14,44,.318,14,19,.737,98
869,SAC,2021-02-21,115,@,MIL,L 115-128,240,44,100,.440,32,67,.478,12,33,.364,15,20,.750,115,44,90,.489,33,62,.532,11,28,.393,29,36,.806,128
870,BOS,2021-02-21,115,@,NOP,L 115-120 (OT),265,39,98,.398,29,61,.475,10,37,.270,27,34,.794,115,42,94,.447,31,58,.534,11,36,.306,25,37,.676,120
871,DEN,2021-02-21,115,@,ATL,L 115-123,240,43,84,.512,27,48,.563,16,36,.444,13,16,.813,115,42,81,.519,30,47,.638,12,34,.353,27,33,.818,123
872,POR,2021-02-16,115,@,OKC,W 115-104,240,42,96,.438,22,49,.449,20,47,.426,11,17,.647,115,37,85,.435,27,52,.519,10,33,.303,20,27,.741,104
873,MIL,2021-02-12,115,@,UTA,L 115-129,240,42,92,.457,30,59,.508,12,33,.364,19,27,.704,115,43,82,.524,29,44,.659,14,38,.368,29,34,.853,129
874,LAL,2021-02-12,115,,MEM,W 115-105,240,43,85,.506,37,55,.673,6,30,.200,23,33,.697,115,39,80,.488,27,51,.529,12,29,.414,15,19,.789,105
875,WAS,2021-02-10,115,,TOR,L 115-137,240,42,93,.452,30,52,.577,12,41,.293,19,23,.826,115,49,93,.527,30,61,.492,19,32,.594,20,23,.870,137
876,LAC,2021-02-05,115,,BOS,L 115-119,240,42,81,.519,28,49,.571,14,32,.438,17,21,.810,115,43,90,.478,27,52,.519,16,38,.421,17,21,.810,119
877,HOU,2021-02-04,115,@,MEM,W 115-103,240,41,87,.471,22,42,.524,19,45,.422,14,17,.824,115,37,87,.425,25,52,.481,12,35,.343,17,24,.708,103
878,TOR,2021-01-31,115,,ORL,W 115-102,240,41,90,.456,29,51,.569,12,39,.308,21,22,.955,115,33,82,.402,20,46,.435,13,36,.361,23,28,.821,102
879,NYK,2021-01-31,115,,LAC,L 115-129,240,41,85,.482,31,58,.534,10,27,.370,23,28,.821,115,44,81,.543,27,43,.628,17,38,.447,24,28,.857,129
880,MIL,2021-01-27,115,@,TOR,W 115-108,240,40,93,.430,24,49,.490,16,44,.364,19,26,.731,115,38,94,.404,16,39,.410,22,55,.400,10,12,.833,108
881,LAL,2021-01-25,115,@,CLE,W 115-108,240,42,87,.483,32,55,.582,10,32,.313,21,28,.750,115,40,86,.465,31,65,.477,9,21,.429,19,22,.864,108
882,ATL,2021-01-24,115,@,MIL,L 115-129,240,42,83,.506,28,44,.636,14,39,.359,17,22,.773,115,50,91,.549,40,60,.667,10,31,.323,19,27,.704,129
883,DET,2021-01-20,115,@,ATL,L 115-123 (OT),265,44,97,.454,34,66,.515,10,31,.323,17,19,.895,115,44,100,.440,35,77,.455,9,23,.391,26,38,.684,123
884,LAC,2021-01-20,115,,SAC,W 115-96,240,41,86,.477,25,51,.490,16,35,.457,17,18,.944,115,39,86,.453,26,58,.448,13,28,.464,5,12,.417,96
885,GSW,2021-01-18,115,@,LAL,W 115-113,240,44,87,.506,32,50,.640,12,37,.324,15,20,.750,115,40,83,.482,31,54,.574,9,29,.310,24,33,.727,113
886,ORL,2021-01-16,115,@,BRK,L 115-122,240,44,95,.463,30,49,.612,14,46,.304,13,16,.813,115,42,78,.538,26,43,.605,16,35,.457,22,25,.880,122
887,DEN,2021-01-09,115,@,PHI,W 115-103,240,45,90,.500,33,57,.579,12,33,.364,13,15,.867,115,43,103,.417,32,68,.471,11,35,.314,6,10,.600,103
888,GSW,2021-01-08,115,,LAC,W 115-105,240,40,82,.488,20,41,.488,20,41,.488,15,18,.833,115,40,83,.482,26,52,.500,14,31,.452,11,13,.846,105
889,MEM,2021-01-08,115,,BRK,W 115-110,240,45,98,.459,32,66,.485,13,32,.406,12,14,.857,115,38,81,.469,24,50,.480,14,31,.452,20,21,.952,110
890,CHI,2021-01-08,115,@,LAL,L 115-117,240,46,91,.505,36,65,.554,10,26,.385,13,14,.929,115,41,81,.506,29,52,.558,12,29,.414,23,27,.852,117
891,DET,2021-01-06,115,@,MIL,L 115-130,240,38,97,.392,25,56,.446,13,41,.317,26,30,.867,115,49,90,.544,30,47,.638,19,43,.442,13,21,.619,130
892,TOR,2021-01-06,115,@,PHO,L 115-123,240,39,79,.494,25,44,.568,14,35,.400,23,32,.719,115,40,83,.482,19,43,.442,21,40,.525,22,24,.917,123
893,DET,2021-01-04,115,@,MIL,L 115-125,240,43,98,.439,26,58,.448,17,40,.425,12,12,1.000,115,49,85,.576,35,51,.686,14,34,.412,13,16,.813,125
894,DEN,2020-12-29,115,@,SAC,L 115-125,240,44,81,.543,33,53,.623,11,28,.393,16,20,.800,115,46,94,.489,30,61,.492,16,33,.485,17,22,.773,125
895,CHI,2020-12-29,115,@,WAS,W 115-107,240,38,87,.437,23,51,.451,15,36,.417,24,32,.750,115,37,84,.440,27,47,.574,10,37,.270,23,26,.885,107
896,POR,2020-12-28,115,@,LAL,W 115-107,240,43,92,.467,27,46,.587,16,46,.348,13,15,.867,115,41,87,.471,31,60,.517,10,27,.370,15,18,.833,107
897,DAL,2020-12-25,115,@,LAL,L 115-138,240,41,83,.494,28,51,.549,13,32,.406,20,26,.769,115,51,91,.560,32,52,.615,19,39,.487,17,24,.708,138
898,DAL,2021-05-14,114,,TOR,W 114-110,240,39,90,.433,22,48,.458,17,42,.405,19,21,.905,114,42,85,.494,29,47,.617,13,38,.342,13,17,.765,110
899,CHI,2021-05-13,114,,TOR,W 114-102,240,45,83,.542,28,47,.596,17,36,.472,7,10,.700,114,40,90,.444,28,54,.519,12,36,.333,10,18,.556,102
900,DEN,2021-05-13,114,@,MIN,W 114-103,240,46,96,.479,34,60,.567,12,36,.333,10,11,.909,114,34,80,.425,18,39,.462,16,41,.390,19,32,.594,103
901,MIL,2021-05-11,114,,ORL,W 114-102,240,43,101,.426,35,68,.515,8,33,.242,20,27,.741,114,39,94,.415,29,64,.453,10,30,.333,14,20,.700,102
902,POR,2021-05-03,114,@,ATL,L 114-123,240,43,95,.453,26,54,.481,17,41,.415,11,14,.786,114,44,84,.524,24,43,.558,20,41,.488,15,18,.833,123
903,BRK,2021-05-02,114,@,MIL,L 114-117,240,41,96,.427,24,54,.444,17,42,.405,15,17,.882,114,48,98,.490,33,61,.541,15,37,.405,6,12,.500,117
904,LAL,2021-05-02,114,,TOR,L 114-121,240,41,85,.482,30,56,.536,11,29,.379,21,31,.677,114,42,94,.447,27,56,.482,15,38,.395,22,31,.710,121
905,GSW,2021-04-29,114,@,MIN,L 114-126,240,42,85,.494,27,47,.574,15,38,.395,15,21,.714,114,43,94,.457,23,53,.434,20,41,.488,20,29,.690,126
906,DEN,2021-04-28,114,,NOP,W 114-112,240,43,85,.506,33,53,.623,10,32,.313,18,23,.783,114,43,87,.494,31,57,.544,12,30,.400,14,19,.737,112
907,MIN,2021-04-27,114,@,HOU,W 114-107,240,45,93,.484,35,55,.636,10,38,.263,14,25,.560,114,42,86,.488,35,55,.636,7,31,.226,16,22,.727,107
908,MIL,2021-04-27,114,@,CHO,W 114-104,240,47,93,.505,38,58,.655,9,35,.257,11,14,.786,114,38,82,.463,26,47,.553,12,35,.343,16,23,.696,104
909,LAL,2021-04-26,114,@,ORL,W 114-103,240,47,87,.540,36,56,.643,11,31,.355,9,14,.643,114,36,76,.474,25,51,.490,11,25,.440,20,24,.833,103
910,TOR,2021-04-21,114,,BRK,W 114-103,240,39,90,.433,21,43,.488,18,47,.383,18,21,.857,114,36,91,.396,23,50,.460,13,41,.317,18,23,.783,103
911,GSW,2021-04-21,114,@,WAS,L 114-118,240,40,101,.396,25,56,.446,15,45,.333,19,21,.905,114,38,91,.418,28,63,.444,10,28,.357,32,38,.842,118
912,HOU,2021-04-18,114,@,ORL,W 114-110,240,42,82,.512,26,48,.542,16,34,.471,14,20,.700,114,41,91,.451,30,59,.508,11,32,.344,17,19,.895,110
913,GSW,2021-04-17,114,@,BOS,L 114-119,240,41,80,.513,24,40,.600,17,40,.425,15,20,.750,114,44,94,.468,29,48,.604,15,46,.326,16,20,.800,119
914,SAC,2021-04-15,114,@,PHO,L 114-122,240,43,78,.551,29,48,.604,14,30,.467,14,19,.737,114,48,86,.558,34,48,.708,14,38,.368,12,14,.857,122
915,DAL,2021-04-14,114,@,MEM,W 114-113,240,44,88,.500,31,48,.646,13,40,.325,13,17,.765,114,42,90,.467,29,56,.518,13,34,.382,16,21,.762,113
916,BRK,2021-04-05,114,,NYK,W 114-112,240,42,92,.457,32,60,.533,10,32,.313,20,26,.769,114,40,86,.465,26,57,.456,14,29,.483,18,22,.818,112
917,CHO,2021-04-02,114,@,IND,W 114-97,240,43,95,.453,35,64,.547,8,31,.258,20,29,.690,114,38,82,.463,28,49,.571,10,33,.303,11,19,.579,97
918,PHI,2021-04-01,114,@,CLE,W 114-94,240,40,93,.430,25,56,.446,15,37,.405,19,25,.760,114,34,80,.425,24,45,.533,10,35,.286,16,21,.762,94
919,CHO,2021-03-30,114,@,WAS,W 114-104,240,42,90,.467,28,56,.500,14,34,.412,16,19,.842,114,41,100,.410,31,63,.492,10,37,.270,12,15,.800,104
920,UTA,2021-03-29,114,,CLE,W 114-75,240,38,82,.463,19,41,.463,19,41,.463,19,23,.826,114,29,83,.349,22,49,.449,7,34,.206,10,16,.625,75
921,MEM,2021-03-26,114,@,UTA,L 114-117,240,44,97,.454,32,67,.478,12,30,.400,14,18,.778,114,45,98,.459,33,65,.508,12,33,.364,15,18,.833,117
922,MIL,2021-03-26,114,,BOS,L 114-122,240,44,99,.444,25,52,.481,19,47,.404,7,11,.636,114,43,88,.489,21,41,.512,22,47,.468,14,16,.875,122
923,OKC,2021-03-21,114,@,HOU,W 114-112,240,42,91,.462,29,52,.558,13,39,.333,17,25,.680,114,39,79,.494,25,41,.610,14,38,.368,20,27,.741,112
924,MIN,2021-03-14,114,,POR,W 114-112,240,36,73,.493,23,35,.657,13,38,.342,29,39,.744,114,39,89,.438,22,44,.500,17,45,.378,17,21,.810,112
925,CHO,2021-03-13,114,,TOR,W 114-104,240,39,81,.481,18,32,.563,21,49,.429,15,19,.789,114,37,96,.385,22,50,.440,15,46,.326,15,18,.833,104
926,UTA,2021-03-12,114,,HOU,W 114-99,240,39,81,.481,24,41,.585,15,40,.375,21,25,.840,114,41,112,.366,32,69,.464,9,43,.209,8,13,.615,99
927,NYK,2021-03-04,114,,DET,W 114-104,240,45,83,.542,36,56,.643,9,27,.333,15,19,.789,114,39,80,.488,25,44,.568,14,36,.389,12,15,.800,104
928,HOU,2021-03-03,114,,BRK,L 114-132,240,38,91,.418,20,48,.417,18,43,.419,20,28,.714,114,49,85,.576,32,50,.640,17,35,.486,17,24,.708,132
929,IND,2021-03-03,114,@,CLE,W 114-111,240,47,83,.566,39,58,.672,8,25,.320,12,16,.750,114,43,83,.518,32,55,.582,11,28,.393,14,15,.933,111
930,PHO,2021-03-02,114,@,LAL,W 114-104,240,38,77,.494,22,48,.458,16,29,.552,22,25,.880,114,40,79,.506,29,48,.604,11,31,.355,13,17,.765,104
931,IND,2021-03-01,114,@,PHI,L 114-130,240,44,91,.484,36,62,.581,8,29,.276,18,21,.857,114,50,88,.568,35,53,.660,15,35,.429,15,16,.938,130
932,NOP,2021-02-27,114,@,SAS,L 114-117,240,40,91,.440,31,59,.525,9,32,.281,25,31,.806,114,41,86,.477,29,54,.537,12,32,.375,23,28,.821,117
933,UTA,2021-02-24,114,,LAL,W 114-89,240,41,87,.471,19,39,.487,22,48,.458,10,15,.667,114,34,85,.400,26,52,.500,8,33,.242,13,20,.650,89
934,GSW,2021-02-23,114,@,NYK,W 114-106,240,40,89,.449,27,51,.529,13,38,.342,21,24,.875,114,38,97,.392,27,68,.397,11,29,.379,19,22,.864,106
935,SAC,2021-02-20,114,@,CHI,L 114-122,240,44,98,.449,36,69,.522,8,29,.276,18,22,.818,114,49,82,.598,38,59,.644,11,23,.478,13,15,.867,122
936,NOP,2021-02-19,114,,PHO,L 114-132,240,42,82,.512,31,50,.620,11,32,.344,19,24,.792,114,51,88,.580,29,49,.592,22,39,.564,8,12,.667,132
937,UTA,2021-02-17,114,@,LAC,W 114-96,240,42,98,.429,29,58,.500,13,40,.325,17,20,.850,114,38,86,.442,29,60,.483,9,26,.346,11,17,.647,96
938,BOS,2021-02-17,114,,ATL,L 114-122,240,40,86,.465,30,55,.545,10,31,.323,24,27,.889,114,44,77,.571,36,53,.679,8,24,.333,26,31,.839,122
939,OKC,2021-02-14,114,,MIL,W 114-109,240,45,95,.474,30,59,.508,15,36,.417,9,16,.563,114,45,97,.464,32,59,.542,13,38,.342,6,9,.667,109
940,ATL,2021-02-12,114,,SAS,L 114-125,240,39,90,.433,28,58,.483,11,32,.344,25,33,.758,114,45,85,.529,33,54,.611,12,31,.387,23,28,.821,125
941,MIN,2021-02-12,114,@,CHO,L 114-120,240,45,99,.455,29,58,.500,16,41,.390,8,14,.571,114,44,90,.489,31,54,.574,13,36,.361,19,19,1.000,120
942,PHI,2021-02-11,114,@,POR,L 114-118,240,42,86,.488,36,59,.610,6,27,.222,24,29,.828,114,40,93,.430,23,55,.418,17,38,.447,21,23,.913,118
943,CHO,2021-02-10,114,@,MEM,L 114-130,240,45,82,.549,31,53,.585,14,29,.483,10,12,.833,114,47,94,.500,24,45,.533,23,49,.469,13,18,.722,130
944,LAL,2021-02-10,114,,OKC,W 114-113 (OT),265,42,89,.472,32,54,.593,10,35,.286,20,24,.833,114,47,100,.470,40,69,.580,7,31,.226,12,14,.857,113
945,GSW,2021-02-09,114,@,SAS,W 114-91,240,42,91,.462,25,51,.490,17,40,.425,13,19,.684,114,32,86,.372,24,62,.387,8,24,.333,19,21,.905,91
946,DEN,2021-02-06,114,@,SAC,L 114-119,240,45,97,.464,32,62,.516,13,35,.371,11,14,.786,114,44,91,.484,30,56,.536,14,35,.400,17,24,.708,119
947,NOP,2021-02-05,114,@,IND,W 114-113,240,41,76,.539,28,51,.549,13,25,.520,19,26,.731,114,41,93,.441,21,51,.412,20,42,.476,11,16,.688,113
948,LAL,2021-02-04,114,,DEN,W 114-93,240,46,81,.568,38,57,.667,8,24,.333,14,22,.636,114,36,92,.391,28,64,.438,8,28,.286,13,15,.867,93
949,MIL,2021-01-30,114,@,CHO,L 114-126,240,40,82,.488,22,37,.595,18,45,.400,16,24,.667,114,44,92,.478,23,48,.479,21,44,.477,17,20,.850,126
950,PHO,2021-01-28,114,,GSW,W 114-93,240,41,88,.466,30,56,.536,11,32,.344,21,23,.913,114,38,99,.384,27,61,.443,11,38,.289,6,8,.750,93
951,TOR,2021-01-25,114,@,IND,L 114-129,240,38,93,.409,24,55,.436,14,38,.368,24,27,.889,114,40,78,.513,28,49,.571,12,29,.414,37,45,.822,129
952,PHI,2021-01-23,114,@,DET,W 114-110,240,38,83,.458,30,60,.500,8,23,.348,30,38,.789,114,37,86,.430,23,53,.434,14,33,.424,22,30,.733,110
953,DEN,2021-01-14,114,,GSW,W 114-104,240,41,90,.456,30,53,.566,11,37,.297,21,27,.778,114,38,81,.469,27,52,.519,11,29,.379,17,24,.708,104
954,DEN,2021-01-10,114,@,NYK,W 114-89,240,45,84,.536,30,49,.612,15,35,.429,9,12,.750,114,32,74,.432,26,53,.491,6,21,.286,19,25,.760,89
955,IND,2021-01-06,114,,HOU,W 114-107,240,42,89,.472,33,66,.500,9,23,.391,21,26,.808,114,39,81,.481,31,51,.608,8,30,.267,21,26,.808,107
956,TOR,2021-01-04,114,,BOS,L 114-126,240,36,90,.400,23,53,.434,13,37,.351,29,38,.763,114,41,84,.488,26,55,.473,15,29,.517,29,34,.853,126
957,ATL,2021-01-01,114,@,BRK,W 114-96,240,43,93,.462,27,54,.500,16,39,.410,12,14,.857,114,35,86,.407,28,49,.571,7,37,.189,19,23,.826,96
958,TOR,2020-12-26,114,@,SAS,L 114-119,240,44,96,.458,29,55,.527,15,41,.366,11,15,.733,114,47,100,.470,33,66,.500,14,34,.412,11,16,.688,119
959,CHO,2020-12-23,114,@,CLE,L 114-121,240,45,90,.500,29,46,.630,16,44,.364,8,15,.533,114,46,87,.529,32,57,.561,14,30,.467,15,20,.750,121
960,GSW,2021-05-16,113,,MEM,W 113-101,240,41,83,.494,26,44,.591,15,39,.385,16,18,.889,113,40,92,.435,34,67,.507,6,25,.240,15,19,.789,101
961,TOR,2021-05-16,113,,IND,L 113-125,240,39,97,.402,27,59,.458,12,38,.316,23,29,.793,113,48,95,.505,33,58,.569,15,37,.405,14,18,.778,125
962,LAC,2021-05-13,113,@,CHO,W 113-90,240,40,75,.533,19,30,.633,21,45,.467,12,16,.750,113,33,84,.393,24,51,.471,9,33,.273,15,19,.789,90
963,SAS,2021-05-07,113,@,SAC,W 113-104,240,46,89,.517,42,67,.627,4,22,.182,17,19,.895,113,41,84,.488,28,52,.538,13,32,.406,9,15,.600,104
964,DAL,2021-05-06,113,,BRK,W 113-109,240,40,89,.449,25,55,.455,15,34,.441,18,26,.692,113,41,95,.432,28,58,.483,13,37,.351,14,15,.933,109
965,DEN,2021-05-05,113,,NYK,W 113-97,240,37,97,.381,25,58,.431,12,39,.308,27,33,.818,113,33,86,.384,20,51,.392,13,35,.371,18,27,.667,97
966,MIA,2021-05-04,113,,DAL,L 113-127,240,39,84,.464,21,43,.488,18,41,.439,17,21,.810,113,46,87,.529,24,39,.615,22,48,.458,13,18,.722,127
967,PHI,2021-05-02,113,@,SAS,W 113-111 (OT),265,42,94,.447,31,64,.484,11,30,.367,18,25,.720,113,43,96,.448,31,65,.477,12,31,.387,13,17,.765,111
968,GSW,2021-05-01,113,@,HOU,W 113-87,240,39,84,.464,21,38,.553,18,46,.391,17,24,.708,113,32,89,.360,23,47,.489,9,42,.214,14,22,.636,87
969,IND,2021-04-29,113,,BRK,L 113-130,240,41,96,.427,30,57,.526,11,39,.282,20,21,.952,113,47,89,.528,35,54,.648,12,35,.343,24,28,.857,130
970,NYK,2021-04-28,113,,CHI,W 113-94,240,42,91,.462,30,64,.469,12,27,.444,17,19,.895,113,39,85,.459,29,56,.518,10,29,.345,6,10,.600,94
971,SAC,2021-04-26,113,,DAL,W 113-106,240,42,81,.519,29,52,.558,13,29,.448,16,18,.889,113,43,92,.467,31,50,.620,12,42,.286,8,14,.571,106
972,SAC,2021-04-25,113,@,GSW,L 113-117,240,41,86,.477,27,49,.551,14,37,.378,17,22,.773,113,46,95,.484,32,59,.542,14,36,.389,11,15,.733,117
973,POR,2021-04-25,113,,MEM,L 113-120,240,39,105,.371,25,67,.373,14,38,.368,21,25,.840,113,42,91,.462,30,68,.441,12,23,.522,24,28,.857,120
974,PHI,2021-04-21,113,,PHO,L 113-116,240,41,80,.513,28,55,.509,13,25,.520,18,26,.692,113,41,86,.477,26,44,.591,15,42,.357,19,21,.905,116
975,LAC,2021-04-20,113,@,POR,W 113-112,240,45,90,.500,34,52,.654,11,38,.289,12,15,.800,113,42,94,.447,28,50,.560,14,44,.318,14,19,.737,112
976,MIA,2021-04-19,113,,HOU,W 113-91,240,45,93,.484,26,45,.578,19,48,.396,4,7,.571,113,33,85,.388,24,47,.511,9,38,.237,16,17,.941,91
977,TOR,2021-04-16,113,,ORL,W 113-102,240,41,82,.500,27,47,.574,14,35,.400,17,18,.944,113,35,77,.455,27,54,.500,8,23,.348,24,34,.706,102
978,LAL,2021-04-15,113,,BOS,L 113-121,240,44,98,.449,32,61,.525,12,37,.324,13,19,.684,113,48,85,.565,34,53,.642,14,32,.438,11,13,.846,121
979,MEM,2021-04-14,113,,DAL,L 113-114,240,42,90,.467,29,56,.518,13,34,.382,16,21,.762,113,44,88,.500,31,48,.646,13,40,.325,13,17,.765,114
980,PHI,2021-04-12,113,@,DAL,W 113-95,240,39,80,.488,27,49,.551,12,31,.387,23,33,.697,113,35,83,.422,26,47,.553,9,36,.250,16,20,.800,95
981,DET,2021-04-08,113,@,SAC,W 113-101,240,44,84,.524,36,61,.590,8,23,.348,17,20,.850,113,38,86,.442,31,56,.554,7,30,.233,18,26,.692,101
982,TOR,2021-04-08,113,,CHI,L 113-122,240,42,97,.433,31,63,.492,11,34,.324,18,22,.818,113,47,87,.540,35,57,.614,12,30,.400,16,18,.889,122
983,LAC,2021-04-08,113,,PHO,W 113-103,240,42,84,.500,24,47,.511,18,37,.486,11,12,.917,113,36,71,.507,30,47,.638,6,24,.250,25,30,.833,103
984,UTA,2021-04-07,113,@,PHO,L 113-117 (OT),265,46,103,.447,35,59,.593,11,44,.250,10,15,.667,113,45,101,.446,34,67,.507,11,34,.324,16,20,.800,117
985,CHO,2021-04-07,113,@,OKC,W 113-102,240,43,97,.443,28,53,.528,15,44,.341,12,13,.923,113,37,85,.435,21,44,.477,16,41,.390,12,17,.706,102
986,ATL,2021-04-07,113,,MEM,L 113-131,240,45,101,.446,35,73,.479,10,28,.357,13,15,.867,113,48,89,.539,31,49,.633,17,40,.425,18,21,.857,131
987,CHI,2021-04-06,113,@,IND,W 113-97,240,44,94,.468,30,61,.492,14,33,.424,11,14,.786,113,38,88,.432,29,58,.500,9,30,.300,12,16,.750,97
988,MIN,2021-04-03,113,@,PHI,L 113-122,240,35,78,.449,23,42,.548,12,36,.333,31,36,.861,113,41,81,.506,29,53,.547,12,28,.429,28,37,.757,122
989,UTA,2021-04-02,113,,CHI,W 113-106,240,37,79,.468,24,43,.558,13,36,.361,26,27,.963,113,43,89,.483,36,61,.590,7,28,.250,13,17,.765,106
990,OKC,2021-03-31,113,,TOR,W 113-103,240,39,86,.453,25,53,.472,14,33,.424,21,28,.750,113,35,90,.389,19,44,.432,16,46,.348,17,20,.850,103
991,DAL,2021-03-31,113,@,BOS,W 113-108,240,38,77,.494,19,38,.500,19,39,.487,18,25,.720,113,39,94,.415,28,47,.596,11,47,.234,19,23,.826,108
992,DEN,2021-03-26,113,@,NOP,W 113-108,240,47,93,.505,33,65,.508,14,28,.500,5,7,.714,113,39,78,.500,27,49,.551,12,29,.414,18,20,.900,108
993,BRK,2021-03-26,113,@,DET,W 113-111,240,37,84,.440,24,51,.471,13,33,.394,26,34,.765,113,33,73,.452,22,42,.524,11,31,.355,34,47,.723,111
994,WAS,2021-03-23,113,@,NYK,L 113-131,240,38,79,.481,29,56,.518,9,23,.391,28,35,.800,113,47,92,.511,31,62,.500,16,30,.533,21,24,.875,131
995,IND,2021-03-22,113,@,MIL,L 113-140,240,45,111,.405,33,61,.541,12,50,.240,11,12,.917,113,53,94,.564,29,55,.527,24,39,.615,10,15,.667,140
996,NOP,2021-03-21,113,@,DEN,W 113-108,240,41,85,.482,33,57,.579,8,28,.286,23,30,.767,113,44,88,.500,32,54,.593,12,34,.353,8,10,.800,108
997,BRK,2021-03-21,113,,WAS,W 113-106,240,44,90,.489,35,61,.574,9,29,.310,16,22,.727,113,42,79,.532,35,58,.603,7,21,.333,15,19,.789,106
998,SAS,2021-03-20,113,@,MIL,L 113-120,240,46,96,.479,34,63,.540,12,33,.364,9,10,.900,113,45,92,.489,31,54,.574,14,38,.368,16,18,.889,120
999,DET,2021-03-19,113,@,HOU,W 113-100,240,37,85,.435,23,56,.411,14,29,.483,25,28,.893,113,39,88,.443,30,56,.536,9,32,.281,13,16,.813,100
1000,BRK,2021-03-19,113,@,ORL,L 113-121,240,43,91,.473,33,54,.611,10,37,.270,17,23,.739,113,43,84,.512,22,44,.500,21,40,.525,14,20,.700,121
1001,PHO,2021-03-19,113,,MIN,W 113-101,240,43,86,.500,29,59,.492,14,27,.519,13,17,.765,113,37,79,.468,24,44,.545,13,35,.371,14,18,.778,101
1002,MIA,2021-03-16,113,,CLE,W 113-98,240,42,85,.494,32,58,.552,10,27,.370,19,21,.905,113,39,86,.453,29,51,.569,10,35,.286,10,14,.714,98
1003,DEN,2021-03-04,113,@,IND,W 113-103,240,45,77,.584,33,49,.673,12,28,.429,11,16,.688,113,41,90,.456,27,51,.529,14,39,.359,7,12,.583,103
1004,SAS,2021-03-01,113,,BRK,L 113-124 (OT),265,44,97,.454,29,62,.468,15,35,.429,10,15,.667,113,47,100,.470,30,59,.508,17,41,.415,13,17,.765,124
1005,OKC,2021-02-17,113,@,MEM,L 113-122,240,35,78,.449,16,37,.432,19,41,.463,24,28,.857,113,42,83,.506,30,57,.526,12,26,.462,26,33,.788,122
1006,HOU,2021-02-17,113,@,PHI,L 113-118,240,42,92,.457,27,45,.600,15,47,.319,14,18,.778,113,39,81,.481,27,55,.491,12,26,.462,28,32,.875,118
1007,MIL,2021-02-16,113,,TOR,L 113-124,240,40,83,.482,26,46,.565,14,37,.378,19,25,.760,113,46,91,.505,29,48,.604,17,43,.395,15,21,.714,124
1008,MEM,2021-02-16,113,,NOP,L 113-144,240,42,88,.477,29,57,.509,13,31,.419,16,18,.889,113,56,91,.615,37,53,.698,19,38,.500,13,17,.765,144
1009,ATL,2021-02-13,113,,IND,L 113-125,240,43,90,.478,34,59,.576,9,31,.290,18,23,.783,113,45,89,.506,33,58,.569,12,31,.387,23,27,.852,125
1010,OKC,2021-02-10,113,@,LAL,L 113-114 (OT),265,47,100,.470,40,69,.580,7,31,.226,12,14,.857,113,42,89,.472,32,54,.593,10,35,.286,20,24,.833,114
1011,MEM,2021-02-08,113,,TOR,L 113-128,240,37,87,.425,24,48,.500,13,39,.333,26,29,.897,113,42,77,.545,22,40,.550,20,37,.541,24,26,.923,128
1012,CLE,2021-02-08,113,@,PHO,L 113-119,240,44,86,.512,36,62,.581,8,24,.333,17,25,.680,113,47,90,.522,36,66,.545,11,24,.458,14,19,.737,119
1013,SAC,2021-02-07,113,@,LAC,W 113-110,240,46,94,.489,36,65,.554,10,29,.345,11,15,.733,113,41,99,.414,33,71,.465,8,28,.286,20,23,.870,110
1014,IND,2021-02-05,113,,NOP,L 113-114,240,41,93,.441,21,51,.412,20,42,.476,11,16,.688,113,41,76,.539,28,51,.549,13,25,.520,19,26,.731,114
1015,DAL,2021-01-25,113,,DEN,L 113-117,240,41,84,.488,30,52,.577,11,32,.344,20,24,.833,113,40,79,.506,25,44,.568,15,35,.429,22,28,.786,117
1016,NYK,2021-01-24,113,@,POR,L 113-116,240,39,86,.453,27,57,.474,12,29,.414,23,25,.920,113,39,83,.470,22,37,.595,17,46,.370,21,23,.913,116
1017,BRK,2021-01-22,113,@,CLE,L 113-125,240,42,87,.483,28,44,.636,14,43,.326,15,17,.882,113,45,87,.517,37,62,.597,8,25,.320,27,32,.844,125
1018,LAL,2021-01-21,113,@,MIL,W 113-106,240,41,88,.466,22,51,.431,19,37,.514,12,15,.800,113,44,87,.506,35,59,.593,9,28,.321,9,12,.750,106
1019,MIA,2021-01-18,113,,DET,W 113-107,240,43,75,.573,31,45,.689,12,30,.400,15,19,.789,113,38,82,.463,25,45,.556,13,37,.351,18,24,.750,107
1020,LAL,2021-01-18,113,,GSW,L 113-115,240,40,83,.482,31,54,.574,9,29,.310,24,33,.727,113,44,87,.506,32,50,.640,12,37,.324,15,20,.750,115
1021,CHO,2021-01-16,113,@,TOR,L 113-116,240,38,87,.437,23,51,.451,15,36,.417,22,29,.759,113,36,86,.419,15,37,.405,21,49,.429,23,26,.885,116
1022,CHO,2021-01-09,113,,ATL,W 113-105,240,40,77,.519,25,44,.568,15,33,.455,18,24,.750,113,34,89,.382,20,44,.455,14,45,.311,23,28,.821,105
1023,LAC,2021-01-05,113,,SAS,L 113-116,240,43,86,.500,28,51,.549,15,35,.429,12,13,.923,113,44,96,.458,24,56,.429,20,40,.500,8,11,.727,116
1024,NYK,2021-01-04,113,@,ATL,W 113-108,240,43,85,.506,36,64,.563,7,21,.333,20,25,.800,113,40,87,.460,30,56,.536,10,31,.323,18,23,.783,108
1025,DAL,2021-01-04,113,@,HOU,W 113-100,240,39,82,.476,23,43,.535,16,39,.410,19,20,.950,113,30,77,.390,19,37,.514,11,40,.275,29,36,.806,100
1026,NOP,2020-12-31,113,@,OKC,W 113-80,240,44,91,.484,31,55,.564,13,36,.361,12,19,.632,113,30,80,.375,15,32,.469,15,48,.313,5,15,.333,80
1027,WAS,2020-12-27,113,,ORL,L 113-120,240,47,97,.485,39,65,.600,8,32,.250,11,13,.846,113,37,85,.435,28,60,.467,9,25,.360,37,38,.974,120
1028,NOP,2020-12-23,113,@,TOR,W 113-99,240,42,80,.525,23,38,.605,19,42,.452,10,20,.500,113,38,89,.427,24,43,.558,14,46,.304,9,12,.750,99
1029,ORL,2020-12-23,113,,MIA,W 113-107,240,42,88,.477,32,60,.533,10,28,.357,19,30,.633,113,42,83,.506,35,63,.556,7,20,.350,16,19,.842,107
1030,PHI,2020-12-23,113,,WAS,W 113-107,240,41,87,.471,33,59,.559,8,28,.286,23,30,.767,113,39,85,.459,26,58,.448,13,27,.481,16,23,.696,107
1031,MIL,2021-05-16,112,@,CHI,L 112-118,240,38,90,.422,26,53,.491,12,37,.324,24,32,.750,112,45,87,.517,31,55,.564,14,32,.438,14,19,.737,118
1032,LAC,2021-05-16,112,@,OKC,L 112-117,240,45,106,.425,35,63,.556,10,43,.233,12,15,.800,112,50,94,.532,42,68,.618,8,26,.308,9,16,.563,117
1033,CHO,2021-05-11,112,,DEN,L 112-117,240,42,91,.462,31,52,.596,11,39,.282,17,20,.850,112,41,83,.494,28,50,.560,13,33,.394,22,26,.846,117
1034,NOP,2021-05-09,112,@,CHO,W 112-110,240,45,96,.469,33,59,.559,12,37,.324,10,22,.455,112,42,95,.442,29,58,.500,13,37,.351,13,18,.722,110
1035,ORL,2021-05-07,112,@,CHO,L 112-122,240,41,98,.418,32,68,.471,9,30,.300,21,28,.750,112,44,89,.494,35,56,.625,9,33,.273,25,33,.758,122
1036,MIN,2021-05-07,112,@,MIA,L 112-121,240,41,85,.482,31,48,.646,10,37,.270,20,30,.667,112,44,87,.506,31,55,.564,13,32,.406,20,27,.741,121
1037,DET,2021-05-03,112,,ORL,L 112-119,240,44,93,.473,33,58,.569,11,35,.314,13,18,.722,112,45,88,.511,35,65,.538,10,23,.435,19,25,.760,119
1038,ORL,2021-05-01,112,,MEM,W 112-111,240,38,85,.447,27,60,.450,11,25,.440,25,28,.893,112,44,96,.458,34,67,.507,10,29,.345,13,21,.619,111
1039,NOP,2021-04-28,112,@,DEN,L 112-114,240,43,87,.494,31,57,.544,12,30,.400,14,19,.737,112,43,85,.506,33,53,.623,10,32,.313,18,23,.783,114
1040,IND,2021-04-27,112,,POR,L 112-133,240,40,86,.465,30,56,.536,10,30,.333,22,28,.786,112,50,106,.472,30,71,.423,20,35,.571,13,16,.813,133
1041,TOR,2021-04-26,112,,CLE,W 112-96,240,43,79,.544,35,50,.700,8,29,.276,18,20,.900,112,36,83,.434,26,45,.578,10,38,.263,14,16,.875,96
1042,ORL,2021-04-25,112,,IND,L 112-131,240,40,101,.396,30,69,.435,10,32,.313,22,28,.786,112,50,91,.549,35,59,.593,15,32,.469,16,18,.889,131
1043,UTA,2021-04-21,112,@,HOU,W 112-89,240,41,90,.456,24,44,.545,17,46,.370,13,16,.813,112,35,99,.354,25,50,.500,10,49,.204,9,17,.529,89
1044,POR,2021-04-20,112,,LAC,L 112-113,240,42,94,.447,28,50,.560,14,44,.318,14,19,.737,112,45,90,.500,34,52,.654,11,38,.289,12,15,.800,113
1045,ATL,2021-04-20,112,,ORL,W 112-96,240,39,94,.415,30,60,.500,9,34,.265,25,29,.862,112,34,86,.395,26,49,.531,8,37,.216,20,29,.690,96
1046,NOP,2021-04-18,112,@,NYK,L 112-122 (OT),265,41,101,.406,35,74,.473,6,27,.222,24,30,.800,112,45,95,.474,34,66,.515,11,29,.379,21,24,.875,122
1047,TOR,2021-04-18,112,,OKC,W 112-106,240,37,96,.385,20,58,.345,17,38,.447,21,24,.875,112,37,82,.451,23,49,.469,14,33,.424,18,21,.857,106
1048,SAS,2021-04-14,112,@,TOR,L 112-117,240,38,89,.427,21,50,.420,17,39,.436,19,27,.704,112,41,88,.466,27,58,.466,14,30,.467,21,25,.840,117
1049,SAC,2021-04-10,112,@,UTA,L 112-128,240,42,88,.477,28,46,.609,14,42,.333,14,22,.636,112,40,88,.455,22,38,.579,18,50,.360,30,35,.857,128
1050,MIA,2021-04-06,112,,MEM,L 112-124,240,44,82,.537,31,49,.633,13,33,.394,11,18,.611,112,46,84,.548,29,43,.674,17,41,.415,15,20,.750,124
1051,NYK,2021-04-05,112,@,BRK,L 112-114,240,40,86,.465,26,57,.456,14,29,.483,18,22,.818,112,42,92,.457,32,60,.533,10,32,.313,20,26,.769,114
1052,MIL,2021-03-31,112,@,LAL,W 112-97,240,42,79,.532,28,53,.528,14,26,.538,14,18,.778,112,35,87,.402,25,51,.490,10,36,.278,17,22,.773,97
1053,BRK,2021-03-29,112,,MIN,W 112-107,240,40,85,.471,30,55,.545,10,30,.333,22,25,.880,112,40,103,.388,26,59,.441,14,44,.318,13,17,.765,107
1054,NOP,2021-03-27,112,,DAL,W 112-103,240,42,81,.519,33,55,.600,9,26,.346,19,29,.655,112,37,83,.446,27,52,.519,10,31,.323,19,24,.792,103
1055,PHI,2021-03-27,112,@,LAC,L 112-122,240,39,77,.506,29,51,.569,10,26,.385,24,33,.727,112,45,85,.529,34,59,.576,11,26,.423,21,27,.778,122
1056,POR,2021-03-26,112,@,ORL,W 112-105,240,40,85,.471,22,45,.489,18,40,.450,14,21,.667,112,42,95,.442,30,68,.441,12,27,.444,9,17,.529,105
1057,ORL,2021-03-24,112,,PHO,W 112-111,240,42,90,.467,29,53,.547,13,37,.351,15,19,.789,112,40,90,.444,29,57,.509,11,33,.333,20,22,.909,111
1058,POR,2021-03-23,112,,BRK,L 112-116,240,36,90,.400,17,35,.486,19,55,.345,21,23,.913,112,43,87,.494,34,57,.596,9,30,.300,21,27,.778,116
1059,OKC,2021-03-22,112,@,MIN,W 112-103,240,41,87,.471,20,50,.400,21,37,.568,9,10,.900,112,38,92,.413,24,53,.453,14,39,.359,13,18,.722,103
1060,HOU,2021-03-21,112,,OKC,L 112-114,240,39,79,.494,25,41,.610,14,38,.368,20,27,.741,112,42,91,.462,29,52,.558,13,39,.333,17,25,.680,114
1061,BOS,2021-03-21,112,,ORL,W 112-96,240,40,88,.455,17,33,.515,23,55,.418,9,9,1.000,112,32,84,.381,21,50,.420,11,34,.324,21,30,.700,96
1062,TOR,2021-03-19,112,,UTA,L 112-115,240,40,83,.482,19,39,.487,21,44,.477,11,14,.786,112,34,74,.459,22,37,.595,12,37,.324,35,41,.854,115
1063,TOR,2021-03-17,112,@,DET,L 112-116,240,37,86,.430,25,46,.543,12,40,.300,26,34,.765,112,38,75,.507,26,46,.565,12,29,.414,28,32,.875,116
1064,NYK,2021-03-15,112,@,BRK,L 112-117,240,37,92,.402,22,50,.440,15,42,.357,23,27,.852,112,44,76,.579,32,47,.681,12,29,.414,17,22,.773,117
1065,POR,2021-03-14,112,@,MIN,L 112-114,240,39,89,.438,22,44,.500,17,45,.378,17,21,.810,112,36,73,.493,23,35,.657,13,38,.342,29,39,.744,114
1066,WAS,2021-03-10,112,@,MEM,L 112-127,240,38,95,.400,27,59,.458,11,36,.306,25,27,.926,112,50,99,.505,42,76,.553,8,23,.348,19,29,.655,127
1067,MIL,2021-03-04,112,@,MEM,W 112-111,240,42,95,.442,32,61,.525,10,34,.294,18,22,.818,112,40,101,.396,32,67,.478,8,34,.235,23,24,.958,111
1068,ORL,2021-03-03,112,,ATL,L 112-115,240,36,84,.429,23,49,.469,13,35,.371,27,27,1.000,112,38,85,.447,17,40,.425,21,45,.467,18,19,.947,115
1069,LAC,2021-03-02,112,@,BOS,L 112-117,240,43,87,.494,25,49,.510,18,38,.474,8,9,.889,112,42,86,.488,26,54,.481,16,32,.500,17,23,.739,117
1070,CHI,2021-03-01,112,,DEN,L 112-118,240,42,94,.447,30,56,.536,12,38,.316,16,22,.727,112,46,87,.529,36,60,.600,10,27,.370,16,20,.800,118
1071,MIN,2021-02-27,112,@,WAS,L 112-128,240,41,95,.432,30,60,.500,11,35,.314,19,29,.655,112,44,98,.449,31,65,.477,13,33,.394,27,34,.794,128
1072,CLE,2021-02-27,112,@,PHI,W 112-109 (OT),265,41,97,.423,33,73,.452,8,24,.333,22,29,.759,112,38,83,.458,28,55,.509,10,28,.357,23,35,.657,109
1073,IND,2021-02-26,112,@,BOS,L 112-118,240,35,89,.393,20,43,.465,15,46,.326,27,29,.931,112,42,82,.512,33,60,.550,9,22,.409,25,29,.862,118
1074,WAS,2021-02-25,112,@,DEN,W 112-110,240,41,86,.477,33,60,.550,8,26,.308,22,25,.880,112,37,85,.435,22,47,.468,15,38,.395,21,24,.875,110
1075,BOS,2021-02-24,112,@,ATL,L 112-127,240,42,95,.442,34,64,.531,8,31,.258,20,23,.870,112,45,85,.529,22,43,.512,23,42,.548,14,17,.824,127
1076,CLE,2021-02-24,112,,HOU,W 112-96,240,43,85,.506,27,49,.551,16,36,.444,10,15,.667,112,36,90,.400,26,57,.456,10,33,.303,14,17,.824,96
1077,MIN,2021-02-23,112,@,MIL,L 112-139,240,42,98,.429,23,44,.523,19,54,.352,9,9,1.000,112,53,99,.535,33,57,.579,20,42,.476,13,18,.722,139
1078,CLE,2021-02-23,112,,ATL,W 112-111,240,41,78,.526,26,50,.520,15,28,.536,15,19,.789,112,40,89,.449,26,58,.448,14,31,.452,17,23,.739,111
1079,BRK,2021-02-21,112,@,LAC,W 112-108,240,44,92,.478,33,54,.611,11,38,.289,13,19,.684,112,40,87,.460,25,52,.481,15,35,.429,13,18,.722,108
1080,UTA,2021-02-19,112,@,LAC,L 112-116,240,41,86,.477,29,52,.558,12,34,.353,18,21,.857,112,43,89,.483,33,59,.559,10,30,.333,20,22,.909,116
1081,PHI,2021-02-19,112,,CHI,W 112-105,240,41,87,.471,34,66,.515,7,21,.333,23,29,.793,112,40,95,.421,33,63,.524,7,32,.219,18,18,1.000,105
1082,MIA,2021-02-17,112,@,GSW,L 112-120 (OT),265,44,97,.454,31,61,.508,13,36,.361,11,12,.917,112,43,95,.453,25,43,.581,18,52,.346,16,21,.762,120
1083,LAL,2021-02-16,112,@,MIN,W 112-104,240,42,77,.545,31,51,.608,11,26,.423,17,21,.810,112,39,93,.419,23,59,.390,16,34,.471,10,13,.769,104
1084,BOS,2021-02-16,112,,DEN,W 112-99,240,39,81,.481,24,39,.615,15,42,.357,19,21,.905,112,38,84,.452,29,50,.580,9,34,.265,14,15,.933,99
1085,IND,2021-02-15,112,,CHI,L 112-120 (OT),265,39,92,.424,30,59,.508,9,33,.273,25,31,.806,112,44,102,.431,31,69,.449,13,33,.394,19,22,.864,120
1086,ATL,2021-02-15,112,@,NYK,L 112-123,240,36,85,.424,25,52,.481,11,33,.333,29,32,.906,112,42,83,.506,25,49,.510,17,34,.500,22,27,.815,123
1087,TOR,2021-02-14,112,,MIN,L 112-116,240,38,91,.418,28,58,.483,10,33,.303,26,31,.839,112,43,82,.524,27,43,.628,16,39,.410,14,19,.737,116
1088,NOP,2021-02-14,112,@,DET,L 112-123,240,40,90,.444,31,55,.564,9,35,.257,23,28,.821,112,45,84,.536,28,49,.571,17,35,.486,16,20,.800,123
1089,UTA,2021-02-13,112,,MIA,W 112-94,240,39,85,.459,27,39,.692,12,46,.261,22,29,.759,112,35,86,.407,23,50,.460,12,36,.333,12,17,.706,94
1090,SAC,2021-02-12,112,,ORL,L 112-123,240,43,83,.518,31,50,.620,12,33,.364,14,19,.737,112,46,91,.505,31,57,.544,15,34,.441,16,20,.800,123
1091,MIN,2021-02-10,112,,LAC,L 112-119,240,41,95,.432,26,54,.481,15,41,.366,15,19,.789,112,41,82,.500,29,59,.492,12,23,.522,25,29,.862,119
1092,OKC,2021-02-08,112,@,LAL,L 112-119 (OT),265,43,110,.391,31,72,.431,12,38,.316,14,19,.737,112,44,95,.463,35,57,.614,9,38,.237,22,29,.759,119
1093,DEN,2021-02-08,112,,MIL,L 112-125,240,41,94,.436,26,58,.448,15,36,.417,15,16,.938,112,45,89,.506,29,49,.592,16,40,.400,19,22,.864,125
1094,UTA,2021-02-04,112,@,ATL,W 112-91,240,44,91,.484,31,64,.484,13,27,.481,11,13,.846,112,32,98,.327,23,67,.343,9,31,.290,18,19,.947,91
1095,SAS,2021-01-30,112,,MEM,L 112-129,240,39,83,.470,26,54,.481,13,29,.448,21,26,.808,112,51,91,.560,34,56,.607,17,35,.486,10,15,.667,129
1096,NOP,2021-01-30,112,,HOU,L 112-126,240,41,91,.451,29,50,.580,12,41,.293,18,29,.621,112,45,92,.489,25,46,.543,20,46,.435,16,20,.800,126
1097,PHO,2021-01-23,112,,DEN,L 112-120 (2OT),290,41,102,.402,25,49,.510,16,53,.302,14,18,.778,112,40,97,.412,25,61,.410,15,36,.417,25,32,.781,120
1098,IND,2021-01-20,112,,DAL,L 112-124,240,41,92,.446,25,53,.472,16,39,.410,14,21,.667,112,51,97,.526,43,70,.614,8,27,.296,14,17,.824,124
1099,POR,2021-01-16,112,,ATL,W 112-106,240,40,103,.388,25,59,.424,15,44,.341,17,20,.850,112,38,87,.437,32,57,.561,6,30,.200,24,28,.857,106
1100,LAL,2021-01-15,112,,NOP,W 112-95,240,39,93,.419,24,56,.429,15,37,.405,19,26,.731,112,41,86,.477,32,57,.561,9,29,.310,4,8,.500,95
1101,MIL,2021-01-15,112,,DAL,W 112-109,240,43,96,.448,29,59,.492,14,37,.378,12,25,.480,112,45,97,.464,32,61,.525,13,36,.361,6,13,.462,109
1102,SAS,2021-01-12,112,@,OKC,W 112-102,240,41,95,.432,31,60,.517,10,35,.286,20,22,.909,112,36,83,.434,29,57,.509,7,26,.269,23,29,.793,102
1103,POR,2021-01-11,112,,TOR,W 112-111,240,38,83,.458,24,41,.585,14,42,.333,22,25,.880,112,40,89,.449,21,42,.500,19,47,.404,12,12,1.000,111
1104,ATL,2021-01-11,112,,PHI,W 112-94,240,37,99,.374,20,55,.364,17,44,.386,21,27,.778,112,37,92,.402,29,56,.518,8,36,.222,12,13,.923,94
1105,DAL,2021-01-09,112,,ORL,W 112-98,240,39,79,.494,19,39,.487,20,40,.500,14,18,.778,112,38,89,.427,32,58,.552,6,31,.194,16,22,.727,98
1106,NYK,2021-01-06,112,,UTA,W 112-100,240,45,87,.517,37,65,.569,8,22,.364,14,19,.737,112,40,91,.440,26,47,.553,14,44,.318,6,11,.545,100
1107,LAC,2021-01-03,112,@,PHO,W 112-107,240,40,83,.482,23,54,.426,17,29,.586,15,19,.789,112,37,75,.493,27,42,.643,10,33,.303,23,28,.821,107
1108,CHO,2021-01-02,112,@,PHI,L 112-127,240,38,92,.413,25,57,.439,13,35,.371,23,26,.885,112,47,79,.595,31,44,.705,16,35,.457,17,24,.708,127
1109,MEM,2020-12-26,112,,ATL,L 112-122,240,37,93,.398,24,50,.480,13,43,.302,25,29,.862,112,38,89,.427,25,53,.472,13,36,.361,33,38,.868,122
1110,IND,2021-05-10,111,@,CLE,W 111-102,240,44,88,.500,33,61,.541,11,27,.407,12,16,.750,111,33,93,.355,20,54,.370,13,39,.333,23,30,.767,102
1111,DET,2021-05-06,111,,MEM,W 111-97,240,44,83,.530,33,55,.600,11,28,.393,12,14,.857,111,38,89,.427,28,52,.538,10,37,.270,11,17,.647,97
1112,CHO,2021-05-02,111,,MIA,L 111-121,240,40,81,.494,26,48,.542,14,33,.424,17,22,.773,111,45,88,.511,34,50,.680,11,38,.289,20,27,.741,121
1113,SAC,2021-05-02,111,@,DAL,W 111-99,240,45,81,.556,34,53,.642,11,28,.393,10,16,.625,111,34,81,.420,28,46,.609,6,35,.171,25,31,.806,99
1114,SAS,2021-05-02,111,,PHI,L 111-113 (OT),265,43,96,.448,31,65,.477,12,31,.387,13,17,.765,111,42,94,.447,31,64,.484,11,30,.367,18,25,.720,113
1115,MEM,2021-05-01,111,@,ORL,L 111-112,240,44,96,.458,34,67,.507,10,29,.345,13,21,.619,111,38,85,.447,27,60,.450,11,25,.440,25,28,.893,112
1116,TOR,2021-04-29,111,@,DEN,L 111-121,240,40,83,.482,24,51,.471,16,32,.500,15,18,.833,111,44,93,.473,32,58,.552,12,35,.343,21,26,.808,121
1117,SAS,2021-04-28,111,@,MIA,L 111-116,240,41,88,.466,31,56,.554,10,32,.313,19,24,.792,111,43,85,.506,34,60,.567,9,25,.360,21,24,.875,116
1118,CHO,2021-04-28,111,@,BOS,L 111-120,240,37,87,.425,24,52,.462,13,35,.371,24,32,.750,111,44,92,.478,29,52,.558,15,40,.375,17,22,.773,120
1119,ATL,2021-04-25,111,,MIL,W 111-104,240,40,88,.455,27,53,.509,13,35,.371,18,23,.783,111,39,81,.481,31,53,.585,8,28,.286,18,23,.783,104
1120,UTA,2021-04-19,111,@,LAL,W 111-97,240,43,75,.573,28,42,.667,15,33,.455,10,11,.909,111,34,79,.430,22,51,.431,12,28,.429,17,25,.680,97
1121,SAS,2021-04-17,111,@,PHO,W 111-85,240,45,89,.506,33,60,.550,12,29,.414,9,12,.750,111,36,90,.400,30,63,.476,6,27,.222,7,16,.438,85
1122,IND,2021-04-16,111,@,UTA,L 111-119,240,41,105,.390,28,66,.424,13,39,.333,16,17,.941,111,42,87,.483,26,45,.578,16,42,.381,19,24,.792,119
1123,MIA,2021-04-16,111,@,MIN,L 111-119,240,39,80,.488,25,46,.543,14,34,.412,19,26,.731,111,42,81,.519,27,45,.600,15,36,.417,20,29,.690,119
1124,SAC,2021-04-14,111,,WAS,L 111-123,240,42,91,.462,33,64,.516,9,27,.333,18,24,.750,111,47,90,.522,40,66,.606,7,24,.292,22,27,.815,123
1125,NYK,2021-04-12,111,,LAL,W 111-96,240,42,89,.472,37,62,.597,5,27,.185,22,27,.815,111,35,80,.438,23,44,.523,12,36,.333,14,18,.778,96
1126,IND,2021-04-09,111,@,ORL,W 111-106,240,38,92,.413,27,59,.458,11,33,.333,24,28,.857,111,38,90,.422,32,66,.485,6,24,.250,24,31,.774,106
1127,NOP,2021-04-07,111,@,BRK,L 111-139,240,38,89,.427,32,62,.516,6,27,.222,29,39,.744,111,51,92,.554,32,51,.627,19,41,.463,18,22,.818,139
1128,DAL,2021-04-05,111,,UTA,W 111-103,240,41,91,.451,18,42,.429,23,49,.469,6,8,.750,111,37,88,.420,25,44,.568,12,44,.273,17,22,.773,103
1129,GSW,2021-04-04,111,@,ATL,L 111-117,240,43,92,.467,33,52,.635,10,40,.250,15,21,.714,111,35,81,.432,23,49,.469,12,32,.375,35,45,.778,117
1130,BRK,2021-04-01,111,,CHO,W 111-89,240,44,91,.484,24,46,.522,20,45,.444,3,4,.750,111,30,86,.349,17,48,.354,13,38,.342,16,19,.842,89
1131,UTA,2021-03-31,111,@,MEM,W 111-107,240,38,89,.427,22,40,.550,16,49,.327,19,25,.760,111,42,90,.467,37,72,.514,5,18,.278,18,23,.783,107
1132,BOS,2021-03-27,111,@,OKC,W 111-94,240,44,96,.458,32,58,.552,12,38,.316,11,14,.786,111,34,83,.410,23,45,.511,11,38,.289,15,24,.625,94
1133,DET,2021-03-26,111,,BRK,L 111-113,240,33,73,.452,22,42,.524,11,31,.355,34,47,.723,111,37,84,.440,24,51,.471,13,33,.394,26,34,.765,113
1134,DET,2021-03-24,111,@,IND,L 111-116,240,44,83,.530,33,55,.600,11,28,.393,12,19,.632,111,45,97,.464,30,63,.476,15,34,.441,11,14,.786,116
1135,DEN,2021-03-24,111,@,TOR,L 111-135,240,41,98,.418,27,55,.491,14,43,.326,15,18,.833,111,45,89,.506,21,41,.512,24,48,.500,21,23,.913,135
1136,PHO,2021-03-24,111,@,ORL,L 111-112,240,40,90,.444,29,57,.509,11,33,.333,20,22,.909,111,42,90,.467,29,53,.547,13,37,.351,15,19,.789,112
1137,LAL,2021-03-23,111,@,NOP,L 111-128,240,36,85,.424,18,48,.375,18,37,.486,21,30,.700,111,47,90,.522,37,61,.607,10,29,.345,24,26,.923,128
1138,PHO,2021-03-21,111,,LAL,W 111-94,240,42,87,.483,33,55,.600,9,32,.281,18,23,.783,111,35,85,.412,30,60,.500,5,25,.200,19,28,.679,94
1139,MEM,2021-03-20,111,,GSW,W 111-103,240,37,95,.389,27,63,.429,10,32,.313,27,31,.871,111,31,90,.344,18,49,.367,13,41,.317,28,34,.824,103
1140,PHO,2021-03-13,111,,IND,L 111-122,240,43,91,.473,31,60,.517,12,31,.387,13,17,.765,111,46,87,.529,33,59,.559,13,28,.464,17,21,.810,122
1141,MIA,2021-03-11,111,,ORL,W 111-103,240,41,91,.451,25,42,.595,16,49,.327,13,22,.591,111,39,96,.406,27,62,.435,12,34,.353,13,15,.867,103
1142,MEM,2021-03-04,111,,MIL,L 111-112,240,40,101,.396,32,67,.478,8,34,.235,23,24,.958,111,42,95,.442,32,61,.525,10,34,.294,18,22,.818,112
1143,CLE,2021-03-03,111,,IND,L 111-114,240,43,83,.518,32,55,.582,11,28,.393,14,15,.933,111,47,83,.566,39,58,.672,8,25,.320,12,16,.750,114
1144,WAS,2021-03-02,111,,MEM,L 111-125,240,41,81,.506,30,50,.600,11,31,.355,18,25,.720,111,47,95,.495,34,66,.515,13,29,.448,18,23,.783,125
1145,CHO,2021-03-01,111,@,POR,L 111-123,240,43,88,.489,28,54,.519,15,34,.441,10,17,.588,111,46,86,.535,22,40,.550,24,46,.522,7,10,.700,123
1146,BOS,2021-02-28,111,,WAS,W 111-110,240,42,89,.472,32,59,.542,10,30,.333,17,24,.708,111,38,84,.452,29,52,.558,9,32,.281,25,29,.862,110
1147,HOU,2021-02-26,111,@,TOR,L 111-122,240,39,91,.429,23,44,.523,16,47,.340,17,20,.850,111,40,89,.449,24,48,.500,16,41,.390,26,27,.963,122
1148,PHI,2021-02-25,111,,DAL,W 111-97,240,39,90,.433,27,61,.443,12,29,.414,21,25,.840,111,32,78,.410,19,44,.432,13,34,.382,20,23,.870,97
1149,GSW,2021-02-24,111,@,IND,W 111-107,240,39,83,.470,34,57,.596,5,26,.192,28,31,.903,111,37,81,.457,30,52,.577,7,29,.241,26,32,.813,107
1150,DEN,2021-02-23,111,,POR,W 111-106,240,40,94,.426,26,58,.448,14,36,.389,17,18,.944,111,41,87,.471,27,46,.587,14,41,.341,10,10,1.000,106
1151,ATL,2021-02-23,111,@,CLE,L 111-112,240,40,89,.449,26,58,.448,14,31,.452,17,23,.739,111,41,78,.526,26,50,.520,15,28,.536,15,19,.789,112
1152,POR,2021-02-20,111,,WAS,L 111-118,240,37,103,.359,18,48,.375,19,55,.345,18,25,.720,111,45,89,.506,39,63,.619,6,26,.231,22,29,.759,118
1153,CLE,2021-02-14,111,@,LAC,L 111-128,240,43,93,.462,36,68,.529,7,25,.280,18,25,.720,111,42,88,.477,29,58,.500,13,30,.433,31,36,.861,128
1154,PHI,2021-02-13,111,@,PHO,L 111-120,240,38,73,.521,31,56,.554,7,17,.412,28,33,.848,111,48,79,.608,38,54,.704,10,25,.400,14,17,.824,120
1155,GSW,2021-02-11,111,,ORL,W 111-105,240,41,88,.466,21,38,.553,20,50,.400,9,12,.750,111,38,97,.392,23,64,.359,15,33,.455,14,18,.778,105
1156,IND,2021-02-11,111,@,DET,W 111-95,240,44,86,.512,30,55,.545,14,31,.452,9,10,.900,111,38,85,.447,33,57,.579,5,28,.179,14,19,.737,95
1157,BRK,2021-02-09,111,@,DET,L 111-122,240,43,86,.500,32,56,.571,11,30,.367,14,16,.875,111,47,84,.560,34,55,.618,13,29,.448,15,21,.714,122
1158,SAC,2021-02-09,111,,PHI,L 111-119,240,43,99,.434,29,57,.509,14,42,.333,11,19,.579,111,41,85,.482,32,65,.492,9,20,.450,28,35,.800,119
1159,SAS,2021-02-06,111,@,HOU,W 111-106,240,37,87,.425,29,62,.468,8,25,.320,29,36,.806,111,38,88,.432,26,50,.520,12,38,.316,18,25,.720,106
1160,BOS,2021-02-03,111,@,SAC,L 111-116,240,39,86,.453,28,53,.528,11,33,.333,22,29,.759,111,42,92,.457,29,55,.527,13,37,.351,19,23,.826,116
1161,CHO,2021-02-03,111,,PHI,L 111-118,240,39,87,.448,25,50,.500,14,37,.378,19,23,.826,111,41,79,.519,31,55,.564,10,24,.417,26,32,.813,118
1162,SAS,2021-02-03,111,,MIN,W 111-108,240,43,96,.448,36,70,.514,7,26,.269,18,24,.750,111,43,94,.457,30,61,.492,13,33,.394,9,11,.818,108
1163,BOS,2021-02-02,111,@,GSW,W 111-107,240,39,84,.464,26,50,.520,13,34,.382,20,27,.741,111,38,83,.458,23,46,.500,15,37,.405,16,23,.696,107
1164,PHO,2021-01-30,111,@,DAL,W 111-105,240,37,81,.457,27,59,.458,10,22,.455,27,31,.871,111,44,83,.530,35,54,.648,9,29,.310,8,14,.571,105
1165,MIN,2021-01-27,111,@,GSW,L 111-123,240,37,87,.425,23,51,.451,14,36,.389,23,33,.697,111,45,85,.529,30,51,.588,15,34,.441,18,23,.783,123
1166,MIA,2021-01-20,111,@,TOR,W 111-102,240,39,80,.488,21,40,.525,18,40,.450,15,17,.882,111,35,88,.398,19,39,.487,16,49,.327,16,18,.889,102
1167,TOR,2021-01-14,111,,CHO,W 111-108,240,40,88,.455,20,38,.526,20,50,.400,11,13,.846,111,42,87,.483,27,52,.519,15,35,.429,9,12,.750,108
1168,IND,2021-01-14,111,@,POR,W 111-87,240,44,92,.478,35,62,.565,9,30,.300,14,18,.778,111,32,87,.368,19,44,.432,13,43,.302,10,10,1.000,87
1169,LAC,2021-01-13,111,,NOP,W 111-106,240,35,74,.473,17,37,.459,18,37,.486,23,27,.852,111,42,88,.477,32,60,.533,10,28,.357,12,16,.750,106
1170,TOR,2021-01-11,111,@,POR,L 111-112,240,40,89,.449,21,42,.500,19,47,.404,12,12,1.000,111,38,83,.458,24,41,.585,14,42,.333,22,25,.880,112
1171,OKC,2021-01-06,111,@,NOP,W 111-110,240,40,87,.460,21,41,.512,19,46,.413,12,16,.750,111,44,89,.494,40,67,.597,4,22,.182,18,23,.783,110
1172,CHI,2021-01-05,111,@,POR,W 111-108,240,40,91,.440,24,50,.480,16,41,.390,15,18,.833,111,39,94,.415,20,43,.465,19,51,.373,11,17,.647,108
1173,PHO,2020-12-29,111,,NOP,W 111-86,240,37,84,.440,18,37,.486,19,47,.404,18,19,.947,111,37,77,.481,34,53,.642,3,24,.125,9,18,.500,86
1174,IND,2020-12-29,111,,BOS,L 111-116,240,43,84,.512,31,51,.608,12,33,.364,13,16,.813,111,40,80,.500,31,58,.534,9,22,.409,27,37,.730,116
1175,BRK,2020-12-28,111,,MEM,L 111-116 (OT),265,41,100,.410,27,58,.466,14,42,.333,15,17,.882,111,42,98,.429,32,69,.464,10,29,.345,22,29,.759,116
1176,HOU,2020-12-28,111,@,DEN,L 111-124,240,39,86,.453,23,47,.489,16,39,.410,17,23,.739,111,46,87,.529,32,56,.571,14,31,.452,18,32,.563,124
1177,UTA,2020-12-26,111,,MIN,L 111-116,240,36,94,.383,26,60,.433,10,34,.294,29,37,.784,111,45,101,.446,32,72,.444,13,29,.448,13,18,.722,116
1178,MIA,2020-12-25,111,,NOP,W 111-98,240,38,75,.507,22,38,.579,16,37,.432,19,23,.826,111,31,78,.397,21,43,.488,10,35,.286,26,33,.788,98
1179,MIN,2020-12-23,111,,DET,W 111-101,240,38,88,.432,27,47,.574,11,41,.268,24,28,.857,111,45,93,.484,37,58,.638,8,35,.229,3,8,.375,101
1180,CHO,2021-05-16,110,@,WAS,L 110-115,240,37,94,.394,23,49,.469,14,45,.311,22,24,.917,110,44,91,.484,34,60,.567,10,31,.323,17,21,.810,115
1181,LAL,2021-05-16,110,@,NOP,W 110-98,240,45,96,.469,34,61,.557,11,35,.314,9,15,.600,110,37,78,.474,28,53,.528,9,25,.360,15,21,.714,98
1182,TOR,2021-05-14,110,@,DAL,L 110-114,240,42,85,.494,29,47,.617,13,38,.342,13,17,.765,110,39,90,.433,22,48,.458,17,42,.405,19,21,.905,114
1183,SAC,2021-05-13,110,@,MEM,L 110-116,240,42,96,.438,25,55,.455,17,41,.415,9,14,.643,110,45,90,.500,34,57,.596,11,33,.333,15,18,.833,116
1184,NOP,2021-05-10,110,@,MEM,L 110-115,240,43,97,.443,33,74,.446,10,23,.435,14,21,.667,110,45,91,.495,36,61,.590,9,30,.300,16,27,.593,115
1185,CHO,2021-05-09,110,,NOP,L 110-112,240,42,95,.442,29,58,.500,13,37,.351,13,18,.722,110,45,96,.469,33,59,.559,12,37,.324,10,22,.455,112
1186,PHO,2021-05-09,110,@,LAL,L 110-123,240,39,73,.534,28,48,.583,11,25,.440,21,25,.840,110,39,80,.488,26,50,.520,13,30,.433,32,41,.780,123
1187,DAL,2021-05-07,110,,CLE,W 110-90,240,41,83,.494,31,51,.608,10,32,.313,18,22,.818,110,32,83,.386,26,54,.481,6,29,.207,20,26,.769,90
1188,UTA,2021-05-03,110,,SAS,W 110-99,240,44,88,.500,33,52,.635,11,36,.306,11,16,.688,110,42,90,.467,37,72,.514,5,18,.278,10,10,1.000,99
1189,DEN,2021-05-01,110,@,LAC,W 110-104,240,39,80,.488,27,48,.563,12,32,.375,20,21,.952,110,36,83,.434,22,49,.449,14,34,.412,18,24,.750,104
1190,SAC,2021-04-30,110,@,LAL,W 110-106,240,39,86,.453,27,53,.509,12,33,.364,20,22,.909,110,42,83,.506,35,55,.636,7,28,.250,15,21,.714,106
1191,NYK,2021-04-26,110,,PHO,L 110-118,240,45,87,.517,33,58,.569,12,29,.414,8,10,.800,110,45,83,.542,31,49,.633,14,34,.412,14,17,.824,118
1192,CHI,2021-04-26,110,@,MIA,W 110-102,240,41,77,.532,30,48,.625,11,29,.379,17,22,.773,110,36,84,.429,29,48,.604,7,36,.194,23,25,.920,102
1193,CLE,2021-04-25,110,@,WAS,L 110-119,240,40,78,.513,30,51,.588,10,27,.370,20,25,.800,110,43,89,.483,31,58,.534,12,31,.387,21,26,.808,119
1194,SAS,2021-04-24,110,@,NOP,W 110-108,240,37,85,.435,28,54,.519,9,31,.290,27,32,.844,110,41,87,.471,32,65,.492,9,22,.409,17,32,.531,108
1195,LAL,2021-04-22,110,@,DAL,L 110-115,240,43,90,.478,33,60,.550,10,30,.333,14,17,.824,110,40,82,.488,31,58,.534,9,24,.375,26,36,.722,115
1196,ORL,2021-04-18,110,,HOU,L 110-114,240,41,91,.451,30,59,.508,11,32,.344,17,19,.895,110,42,82,.512,26,48,.542,16,34,.471,14,20,.700,114
1197,DET,2021-04-16,110,,OKC,W 110-104,240,38,90,.422,28,55,.509,10,35,.286,24,34,.706,110,39,97,.402,32,58,.552,7,39,.179,19,26,.731,104
1198,SAC,2021-04-12,110,@,NOP,L 110-117,240,39,90,.433,29,55,.527,10,35,.286,22,37,.595,110,42,77,.545,36,58,.621,6,19,.316,27,39,.692,117
1199,WAS,2021-04-09,110,@,GSW,W 110-107,240,43,89,.483,38,70,.543,5,19,.263,19,24,.792,110,41,88,.466,30,52,.577,11,36,.306,14,21,.667,107
1200,MIA,2021-04-08,110,,LAL,W 110-104,240,34,71,.479,24,46,.522,10,25,.400,32,40,.800,110,35,79,.443,23,44,.523,12,35,.343,22,25,.880,104
1201,LAL,2021-04-06,110,@,TOR,W 110-101,240,39,79,.494,21,39,.538,18,40,.450,14,22,.636,110,36,91,.396,31,58,.534,5,33,.152,24,30,.800,101
1202,NOP,2021-04-01,110,,ORL,L 110-115 (OT),265,41,93,.441,29,64,.453,12,29,.414,16,19,.842,110,45,106,.425,40,81,.494,5,25,.200,20,23,.870,115
1203,ATL,2021-03-30,110,@,PHO,L 110-117,240,41,85,.482,28,53,.528,13,32,.406,15,21,.714,110,45,88,.511,33,56,.589,12,32,.375,15,18,.833,117
1204,HOU,2021-03-29,110,,MEM,L 110-120,240,40,94,.426,29,52,.558,11,42,.262,19,22,.864,110,46,85,.541,35,54,.648,11,31,.355,17,24,.708,120
1205,MEM,2021-03-27,110,@,UTA,L 110-126,240,39,97,.402,30,64,.469,9,33,.273,23,30,.767,110,46,92,.500,27,47,.574,19,45,.422,15,20,.750,126
1206,CHO,2021-03-26,110,,MIA,W 110-105,240,39,79,.494,21,36,.583,18,43,.419,14,19,.737,110,40,87,.460,25,44,.568,15,43,.349,10,20,.500,105
1207,SAC,2021-03-24,110,,ATL,W 110-108,240,40,84,.476,30,54,.556,10,30,.333,20,22,.909,110,41,85,.482,34,60,.567,7,25,.280,19,23,.826,108
1208,PHO,2021-03-23,110,@,MIA,W 110-100,240,45,91,.495,33,54,.611,12,37,.324,8,9,.889,110,36,86,.419,23,50,.460,13,36,.361,15,17,.882,100
1209,DEN,2021-03-23,110,@,ORL,W 110-99,240,45,91,.495,37,61,.607,8,30,.267,12,13,.923,110,39,88,.443,28,54,.519,11,34,.324,10,14,.714,99
1210,ATL,2021-03-22,110,@,LAC,L 110-119,240,43,95,.453,31,61,.508,12,34,.353,12,16,.750,110,42,85,.494,25,47,.532,17,38,.447,18,20,.900,119
1211,MIA,2021-03-19,110,,IND,L 110-137,240,41,92,.446,32,58,.552,9,34,.265,19,20,.950,110,52,89,.584,32,53,.604,20,36,.556,13,19,.684,137
1212,CLE,2021-03-19,110,,SAS,L 110-116,240,39,89,.438,32,62,.516,7,27,.259,25,32,.781,110,41,88,.466,34,70,.486,7,18,.389,27,33,.818,116
1213,BOS,2021-03-17,110,@,CLE,L 110-117,240,40,88,.455,30,50,.600,10,38,.263,20,29,.690,110,40,74,.541,30,51,.588,10,23,.435,27,33,.818,117
1214,WAS,2021-02-28,110,@,BOS,L 110-111,240,38,84,.452,29,52,.558,9,32,.281,25,29,.862,110,42,89,.472,32,59,.542,10,30,.333,17,24,.708,111
1215,NYK,2021-02-27,110,,IND,W 110-107,240,40,81,.494,28,57,.491,12,24,.500,18,22,.818,110,38,84,.452,27,56,.482,11,28,.393,20,25,.800,107
1216,SAC,2021-02-26,110,@,DET,W 110-107,240,37,89,.416,30,57,.526,7,32,.219,29,41,.707,110,37,82,.451,25,49,.510,12,33,.364,21,32,.656,107
1217,DEN,2021-02-25,110,,WAS,L 110-112,240,37,85,.435,22,47,.468,15,38,.395,21,24,.875,110,41,86,.477,33,60,.550,8,26,.308,22,25,.880,112
1218,DAL,2021-02-23,110,,BOS,W 110-107,240,42,89,.472,29,56,.518,13,33,.394,13,15,.867,110,41,86,.477,29,47,.617,12,39,.308,13,18,.722,107
1219,CHO,2021-02-22,110,@,UTA,L 110-132,240,41,89,.461,30,53,.566,11,36,.306,17,21,.810,110,45,85,.529,17,30,.567,28,55,.509,14,17,.824,132
1220,TOR,2021-02-21,110,,PHI,W 110-103,240,40,81,.494,26,47,.553,14,34,.412,16,18,.889,110,33,85,.388,22,48,.458,11,37,.297,26,35,.743,103
1221,SAC,2021-02-18,110,,MIA,L 110-118,240,43,93,.462,28,52,.538,15,41,.366,9,16,.563,110,49,95,.516,37,61,.607,12,34,.353,8,10,.800,118
1222,TOR,2021-02-18,110,@,MIL,W 110-96,240,38,78,.487,26,43,.605,12,35,.343,22,23,.957,110,35,88,.398,25,54,.463,10,34,.294,16,23,.696,96
1223,CHO,2021-02-14,110,,SAS,L 110-122,240,45,95,.474,33,61,.541,12,34,.353,8,11,.727,110,48,96,.500,38,62,.613,10,34,.294,16,19,.842,122
1224,SAC,2021-02-14,110,,MEM,L 110-124,240,41,82,.500,33,49,.673,8,33,.242,20,26,.769,110,50,94,.532,41,73,.562,9,21,.429,15,19,.789,124
1225,CLE,2021-02-12,110,@,POR,L 110-129,240,38,87,.437,30,64,.469,8,23,.348,26,37,.703,110,43,83,.518,30,48,.625,13,35,.371,30,33,.909,129
1226,LAC,2021-02-07,110,,SAC,L 110-113,240,41,99,.414,33,71,.465,8,28,.286,20,23,.870,110,46,94,.489,36,65,.554,10,29,.345,11,15,.733,113
1227,NYK,2021-02-06,110,,POR,W 110-99,240,44,88,.500,31,58,.534,13,30,.433,9,13,.692,110,37,89,.416,20,42,.476,17,47,.362,8,16,.500,99
1228,IND,2021-02-03,110,@,MIL,L 110-130,240,43,95,.453,32,61,.525,11,34,.324,13,15,.867,110,48,102,.471,27,54,.500,21,48,.438,13,14,.929,130
1229,CHI,2021-02-01,110,,NYK,W 110-102,240,42,88,.477,31,54,.574,11,34,.324,15,20,.750,110,37,87,.425,31,58,.534,6,29,.207,22,26,.846,102
1230,IND,2021-01-31,110,,PHI,L 110-119,240,41,84,.488,31,56,.554,10,28,.357,18,22,.818,110,45,92,.489,37,66,.561,8,26,.308,21,31,.677,119
1231,SAS,2021-01-27,110,,BOS,W 110-106,240,46,82,.561,38,54,.704,8,28,.286,10,16,.625,110,42,98,.429,32,68,.471,10,30,.333,12,14,.857,106
1232,DET,2021-01-23,110,,PHI,L 110-114,240,37,86,.430,23,53,.434,14,33,.424,22,30,.733,110,38,83,.458,30,60,.500,8,23,.348,30,38,.789,114
1233,NOP,2021-01-23,110,@,MIN,L 110-120,240,40,87,.460,30,54,.556,10,33,.303,20,28,.714,110,39,91,.429,27,57,.474,12,34,.353,30,37,.811,120
1234,BOS,2021-01-22,110,@,PHI,L 110-122,240,41,90,.456,29,60,.483,12,30,.400,16,20,.800,110,45,81,.556,33,53,.623,12,28,.429,20,24,.833,122
1235,CHO,2021-01-22,110,,CHI,L 110-123,240,42,85,.494,35,53,.660,7,32,.219,19,25,.760,110,49,96,.510,34,53,.642,15,43,.349,10,12,.833,123
1236,MIL,2021-01-13,110,@,DET,W 110-101,240,41,85,.482,22,42,.524,19,43,.442,9,14,.643,110,36,92,.391,22,57,.386,14,35,.400,15,22,.682,101
1237,NOP,2021-01-08,110,,CHO,L 110-118,240,38,77,.494,23,39,.590,15,38,.395,19,26,.731,110,41,87,.471,25,45,.556,16,42,.381,20,25,.800,118
1238,BRK,2021-01-08,110,@,MEM,L 110-115,240,38,81,.469,24,50,.480,14,31,.452,20,21,.952,110,45,98,.459,32,66,.485,13,32,.406,12,14,.857,115
1239,DET,2021-01-08,110,,PHO,W 110-105 (OT),265,37,90,.411,26,56,.464,11,34,.324,25,29,.862,110,41,91,.451,24,39,.615,17,52,.327,6,13,.462,105
1240,NOP,2021-01-06,110,,OKC,L 110-111,240,44,89,.494,40,67,.597,4,22,.182,18,23,.783,110,40,87,.460,21,41,.512,19,46,.413,12,16,.750,111
1241,UTA,2020-12-28,110,@,OKC,W 110-109,240,43,86,.500,30,50,.600,13,36,.361,11,14,.786,110,40,86,.465,25,48,.521,15,38,.395,14,19,.737,109
1242,MIL,2020-12-27,110,@,NYK,L 110-130,240,41,95,.432,34,57,.596,7,38,.184,21,29,.724,110,46,85,.541,30,58,.517,16,27,.593,22,27,.815,130
1243,CLE,2021-05-16,109,@,BRK,L 109-123,240,38,85,.447,26,46,.565,12,39,.308,21,31,.677,109,47,83,.566,31,53,.585,16,30,.533,13,17,.765,123
1244,CHO,2021-05-15,109,@,NYK,L 109-118 (OT),265,39,102,.382,26,53,.491,13,49,.265,18,24,.750,109,45,88,.511,29,51,.569,16,37,.432,12,15,.800,118
1245,UTA,2021-05-14,109,@,OKC,W 109-93,240,40,93,.430,27,54,.500,13,39,.333,16,21,.762,109,36,84,.429,30,65,.462,6,19,.316,15,16,.938,93
1246,MEM,2021-05-08,109,@,TOR,W 109-99,240,38,85,.447,24,42,.571,14,43,.326,19,26,.731,109,36,94,.383,26,62,.419,10,32,.313,17,24,.708,99
1247,PHI,2021-05-07,109,,NOP,W 109-107,240,38,85,.447,23,50,.460,15,35,.429,18,22,.818,109,41,101,.406,32,65,.492,9,36,.250,16,22,.727,107
1248,BRK,2021-05-06,109,@,DAL,L 109-113,240,41,95,.432,28,58,.483,13,37,.351,14,15,.933,109,40,89,.449,25,55,.455,15,34,.441,18,26,.692,113
1249,BRK,2021-04-30,109,,POR,L 109-128,240,40,95,.421,27,54,.500,13,41,.317,16,19,.842,109,47,91,.516,31,55,.564,16,36,.444,18,20,.900,128
1250,NOP,2021-04-29,109,@,OKC,W 109-95,240,45,101,.446,40,72,.556,5,29,.172,14,19,.737,109,34,89,.382,23,50,.460,11,39,.282,16,20,.800,95
1251,ORL,2021-04-28,109,@,CLE,W 109-104,240,43,85,.506,33,56,.589,10,29,.345,13,20,.650,109,37,92,.402,25,48,.521,12,44,.273,18,24,.750,104
1252,MEM,2021-04-28,109,,POR,L 109-130,240,37,88,.420,28,56,.500,9,32,.281,26,30,.867,109,45,92,.489,30,52,.577,15,40,.375,25,28,.893,130
1253,PHO,2021-04-28,109,,LAC,W 109-101,240,43,91,.473,30,54,.556,13,37,.351,10,13,.769,109,41,80,.513,29,49,.592,12,31,.387,7,9,.778,101
1254,DET,2021-04-24,109,@,IND,L 109-115,240,39,96,.406,29,62,.468,10,34,.294,21,26,.808,109,40,96,.417,30,64,.469,10,32,.313,25,35,.714,115
1255,OKC,2021-04-23,109,,WAS,L 109-129,240,39,93,.419,29,60,.483,10,33,.303,21,25,.840,109,48,93,.516,30,61,.492,18,32,.563,15,16,.938,129
1256,BRK,2021-04-23,109,,BOS,W 109-104,240,37,86,.430,26,54,.481,11,32,.344,24,28,.857,109,38,94,.404,21,52,.404,17,42,.405,11,16,.688,104
1257,LAC,2021-04-23,109,@,HOU,W 109-104,240,39,97,.402,27,63,.429,12,34,.353,19,23,.826,109,36,89,.404,23,47,.489,13,42,.310,19,22,.864,104
1258,NYK,2021-04-20,109,,CHO,W 109-97,240,40,83,.482,22,38,.579,18,45,.400,11,12,.917,109,39,86,.453,23,47,.489,16,39,.410,3,8,.375,97
1259,SAS,2021-04-19,109,@,IND,W 109-94,240,36,84,.429,28,56,.500,8,28,.286,29,35,.829,109,34,104,.327,26,70,.371,8,34,.235,18,27,.667,94
1260,DET,2021-04-19,109,,CLE,W 109-105,240,42,86,.488,32,59,.542,10,27,.370,15,21,.714,109,42,86,.488,37,60,.617,5,26,.192,16,20,.800,105
1261,MIA,2021-04-18,109,,BRK,W 109-107,240,38,87,.437,22,48,.458,16,39,.410,17,21,.810,109,39,82,.476,22,39,.564,17,43,.395,12,18,.667,107
1262,CHO,2021-04-18,109,,POR,W 109-101,240,39,83,.470,21,40,.525,18,43,.419,13,17,.765,109,36,91,.396,26,55,.473,10,36,.278,19,28,.679,101
1263,DAL,2021-04-16,109,,NYK,L 109-117,240,40,91,.440,25,46,.543,15,45,.333,14,19,.737,109,44,86,.512,30,58,.517,14,28,.500,15,21,.714,117
1264,ATL,2021-04-15,109,,MIL,L 109-120,240,39,86,.453,25,52,.481,14,34,.412,17,19,.895,109,46,95,.484,30,52,.577,16,43,.372,12,17,.706,120
1265,OKC,2021-04-14,109,,GSW,L 109-147,240,44,92,.478,37,65,.569,7,27,.259,14,25,.560,109,52,95,.547,28,48,.583,24,47,.511,19,23,.826,147
1266,CLE,2021-04-11,109,,NOP,L 109-116,240,41,85,.482,28,45,.622,13,40,.325,14,17,.824,109,44,86,.512,37,62,.597,7,24,.292,21,26,.808,116
1267,HOU,2021-04-10,109,@,GSW,L 109-125,240,41,88,.466,28,51,.549,13,37,.351,14,20,.700,109,49,91,.538,35,56,.625,14,35,.400,13,16,.813,125
1268,HOU,2021-04-09,109,@,LAC,L 109-126,240,39,83,.470,27,46,.587,12,37,.324,19,27,.704,109,48,88,.545,29,51,.569,19,37,.514,11,13,.846,126
1269,ORL,2021-04-04,109,@,DEN,L 109-119,240,42,89,.472,29,54,.537,13,35,.371,12,17,.706,109,43,88,.489,34,59,.576,9,29,.310,24,31,.774,119
1270,DAL,2021-04-03,109,@,WAS,W 109-87,240,40,90,.444,30,60,.500,10,30,.333,19,24,.792,109,35,86,.407,30,61,.492,5,25,.200,12,15,.800,87
1271,POR,2021-04-02,109,,MIL,L 109-127,240,36,99,.364,15,45,.333,21,54,.389,16,22,.727,109,49,90,.544,37,51,.725,12,39,.308,17,19,.895,127
1272,GSW,2021-04-01,109,@,MIA,L 109-116,240,36,82,.439,21,45,.467,15,37,.405,22,25,.880,109,39,82,.476,26,43,.605,13,39,.333,25,30,.833,116
1273,BOS,2021-03-29,109,,NOP,L 109-115,240,40,93,.430,26,50,.520,14,43,.326,15,19,.789,109,41,82,.500,25,51,.490,16,31,.516,17,30,.567,115
1274,IND,2021-03-26,109,@,DAL,W 109-94,240,38,87,.437,18,40,.450,20,47,.426,13,18,.722,109,39,95,.411,31,60,.517,8,35,.229,8,14,.571,94
1275,PHI,2021-03-25,109,@,LAL,W 109-101,240,39,80,.488,22,35,.629,17,45,.378,14,21,.667,109,34,78,.436,25,52,.481,9,26,.346,24,33,.727,101
1276,IND,2021-03-21,109,@,MIA,W 109-106 (OT),265,38,98,.388,23,53,.434,15,45,.333,18,20,.900,109,39,97,.402,30,60,.500,9,37,.243,19,23,.826,106
1277,MIL,2021-03-17,109,@,PHI,W 109-105 (OT),265,41,101,.406,32,62,.516,9,39,.231,18,24,.750,109,43,109,.394,29,68,.426,14,41,.341,5,8,.625,105
1278,BOS,2021-03-16,109,,UTA,L 109-117,240,48,98,.490,38,69,.551,10,29,.345,3,4,.750,109,38,80,.475,19,37,.514,19,43,.442,22,24,.917,117
1279,SAS,2021-03-15,109,@,DET,W 109-99,240,47,83,.566,35,58,.603,12,25,.480,3,5,.600,109,39,83,.470,32,58,.552,7,25,.280,14,25,.560,99
1280,LAC,2021-03-15,109,@,DAL,W 109-99,240,43,86,.500,29,54,.537,14,32,.438,9,11,.818,109,39,79,.494,22,38,.579,17,41,.415,4,5,.800,99
1281,BOS,2021-03-11,109,@,BRK,L 109-121,240,41,91,.451,28,51,.549,13,40,.325,14,22,.636,109,42,88,.477,23,46,.500,19,42,.452,18,22,.818,121
1282,MIA,2021-02-28,109,,ATL,W 109-99,240,39,86,.453,28,49,.571,11,37,.297,20,22,.909,109,36,87,.414,28,52,.538,8,35,.229,19,22,.864,99
1283,NYK,2021-02-28,109,@,DET,W 109-90,240,44,86,.512,31,60,.517,13,26,.500,8,10,.800,109,28,72,.389,19,40,.475,9,32,.281,25,31,.806,90
1284,ORL,2021-02-27,109,,UTA,L 109-124,240,44,96,.458,30,62,.484,14,34,.412,7,8,.875,109,45,85,.529,28,40,.700,17,45,.378,17,24,.708,124
1285,PHI,2021-02-27,109,,CLE,L 109-112 (OT),265,38,83,.458,28,55,.509,10,28,.357,23,35,.657,109,41,97,.423,33,73,.452,8,24,.333,22,29,.759,112
1286,ATL,2021-02-26,109,@,OKC,L 109-118,240,43,97,.443,31,57,.544,12,40,.300,11,17,.647,109,46,88,.523,30,46,.652,16,42,.381,10,16,.625,118
1287,PHI,2021-02-23,109,@,TOR,W 109-102,240,33,80,.413,16,42,.381,17,38,.447,26,30,.867,109,40,93,.430,29,56,.518,11,37,.297,11,13,.846,102
1288,ATL,2021-02-19,109,@,BOS,L 109-121,240,38,90,.422,28,60,.467,10,30,.333,23,25,.920,109,50,90,.556,36,55,.655,14,35,.400,7,10,.700,121
1289,MEM,2021-02-19,109,,DET,W 109-95,240,42,90,.467,37,70,.529,5,20,.250,20,23,.870,109,36,86,.419,22,41,.537,14,45,.311,9,13,.692,95
1290,BRK,2021-02-18,109,@,LAL,W 109-98,240,38,77,.494,20,38,.526,18,39,.462,15,24,.625,109,40,83,.482,32,53,.604,8,30,.267,10,14,.714,98
1291,PHO,2021-02-14,109,,ORL,W 109-90,240,41,92,.446,29,55,.527,12,37,.324,15,16,.938,109,33,89,.371,27,54,.500,6,35,.171,18,22,.818,90
1292,MIL,2021-02-14,109,@,OKC,L 109-114,240,45,97,.464,32,59,.542,13,38,.342,6,9,.667,109,45,95,.474,30,59,.508,15,36,.417,9,16,.563,114
1293,NYK,2021-02-12,109,@,WAS,W 109-91,240,44,98,.449,38,74,.514,6,24,.250,15,22,.682,109,34,89,.382,25,55,.455,9,34,.265,14,20,.700,91
1294,MIA,2021-02-07,109,@,NYK,W 109-103,240,40,83,.482,27,48,.563,13,35,.371,16,20,.800,109,38,85,.447,22,43,.512,16,42,.381,11,15,.733,103
1295,MEM,2021-02-06,109,@,NOP,L 109-118,240,40,90,.444,27,51,.529,13,39,.333,16,19,.842,109,45,87,.517,30,54,.556,15,33,.455,13,21,.619,118
1296,PHO,2021-02-05,109,,DET,W 109-92,240,42,85,.494,30,53,.566,12,32,.375,13,16,.813,109,34,91,.374,27,55,.491,7,36,.194,17,28,.607,92
1297,NOP,2021-02-01,109,,SAC,L 109-118,240,40,101,.396,31,71,.437,9,30,.300,20,24,.833,109,42,88,.477,28,45,.622,14,43,.326,20,26,.769,118
1298,PHO,2021-02-01,109,@,DAL,W 109-108,240,43,92,.467,30,57,.526,13,35,.371,10,12,.833,109,37,86,.430,27,54,.500,10,32,.313,24,25,.960,108
1299,MIN,2021-01-31,109,,CLE,W 109-104,240,41,91,.451,25,51,.490,16,40,.400,11,15,.733,109,41,84,.488,37,68,.544,4,16,.250,18,23,.783,104
1300,DEN,2021-01-29,109,@,SAS,L 109-119,240,41,78,.526,27,47,.574,14,31,.452,13,20,.650,109,44,81,.543,34,58,.586,10,23,.435,21,26,.808,119
1301,LAC,2021-01-28,109,@,MIA,W 109-105,240,36,87,.414,19,45,.422,17,42,.405,20,22,.909,109,40,90,.444,27,57,.474,13,33,.394,12,15,.800,105
1302,DEN,2021-01-27,109,@,MIA,W 109-82,240,42,92,.457,28,49,.571,14,43,.326,11,11,1.000,109,30,80,.375,17,35,.486,13,45,.289,9,11,.818,82
1303,BOS,2021-01-20,109,@,PHI,L 109-117,240,42,89,.472,30,56,.536,12,33,.364,13,20,.650,109,36,78,.462,27,51,.529,9,27,.333,36,45,.800,117
1304,PHO,2021-01-20,109,@,HOU,W 109-103,240,42,89,.472,34,55,.618,8,34,.235,17,19,.895,109,37,88,.420,27,57,.474,10,31,.323,19,22,.864,103
1305,UTA,2021-01-17,109,@,DEN,W 109-105,240,39,76,.513,24,39,.615,15,37,.405,16,28,.571,109,40,100,.400,26,63,.413,14,37,.378,11,15,.733,105
1306,DAL,2021-01-15,109,@,MIL,L 109-112,240,45,97,.464,32,61,.525,13,36,.361,6,13,.462,109,43,96,.448,29,59,.492,14,37,.378,12,25,.480,112
1307,HOU,2021-01-14,109,@,SAS,W 109-105,240,42,86,.488,29,53,.547,13,33,.394,12,19,.632,109,42,92,.457,33,61,.541,9,31,.290,12,16,.750,105
1308,NYK,2021-01-13,109,,BRK,L 109-116,240,44,92,.478,33,64,.516,11,28,.393,10,12,.833,109,44,91,.484,28,51,.549,16,40,.400,12,17,.706,116
1309,CHO,2021-01-11,109,,NYK,W 109-88,240,38,78,.487,25,46,.543,13,32,.406,20,23,.870,109,34,87,.391,25,50,.500,9,37,.243,11,17,.647,88
1310,PHI,2021-01-07,109,@,BRK,L 109-122,240,41,87,.471,32,61,.525,9,26,.346,18,20,.900,109,44,97,.454,29,60,.483,15,37,.405,19,29,.655,122
1311,LAL,2021-01-07,109,,SAS,L 109-118,240,43,86,.500,33,56,.589,10,30,.333,13,21,.619,109,43,92,.467,27,57,.474,16,35,.457,16,17,.941,118
1312,SAS,2021-01-03,109,,UTA,L 109-130,240,44,105,.419,38,86,.442,6,19,.316,15,21,.714,109,49,89,.551,28,48,.583,21,41,.512,11,19,.579,130
1313,MIN,2021-01-03,109,,DEN,L 109-124,240,44,85,.518,34,54,.630,10,31,.323,11,16,.688,109,45,92,.489,26,47,.553,19,45,.422,15,21,.714,124
1314,MIN,2021-01-01,109,,WAS,L 109-130,240,42,88,.477,29,52,.558,13,36,.361,12,21,.571,109,49,89,.551,33,56,.589,16,33,.485,16,21,.762,130
1315,LAL,2021-01-01,109,@,SAS,W 109-103,240,41,101,.406,27,68,.397,14,33,.424,13,16,.813,109,36,85,.424,23,51,.451,13,34,.382,18,26,.692,103
1316,OKC,2020-12-28,109,,UTA,L 109-110,240,40,86,.465,25,48,.521,15,38,.395,14,19,.737,109,43,86,.500,30,50,.600,13,36,.361,11,14,.786,110
1317,PHI,2020-12-26,109,@,NYK,W 109-89,240,41,88,.466,30,57,.526,11,31,.355,16,22,.727,109,32,83,.386,24,54,.444,8,29,.276,17,23,.739,89
1318,OKC,2020-12-26,109,@,CHO,W 109-107,240,40,88,.455,30,52,.577,10,36,.278,19,24,.792,109,37,93,.398,24,61,.393,13,32,.406,20,32,.625,107
1319,LAL,2020-12-22,109,,LAC,L 109-116,240,38,81,.469,29,52,.558,9,29,.310,24,31,.774,109,44,93,.473,30,53,.566,14,40,.350,14,19,.737,116
1320,MIN,2021-05-15,108,,BOS,L 108-124,240,39,95,.411,34,58,.586,5,37,.135,25,34,.735,108,46,95,.484,28,53,.528,18,42,.429,14,18,.778,124
1321,MIA,2021-05-15,108,@,MIL,L 108-122,240,40,96,.417,18,47,.383,22,49,.449,6,8,.750,108,46,86,.535,33,51,.647,13,35,.371,17,24,.708,122
1322,CHI,2021-05-09,108,@,DET,W 108-96,240,43,84,.512,31,52,.596,12,32,.375,10,14,.714,108,36,79,.456,25,52,.481,11,27,.407,13,22,.591,96
1323,NOP,2021-05-04,108,,GSW,W 108-103,240,39,97,.402,27,67,.403,12,30,.400,18,22,.818,108,39,93,.419,19,40,.475,20,53,.377,5,7,.714,103
1324,NOP,2021-05-03,108,,GSW,L 108-123,240,39,90,.433,34,65,.523,5,25,.200,25,32,.781,108,47,88,.534,30,44,.682,17,44,.386,12,14,.857,123
1325,ATL,2021-05-01,108,,CHI,W 108-97,240,37,74,.500,23,38,.605,14,36,.389,20,26,.769,108,40,85,.471,34,61,.557,6,24,.250,11,17,.647,97
1326,MIL,2021-04-30,108,@,CHI,W 108-98,240,42,90,.467,33,65,.508,9,25,.360,15,20,.750,108,37,96,.385,27,63,.429,10,33,.303,14,21,.667,98
1327,NOP,2021-04-24,108,,SAS,L 108-110,240,41,87,.471,32,65,.492,9,22,.409,17,32,.531,108,37,85,.435,28,54,.519,9,31,.290,27,32,.844,110
1328,DAL,2021-04-24,108,,LAL,W 108-93,240,38,78,.487,25,48,.521,13,30,.433,19,25,.760,108,33,86,.384,21,41,.512,12,45,.267,15,19,.789,93
1329,CHO,2021-04-23,108,,CLE,W 108-102,240,40,94,.426,26,54,.481,14,40,.350,14,18,.778,108,41,80,.513,31,50,.620,10,30,.333,10,14,.714,102
1330,CHI,2021-04-22,108,,CHO,W 108-91,240,43,87,.494,29,44,.659,14,43,.326,8,11,.727,108,35,82,.427,27,51,.529,8,31,.258,13,17,.765,91
1331,ATL,2021-04-13,108,@,TOR,W 108-103,240,40,84,.476,27,54,.500,13,30,.433,15,22,.682,108,42,88,.477,32,49,.653,10,39,.256,9,13,.692,103
1332,CHI,2021-04-09,108,@,ATL,L 108-120,240,41,86,.477,28,53,.528,13,33,.394,13,14,.929,108,47,84,.560,40,57,.702,7,27,.259,19,23,.826,120
1333,OKC,2021-04-05,108,,DET,L 108-132,240,41,97,.423,36,70,.514,5,27,.185,21,25,.840,108,49,95,.516,36,67,.537,13,28,.464,21,24,.875,132
1334,MIN,2021-04-02,108,@,MEM,L 108-120,240,38,85,.447,26,52,.500,12,33,.364,20,23,.870,108,42,95,.442,23,56,.411,19,39,.487,17,25,.680,120
1335,HOU,2021-03-31,108,@,BRK,L 108-120,240,39,78,.500,26,38,.684,13,40,.325,17,24,.708,108,44,90,.489,31,54,.574,13,36,.361,19,19,1.000,120
1336,BOS,2021-03-31,108,,DAL,L 108-113,240,39,94,.415,28,47,.596,11,47,.234,19,23,.826,108,38,77,.494,19,38,.500,19,39,.487,18,25,.720,113
1337,GSW,2021-03-26,108,,ATL,L 108-124,240,39,79,.494,27,51,.529,12,28,.429,18,26,.692,108,46,84,.548,33,51,.647,13,33,.394,19,24,.792,124
1338,NOP,2021-03-26,108,,DEN,L 108-113,240,39,78,.500,27,49,.551,12,29,.414,18,20,.900,108,47,93,.505,33,65,.508,14,28,.500,5,7,.714,113
1339,ATL,2021-03-24,108,@,SAC,L 108-110,240,41,85,.482,34,60,.567,7,25,.280,19,23,.826,108,40,84,.476,30,54,.556,10,30,.333,20,22,.909,110
1340,MIN,2021-03-24,108,,DAL,L 108-128,240,38,86,.442,26,48,.542,12,38,.316,20,26,.769,108,48,99,.485,32,55,.582,16,44,.364,16,22,.727,128
1341,PHI,2021-03-23,108,@,GSW,W 108-98,240,39,86,.453,32,62,.516,7,24,.292,23,35,.657,108,36,83,.434,28,58,.483,8,25,.320,18,26,.692,98
1342,DEN,2021-03-21,108,,NOP,L 108-113,240,44,88,.500,32,54,.593,12,34,.353,8,10,.800,108,41,85,.482,33,57,.579,8,28,.286,23,30,.767,113
1343,GSW,2021-03-17,108,@,HOU,W 108-94,240,41,90,.456,25,45,.556,16,45,.356,10,12,.833,108,33,80,.413,26,53,.491,7,27,.259,21,40,.525,94
1344,DAL,2021-03-11,108,@,OKC,L 108-116,240,35,82,.427,20,48,.417,15,34,.441,23,33,.697,108,41,91,.451,25,59,.424,16,32,.500,18,20,.900,116
1345,POR,2021-03-03,108,,GSW,W 108-106,240,36,86,.419,22,37,.595,14,49,.286,22,26,.846,108,41,97,.423,26,55,.473,15,42,.357,9,14,.643,106
1346,TOR,2021-02-24,108,@,MIA,L 108-116,240,37,74,.500,17,30,.567,20,44,.455,14,17,.824,108,37,80,.463,20,42,.476,17,38,.447,25,29,.862,116
1347,MIA,2021-02-22,108,@,OKC,W 108-94,240,36,81,.444,21,41,.512,15,40,.375,21,25,.840,108,32,74,.432,18,35,.514,14,39,.359,16,19,.842,94
1348,LAC,2021-02-21,108,,BRK,L 108-112,240,40,87,.460,25,52,.481,15,35,.429,13,18,.722,108,44,92,.478,33,54,.611,11,38,.289,13,19,.684,112
1349,DET,2021-02-12,108,@,BOS,W 108-102,240,34,79,.430,19,41,.463,15,38,.395,25,30,.833,108,36,82,.439,28,55,.509,8,27,.296,22,30,.733,102
1350,BOS,2021-02-09,108,@,UTA,L 108-122,240,38,86,.442,25,57,.439,13,29,.448,19,23,.826,108,40,84,.476,22,36,.611,18,48,.375,24,27,.889,122
1351,BRK,2021-02-06,108,@,PHI,L 108-124,240,39,88,.443,24,47,.511,15,41,.366,15,17,.882,108,48,94,.511,38,67,.567,10,27,.370,18,22,.818,124
1352,MIN,2021-02-03,108,@,SAS,L 108-111,240,43,94,.457,30,61,.492,13,33,.394,9,11,.818,108,43,96,.448,36,70,.514,7,26,.269,18,24,.750,111
1353,ORL,2021-02-02,108,,TOR,L 108-123,240,41,89,.461,27,51,.529,14,38,.368,12,14,.857,108,40,83,.482,20,38,.526,20,45,.444,23,25,.920,123
1354,DAL,2021-02-01,108,,PHO,L 108-109,240,37,86,.430,27,54,.500,10,32,.313,24,25,.960,108,43,92,.467,30,57,.526,13,35,.371,10,12,.833,109
1355,CHO,2021-01-29,108,,IND,W 108-105,240,43,85,.506,27,48,.563,16,37,.432,6,9,.667,108,42,87,.483,31,52,.596,11,35,.314,10,13,.769,105
1356,TOR,2021-01-27,108,,MIL,L 108-115,240,38,94,.404,16,39,.410,22,55,.400,10,12,.833,108,40,93,.430,24,49,.490,16,44,.364,19,26,.731,115
1357,ATL,2021-01-26,108,,LAC,W 108-99,240,37,80,.463,27,54,.500,10,26,.385,24,25,.960,108,36,89,.404,28,63,.444,8,26,.308,19,22,.864,99
1358,UTA,2021-01-26,108,,NYK,W 108-94,240,37,92,.402,22,44,.500,15,48,.313,19,22,.864,108,36,83,.434,26,56,.464,10,27,.370,12,17,.706,94
1359,CHO,2021-01-25,108,@,ORL,L 108-117,240,39,89,.438,28,51,.549,11,38,.289,19,27,.704,108,42,88,.477,23,51,.451,19,37,.514,14,22,.636,117
1360,MIN,2021-01-25,108,@,GSW,L 108-130,240,39,94,.415,31,70,.443,8,24,.333,22,25,.880,108,44,89,.494,30,59,.508,14,30,.467,28,37,.757,130
1361,CLE,2021-01-25,108,,LAL,L 108-115,240,40,86,.465,31,65,.477,9,21,.429,19,22,.864,108,42,87,.483,32,55,.582,10,32,.313,21,28,.750,115
1362,LAC,2021-01-24,108,,OKC,W 108-100,240,41,92,.446,27,46,.587,14,46,.304,12,16,.750,108,42,95,.442,35,60,.583,7,35,.200,9,14,.643,100
1363,GSW,2021-01-23,108,@,UTA,L 108-127,240,42,93,.452,28,54,.519,14,39,.359,10,15,.667,108,45,94,.479,25,44,.568,20,50,.400,17,22,.773,127
1364,DAL,2021-01-23,108,,HOU,L 108-133,240,37,83,.446,32,58,.552,5,25,.200,29,40,.725,108,47,86,.547,31,49,.633,16,37,.432,23,29,.793,133
1365,MEM,2021-01-18,108,,PHO,W 108-104,240,41,83,.494,30,57,.526,11,26,.423,15,20,.750,108,40,88,.455,25,52,.481,15,36,.417,9,16,.563,104
1366,ATL,2021-01-18,108,,MIN,W 108-97,240,37,79,.468,26,51,.510,11,28,.393,23,25,.920,108,36,91,.396,22,54,.407,14,37,.378,11,16,.688,97
1367,MIA,2021-01-14,108,@,PHI,L 108-125,240,40,81,.494,28,47,.596,12,34,.353,16,26,.615,108,44,82,.537,27,45,.600,17,37,.459,20,24,.833,125
1368,CHO,2021-01-14,108,@,TOR,L 108-111,240,42,87,.483,27,52,.519,15,35,.429,9,12,.750,108,40,88,.455,20,38,.526,20,50,.400,11,13,.846,111
1369,LAC,2021-01-06,108,@,GSW,W 108-101,240,36,81,.444,25,47,.532,11,34,.324,25,25,1.000,108,39,86,.453,31,56,.554,8,30,.267,15,19,.789,101
1370,POR,2021-01-05,108,,CHI,L 108-111,240,39,94,.415,20,43,.465,19,51,.373,11,17,.647,108,40,91,.440,24,50,.480,16,41,.390,15,18,.833,111
1371,ATL,2021-01-04,108,,NYK,L 108-113,240,40,87,.460,30,56,.536,10,31,.323,18,23,.783,108,43,85,.506,36,64,.563,7,21,.333,20,25,.800,113
1372,LAL,2021-01-03,108,@,MEM,W 108-94,240,41,89,.461,29,54,.537,12,35,.343,14,19,.737,108,39,95,.411,30,62,.484,9,33,.273,7,8,.875,94
1373,DAL,2021-01-03,108,@,CHI,L 108-118,240,39,89,.438,28,47,.596,11,42,.262,19,27,.704,108,39,85,.459,26,48,.542,13,37,.351,27,30,.900,118
1374,OKC,2021-01-02,108,@,ORL,W 108-99,240,38,86,.442,25,45,.556,13,41,.317,19,21,.905,108,40,108,.370,30,70,.429,10,38,.263,9,12,.750,99
1375,MEM,2021-01-01,108,@,CHO,W 108-93,240,43,90,.478,29,51,.569,14,39,.359,8,10,.800,108,35,86,.407,26,55,.473,9,31,.290,14,21,.667,93
1376,MIL,2020-12-30,108,@,MIA,L 108-119,240,40,102,.392,24,61,.393,16,41,.390,12,13,.923,108,40,82,.488,25,43,.581,15,39,.385,24,29,.828,119
1377,IND,2020-12-27,108,,BOS,W 108-107,240,45,88,.511,38,62,.613,7,26,.269,11,15,.733,108,40,79,.506,31,56,.554,9,23,.391,18,24,.750,107
1378,DEN,2020-12-25,108,,LAC,L 108-121,240,37,81,.457,26,45,.578,11,36,.306,23,31,.742,108,41,74,.554,22,36,.611,19,38,.500,20,24,.833,121
1379,DET,2021-05-16,107,,MIA,L 107-120,240,40,86,.465,29,51,.569,11,35,.314,16,22,.727,107,47,84,.560,34,50,.680,13,34,.382,13,20,.650,120
1380,MEM,2021-05-14,107,,SAC,W 107-106,240,37,84,.440,26,51,.510,11,33,.333,22,35,.629,107,37,96,.385,27,54,.500,10,42,.238,22,27,.815,106
1381,NOP,2021-05-12,107,@,DAL,L 107-125,240,36,87,.414,29,59,.492,7,28,.250,28,38,.737,107,47,96,.490,32,51,.627,15,45,.333,16,20,.800,125
1382,CHI,2021-05-11,107,,BRK,L 107-115,240,39,96,.406,21,52,.404,18,44,.409,11,14,.786,107,42,89,.472,30,56,.536,12,33,.364,19,25,.760,115
1383,NOP,2021-05-07,107,@,PHI,L 107-109,240,41,101,.406,32,65,.492,9,36,.250,16,22,.727,107,38,85,.447,23,50,.460,15,35,.429,18,22,.818,109
1384,CLE,2021-05-01,107,,MIA,L 107-124,240,37,74,.500,17,34,.500,20,40,.500,13,17,.765,107,47,87,.540,29,51,.569,18,36,.500,12,15,.800,124
1385,CHO,2021-05-01,107,,DET,W 107-94,240,42,87,.483,28,50,.560,14,37,.378,9,20,.450,107,35,91,.385,22,54,.407,13,37,.351,11,17,.647,94
1386,LAL,2021-04-28,107,@,WAS,L 107-116,240,42,96,.438,32,62,.516,10,34,.294,13,21,.619,107,47,90,.522,41,72,.569,6,18,.333,16,21,.762,116
1387,HOU,2021-04-27,107,,MIN,L 107-114,240,42,86,.488,35,55,.636,7,31,.226,16,22,.727,107,45,93,.484,35,55,.636,10,38,.263,14,25,.560,114
1388,MIA,2021-04-21,107,@,SAS,W 107-87,240,39,83,.470,26,52,.500,13,31,.419,16,20,.800,107,31,77,.403,21,42,.500,10,35,.286,15,20,.750,87
1389,OKC,2021-04-19,107,@,WAS,L 107-119,240,36,83,.434,23,50,.460,13,33,.394,22,27,.815,107,46,91,.505,36,60,.600,10,31,.323,17,29,.586,119
1390,GSW,2021-04-19,107,@,PHI,W 107-96,240,34,76,.447,20,44,.455,14,32,.438,25,32,.781,107,35,89,.393,23,57,.404,12,32,.375,14,18,.778,96
1391,BRK,2021-04-18,107,@,MIA,L 107-109,240,39,82,.476,22,39,.564,17,43,.395,12,18,.667,107,38,87,.437,22,48,.458,16,39,.410,17,21,.810,109
1392,DAL,2021-04-18,107,,SAC,L 107-121,240,39,87,.448,23,39,.590,16,48,.333,13,20,.650,107,44,89,.494,33,65,.508,11,24,.458,22,25,.880,121
1393,POR,2021-04-16,107,@,SAS,W 107-106,240,41,89,.461,30,60,.500,11,29,.379,14,16,.875,107,45,95,.474,38,72,.528,7,23,.304,9,10,.900,106
1394,DEN,2021-04-12,107,@,GSW,L 107-116,240,39,83,.470,31,57,.544,8,26,.308,21,25,.840,107,39,81,.481,21,37,.568,18,44,.409,20,22,.909,116
1395,MIA,2021-04-11,107,@,POR,W 107-98,240,41,83,.494,29,54,.537,12,29,.414,13,20,.650,107,37,77,.481,26,42,.619,11,35,.314,13,19,.684,98
1396,GSW,2021-04-09,107,,WAS,L 107-110,240,41,88,.466,30,52,.577,11,36,.306,14,21,.667,107,43,89,.483,38,70,.543,5,19,.263,19,24,.792,110
1397,NOP,2021-04-06,107,@,ATL,L 107-123,240,37,91,.407,25,53,.472,12,38,.316,21,28,.750,107,44,88,.500,24,57,.421,20,31,.645,15,22,.682,123
1398,BRK,2021-04-04,107,@,CHI,L 107-115,240,45,93,.484,34,65,.523,11,28,.393,6,7,.857,107,43,78,.551,35,56,.625,8,22,.364,21,30,.700,115
1399,MEM,2021-03-31,107,,UTA,L 107-111,240,42,90,.467,37,72,.514,5,18,.278,18,23,.783,107,38,89,.427,22,40,.550,16,49,.327,19,25,.760,111
1400,MIN,2021-03-29,107,@,BRK,L 107-112,240,40,103,.388,26,59,.441,14,44,.318,13,17,.765,107,40,85,.471,30,55,.545,10,30,.333,22,25,.880,112
1401,MIN,2021-03-27,107,,HOU,L 107-129,240,36,85,.424,23,45,.511,13,40,.325,22,28,.786,107,50,92,.543,32,53,.604,18,39,.462,11,13,.846,129
1402,MIN,2021-03-26,107,,HOU,W 107-101,240,39,103,.379,29,65,.446,10,38,.263,19,24,.792,107,37,87,.425,20,43,.465,17,44,.386,10,13,.769,101
1403,OKC,2021-03-24,107,,MEM,L 107-116,240,43,95,.453,33,60,.550,10,35,.286,11,17,.647,107,47,99,.475,36,69,.522,11,30,.367,11,13,.846,116
1404,SAC,2021-03-19,107,@,BOS,W 107-96,240,37,81,.457,25,51,.490,12,30,.400,21,26,.808,107,39,91,.429,27,60,.450,12,31,.387,6,7,.857,96
1405,HOU,2021-03-16,107,,ATL,L 107-119,240,42,88,.477,29,54,.537,13,34,.382,10,13,.769,107,44,86,.512,27,49,.551,17,37,.459,14,16,.875,119
1406,HOU,2021-03-14,107,,BOS,L 107-134,240,35,91,.385,19,41,.463,16,50,.320,21,31,.677,107,51,92,.554,33,55,.600,18,37,.486,14,21,.667,134
1407,OKC,2021-03-04,107,@,SAS,W 107-102,240,37,85,.435,25,45,.556,12,40,.300,21,26,.808,107,40,85,.471,30,54,.556,10,31,.323,12,12,1.000,102
1408,IND,2021-02-27,107,@,NYK,L 107-110,240,38,84,.452,27,56,.482,11,28,.393,20,25,.800,107,40,81,.494,28,57,.491,12,24,.500,18,22,.818,110
1409,DET,2021-02-26,107,,SAC,L 107-110,240,37,82,.451,25,49,.510,12,33,.364,21,32,.656,107,37,89,.416,30,57,.526,7,32,.219,29,41,.707,110
1410,IND,2021-02-24,107,,GSW,L 107-111,240,37,81,.457,30,52,.577,7,29,.241,26,32,.813,107,39,83,.470,34,57,.596,5,26,.192,28,31,.903,111
1411,BOS,2021-02-23,107,@,DAL,L 107-110,240,41,86,.477,29,47,.617,12,39,.308,13,18,.722,107,42,89,.472,29,56,.518,13,33,.394,13,15,.867,110
1412,ORL,2021-02-17,107,,NYK,W 107-89,240,42,92,.457,26,58,.448,16,34,.471,7,10,.700,107,33,87,.379,26,60,.433,7,27,.259,16,19,.842,89
1413,NYK,2021-02-03,107,@,CHI,W 107-103,240,43,89,.483,32,67,.478,11,22,.500,10,15,.667,107,43,88,.489,37,52,.712,6,36,.167,11,16,.688,103
1414,GSW,2021-02-02,107,,BOS,L 107-111,240,38,83,.458,23,46,.500,15,37,.405,16,23,.696,107,39,84,.464,26,50,.520,13,34,.382,20,27,.741,111
1415,LAL,2021-02-01,107,@,ATL,W 107-99,240,40,77,.519,33,54,.611,7,23,.304,20,24,.833,107,37,78,.474,26,49,.531,11,29,.379,14,17,.824,99
1416,DET,2021-01-28,107,,LAL,W 107-92,240,40,87,.460,26,51,.510,14,36,.389,13,13,1.000,107,36,88,.409,24,60,.400,12,28,.429,8,12,.667,92
1417,PHI,2021-01-27,107,,LAL,W 107-106,240,41,85,.482,32,60,.533,9,25,.360,16,26,.615,107,41,86,.477,33,62,.532,8,24,.333,16,25,.640,106
1418,ORL,2021-01-27,107,,SAC,L 107-121,240,40,96,.417,30,70,.429,10,26,.385,17,18,.944,107,45,92,.489,31,59,.525,14,33,.424,17,26,.654,121
1419,DET,2021-01-27,107,@,CLE,L 107-122,240,37,82,.451,26,55,.473,11,27,.407,22,29,.759,107,47,87,.540,36,66,.545,11,21,.524,17,23,.739,122
1420,HOU,2021-01-26,107,,WAS,W 107-88,240,37,88,.420,25,51,.490,12,37,.324,21,29,.724,107,33,85,.388,28,59,.475,5,26,.192,17,23,.739,88
1421,CHO,2021-01-24,107,@,ORL,W 107-104,240,42,88,.477,28,52,.538,14,36,.389,9,16,.563,107,39,87,.448,22,49,.449,17,38,.447,9,13,.692,104
1422,TOR,2021-01-24,107,@,IND,W 107-102,240,37,90,.411,22,55,.400,15,35,.429,18,26,.692,107,35,87,.402,22,48,.458,13,39,.333,19,22,.864,102
1423,DET,2021-01-18,107,@,MIA,L 107-113,240,38,82,.463,25,45,.556,13,37,.351,18,24,.750,107,43,75,.573,31,45,.689,12,30,.400,15,19,.789,113
1424,MIN,2021-01-13,107,,MEM,L 107-118,240,39,90,.433,30,53,.566,9,37,.243,20,24,.833,107,50,106,.472,42,81,.519,8,25,.320,10,13,.769,118
1425,PHO,2021-01-11,107,@,WAS,L 107-128,240,39,87,.448,35,60,.583,4,27,.148,25,30,.833,107,48,92,.522,33,58,.569,15,34,.441,17,28,.607,128
1426,WAS,2021-01-08,107,@,BOS,L 107-116,240,41,88,.466,30,59,.508,11,29,.379,14,16,.875,107,41,86,.477,29,54,.537,12,32,.375,22,30,.733,116
1427,HOU,2021-01-06,107,@,IND,L 107-114,240,39,81,.481,31,51,.608,8,30,.267,21,26,.808,107,42,89,.472,33,66,.500,9,23,.391,21,26,.808,114
1428,BOS,2021-01-06,107,@,MIA,W 107-105,240,42,99,.424,30,64,.469,12,35,.343,11,12,.917,107,35,81,.432,22,45,.489,13,36,.361,22,26,.846,105
1429,PHO,2021-01-03,107,,LAC,L 107-112,240,37,75,.493,27,42,.643,10,33,.303,23,28,.821,107,40,83,.482,23,54,.426,17,29,.586,15,19,.789,112
1430,SAS,2020-12-30,107,,LAL,L 107-121,240,40,87,.460,30,63,.476,10,24,.417,17,23,.739,107,46,82,.561,32,56,.571,14,26,.538,15,20,.750,121
1431,MEM,2020-12-30,107,@,BOS,L 107-126,240,40,93,.430,31,60,.517,9,33,.273,18,25,.720,107,49,91,.538,33,52,.635,16,39,.410,12,14,.857,126
1432,OKC,2020-12-29,107,,ORL,L 107-118,240,43,87,.494,32,53,.604,11,34,.324,10,19,.526,107,49,96,.510,42,74,.568,7,22,.318,13,16,.813,118
1433,WAS,2020-12-29,107,,CHI,L 107-115,240,37,84,.440,27,47,.574,10,37,.270,23,26,.885,107,38,87,.437,23,51,.451,15,36,.417,24,32,.750,115
1434,LAL,2020-12-28,107,,POR,L 107-115,240,41,87,.471,31,60,.517,10,27,.370,15,18,.833,107,43,92,.467,27,46,.587,16,46,.348,13,15,.867,115
1435,BOS,2020-12-27,107,@,IND,L 107-108,240,40,79,.506,31,56,.554,9,23,.391,18,24,.750,107,45,88,.511,38,62,.613,7,26,.269,11,15,.733,108
1436,CHO,2020-12-26,107,,OKC,L 107-109,240,37,93,.398,24,61,.393,13,32,.406,20,32,.625,107,40,88,.455,30,52,.577,10,36,.278,19,24,.792,109
1437,WAS,2020-12-23,107,@,PHI,L 107-113,240,39,85,.459,26,58,.448,13,27,.481,16,23,.696,107,41,87,.471,33,59,.559,8,28,.286,23,30,.767,113
1438,MIA,2020-12-23,107,@,ORL,L 107-113,240,42,83,.506,35,63,.556,7,20,.350,16,19,.842,107,42,88,.477,32,60,.533,10,28,.357,19,30,.633,113
1439,NYK,2020-12-23,107,@,IND,L 107-121,240,39,85,.459,27,57,.474,12,28,.429,17,23,.739,107,46,94,.489,38,60,.633,8,34,.235,21,29,.724,121
1440,SAC,2021-05-14,106,@,MEM,L 106-107,240,37,96,.385,27,54,.500,10,42,.238,22,27,.815,106,37,84,.440,26,51,.510,11,33,.333,22,35,.629,107
1441,MIA,2021-05-13,106,,PHI,W 106-94,240,41,81,.506,28,46,.609,13,35,.371,11,11,1.000,106,36,78,.462,29,53,.547,7,25,.280,15,20,.750,94
1442,OKC,2021-05-11,106,@,SAC,L 106-122,240,39,84,.464,30,61,.492,9,23,.391,19,28,.679,106,44,86,.512,25,47,.532,19,39,.487,15,19,.789,122
1443,NYK,2021-05-09,106,@,LAC,W 106-100,240,42,90,.467,29,58,.500,13,32,.406,9,9,1.000,106,37,86,.430,25,51,.490,12,35,.343,14,16,.875,100
1444,POR,2021-05-07,106,,LAL,W 106-101,240,37,88,.420,25,51,.490,12,37,.324,20,21,.952,106,37,89,.416,26,59,.441,11,30,.367,16,22,.727,101
1445,PHI,2021-05-03,106,@,CHI,W 106-94,240,40,75,.533,29,47,.617,11,28,.393,15,21,.714,106,36,87,.414,25,53,.472,11,34,.324,11,14,.786,94
1446,UTA,2021-05-01,106,,TOR,W 106-102,240,37,78,.474,20,37,.541,17,41,.415,15,18,.833,106,42,94,.447,30,61,.492,12,33,.364,6,9,.667,102
1447,LAL,2021-04-30,106,,SAC,L 106-110,240,42,83,.506,35,55,.636,7,28,.250,15,21,.714,106,39,86,.453,27,53,.509,12,33,.364,20,22,.909,110
1448,DAL,2021-04-26,106,@,SAC,L 106-113,240,43,92,.467,31,50,.620,12,42,.286,8,14,.571,106,42,81,.519,29,52,.558,13,29,.448,16,18,.889,113
1449,MIA,2021-04-24,106,,CHI,W 106-101,240,36,80,.450,22,43,.512,14,37,.378,20,24,.833,106,38,79,.481,25,41,.610,13,38,.342,12,13,.923,101
1450,SAS,2021-04-22,106,,DET,W 106-91,240,37,80,.463,26,56,.464,11,24,.458,21,27,.778,106,35,77,.455,27,55,.491,8,22,.364,13,22,.591,91
1451,DEN,2021-04-21,106,@,POR,W 106-105,240,39,88,.443,26,49,.531,13,39,.333,15,17,.882,106,40,87,.460,28,51,.549,12,36,.333,13,15,.867,105
1452,OKC,2021-04-18,106,@,TOR,L 106-112,240,37,82,.451,23,49,.469,14,33,.424,18,21,.857,106,37,96,.385,20,58,.345,17,38,.447,21,24,.875,112
1453,CHI,2021-04-17,106,,CLE,W 106-96,240,41,82,.500,25,42,.595,16,40,.400,8,9,.889,106,39,88,.443,27,58,.466,12,30,.400,6,7,.857,96
1454,PHI,2021-04-16,106,,LAC,W 106-103,240,35,83,.422,21,39,.538,14,44,.318,22,30,.733,106,37,82,.451,18,43,.419,19,39,.487,10,16,.625,103
1455,SAS,2021-04-16,106,,POR,L 106-107,240,45,95,.474,38,72,.528,7,23,.304,9,10,.900,106,41,89,.461,30,60,.500,11,29,.379,14,16,.875,107
1456,MIA,2021-04-14,106,@,DEN,L 106-123,240,39,79,.494,26,47,.553,13,32,.406,15,18,.833,106,48,89,.539,31,53,.585,17,36,.472,10,13,.769,123
1457,CHI,2021-04-14,106,,ORL,L 106-115,240,41,86,.477,24,49,.490,17,37,.459,7,9,.778,106,44,89,.494,32,62,.516,12,27,.444,15,20,.750,115
1458,NOP,2021-04-14,106,,NYK,L 106-116,240,40,88,.455,34,60,.567,6,28,.214,20,24,.833,106,44,97,.454,27,64,.422,17,33,.515,11,13,.846,116
1459,PHO,2021-04-13,106,,MIA,W 106-86,240,38,82,.463,25,40,.625,13,42,.310,17,18,.944,106,31,82,.378,22,38,.579,9,44,.205,15,19,.789,86
1460,UTA,2021-04-13,106,,OKC,W 106-96,240,36,86,.419,19,39,.487,17,47,.362,17,20,.850,106,36,93,.387,22,59,.373,14,34,.412,10,18,.556,96
1461,WAS,2021-04-10,106,@,PHO,L 106-134,240,39,84,.464,30,59,.508,9,25,.360,19,28,.679,106,55,107,.514,38,64,.594,17,43,.395,7,7,1.000,134
1462,ORL,2021-04-09,106,,IND,L 106-111,240,38,90,.422,32,66,.485,6,24,.250,24,31,.774,106,38,92,.413,27,59,.458,11,33,.333,24,28,.857,111
1463,DEN,2021-04-07,106,,SAS,W 106-96,240,40,91,.440,32,65,.492,8,26,.308,18,24,.750,106,38,91,.418,32,67,.478,6,24,.250,14,21,.667,96
1464,PHI,2021-04-06,106,@,BOS,W 106-96,240,34,73,.466,25,49,.510,9,24,.375,29,39,.744,106,33,70,.471,19,36,.528,14,34,.412,16,18,.889,96
1465,SAC,2021-04-05,106,@,MIN,L 106-116,240,39,88,.443,30,52,.577,9,36,.250,19,24,.792,106,38,91,.418,26,59,.441,12,32,.375,28,33,.848,116
1466,CHI,2021-04-02,106,@,UTA,L 106-113,240,43,89,.483,36,61,.590,7,28,.250,13,17,.765,106,37,79,.468,24,43,.558,13,36,.361,26,27,.963,113
1467,SAC,2021-03-31,106,@,SAS,L 106-120,240,39,92,.424,28,57,.491,11,35,.314,17,19,.895,106,43,92,.467,33,66,.500,10,26,.385,24,34,.706,120
1468,OKC,2021-03-29,106,,DAL,L 106-127,240,38,81,.469,29,55,.527,9,26,.346,21,33,.636,106,51,96,.531,35,52,.673,16,44,.364,9,13,.692,127
1469,WAS,2021-03-27,106,,DET,W 106-92,240,44,91,.484,35,70,.500,9,21,.429,9,9,1.000,106,33,85,.388,23,56,.411,10,29,.345,16,19,.842,92
1470,NYK,2021-03-25,106,,WAS,W 106-102,240,34,93,.366,27,65,.415,7,28,.250,31,42,.738,106,37,80,.463,29,54,.537,8,26,.308,20,33,.606,102
1471,MIA,2021-03-21,106,,IND,L 106-109 (OT),265,39,97,.402,30,60,.500,9,37,.243,19,23,.826,106,38,98,.388,23,53,.434,15,45,.333,18,20,.900,109
1472,WAS,2021-03-21,106,@,BRK,L 106-113,240,42,79,.532,35,58,.603,7,21,.333,15,19,.789,106,44,90,.489,35,61,.574,9,29,.310,16,22,.727,113
1473,SAS,2021-03-17,106,@,CHI,W 106-99,240,38,89,.427,30,58,.517,8,31,.258,22,30,.733,106,40,91,.440,29,58,.500,11,33,.333,8,9,.889,99
1474,IND,2021-03-15,106,@,DEN,L 106-121,240,39,90,.433,22,48,.458,17,42,.405,11,13,.846,106,45,97,.464,30,69,.435,15,28,.536,16,19,.842,121
1475,SAC,2021-03-13,106,@,ATL,L 106-121,240,43,98,.439,36,62,.581,7,36,.194,13,16,.813,106,43,84,.512,31,51,.608,12,33,.364,23,33,.697,121
1476,GSW,2021-03-03,106,@,POR,L 106-108,240,41,97,.423,26,55,.473,15,42,.357,9,14,.643,106,36,86,.419,22,37,.595,14,49,.286,22,26,.846,108
1477,PHO,2021-02-26,106,@,CHI,W 106-97,240,44,88,.500,38,66,.576,6,22,.273,12,15,.800,106,39,78,.500,27,47,.574,12,31,.387,7,10,.700,97
1478,NYK,2021-02-23,106,,GSW,L 106-114,240,38,97,.392,27,68,.397,11,29,.379,19,22,.864,106,40,89,.449,27,51,.529,13,38,.342,21,24,.875,114
1479,POR,2021-02-23,106,@,DEN,L 106-111,240,41,87,.471,27,46,.587,14,41,.341,10,10,1.000,106,40,94,.426,26,58,.448,14,36,.389,17,18,.944,111
1480,CHI,2021-02-12,106,,LAC,L 106-125,240,40,85,.471,28,53,.528,12,32,.375,14,15,.933,106,50,86,.581,37,56,.661,13,30,.433,12,15,.800,125
1481,TOR,2021-02-11,106,@,BOS,L 106-120,240,41,83,.494,32,55,.582,9,28,.321,15,19,.789,106,39,86,.453,19,47,.404,20,39,.513,22,28,.786,120
1482,POR,2021-02-09,106,,ORL,W 106-97,240,35,90,.389,17,44,.386,18,46,.391,18,19,.947,106,37,88,.420,26,53,.491,11,35,.314,12,22,.545,97
1483,HOU,2021-02-06,106,,SAS,L 106-111,240,38,88,.432,26,50,.520,12,38,.316,18,25,.720,106,37,87,.425,29,62,.468,8,25,.320,29,36,.806,111
1484,MIN,2021-02-05,106,@,OKC,W 106-103,240,41,94,.436,25,54,.463,16,40,.400,8,9,.889,106,39,85,.459,26,51,.510,13,34,.382,12,17,.706,103
1485,POR,2021-02-01,106,@,MIL,L 106-134,240,39,104,.375,24,62,.387,15,42,.357,13,13,1.000,106,53,96,.552,32,54,.593,21,42,.500,7,12,.583,134
1486,OKC,2021-02-01,106,,HOU,L 106-136,240,39,89,.438,26,55,.473,13,34,.382,15,19,.789,106,49,102,.480,21,50,.420,28,52,.538,10,11,.909,136
1487,WAS,2021-01-27,106,@,NOP,L 106-124,240,37,92,.402,24,54,.444,13,38,.342,19,21,.905,106,46,89,.517,29,46,.630,17,43,.395,15,24,.625,124
1488,BOS,2021-01-27,106,@,SAS,L 106-110,240,42,98,.429,32,68,.471,10,30,.333,12,14,.857,106,46,82,.561,38,54,.704,8,28,.286,10,16,.625,110
1489,LAL,2021-01-27,106,@,PHI,L 106-107,240,41,86,.477,33,62,.532,8,24,.333,16,25,.640,106,41,85,.482,32,60,.533,9,25,.360,16,26,.615,107
1490,CHO,2021-01-27,106,,IND,L 106-116,240,37,90,.411,24,52,.462,13,38,.342,19,21,.905,106,45,88,.511,29,48,.604,16,40,.400,10,12,.833,116
1491,OKC,2021-01-22,106,@,LAC,L 106-120,240,41,87,.471,27,45,.600,14,42,.333,10,13,.769,106,43,84,.512,33,51,.647,10,33,.303,24,25,.960,120
1492,MIL,2021-01-21,106,,LAL,L 106-113,240,44,87,.506,35,59,.593,9,28,.321,9,12,.750,106,41,88,.466,22,51,.431,19,37,.514,12,15,.800,113
1493,ATL,2021-01-16,106,@,POR,L 106-112,240,38,87,.437,32,57,.561,6,30,.200,24,28,.857,106,40,103,.388,25,59,.424,15,44,.341,17,20,.850,112
1494,MEM,2021-01-16,106,,PHI,W 106-104,240,43,99,.434,35,70,.500,8,29,.276,12,18,.667,106,37,84,.440,30,59,.508,7,25,.280,23,32,.719,104
1495,CLE,2021-01-15,106,,NYK,W 106-103,240,36,79,.456,27,52,.519,9,27,.333,25,34,.735,106,40,82,.488,31,57,.544,9,25,.360,14,16,.875,103
1496,NOP,2021-01-13,106,@,LAC,L 106-111,240,42,88,.477,32,60,.533,10,28,.357,12,16,.750,106,35,74,.473,17,37,.459,18,37,.486,23,27,.852,111
1497,GSW,2021-01-10,106,,TOR,W 106-105,240,38,93,.409,25,47,.532,13,46,.283,17,19,.895,106,39,96,.406,26,58,.448,13,38,.342,14,22,.636,105
1498,SAC,2021-01-04,106,@,GSW,L 106-137,240,34,90,.378,24,55,.436,10,35,.286,28,39,.718,106,51,97,.526,28,54,.519,23,43,.535,12,14,.857,137
1499,NYK,2021-01-02,106,@,IND,W 106-102,240,42,83,.506,30,56,.536,12,27,.444,10,13,.769,106,34,84,.405,15,34,.441,19,50,.380,15,18,.833,102
1500,PHO,2021-01-01,106,@,DEN,W 106-103,240,37,76,.487,24,41,.585,13,35,.371,19,21,.905,106,39,86,.453,27,57,.474,12,29,.414,13,16,.813,103
1501,UTA,2021-01-01,106,,LAC,W 106-100,240,41,89,.461,26,47,.553,15,42,.357,9,14,.643,106,33,85,.388,20,52,.385,13,33,.394,21,24,.875,100
1502,PHO,2020-12-31,106,@,UTA,W 106-95,240,41,84,.488,24,51,.471,17,33,.515,7,10,.700,106,35,84,.417,23,50,.460,12,34,.353,13,19,.684,95
1503,DET,2020-12-29,106,,GSW,L 106-116,240,35,92,.380,22,57,.386,13,35,.371,23,29,.793,106,38,76,.500,24,43,.558,14,33,.424,26,36,.722,116
1504,CHO,2020-12-27,106,,BRK,W 106-104,240,43,96,.448,33,62,.532,10,34,.294,10,17,.588,106,35,82,.427,18,35,.514,17,47,.362,17,25,.680,104
1505,SAC,2020-12-26,106,,PHO,W 106-103,240,39,86,.453,34,63,.540,5,23,.217,23,33,.697,106,41,98,.418,30,54,.556,11,44,.250,10,13,.769,103
1506,CHI,2020-12-26,106,,IND,L 106-125,240,34,91,.374,18,52,.346,16,39,.410,22,25,.880,106,52,93,.559,43,67,.642,9,26,.346,12,19,.632,125
1507,PHO,2020-12-23,106,,DAL,W 106-102,240,38,79,.481,27,49,.551,11,30,.367,19,27,.704,106,36,85,.424,27,48,.563,9,37,.243,21,26,.808,102
1508,BRK,2021-05-15,105,,CHI,W 105-91,240,41,87,.471,27,53,.509,14,34,.412,9,15,.600,105,34,98,.347,23,57,.404,11,41,.268,12,17,.706,91
1509,CLE,2021-05-14,105,@,WAS,L 105-120,240,39,84,.464,29,48,.604,10,36,.278,17,21,.810,105,41,89,.461,34,64,.531,7,25,.280,31,37,.838,120
1510,POR,2021-05-12,105,@,UTA,W 105-98,240,40,91,.440,27,59,.458,13,32,.406,12,17,.706,105,35,85,.412,23,45,.511,12,40,.300,16,21,.762,98
1511,NYK,2021-05-07,105,@,PHO,L 105-128,240,38,84,.452,27,52,.519,11,32,.344,18,23,.783,105,43,92,.467,25,51,.490,18,41,.439,24,25,.960,128
1512,CLE,2021-05-05,105,,POR,L 105-141,240,37,92,.402,24,54,.444,13,38,.342,18,26,.692,105,53,92,.576,37,59,.627,16,33,.485,19,25,.760,141
1513,LAC,2021-05-04,105,,TOR,W 105-100,240,39,75,.520,24,41,.585,15,34,.441,12,13,.923,105,40,87,.460,28,52,.538,12,35,.343,8,13,.615,100
1514,DET,2021-04-29,105,,DAL,L 105-115,240,36,71,.507,26,42,.619,10,29,.345,23,34,.676,105,40,89,.449,27,59,.458,13,30,.433,22,23,.957,115
1515,SAC,2021-04-28,105,,UTA,L 105-154,240,42,87,.483,35,66,.530,7,21,.333,14,17,.824,105,55,86,.640,31,45,.689,24,41,.585,20,21,.952,154
1516,MIN,2021-04-26,105,,UTA,W 105-104,240,37,83,.446,21,39,.538,16,44,.364,15,21,.714,105,37,95,.389,21,38,.553,16,57,.281,14,19,.737,104
1517,POR,2021-04-21,105,,DEN,L 105-106,240,40,87,.460,28,51,.549,12,36,.333,13,15,.867,105,39,88,.443,26,49,.531,13,39,.333,15,17,.882,106
1518,CHI,2021-04-21,105,@,CLE,L 105-121,240,39,79,.494,26,42,.619,13,37,.351,14,18,.778,105,45,88,.511,29,52,.558,16,36,.444,15,19,.789,121
1519,MEM,2021-04-21,105,@,LAC,L 105-117,240,38,84,.452,25,54,.463,13,30,.433,16,23,.696,105,38,84,.452,24,57,.421,14,27,.519,27,36,.750,117
1520,CLE,2021-04-19,105,@,DET,L 105-109,240,42,86,.488,37,60,.617,5,26,.192,16,20,.800,105,42,86,.488,32,59,.542,10,27,.370,15,21,.714,109
1521,MIN,2021-04-18,105,@,LAC,L 105-124,240,36,88,.409,19,43,.442,17,45,.378,16,21,.762,105,45,89,.506,24,47,.511,21,42,.500,13,17,.765,124
1522,MIN,2021-04-14,105,,MIL,L 105-130,240,34,92,.370,19,51,.373,15,41,.366,22,31,.710,105,46,98,.469,27,58,.466,19,40,.475,19,23,.826,130
1523,BOS,2021-04-11,105,@,DEN,W 105-87,240,39,87,.448,32,54,.593,7,33,.212,20,23,.870,105,32,88,.364,24,54,.444,8,34,.235,15,18,.833,87
1524,ATL,2021-04-11,105,@,CHO,W 105-101,240,38,84,.452,21,45,.467,17,39,.436,12,16,.750,105,37,80,.463,22,37,.595,15,43,.349,12,14,.857,101
1525,MIL,2021-03-29,105,@,LAC,L 105-129,240,38,81,.469,27,51,.529,11,30,.367,18,21,.857,105,51,95,.537,32,61,.525,19,34,.559,8,10,.800,129
1526,ORL,2021-03-26,105,,POR,L 105-112,240,42,95,.442,30,68,.441,12,27,.444,9,17,.529,105,40,85,.471,22,45,.489,18,40,.450,14,21,.667,112
1527,MIA,2021-03-26,105,@,CHO,L 105-110,240,40,87,.460,25,44,.568,15,43,.349,10,20,.500,105,39,79,.494,21,36,.583,18,43,.419,14,19,.737,110
1528,CLE,2021-03-22,105,,SAC,L 105-119,240,41,96,.427,37,79,.468,4,17,.235,19,23,.826,105,49,90,.544,36,60,.600,13,30,.433,8,12,.667,119
1529,TOR,2021-03-21,105,@,CLE,L 105-116,240,37,95,.389,22,49,.449,15,46,.326,16,19,.842,105,39,77,.506,22,44,.500,17,33,.515,21,28,.750,116
1530,SAC,2021-03-20,105,@,PHI,L 105-129,240,39,85,.459,29,57,.509,10,28,.357,17,27,.630,105,48,86,.558,37,63,.587,11,23,.478,22,29,.759,129
1531,CHO,2021-03-18,105,@,LAL,L 105-116,240,41,83,.494,30,54,.556,11,29,.379,12,20,.600,105,44,92,.478,31,53,.585,13,39,.333,15,20,.750,116
1532,PHI,2021-03-17,105,,MIL,L 105-109 (OT),265,43,109,.394,29,68,.426,14,41,.341,5,8,.625,105,41,101,.406,32,62,.516,9,39,.231,18,24,.750,109
1533,DAL,2021-03-17,105,,LAC,W 105-89,240,40,79,.506,25,45,.556,15,34,.441,10,12,.833,105,37,88,.420,28,56,.500,9,32,.281,6,11,.545,89
1534,LAL,2021-03-12,105,,IND,W 105-100,240,34,76,.447,27,54,.500,7,22,.318,30,39,.769,105,37,88,.420,29,52,.558,8,36,.222,18,21,.857,100
1535,HOU,2021-03-11,105,@,SAC,L 105-125,240,41,99,.414,30,54,.556,11,45,.244,12,17,.706,105,45,92,.489,34,59,.576,11,33,.333,24,28,.857,125
1536,CHI,2021-03-11,105,,PHI,L 105-127,240,39,83,.470,25,54,.463,14,29,.483,13,16,.813,105,53,103,.515,43,70,.614,10,33,.303,11,15,.733,127
1537,NOP,2021-03-11,105,,MIN,L 105-135,240,43,100,.430,37,68,.544,6,32,.188,13,24,.542,105,51,95,.537,32,55,.582,19,40,.475,14,16,.875,135
1538,CHO,2021-03-11,105,,DET,W 105-102,240,36,90,.400,26,60,.433,10,30,.333,23,24,.958,105,38,85,.447,23,39,.590,15,46,.326,11,14,.786,102
1539,TOR,2021-03-03,105,,DET,L 105-129,240,34,77,.442,22,41,.537,12,36,.333,25,30,.833,105,48,91,.527,28,50,.560,20,41,.488,13,21,.619,129
1540,MIL,2021-02-28,105,,LAC,W 105-100,240,38,85,.447,26,47,.553,12,38,.316,17,22,.773,105,40,97,.412,26,53,.491,14,44,.318,6,7,.857,100
1541,DET,2021-02-23,105,@,ORL,W 105-93,240,41,88,.466,31,54,.574,10,34,.294,13,16,.813,105,33,88,.375,19,50,.380,14,38,.368,13,22,.591,93
1542,ORL,2021-02-21,105,,DET,W 105-96,240,35,81,.432,26,51,.510,9,30,.300,26,29,.897,105,34,91,.374,23,51,.451,11,40,.275,17,21,.810,96
1543,CHI,2021-02-19,105,@,PHI,L 105-112,240,40,95,.421,33,63,.524,7,32,.219,18,18,1.000,105,41,87,.471,34,66,.515,7,21,.333,23,29,.793,112
1544,CHI,2021-02-17,105,,DET,W 105-102,240,41,85,.482,33,57,.579,8,28,.286,15,24,.625,105,37,82,.451,29,54,.537,8,28,.286,20,24,.833,102
1545,LAL,2021-02-14,105,@,DEN,L 105-122,240,40,87,.460,34,59,.576,6,28,.214,19,29,.655,105,39,85,.459,20,38,.526,19,47,.404,25,34,.735,122
1546,MEM,2021-02-12,105,@,LAL,L 105-115,240,39,80,.488,27,51,.529,12,29,.414,15,19,.789,105,43,85,.506,37,55,.673,6,30,.200,23,33,.697,115
1547,ORL,2021-02-11,105,@,GSW,L 105-111,240,38,97,.392,23,64,.359,15,33,.455,14,18,.778,105,41,88,.466,21,38,.553,20,50,.400,9,12,.750,111
1548,SAS,2021-02-08,105,,GSW,W 105-100,240,39,96,.406,28,65,.431,11,31,.355,16,19,.842,105,38,86,.442,25,49,.510,13,37,.351,11,15,.733,100
1549,WAS,2021-02-08,105,@,CHI,W 105-101,240,36,86,.419,30,60,.500,6,26,.231,27,36,.750,105,36,85,.424,27,55,.491,9,30,.300,20,24,.833,101
1550,CLE,2021-02-05,105,,MIL,L 105-123,240,41,92,.446,30,60,.500,11,32,.344,12,16,.750,105,50,97,.515,43,75,.573,7,22,.318,16,22,.727,123
1551,PHI,2021-02-04,105,,POR,L 105-121,240,39,81,.481,32,54,.593,7,27,.259,20,24,.833,105,45,98,.459,32,67,.478,13,31,.419,18,23,.783,121
1552,DET,2021-02-02,105,@,UTA,L 105-117,240,39,93,.419,30,66,.455,9,27,.333,18,20,.900,105,38,82,.463,22,40,.550,16,42,.381,25,29,.862,117
1553,MIA,2021-01-30,105,,SAC,W 105-104,240,36,77,.468,25,45,.556,11,32,.344,22,26,.846,105,41,85,.482,24,40,.600,17,45,.378,5,11,.455,104
1554,DAL,2021-01-30,105,,PHO,L 105-111,240,44,83,.530,35,54,.648,9,29,.310,8,14,.571,105,37,81,.457,27,59,.458,10,22,.455,27,31,.871,111
1555,IND,2021-01-29,105,@,CHO,L 105-108,240,42,87,.483,31,52,.596,11,35,.314,10,13,.769,105,43,85,.506,27,48,.563,16,37,.432,6,9,.667,108
1556,MIA,2021-01-28,105,,LAC,L 105-109,240,40,90,.444,27,57,.474,13,33,.394,12,15,.800,105,36,87,.414,19,45,.422,17,42,.405,20,22,.909,109
1557,DEN,2021-01-17,105,,UTA,L 105-109,240,40,100,.400,26,63,.413,14,37,.378,11,15,.733,105,39,76,.513,24,39,.615,15,37,.405,16,28,.571,109
1558,NYK,2021-01-17,105,@,BOS,W 105-75,240,38,80,.475,26,49,.531,12,31,.387,17,21,.810,105,25,84,.298,18,38,.474,7,46,.152,18,29,.621,75
1559,SAS,2021-01-14,105,,HOU,L 105-109,240,42,92,.457,33,61,.541,9,31,.290,12,16,.750,105,42,86,.488,29,53,.547,13,33,.394,12,19,.632,109
1560,TOR,2021-01-10,105,@,GSW,L 105-106,240,39,96,.406,26,58,.448,13,38,.342,14,22,.636,105,38,93,.409,25,47,.532,13,46,.283,17,19,.895,106
1561,ATL,2021-01-09,105,@,CHO,L 105-113,240,34,89,.382,20,44,.455,14,45,.311,23,28,.821,105,40,77,.519,25,44,.568,15,33,.455,18,24,.750,113
1562,LAC,2021-01-08,105,@,GSW,L 105-115,240,40,83,.482,26,52,.500,14,31,.452,11,13,.846,105,40,82,.488,20,41,.488,20,41,.488,15,18,.833,115
1563,PHO,2021-01-08,105,@,DET,L 105-110 (OT),265,41,91,.451,24,39,.615,17,52,.327,6,13,.462,105,37,90,.411,26,56,.464,11,34,.324,25,29,.862,110
1564,ORL,2021-01-06,105,,CLE,W 105-94,240,40,81,.494,28,52,.538,12,29,.414,13,18,.722,105,36,85,.424,32,59,.542,4,26,.154,18,26,.692,94
1565,MIA,2021-01-06,105,,BOS,L 105-107,240,35,81,.432,22,45,.489,13,36,.361,22,26,.846,105,42,99,.424,30,64,.469,12,35,.343,11,12,.917,107
1566,POR,2020-12-30,105,@,LAC,L 105-128,240,32,76,.421,20,38,.526,12,38,.316,29,34,.853,105,47,95,.495,29,57,.509,18,38,.474,16,22,.727,128
1567,DEN,2021-05-14,104,@,DET,W 104-91,240,42,86,.488,33,54,.611,9,32,.281,11,14,.786,104,34,83,.410,28,46,.609,6,37,.162,17,23,.739,91
1568,DAL,2021-05-11,104,@,MEM,L 104-133,240,37,88,.420,25,50,.500,12,38,.316,18,19,.947,104,51,89,.573,35,56,.625,16,33,.485,15,16,.938,133
1569,DET,2021-05-08,104,@,PHI,L 104-118,240,41,84,.488,30,50,.600,11,34,.324,11,16,.688,104,41,84,.488,32,54,.593,9,30,.300,27,31,.871,118
1570,SAC,2021-05-07,104,,SAS,L 104-113,240,41,84,.488,28,52,.538,13,32,.406,9,15,.600,104,46,89,.517,42,67,.627,4,22,.182,17,19,.895,113
1571,SAC,2021-05-05,104,@,IND,W 104-93,240,43,95,.453,35,63,.556,8,32,.250,10,14,.714,104,36,83,.434,27,58,.466,9,25,.360,12,17,.706,93
1572,MEM,2021-05-03,104,,NYK,L 104-118,240,34,86,.395,18,45,.400,16,41,.390,20,24,.833,104,45,89,.506,31,62,.500,14,27,.519,14,18,.778,118
1573,LAC,2021-05-01,104,,DEN,L 104-110,240,36,83,.434,22,49,.449,14,34,.412,18,24,.750,104,39,80,.488,27,48,.563,12,32,.375,20,21,.952,110
1574,ATL,2021-04-30,104,@,PHI,L 104-126,240,36,82,.439,26,54,.481,10,28,.357,22,28,.786,104,47,101,.465,37,73,.507,10,28,.357,22,26,.846,126
1575,CLE,2021-04-28,104,,ORL,L 104-109,240,37,92,.402,25,48,.521,12,44,.273,18,24,.750,104,43,85,.506,33,56,.589,10,29,.345,13,20,.650,109
1576,CHO,2021-04-27,104,,MIL,L 104-114,240,38,82,.463,26,47,.553,12,35,.343,16,23,.696,104,47,93,.505,38,58,.655,9,35,.257,11,14,.786,114
1577,UTA,2021-04-26,104,@,MIN,L 104-105,240,37,95,.389,21,38,.553,16,57,.281,14,19,.737,104,37,83,.446,21,39,.538,16,44,.364,15,21,.714,105
1578,BOS,2021-04-25,104,@,CHO,L 104-125,240,34,88,.386,20,47,.426,14,41,.341,22,26,.846,104,47,93,.505,26,50,.520,21,43,.488,10,11,.909,125
1579,MIL,2021-04-25,104,@,ATL,L 104-111,240,39,81,.481,31,53,.585,8,28,.286,18,23,.783,104,40,88,.455,27,53,.509,13,35,.371,18,23,.783,111
1580,HOU,2021-04-23,104,,LAC,L 104-109,240,36,89,.404,23,47,.489,13,42,.310,19,22,.864,104,39,97,.402,27,63,.429,12,34,.353,19,23,.826,109
1581,BOS,2021-04-23,104,@,BRK,L 104-109,240,38,94,.404,21,52,.404,17,42,.405,11,16,.688,104,37,86,.430,26,54,.481,11,32,.344,24,28,.857,109
1582,OKC,2021-04-16,104,@,DET,L 104-110,240,39,97,.402,32,58,.552,7,39,.179,19,26,.731,104,38,90,.422,28,55,.509,10,35,.286,24,34,.706,110
1583,LAL,2021-04-08,104,@,MIA,L 104-110,240,35,79,.443,23,44,.523,12,35,.343,22,25,.880,104,34,71,.479,24,46,.522,10,25,.400,32,40,.800,110
1584,LAC,2021-04-04,104,,LAL,W 104-86,240,41,86,.477,27,58,.466,14,28,.500,8,9,.889,104,32,80,.400,25,57,.439,7,23,.304,15,20,.750,86
1585,DEN,2021-03-30,104,,PHI,W 104-95,240,39,81,.481,27,50,.540,12,31,.387,14,17,.824,104,35,82,.427,24,47,.511,11,35,.314,14,15,.933,95
1586,WAS,2021-03-30,104,,CHO,L 104-114,240,41,100,.410,31,63,.492,10,37,.270,12,15,.800,104,42,90,.467,28,56,.500,14,34,.412,16,19,.842,114
1587,TOR,2021-03-29,104,@,DET,L 104-118,240,35,86,.407,24,50,.480,11,36,.306,23,28,.821,104,38,75,.507,23,45,.511,15,30,.500,27,34,.794,118
1588,CHI,2021-03-27,104,@,SAS,L 104-120,240,41,95,.432,33,61,.541,8,34,.235,14,18,.778,104,46,85,.541,36,60,.600,10,25,.400,18,28,.643,120
1589,PHO,2021-03-26,104,@,TOR,W 104-100,240,43,90,.478,34,54,.630,9,36,.250,9,9,1.000,104,37,90,.411,25,45,.556,12,45,.267,14,16,.875,100
1590,CHO,2021-03-17,104,@,DEN,L 104-129,240,36,80,.450,24,42,.571,12,38,.316,20,28,.714,104,52,90,.578,36,46,.783,16,44,.364,9,13,.692,129
1591,TOR,2021-03-13,104,@,CHO,L 104-114,240,37,96,.385,22,50,.440,15,46,.326,15,18,.833,104,39,81,.481,18,32,.563,21,49,.429,15,19,.789,114
1592,SAS,2021-03-12,104,,ORL,W 104-77,240,40,89,.449,30,60,.500,10,29,.345,14,18,.778,104,29,80,.363,19,42,.452,10,38,.263,9,12,.750,77
1593,GSW,2021-03-11,104,@,LAC,L 104-130,240,38,88,.432,29,52,.558,9,36,.250,19,27,.704,104,44,96,.458,26,55,.473,18,41,.439,24,29,.828,130
1594,SAS,2021-03-10,104,@,DAL,L 104-115,240,38,83,.458,26,55,.473,12,28,.429,16,20,.800,104,43,83,.518,30,43,.698,13,40,.325,16,19,.842,115
1595,DET,2021-03-04,104,@,NYK,L 104-114,240,39,80,.488,25,44,.568,14,36,.389,12,15,.800,104,45,83,.542,36,56,.643,9,27,.333,15,19,.789,114
1596,LAL,2021-03-02,104,,PHO,L 104-114,240,40,79,.506,29,48,.604,11,31,.355,13,17,.765,104,38,77,.494,22,48,.458,16,29,.552,22,25,.880,114
1597,OKC,2021-02-16,104,,POR,L 104-115,240,37,85,.435,27,52,.519,10,33,.303,20,27,.741,104,42,96,.438,22,49,.449,20,47,.426,11,17,.647,115
1598,MIN,2021-02-16,104,,LAL,L 104-112,240,39,93,.419,23,59,.390,16,34,.471,10,13,.769,104,42,77,.545,31,51,.608,11,26,.423,17,21,.810,112
1599,WAS,2021-02-14,104,,BOS,W 104-91,240,33,83,.398,26,53,.491,7,30,.233,31,36,.861,104,32,90,.356,23,55,.418,9,35,.257,18,30,.600,91
1600,BRK,2021-02-10,104,,IND,W 104-94,240,32,76,.421,23,45,.511,9,31,.290,31,35,.886,104,36,92,.391,21,54,.389,15,38,.395,7,11,.636,94
1601,OKC,2021-02-03,104,,HOU,W 104-87,240,36,83,.434,26,50,.520,10,33,.303,22,26,.846,104,33,86,.384,21,40,.525,12,46,.261,9,13,.692,87
1602,CLE,2021-01-31,104,@,MIN,L 104-109,240,41,84,.488,37,68,.544,4,16,.250,18,23,.783,104,41,91,.451,25,51,.490,16,40,.400,11,15,.733,109
1603,SAC,2021-01-30,104,@,MIA,L 104-105,240,41,85,.482,24,40,.600,17,45,.378,5,11,.455,104,36,77,.468,25,45,.556,11,32,.344,22,26,.846,105
1604,HOU,2021-01-28,104,,POR,W 104-101,240,38,90,.422,25,43,.581,13,47,.277,15,18,.833,104,39,93,.419,22,52,.423,17,41,.415,6,8,.750,101
1605,DAL,2021-01-27,104,@,UTA,L 104-116,240,42,91,.462,30,56,.536,12,35,.343,8,9,.889,104,42,91,.462,26,50,.520,16,41,.390,16,21,.762,116
1606,PHI,2021-01-25,104,@,DET,L 104-119,240,40,94,.426,31,66,.470,9,28,.321,15,20,.750,104,35,70,.500,18,32,.563,17,38,.447,32,38,.842,119
1607,ORL,2021-01-24,104,,CHO,L 104-107,240,39,87,.448,22,49,.449,17,38,.447,9,13,.692,104,42,88,.477,28,52,.538,14,36,.389,9,16,.563,107
1608,GSW,2021-01-21,104,,NYK,L 104-119,240,33,86,.384,24,48,.500,9,38,.237,29,39,.744,104,38,82,.463,27,58,.466,11,24,.458,32,41,.780,119
1609,POR,2021-01-18,104,,SAS,L 104-125,240,39,90,.433,29,55,.527,10,35,.286,16,19,.842,104,48,90,.533,33,57,.579,15,33,.455,14,16,.875,125
1610,PHO,2021-01-18,104,@,MEM,L 104-108,240,40,88,.455,25,52,.481,15,36,.417,9,16,.563,104,41,83,.494,30,57,.526,11,26,.423,15,20,.750,108
1611,PHI,2021-01-16,104,@,MEM,L 104-106,240,37,84,.440,30,59,.508,7,25,.280,23,32,.719,104,43,99,.434,35,70,.500,8,29,.276,12,18,.667,106
1612,GSW,2021-01-14,104,@,DEN,L 104-114,240,38,81,.469,27,52,.519,11,29,.379,17,24,.708,104,41,90,.456,30,53,.566,11,37,.297,21,27,.778,114
1613,DAL,2021-01-13,104,@,CHO,W 104-93,240,40,96,.417,25,50,.500,15,46,.326,9,16,.563,104,38,100,.380,28,62,.452,10,38,.263,7,14,.500,93
1614,IND,2021-01-12,104,@,GSW,W 104-95,240,39,88,.443,30,60,.500,9,28,.321,17,25,.680,104,34,89,.382,21,51,.412,13,38,.342,14,22,.636,95
1615,BRK,2020-12-27,104,@,CHO,L 104-106,240,35,82,.427,18,35,.514,17,47,.362,17,25,.680,104,43,96,.448,33,62,.532,10,34,.294,10,17,.588,106
1616,CHI,2020-12-23,104,,ATL,L 104-124,240,36,87,.414,28,52,.538,8,35,.229,24,28,.857,104,43,80,.538,29,45,.644,14,35,.400,24,29,.828,124
1617,SAS,2021-05-15,103,,PHO,L 103-140,240,39,88,.443,35,62,.565,4,26,.154,21,24,.875,103,52,94,.553,37,61,.607,15,33,.455,21,22,.955,140
1618,MIN,2021-05-13,103,,DEN,L 103-114,240,34,80,.425,18,39,.462,16,41,.390,19,32,.594,103,46,96,.479,34,60,.567,12,36,.333,10,11,.909,114
1619,IND,2021-05-11,103,,PHI,W 103-94,240,37,83,.446,23,42,.548,14,41,.341,15,16,.938,103,38,87,.437,30,61,.492,8,26,.308,10,14,.714,94
1620,PHO,2021-05-05,103,@,ATL,L 103-135,240,33,79,.418,21,47,.447,12,32,.375,25,29,.862,103,53,84,.631,40,58,.690,13,26,.500,16,18,.889,135
1621,SAC,2021-05-04,103,@,OKC,W 103-99,240,39,95,.411,27,52,.519,12,43,.279,13,16,.813,103,35,98,.357,24,62,.387,11,36,.306,18,25,.720,99
1622,GSW,2021-05-04,103,@,NOP,L 103-108,240,39,93,.419,19,40,.475,20,53,.377,5,7,.714,103,39,97,.402,27,67,.403,12,30,.400,18,22,.818,108
1623,TOR,2021-04-27,103,,BRK,L 103-116,240,36,91,.396,21,48,.438,15,43,.349,16,19,.842,103,40,83,.482,22,38,.579,18,45,.400,18,18,1.000,116
1624,GSW,2021-04-27,103,,DAL,L 103-133,240,34,84,.405,18,41,.439,16,43,.372,19,24,.792,103,48,92,.522,30,57,.526,18,35,.514,19,22,.864,133
1625,ORL,2021-04-26,103,,LAL,L 103-114,240,36,76,.474,25,51,.490,11,25,.440,20,24,.833,103,47,87,.540,36,56,.643,11,31,.355,9,14,.643,114
1626,LAC,2021-04-26,103,@,NOP,L 103-120,240,36,90,.400,22,45,.489,14,45,.311,17,17,1.000,103,44,82,.537,29,53,.547,15,29,.517,17,26,.654,120
1627,TOR,2021-04-24,103,@,NYK,L 103-120,240,36,83,.434,19,39,.487,17,44,.386,14,19,.737,103,42,75,.560,26,44,.591,16,31,.516,20,24,.833,120
1628,MIA,2021-04-23,103,@,ATL,L 103-118,240,38,79,.481,25,42,.595,13,37,.351,14,16,.875,103,43,80,.538,28,45,.622,15,35,.429,17,19,.895,118
1629,BRK,2021-04-21,103,@,TOR,L 103-114,240,36,91,.396,23,50,.460,13,41,.317,18,23,.783,103,39,90,.433,21,43,.488,18,47,.383,18,21,.857,114
1630,LAC,2021-04-16,103,@,PHI,L 103-106,240,37,82,.451,18,43,.419,19,39,.487,10,16,.625,103,35,83,.422,21,39,.538,14,44,.318,22,30,.733,106
1631,CLE,2021-04-14,103,@,CHO,W 103-90,240,37,76,.487,24,45,.533,13,31,.419,16,19,.842,103,34,84,.405,18,40,.450,16,44,.364,6,12,.500,90
1632,TOR,2021-04-13,103,,ATL,L 103-108,240,42,88,.477,32,49,.653,10,39,.256,9,13,.692,103,40,84,.476,27,54,.500,13,30,.433,15,22,.682,108
1633,DET,2021-04-10,103,@,POR,L 103-118,240,37,83,.446,28,57,.491,9,26,.346,20,28,.714,103,43,90,.478,30,61,.492,13,29,.448,19,24,.792,118
1634,POR,2021-04-08,103,@,UTA,L 103-122,240,38,96,.396,25,48,.521,13,48,.271,14,18,.778,103,43,95,.453,31,53,.585,12,42,.286,24,27,.889,122
1635,PHO,2021-04-08,103,@,LAC,L 103-113,240,36,71,.507,30,47,.638,6,24,.250,25,30,.833,103,42,84,.500,24,47,.511,18,37,.486,11,12,.917,113
1636,TOR,2021-04-05,103,,WAS,W 103-101,240,44,94,.468,37,61,.607,7,33,.212,8,11,.727,103,37,94,.394,25,59,.424,12,35,.343,15,18,.833,101
1637,UTA,2021-04-05,103,@,DAL,L 103-111,240,37,88,.420,25,44,.568,12,44,.273,17,22,.773,103,41,91,.451,18,42,.429,23,49,.469,6,8,.750,111
1638,OKC,2021-04-02,103,@,PHO,L 103-140,240,35,89,.393,20,51,.392,15,38,.395,18,23,.783,103,54,90,.600,39,57,.684,15,33,.455,17,21,.810,140
1639,NOP,2021-04-02,103,,ATL,L 103-126,240,38,88,.432,30,59,.508,8,29,.276,19,23,.826,103,49,87,.563,36,58,.621,13,29,.448,15,21,.714,126
1640,TOR,2021-03-31,103,@,OKC,L 103-113,240,35,90,.389,19,44,.432,16,46,.348,17,20,.850,103,39,86,.453,25,53,.472,14,33,.424,21,28,.750,113
1641,ORL,2021-03-30,103,@,LAC,W 103-96,240,38,92,.413,33,75,.440,5,17,.294,22,25,.880,103,37,89,.416,25,52,.481,12,37,.324,10,10,1.000,96
1642,DAL,2021-03-27,103,@,NOP,L 103-112,240,37,83,.446,27,52,.519,10,31,.323,19,24,.792,103,42,81,.519,33,55,.600,9,26,.346,19,29,.655,112
1643,CLE,2021-03-24,103,@,CHI,W 103-94,240,42,92,.457,31,63,.492,11,29,.379,8,10,.800,103,37,83,.446,29,55,.527,8,28,.286,12,14,.857,94
1644,MIN,2021-03-22,103,,OKC,L 103-112,240,38,92,.413,24,53,.453,14,39,.359,13,18,.722,103,41,87,.471,20,50,.400,21,37,.568,9,10,.900,112
1645,GSW,2021-03-20,103,@,MEM,L 103-111,240,31,90,.344,18,49,.367,13,41,.317,28,34,.824,103,37,95,.389,27,63,.429,10,32,.313,27,31,.871,111
1646,MEM,2021-03-19,103,,GSW,L 103-116,240,39,84,.464,31,58,.534,8,26,.308,17,21,.810,103,44,91,.484,29,50,.580,15,41,.366,13,18,.722,116
1647,DEN,2021-03-13,103,,DAL,L 103-116,240,37,90,.411,21,49,.429,16,41,.390,13,18,.722,103,42,86,.488,24,40,.600,18,46,.391,14,16,.875,116
1648,DEN,2021-03-12,103,@,MEM,W 103-102,240,41,92,.446,28,55,.509,13,37,.351,8,11,.727,103,40,87,.460,26,59,.441,14,28,.500,8,8,1.000,102
1649,ORL,2021-03-11,103,@,MIA,L 103-111,240,39,96,.406,27,62,.435,12,34,.353,13,15,.867,103,41,91,.451,25,42,.595,16,49,.327,13,22,.591,111
1650,MIA,2021-03-04,103,@,NOP,W 103-93,240,36,73,.493,26,43,.605,10,30,.333,21,25,.840,103,33,84,.393,22,41,.537,11,43,.256,16,20,.800,93
1651,IND,2021-03-04,103,,DEN,L 103-113,240,41,90,.456,27,51,.529,14,39,.359,7,12,.583,103,45,77,.584,33,49,.673,12,28,.429,11,16,.688,113
1652,PHI,2021-02-21,103,@,TOR,L 103-110,240,33,85,.388,22,48,.458,11,37,.297,26,35,.743,103,40,81,.494,26,47,.553,14,34,.412,16,18,.889,110
1653,NYK,2021-02-21,103,,MIN,W 103-99,240,33,78,.423,27,60,.450,6,18,.333,31,38,.816,103,33,82,.402,17,47,.362,16,35,.457,17,21,.810,99
1654,CLE,2021-02-19,103,,DEN,L 103-120,240,39,83,.470,27,52,.519,12,31,.387,13,21,.619,103,46,80,.575,31,49,.633,15,31,.484,13,17,.765,120
1655,UTA,2021-02-07,103,@,IND,W 103-95,240,38,92,.413,25,50,.500,13,42,.310,14,21,.667,103,37,93,.398,29,64,.453,8,29,.276,13,18,.722,95
1656,NYK,2021-02-07,103,,MIA,L 103-109,240,38,85,.447,22,43,.512,16,42,.381,11,15,.733,103,40,83,.482,27,48,.563,13,35,.371,16,20,.800,109
1657,OKC,2021-02-05,103,,MIN,L 103-106,240,39,85,.459,26,51,.510,13,34,.382,12,17,.706,103,41,94,.436,25,54,.463,16,40,.400,8,9,.889,106
1658,MEM,2021-02-04,103,,HOU,L 103-115,240,37,87,.425,25,52,.481,12,35,.343,17,24,.708,103,41,87,.471,22,42,.524,19,45,.422,14,17,.824,115
1659,CHI,2021-02-03,103,,NYK,L 103-107,240,43,88,.489,37,52,.712,6,36,.167,11,16,.688,103,43,89,.483,32,67,.478,11,22,.500,10,15,.667,107
1660,WAS,2021-02-03,103,@,MIA,W 103-100,240,35,84,.417,20,47,.426,15,37,.405,18,25,.720,103,36,83,.434,24,48,.500,12,35,.343,16,22,.727,100
1661,CHI,2021-01-25,103,,BOS,L 103-119,240,41,88,.466,24,49,.490,17,39,.436,4,10,.400,103,44,87,.506,29,58,.500,15,29,.517,16,20,.800,119
1662,CLE,2021-01-24,103,@,BOS,L 103-141,240,34,85,.400,24,52,.462,10,33,.303,25,34,.735,103,52,93,.559,38,65,.585,14,28,.500,23,27,.852,141
1663,SAC,2021-01-22,103,,NYK,W 103-94,240,38,91,.418,26,57,.456,12,34,.353,15,21,.714,103,36,94,.383,31,72,.431,5,22,.227,17,25,.680,94
1664,HOU,2021-01-22,103,@,DET,W 103-102,240,37,95,.389,23,54,.426,14,41,.341,15,20,.750,103,31,82,.378,16,50,.320,15,32,.469,25,37,.676,102
1665,HOU,2021-01-20,103,,PHO,L 103-109,240,37,88,.420,27,57,.474,10,31,.323,19,22,.864,103,42,89,.472,34,55,.618,8,34,.235,17,19,.895,109
1666,SAS,2021-01-16,103,,HOU,W 103-91,240,40,100,.400,35,76,.461,5,24,.208,18,23,.783,103,31,84,.369,19,52,.365,12,32,.375,17,27,.630,91
1667,NYK,2021-01-15,103,@,CLE,L 103-106,240,40,82,.488,31,57,.544,9,25,.360,14,16,.875,103,36,79,.456,27,52,.519,9,27,.333,25,34,.735,106
1668,PHI,2021-01-09,103,,DEN,L 103-115,240,43,103,.417,32,68,.471,11,35,.314,6,10,.600,103,45,90,.500,33,57,.579,12,33,.364,13,15,.867,115
1669,ORL,2021-01-04,103,,CLE,W 103-83,240,38,88,.432,23,54,.426,15,34,.441,12,13,.923,103,33,85,.388,23,57,.404,10,28,.357,7,12,.583,83
1670,DEN,2021-01-01,103,,PHO,L 103-106,240,39,86,.453,27,57,.474,12,29,.414,13,16,.813,103,37,76,.487,24,41,.585,13,35,.371,19,21,.905,106
1671,SAS,2021-01-01,103,,LAL,L 103-109,240,36,85,.424,23,51,.451,13,34,.382,18,26,.692,103,41,101,.406,27,68,.397,14,33,.424,13,16,.813,109
1672,PHO,2020-12-26,103,@,SAC,L 103-106,240,41,98,.418,30,54,.556,11,44,.250,10,13,.769,103,39,86,.453,34,63,.540,5,23,.217,23,33,.697,106
1673,NYK,2021-05-13,102,,SAS,W 102-98,240,35,86,.407,21,51,.412,14,35,.400,18,18,1.000,102,38,91,.418,32,70,.457,6,21,.286,16,19,.842,98
1674,TOR,2021-05-13,102,@,CHI,L 102-114,240,40,90,.444,28,54,.519,12,36,.333,10,18,.556,102,45,83,.542,28,47,.596,17,36,.472,7,10,.700,114
1675,CLE,2021-05-12,102,,BOS,W 102-94,240,36,80,.450,28,56,.500,8,24,.333,22,27,.815,102,36,101,.356,24,60,.400,12,41,.293,10,14,.714,94
1676,ORL,2021-05-11,102,@,MIL,L 102-114,240,39,94,.415,29,64,.453,10,30,.333,14,20,.700,102,43,101,.426,35,68,.515,8,33,.242,20,27,.741,114
1677,CLE,2021-05-10,102,,IND,L 102-111,240,33,93,.355,20,54,.370,13,39,.333,23,30,.767,102,44,88,.500,33,61,.541,11,27,.407,12,16,.750,111
1678,SAS,2021-05-08,102,@,POR,L 102-124,240,37,93,.398,29,63,.460,8,30,.267,20,23,.870,102,45,97,.464,33,63,.524,12,34,.353,22,30,.733,124
1679,CHO,2021-05-04,102,@,DET,W 102-99,240,38,93,.409,30,62,.484,8,31,.258,18,24,.750,102,39,85,.459,30,53,.566,9,32,.281,12,20,.600,99
1680,TOR,2021-05-01,102,@,UTA,L 102-106,240,42,94,.447,30,61,.492,12,33,.364,6,9,.667,102,37,78,.474,20,37,.541,17,41,.415,15,18,.833,106
1681,MIA,2021-04-26,102,,CHI,L 102-110,240,36,84,.429,29,48,.604,7,36,.194,23,25,.920,102,41,77,.532,30,48,.625,11,29,.379,17,22,.773,110
1682,CLE,2021-04-23,102,@,CHO,L 102-108,240,41,80,.513,31,50,.620,10,30,.333,10,14,.714,102,40,94,.426,26,54,.481,14,40,.350,14,18,.778,108
1683,CHI,2021-04-19,102,@,BOS,W 102-96,240,41,91,.451,30,59,.508,11,32,.344,9,10,.900,102,36,77,.468,26,52,.500,10,25,.400,14,15,.933,96
1684,ORL,2021-04-16,102,@,TOR,L 102-113,240,35,77,.455,27,54,.500,8,23,.348,24,34,.706,102,41,82,.500,27,47,.574,14,35,.400,17,18,.944,113
1685,NYK,2021-04-11,102,,TOR,W 102-96,240,35,88,.398,26,53,.491,9,35,.257,23,27,.852,102,33,79,.418,22,45,.489,11,34,.324,19,23,.826,96
1686,OKC,2021-04-08,102,,CLE,L 102-129,240,40,89,.449,27,57,.474,13,32,.406,9,13,.692,102,48,94,.511,35,57,.614,13,37,.351,20,24,.833,129
1687,OKC,2021-04-07,102,,CHO,L 102-113,240,37,85,.435,21,44,.477,16,41,.390,12,17,.706,102,43,97,.443,28,53,.528,15,44,.341,12,13,.923,113
1688,HOU,2021-04-07,102,,DAL,W 102-93,240,38,88,.432,21,44,.477,17,44,.386,9,16,.563,102,33,87,.379,23,48,.479,10,39,.256,17,22,.773,93
1689,HOU,2021-04-02,102,@,BOS,L 102-118,240,37,86,.430,25,50,.500,12,36,.333,16,26,.615,102,46,88,.523,29,47,.617,17,41,.415,9,12,.750,118
1690,MIN,2021-03-31,102,,NYK,W 102-101,240,36,87,.414,22,47,.468,14,40,.350,16,19,.842,102,39,82,.476,28,59,.475,11,23,.478,12,17,.706,101
1691,CHI,2021-03-29,102,@,GSW,L 102-116,240,44,84,.524,38,60,.633,6,24,.250,8,11,.727,102,46,92,.500,30,54,.556,16,38,.421,8,9,.889,116
1692,ATL,2021-03-28,102,@,DEN,L 102-126,240,36,76,.474,24,42,.571,12,34,.353,18,21,.857,102,50,92,.543,35,56,.625,15,36,.417,11,16,.688,126
1693,NYK,2021-03-27,102,@,MIL,W 102-96,240,40,93,.430,24,49,.490,16,44,.364,6,8,.750,102,36,87,.414,22,51,.431,14,36,.389,10,16,.625,96
1694,WAS,2021-03-25,102,@,NYK,L 102-106,240,37,80,.463,29,54,.537,8,26,.308,20,33,.606,102,34,93,.366,27,65,.415,7,28,.250,31,42,.738,106
1695,OKC,2021-03-16,102,@,CHI,L 102-123,240,42,90,.467,35,70,.500,7,20,.350,11,13,.846,102,48,94,.511,36,58,.621,12,36,.333,15,18,.833,123
1696,MIA,2021-03-14,102,@,ORL,W 102-97,240,37,89,.416,23,39,.590,14,50,.280,14,15,.933,102,33,75,.440,17,35,.486,16,40,.400,15,21,.714,97
1697,MEM,2021-03-12,102,,DEN,L 102-103,240,40,87,.460,26,59,.441,14,28,.500,8,8,1.000,102,41,92,.446,28,55,.509,13,37,.351,8,11,.727,103
1698,DET,2021-03-11,102,@,CHO,L 102-105,240,38,85,.447,23,39,.590,15,46,.326,11,14,.786,102,36,90,.400,26,60,.433,10,30,.333,23,24,.958,105
1699,SAS,2021-03-04,102,,OKC,L 102-107,240,40,85,.471,30,54,.556,10,31,.323,12,12,1.000,102,37,85,.435,25,45,.556,12,40,.300,21,26,.808,107
1700,MIN,2021-03-03,102,,CHO,L 102-135,240,39,96,.406,30,56,.536,9,40,.225,15,18,.833,102,51,98,.520,34,59,.576,17,39,.436,16,21,.762,135
1701,LAL,2021-02-26,102,,POR,W 102-93,240,37,88,.420,30,61,.492,7,27,.259,21,28,.750,102,32,83,.386,21,46,.457,11,37,.297,18,20,.900,93
1702,OKC,2021-02-24,102,,SAS,W 102-99,240,37,89,.416,19,45,.422,18,44,.409,10,11,.909,102,40,86,.465,31,61,.508,9,25,.360,10,15,.667,99
1703,TOR,2021-02-23,102,,PHI,L 102-109,240,40,93,.430,29,56,.518,11,37,.297,11,13,.846,102,33,80,.413,16,42,.381,17,38,.447,26,30,.867,109
1704,DAL,2021-02-22,102,,MEM,W 102-92,240,35,80,.438,20,39,.513,15,41,.366,17,26,.654,102,37,94,.394,31,63,.492,6,31,.194,12,19,.632,92
1705,CHO,2021-02-20,102,,GSW,W 102-100,240,37,75,.493,17,35,.486,20,40,.500,8,9,.889,102,37,85,.435,24,46,.522,13,39,.333,13,17,.765,100
1706,DET,2021-02-17,102,@,CHI,L 102-105,240,37,82,.451,29,54,.537,8,28,.286,20,24,.833,102,41,85,.482,33,57,.579,8,28,.286,15,24,.625,105
1707,BOS,2021-02-12,102,,DET,L 102-108,240,36,82,.439,28,55,.509,8,27,.296,22,30,.733,102,34,79,.430,19,41,.463,15,38,.395,25,30,.833,108
1708,SAS,2021-02-01,102,,MEM,L 102-133,240,37,89,.416,24,52,.462,13,37,.351,15,22,.682,102,52,93,.559,37,63,.587,15,30,.500,14,18,.778,133
1709,NYK,2021-02-01,102,@,CHI,L 102-110,240,37,87,.425,31,58,.534,6,29,.207,22,26,.846,102,42,88,.477,31,54,.574,11,34,.324,15,20,.750,110
1710,ORL,2021-01-31,102,@,TOR,L 102-115,240,33,82,.402,20,46,.435,13,36,.361,23,28,.821,102,41,90,.456,29,51,.569,12,39,.308,21,22,.955,115
1711,NYK,2021-01-29,102,,CLE,W 102-81,240,39,80,.488,29,53,.547,10,27,.370,14,16,.875,102,29,84,.345,21,58,.362,8,26,.308,15,18,.833,81
1712,OKC,2021-01-27,102,@,PHO,W 102-97,240,38,85,.447,22,45,.489,16,40,.400,10,14,.714,102,36,95,.379,21,52,.404,15,43,.349,10,12,.833,97
1713,IND,2021-01-24,102,,TOR,L 102-107,240,35,87,.402,22,48,.458,13,39,.333,19,22,.864,102,37,90,.411,22,55,.400,15,35,.429,18,26,.692,107
1714,DET,2021-01-22,102,,HOU,L 102-103,240,31,82,.378,16,50,.320,15,32,.469,25,37,.676,102,37,95,.389,23,54,.426,14,41,.341,15,20,.750,103
1715,TOR,2021-01-20,102,,MIA,L 102-111,240,35,88,.398,19,39,.487,16,49,.327,16,18,.889,102,39,80,.488,21,40,.525,18,40,.450,15,17,.882,111
1716,NOP,2021-01-19,102,@,UTA,L 102-118,240,43,95,.453,37,69,.536,6,26,.231,10,15,.667,102,43,85,.506,22,38,.579,21,47,.447,11,17,.647,118
1717,OKC,2021-01-12,102,,SAS,L 102-112,240,36,83,.434,29,57,.509,7,26,.269,23,29,.793,102,41,95,.432,31,60,.517,10,35,.286,20,22,.909,112
1718,HOU,2021-01-10,102,,LAL,L 102-120,240,37,90,.411,25,49,.510,12,41,.293,16,23,.696,102,46,91,.505,36,62,.581,10,29,.345,18,24,.750,120
1719,CHO,2021-01-06,102,@,ATL,W 102-94,240,32,85,.376,21,49,.429,11,36,.306,27,33,.818,102,36,96,.375,29,56,.518,7,40,.175,15,18,.833,94
1720,IND,2021-01-02,102,,NYK,L 102-106,240,34,84,.405,15,34,.441,19,50,.380,15,18,.833,102,42,83,.506,30,56,.536,12,27,.444,10,13,.769,106
1721,HOU,2021-01-02,102,,SAC,W 102-94,240,36,81,.444,23,40,.575,13,41,.317,17,23,.739,102,35,90,.389,26,62,.419,9,28,.321,15,21,.714,94
1722,DAL,2020-12-23,102,@,PHO,L 102-106,240,36,85,.424,27,48,.563,9,37,.243,21,26,.808,102,38,79,.481,27,49,.551,11,30,.367,19,27,.704,106
1723,MEM,2021-05-16,101,@,GSW,L 101-113,240,40,92,.435,34,67,.507,6,25,.240,15,19,.789,101,41,83,.494,26,44,.591,15,39,.385,16,18,.889,113
1724,LAL,2021-05-11,101,,NYK,W 101-99 (OT),265,37,89,.416,25,61,.410,12,28,.429,15,19,.789,101,34,87,.391,24,58,.414,10,29,.345,21,23,.913,99
1725,LAL,2021-05-07,101,@,POR,L 101-106,240,37,89,.416,26,59,.441,11,30,.367,16,22,.727,101,37,88,.420,25,51,.490,12,37,.324,20,21,.952,106
1726,LAC,2021-04-28,101,@,PHO,L 101-109,240,41,80,.513,29,49,.592,12,31,.387,7,9,.778,101,43,91,.473,30,54,.556,13,37,.351,10,13,.769,109
1727,MIN,2021-04-24,101,@,UTA,W 101-96,240,40,92,.435,31,54,.574,9,38,.237,12,20,.600,101,33,82,.402,14,35,.400,19,47,.404,11,15,.733,96
1728,CHI,2021-04-24,101,@,MIA,L 101-106,240,38,79,.481,25,41,.610,13,38,.342,12,13,.923,101,36,80,.450,22,43,.512,14,37,.378,20,24,.833,106
1729,POR,2021-04-18,101,@,CHO,L 101-109,240,36,91,.396,26,55,.473,10,36,.278,19,28,.679,101,39,83,.470,21,40,.525,18,43,.419,13,17,.765,109
1730,CLE,2021-04-15,101,,GSW,L 101-119,240,35,81,.432,25,50,.500,10,31,.323,21,27,.778,101,47,92,.511,30,46,.652,17,46,.370,8,10,.800,119
1731,LAL,2021-04-13,101,@,CHO,W 101-93,240,34,82,.415,18,38,.474,16,44,.364,17,18,.944,101,36,83,.434,27,48,.563,9,35,.257,12,18,.667,93
1732,MEM,2021-04-12,101,,CHI,W 101-90,240,40,85,.471,31,57,.544,9,28,.321,12,14,.857,101,36,86,.419,31,55,.564,5,31,.161,13,17,.765,90
1733,CHO,2021-04-11,101,,ATL,L 101-105,240,37,80,.463,22,37,.595,15,43,.349,12,14,.857,101,38,84,.452,21,45,.467,17,39,.436,12,16,.750,105
1734,BRK,2021-04-10,101,,LAL,L 101-126,240,35,80,.438,30,53,.566,5,27,.185,26,30,.867,101,47,93,.505,28,59,.475,19,34,.559,13,20,.650,126
1735,NOP,2021-04-09,101,,PHI,W 101-94,240,39,90,.433,35,68,.515,4,22,.182,19,30,.633,101,33,79,.418,22,48,.458,11,31,.355,17,24,.708,94
1736,SAC,2021-04-08,101,,DET,L 101-113,240,38,86,.442,31,56,.554,7,30,.233,18,26,.692,101,44,84,.524,36,61,.590,8,23,.348,17,20,.850,113
1737,MIL,2021-04-08,101,@,DAL,L 101-116,240,38,100,.380,26,67,.388,12,33,.364,13,16,.813,101,43,97,.443,26,52,.500,17,45,.378,13,18,.722,116
1738,BOS,2021-04-07,101,,NYK,W 101-99,240,36,86,.419,21,46,.457,15,40,.375,14,20,.700,101,35,84,.417,19,51,.373,16,33,.485,13,16,.813,99
1739,TOR,2021-04-06,101,,LAL,L 101-110,240,36,91,.396,31,58,.534,5,33,.152,24,30,.800,101,39,79,.494,21,39,.538,18,40,.450,14,22,.636,110
1740,WAS,2021-04-05,101,@,TOR,L 101-103,240,37,94,.394,25,59,.424,12,35,.343,15,18,.833,101,44,94,.468,37,61,.607,7,33,.212,8,11,.727,103
1741,SAS,2021-04-05,101,,CLE,L 101-125,240,35,83,.422,30,57,.526,5,26,.192,26,32,.813,101,45,86,.523,33,52,.635,12,34,.353,23,27,.852,125
1742,CLE,2021-04-03,101,@,MIA,L 101-115,240,35,74,.473,25,43,.581,10,31,.323,21,25,.840,101,44,82,.537,29,44,.659,15,38,.395,12,16,.750,115
1743,DEN,2021-04-01,101,@,LAC,W 101-94,240,39,81,.481,26,56,.464,13,25,.520,10,14,.714,101,35,85,.412,25,51,.490,10,34,.294,14,16,.875,94
1744,NYK,2021-03-31,101,@,MIN,L 101-102,240,39,82,.476,28,59,.475,11,23,.478,12,17,.706,101,36,87,.414,22,47,.468,14,40,.350,16,19,.842,102
1745,DET,2021-03-31,101,,POR,L 101-124,240,40,86,.465,31,59,.525,9,27,.333,12,17,.706,101,42,82,.512,26,52,.500,16,30,.533,24,26,.923,124
1746,PHO,2021-03-28,101,@,CHO,W 101-97 (OT),265,34,96,.354,26,56,.464,8,40,.200,25,29,.862,101,34,85,.400,21,42,.500,13,43,.302,16,23,.696,97
1747,HOU,2021-03-26,101,@,MIN,L 101-107,240,37,87,.425,20,43,.465,17,44,.386,10,13,.769,101,39,103,.379,29,65,.446,10,38,.263,19,24,.792,107
1748,LAL,2021-03-25,101,,PHI,L 101-109,240,34,78,.436,25,52,.481,9,26,.346,24,33,.727,101,39,80,.488,22,35,.629,17,45,.378,14,21,.667,109
1749,SAS,2021-03-24,101,,LAC,L 101-134,240,39,85,.459,32,63,.508,7,22,.318,16,19,.842,101,49,88,.557,32,55,.582,17,33,.515,19,30,.633,134
1750,PHI,2021-03-21,101,@,NYK,W 101-100 (OT),265,38,82,.463,27,57,.474,11,25,.440,14,23,.609,101,38,88,.432,27,64,.422,11,24,.458,13,23,.565,100
1751,MIN,2021-03-19,101,@,PHO,L 101-113,240,37,79,.468,24,44,.545,13,35,.371,14,18,.778,101,43,86,.500,29,59,.492,14,27,.519,13,17,.765,113
1752,POR,2021-03-18,101,,NOP,W 101-93,240,33,87,.379,19,44,.432,14,43,.326,21,25,.840,101,33,83,.398,23,46,.500,10,37,.270,17,25,.680,93
1753,WAS,2021-03-12,101,,PHI,L 101-127,240,40,82,.488,32,58,.552,8,24,.333,13,22,.591,101,49,90,.544,38,69,.551,11,21,.524,18,18,1.000,127
1754,MIA,2021-03-12,101,@,CHI,W 101-90,240,37,80,.463,25,45,.556,12,35,.343,15,20,.750,101,34,92,.370,19,54,.352,15,38,.395,7,7,1.000,90
1755,NYK,2021-03-11,101,@,MIL,L 101-134,240,37,88,.420,24,51,.471,13,37,.351,14,21,.667,101,50,87,.575,32,49,.653,18,38,.474,16,17,.941,134
1756,CLE,2021-03-01,101,@,HOU,W 101-90,240,36,73,.493,26,43,.605,10,30,.333,19,24,.792,101,31,76,.408,21,45,.467,10,31,.323,18,24,.750,90
1757,CLE,2021-02-21,101,,OKC,L 101-117,240,39,84,.464,31,49,.633,8,35,.229,15,20,.750,101,43,79,.544,30,51,.588,13,28,.464,18,24,.750,117
1758,MIA,2021-02-11,101,@,HOU,W 101-94,240,34,79,.430,19,37,.514,15,42,.357,18,20,.900,101,32,83,.386,17,33,.515,15,50,.300,15,20,.750,94
1759,HOU,2021-02-09,101,@,NOP,L 101-130,240,38,91,.418,25,48,.521,13,43,.302,12,21,.571,101,47,92,.511,35,61,.574,12,31,.387,24,28,.857,130
1760,CHI,2021-02-08,101,,WAS,L 101-105,240,36,85,.424,27,55,.491,9,30,.300,20,24,.833,101,36,86,.419,30,60,.500,6,26,.231,27,36,.750,105
1761,PHO,2021-02-03,101,@,NOP,L 101-123,240,38,82,.463,30,47,.638,8,35,.229,17,20,.850,101,46,90,.511,32,57,.561,14,33,.424,17,21,.810,123
1762,DAL,2021-01-29,101,@,UTA,L 101-120,240,37,86,.430,28,53,.528,9,33,.273,18,27,.667,101,38,87,.437,18,39,.462,20,48,.417,24,26,.923,120
1763,POR,2021-01-28,101,@,HOU,L 101-104,240,39,93,.419,22,52,.423,17,41,.415,6,8,.750,101,38,90,.422,25,43,.581,13,47,.277,15,18,.833,104
1764,WAS,2021-01-24,101,@,SAS,L 101-121,240,39,92,.424,25,50,.500,14,42,.333,9,14,.643,101,48,96,.500,33,65,.508,15,31,.484,10,11,.909,121
1765,LAL,2021-01-23,101,@,CHI,W 101-90,240,36,79,.456,32,60,.533,4,19,.211,25,31,.806,101,33,84,.393,25,59,.424,8,25,.320,16,22,.727,90
1766,TOR,2021-01-22,101,,MIA,W 101-81,240,39,84,.464,22,44,.500,17,40,.425,6,9,.667,101,33,77,.429,26,46,.565,7,31,.226,8,10,.800,81
1767,OKC,2021-01-19,101,@,DEN,L 101-119,240,36,86,.419,22,43,.512,14,43,.326,15,23,.652,101,46,105,.438,32,63,.508,14,42,.333,13,14,.929,119
1768,DAL,2021-01-17,101,,CHI,L 101-117,240,41,93,.441,33,62,.532,8,31,.258,11,19,.579,101,43,85,.506,36,60,.600,7,25,.280,24,33,.727,117
1769,DET,2021-01-13,101,,MIL,L 101-110,240,36,92,.391,22,57,.386,14,35,.400,15,22,.682,101,41,85,.482,22,42,.524,19,43,.442,9,14,.643,110
1770,MEM,2021-01-11,101,@,CLE,W 101-91,240,40,78,.513,35,58,.603,5,20,.250,16,21,.762,101,37,82,.451,26,56,.464,11,26,.423,6,14,.429,91
1771,OKC,2021-01-08,101,@,NYK,W 101-89,240,38,87,.437,27,53,.509,11,34,.324,14,21,.667,101,34,96,.354,25,69,.362,9,27,.333,12,20,.600,89
1772,GSW,2021-01-06,101,,LAC,L 101-108,240,39,86,.453,31,56,.554,8,30,.267,15,19,.789,101,36,81,.444,25,47,.532,11,34,.324,25,25,1.000,108
1773,CHO,2021-01-04,101,@,PHI,L 101-118,240,36,86,.419,23,47,.489,13,39,.333,16,22,.727,101,46,95,.484,35,63,.556,11,32,.344,15,23,.652,118
1774,MIN,2020-12-29,101,@,LAC,L 101-124,240,37,89,.416,24,51,.471,13,38,.342,14,17,.824,101,47,88,.534,31,57,.544,16,31,.516,14,16,.875,124
1775,DET,2020-12-23,101,@,MIN,L 101-111,240,45,93,.484,37,58,.638,8,35,.229,3,8,.375,101,38,88,.432,27,47,.574,11,41,.268,24,28,.857,111
1776,DET,2021-05-11,100,,MIN,L 100-119,240,35,75,.467,25,52,.481,10,23,.435,20,26,.769,100,45,98,.459,31,50,.620,14,48,.292,15,21,.714,119
1777,LAC,2021-05-09,100,,NYK,L 100-106,240,37,86,.430,25,51,.490,12,35,.343,14,16,.875,100,42,90,.467,29,58,.500,13,32,.406,9,9,1.000,106
1778,TOR,2021-05-04,100,@,LAC,L 100-105,240,40,87,.460,28,52,.538,12,35,.343,8,13,.615,100,39,75,.520,24,41,.585,15,34,.441,12,13,.923,105
1779,UTA,2021-04-30,100,@,PHO,L 100-121,240,35,80,.438,21,41,.512,14,39,.359,16,18,.889,100,48,88,.545,37,55,.673,11,33,.333,14,19,.737,121
1780,DET,2021-04-26,100,,ATL,W 100-86,240,40,84,.476,31,58,.534,9,26,.346,11,15,.733,100,33,85,.388,29,58,.500,4,27,.148,16,17,.941,86
1781,ORL,2021-04-22,100,,NOP,L 100-135,240,36,98,.367,23,62,.371,13,36,.361,15,19,.789,100,50,90,.556,38,62,.613,12,28,.429,23,26,.885,135
1782,DET,2021-04-17,100,@,WAS,L 100-121,240,37,84,.440,28,57,.491,9,27,.333,17,23,.739,100,50,94,.532,41,78,.526,9,16,.563,12,19,.632,121
1783,LAC,2021-04-14,100,@,DET,W 100-98,240,37,93,.398,30,64,.469,7,29,.241,19,21,.905,100,37,85,.435,30,61,.492,7,24,.292,17,22,.773,98
1784,PHI,2021-04-04,100,,MEM,L 100-116,240,37,89,.416,29,55,.527,8,34,.235,18,28,.643,100,44,89,.494,28,51,.549,16,38,.421,12,15,.800,116
1785,SAC,2021-03-27,100,,CLE,W 100-98,240,41,80,.513,34,50,.680,7,30,.233,11,14,.786,100,37,84,.440,28,58,.483,9,26,.346,15,23,.652,98
1786,LAL,2021-03-26,100,,CLE,W 100-86,240,38,78,.487,32,52,.615,6,26,.231,18,25,.720,100,31,80,.388,26,54,.481,5,26,.192,19,28,.679,86
1787,TOR,2021-03-26,100,,PHO,L 100-104,240,37,90,.411,25,45,.556,12,45,.267,14,16,.875,100,43,90,.478,34,54,.630,9,36,.250,9,9,1.000,104
1788,MIA,2021-03-23,100,,PHO,L 100-110,240,36,86,.419,23,50,.460,13,36,.361,15,17,.882,100,45,91,.495,33,54,.611,12,37,.324,8,9,.889,110
1789,CHO,2021-03-22,100,@,SAS,W 100-97,240,34,81,.420,22,49,.449,12,32,.375,20,23,.870,100,36,78,.462,25,46,.543,11,32,.344,14,17,.824,97
1790,CHI,2021-03-21,100,@,DET,W 100-86,240,37,80,.463,23,52,.442,14,28,.500,12,14,.857,100,32,82,.390,28,57,.491,4,25,.160,18,25,.720,86
1791,NYK,2021-03-21,100,,PHI,L 100-101 (OT),265,38,88,.432,27,64,.422,11,24,.458,13,23,.565,100,38,82,.463,27,57,.474,11,25,.440,14,23,.609,101
1792,HOU,2021-03-19,100,,DET,L 100-113,240,39,88,.443,30,56,.536,9,32,.281,13,16,.813,100,37,85,.435,23,56,.411,14,29,.483,25,28,.893,113
1793,ATL,2021-03-14,100,,CLE,W 100-82,240,32,71,.451,20,42,.476,12,29,.414,24,26,.923,100,31,81,.383,23,51,.451,8,30,.267,12,23,.522,82
1794,BRK,2021-03-13,100,,DET,W 100-95,240,39,80,.488,33,53,.623,6,27,.222,16,22,.727,100,36,89,.404,28,57,.491,8,32,.250,15,20,.750,95
1795,IND,2021-03-12,100,@,LAL,L 100-105,240,37,88,.420,29,52,.558,8,36,.222,18,21,.857,100,34,76,.447,27,54,.500,7,22,.318,30,39,.769,105
1796,LAC,2021-02-28,100,@,MIL,L 100-105,240,40,97,.412,26,53,.491,14,44,.318,6,7,.857,100,38,85,.447,26,47,.553,12,38,.316,17,22,.773,105
1797,HOU,2021-02-22,100,,CHI,L 100-120,240,37,96,.385,24,56,.429,13,40,.325,13,19,.684,100,49,91,.538,34,55,.618,15,36,.417,7,10,.700,120
1798,POR,2021-02-22,100,@,PHO,L 100-132,240,37,84,.440,25,45,.556,12,39,.308,14,19,.737,100,50,99,.505,34,66,.515,16,33,.485,16,18,.889,132
1799,GSW,2021-02-20,100,@,CHO,L 100-102,240,37,85,.435,24,46,.522,13,39,.333,13,17,.765,100,37,75,.493,17,35,.486,20,40,.500,8,9,.889,102
1800,GSW,2021-02-08,100,@,SAS,L 100-105,240,38,86,.442,25,49,.510,13,37,.351,11,15,.733,100,39,96,.406,28,65,.431,11,31,.355,16,19,.842,105
1801,PHO,2021-02-07,100,,BOS,W 100-91,240,40,82,.488,32,53,.604,8,29,.276,12,12,1.000,100,33,93,.355,16,49,.327,17,44,.386,8,12,.667,91
1802,MIA,2021-02-03,100,,WAS,L 100-103,240,36,83,.434,24,48,.500,12,35,.343,16,22,.727,100,35,84,.417,20,47,.426,15,37,.405,18,25,.720,103
1803,CLE,2021-02-01,100,,MIN,W 100-98,240,35,84,.417,28,62,.452,7,22,.318,23,31,.742,100,40,102,.392,29,64,.453,11,38,.289,7,11,.636,98
1804,WAS,2021-01-29,100,,ATL,L 100-116,240,31,85,.365,24,57,.421,7,28,.250,31,38,.816,100,39,87,.448,27,50,.540,12,37,.324,26,34,.765,116
1805,OKC,2021-01-24,100,@,LAC,L 100-108,240,42,95,.442,35,60,.583,7,35,.200,9,14,.643,100,41,92,.446,27,46,.587,14,46,.304,12,16,.750,108
1806,MIA,2021-01-16,100,,DET,L 100-120,240,32,67,.478,20,38,.526,12,29,.414,24,27,.889,100,46,91,.505,28,45,.622,18,46,.391,10,15,.667,120
1807,SAC,2021-01-15,100,,LAC,L 100-138,240,40,85,.471,32,59,.542,8,26,.308,12,17,.706,100,52,89,.584,34,54,.630,18,35,.514,16,20,.800,138
1808,HOU,2021-01-12,100,,LAL,L 100-117,240,38,97,.392,26,57,.456,12,40,.300,12,16,.750,100,42,84,.500,28,52,.538,14,32,.438,19,27,.704,117
1809,MIL,2021-01-09,100,,CLE,W 100-90,240,37,84,.440,25,48,.521,12,36,.333,14,18,.778,100,36,87,.414,29,61,.475,7,26,.269,11,16,.688,90
1810,UTA,2021-01-06,100,@,NYK,L 100-112,240,40,91,.440,26,47,.553,14,44,.318,6,11,.545,100,45,87,.517,37,65,.569,8,22,.364,14,19,.737,112
1811,HOU,2021-01-04,100,,DAL,L 100-113,240,30,77,.390,19,37,.514,11,40,.275,29,36,.806,100,39,82,.476,23,43,.535,16,39,.410,19,20,.950,113
1812,LAC,2021-01-01,100,@,UTA,L 100-106,240,33,85,.388,20,52,.385,13,33,.394,21,24,.875,100,41,89,.461,26,47,.553,15,42,.357,9,14,.643,106
1813,TOR,2020-12-31,100,,NYK,W 100-83,240,34,83,.410,17,31,.548,17,52,.327,15,21,.714,100,32,88,.364,29,52,.558,3,36,.083,16,20,.800,83
1814,PHI,2020-12-29,100,,TOR,W 100-93,240,32,84,.381,24,53,.453,8,31,.258,28,33,.848,100,32,90,.356,15,45,.333,17,45,.378,12,14,.857,93
1815,SAC,2020-12-27,100,,PHO,L 100-116,240,36,76,.474,26,53,.491,10,23,.435,18,25,.720,100,46,94,.489,32,59,.542,14,35,.400,10,11,.909,116
1816,POR,2020-12-23,100,,UTA,L 100-120,240,37,92,.402,25,59,.424,12,33,.364,14,17,.824,100,43,94,.457,24,44,.545,19,50,.380,15,19,.789,120
1817,SAC,2021-05-16,99,,UTA,L 99-121,240,42,90,.467,33,60,.550,9,30,.300,6,10,.600,99,41,86,.477,23,47,.489,18,39,.462,21,25,.840,121
1818,NYK,2021-05-11,99,@,LAL,L 99-101 (OT),265,34,87,.391,24,58,.414,10,29,.345,21,23,.913,99,37,89,.416,25,61,.410,12,28,.429,15,19,.789,101
1819,TOR,2021-05-08,99,,MEM,L 99-109,240,36,94,.383,26,62,.419,10,32,.313,17,24,.708,99,38,85,.447,24,42,.571,14,43,.326,19,26,.731,109
1820,BOS,2021-05-07,99,@,CHI,L 99-121,240,35,86,.407,24,47,.511,11,39,.282,18,23,.783,99,43,99,.434,25,59,.424,18,40,.450,17,18,.944,121
1821,CHO,2021-05-06,99,,CHI,L 99-120,240,38,90,.422,22,55,.400,16,35,.457,7,18,.389,99,46,91,.505,28,54,.519,18,37,.486,10,17,.588,120
1822,OKC,2021-05-04,99,,SAC,L 99-103,240,35,98,.357,24,62,.387,11,36,.306,18,25,.720,99,39,95,.411,27,52,.519,12,43,.279,13,16,.813,103
1823,DET,2021-05-04,99,,CHO,L 99-102,240,39,85,.459,30,53,.566,9,32,.281,12,20,.600,99,38,93,.409,30,62,.484,8,31,.258,18,24,.750,102
1824,SAS,2021-05-03,99,@,UTA,L 99-110,240,42,90,.467,37,72,.514,5,18,.278,10,10,1.000,99,44,88,.500,33,52,.635,11,36,.306,11,16,.688,110
1825,DAL,2021-05-02,99,,SAC,L 99-111,240,34,81,.420,28,46,.609,6,35,.171,25,31,.806,99,45,81,.556,34,53,.642,11,28,.393,10,16,.625,111
1826,BOS,2021-04-22,99,,PHO,W 99-86,240,33,77,.429,21,37,.568,12,40,.300,21,24,.875,99,36,88,.409,30,53,.566,6,35,.171,8,9,.889,86
1827,HOU,2021-04-16,99,,DEN,L 99-128,240,38,86,.442,27,51,.529,11,35,.314,12,18,.667,99,46,94,.489,37,63,.587,9,31,.290,27,31,.871,128
1828,NYK,2021-04-07,99,@,BOS,L 99-101,240,35,84,.417,19,51,.373,16,33,.485,13,16,.813,99,36,86,.419,21,46,.457,15,40,.375,14,20,.700,101
1829,DAL,2021-04-02,99,@,NYK,W 99-86,240,41,88,.466,29,51,.569,12,37,.324,5,10,.500,99,32,89,.360,20,51,.392,12,38,.316,10,10,1.000,86
1830,ORL,2021-03-23,99,,DEN,L 99-110,240,39,88,.443,28,54,.519,11,34,.324,10,14,.714,99,45,91,.495,37,61,.607,8,30,.267,12,13,.923,110
1831,TOR,2021-03-22,99,@,HOU,L 99-117,240,37,87,.425,27,47,.574,10,40,.250,15,19,.789,99,41,90,.456,27,54,.500,14,36,.389,21,26,.808,117
1832,ATL,2021-03-20,99,@,LAL,W 99-94,240,39,98,.398,26,61,.426,13,37,.351,8,9,.889,99,34,81,.420,26,55,.473,8,26,.308,18,24,.750,94
1833,CHI,2021-03-17,99,,SAS,L 99-106,240,40,91,.440,29,58,.500,11,33,.333,8,9,.889,99,38,89,.427,30,58,.517,8,31,.258,22,30,.733,106
1834,PHI,2021-03-16,99,,NYK,W 99-96,240,37,90,.411,26,58,.448,11,32,.344,14,19,.737,99,37,84,.440,29,60,.483,8,24,.333,14,22,.636,96
1835,DAL,2021-03-15,99,,LAC,L 99-109,240,39,79,.494,22,38,.579,17,41,.415,4,5,.800,99,43,86,.500,29,54,.537,14,32,.438,9,11,.818,109
1836,DET,2021-03-15,99,,SAS,L 99-109,240,39,83,.470,32,58,.552,7,25,.280,14,25,.560,99,47,83,.566,35,58,.603,12,25,.480,3,5,.600,109
1837,MEM,2021-03-15,99,@,PHO,L 99-122,240,38,87,.437,33,64,.516,5,23,.217,18,26,.692,99,47,83,.566,35,53,.660,12,30,.400,16,18,.889,122
1838,SAS,2021-03-14,99,@,PHI,L 99-134,240,36,85,.424,32,64,.500,4,21,.190,23,31,.742,99,56,98,.571,41,69,.594,15,29,.517,7,11,.636,134
1839,HOU,2021-03-12,99,@,UTA,L 99-114,240,41,112,.366,32,69,.464,9,43,.209,8,13,.615,99,39,81,.481,24,41,.585,15,40,.375,21,25,.840,114
1840,ATL,2021-02-28,99,@,MIA,L 99-109,240,36,87,.414,28,52,.538,8,35,.229,19,22,.864,99,39,86,.453,28,49,.571,11,37,.297,20,22,.909,109
1841,MIN,2021-02-28,99,,PHO,L 99-118,240,35,93,.376,27,58,.466,8,35,.229,21,24,.875,99,44,89,.494,37,62,.597,7,27,.259,23,24,.958,118
1842,MEM,2021-02-26,99,,LAC,L 99-119,240,39,97,.402,30,69,.435,9,28,.321,12,16,.750,99,44,80,.550,30,45,.667,14,35,.400,17,18,.944,119
1843,SAS,2021-02-24,99,@,OKC,L 99-102,240,40,86,.465,31,61,.508,9,25,.360,10,15,.667,99,37,89,.416,19,45,.422,18,44,.409,10,11,.909,102
1844,MIN,2021-02-21,99,@,NYK,L 99-103,240,33,82,.402,17,47,.362,16,35,.457,17,21,.810,99,33,78,.423,27,60,.450,6,18,.333,31,38,.816,103
1845,DEN,2021-02-16,99,@,BOS,L 99-112,240,38,84,.452,29,50,.580,9,34,.265,14,15,.933,99,39,81,.481,24,39,.615,15,42,.357,19,21,.905,112
1846,HOU,2021-02-13,99,@,NYK,L 99-121,240,33,88,.375,25,45,.556,8,43,.186,25,30,.833,99,45,86,.523,33,58,.569,12,28,.429,19,23,.826,121
1847,POR,2021-02-06,99,@,NYK,L 99-110,240,37,89,.416,20,42,.476,17,47,.362,8,16,.500,99,44,88,.500,31,58,.534,13,30,.433,9,13,.692,110
1848,CLE,2021-02-06,99,,MIL,L 99-124,240,39,86,.453,33,58,.569,6,28,.214,15,21,.714,99,47,86,.547,31,52,.596,16,34,.471,14,23,.609,124
1849,CLE,2021-02-03,99,,LAC,L 99-121,240,41,92,.446,37,82,.451,4,10,.400,13,17,.765,99,44,79,.557,24,45,.533,20,34,.588,13,17,.765,121
1850,ATL,2021-02-01,99,,LAL,L 99-107,240,37,78,.474,26,49,.531,11,29,.379,14,17,.824,99,40,77,.519,33,54,.611,7,23,.304,20,24,.833,107
1851,LAC,2021-01-26,99,@,ATL,L 99-108,240,36,89,.404,28,63,.444,8,26,.308,19,22,.864,99,37,80,.463,27,54,.500,10,26,.385,24,25,.960,108
1852,SAS,2021-01-20,99,@,GSW,L 99-121,240,35,94,.372,31,61,.508,4,33,.121,25,31,.806,99,46,91,.505,31,53,.585,15,38,.395,14,20,.700,121
1853,OKC,2021-01-13,99,,LAL,L 99-128,240,37,86,.430,27,55,.491,10,31,.323,15,19,.789,99,47,95,.495,30,58,.517,17,37,.459,17,22,.773,128
1854,ORL,2021-01-11,99,,MIL,L 99-121,240,39,91,.429,28,60,.467,11,31,.355,10,13,.769,99,46,91,.505,33,56,.589,13,35,.371,16,20,.800,121
1855,SAC,2021-01-09,99,,POR,L 99-125,240,33,81,.407,25,51,.490,8,30,.267,25,35,.714,99,44,100,.440,27,59,.458,17,41,.415,20,23,.870,125
1856,ORL,2021-01-02,99,,OKC,L 99-108,240,40,108,.370,30,70,.429,10,38,.263,9,12,.750,99,38,86,.442,25,45,.556,13,41,.317,19,21,.905,108
1857,CLE,2020-12-31,99,@,IND,L 99-119,240,37,82,.451,25,59,.424,12,23,.522,13,24,.542,99,42,87,.483,26,52,.500,16,35,.457,19,24,.792,119
1858,DAL,2020-12-30,99,,CHO,L 99-118,240,34,87,.391,22,45,.489,12,42,.286,19,33,.576,99,43,84,.512,28,50,.560,15,34,.441,17,21,.810,118
1859,GSW,2020-12-25,99,@,MIL,L 99-138,240,34,99,.343,24,54,.444,10,45,.222,21,25,.840,99,50,90,.556,30,54,.556,20,36,.556,18,26,.692,138
1860,TOR,2020-12-23,99,,NOP,L 99-113,240,38,89,.427,24,43,.558,14,46,.304,9,12,.750,99,42,80,.525,23,38,.605,19,42,.452,10,20,.500,113
1861,GSW,2020-12-22,99,@,BRK,L 99-125,240,37,99,.374,27,66,.409,10,33,.303,15,23,.652,99,42,92,.457,27,57,.474,15,35,.429,26,32,.813,125
1862,NOP,2021-05-16,98,,LAL,L 98-110,240,37,78,.474,28,53,.528,9,25,.360,15,21,.714,98,45,96,.469,34,61,.557,11,35,.314,9,15,.600,110
1863,SAS,2021-05-13,98,@,NYK,L 98-102,240,38,91,.418,32,70,.457,6,21,.286,16,19,.842,98,35,86,.407,21,51,.412,14,35,.400,18,18,1.000,102
1864,UTA,2021-05-12,98,,POR,L 98-105,240,35,85,.412,23,45,.511,12,40,.300,16,21,.762,98,40,91,.440,27,59,.458,13,32,.406,12,17,.706,105
1865,OKC,2021-05-09,98,@,SAC,L 98-126,240,34,87,.391,23,50,.460,11,37,.297,19,29,.655,98,45,85,.529,29,49,.592,16,36,.444,20,24,.833,126
1866,CHI,2021-04-30,98,,MIL,L 98-108,240,37,96,.385,27,63,.429,10,33,.303,14,21,.667,98,42,90,.467,33,65,.508,9,25,.360,15,20,.750,108
1867,DET,2021-04-14,98,,LAC,L 98-100,240,37,85,.435,30,61,.492,7,24,.292,17,22,.773,98,37,93,.398,30,64,.469,7,29,.241,19,21,.905,100
1868,POR,2021-04-11,98,,MIA,L 98-107,240,37,77,.481,26,42,.619,11,35,.314,13,19,.684,98,41,83,.494,29,54,.537,12,29,.414,13,20,.650,107
1869,MIA,2021-03-29,98,@,NYK,W 98-88,240,37,86,.430,27,52,.519,10,34,.294,14,17,.824,98,33,80,.413,23,44,.523,10,36,.278,12,20,.600,88
1870,CLE,2021-03-27,98,@,SAC,L 98-100,240,37,84,.440,28,58,.483,9,26,.346,15,23,.652,98,41,80,.513,34,50,.680,7,30,.233,11,14,.786,100
1871,LAC,2021-03-25,98,@,SAS,W 98-85,240,34,89,.382,21,55,.382,13,34,.382,17,18,.944,98,33,82,.402,25,59,.424,8,23,.348,11,13,.846,85
1872,GSW,2021-03-23,98,,PHI,L 98-108,240,36,83,.434,28,58,.483,8,25,.320,18,26,.692,98,39,86,.453,32,62,.516,7,24,.292,23,35,.657,108
1873,CHO,2021-03-20,98,@,LAC,L 98-125,240,31,80,.388,16,39,.410,15,41,.366,21,28,.750,98,45,86,.523,33,52,.635,12,34,.353,23,23,1.000,125
1874,CLE,2021-03-16,98,@,MIA,L 98-113,240,39,86,.453,29,51,.569,10,35,.286,10,14,.714,98,42,85,.494,32,58,.552,10,27,.370,19,21,.905,113
1875,GSW,2021-03-04,98,@,PHO,L 98-120,240,38,88,.432,26,53,.491,12,35,.343,10,16,.625,98,49,96,.510,37,66,.561,12,30,.400,10,13,.769,120
1876,BRK,2021-02-27,98,,DAL,L 98-115,240,35,86,.407,21,42,.500,14,44,.318,14,19,.737,98,45,86,.523,31,50,.620,14,36,.389,11,17,.647,115
1877,MIL,2021-02-19,98,,OKC,W 98-85,240,35,86,.407,24,52,.462,11,34,.324,17,25,.680,98,31,85,.365,19,45,.422,12,40,.300,11,21,.524,85
1878,LAL,2021-02-18,98,,BRK,L 98-109,240,40,83,.482,32,53,.604,8,30,.267,10,14,.714,98,38,77,.494,20,38,.526,18,39,.462,15,24,.625,109
1879,CLE,2021-02-15,98,@,GSW,L 98-129,240,37,95,.389,29,65,.446,8,30,.267,16,20,.800,98,46,88,.523,29,51,.569,17,37,.459,20,21,.952,129
1880,MIA,2021-02-09,98,,NYK,W 98-96,240,26,70,.371,12,37,.324,14,33,.424,32,39,.821,98,37,87,.425,27,59,.458,10,28,.357,12,16,.750,96
1881,MIN,2021-02-01,98,@,CLE,L 98-100,240,40,102,.392,29,64,.453,11,38,.289,7,11,.636,98,35,84,.417,28,62,.452,7,22,.318,23,31,.742,100
1882,BRK,2021-01-25,98,,MIA,W 98-85,240,34,85,.400,23,47,.489,11,38,.289,19,22,.864,98,31,84,.369,20,41,.488,11,43,.256,12,17,.706,85
1883,MIN,2021-01-22,98,,ATL,L 98-116,240,40,93,.430,32,61,.525,8,32,.250,10,12,.833,98,38,83,.458,23,48,.479,15,35,.429,25,30,.833,116
1884,ORL,2021-01-09,98,@,DAL,L 98-112,240,38,89,.427,32,58,.552,6,31,.194,16,22,.727,98,39,79,.494,19,39,.487,20,40,.500,14,18,.778,112
1885,GSW,2021-01-01,98,,POR,L 98-123,240,31,79,.392,24,44,.545,7,35,.200,29,33,.879,98,40,92,.435,20,49,.408,20,43,.465,23,30,.767,123
1886,NOP,2020-12-27,98,,SAS,W 98-95,240,36,94,.383,31,70,.443,5,24,.208,21,29,.724,98,38,89,.427,27,53,.509,11,36,.306,8,8,1.000,95
1887,NOP,2020-12-25,98,@,MIA,L 98-111,240,31,78,.397,21,43,.488,10,35,.286,26,33,.788,98,38,75,.507,22,38,.579,16,37,.432,19,23,.826,111
1888,ORL,2021-05-14,97,@,PHI,L 97-122,240,33,83,.398,23,53,.434,10,30,.333,21,28,.750,97,44,93,.473,28,59,.475,16,34,.471,18,19,.947,122
1889,CLE,2021-05-09,97,,DAL,L 97-124,240,33,86,.384,22,55,.400,11,31,.355,20,31,.645,97,50,93,.538,35,54,.648,15,39,.385,9,11,.818,124
1890,OKC,2021-05-08,97,@,GSW,L 97-136,240,38,94,.404,29,57,.509,9,37,.243,12,20,.600,97,47,81,.580,20,27,.741,27,54,.500,15,18,.833,136
1891,MEM,2021-05-06,97,@,DET,L 97-111,240,38,89,.427,28,52,.538,10,37,.270,11,17,.647,97,44,83,.530,33,55,.600,11,28,.393,12,14,.857,111
1892,OKC,2021-05-06,97,@,GSW,L 97-118,240,36,88,.409,27,49,.551,9,39,.231,16,20,.800,97,42,86,.488,23,39,.590,19,47,.404,15,18,.833,118
1893,NYK,2021-05-05,97,@,DEN,L 97-113,240,33,86,.384,20,51,.392,13,35,.371,18,27,.667,97,37,97,.381,25,58,.431,12,39,.308,27,33,.818,113
1894,HOU,2021-05-02,97,,NYK,L 97-122,240,34,79,.430,26,44,.591,8,35,.229,21,32,.656,97,45,86,.523,27,51,.529,18,35,.514,14,16,.875,122
1895,CHI,2021-05-01,97,@,ATL,L 97-108,240,40,85,.471,34,61,.557,6,24,.250,11,17,.647,97,37,74,.500,23,38,.605,14,36,.389,20,26,.769,108
1896,DEN,2021-04-23,97,@,GSW,L 97-118,240,34,88,.386,21,42,.500,13,46,.283,16,20,.800,97,45,84,.536,30,45,.667,15,39,.385,13,18,.722,118
1897,CHO,2021-04-20,97,@,NYK,L 97-109,240,39,86,.453,23,47,.489,16,39,.410,3,8,.375,97,40,83,.482,22,38,.579,18,45,.400,11,12,.917,109
1898,LAL,2021-04-19,97,,UTA,L 97-111,240,34,79,.430,22,51,.431,12,28,.429,17,25,.680,97,43,75,.573,28,42,.667,15,33,.455,10,11,.909,111
1899,MIN,2021-04-13,97,,BRK,L 97-127,240,30,87,.345,17,38,.447,13,49,.265,24,33,.727,97,46,91,.505,31,55,.564,15,36,.417,20,24,.833,127
1900,ORL,2021-04-12,97,,SAS,L 97-120,240,36,80,.450,31,60,.517,5,20,.250,20,32,.625,97,48,93,.516,38,68,.559,10,25,.400,14,18,.778,120
1901,IND,2021-04-06,97,,CHI,L 97-113,240,38,88,.432,29,58,.500,9,30,.300,12,16,.750,97,44,94,.468,30,61,.492,14,33,.424,11,14,.786,113
1902,IND,2021-04-02,97,,CHO,L 97-114,240,38,82,.463,28,49,.571,10,33,.303,11,19,.579,97,43,95,.453,35,64,.547,8,31,.258,20,29,.690,114
1903,LAL,2021-03-31,97,,MIL,L 97-112,240,35,87,.402,25,51,.490,10,36,.278,17,22,.773,97,42,79,.532,28,53,.528,14,26,.538,14,18,.778,112
1904,CHO,2021-03-28,97,,PHO,L 97-101 (OT),265,34,85,.400,21,42,.500,13,43,.302,16,23,.696,97,34,96,.354,26,56,.464,8,40,.200,25,29,.862,101
1905,HOU,2021-03-24,97,,CHO,L 97-122,240,33,86,.384,17,37,.459,16,49,.327,15,22,.682,97,41,80,.513,23,42,.548,18,38,.474,22,29,.759,122
1906,SAS,2021-03-22,97,,CHO,L 97-100,240,36,78,.462,25,46,.543,11,32,.344,14,17,.824,97,34,81,.420,22,49,.449,12,32,.375,20,23,.870,100
1907,GSW,2021-03-15,97,,LAL,L 97-128,240,34,79,.430,21,42,.500,13,37,.351,16,24,.667,97,49,78,.628,38,51,.745,11,27,.407,19,25,.760,128
1908,ORL,2021-03-14,97,,MIA,L 97-102,240,33,75,.440,17,35,.486,16,40,.400,15,21,.714,97,37,89,.416,23,39,.590,14,50,.280,14,15,.933,102
1909,OKC,2021-03-13,97,,NYK,L 97-119,240,37,76,.487,29,44,.659,8,32,.250,15,21,.714,97,44,90,.489,30,55,.545,14,35,.400,17,22,.773,119
1910,MIL,2021-03-02,97,,DEN,L 97-128,240,32,79,.405,21,39,.538,11,40,.275,22,31,.710,97,53,95,.558,42,65,.646,11,30,.367,11,12,.917,128
1911,CHI,2021-02-26,97,,PHO,L 97-106,240,39,78,.500,27,47,.574,12,31,.387,7,10,.700,97,44,88,.500,38,66,.576,6,22,.273,12,15,.800,106
1912,DAL,2021-02-25,97,@,PHI,L 97-111,240,32,78,.410,19,44,.432,13,34,.382,20,23,.870,97,39,90,.433,27,61,.443,12,29,.414,21,25,.840,111
1913,MEM,2021-02-20,97,,PHO,L 97-128,240,36,93,.387,31,60,.517,5,33,.152,20,23,.870,97,46,86,.535,22,40,.550,24,46,.522,12,13,.923,128
1914,DEN,2021-02-12,97,,OKC,W 97-95,240,40,87,.460,30,47,.638,10,40,.250,7,10,.700,97,36,90,.400,26,58,.448,10,32,.313,13,17,.765,95
1915,ORL,2021-02-09,97,@,POR,L 97-106,240,37,88,.420,26,53,.491,11,35,.314,12,22,.545,97,35,90,.389,17,44,.386,18,46,.391,18,19,.947,106
1916,WAS,2021-02-07,97,@,CHO,L 97-119,240,34,90,.378,25,50,.500,9,40,.225,20,28,.714,97,42,99,.424,27,63,.429,15,36,.417,20,26,.769,119
1917,PHO,2021-01-27,97,,OKC,L 97-102,240,36,95,.379,21,52,.404,15,43,.349,10,12,.833,97,38,85,.447,22,45,.489,16,40,.400,10,14,.714,102
1918,ORL,2021-01-20,97,@,MIN,W 97-96,240,36,92,.391,26,61,.426,10,31,.323,15,21,.714,97,36,85,.424,21,50,.420,15,35,.429,9,14,.643,96
1919,MIN,2021-01-18,97,@,ATL,L 97-108,240,36,91,.396,22,54,.407,14,37,.378,11,16,.688,97,37,79,.468,26,51,.510,11,28,.393,23,25,.920,108
1920,ORL,2021-01-15,97,@,BOS,L 97-124,240,38,94,.404,31,66,.470,7,28,.250,14,22,.636,97,45,88,.511,28,46,.609,17,42,.405,17,19,.895,124
1921,MIA,2020-12-29,97,,MIL,L 97-144,240,37,79,.468,26,42,.619,11,37,.297,12,18,.667,97,51,92,.554,22,41,.537,29,51,.569,13,15,.867,144
1922,NYK,2021-05-16,96,,BOS,W 96-92,240,34,79,.430,21,52,.404,13,27,.481,15,19,.789,96,35,86,.407,24,45,.533,11,41,.268,11,15,.733,92
1923,TOR,2021-05-11,96,,LAC,L 96-115,240,35,86,.407,25,49,.510,10,37,.270,16,19,.842,96,39,78,.500,28,46,.609,11,32,.344,26,26,1.000,115
1924,ORL,2021-05-09,96,,MIN,L 96-128,240,36,91,.396,27,55,.491,9,36,.250,15,22,.682,96,47,97,.485,31,52,.596,16,45,.356,18,24,.750,128
1925,DET,2021-05-09,96,,CHI,L 96-108,240,36,79,.456,25,52,.481,11,27,.407,13,22,.591,96,43,84,.512,31,52,.596,12,32,.375,10,14,.714,108
1926,ORL,2021-05-05,96,,BOS,L 96-132,240,33,85,.388,27,60,.450,6,25,.240,24,28,.857,96,51,96,.531,30,51,.588,21,45,.467,9,12,.750,132
1927,CLE,2021-04-26,96,@,TOR,L 96-112,240,36,83,.434,26,45,.578,10,38,.263,14,16,.875,96,43,79,.544,35,50,.700,8,29,.276,18,20,.900,112
1928,MEM,2021-04-26,96,@,DEN,L 96-120,240,34,81,.420,30,49,.612,4,32,.125,24,31,.774,96,45,94,.479,34,61,.557,11,33,.333,19,22,.864,120
1929,UTA,2021-04-24,96,,MIN,L 96-101,240,33,82,.402,14,35,.400,19,47,.404,11,15,.733,96,40,92,.435,31,54,.574,9,38,.237,12,20,.600,101
1930,ORL,2021-04-20,96,@,ATL,L 96-112,240,34,86,.395,26,49,.531,8,37,.216,20,29,.690,96,39,94,.415,30,60,.500,9,34,.265,25,29,.862,112
1931,PHI,2021-04-19,96,,GSW,L 96-107,240,35,89,.393,23,57,.404,12,32,.375,14,18,.778,96,34,76,.447,20,44,.455,14,32,.438,25,32,.781,107
1932,BOS,2021-04-19,96,,CHI,L 96-102,240,36,77,.468,26,52,.500,10,25,.400,14,15,.933,96,41,91,.451,30,59,.508,11,32,.344,9,10,.900,102
1933,CLE,2021-04-17,96,@,CHI,L 96-106,240,39,88,.443,27,58,.466,12,30,.400,6,7,.857,96,41,82,.500,25,42,.595,16,40,.400,8,9,.889,106
1934,OKC,2021-04-13,96,@,UTA,L 96-106,240,36,93,.387,22,59,.373,14,34,.412,10,18,.556,96,36,86,.419,19,39,.487,17,47,.362,17,20,.850,106
1935,LAL,2021-04-12,96,@,NYK,L 96-111,240,35,80,.438,23,44,.523,12,36,.333,14,18,.778,96,42,89,.472,37,62,.597,5,27,.185,22,27,.815,111
1936,TOR,2021-04-11,96,@,NYK,L 96-102,240,33,79,.418,22,45,.489,11,34,.324,19,23,.826,96,35,88,.398,26,53,.491,9,35,.257,23,27,.852,102
1937,SAS,2021-04-07,96,@,DEN,L 96-106,240,38,91,.418,32,67,.478,6,24,.250,14,21,.667,96,40,91,.440,32,65,.492,8,26,.308,18,24,.750,106
1938,BOS,2021-04-06,96,,PHI,L 96-106,240,33,70,.471,19,36,.528,14,34,.412,16,18,.889,96,34,73,.466,25,49,.510,9,24,.375,29,39,.744,106
1939,LAC,2021-03-30,96,,ORL,L 96-103,240,37,89,.416,25,52,.481,12,37,.324,10,10,1.000,96,38,92,.413,33,75,.440,5,17,.294,22,25,.880,103
1940,LAL,2021-03-28,96,,ORL,W 96-93,240,34,82,.415,23,42,.548,11,40,.275,17,23,.739,96,34,88,.386,23,55,.418,11,33,.333,14,17,.824,93
1941,MIL,2021-03-27,96,,NYK,L 96-102,240,36,87,.414,22,51,.431,14,36,.389,10,16,.625,96,40,93,.430,24,49,.490,16,44,.364,6,8,.750,102
1942,ORL,2021-03-21,96,@,BOS,L 96-112,240,32,84,.381,21,50,.420,11,34,.324,21,30,.700,96,40,88,.455,17,33,.515,23,55,.418,9,9,1.000,112
1943,BOS,2021-03-19,96,,SAC,L 96-107,240,39,91,.429,27,60,.450,12,31,.387,6,7,.857,96,37,81,.457,25,51,.490,12,30,.400,21,26,.808,107
1944,NYK,2021-03-16,96,@,PHI,L 96-99,240,37,84,.440,29,60,.483,8,24,.333,14,22,.636,96,37,90,.411,26,58,.448,11,32,.344,14,19,.737,99
1945,OKC,2021-02-27,96,,DEN,L 96-126,240,37,88,.420,26,41,.634,11,47,.234,11,15,.733,96,49,89,.551,34,58,.586,15,31,.484,13,16,.813,126
1946,HOU,2021-02-24,96,@,CLE,L 96-112,240,36,90,.400,26,57,.456,10,33,.303,14,17,.824,96,43,85,.506,27,49,.551,16,36,.444,10,15,.667,112
1947,DET,2021-02-21,96,@,ORL,L 96-105,240,34,91,.374,23,51,.451,11,40,.275,17,21,.810,96,35,81,.432,26,51,.510,9,30,.300,26,29,.897,105
1948,MIA,2021-02-20,96,@,LAL,W 96-94,240,36,85,.424,28,57,.491,8,28,.286,16,23,.696,96,33,84,.393,20,39,.513,13,45,.289,15,17,.882,94
1949,MIL,2021-02-18,96,,TOR,L 96-110,240,35,88,.398,25,54,.463,10,34,.294,16,23,.696,96,38,78,.487,26,43,.605,12,35,.343,22,23,.957,110
1950,LAC,2021-02-17,96,,UTA,L 96-114,240,38,86,.442,29,60,.483,9,26,.346,11,17,.647,96,42,98,.429,29,58,.500,13,40,.325,17,20,.850,114
1951,NYK,2021-02-09,96,@,MIA,L 96-98,240,37,87,.425,27,59,.458,10,28,.357,12,16,.750,96,26,70,.371,12,37,.324,14,33,.424,32,39,.821,98
1952,LAL,2021-01-30,96,@,BOS,W 96-95,240,37,84,.440,28,53,.528,9,31,.290,13,19,.684,96,40,82,.488,34,61,.557,6,21,.286,9,14,.643,95
1953,MIN,2021-01-20,96,,ORL,L 96-97,240,36,85,.424,21,50,.420,15,35,.429,9,14,.643,96,36,92,.391,26,61,.426,10,31,.323,15,21,.714,97
1954,SAC,2021-01-20,96,@,LAC,L 96-115,240,39,86,.453,26,58,.448,13,28,.464,5,12,.417,96,41,86,.477,25,51,.490,16,35,.457,17,18,.944,115
1955,IND,2021-01-17,96,@,LAC,L 96-129,240,37,89,.416,26,51,.510,11,38,.289,11,16,.688,96,48,87,.552,29,48,.604,19,39,.487,14,20,.700,129
1956,MIN,2021-01-10,96,,SAS,W 96-88,240,34,81,.420,25,55,.455,9,26,.346,19,23,.826,96,36,94,.383,28,64,.438,8,30,.267,8,14,.571,88
1957,UTA,2021-01-10,96,@,DET,W 96-86,240,35,82,.427,24,47,.511,11,35,.314,15,22,.682,96,29,87,.333,19,45,.422,10,42,.238,18,21,.857,86
1958,UTA,2021-01-05,96,@,BRK,L 96-130,240,33,86,.384,22,52,.423,11,34,.324,19,27,.704,96,52,93,.559,38,57,.667,14,36,.389,12,16,.750,130
1959,CLE,2021-01-02,96,@,ATL,W 96-91,240,38,91,.418,31,62,.500,7,29,.241,13,17,.765,96,35,85,.412,24,53,.453,11,32,.344,10,19,.526,91
1960,BRK,2021-01-01,96,,ATL,L 96-114,240,35,86,.407,28,49,.571,7,37,.189,19,23,.826,96,43,93,.462,27,54,.500,16,39,.410,12,14,.857,114
1961,DET,2021-01-01,96,,BOS,W 96-93,240,36,88,.409,25,54,.463,11,34,.324,13,20,.650,96,39,83,.470,31,52,.596,8,31,.258,7,14,.500,93
1962,CHI,2021-01-01,96,@,MIL,L 96-126,240,38,87,.437,32,61,.525,6,26,.231,14,20,.700,96,42,85,.494,20,40,.500,22,45,.489,20,30,.667,126
1963,HOU,2021-05-16,95,@,ATL,L 95-124,240,31,92,.337,13,29,.448,18,63,.286,15,20,.750,95,49,90,.544,42,69,.609,7,21,.333,19,26,.731,124
1964,OKC,2021-05-01,95,,IND,L 95-152,240,38,111,.342,30,73,.411,8,38,.211,11,23,.478,95,57,87,.655,36,54,.667,21,33,.636,17,22,.773,152
1965,OKC,2021-04-29,95,,NOP,L 95-109,240,34,89,.382,23,50,.460,11,39,.282,16,20,.800,95,45,101,.446,40,72,.556,5,29,.172,14,19,.737,109
1966,DAL,2021-04-12,95,,PHI,L 95-113,240,35,83,.422,26,47,.553,9,36,.250,16,20,.800,95,39,80,.488,27,49,.551,12,31,.387,23,33,.697,113
1967,PHI,2021-03-30,95,@,DEN,L 95-104,240,35,82,.427,24,47,.511,11,35,.314,14,15,.933,95,39,81,.481,27,50,.540,12,31,.387,14,17,.824,104
1968,CHI,2021-03-22,95,,UTA,L 95-120,240,39,96,.406,33,70,.471,6,26,.231,11,12,.917,95,45,92,.489,28,53,.528,17,39,.436,13,15,.867,120
1969,TOR,2021-03-14,95,@,CHI,L 95-118,240,34,90,.378,22,45,.489,12,45,.267,15,21,.714,95,44,97,.454,32,53,.604,12,44,.273,18,23,.783,118
1970,DET,2021-03-13,95,@,BRK,L 95-100,240,36,89,.404,28,57,.491,8,32,.250,15,20,.750,95,39,80,.488,33,53,.623,6,27,.222,16,22,.727,100
1971,DET,2021-02-19,95,@,MEM,L 95-109,240,36,86,.419,22,41,.537,14,45,.311,9,13,.692,95,42,90,.467,37,70,.529,5,20,.250,20,23,.870,109
1972,OKC,2021-02-12,95,@,DEN,L 95-97,240,36,90,.400,26,58,.448,10,32,.313,13,17,.765,95,40,87,.460,30,47,.638,10,40,.250,7,10,.700,97
1973,DET,2021-02-11,95,,IND,L 95-111,240,38,85,.447,33,57,.579,5,28,.179,14,19,.737,95,44,86,.512,30,55,.545,14,31,.452,9,10,.900,111
1974,CLE,2021-02-10,95,@,DEN,L 95-133,240,36,94,.383,28,57,.491,8,37,.216,15,20,.750,95,51,85,.600,35,49,.714,16,36,.444,15,21,.714,133
1975,IND,2021-02-07,95,,UTA,L 95-103,240,37,93,.398,29,64,.453,8,29,.276,13,18,.722,95,38,92,.413,25,50,.500,13,42,.310,14,21,.667,103
1976,WAS,2021-02-05,95,@,MIA,L 95-122,240,33,89,.371,25,56,.446,8,33,.242,21,24,.875,95,43,86,.500,27,50,.540,16,36,.444,20,23,.870,122
1977,BOS,2021-01-30,95,,LAL,L 95-96,240,40,82,.488,34,61,.557,6,21,.286,9,14,.643,95,37,84,.440,28,53,.528,9,31,.290,13,19,.684,96
1978,NOP,2021-01-15,95,@,LAL,L 95-112,240,41,86,.477,32,57,.561,9,29,.310,4,8,.500,95,39,93,.419,24,56,.429,15,37,.405,19,26,.731,112
1979,GSW,2021-01-12,95,,IND,L 95-104,240,34,89,.382,21,51,.412,13,38,.342,14,22,.636,95,39,88,.443,30,60,.500,9,28,.321,17,25,.680,104
1980,UTA,2020-12-31,95,,PHO,L 95-106,240,35,84,.417,23,50,.460,12,34,.353,13,19,.684,95,41,84,.488,24,51,.471,17,33,.515,7,10,.700,106
1981,NYK,2020-12-29,95,@,CLE,W 95-86,240,34,79,.430,20,54,.370,14,25,.560,13,21,.619,95,32,88,.364,25,56,.446,7,32,.219,15,22,.682,86
1982,SAS,2020-12-27,95,@,NOP,L 95-98,240,38,89,.427,27,53,.509,11,36,.306,8,8,1.000,95,36,94,.383,31,70,.443,5,24,.208,21,29,.724,98
1983,BOS,2020-12-25,95,,BRK,L 95-123,240,37,98,.378,29,71,.408,8,27,.296,13,19,.684,95,41,76,.539,26,47,.553,15,29,.517,26,31,.839,123
1984,PHI,2021-05-13,94,@,MIA,L 94-106,240,36,78,.462,29,53,.547,7,25,.280,15,20,.750,94,41,81,.506,28,46,.609,13,35,.371,11,11,1.000,106
1985,BOS,2021-05-12,94,@,CLE,L 94-102,240,36,101,.356,24,60,.400,12,41,.293,10,14,.714,94,36,80,.450,28,56,.500,8,24,.333,22,27,.815,102
1986,PHI,2021-05-11,94,@,IND,L 94-103,240,38,87,.437,30,61,.492,8,26,.308,10,14,.714,94,37,83,.446,23,42,.548,14,41,.341,15,16,.938,103
1987,LAL,2021-05-06,94,@,LAC,L 94-118,240,33,87,.379,23,51,.451,10,36,.278,18,29,.621,94,41,77,.532,28,46,.609,13,31,.419,23,26,.885,118
1988,SAS,2021-05-05,94,@,UTA,L 94-126,240,37,92,.402,30,69,.435,7,23,.304,13,20,.650,94,49,88,.557,31,47,.660,18,41,.439,10,14,.714,126
1989,CHI,2021-05-03,94,,PHI,L 94-106,240,36,87,.414,25,53,.472,11,34,.324,11,14,.786,94,40,75,.533,29,47,.617,11,28,.393,15,21,.714,106
1990,DET,2021-05-01,94,@,CHO,L 94-107,240,35,91,.385,22,54,.407,13,37,.351,11,17,.647,94,42,87,.483,28,50,.560,14,37,.378,9,20,.450,107
1991,CHI,2021-04-28,94,@,NYK,L 94-113,240,39,85,.459,29,56,.518,10,29,.345,6,10,.600,94,42,91,.462,30,64,.469,12,27,.444,17,19,.895,113
1992,PHI,2021-04-24,94,@,MIL,L 94-132,240,31,82,.378,24,51,.471,7,31,.226,25,34,.735,94,49,95,.516,31,55,.564,18,40,.450,16,24,.667,132
1993,IND,2021-04-19,94,,SAS,L 94-109,240,34,104,.327,26,70,.371,8,34,.235,18,27,.667,94,36,84,.429,28,56,.500,8,28,.286,29,35,.829,109
1994,PHI,2021-04-09,94,@,NOP,L 94-101,240,33,79,.418,22,48,.458,11,31,.355,17,24,.708,94,39,90,.433,35,68,.515,4,22,.182,19,30,.633,101
1995,SAC,2021-04-02,94,,LAL,L 94-115,240,36,85,.424,26,50,.520,10,35,.286,12,16,.750,94,43,91,.473,26,58,.448,17,33,.515,12,20,.600,115
1996,CLE,2021-04-01,94,,PHI,L 94-114,240,34,80,.425,24,45,.533,10,35,.286,16,21,.762,94,40,93,.430,25,56,.446,15,37,.405,19,25,.760,114
1997,LAC,2021-04-01,94,,DEN,L 94-101,240,35,85,.412,25,51,.490,10,34,.294,14,16,.875,94,39,81,.481,26,56,.464,13,25,.520,10,14,.714,101
1998,OKC,2021-03-27,94,,BOS,L 94-111,240,34,83,.410,23,45,.511,11,38,.289,15,24,.625,94,44,96,.458,32,58,.552,12,38,.316,11,14,.786,111
1999,DAL,2021-03-26,94,,IND,L 94-109,240,39,95,.411,31,60,.517,8,35,.229,8,14,.571,94,38,87,.437,18,40,.450,20,47,.426,13,18,.722,109
2000,CHI,2021-03-24,94,,CLE,L 94-103,240,37,83,.446,29,55,.527,8,28,.286,12,14,.857,94,42,92,.457,31,63,.492,11,29,.379,8,10,.800,103
2001,LAL,2021-03-21,94,@,PHO,L 94-111,240,35,85,.412,30,60,.500,5,25,.200,19,28,.679,94,42,87,.483,33,55,.600,9,32,.281,18,23,.783,111
2002,LAL,2021-03-20,94,,ATL,L 94-99,240,34,81,.420,26,55,.473,8,26,.308,18,24,.750,94,39,98,.398,26,61,.426,13,37,.351,8,9,.889,99
2003,NYK,2021-03-18,94,,ORL,W 94-93,240,37,86,.430,23,52,.442,14,34,.412,6,11,.545,94,35,82,.427,25,48,.521,10,34,.294,13,16,.813,93
2004,HOU,2021-03-17,94,,GSW,L 94-108,240,33,80,.413,26,53,.491,7,27,.259,21,40,.525,94,41,90,.456,25,45,.556,16,45,.356,10,12,.833,108
2005,ATL,2021-03-02,94,@,MIA,W 94-80,240,34,71,.479,21,35,.600,13,36,.361,13,15,.867,94,28,75,.373,19,42,.452,9,33,.273,15,22,.682,80
2006,LAC,2021-02-25,94,@,MEM,L 94-122,240,34,84,.405,22,50,.440,12,34,.353,14,16,.875,94,50,92,.543,39,73,.534,11,19,.579,11,16,.688,122
2007,OKC,2021-02-22,94,,MIA,L 94-108,240,32,74,.432,18,35,.514,14,39,.359,16,19,.842,94,36,81,.444,21,41,.512,15,40,.375,21,25,.840,108
2008,LAL,2021-02-20,94,,MIA,L 94-96,240,33,84,.393,20,39,.513,13,45,.289,15,17,.882,94,36,85,.424,28,57,.491,8,28,.286,16,23,.696,96
2009,MIA,2021-02-13,94,@,UTA,L 94-112,240,35,86,.407,23,50,.460,12,36,.333,12,17,.706,94,39,85,.459,27,39,.692,12,46,.261,22,29,.759,112
2010,HOU,2021-02-11,94,,MIA,L 94-101,240,32,83,.386,17,33,.515,15,50,.300,15,20,.750,94,34,79,.430,19,37,.514,15,42,.357,18,20,.900,101
2011,IND,2021-02-10,94,@,BRK,L 94-104,240,36,92,.391,21,54,.389,15,38,.395,7,11,.636,94,32,76,.421,23,45,.511,9,31,.290,31,35,.886,104
2012,HOU,2021-02-08,94,@,CHO,L 94-119,240,35,86,.407,22,39,.564,13,47,.277,11,16,.688,94,44,90,.489,25,49,.510,19,41,.463,12,13,.923,119
2013,MIN,2021-01-29,94,,PHI,L 94-118,240,35,82,.427,25,49,.510,10,33,.303,14,18,.778,94,39,87,.448,31,71,.437,8,16,.500,32,38,.842,118
2014,NYK,2021-01-26,94,@,UTA,L 94-108,240,36,83,.434,26,56,.464,10,27,.370,12,17,.706,94,37,92,.402,22,44,.500,15,48,.313,19,22,.864,108
2015,NYK,2021-01-22,94,@,SAC,L 94-103,240,36,94,.383,31,72,.431,5,22,.227,17,25,.680,94,38,91,.418,26,57,.456,12,34,.353,15,21,.714,103
2016,PHI,2021-01-11,94,@,ATL,L 94-112,240,37,92,.402,29,56,.518,8,36,.222,12,13,.923,94,37,99,.374,20,55,.364,17,44,.386,21,27,.778,112
2017,CLE,2021-01-07,94,@,MEM,W 94-90,240,36,79,.456,23,49,.469,13,30,.433,9,16,.563,94,36,83,.434,25,52,.481,11,31,.355,7,8,.875,90
2018,CLE,2021-01-06,94,@,ORL,L 94-105,240,36,85,.424,32,59,.542,4,26,.154,18,26,.692,94,40,81,.494,28,52,.538,12,29,.414,13,18,.722,105
2019,ATL,2021-01-06,94,,CHO,L 94-102,240,36,96,.375,29,56,.518,7,40,.175,15,18,.833,94,32,85,.376,21,49,.429,11,36,.306,27,33,.818,102
2020,LAL,2021-01-05,94,@,MEM,W 94-92,240,38,87,.437,29,56,.518,9,31,.290,9,11,.818,94,36,87,.414,26,61,.426,10,26,.385,10,13,.769,92
2021,MEM,2021-01-03,94,,LAL,L 94-108,240,39,95,.411,30,62,.484,9,33,.273,7,8,.875,94,41,89,.461,29,54,.537,12,35,.343,14,19,.737,108
2022,SAC,2021-01-02,94,@,HOU,L 94-102,240,35,90,.389,26,62,.419,9,28,.321,15,21,.714,94,36,81,.444,23,40,.575,13,41,.317,17,23,.739,102
2023,PHI,2020-12-27,94,@,CLE,L 94-118,240,33,79,.418,21,42,.500,12,37,.324,16,22,.727,94,48,91,.527,39,68,.574,9,23,.391,13,16,.813,118
2024,OKC,2021-05-14,93,,UTA,L 93-109,240,36,84,.429,30,65,.462,6,19,.316,15,16,.938,93,40,93,.430,27,54,.500,13,39,.333,16,21,.762,109
2025,ORL,2021-05-13,93,@,ATL,L 93-116,240,36,94,.383,25,58,.431,11,36,.306,10,15,.667,93,41,94,.436,27,58,.466,14,36,.389,20,24,.833,116
2026,IND,2021-05-05,93,,SAC,L 93-104,240,36,83,.434,27,58,.466,9,25,.360,12,17,.706,93,43,95,.453,35,63,.556,8,32,.250,10,14,.714,104
2027,LAL,2021-05-03,93,,DEN,W 93-89,240,32,73,.438,19,43,.442,13,30,.433,16,23,.696,93,36,82,.439,30,58,.517,6,24,.250,11,16,.688,89
2028,CLE,2021-04-30,93,,WAS,L 93-122,240,34,82,.415,27,49,.551,7,33,.212,18,28,.643,93,46,92,.500,38,74,.514,8,18,.444,22,26,.846,122
2029,LAL,2021-04-24,93,@,DAL,L 93-108,240,33,86,.384,21,41,.512,12,45,.267,15,19,.789,93,38,78,.487,25,48,.521,13,30,.433,19,25,.760,108
2030,CHO,2021-04-13,93,,LAL,L 93-101,240,36,83,.434,27,48,.563,9,35,.257,12,18,.667,93,34,82,.415,18,38,.474,16,44,.364,17,18,.944,101
2031,OKC,2021-04-10,93,,PHI,L 93-117,240,38,76,.500,30,56,.536,8,20,.400,9,19,.474,93,44,94,.468,32,56,.571,12,38,.316,17,25,.680,117
2032,DAL,2021-04-07,93,@,HOU,L 93-102,240,33,87,.379,23,48,.479,10,39,.256,17,22,.773,93,38,88,.432,21,44,.477,17,44,.386,9,16,.563,102
2033,ORL,2021-03-28,93,@,LAL,L 93-96,240,34,88,.386,23,55,.418,11,33,.333,14,17,.824,93,34,82,.415,23,42,.548,11,40,.275,17,23,.739,96
2034,ORL,2021-03-18,93,@,NYK,L 93-94,240,35,82,.427,25,48,.521,10,34,.294,13,16,.813,93,37,86,.430,23,52,.442,14,34,.412,6,11,.545,94
2035,OKC,2021-03-18,93,@,ATL,L 93-116,240,34,93,.366,21,59,.356,13,34,.382,12,16,.750,93,47,87,.540,36,54,.667,11,33,.333,11,13,.846,116
2036,NOP,2021-03-18,93,@,POR,L 93-101,240,33,83,.398,23,46,.500,10,37,.270,17,25,.680,93,33,87,.379,19,44,.432,14,43,.326,21,25,.840,101
2037,NOP,2021-03-04,93,,MIA,L 93-103,240,33,84,.393,22,41,.537,11,43,.256,16,20,.800,93,36,73,.493,26,43,.605,10,30,.333,21,25,.840,103
2038,NYK,2021-03-02,93,@,SAS,L 93-119,240,33,81,.407,18,45,.400,15,36,.417,12,15,.800,93,43,89,.483,25,47,.532,18,42,.429,15,21,.714,119
2039,POR,2021-02-26,93,@,LAL,L 93-102,240,32,83,.386,21,46,.457,11,37,.297,18,20,.900,93,37,88,.420,30,61,.492,7,27,.259,21,28,.750,102
2040,ORL,2021-02-23,93,,DET,L 93-105,240,33,88,.375,19,50,.380,14,38,.368,13,22,.591,93,41,88,.466,31,54,.574,10,34,.294,13,16,.813,105
2041,DEN,2021-02-04,93,@,LAL,L 93-114,240,36,92,.391,28,64,.438,8,28,.286,13,15,.867,93,46,81,.568,38,57,.667,8,24,.333,14,22,.636,114
2042,GSW,2021-01-28,93,@,PHO,L 93-114,240,38,99,.384,27,61,.443,11,38,.289,6,8,.750,93,41,88,.466,30,56,.536,11,32,.344,21,23,.913,114
2043,DAL,2021-01-18,93,@,TOR,L 93-116,240,31,82,.378,22,46,.478,9,36,.250,22,27,.815,93,44,88,.500,32,55,.582,12,33,.364,16,18,.889,116
2044,CHO,2021-01-13,93,,DAL,L 93-104,240,38,100,.380,28,62,.452,10,38,.263,7,14,.500,93,40,96,.417,25,50,.500,15,46,.326,9,16,.563,104
2045,CHO,2021-01-01,93,,MEM,L 93-108,240,35,86,.407,26,55,.473,9,31,.290,14,21,.667,93,43,90,.478,29,51,.569,14,39,.359,8,10,.800,108
2046,DAL,2021-01-01,93,,MIA,W 93-83,240,32,78,.410,20,41,.488,12,37,.324,17,23,.739,93,29,78,.372,22,45,.489,7,33,.212,18,25,.720,83
2047,BOS,2021-01-01,93,@,DET,L 93-96,240,39,83,.470,31,52,.596,8,31,.258,7,14,.500,93,36,88,.409,25,54,.463,11,34,.324,13,20,.650,96
2048,TOR,2020-12-29,93,@,PHI,L 93-100,240,32,90,.356,15,45,.333,17,45,.378,12,14,.857,93,32,84,.381,24,53,.453,8,31,.258,28,33,.848,100
2049,BOS,2021-05-16,92,@,NYK,L 92-96,240,35,86,.407,24,45,.533,11,41,.268,11,15,.733,92,34,79,.430,21,52,.404,13,27,.481,15,19,.789,96
2050,MEM,2021-04-30,92,,ORL,W 92-75,240,34,99,.343,23,60,.383,11,39,.282,13,16,.813,92,27,86,.314,21,60,.350,6,26,.231,15,20,.750,75
2051,MIA,2021-03-31,92,@,IND,W 92-87,240,32,78,.410,22,46,.478,10,32,.313,18,28,.643,92,34,85,.400,23,48,.479,11,37,.297,8,12,.667,87
2052,DET,2021-03-27,92,@,WAS,L 92-106,240,33,85,.388,23,56,.411,10,29,.345,16,19,.842,92,44,91,.484,35,70,.500,9,21,.429,9,9,1.000,106
2053,POR,2021-03-21,92,,DAL,L 92-132,240,34,89,.382,25,48,.521,9,41,.220,15,19,.789,92,48,86,.558,29,49,.592,19,37,.514,17,20,.850,132
2054,ORL,2021-02-25,92,@,BRK,L 92-129,240,35,87,.402,26,51,.510,9,36,.250,13,15,.867,92,49,92,.533,29,47,.617,20,45,.444,11,14,.786,129
2055,MEM,2021-02-22,92,@,DAL,L 92-102,240,37,94,.394,31,63,.492,6,31,.194,12,19,.632,92,35,80,.438,20,39,.513,15,41,.366,17,26,.654,102
2056,ORL,2021-02-06,92,,CHI,L 92-118,240,37,95,.389,31,68,.456,6,27,.222,12,12,1.000,92,47,91,.516,32,61,.525,15,30,.500,9,13,.692,118
2057,DET,2021-02-05,92,@,PHO,L 92-109,240,34,91,.374,27,55,.491,7,36,.194,17,28,.607,92,42,85,.494,30,53,.566,12,32,.375,13,16,.813,109
2058,LAL,2021-01-28,92,@,DET,L 92-107,240,36,88,.409,24,60,.400,12,28,.429,8,12,.667,92,40,87,.460,26,51,.510,14,36,.389,13,13,1.000,107
2059,ATL,2021-01-15,92,@,UTA,L 92-116,240,38,92,.413,33,64,.516,5,28,.179,11,15,.733,92,43,92,.467,23,48,.479,20,44,.455,10,14,.714,116
2060,MEM,2021-01-05,92,,LAL,L 92-94,240,36,87,.414,26,61,.426,10,26,.385,10,13,.769,92,38,87,.437,29,56,.518,9,31,.290,9,11,.818,94
2061,ORL,2020-12-31,92,,PHI,L 92-116,240,33,95,.347,26,67,.388,7,28,.250,19,21,.905,92,44,91,.484,29,58,.500,15,33,.455,13,15,.867,116
2062,CHI,2021-05-15,91,@,BRK,L 91-105,240,34,98,.347,23,57,.404,11,41,.268,12,17,.706,91,41,87,.471,27,53,.509,14,34,.412,9,15,.600,105
2063,DET,2021-05-14,91,,DEN,L 91-104,240,34,83,.410,28,46,.609,6,37,.162,17,23,.739,91,42,86,.488,33,54,.611,9,32,.281,11,14,.786,104
2064,CHO,2021-04-22,91,@,CHI,L 91-108,240,35,82,.427,27,51,.529,8,31,.258,13,17,.765,91,43,87,.494,29,44,.659,14,43,.326,8,11,.727,108
2065,DET,2021-04-22,91,@,SAS,L 91-106,240,35,77,.455,27,55,.491,8,22,.364,13,22,.591,91,37,80,.463,26,56,.464,11,24,.458,21,27,.778,106
2066,HOU,2021-04-19,91,@,MIA,L 91-113,240,33,85,.388,24,47,.511,9,38,.237,16,17,.941,91,45,93,.484,26,45,.578,19,48,.396,4,7,.571,113
2067,ORL,2021-04-03,91,@,UTA,L 91-137,240,32,87,.368,30,64,.469,2,23,.087,25,31,.806,91,51,92,.554,25,37,.676,26,55,.473,9,12,.750,137
2068,WAS,2021-04-01,91,@,DET,L 91-120,240,40,85,.471,35,66,.530,5,19,.263,6,19,.316,91,45,94,.479,33,65,.508,12,29,.414,18,22,.818,120
2069,GSW,2021-02-28,91,@,LAL,L 91-117,240,35,86,.407,27,52,.519,8,34,.235,13,19,.684,91,40,85,.471,29,54,.537,11,31,.355,26,38,.684,117
2070,BOS,2021-02-14,91,@,WAS,L 91-104,240,32,90,.356,23,55,.418,9,35,.257,18,30,.600,91,33,83,.398,26,53,.491,7,30,.233,31,36,.861,104
2071,WAS,2021-02-12,91,,NYK,L 91-109,240,34,89,.382,25,55,.455,9,34,.265,14,20,.700,91,44,98,.449,38,74,.514,6,24,.250,15,22,.682,109
2072,SAS,2021-02-09,91,,GSW,L 91-114,240,32,86,.372,24,62,.387,8,24,.333,19,21,.905,91,42,91,.462,25,51,.490,17,40,.425,13,19,.684,114
2073,BOS,2021-02-07,91,@,PHO,L 91-100,240,33,93,.355,16,49,.327,17,44,.386,8,12,.667,91,40,82,.488,32,53,.604,8,29,.276,12,12,1.000,100
2074,ATL,2021-02-04,91,,UTA,L 91-112,240,32,98,.327,23,67,.343,9,31,.290,18,19,.947,91,44,91,.484,31,64,.484,13,27,.481,11,13,.846,112
2075,DET,2021-01-30,91,@,GSW,L 91-118,240,29,77,.377,20,41,.488,9,36,.250,24,32,.750,91,47,89,.528,30,53,.566,17,36,.472,7,10,.700,118
2076,NYK,2021-01-18,91,,ORL,W 91-84,240,31,87,.356,26,60,.433,5,27,.185,24,34,.706,91,29,86,.337,17,48,.354,12,38,.316,14,16,.875,84
2077,HOU,2021-01-16,91,@,SAS,L 91-103,240,31,84,.369,19,52,.365,12,32,.375,17,27,.630,91,40,100,.400,35,76,.461,5,24,.208,18,23,.783,103
2078,CLE,2021-01-11,91,,MEM,L 91-101,240,37,82,.451,26,56,.464,11,26,.423,6,14,.429,91,40,78,.513,35,58,.603,5,20,.250,16,21,.762,101
2079,ATL,2021-01-02,91,,CLE,L 91-96,240,35,85,.412,24,53,.453,11,32,.344,10,19,.526,91,38,91,.418,31,62,.500,7,29,.241,13,17,.765,96
2080,MIN,2020-12-27,91,@,LAL,L 91-127,240,38,103,.369,32,68,.471,6,35,.171,9,14,.643,91,50,90,.556,37,55,.673,13,35,.371,14,18,.778,127
2081,CHO,2021-05-13,90,,LAC,L 90-113,240,33,84,.393,24,51,.471,9,33,.273,15,19,.789,90,40,75,.533,19,30,.633,21,45,.467,12,16,.750,113
2082,CLE,2021-05-07,90,@,DAL,L 90-110,240,32,83,.386,26,54,.481,6,29,.207,20,26,.769,90,41,83,.494,31,51,.608,10,32,.313,18,22,.818,110
2083,OKC,2021-04-26,90,@,PHI,L 90-121,240,35,78,.449,28,48,.583,7,30,.233,13,23,.565,90,47,86,.547,33,55,.600,14,31,.452,13,18,.722,121
2084,CHO,2021-04-14,90,,CLE,L 90-103,240,34,84,.405,18,40,.450,16,44,.364,6,12,.500,90,37,76,.487,24,45,.533,13,31,.419,16,19,.842,103
2085,CHI,2021-04-12,90,@,MEM,L 90-101,240,36,86,.419,31,55,.564,5,31,.161,13,17,.765,90,40,85,.471,31,57,.544,9,28,.321,12,14,.857,101
2086,CHI,2021-03-12,90,,MIA,L 90-101,240,34,92,.370,19,54,.352,15,38,.395,7,7,1.000,90,37,80,.463,25,45,.556,12,35,.343,15,20,.750,101
2087,HOU,2021-03-01,90,,CLE,L 90-101,240,31,76,.408,21,45,.467,10,31,.323,18,24,.750,90,36,73,.493,26,43,.605,10,30,.333,19,24,.792,101
2088,DET,2021-02-28,90,,NYK,L 90-109,240,28,72,.389,19,40,.475,9,32,.281,25,31,.806,90,44,86,.512,31,60,.517,13,26,.500,8,10,.800,109
2089,ORL,2021-02-14,90,@,PHO,L 90-109,240,33,89,.371,27,54,.500,6,35,.171,18,22,.818,90,41,92,.446,29,55,.527,12,37,.324,15,16,.938,109
2090,ORL,2021-01-29,90,,LAC,L 90-116,240,32,89,.360,22,56,.393,10,33,.303,16,18,.889,90,46,94,.489,33,57,.579,13,37,.351,11,11,1.000,116
2091,CHI,2021-01-23,90,,LAL,L 90-101,240,33,84,.393,25,59,.424,8,25,.320,16,22,.727,90,36,79,.456,32,60,.533,4,19,.211,25,31,.806,101
2092,CLE,2021-01-09,90,@,MIL,L 90-100,240,36,87,.414,29,61,.475,7,26,.269,11,16,.688,90,37,84,.440,25,48,.521,12,36,.333,14,18,.778,100
2093,ORL,2021-01-08,90,@,HOU,L 90-132,240,34,89,.382,26,60,.433,8,29,.276,14,16,.875,90,51,91,.560,29,44,.659,22,47,.468,8,11,.727,132
2094,MEM,2021-01-07,90,,CLE,L 90-94,240,36,83,.434,25,52,.481,11,31,.355,7,8,.875,90,36,79,.456,23,49,.469,13,30,.433,9,16,.563,94
2095,OKC,2021-01-04,90,@,MIA,L 90-118,240,29,79,.367,16,31,.516,13,48,.271,19,27,.704,90,46,81,.568,30,47,.638,16,34,.471,10,18,.556,118
2096,DEN,2021-05-03,89,@,LAL,L 89-93,240,36,82,.439,30,58,.517,6,24,.250,11,16,.688,89,32,73,.438,19,43,.442,13,30,.433,16,23,.696,93
2097,HOU,2021-04-21,89,,UTA,L 89-112,240,35,99,.354,25,50,.500,10,49,.204,9,17,.529,89,41,90,.456,24,44,.545,17,46,.370,13,16,.813,112
2098,CHO,2021-04-01,89,@,BRK,L 89-111,240,30,86,.349,17,48,.354,13,38,.342,16,19,.842,89,44,91,.484,24,46,.522,20,45,.444,3,4,.750,111
2099,LAC,2021-03-17,89,@,DAL,L 89-105,240,37,88,.420,28,56,.500,9,32,.281,6,11,.545,89,40,79,.506,25,45,.556,15,34,.441,10,12,.833,105
2100,MEM,2021-03-17,89,,MIA,W 89-85,240,30,85,.353,20,43,.465,10,42,.238,19,25,.760,89,32,89,.360,24,55,.436,8,34,.235,13,18,.722,85
2101,LAL,2021-02-24,89,@,UTA,L 89-114,240,34,85,.400,26,52,.500,8,33,.242,13,20,.650,89,41,87,.471,19,39,.487,22,48,.458,10,15,.667,114
2102,NYK,2021-02-17,89,@,ORL,L 89-107,240,33,87,.379,26,60,.433,7,27,.259,16,19,.842,89,42,92,.457,26,58,.448,16,34,.471,7,10,.700,107
2103,NYK,2021-01-10,89,,DEN,L 89-114,240,32,74,.432,26,53,.491,6,21,.286,19,25,.760,89,45,84,.536,30,49,.612,15,35,.429,9,12,.750,114
2104,NYK,2021-01-08,89,,OKC,L 89-101,240,34,96,.354,25,69,.362,9,27,.333,12,20,.600,89,38,87,.437,27,53,.509,11,34,.324,14,21,.667,101
2105,NYK,2020-12-26,89,,PHI,L 89-109,240,32,83,.386,24,54,.444,8,29,.276,17,23,.739,89,41,88,.466,30,57,.526,11,31,.355,16,22,.727,109
2106,NYK,2021-03-29,88,,MIA,L 88-98,240,33,80,.413,23,44,.523,10,36,.278,12,20,.600,88,37,86,.430,27,52,.519,10,34,.294,14,17,.824,98
2107,BRK,2021-03-24,88,@,UTA,L 88-118,240,35,97,.361,28,62,.452,7,35,.200,11,15,.733,88,41,91,.451,18,36,.500,23,55,.418,13,14,.929,118
2108,WAS,2021-01-26,88,@,HOU,L 88-107,240,33,85,.388,28,59,.475,5,26,.192,17,23,.739,88,37,88,.420,25,51,.490,12,37,.324,21,29,.724,107
2109,NYK,2021-01-11,88,@,CHO,L 88-109,240,34,87,.391,25,50,.500,9,37,.243,11,17,.647,88,38,78,.487,25,46,.543,13,32,.406,20,23,.870,109
2110,SAS,2021-01-10,88,@,MIN,L 88-96,240,36,94,.383,28,64,.438,8,30,.267,8,14,.571,88,34,81,.420,25,55,.455,9,26,.346,19,23,.826,96
2111,HOU,2021-05-01,87,,GSW,L 87-113,240,32,89,.360,23,47,.489,9,42,.214,14,22,.636,87,39,84,.464,21,38,.553,18,46,.391,17,24,.708,113
2112,SAS,2021-04-21,87,,MIA,L 87-107,240,31,77,.403,21,42,.500,10,35,.286,15,20,.750,87,39,83,.470,26,52,.500,13,31,.419,16,20,.800,107
2113,DEN,2021-04-11,87,,BOS,L 87-105,240,32,88,.364,24,54,.444,8,34,.235,15,18,.833,87,39,87,.448,32,54,.593,7,33,.212,20,23,.870,105
2114,ORL,2021-04-11,87,,MIL,L 87-124,240,32,86,.372,24,50,.480,8,36,.222,15,19,.789,87,46,94,.489,27,54,.500,19,40,.475,13,15,.867,124
2115,WAS,2021-04-03,87,,DAL,L 87-109,240,35,86,.407,30,61,.492,5,25,.200,12,15,.800,87,40,90,.444,30,60,.500,10,30,.333,19,24,.792,109
2116,IND,2021-03-31,87,,MIA,L 87-92,240,34,85,.400,23,48,.479,11,37,.297,8,12,.667,87,32,78,.410,22,46,.478,10,32,.313,18,28,.643,92
2117,DAL,2021-03-03,87,,OKC,W 87-78,240,32,83,.386,24,43,.558,8,40,.200,15,19,.789,87,29,87,.333,20,48,.417,9,39,.231,11,17,.647,78
2118,HOU,2021-02-03,87,@,OKC,L 87-104,240,33,86,.384,21,40,.525,12,46,.261,9,13,.692,87,36,83,.434,26,50,.520,10,33,.303,22,26,.846,104
2119,POR,2021-01-14,87,,IND,L 87-111,240,32,87,.368,19,44,.432,13,43,.302,10,10,1.000,87,44,92,.478,35,62,.565,9,30,.300,14,18,.778,111
2120,CLE,2021-01-12,87,,UTA,L 87-117,240,35,90,.389,27,59,.458,8,31,.258,9,14,.643,87,42,84,.500,18,39,.462,24,45,.533,9,12,.750,117
2121,ATL,2021-04-26,86,@,DET,L 86-100,240,33,85,.388,29,58,.500,4,27,.148,16,17,.941,86,40,84,.476,31,58,.534,9,26,.346,11,15,.733,100
2122,PHO,2021-04-22,86,@,BOS,L 86-99,240,36,88,.409,30,53,.566,6,35,.171,8,9,.889,86,33,77,.429,21,37,.568,12,40,.300,21,24,.875,99
2123,MIA,2021-04-13,86,@,PHO,L 86-106,240,31,82,.378,22,38,.579,9,44,.205,15,19,.789,86,38,82,.463,25,40,.625,13,42,.310,17,18,.944,106
2124,CHO,2021-04-04,86,@,BOS,L 86-116,240,32,80,.400,22,49,.449,10,31,.323,12,20,.600,86,43,94,.457,22,40,.550,21,54,.389,9,11,.818,116
2125,LAL,2021-04-04,86,@,LAC,L 86-104,240,32,80,.400,25,57,.439,7,23,.304,15,20,.750,86,41,86,.477,27,58,.466,14,28,.500,8,9,.889,104
2126,NYK,2021-04-02,86,,DAL,L 86-99,240,32,89,.360,20,51,.392,12,38,.316,10,10,1.000,86,41,88,.466,29,51,.569,12,37,.324,5,10,.500,99
2127,CLE,2021-03-26,86,@,LAL,L 86-100,240,31,80,.388,26,54,.481,5,26,.192,19,28,.679,86,38,78,.487,32,52,.615,6,26,.231,18,25,.720,100
2128,DET,2021-03-21,86,,CHI,L 86-100,240,32,82,.390,28,57,.491,4,25,.160,18,25,.720,86,37,80,.463,23,52,.442,14,28,.500,12,14,.857,100
2129,TOR,2021-02-19,86,@,MIN,W 86-81,240,28,85,.329,16,45,.356,12,40,.300,18,22,.818,86,32,83,.386,23,45,.511,9,38,.237,8,11,.727,81
2130,DET,2021-01-10,86,,UTA,L 86-96,240,29,87,.333,19,45,.422,10,42,.238,18,21,.857,86,35,82,.427,24,47,.511,11,35,.314,15,22,.682,96
2131,NOP,2020-12-29,86,@,PHO,L 86-111,240,37,77,.481,34,53,.642,3,24,.125,9,18,.500,86,37,84,.440,18,37,.486,19,47,.404,18,19,.947,111
2132,CLE,2020-12-29,86,,NYK,L 86-95,240,32,88,.364,25,56,.446,7,32,.219,15,22,.682,86,34,79,.430,20,54,.370,14,25,.560,13,21,.619,95
2133,PHO,2021-04-17,85,,SAS,L 85-111,240,36,90,.400,30,63,.476,6,27,.222,7,16,.438,85,45,89,.506,33,60,.550,12,29,.414,9,12,.750,111
2134,OKC,2021-04-03,85,@,POR,L 85-133,240,30,85,.353,22,51,.431,8,34,.235,17,24,.708,85,51,104,.490,31,58,.534,20,46,.435,11,14,.786,133
2135,SAS,2021-03-25,85,,LAC,L 85-98,240,33,82,.402,25,59,.424,8,23,.348,11,13,.846,85,34,89,.382,21,55,.382,13,34,.382,17,18,.944,98
2136,MIA,2021-03-17,85,@,MEM,L 85-89,240,32,89,.360,24,55,.436,8,34,.235,13,18,.722,85,30,85,.353,20,43,.465,10,42,.238,19,25,.760,89
2137,OKC,2021-02-19,85,@,MIL,L 85-98,240,31,85,.365,19,45,.422,12,40,.300,11,21,.524,85,35,86,.407,24,52,.462,11,34,.324,17,25,.680,98
2138,MIA,2021-01-25,85,@,BRK,L 85-98,240,31,84,.369,20,41,.488,11,43,.256,12,17,.706,85,34,85,.400,23,47,.489,11,38,.289,19,22,.864,98
2139,HOU,2021-02-28,84,,MEM,L 84-133,240,23,83,.277,19,38,.500,4,45,.089,34,41,.829,84,50,94,.532,40,64,.625,10,30,.333,23,28,.821,133
2140,ORL,2021-01-18,84,@,NYK,L 84-91,240,29,86,.337,17,48,.354,12,38,.316,14,16,.875,84,31,87,.356,26,60,.433,5,27,.185,24,34,.706,91
2141,ATL,2021-04-28,83,@,PHI,L 83-127,240,27,81,.333,21,62,.339,6,19,.316,23,29,.793,83,48,89,.539,32,53,.604,16,36,.444,15,22,.682,127
2142,CLE,2021-01-04,83,@,ORL,L 83-103,240,33,85,.388,23,57,.404,10,28,.357,7,12,.583,83,38,88,.432,23,54,.426,15,34,.441,12,13,.923,103
2143,MIA,2021-01-01,83,@,DAL,L 83-93,240,29,78,.372,22,45,.489,7,33,.212,18,25,.720,83,32,78,.410,20,41,.488,12,37,.324,17,23,.739,93
2144,NYK,2020-12-31,83,@,TOR,L 83-100,240,32,88,.364,29,52,.558,3,36,.083,16,20,.800,83,34,83,.410,17,31,.548,17,52,.327,15,21,.714,100
2145,CLE,2021-03-14,82,@,ATL,L 82-100,240,31,81,.383,23,51,.451,8,30,.267,12,23,.522,82,32,71,.451,20,42,.476,12,29,.414,24,26,.923,100
2146,CLE,2021-03-12,82,@,NOP,L 82-116,240,30,88,.341,23,56,.411,7,32,.219,15,20,.750,82,47,101,.465,41,77,.532,6,24,.250,16,19,.842,116
2147,MIA,2021-01-27,82,,DEN,L 82-109,240,30,80,.375,17,35,.486,13,45,.289,9,11,.818,82,42,92,.457,28,49,.571,14,43,.326,11,11,1.000,109
2148,DET,2021-04-03,81,,NYK,L 81-125,240,29,82,.354,20,54,.370,9,28,.321,14,20,.700,81,43,79,.544,24,40,.600,19,39,.487,20,27,.741,125
2149,MIN,2021-02-19,81,,TOR,L 81-86,240,32,83,.386,23,45,.511,9,38,.237,8,11,.727,81,28,85,.329,16,45,.356,12,40,.300,18,22,.818,86
2150,CLE,2021-01-29,81,@,NYK,L 81-102,240,29,84,.345,21,58,.362,8,26,.308,15,18,.833,81,39,80,.488,29,53,.547,10,27,.370,14,16,.875,102
2151,MIA,2021-01-22,81,@,TOR,L 81-101,240,33,77,.429,26,46,.565,7,31,.226,8,10,.800,81,39,84,.464,22,44,.500,17,40,.425,6,9,.667,101
2152,MIA,2021-03-02,80,,ATL,L 80-94,240,28,75,.373,19,42,.452,9,33,.273,15,22,.682,80,34,71,.479,21,35,.600,13,36,.361,13,15,.867,94
2153,OKC,2020-12-31,80,,NOP,L 80-113,240,30,80,.375,15,32,.469,15,48,.313,5,15,.333,80,44,91,.484,31,55,.564,13,36,.361,12,19,.632,113
2154,OKC,2021-03-03,78,@,DAL,L 78-87,240,29,87,.333,20,48,.417,9,39,.231,11,17,.647,78,32,83,.386,24,43,.558,8,40,.200,15,19,.789,87
2155,GSW,2021-04-02,77,@,TOR,L 77-130,240,26,79,.329,15,45,.333,11,34,.324,14,18,.778,77,47,88,.534,32,53,.604,15,35,.429,21,25,.840,130
2156,ORL,2021-03-12,77,@,SAS,L 77-104,240,29,80,.363,19,42,.452,10,38,.263,9,12,.750,77,40,89,.449,30,60,.500,10,29,.345,14,18,.778,104
2157,ORL,2021-04-30,75,@,MEM,L 75-92,240,27,86,.314,21,60,.350,6,26,.231,15,20,.750,75,34,99,.343,23,60,.383,11,39,.282,13,16,.813,92
2158,CLE,2021-03-29,75,@,UTA,L 75-114,240,29,83,.349,22,49,.449,7,34,.206,10,16,.625,75,38,82,.463,19,41,.463,19,41,.463,19,23,.826,114
2159,BOS,2021-01-17,75,,NYK,L 75-105,240,25,84,.298,18,38,.474,7,46,.152,18,29,.621,75,38,80,.475,26,49,.531,12,31,.387,17,21,.810,105
2160,LAC,2020-12-27,73,,DAL,L 73-124,240,26,76,.342,22,43,.512,4,33,.121,17,20,.850,73,43,87,.494,29,46,.630,14,41,.341,24,27,.889,124