Rk,Team,Date,PTS,,Opp,Result,MP,FG,FGA,FG%,2P,2PA,2P%,3P,3PA,3P%,FT,FTA,FT%,PTS,FG,FGA,FG%,2P,2PA,2P%,3P,3PA,3P%,FT,FTA,FT%,PTS
1,MIA,2018-03-19,149,,DEN,W 149-141 (2OT),290,56,102,.549,36,66,.545,20,36,.556,17,27,.630,149,46,100,.460,28,62,.452,18,38,.474,31,37,.838,141
2,OKC,2018-01-20,148,@,CLE,W 148-124,240,58,100,.580,44,70,.629,14,30,.467,18,28,.643,148,46,89,.517,36,52,.692,10,37,.270,22,27,.815,124
3,HOU,2017-12-31,148,,LAL,W 148-142 (2OT),290,49,106,.462,31,54,.574,18,52,.346,32,39,.821,148,53,105,.505,43,80,.538,10,25,.400,26,37,.703,142
4,DEN,2017-11-17,146,,NOP,W 146-114,240,56,89,.629,38,54,.704,18,35,.514,16,21,.762,146,48,91,.527,36,58,.621,12,33,.364,6,10,.600,114
5,GSW,2017-11-24,143,,CHI,W 143-94,240,53,91,.582,37,55,.673,16,36,.444,21,21,1.000,143,35,99,.354,22,63,.349,13,36,.361,11,15,.733,94
6,LAL,2017-12-31,142,@,HOU,L 142-148 (2OT),290,53,105,.505,43,80,.538,10,25,.400,26,37,.703,142,49,106,.462,31,54,.574,18,52,.346,32,39,.821,148
7,HOU,2017-11-16,142,@,PHO,W 142-116,240,43,90,.478,22,46,.478,21,44,.477,35,38,.921,142,47,104,.452,37,74,.500,10,30,.333,12,21,.571,116
8,DEN,2018-03-19,141,@,MIA,L 141-149 (2OT),290,46,100,.460,28,62,.452,18,38,.474,31,37,.838,141,56,102,.549,36,66,.545,20,36,.556,17,27,.630,149
9,GSW,2017-12-30,141,,MEM,W 141-128,240,50,85,.588,32,52,.615,18,33,.545,23,25,.920,141,49,94,.521,34,73,.466,15,21,.714,15,22,.682,128
10,GSW,2017-10-30,141,@,LAC,W 141-113,240,52,89,.584,38,60,.633,14,29,.483,23,30,.767,141,39,86,.453,29,61,.475,10,25,.400,25,30,.833,113
11,CHO,2018-03-22,140,,MEM,W 140-79,240,49,92,.533,30,52,.577,19,40,.475,23,27,.852,140,30,78,.385,26,60,.433,4,18,.222,15,21,.714,79
12,CLE,2018-02-07,140,,MIN,W 140-138 (OT),265,52,88,.591,31,47,.660,21,41,.512,15,23,.652,140,54,93,.581,35,60,.583,19,33,.576,11,12,.917,138
13,IND,2017-10-18,140,,BRK,W 140-131,240,53,102,.520,44,68,.647,9,34,.265,25,32,.781,140,45,94,.479,33,64,.516,12,30,.400,29,32,.906,131
14,NOP,2018-02-14,139,,LAL,W 139-117,240,53,99,.535,39,67,.582,14,32,.438,19,21,.905,139,46,90,.511,36,68,.529,10,22,.455,15,18,.833,117
15,NOP,2018-02-10,138,@,BRK,W 138-128 (2OT),290,52,106,.491,43,82,.524,9,24,.375,25,39,.641,138,43,114,.377,22,55,.400,21,59,.356,21,22,.955,128
16,MIN,2018-02-07,138,@,CLE,L 138-140 (OT),265,54,93,.581,35,60,.583,19,33,.576,11,12,.917,138,52,88,.591,31,47,.660,21,41,.512,15,23,.652,140
17,OKC,2018-04-11,137,,MEM,W 137-123,240,47,85,.553,27,42,.643,20,43,.465,23,32,.719,137,44,91,.484,31,60,.517,13,31,.419,22,24,.917,123
18,CHO,2018-04-06,137,@,ORL,W 137-100,240,48,86,.558,31,55,.564,17,31,.548,24,26,.923,137,42,94,.447,33,71,.465,9,23,.391,7,13,.538,100
19,CHO,2018-03-26,137,,NYK,W 137-128 (OT),265,51,93,.548,40,65,.615,11,28,.393,24,28,.857,137,54,105,.514,45,75,.600,9,30,.300,11,11,1.000,128
20,HOU,2017-11-05,137,,UTA,W 137-110,240,48,81,.593,25,42,.595,23,39,.590,18,21,.857,137,38,88,.432,25,54,.463,13,34,.382,21,24,.875,110
21,DEN,2018-03-21,135,@,CHI,W 135-102,240,51,83,.614,31,48,.646,20,35,.571,13,16,.813,135,39,89,.438,26,51,.510,13,38,.342,11,14,.786,102
22,GSW,2017-11-11,135,,PHI,W 135-114,240,48,82,.585,34,55,.618,14,27,.519,25,26,.962,135,44,94,.468,32,66,.485,12,28,.429,14,20,.700,114
23,DEN,2018-04-07,134,@,LAC,W 134-115,240,53,85,.624,41,56,.732,12,29,.414,16,23,.696,134,43,87,.494,37,70,.529,6,17,.353,23,34,.676,115
24,BOS,2018-02-28,134,,CHO,W 134-106,240,54,87,.621,42,67,.627,12,20,.600,14,15,.933,134,42,91,.462,33,64,.516,9,27,.333,13,22,.591,106
25,GSW,2018-02-22,134,,LAC,W 134-127,240,47,77,.610,33,52,.635,14,25,.560,26,34,.765,134,44,88,.500,33,56,.589,11,32,.344,28,34,.824,127
26,DEN,2018-02-15,134,@,MIL,W 134-123,240,47,85,.553,23,45,.511,24,40,.600,16,20,.800,134,49,92,.533,40,66,.606,9,26,.346,16,22,.727,123
27,DEN,2018-01-03,134,,PHO,W 134-111,240,51,82,.622,39,55,.709,12,27,.444,20,22,.909,134,39,92,.424,26,57,.456,13,35,.371,20,28,.714,111
28,UTA,2018-02-05,133,@,NOP,W 133-109,240,52,89,.584,38,68,.559,14,21,.667,15,17,.882,133,47,93,.505,39,71,.549,8,22,.364,7,13,.538,109
29,CHO,2018-02-02,133,,IND,W 133-126,240,44,83,.530,29,50,.580,15,33,.455,30,34,.882,133,44,87,.506,32,58,.552,12,29,.414,26,28,.929,126
30,CHO,2018-01-17,133,,WAS,W 133-109,240,48,98,.490,33,67,.493,15,31,.484,22,26,.846,133,40,82,.488,27,59,.458,13,23,.565,16,23,.696,109
31,TOR,2018-01-11,133,,CLE,W 133-99,240,53,106,.500,35,64,.547,18,42,.429,9,13,.692,133,34,89,.382,28,63,.444,6,26,.231,25,30,.833,99
32,OKC,2018-01-03,133,@,LAL,W 133-96,240,56,93,.602,42,63,.667,14,30,.467,7,9,.778,133,38,92,.413,27,59,.458,11,33,.333,9,15,.600,96
33,GSW,2017-12-01,133,@,ORL,W 133-112,240,55,88,.625,43,64,.672,12,24,.500,11,11,1.000,133,44,96,.458,33,68,.485,11,28,.393,13,18,.722,112
34,SAS,2017-11-11,133,,CHI,W 133-94,240,51,85,.600,33,58,.569,18,27,.667,13,16,.813,133,40,86,.465,34,63,.540,6,23,.261,8,13,.615,94
35,GSW,2017-10-23,133,@,DAL,W 133-103,240,48,86,.558,33,47,.702,15,39,.385,22,26,.846,133,38,96,.396,29,67,.433,9,29,.310,18,30,.600,103
36,PHI,2018-04-06,132,,CLE,W 132-130,240,50,101,.495,36,62,.581,14,39,.359,18,21,.857,132,45,87,.517,29,53,.547,16,34,.471,24,33,.727,130
37,CLE,2018-03-21,132,,TOR,W 132-129,240,47,78,.603,32,54,.593,15,24,.625,23,28,.821,132,47,88,.534,32,54,.593,15,34,.441,20,23,.870,129
38,OKC,2018-03-18,132,@,TOR,W 132-125,240,49,88,.557,39,67,.582,10,21,.476,24,34,.706,132,46,81,.568,31,51,.608,15,30,.500,18,23,.783,125
39,TOR,2018-03-11,132,@,NYK,W 132-106,240,47,93,.505,31,58,.534,16,35,.457,22,25,.880,132,40,88,.455,33,67,.493,7,21,.333,19,24,.792,106
40,NOP,2018-01-22,132,,CHI,W 132-128 (2OT),290,47,113,.416,31,69,.449,16,44,.364,22,26,.846,132,45,92,.489,37,61,.607,8,31,.258,30,34,.882,128
41,LAL,2018-01-07,132,,ATL,W 132-113,240,48,86,.558,32,50,.640,16,36,.444,20,25,.800,132,41,94,.436,29,60,.483,12,34,.353,19,23,.826,113
42,LAL,2017-10-20,132,@,PHO,W 132-130,240,48,93,.516,36,67,.537,12,26,.462,24,33,.727,132,45,92,.489,31,63,.492,14,29,.483,26,38,.684,130
43,LAL,2018-03-01,131,@,MIA,W 131-113,240,47,79,.595,31,50,.620,16,29,.552,21,26,.808,131,46,95,.484,37,64,.578,9,31,.290,12,16,.750,113
44,CLE,2018-01-06,131,@,ORL,W 131-127,240,47,94,.500,32,60,.533,15,34,.441,22,31,.710,131,49,98,.500,35,61,.574,14,37,.378,15,22,.682,127
45,CHO,2018-01-02,131,@,SAC,W 131-111,240,51,89,.573,36,57,.632,15,32,.469,14,18,.778,131,45,87,.517,38,70,.543,7,17,.412,14,18,.778,111
46,TOR,2018-01-01,131,,MIL,W 131-127 (OT),265,45,91,.495,31,58,.534,14,33,.424,27,33,.818,131,44,93,.473,31,66,.470,13,27,.481,26,28,.929,127
47,NOP,2017-12-10,131,,PHI,W 131-124,240,46,80,.575,31,56,.554,15,24,.625,24,32,.750,131,44,96,.458,35,67,.522,9,29,.310,27,30,.900,124
48,DET,2017-11-29,131,,PHO,W 131-107,240,51,89,.573,38,61,.623,13,28,.464,16,21,.762,131,39,84,.464,32,62,.516,7,22,.318,22,28,.786,107
49,BRK,2017-10-18,131,@,IND,L 131-140,240,45,94,.479,33,64,.516,12,30,.400,29,32,.906,131,53,102,.520,44,68,.647,9,34,.265,25,32,.781,140
50,PHI,2018-04-11,130,,MIL,W 130-95,240,52,105,.495,37,69,.536,15,36,.417,11,15,.733,130,37,90,.411,30,65,.462,7,25,.280,14,16,.875,95
51,MEM,2018-04-08,130,,DET,W 130-117,240,48,83,.578,32,50,.640,16,33,.485,18,24,.750,130,38,93,.409,15,46,.326,23,47,.489,18,23,.783,117
52,CLE,2018-04-06,130,@,PHI,L 130-132,240,45,87,.517,29,53,.547,16,34,.471,24,33,.727,130,50,101,.495,36,62,.581,14,39,.359,18,21,.857,132
53,DEN,2018-03-11,130,,SAC,W 130-104,240,50,89,.562,35,52,.673,15,37,.405,15,21,.714,130,39,91,.429,33,60,.550,6,31,.194,20,26,.769,104
54,DAL,2018-02-10,130,,LAL,W 130-123,240,48,89,.539,36,62,.581,12,27,.444,22,27,.815,130,46,84,.548,30,50,.600,16,34,.471,15,22,.682,123
55,HOU,2018-02-09,130,,DEN,W 130-104,240,43,86,.500,24,45,.533,19,41,.463,25,34,.735,130,42,88,.477,39,60,.650,3,28,.107,17,21,.810,104
56,TOR,2018-02-02,130,,POR,W 130-105,240,46,99,.465,27,59,.458,19,40,.475,19,21,.905,130,37,73,.507,30,52,.577,7,21,.333,24,33,.727,105
57,DEN,2018-01-25,130,,NYK,W 130-118,240,48,80,.600,34,52,.654,14,28,.500,20,24,.833,130,45,82,.549,37,61,.607,8,21,.381,20,24,.833,118
58,WAS,2017-12-23,130,,ORL,W 130-103,240,47,86,.547,31,56,.554,16,30,.533,20,23,.870,130,42,87,.483,34,61,.557,8,26,.308,11,17,.647,103
59,HOU,2017-12-11,130,,NOP,W 130-123,240,48,88,.545,31,43,.721,17,45,.378,17,25,.680,130,49,85,.576,31,52,.596,18,33,.545,7,13,.538,123
60,PHI,2017-11-25,130,,ORL,W 130-111,240,48,95,.505,32,61,.525,16,34,.471,18,20,.900,130,39,86,.453,27,55,.491,12,31,.387,21,31,.677,111
61,CLE,2017-11-03,130,@,WAS,W 130-122,240,46,82,.561,34,55,.618,12,27,.444,26,28,.929,130,45,84,.536,34,56,.607,11,28,.393,21,31,.677,122
62,IND,2017-10-24,130,@,MIN,W 130-107,240,56,84,.667,46,62,.742,10,22,.455,8,11,.727,130,42,86,.488,33,62,.532,9,24,.375,14,22,.636,107
63,LAC,2017-10-21,130,,PHO,W 130-88,240,48,88,.545,36,62,.581,12,26,.462,22,30,.733,130,27,71,.380,21,47,.447,6,24,.250,28,38,.737,88
64,PHO,2017-10-20,130,,LAL,L 130-132,240,45,92,.489,31,63,.492,14,29,.483,26,38,.684,130,48,93,.516,36,67,.537,12,26,.462,24,33,.727,132
65,TOR,2018-03-21,129,@,CLE,L 129-132,240,47,88,.534,32,54,.593,15,34,.441,20,23,.870,129,47,78,.603,32,54,.593,15,24,.625,23,28,.821,132
66,HOU,2018-03-18,129,@,MIN,W 129-120,240,43,78,.551,27,43,.628,16,35,.457,27,36,.750,129,45,86,.523,35,66,.530,10,20,.500,20,26,.769,120
67,CHO,2018-03-15,129,@,ATL,W 129-117,240,46,87,.529,29,54,.537,17,33,.515,20,30,.667,129,42,90,.467,26,54,.481,16,36,.444,17,26,.654,117
68,CLE,2018-03-13,129,@,PHO,W 129-107,240,43,87,.494,26,52,.500,17,35,.486,26,30,.867,129,38,98,.388,32,66,.485,6,32,.188,25,30,.833,107
69,CHI,2018-03-11,129,@,ATL,W 129-122,240,48,98,.490,31,61,.508,17,37,.459,16,19,.842,129,42,82,.512,23,42,.548,19,40,.475,19,22,.864,122
70,MIA,2018-03-10,129,,WAS,W 129-102,240,52,88,.591,42,60,.700,10,28,.357,15,21,.714,129,34,77,.442,27,57,.474,7,20,.350,27,34,.794,102
71,CLE,2018-02-27,129,,BRK,W 129-123,240,50,97,.515,38,73,.521,12,24,.500,17,27,.630,129,44,82,.537,32,50,.640,12,32,.375,23,30,.767,123
72,LAC,2018-02-14,129,@,BOS,W 129-119,240,44,88,.500,33,59,.559,11,29,.379,30,33,.909,129,42,97,.433,27,66,.409,15,31,.484,20,21,.952,119
73,GSW,2018-02-12,129,,PHO,W 129-83,240,52,89,.584,41,63,.651,11,26,.423,14,21,.667,129,33,95,.347,30,72,.417,3,23,.130,14,22,.636,83
74,SAS,2018-02-07,129,@,PHO,W 129-81,240,46,93,.495,30,61,.492,16,32,.500,21,27,.778,129,33,97,.340,30,65,.462,3,32,.094,12,18,.667,81
75,UTA,2018-02-02,129,@,PHO,W 129-97,240,51,90,.567,36,61,.590,15,29,.517,12,17,.706,129,36,87,.414,27,54,.500,9,33,.273,16,19,.842,97
76,UTA,2018-01-30,129,,GSW,W 129-99,240,53,91,.582,39,63,.619,14,28,.500,9,14,.643,129,39,85,.459,34,60,.567,5,25,.200,16,21,.762,99
77,WAS,2018-01-27,129,@,ATL,W 129-104,240,49,85,.576,31,53,.585,18,32,.563,13,14,.929,129,38,88,.432,26,45,.578,12,43,.279,16,21,.762,104
78,TOR,2018-01-05,129,@,MIL,W 129-110,240,48,86,.558,38,53,.717,10,33,.303,23,28,.821,129,41,77,.532,34,60,.567,7,17,.412,21,29,.724,110
79,TOR,2017-12-20,129,@,CHO,W 129-111,240,49,91,.538,33,58,.569,16,33,.485,15,18,.833,129,39,85,.459,32,62,.516,7,23,.304,26,35,.743,111
80,CHO,2017-11-22,129,,WAS,W 129-124 (OT),265,43,91,.473,33,63,.524,10,28,.357,33,40,.825,129,48,99,.485,37,66,.561,11,33,.333,17,22,.773,124
81,TOR,2017-11-14,129,@,HOU,W 129-113,240,41,78,.526,27,48,.563,14,30,.467,33,42,.786,129,33,79,.418,21,40,.525,12,39,.308,35,41,.854,113
82,DEN,2017-11-01,129,,TOR,W 129-111,240,47,88,.534,31,56,.554,16,32,.500,19,29,.655,129,42,85,.494,31,54,.574,11,31,.355,16,25,.640,111
83,DEN,2018-04-01,128,,MIL,W 128-125 (OT),265,40,90,.444,29,54,.537,11,36,.306,37,46,.804,128,45,100,.450,33,67,.493,12,33,.364,23,27,.852,125
84,NYK,2018-03-26,128,@,CHO,L 128-137 (OT),265,54,105,.514,45,75,.600,9,30,.300,11,11,1.000,128,51,93,.548,40,65,.615,11,28,.393,24,28,.857,137
85,NOP,2018-03-22,128,,LAL,W 128-125,240,52,95,.547,46,71,.648,6,24,.250,18,22,.818,128,43,87,.494,26,48,.542,17,39,.436,22,28,.786,125
86,PHI,2018-03-06,128,@,CHO,W 128-114,240,50,87,.575,34,54,.630,16,33,.485,12,15,.800,128,40,80,.500,29,51,.569,11,29,.379,23,31,.742,114
87,LAC,2018-03-02,128,,NYK,W 128-105,240,50,89,.562,41,64,.641,9,25,.360,19,24,.792,128,41,89,.461,30,64,.469,11,25,.440,12,16,.750,105
88,LAC,2018-02-23,128,@,PHO,W 128-117,240,45,87,.517,31,55,.564,14,32,.438,24,32,.750,128,45,103,.437,36,72,.500,9,31,.290,18,31,.581,117
89,BRK,2018-02-10,128,,NOP,L 128-138 (2OT),290,43,114,.377,22,55,.400,21,59,.356,21,22,.955,128,52,106,.491,43,82,.524,9,24,.375,25,39,.641,138
90,CHI,2018-01-22,128,@,NOP,L 128-132 (2OT),290,45,92,.489,37,61,.607,8,31,.258,30,34,.882,128,47,113,.416,31,69,.449,16,44,.364,22,26,.846,132
91,MEM,2017-12-30,128,@,GSW,L 128-141,240,49,94,.521,34,73,.466,15,21,.714,15,22,.682,128,50,85,.588,32,52,.615,18,33,.545,23,25,.920,141
92,DAL,2017-12-29,128,@,NOP,W 128-120,240,46,83,.554,24,44,.545,22,39,.564,14,18,.778,128,42,85,.494,34,54,.630,8,31,.258,28,32,.875,120
93,MIN,2017-12-27,128,,DEN,W 128-125 (OT),265,47,90,.522,35,61,.574,12,29,.414,22,30,.733,128,42,91,.462,27,52,.519,15,39,.385,26,31,.839,125
94,NOP,2017-12-27,128,,BRK,W 128-113,240,48,90,.533,31,57,.544,17,33,.515,15,19,.789,128,41,90,.456,22,52,.423,19,38,.500,12,14,.857,113
95,LAC,2017-12-22,128,@,HOU,W 128-118,240,43,91,.473,25,49,.510,18,42,.429,24,31,.774,128,36,78,.462,19,38,.500,17,40,.425,29,35,.829,118
96,ORL,2017-11-10,128,@,PHO,W 128-112,240,43,82,.524,30,54,.556,13,28,.464,29,43,.674,128,44,94,.468,39,70,.557,5,24,.208,19,25,.760,112
97,TOR,2017-10-21,128,,PHI,W 128-94,240,42,89,.472,29,45,.644,13,44,.295,31,37,.838,128,32,82,.390,24,58,.414,8,24,.333,22,36,.611,94
98,GSW,2017-10-20,128,@,NOP,W 128-120,240,47,92,.511,29,51,.569,18,41,.439,16,20,.800,128,45,98,.459,29,62,.468,16,36,.444,14,22,.636,120
99,LAC,2018-03-21,127,@,MIL,W 127-120,240,45,86,.523,30,56,.536,15,30,.500,22,29,.759,127,50,91,.549,42,65,.646,8,26,.308,12,17,.706,120
100,LAL,2018-03-11,127,,CLE,W 127-113,240,48,96,.500,35,62,.565,13,34,.382,18,20,.900,127,41,88,.466,29,57,.509,12,31,.387,19,23,.826,113
101,LAC,2018-02-22,127,@,GSW,L 127-134,240,44,88,.500,33,56,.589,11,32,.344,28,34,.824,127,47,77,.610,33,52,.635,14,25,.560,26,34,.765,134
102,DEN,2018-02-01,127,,OKC,W 127-124,240,50,97,.515,35,59,.593,15,38,.395,12,17,.706,127,51,98,.520,42,70,.600,9,28,.321,13,17,.765,124
103,ORL,2018-01-31,127,,LAL,W 127-105,240,44,81,.543,26,49,.531,18,32,.563,21,29,.724,127,39,83,.470,35,63,.556,4,20,.200,23,30,.767,105
104,LAL,2018-01-21,127,,NYK,W 127-107,240,51,91,.560,41,65,.631,10,26,.385,15,21,.714,127,44,81,.543,32,56,.571,12,25,.480,7,10,.700,107
105,GSW,2018-01-13,127,@,TOR,W 127-125,240,47,81,.580,38,57,.667,9,24,.375,24,28,.857,127,45,93,.484,37,68,.544,8,25,.320,27,32,.844,125
106,MIN,2018-01-08,127,,CLE,W 127-99,240,52,100,.520,42,69,.609,10,31,.323,13,17,.765,127,37,84,.440,24,46,.522,13,38,.342,12,16,.750,99
107,ORL,2018-01-06,127,,CLE,L 127-131,240,49,98,.500,35,61,.574,14,37,.378,15,22,.682,127,47,94,.500,32,60,.533,15,34,.441,22,31,.710,131
108,CHI,2018-01-05,127,@,DAL,W 127-124,240,44,78,.564,30,50,.600,14,28,.500,25,31,.806,127,49,92,.533,35,60,.583,14,32,.438,12,17,.706,124
109,OKC,2018-01-04,127,@,LAC,W 127-117,240,51,95,.537,36,61,.590,15,34,.441,10,14,.714,127,45,100,.450,36,70,.514,9,30,.300,18,23,.783,117
110,CLE,2018-01-02,127,,POR,W 127-110,240,43,83,.518,30,51,.588,13,32,.406,28,37,.757,127,42,90,.467,29,58,.500,13,32,.406,13,19,.684,110
111,MIL,2018-01-01,127,@,TOR,L 127-131 (OT),265,44,93,.473,31,66,.470,13,27,.481,26,28,.929,127,45,91,.495,31,58,.534,14,33,.424,27,33,.818,131
112,GSW,2017-11-29,127,@,LAL,W 127-123 (OT),265,47,94,.500,35,64,.547,12,30,.400,21,28,.750,127,47,95,.495,38,71,.535,9,24,.375,20,25,.800,123
113,POR,2017-11-24,127,@,BRK,W 127-125,240,48,96,.500,42,81,.519,6,15,.400,25,35,.714,127,50,100,.500,40,75,.533,10,25,.400,15,21,.714,125
114,LAL,2017-11-19,127,,DEN,W 127-109,240,53,100,.530,41,68,.603,12,32,.375,9,16,.563,127,36,84,.429,23,53,.434,13,31,.419,24,35,.686,109
115,GSW,2017-11-04,127,@,DEN,W 127-108,240,50,91,.549,32,51,.627,18,40,.450,9,17,.529,127,40,87,.460,34,63,.540,6,24,.250,22,27,.815,108
116,NOP,2018-04-07,126,@,GSW,W 126-120,240,49,87,.563,38,60,.633,11,27,.407,17,22,.773,126,49,90,.544,34,57,.596,15,33,.455,7,11,.636,120
117,IND,2018-04-05,126,,GSW,W 126-106,240,50,93,.538,35,64,.547,15,29,.517,11,15,.733,126,37,83,.446,28,54,.519,9,29,.310,23,24,.958,106
118,DEN,2018-03-30,126,@,OKC,W 126-125 (OT),265,49,94,.521,39,64,.609,10,30,.333,18,21,.857,126,45,108,.417,25,64,.391,20,44,.455,15,27,.556,125
119,MIN,2018-03-28,126,,ATL,W 126-114,240,48,90,.533,35,60,.583,13,30,.433,17,21,.810,126,41,77,.532,28,50,.560,13,27,.481,19,23,.826,114
120,ORL,2018-03-14,126,,MIL,W 126-117,240,44,87,.506,26,53,.491,18,34,.529,20,23,.870,126,49,98,.500,39,74,.527,10,24,.417,9,12,.750,117
121,NOP,2018-03-04,126,@,DAL,W 126-109,240,49,91,.538,37,65,.569,12,26,.462,16,21,.762,126,40,90,.444,30,67,.448,10,23,.435,19,25,.760,109
122,DEN,2018-03-03,126,@,CLE,W 126-117,240,47,86,.547,28,51,.549,19,35,.543,13,15,.867,126,46,88,.523,37,64,.578,9,24,.375,16,21,.762,117
123,HOU,2018-02-13,126,@,MIN,W 126-108,240,41,83,.494,19,36,.528,22,47,.468,22,29,.759,126,40,84,.476,34,61,.557,6,23,.261,22,23,.957,108
124,IND,2018-02-02,126,@,CHO,L 126-133,240,44,87,.506,32,58,.552,12,29,.414,26,28,.929,126,44,83,.530,29,50,.580,15,33,.455,30,34,.882,133
125,GSW,2018-01-25,126,,MIN,W 126-113,240,48,89,.539,27,52,.519,21,37,.568,9,15,.600,126,46,101,.455,40,81,.494,6,20,.300,15,18,.833,113
126,MIN,2018-01-22,126,@,LAC,W 126-118,240,43,91,.473,36,69,.522,7,22,.318,33,39,.846,126,47,84,.560,38,57,.667,9,27,.333,15,22,.682,118
127,LAC,2018-01-13,126,,SAC,W 126-105,240,46,82,.561,34,51,.667,12,31,.387,22,26,.846,126,43,85,.506,37,68,.544,6,17,.353,13,22,.591,105
128,GSW,2017-12-27,126,,UTA,W 126-101,240,51,86,.593,40,63,.635,11,23,.478,13,17,.765,126,37,92,.402,31,69,.449,6,23,.261,21,27,.778,101
129,IND,2017-12-10,126,,DEN,W 126-116 (OT),265,49,93,.527,39,68,.574,10,25,.400,18,22,.818,126,43,95,.453,26,53,.491,17,42,.405,13,16,.813,116
130,TOR,2017-12-05,126,,PHO,W 126-113,240,44,92,.478,29,56,.518,15,36,.417,23,26,.885,126,37,75,.493,28,51,.549,9,24,.375,30,38,.789,113
131,UTA,2017-11-30,126,@,LAC,W 126-107,240,49,85,.576,32,50,.640,17,35,.486,11,14,.786,126,38,70,.543,28,41,.683,10,29,.345,21,30,.700,107
132,TOR,2017-11-29,126,,CHO,W 126-113,240,52,98,.531,38,66,.576,14,32,.438,8,11,.727,126,37,79,.468,28,60,.467,9,19,.474,30,35,.857,113
133,ATL,2017-11-15,126,,SAC,W 126-80,240,50,79,.633,34,47,.723,16,32,.500,10,16,.625,126,31,88,.352,25,60,.417,6,28,.214,12,20,.600,80
134,MIA,2017-11-08,126,@,PHO,W 126-115,240,43,81,.531,31,51,.608,12,30,.400,28,35,.800,126,40,88,.455,28,59,.475,12,29,.414,23,30,.767,115
135,CHO,2017-11-01,126,,MIL,W 126-121,240,45,84,.536,31,59,.525,14,25,.560,22,29,.759,126,45,91,.495,26,55,.473,19,36,.528,12,15,.800,121
136,BRK,2017-10-20,126,,ORL,W 126-121,240,46,92,.500,37,65,.569,9,27,.333,25,35,.714,126,45,89,.506,27,56,.482,18,33,.545,13,15,.867,121
137,MIL,2018-04-01,125,@,DEN,L 125-128 (OT),265,45,100,.450,33,67,.493,12,33,.364,23,27,.852,125,40,90,.444,29,54,.537,11,36,.306,37,46,.804,128
138,OKC,2018-03-30,125,,DEN,L 125-126 (OT),265,45,108,.417,25,64,.391,20,44,.455,15,27,.556,125,49,94,.521,39,64,.609,10,30,.333,18,21,.857,126
139,LAL,2018-03-22,125,@,NOP,L 125-128,240,43,87,.494,26,48,.542,17,39,.436,22,28,.786,125,52,95,.547,46,71,.648,6,24,.250,18,22,.818,128
140,TOR,2018-03-18,125,,OKC,L 125-132,240,46,81,.568,31,51,.608,15,30,.500,18,23,.783,125,49,88,.557,39,67,.582,10,21,.476,24,34,.706,132
141,WAS,2018-03-14,125,@,BOS,W 125-124 (2OT),290,46,97,.474,34,65,.523,12,32,.375,21,28,.750,125,48,99,.485,36,73,.493,12,26,.462,16,23,.696,124
142,DEN,2018-03-09,125,,LAL,W 125-116,240,42,83,.506,27,52,.519,15,31,.484,26,30,.867,125,45,92,.489,31,57,.544,14,35,.400,12,16,.750,116
143,POR,2018-03-09,125,,GSW,W 125-108,240,44,89,.494,28,50,.560,16,39,.410,21,27,.778,125,38,78,.487,26,50,.520,12,28,.429,20,24,.833,108
144,BRK,2018-03-08,125,@,CHO,W 125-111,240,47,92,.511,36,60,.600,11,32,.344,20,22,.909,125,41,85,.482,37,66,.561,4,19,.211,25,30,.833,111
145,MIA,2018-03-05,125,,PHO,W 125-103,240,47,92,.511,35,56,.625,12,36,.333,19,23,.826,125,42,87,.483,32,63,.508,10,24,.417,9,18,.500,103
146,GSW,2018-02-26,125,@,NYK,W 125-111,240,44,85,.518,29,54,.537,15,31,.484,22,26,.846,125,47,96,.490,37,71,.521,10,25,.400,7,9,.778,111
147,NOP,2018-02-26,125,,PHO,W 125-116,240,43,91,.473,35,63,.556,8,28,.286,31,40,.775,125,42,97,.433,35,73,.479,7,24,.292,25,32,.781,116
148,OKC,2018-02-06,125,@,GSW,W 125-105,240,44,93,.473,32,62,.516,12,31,.387,25,33,.758,125,37,76,.487,29,48,.604,8,28,.286,23,31,.742,105
149,DET,2018-01-30,125,,CLE,W 125-114,240,49,93,.527,40,70,.571,9,23,.391,18,28,.643,125,38,84,.452,25,49,.510,13,35,.371,25,32,.781,114
150,UTA,2018-01-20,125,,LAC,W 125-113,240,45,82,.549,34,54,.630,11,28,.393,24,32,.750,125,36,82,.439,25,46,.543,11,36,.306,30,38,.789,113
151,TOR,2018-01-13,125,,GSW,L 125-127,240,45,93,.484,37,68,.544,8,25,.320,27,32,.844,125,47,81,.580,38,57,.667,9,24,.375,24,28,.857,127
152,WAS,2018-01-12,125,,ORL,W 125-119,240,54,95,.568,50,79,.633,4,16,.250,13,19,.684,125,41,80,.513,29,51,.569,12,29,.414,25,31,.806,119
153,LAC,2018-01-10,125,@,GSW,W 125-106,240,46,94,.489,35,70,.500,11,24,.458,22,28,.786,125,38,79,.481,30,56,.536,8,23,.348,22,26,.846,106
154,IND,2018-01-06,125,,CHI,W 125-86,240,48,86,.558,33,55,.600,15,31,.484,14,18,.778,125,30,80,.375,20,48,.417,10,32,.313,16,20,.800,86
155,GSW,2018-01-03,125,@,DAL,W 125-122,240,48,91,.527,35,59,.593,13,32,.406,16,19,.842,125,43,90,.478,24,47,.511,19,43,.442,17,22,.773,122
156,DEN,2017-12-27,125,@,MIN,L 125-128 (OT),265,42,91,.462,27,52,.519,15,39,.385,26,31,.839,125,47,90,.522,35,61,.574,12,29,.414,22,30,.733,128
157,GSW,2017-12-04,125,@,NOP,W 125-115,240,45,87,.517,29,54,.537,16,33,.485,19,27,.704,125,45,91,.495,29,52,.558,16,39,.410,9,15,.600,115
158,BRK,2017-11-24,125,,POR,L 125-127,240,50,100,.500,40,75,.533,10,25,.400,15,21,.714,125,48,96,.500,42,81,.519,6,15,.400,25,35,.714,127
159,HOU,2017-11-22,125,,DEN,W 125-95,240,45,82,.549,27,41,.659,18,41,.439,17,23,.739,125,35,87,.402,25,54,.463,10,33,.303,15,23,.652,95
160,UTA,2017-11-18,125,@,ORL,W 125-85,240,47,98,.480,33,64,.516,14,34,.412,17,18,.944,125,31,81,.383,23,52,.442,8,29,.276,15,23,.652,85
161,TOR,2017-11-15,125,@,NOP,W 125-116,240,45,76,.592,29,42,.690,16,34,.471,19,20,.950,125,46,91,.505,36,64,.563,10,27,.370,14,14,1.000,116
162,DEN,2017-11-11,125,,ORL,W 125-107,240,46,87,.529,34,58,.586,12,29,.414,21,27,.778,125,41,87,.471,30,56,.536,11,31,.355,14,20,.700,107
163,GSW,2017-11-08,125,,MIN,W 125-101,240,48,85,.565,33,49,.673,15,36,.417,14,18,.778,125,38,92,.413,33,68,.485,5,24,.208,20,27,.741,101
164,MIN,2017-10-30,125,@,MIA,W 125-122 (OT),265,41,91,.451,30,68,.441,11,23,.478,32,35,.914,125,49,93,.527,42,66,.636,7,27,.259,17,25,.680,122
165,ORL,2017-10-24,125,,BRK,W 125-121,240,41,83,.494,33,60,.550,8,23,.348,35,40,.875,125,40,96,.417,29,61,.475,11,35,.314,30,34,.882,121
166,PHO,2018-04-10,124,@,DAL,W 124-97,240,48,76,.632,35,50,.700,13,26,.500,15,21,.714,124,37,97,.381,29,64,.453,8,33,.242,15,22,.682,97
167,BRK,2018-04-07,124,@,CHI,W 124-96,240,46,92,.500,22,37,.595,24,55,.436,8,11,.727,124,36,88,.409,30,59,.508,6,29,.207,18,21,.857,96
168,MIL,2018-03-30,124,@,LAL,W 124-122 (OT),265,45,94,.479,34,65,.523,11,29,.379,23,28,.821,124,48,94,.511,40,67,.597,8,27,.296,18,25,.720,122
169,SAS,2018-03-23,124,,UTA,W 124-120 (OT),265,47,92,.511,40,75,.533,7,17,.412,23,27,.852,124,43,88,.489,32,60,.533,11,28,.393,23,29,.793,120
170,CLE,2018-03-19,124,,MIL,W 124-117,240,43,87,.494,28,49,.571,15,38,.395,23,27,.852,124,45,88,.511,37,57,.649,8,31,.258,19,20,.950,117
171,NYK,2018-03-17,124,,CHO,W 124-101,240,49,100,.490,37,74,.500,12,26,.462,14,18,.778,124,33,90,.367,24,57,.421,9,33,.273,26,32,.813,101
172,GSW,2018-03-17,124,@,PHO,W 124-109,240,50,95,.526,37,64,.578,13,31,.419,11,14,.786,124,39,82,.476,28,58,.483,11,24,.458,20,29,.690,109
173,BOS,2018-03-14,124,,WAS,L 124-125 (2OT),290,48,99,.485,36,73,.493,12,26,.462,16,23,.696,124,46,97,.474,34,65,.523,12,32,.375,21,28,.750,125
174,OKC,2018-03-02,124,@,PHO,W 124-116,240,46,96,.479,35,62,.565,11,34,.324,21,29,.724,124,46,96,.479,35,71,.493,11,25,.440,13,18,.722,116
175,LAL,2018-02-23,124,,DAL,W 124-102,240,48,93,.516,35,60,.583,13,33,.394,15,20,.750,124,37,91,.407,18,49,.367,19,42,.452,9,11,.818,102
176,NOP,2018-02-23,124,,MIA,W 124-123 (OT),265,48,108,.444,40,77,.519,8,31,.258,20,24,.833,124,50,108,.463,44,90,.489,6,18,.333,17,26,.654,123
177,OKC,2018-02-01,124,@,DEN,L 124-127,240,51,98,.520,42,70,.600,9,28,.321,13,17,.765,124,50,97,.515,35,59,.593,15,38,.395,12,17,.706,127
178,POR,2018-01-31,124,,CHI,W 124-108,240,46,82,.561,31,50,.620,15,32,.469,17,20,.850,124,41,99,.414,28,65,.431,13,34,.382,13,22,.591,108
179,CLE,2018-01-20,124,,OKC,L 124-148,240,46,89,.517,36,52,.692,10,37,.270,22,27,.815,124,58,100,.580,44,70,.629,14,30,.467,18,28,.643,148
180,GSW,2018-01-08,124,,DEN,W 124-114,240,48,85,.565,35,55,.636,13,30,.433,15,21,.714,124,47,95,.495,39,76,.513,8,19,.421,12,16,.750,114
181,DAL,2018-01-05,124,,CHI,L 124-127,240,49,92,.533,35,60,.583,14,32,.438,12,17,.706,124,44,78,.564,30,50,.600,14,28,.500,25,31,.806,127
182,GSW,2018-01-04,124,@,HOU,W 124-114,240,48,87,.552,35,57,.614,13,30,.433,15,20,.750,124,42,89,.472,25,39,.641,17,50,.340,13,22,.591,114
183,TOR,2018-01-03,124,@,CHI,W 124-115,240,45,92,.489,30,54,.556,15,38,.395,19,19,1.000,124,43,93,.462,30,60,.500,13,33,.394,16,19,.842,115
184,POR,2018-01-01,124,@,CHI,W 124-120 (OT),265,47,108,.435,33,75,.440,14,33,.424,16,18,.889,124,45,104,.433,34,77,.442,11,27,.407,19,23,.826,120
185,OKC,2017-12-27,124,,TOR,W 124-107,240,46,87,.529,37,62,.597,9,25,.360,23,33,.697,124,36,85,.424,25,47,.532,11,38,.289,24,26,.923,107
186,HOU,2017-12-15,124,,SAS,W 124-109,240,43,91,.473,25,41,.610,18,50,.360,20,25,.800,124,46,94,.489,36,68,.529,10,26,.385,7,13,.538,109
187,BOS,2017-12-13,124,,DEN,W 124-118,240,47,79,.595,36,54,.667,11,25,.440,19,24,.792,124,45,91,.495,36,63,.571,9,28,.321,19,26,.731,118
188,PHI,2017-12-10,124,@,NOP,L 124-131,240,44,96,.458,35,67,.522,9,29,.310,27,30,.900,124,46,80,.575,31,56,.554,15,24,.625,24,32,.750,131
189,HOU,2017-12-09,124,@,POR,W 124-117,240,40,75,.533,30,50,.600,10,25,.400,34,42,.810,124,45,88,.511,27,47,.574,18,41,.439,9,12,.750,117
190,WAS,2017-11-22,124,@,CHO,L 124-129 (OT),265,48,99,.485,37,66,.561,11,33,.333,17,22,.773,124,43,91,.473,33,63,.524,10,28,.357,33,40,.825,129
191,MIN,2017-11-22,124,,ORL,W 124-118,240,40,87,.460,32,64,.500,8,23,.348,36,45,.800,124,46,91,.505,34,54,.630,12,37,.324,14,22,.636,118
192,GSW,2017-11-18,124,@,PHI,W 124-116,240,50,91,.549,43,68,.632,7,23,.304,17,20,.850,124,47,97,.485,37,68,.544,10,29,.345,12,16,.750,116
193,CLE,2017-11-07,124,,MIL,W 124-119,240,41,82,.500,32,64,.500,9,18,.500,33,38,.868,124,47,83,.566,34,53,.642,13,30,.433,12,16,.750,119
194,LAL,2017-11-03,124,,BRK,W 124-112,240,48,94,.511,39,73,.534,9,21,.429,19,27,.704,124,37,91,.407,28,53,.528,9,38,.237,29,38,.763,112
195,IND,2017-11-01,124,@,CLE,W 124-107,240,49,90,.544,33,64,.516,16,26,.615,10,13,.769,124,43,86,.500,36,55,.655,7,31,.226,14,20,.700,107
196,DEN,2017-10-29,124,@,BRK,W 124-111,240,47,94,.500,36,74,.486,11,20,.550,19,22,.864,124,39,96,.406,27,65,.415,12,31,.387,21,31,.677,111
197,POR,2017-10-18,124,@,PHO,W 124-76,240,44,90,.489,30,66,.455,14,24,.583,22,28,.786,124,28,89,.315,21,62,.339,7,27,.259,13,18,.722,76
198,MEM,2018-04-11,123,@,OKC,L 123-137,240,44,91,.484,31,60,.517,13,31,.419,22,24,.917,123,47,85,.553,27,42,.643,20,43,.465,23,32,.719,137
199,CLE,2018-04-09,123,@,NYK,W 123-109,240,40,85,.471,21,40,.525,19,45,.422,24,28,.857,123,46,87,.529,35,57,.614,11,30,.367,6,12,.500,109
200,IND,2018-04-08,123,@,CHO,W 123-117,240,50,93,.538,41,68,.603,9,25,.360,14,18,.778,123,40,80,.500,29,50,.580,11,30,.367,26,30,.867,117
201,NOP,2018-04-04,123,,MEM,W 123-95,240,45,86,.523,29,50,.580,16,36,.444,17,19,.895,123,37,93,.398,27,61,.443,10,32,.313,11,15,.733,95
202,PHI,2018-03-26,123,,DEN,W 123-104,240,46,91,.505,33,62,.532,13,29,.448,18,25,.720,123,36,84,.429,25,52,.481,11,32,.344,21,34,.618,104
203,MIN,2018-03-20,123,,LAC,W 123-109,240,45,86,.523,35,61,.574,10,25,.400,23,24,.958,123,40,93,.430,32,69,.464,8,24,.333,21,26,.808,109
204,SAC,2018-03-14,123,,MIA,W 123-119 (OT),265,48,94,.511,40,70,.571,8,24,.333,19,25,.760,123,41,99,.414,23,56,.411,18,43,.419,19,21,.905,119
205,LAC,2018-03-04,123,,BRK,W 123-120,240,44,84,.524,34,57,.596,10,27,.370,25,30,.833,123,40,92,.435,21,47,.447,19,45,.422,21,23,.913,120
206,HOU,2018-03-03,123,,BOS,W 123-120,240,39,87,.448,20,38,.526,19,49,.388,26,30,.867,123,44,91,.484,31,67,.463,13,24,.542,19,21,.905,120
207,BRK,2018-02-27,123,@,CLE,L 123-129,240,44,82,.537,32,50,.640,12,32,.375,23,30,.767,123,50,97,.515,38,73,.521,12,24,.500,17,27,.630,129
208,TOR,2018-02-26,123,,DET,W 123-94,240,42,80,.525,25,42,.595,17,38,.447,22,23,.957,123,36,94,.383,29,72,.403,7,22,.318,15,20,.750,94
209,LAL,2018-02-26,123,@,ATL,W 123-104,240,47,90,.522,32,57,.561,15,33,.455,14,19,.737,123,36,96,.375,28,60,.467,8,36,.222,24,34,.706,104
210,NOP,2018-02-25,123,@,MIL,W 123-121 (OT),265,51,107,.477,41,77,.532,10,30,.333,11,14,.786,123,44,96,.458,37,71,.521,7,25,.280,26,29,.897,121
211,MIA,2018-02-23,123,@,NOP,L 123-124 (OT),265,50,108,.463,44,90,.489,6,18,.333,17,26,.654,123,48,108,.444,40,77,.519,8,31,.258,20,24,.833,124
212,MIL,2018-02-15,123,,DEN,L 123-134,240,49,92,.533,40,66,.606,9,26,.346,16,22,.727,123,47,85,.553,23,45,.511,24,40,.600,16,20,.800,134
213,POR,2018-02-14,123,,GSW,W 123-117,240,45,93,.484,33,60,.550,12,33,.364,21,24,.875,123,43,90,.478,30,53,.566,13,37,.351,18,19,.947,117
214,TOR,2018-02-11,123,@,CHO,W 123-103,240,49,87,.563,31,50,.620,18,37,.486,7,10,.700,123,38,89,.427,28,66,.424,10,23,.435,17,23,.739,103
215,LAL,2018-02-10,123,@,DAL,L 123-130,240,46,84,.548,30,50,.600,16,34,.471,15,22,.682,123,48,89,.539,36,62,.581,12,27,.444,22,27,.815,130
216,DEN,2018-02-10,123,@,PHO,W 123-113,240,45,88,.511,32,59,.542,13,29,.448,20,22,.909,123,46,84,.548,39,65,.600,7,19,.368,14,25,.560,113
217,CLE,2018-02-09,123,@,ATL,W 123-107,240,46,86,.535,31,51,.608,15,35,.429,16,24,.667,123,37,83,.446,21,39,.538,16,44,.364,17,19,.895,107
218,HOU,2018-02-06,123,@,BRK,W 123-113,240,45,81,.556,29,48,.604,16,33,.485,17,21,.810,123,41,85,.482,25,50,.500,16,35,.457,15,17,.882,113
219,CHO,2018-01-31,123,@,ATL,W 123-110,240,46,90,.511,29,58,.500,17,32,.531,14,18,.778,123,39,77,.506,27,45,.600,12,32,.375,20,22,.909,110
220,TOR,2018-01-28,123,,LAL,W 123-111,240,46,92,.500,34,61,.557,12,31,.387,19,25,.760,123,40,91,.440,32,66,.485,8,25,.320,23,33,.697,111
221,POR,2018-01-24,123,,MIN,W 123-114,240,45,82,.549,28,51,.549,17,31,.548,16,21,.762,123,45,84,.536,39,68,.574,6,16,.375,18,22,.818,114
222,GSW,2018-01-23,123,,NYK,W 123-112,240,46,83,.554,33,53,.623,13,30,.433,18,20,.900,123,43,83,.518,34,61,.557,9,22,.409,17,19,.895,112
223,MEM,2018-01-15,123,,LAL,W 123-114,240,42,82,.512,32,60,.533,10,22,.455,29,34,.853,123,38,96,.396,26,61,.426,12,35,.343,26,31,.839,114
224,NOP,2018-01-14,123,@,NYK,W 123-118 (OT),265,45,95,.474,36,63,.571,9,32,.281,24,34,.706,123,46,97,.474,34,63,.540,12,34,.353,14,18,.778,118
225,PHI,2017-12-31,123,@,PHO,W 123-110,240,43,77,.558,33,53,.623,10,24,.417,27,34,.794,123,37,88,.420,27,61,.443,10,27,.370,26,34,.765,110
226,IND,2017-12-23,123,,BRK,W 123-119 (OT),265,47,90,.522,37,67,.552,10,23,.435,19,24,.792,123,42,98,.429,26,62,.419,16,36,.444,19,25,.760,119
227,CLE,2017-12-12,123,,ATL,W 123-114,240,48,86,.558,28,48,.583,20,38,.526,7,10,.700,123,43,92,.467,27,56,.482,16,36,.444,12,13,.923,114
228,NOP,2017-12-11,123,@,HOU,L 123-130,240,49,85,.576,31,52,.596,18,33,.545,7,13,.538,123,48,88,.545,31,43,.721,17,45,.378,17,25,.680,130
229,NOP,2017-12-06,123,,DEN,W 123-114,240,46,86,.535,34,55,.618,12,31,.387,19,29,.655,123,41,94,.436,25,59,.424,16,35,.457,16,22,.727,114
230,GSW,2017-12-03,123,@,MIA,W 123-95,240,47,84,.560,36,54,.667,11,30,.367,18,24,.750,123,33,81,.407,19,44,.432,14,37,.378,15,17,.882,95
231,NOP,2017-12-02,123,@,POR,W 123-116,240,45,86,.523,30,55,.545,15,31,.484,18,25,.720,123,47,105,.448,36,70,.514,11,35,.314,11,11,1.000,116
232,LAL,2017-11-29,123,,GSW,L 123-127 (OT),265,47,95,.495,38,71,.535,9,24,.375,20,25,.800,123,47,94,.500,35,64,.547,12,30,.400,21,28,.750,127
233,CHI,2017-11-17,123,,CHO,W 123-120,240,47,91,.516,30,57,.526,17,34,.500,12,13,.923,123,42,81,.519,32,60,.533,10,21,.476,26,34,.765,120
234,NOP,2017-10-28,123,,CLE,W 123-101,240,49,95,.516,36,62,.581,13,33,.394,12,16,.750,123,36,78,.462,24,46,.522,12,32,.375,17,23,.739,101
235,NOP,2018-04-11,122,,SAS,W 122-98,240,52,88,.591,47,69,.681,5,19,.263,13,19,.684,122,37,92,.402,29,68,.426,8,24,.333,16,19,.842,98
236,NOP,2018-04-06,122,@,PHO,W 122-103,240,45,99,.455,29,61,.475,16,38,.421,16,20,.800,122,37,94,.394,28,61,.459,9,33,.273,20,26,.769,103
237,NYK,2018-04-06,122,,MIA,W 122-98,240,45,89,.506,27,52,.519,18,37,.486,14,21,.667,122,35,88,.398,28,61,.459,7,27,.259,21,22,.955,98
238,LAL,2018-04-04,122,,SAS,W 122-112 (OT),265,47,86,.547,34,62,.548,13,24,.542,15,18,.833,122,42,97,.433,33,74,.446,9,23,.391,19,27,.704,112
239,LAL,2018-03-30,122,,MIL,L 122-124 (OT),265,48,94,.511,40,67,.597,8,27,.296,18,25,.720,122,45,94,.479,34,65,.523,11,29,.379,23,28,.821,124
240,POR,2018-03-18,122,@,LAC,W 122-109,240,46,92,.500,32,63,.508,14,29,.483,16,20,.800,122,40,89,.449,31,66,.470,9,23,.391,20,27,.741,109
241,MIL,2018-03-17,122,,ATL,W 122-117,240,41,86,.477,30,61,.492,11,25,.440,29,32,.906,122,39,85,.459,27,49,.551,12,36,.333,27,28,.964,117
242,TOR,2018-03-16,122,,DAL,W 122-115 (OT),265,43,91,.473,33,61,.541,10,30,.333,26,31,.839,122,48,91,.527,42,69,.609,6,22,.273,13,18,.722,115
243,ATL,2018-03-11,122,,CHI,L 122-129,240,42,82,.512,23,42,.548,19,40,.475,19,22,.864,122,48,98,.490,31,61,.508,17,37,.459,16,19,.842,129
244,CHO,2018-03-10,122,,PHO,W 122-115,240,44,87,.506,31,55,.564,13,32,.406,21,27,.778,122,42,83,.506,24,51,.471,18,32,.563,13,19,.684,115
245,HOU,2018-03-06,122,@,OKC,W 122-112,240,38,72,.528,21,39,.538,17,33,.515,29,34,.853,122,46,93,.495,34,59,.576,12,34,.353,8,11,.727,112
246,LAC,2018-02-27,122,@,DEN,W 122-120,240,46,89,.517,39,63,.619,7,26,.269,23,31,.742,122,43,87,.494,33,56,.589,10,31,.323,24,30,.800,120
247,MIN,2018-02-24,122,,CHI,W 122-104,240,46,94,.489,35,59,.593,11,35,.314,19,26,.731,122,42,90,.467,36,67,.537,6,23,.261,14,20,.700,104
248,MIL,2018-02-23,122,@,TOR,W 122-119 (OT),265,43,90,.478,30,64,.469,13,26,.500,23,27,.852,122,43,90,.478,34,56,.607,9,34,.265,24,26,.923,119
249,DEN,2018-02-23,122,,SAS,W 122-119,240,48,97,.495,36,65,.554,12,32,.375,14,19,.737,122,43,85,.506,38,69,.551,5,16,.313,28,39,.718,119
250,CHO,2018-02-23,122,@,WAS,W 122-105,240,44,90,.489,27,51,.529,17,39,.436,17,20,.850,122,40,81,.494,31,56,.554,9,25,.360,16,17,.941,105
251,TOR,2018-02-14,122,@,CHI,W 122-98,240,48,92,.522,34,54,.630,14,38,.368,12,15,.800,122,39,91,.429,35,67,.522,4,24,.167,16,20,.800,98
252,GSW,2018-02-10,122,,SAS,W 122-105,240,48,85,.565,36,58,.621,12,27,.444,14,15,.933,122,43,94,.457,38,67,.567,5,27,.185,14,19,.737,105
253,WAS,2018-02-01,122,,TOR,W 122-119,240,44,85,.518,34,55,.618,10,30,.333,24,26,.923,122,44,83,.530,32,54,.593,12,29,.414,19,24,.792,119
254,OKC,2018-01-28,122,,PHI,W 122-112,240,45,92,.489,35,59,.593,10,33,.303,22,30,.733,122,38,76,.500,27,47,.574,11,29,.379,25,31,.806,112
255,WAS,2018-01-19,122,@,DET,W 122-112,240,41,82,.500,25,47,.532,16,35,.457,24,27,.889,122,40,80,.500,30,50,.600,10,30,.333,22,26,.846,112
256,CHI,2018-01-10,122,@,NYK,W 122-119 (2OT),290,45,98,.459,30,65,.462,15,33,.455,17,20,.850,122,48,96,.500,38,74,.514,10,22,.455,13,21,.619,119
257,DAL,2018-01-03,122,,GSW,L 122-125,240,43,90,.478,24,47,.511,19,43,.442,17,22,.773,122,48,91,.527,35,59,.593,13,32,.406,16,19,.842,125
258,MIL,2018-01-03,122,,IND,W 122-101,240,44,75,.587,35,58,.603,9,17,.529,25,28,.893,122,41,84,.488,38,69,.551,3,15,.200,16,19,.842,101
259,LAC,2017-12-26,122,,SAC,W 122-95,240,44,81,.543,31,50,.620,13,31,.419,21,27,.778,122,40,96,.417,33,74,.446,7,22,.318,8,12,.667,95
260,LAL,2017-12-20,122,@,HOU,W 122-116,240,40,85,.471,25,50,.500,15,35,.429,27,43,.628,122,37,90,.411,20,48,.417,17,42,.405,25,32,.781,116
261,DAL,2017-12-04,122,,DEN,W 122-105,240,49,86,.570,37,60,.617,12,26,.462,12,17,.706,122,38,91,.418,24,55,.436,14,36,.389,15,23,.652,105
262,PHO,2017-11-17,122,@,LAL,W 122-113,240,48,103,.466,35,71,.493,13,32,.406,13,19,.684,122,45,91,.495,38,66,.576,7,25,.280,16,24,.667,113
263,TOR,2017-11-09,122,,NOP,W 122-118,240,45,98,.459,29,56,.518,16,42,.381,16,23,.696,122,44,82,.537,31,51,.608,13,31,.419,17,25,.680,118
264,WAS,2017-11-03,122,,CLE,L 122-130,240,45,84,.536,34,56,.607,11,28,.393,21,31,.677,122,46,82,.561,34,55,.618,12,27,.444,26,28,.929,130
265,PHO,2017-11-01,122,@,WAS,W 122-116,240,41,83,.494,32,59,.542,9,24,.375,31,38,.816,122,41,92,.446,31,62,.500,10,30,.333,24,30,.800,116
266,PHO,2017-10-31,122,@,BRK,W 122-114,240,45,96,.469,35,74,.473,10,22,.455,22,24,.917,122,42,102,.412,33,71,.465,9,31,.290,21,30,.700,114
267,MIA,2017-10-30,122,,MIN,L 122-125 (OT),265,49,93,.527,42,66,.636,7,27,.259,17,25,.680,122,41,91,.451,30,68,.441,11,23,.478,32,35,.914,125
268,DET,2017-10-25,122,,MIN,W 122-101,240,48,92,.522,33,58,.569,15,34,.441,11,17,.647,122,37,85,.435,28,60,.467,9,25,.360,18,21,.857,101
269,HOU,2017-10-17,122,@,GSW,W 122-121,240,47,97,.485,32,56,.571,15,41,.366,13,19,.684,122,43,80,.538,27,50,.540,16,30,.533,19,21,.905,121
270,PHI,2018-04-10,121,@,ATL,W 121-113,240,43,87,.494,26,50,.520,17,37,.459,18,30,.600,121,41,98,.418,28,61,.459,13,37,.351,18,26,.692,113
271,PHI,2018-04-03,121,,BRK,W 121-95,240,50,91,.549,41,70,.586,9,21,.429,12,18,.667,121,34,81,.420,17,39,.436,17,42,.405,10,23,.435,95
272,UTA,2018-04-01,121,@,MIN,W 121-97,240,46,76,.605,35,48,.729,11,28,.393,18,25,.720,121,38,90,.422,30,66,.455,8,24,.333,13,14,.929,97
273,CLE,2018-03-25,121,@,BRK,W 121-114,240,44,87,.506,32,59,.542,12,28,.429,21,26,.808,121,38,83,.458,21,46,.457,17,37,.459,21,26,.808,114
274,OKC,2018-03-16,121,,LAC,W 121-113,240,46,94,.489,35,62,.565,11,32,.344,18,22,.818,121,42,86,.488,31,60,.517,11,26,.423,18,23,.783,113
275,MIL,2018-03-12,121,@,MEM,W 121-103,240,47,81,.580,35,56,.625,12,25,.480,15,22,.682,121,42,89,.472,33,62,.532,9,27,.333,10,19,.526,103
276,TOR,2018-03-07,121,@,DET,W 121-119 (OT),265,45,101,.446,33,61,.541,12,40,.300,19,21,.905,121,44,90,.489,31,64,.484,13,26,.500,18,23,.783,119
277,NOP,2018-03-06,121,@,LAC,W 121-116,240,46,103,.447,33,73,.452,13,30,.433,16,18,.889,121,46,99,.465,39,72,.542,7,27,.259,17,26,.654,116
278,NOP,2018-02-28,121,@,SAS,W 121-116,240,50,99,.505,41,73,.562,9,26,.346,12,15,.800,121,48,99,.485,39,73,.534,9,26,.346,11,14,.786,116
279,MIL,2018-02-25,121,,NOP,L 121-123 (OT),265,44,96,.458,37,71,.521,7,25,.280,26,29,.897,121,51,107,.477,41,77,.532,10,30,.333,11,14,.786,123
280,BOS,2018-02-24,121,@,NYK,W 121-112,240,42,93,.452,29,60,.483,13,33,.394,24,28,.857,121,45,96,.469,39,69,.565,6,27,.222,16,20,.800,112
281,OKC,2018-02-14,121,@,MEM,W 121-114,240,40,81,.494,23,44,.523,17,37,.459,24,35,.686,121,44,86,.512,30,59,.508,14,27,.519,12,15,.800,114
282,IND,2018-02-11,121,,NYK,W 121-113,240,47,94,.500,35,66,.530,12,28,.429,15,22,.682,121,41,93,.441,32,58,.552,9,35,.257,22,25,.880,113
283,CLE,2018-02-11,121,@,BOS,W 121-99,240,45,84,.536,29,54,.537,16,30,.533,15,20,.750,121,36,89,.404,26,51,.510,10,38,.263,17,22,.773,99
284,GSW,2018-02-08,121,,DAL,W 121-103,240,45,88,.511,31,59,.525,14,29,.483,17,20,.850,121,40,92,.435,31,55,.564,9,37,.243,14,17,.824,103
285,DEN,2018-02-05,121,,CHO,W 121-104,240,46,81,.568,28,47,.596,18,34,.529,11,13,.846,121,39,77,.506,28,51,.549,11,26,.423,15,24,.625,104
286,CLE,2018-01-28,121,,DET,W 121-104,240,42,83,.506,27,48,.563,15,35,.429,22,26,.846,121,40,95,.421,26,59,.441,14,36,.389,10,13,.769,104
287,OKC,2018-01-27,121,@,DET,W 121-108,240,45,93,.484,31,60,.517,14,33,.424,17,23,.739,121,39,84,.464,27,51,.529,12,33,.364,18,24,.750,108
288,CHO,2018-01-26,121,,ATL,W 121-110,240,40,88,.455,27,54,.500,13,34,.382,28,32,.875,121,37,79,.468,22,49,.449,15,30,.500,21,25,.840,110
289,OKC,2018-01-25,121,,WAS,W 121-112,240,45,87,.517,36,60,.600,9,27,.333,22,29,.759,121,42,86,.488,26,51,.510,16,35,.457,12,16,.750,112
290,LAC,2018-01-11,121,@,SAC,W 121-115,240,43,84,.512,30,53,.566,13,31,.419,22,30,.733,121,42,85,.494,34,59,.576,8,26,.308,23,28,.821,115
291,HOU,2018-01-10,121,,POR,W 121-112,240,45,100,.450,33,62,.532,12,38,.316,19,25,.760,121,40,83,.482,31,57,.544,9,26,.346,23,32,.719,112
292,GSW,2018-01-06,121,@,LAC,W 121-105,240,39,94,.415,26,55,.473,13,39,.333,30,37,.811,121,39,91,.429,36,80,.450,3,11,.273,24,30,.800,105
293,WAS,2018-01-03,121,,NYK,W 121-103,240,48,81,.593,39,58,.672,9,23,.391,16,26,.615,121,41,86,.477,34,67,.507,7,19,.368,14,18,.778,103
294,LAC,2017-12-29,121,@,LAL,W 121-106,240,42,86,.488,33,54,.611,9,32,.281,28,34,.824,121,46,94,.489,43,75,.573,3,19,.158,11,16,.688,106
295,WAS,2017-12-29,121,,HOU,W 121-103,240,47,88,.534,29,52,.558,18,36,.500,9,12,.750,121,38,89,.427,24,41,.585,14,48,.292,13,16,.813,103
296,MIN,2017-12-25,121,@,LAL,W 121-104,240,49,84,.583,38,52,.731,11,32,.344,12,14,.857,121,40,92,.435,30,62,.484,10,30,.333,14,20,.700,104
297,CLE,2017-12-14,121,,LAL,W 121-112,240,43,86,.500,28,50,.560,15,36,.417,20,25,.800,121,47,95,.495,38,64,.594,9,31,.290,9,14,.643,112
298,CLE,2017-11-30,121,@,ATL,W 121-114,240,41,79,.519,23,40,.575,18,39,.462,21,27,.778,121,41,79,.519,29,48,.604,12,31,.387,20,24,.833,114
299,ORL,2017-11-29,121,,OKC,W 121-108,240,45,76,.592,32,46,.696,13,30,.433,18,26,.692,121,38,96,.396,26,64,.406,12,32,.375,20,30,.667,108
300,IND,2017-11-27,121,,ORL,W 121-109,240,42,79,.532,27,53,.509,15,26,.577,22,26,.846,121,40,92,.435,24,51,.471,16,41,.390,13,16,.813,109
301,UTA,2017-11-25,121,,MIL,W 121-108,240,46,81,.568,28,49,.571,18,32,.563,11,19,.579,121,41,77,.532,33,56,.589,8,21,.381,18,23,.783,108
302,PHI,2017-11-03,121,,IND,W 121-110,240,46,92,.500,28,56,.500,18,36,.500,11,14,.786,121,45,97,.464,37,69,.536,8,28,.286,12,19,.632,110
303,MIL,2017-11-01,121,@,CHO,L 121-126,240,45,91,.495,26,55,.473,19,36,.528,12,15,.800,121,45,84,.536,31,59,.525,14,25,.560,22,29,.759,126
304,BRK,2017-10-24,121,@,ORL,L 121-125,240,40,96,.417,29,61,.475,11,35,.314,30,34,.882,121,41,83,.494,33,60,.550,8,23,.348,35,40,.875,125
305,ORL,2017-10-20,121,@,BRK,L 121-126,240,45,89,.506,27,56,.482,18,33,.545,13,15,.867,121,46,92,.500,37,65,.569,9,27,.333,25,35,.714,126
306,GSW,2017-10-17,121,,HOU,L 121-122,240,43,80,.538,27,50,.540,16,30,.533,19,21,.905,121,47,97,.485,32,56,.571,15,41,.366,13,19,.684,122
307,GSW,2018-04-07,120,,NOP,L 120-126,240,49,90,.544,34,57,.596,15,33,.455,7,11,.636,120,49,87,.563,38,60,.633,11,27,.407,17,22,.773,126
308,HOU,2018-04-03,120,,WAS,W 120-104,240,43,84,.512,27,38,.711,16,46,.348,18,27,.667,120,38,72,.528,26,47,.553,12,25,.480,16,23,.696,104
309,CHI,2018-04-03,120,,CHO,W 120-114,240,46,99,.465,31,65,.477,15,34,.441,13,18,.722,120,40,81,.494,27,47,.574,13,34,.382,21,28,.750,114
310,PHI,2018-03-24,120,,MIN,W 120-108,240,42,88,.477,29,51,.569,13,37,.351,23,36,.639,120,37,96,.385,31,73,.425,6,23,.261,28,38,.737,108
311,CLE,2018-03-23,120,,PHO,W 120-95,240,47,95,.495,39,66,.591,8,29,.276,18,24,.750,120,38,87,.437,31,59,.525,7,28,.250,12,20,.600,95
312,UTA,2018-03-23,120,@,SAS,L 120-124 (OT),265,43,88,.489,32,60,.533,11,28,.393,23,29,.793,120,47,92,.511,40,75,.533,7,17,.412,23,27,.852,124
313,MIL,2018-03-21,120,,LAC,L 120-127,240,50,91,.549,42,65,.646,8,26,.308,12,17,.706,120,45,86,.523,30,56,.536,15,30,.500,22,29,.759,127
314,MIN,2018-03-18,120,,HOU,L 120-129,240,45,86,.523,35,66,.530,10,20,.500,20,26,.769,120,43,78,.551,27,43,.628,16,35,.457,27,36,.750,129
315,PHI,2018-03-16,120,,BRK,W 120-116,240,43,95,.453,31,68,.456,12,27,.444,22,26,.846,120,40,89,.449,25,59,.424,15,30,.500,21,27,.778,116
316,DEN,2018-03-15,120,,DET,W 120-113,240,43,85,.506,31,57,.544,12,28,.429,22,28,.786,120,44,92,.478,30,65,.462,14,27,.519,11,17,.647,113
317,PHI,2018-03-11,120,@,BRK,W 120-97,240,50,95,.526,41,69,.594,9,26,.346,11,18,.611,120,33,85,.388,23,57,.404,10,28,.357,21,24,.875,97
318,MIL,2018-03-09,120,,NYK,W 120-112,240,41,73,.562,33,55,.600,8,18,.444,30,39,.769,120,47,98,.480,40,70,.571,7,28,.250,11,14,.786,112
319,BRK,2018-03-04,120,@,LAC,L 120-123,240,40,92,.435,21,47,.447,19,45,.422,21,23,.913,120,44,84,.524,34,57,.596,10,27,.370,25,30,.833,123
320,BOS,2018-03-03,120,@,HOU,L 120-123,240,44,91,.484,31,67,.463,13,24,.542,19,21,.905,120,39,87,.448,20,38,.526,19,49,.388,26,30,.867,123
321,DEN,2018-02-27,120,,LAC,L 120-122,240,43,87,.494,33,56,.589,10,31,.323,24,30,.800,120,46,89,.517,39,63,.619,7,26,.269,23,31,.742,122
322,HOU,2018-02-23,120,,MIN,W 120-102,240,40,83,.482,26,45,.578,14,38,.368,26,30,.867,120,40,94,.426,30,68,.441,10,26,.385,12,16,.750,102
323,NYK,2018-02-22,120,@,ORL,W 120-113,240,48,99,.485,41,74,.554,7,25,.280,17,21,.810,120,43,83,.518,32,59,.542,11,24,.458,16,23,.696,113
324,CLE,2018-02-13,120,@,OKC,W 120-112,240,45,88,.511,29,52,.558,16,36,.444,14,22,.636,120,40,90,.444,29,55,.527,11,35,.314,21,30,.700,112
325,HOU,2018-02-03,120,@,CLE,W 120-88,240,44,93,.473,25,42,.595,19,51,.373,13,16,.813,120,34,87,.391,26,57,.456,8,30,.267,12,16,.750,88
326,UTA,2018-02-03,120,@,SAS,W 120-111,240,39,69,.565,27,46,.587,12,23,.522,30,36,.833,120,44,91,.484,34,65,.523,10,26,.385,13,18,.722,111
327,MEM,2018-01-29,120,,PHO,W 120-109,240,47,83,.566,36,61,.590,11,22,.500,15,18,.833,120,38,82,.463,31,59,.525,7,23,.304,26,36,.722,109
328,UTA,2018-01-17,120,@,SAC,W 120-105,240,46,81,.568,34,52,.654,12,29,.414,16,20,.800,120,38,72,.528,25,51,.490,13,21,.619,16,20,.800,105
329,IND,2018-01-14,120,@,PHO,W 120-97,240,48,88,.545,37,65,.569,11,23,.478,13,14,.929,120,35,85,.412,26,48,.542,9,37,.243,18,24,.750,97
330,MIN,2018-01-14,120,,POR,W 120-103,240,43,80,.538,36,61,.590,7,19,.368,27,33,.818,120,39,79,.494,28,54,.519,11,25,.440,14,17,.824,103
331,CHI,2018-01-01,120,,POR,L 120-124 (OT),265,45,104,.433,34,77,.442,11,27,.407,19,23,.826,120,47,108,.435,33,75,.440,14,33,.424,16,18,.889,124
332,NOP,2017-12-29,120,,DAL,L 120-128,240,42,85,.494,34,54,.630,8,31,.258,28,32,.875,120,46,83,.554,24,44,.545,22,39,.564,14,18,.778,128
333,OKC,2017-12-22,120,,ATL,W 120-117,240,44,82,.537,31,57,.544,13,25,.520,19,31,.613,120,44,85,.518,29,53,.547,15,32,.469,14,17,.824,117
334,HOU,2017-12-18,120,,UTA,W 120-99,240,40,77,.519,23,34,.676,17,43,.395,23,27,.852,120,42,91,.462,34,64,.531,8,27,.296,7,8,.875,99
335,TOR,2017-12-15,120,,BRK,W 120-87,240,54,97,.557,47,69,.681,7,28,.250,5,9,.556,120,32,76,.421,25,53,.472,7,23,.304,16,19,.842,87
336,TOR,2017-12-01,120,,IND,W 120-115,240,48,97,.495,38,65,.585,10,32,.313,14,21,.667,120,45,102,.441,37,76,.487,8,26,.308,17,22,.773,115
337,MIN,2017-11-29,120,@,NOP,W 120-102,240,47,81,.580,38,58,.655,9,23,.391,17,19,.895,120,39,84,.464,25,49,.510,14,35,.400,10,11,.909,102
338,LAC,2017-11-27,120,,LAL,W 120-115,240,41,85,.482,31,57,.544,10,28,.357,28,30,.933,120,44,91,.484,33,61,.541,11,30,.367,16,24,.667,115
339,IND,2017-11-19,120,@,MIA,W 120-95,240,51,85,.600,40,62,.645,11,23,.478,7,8,.875,120,35,83,.422,22,46,.478,13,37,.351,12,14,.857,95
340,CHO,2017-11-17,120,@,CHI,L 120-123,240,42,81,.519,32,60,.533,10,21,.476,26,34,.765,120,47,91,.516,30,57,.526,17,34,.500,12,13,.923,123
341,OKC,2017-11-10,120,,LAC,W 120-111,240,40,78,.513,29,52,.558,11,26,.423,29,40,.725,120,39,84,.464,27,54,.500,12,30,.400,21,30,.700,111
342,SAS,2017-11-07,120,,LAC,W 120-107,240,45,84,.536,30,56,.536,15,28,.536,15,19,.789,120,42,82,.512,31,52,.596,11,30,.367,12,17,.706,107
343,NYK,2017-11-03,120,,PHO,W 120-107,240,45,87,.517,37,61,.607,8,26,.308,22,25,.880,120,34,97,.351,25,65,.385,9,32,.281,30,37,.811,107
344,CHO,2017-10-29,120,,ORL,W 120-113,240,53,97,.546,47,79,.595,6,18,.333,8,17,.471,120,41,97,.423,30,64,.469,11,33,.333,20,26,.769,113
345,GSW,2017-10-27,120,,WAS,W 120-117,240,46,95,.484,36,57,.632,10,38,.263,18,20,.900,120,43,97,.443,28,64,.438,15,33,.455,16,22,.727,117
346,NOP,2017-10-20,120,,GSW,L 120-128,240,45,98,.459,29,62,.468,16,36,.444,14,22,.636,120,47,92,.511,29,51,.569,18,41,.439,16,20,.800,128
347,WAS,2017-10-18,120,,PHI,W 120-115,240,42,97,.433,36,75,.480,6,22,.273,30,38,.789,120,43,93,.462,28,58,.483,15,35,.429,14,19,.737,115
348,DET,2018-04-11,119,@,CHI,W 119-87,240,47,89,.528,32,54,.593,15,35,.429,10,10,1.000,119,32,86,.372,21,52,.404,11,34,.324,12,18,.667,87
349,UTA,2018-04-10,119,,GSW,W 119-79,240,48,90,.533,35,55,.636,13,35,.371,10,13,.769,119,30,86,.349,25,67,.373,5,19,.263,14,16,.875,79
350,CHO,2018-04-10,119,@,IND,W 119-93,240,46,99,.465,28,57,.491,18,42,.429,9,12,.750,119,40,99,.404,32,68,.471,8,31,.258,5,8,.625,93
351,BRK,2018-04-05,119,@,MIL,W 119-111,240,41,75,.547,22,36,.611,19,39,.487,18,21,.857,119,41,93,.441,36,73,.493,5,20,.250,24,30,.800,111
352,CLE,2018-04-05,119,,WAS,W 119-115,240,42,77,.545,29,50,.580,13,27,.481,22,28,.786,119,47,94,.500,38,73,.521,9,21,.429,12,14,.857,115
353,PHI,2018-04-01,119,@,CHO,W 119-102,240,48,94,.511,34,62,.548,14,32,.438,9,10,.900,119,33,82,.402,24,52,.462,9,30,.300,27,34,.794,102
354,UTA,2018-03-22,119,@,DAL,W 119-112,240,46,87,.529,34,58,.586,12,29,.414,15,16,.938,119,42,85,.494,25,53,.472,17,32,.531,11,14,.786,112
355,MIA,2018-03-21,119,,NYK,W 119-98,240,45,81,.556,30,47,.638,15,34,.441,14,19,.737,119,39,89,.438,29,58,.500,10,31,.323,10,12,.833,98
356,PHI,2018-03-21,119,,MEM,W 119-105,240,46,84,.548,35,53,.660,11,31,.355,16,20,.800,119,40,99,.404,31,72,.431,9,27,.333,16,20,.800,105
357,MIA,2018-03-14,119,@,SAC,L 119-123 (OT),265,41,99,.414,23,56,.411,18,43,.419,19,21,.905,119,48,94,.511,40,70,.571,8,24,.333,19,25,.760,123
358,NOP,2018-03-13,119,,CHO,W 119-115,240,52,104,.500,43,82,.524,9,22,.409,6,8,.750,119,45,93,.484,38,67,.567,7,26,.269,18,22,.818,115
359,OKC,2018-03-13,119,@,ATL,W 119-107,240,42,89,.472,26,54,.481,16,35,.457,19,25,.760,119,37,87,.425,24,56,.429,13,31,.419,20,24,.833,107
360,DET,2018-03-07,119,,TOR,L 119-121 (OT),265,44,90,.489,31,64,.484,13,26,.500,18,23,.783,119,45,101,.446,33,61,.541,12,40,.300,19,21,.905,121
361,CHI,2018-03-07,119,,MEM,W 119-110,240,42,79,.532,31,50,.620,11,29,.379,24,32,.750,119,40,82,.488,30,53,.566,10,29,.345,20,25,.800,110
362,HOU,2018-02-25,119,@,DEN,W 119-114,240,39,77,.506,24,42,.571,15,35,.429,26,32,.813,119,44,91,.484,34,62,.548,10,29,.345,16,24,.667,114
363,SAS,2018-02-23,119,@,DEN,L 119-122,240,43,85,.506,38,69,.551,5,16,.313,28,39,.718,119,48,97,.495,36,65,.554,12,32,.375,14,19,.737,122
364,TOR,2018-02-23,119,,MIL,L 119-122 (OT),265,43,90,.478,34,56,.607,9,34,.265,24,26,.923,119,43,90,.478,30,64,.469,13,26,.500,23,27,.852,122
365,MIN,2018-02-15,119,,LAL,W 119-111,240,42,90,.467,36,66,.545,6,24,.250,29,31,.935,119,43,94,.457,36,63,.571,7,31,.226,18,26,.692,111
366,BOS,2018-02-14,119,,LAC,L 119-129,240,42,97,.433,27,66,.409,15,31,.484,20,21,.952,119,44,88,.500,33,59,.559,11,29,.379,30,33,.909,129
367,GSW,2018-02-02,119,@,SAC,W 119-104,240,44,80,.550,27,47,.574,17,33,.515,14,16,.875,119,42,95,.442,32,70,.457,10,25,.400,10,15,.667,104
368,BOS,2018-02-02,119,,ATL,W 119-110,240,45,89,.506,34,65,.523,11,24,.458,18,20,.900,119,34,80,.425,23,49,.469,11,31,.355,31,34,.912,110
369,TOR,2018-02-01,119,@,WAS,L 119-122,240,44,83,.530,32,54,.593,12,29,.414,19,24,.792,119,44,85,.518,34,55,.618,10,30,.333,24,26,.923,122
370,GSW,2018-01-17,119,@,CHI,W 119-112,240,42,84,.500,29,51,.569,13,33,.394,22,25,.880,119,45,106,.425,35,67,.522,10,39,.256,12,13,.923,112
371,NYK,2018-01-15,119,@,BRK,W 119-104,240,42,82,.512,33,66,.500,9,16,.563,26,37,.703,119,32,87,.368,21,55,.382,11,32,.344,29,36,.806,104
372,CHI,2018-01-15,119,,MIA,W 119-111,240,42,88,.477,26,49,.531,16,39,.410,19,22,.864,119,40,84,.476,28,48,.583,12,36,.333,19,24,.792,111
373,WAS,2018-01-13,119,,BRK,W 119-113 (OT),265,46,93,.495,36,70,.514,10,23,.435,17,23,.739,119,42,99,.424,30,56,.536,12,43,.279,17,20,.850,113
374,NOP,2018-01-12,119,,POR,W 119-113,240,45,82,.549,38,63,.603,7,19,.368,22,23,.957,119,45,101,.446,33,59,.559,12,42,.286,11,14,.786,113
375,ORL,2018-01-12,119,@,WAS,L 119-125,240,41,80,.513,29,51,.569,12,29,.414,25,31,.806,119,54,95,.568,50,79,.633,4,16,.250,13,19,.684,125
376,NYK,2018-01-10,119,,CHI,L 119-122 (2OT),290,48,96,.500,38,74,.514,10,22,.455,13,21,.619,119,45,98,.459,30,65,.462,15,33,.455,17,20,.850,122
377,CHI,2017-12-29,119,,IND,W 119-107,240,43,85,.506,25,46,.543,18,39,.462,15,15,1.000,119,43,93,.462,36,71,.507,7,22,.318,14,20,.700,107
378,SAS,2017-12-28,119,,NYK,W 119-107,240,41,80,.513,32,60,.533,9,20,.450,28,39,.718,119,41,90,.456,36,76,.474,5,14,.357,20,22,.909,107
379,BRK,2017-12-23,119,@,IND,L 119-123 (OT),265,42,98,.429,26,62,.419,16,36,.444,19,25,.760,119,47,90,.522,37,67,.552,10,23,.435,19,24,.792,123
380,BRK,2017-12-22,119,,WAS,W 119-84,240,44,88,.500,30,47,.638,14,41,.341,17,21,.810,119,34,93,.366,29,73,.397,5,20,.250,11,15,.733,84
381,MIL,2017-12-19,119,,CLE,W 119-116,240,43,82,.524,32,53,.604,11,29,.379,22,27,.815,119,40,80,.500,24,39,.615,16,41,.390,20,24,.833,116
382,OKC,2017-12-15,119,@,PHI,W 119-117 (3OT),315,47,113,.416,32,78,.410,15,35,.429,10,19,.526,119,44,100,.440,31,54,.574,13,46,.283,16,20,.800,117
383,MIN,2017-12-14,119,,SAC,W 119-96,240,46,82,.561,36,61,.590,10,21,.476,17,20,.850,119,36,87,.414,22,54,.407,14,33,.424,10,12,.833,96
384,CHI,2017-12-08,119,@,CHO,W 119-111 (OT),265,48,99,.485,42,81,.519,6,18,.333,17,22,.773,119,40,100,.400,30,71,.423,10,29,.345,21,29,.724,111
385,MIN,2017-11-26,119,,PHO,W 119-108,240,49,93,.527,40,72,.556,9,21,.429,12,17,.706,119,43,85,.506,30,59,.508,13,26,.500,9,12,.750,108
386,CLE,2017-11-22,119,,BRK,W 119-109,240,43,82,.524,29,48,.604,14,34,.412,19,27,.704,119,42,81,.519,28,44,.636,14,37,.378,11,16,.688,109
387,TOR,2017-11-07,119,,CHI,W 119-114,240,44,81,.543,31,56,.554,13,25,.520,18,24,.750,119,40,80,.500,29,51,.569,11,29,.379,23,28,.821,114
388,MIL,2017-11-07,119,@,CLE,L 119-124,240,47,83,.566,34,53,.642,13,30,.433,12,16,.750,119,41,82,.500,32,64,.500,9,18,.500,33,38,.868,124
389,HOU,2017-11-03,119,@,ATL,W 119-104,240,42,89,.472,26,42,.619,16,47,.340,19,23,.826,119,39,81,.481,28,48,.583,11,33,.333,15,18,.833,104
390,PHI,2017-11-01,119,,ATL,W 119-109,240,46,99,.465,33,64,.516,13,35,.371,14,25,.560,119,41,94,.436,33,71,.465,8,23,.348,19,27,.704,109
391,HOU,2017-11-01,119,@,NYK,W 119-97,240,42,88,.477,23,36,.639,19,52,.365,16,21,.762,119,39,90,.433,31,64,.484,8,26,.308,11,13,.846,97
392,LAC,2017-11-01,119,,DAL,W 119-98,240,41,78,.526,28,50,.560,13,28,.464,24,29,.828,119,35,89,.393,23,53,.434,12,36,.333,16,20,.800,98
393,MIN,2017-10-27,119,,OKC,W 119-116,240,42,86,.488,34,64,.531,8,22,.364,27,35,.771,119,43,86,.500,35,58,.603,8,28,.286,22,25,.880,116
394,CLE,2017-10-24,119,,CHI,W 119-112,240,43,83,.518,27,45,.600,16,38,.421,17,22,.773,119,42,88,.477,25,55,.455,17,33,.515,11,13,.846,112
395,NOP,2017-10-22,119,@,LAL,W 119-112,240,47,83,.566,37,51,.725,10,32,.313,15,21,.714,119,44,90,.489,35,63,.556,9,27,.333,15,20,.750,112
396,PHI,2018-03-28,118,,NYK,W 118-101,240,45,98,.459,36,67,.537,9,31,.290,19,27,.704,118,36,94,.383,27,63,.429,9,31,.290,20,26,.769,101
397,CLE,2018-03-28,118,@,CHO,W 118-105,240,45,93,.484,34,65,.523,11,28,.393,17,20,.850,118,39,76,.513,34,55,.618,5,21,.238,22,24,.917,105
398,HOU,2018-03-27,118,,CHI,W 118-86,240,41,93,.441,23,36,.639,18,57,.316,18,21,.857,118,34,89,.382,26,52,.500,8,37,.216,10,17,.588,86
399,HOU,2018-03-25,118,,ATL,W 118-99,240,44,90,.489,24,38,.632,20,52,.385,10,11,.909,118,39,88,.443,28,48,.583,11,40,.275,10,11,.909,99
400,MIL,2018-03-23,118,@,CHI,W 118-105,240,43,87,.494,28,57,.491,15,30,.500,17,19,.895,118,36,87,.414,24,61,.393,12,26,.462,21,23,.913,105
401,PHI,2018-03-22,118,@,ORL,W 118-98,240,42,89,.472,27,52,.519,15,37,.405,19,24,.792,118,37,91,.407,27,58,.466,10,33,.303,14,22,.636,98
402,BRK,2018-03-19,118,,MEM,W 118-115,240,36,72,.500,20,32,.625,16,40,.400,30,40,.750,118,46,88,.523,36,65,.554,10,23,.435,13,20,.650,115
403,PHI,2018-03-15,118,@,NYK,W 118-110,240,41,91,.451,26,54,.481,15,37,.405,21,34,.618,118,45,87,.517,40,67,.597,5,20,.250,15,24,.625,110
404,DAL,2018-03-06,118,,DEN,W 118-107,240,43,90,.478,28,63,.444,15,27,.556,17,23,.739,118,38,92,.413,27,56,.482,11,36,.306,20,26,.769,107
405,MIL,2018-03-04,118,,PHI,W 118-110,240,47,95,.495,37,72,.514,10,23,.435,14,22,.636,118,39,70,.557,25,42,.595,14,28,.500,18,22,.818,110
406,CHO,2018-02-27,118,,CHI,W 118-103,240,44,82,.537,29,47,.617,15,35,.429,15,21,.714,118,39,81,.481,30,57,.526,9,24,.375,16,21,.762,103
407,MIN,2018-02-26,118,@,SAC,W 118-100,240,39,76,.513,32,60,.533,7,16,.438,33,36,.917,118,40,84,.476,32,62,.516,8,22,.364,12,13,.923,100
408,WAS,2018-02-14,118,@,NYK,W 118-113,240,48,88,.545,41,66,.621,7,22,.318,15,19,.789,118,45,97,.464,36,78,.462,9,19,.474,14,18,.778,113
409,NOP,2018-02-12,118,@,DET,W 118-103,240,44,100,.440,30,66,.455,14,34,.412,16,16,1.000,118,35,95,.368,26,60,.433,9,35,.257,24,32,.750,103
410,ATL,2018-02-11,118,,DET,W 118-115,240,38,78,.487,28,49,.571,10,29,.345,32,37,.865,118,38,83,.458,25,50,.500,13,33,.394,26,33,.788,115
411,POR,2018-02-09,118,@,SAC,W 118-100,240,43,88,.489,28,53,.528,15,35,.429,17,18,.944,118,38,90,.422,29,67,.433,9,23,.391,15,21,.714,100
412,MIN,2018-02-03,118,,NOP,W 118-107,240,48,95,.505,38,74,.514,10,21,.476,12,16,.750,118,42,101,.416,34,68,.500,8,33,.242,15,17,.882,107
413,NYK,2018-01-25,118,@,DEN,L 118-130,240,45,82,.549,37,61,.607,8,21,.381,20,24,.833,118,48,80,.600,34,52,.654,14,28,.500,20,24,.833,130
414,LAC,2018-01-22,118,,MIN,L 118-126,240,47,84,.560,38,57,.667,9,27,.333,15,22,.682,118,43,91,.473,36,69,.522,7,22,.318,33,39,.846,126
415,POR,2018-01-16,118,,PHO,W 118-111,240,46,91,.505,29,56,.518,17,35,.486,9,10,.900,118,37,89,.416,21,48,.438,16,41,.390,21,22,.955,111
416,CHO,2018-01-15,118,@,DET,W 118-107,240,43,84,.512,33,63,.524,10,21,.476,22,33,.667,118,42,86,.488,27,57,.474,15,29,.517,8,11,.727,107
417,GSW,2018-01-15,118,@,CLE,W 118-108,240,41,85,.482,29,53,.547,12,32,.375,24,30,.800,118,43,94,.457,36,66,.545,7,28,.250,15,22,.682,108
418,NYK,2018-01-14,118,,NOP,L 118-123 (OT),265,46,97,.474,34,63,.540,12,34,.353,14,18,.778,118,45,95,.474,36,63,.571,9,32,.281,24,34,.706,123
419,MIN,2018-01-12,118,,NYK,W 118-108,240,49,95,.516,39,68,.574,10,27,.370,10,16,.625,118,45,83,.542,33,59,.559,12,24,.500,6,9,.667,108
420,HOU,2017-12-22,118,,LAC,L 118-128,240,36,78,.462,19,38,.500,17,40,.425,29,35,.829,118,43,91,.473,25,49,.510,18,42,.429,24,31,.774,128
421,DEN,2017-12-13,118,@,BOS,L 118-124,240,45,91,.495,36,63,.571,9,28,.321,19,26,.731,118,47,79,.595,36,54,.667,11,25,.440,19,24,.792,124
422,PHI,2017-12-12,118,@,MIN,W 118-112 (OT),265,40,80,.500,29,54,.537,11,26,.423,27,32,.844,118,44,108,.407,39,79,.494,5,29,.172,19,27,.704,112
423,HOU,2017-12-03,118,@,LAL,W 118-95,240,45,90,.500,31,53,.585,14,37,.378,14,17,.824,118,32,84,.381,23,56,.411,9,28,.321,22,30,.733,95
424,PHI,2017-11-29,118,,WAS,W 118-113,240,37,81,.457,34,63,.540,3,18,.167,41,64,.641,118,36,89,.404,27,67,.403,9,22,.409,32,37,.865,113
425,HOU,2017-11-29,118,,IND,W 118-97,240,42,86,.488,24,46,.522,18,40,.450,16,21,.762,118,42,88,.477,35,60,.583,7,28,.250,6,6,1.000,97
426,DET,2017-11-27,118,@,BOS,W 118-108,240,44,85,.518,33,60,.550,11,25,.440,19,23,.826,118,40,77,.519,24,44,.545,16,33,.485,12,21,.571,108
427,BOS,2017-11-24,118,,ORL,W 118-103,240,42,91,.462,25,49,.510,17,42,.405,17,25,.680,118,41,95,.432,32,71,.451,9,24,.375,12,19,.632,103
428,ORL,2017-11-22,118,@,MIN,L 118-124,240,46,91,.505,34,54,.630,12,37,.324,14,22,.636,118,40,87,.460,32,64,.500,8,23,.348,36,45,.800,124
429,CHO,2017-11-20,118,,MIN,W 118-102,240,42,85,.494,31,59,.525,11,26,.423,23,29,.793,118,37,90,.411,31,63,.492,6,27,.222,22,26,.846,102
430,GSW,2017-11-19,118,@,BRK,W 118-111,240,46,90,.511,36,66,.545,10,24,.417,16,23,.696,118,34,95,.358,18,47,.383,16,48,.333,27,39,.692,111
431,CLE,2017-11-17,118,,LAC,W 118-113 (OT),265,42,90,.467,31,57,.544,11,33,.333,23,29,.793,118,46,103,.447,36,68,.529,10,35,.286,11,14,.786,113
432,BRK,2017-11-17,118,,UTA,W 118-107,240,43,84,.512,26,47,.553,17,37,.459,15,20,.750,118,39,79,.494,27,53,.509,12,26,.462,17,24,.708,107
433,HOU,2017-11-12,118,@,IND,W 118-95,240,43,90,.478,26,43,.605,17,47,.362,15,18,.833,118,37,83,.446,29,61,.475,8,22,.364,13,21,.619,95
434,PHO,2017-11-11,118,,MIN,W 118-110,240,46,86,.535,36,60,.600,10,26,.385,16,24,.667,118,39,96,.406,35,76,.461,4,20,.200,28,35,.800,110
435,NYK,2017-11-11,118,,SAC,W 118-91,240,47,90,.522,35,63,.556,12,27,.444,12,15,.800,118,30,80,.375,23,58,.397,7,22,.318,24,30,.800,91
436,NOP,2017-11-09,118,@,TOR,L 118-122,240,44,82,.537,31,51,.608,13,31,.419,17,25,.680,118,45,98,.459,29,56,.518,16,42,.381,16,23,.696,122
437,NYK,2017-11-07,118,,CHO,W 118-113,240,45,75,.600,33,50,.660,12,25,.480,16,21,.762,118,42,91,.462,27,54,.500,15,37,.405,14,17,.824,113
438,CHO,2018-04-08,117,,IND,L 117-123,240,40,80,.500,29,50,.580,11,30,.367,26,30,.867,117,50,93,.538,41,68,.603,9,25,.360,14,18,.778,123
439,DET,2018-04-08,117,@,MEM,L 117-130,240,38,93,.409,15,46,.326,23,47,.489,18,23,.783,117,48,83,.578,32,50,.640,16,33,.485,18,24,.750,130
440,GSW,2018-04-08,117,@,PHO,W 117-100,240,47,90,.522,34,58,.586,13,32,.406,10,15,.667,117,39,92,.424,29,57,.509,10,35,.286,12,16,.750,100
441,UTA,2018-04-05,117,,LAC,W 117-95,240,44,83,.530,34,56,.607,10,27,.370,19,28,.679,117,35,79,.443,32,62,.516,3,17,.176,22,28,.786,95
442,UTA,2018-04-03,117,,LAL,W 117-110,240,43,89,.483,29,56,.518,14,33,.424,17,27,.630,117,36,74,.486,22,46,.478,14,28,.500,24,36,.667,110
443,GSW,2018-04-01,117,,PHO,W 117-107,240,48,89,.539,35,61,.574,13,28,.464,8,9,.889,117,41,90,.456,30,59,.508,11,31,.355,14,16,.875,107
444,LAC,2018-03-25,117,@,TOR,W 117-106,240,44,95,.463,36,77,.468,8,18,.444,21,27,.778,117,41,92,.446,25,56,.446,16,36,.444,8,14,.571,106
445,DET,2018-03-24,117,,CHI,W 117-95,240,43,87,.494,27,45,.600,16,42,.381,15,18,.833,117,39,97,.402,28,62,.452,11,35,.314,6,9,.667,95
446,MIL,2018-03-19,117,@,CLE,L 117-124,240,45,88,.511,37,57,.649,8,31,.258,19,20,.950,117,43,87,.494,28,49,.571,15,38,.395,23,27,.852,124
447,SAS,2018-03-17,117,,MIN,W 117-101,240,49,96,.510,43,70,.614,6,26,.231,13,14,.929,117,39,81,.481,32,69,.464,7,12,.583,16,20,.800,101
448,ATL,2018-03-17,117,@,MIL,L 117-122,240,39,85,.459,27,49,.551,12,36,.333,27,28,.964,117,41,86,.477,30,61,.492,11,25,.440,29,32,.906,122
449,ATL,2018-03-15,117,,CHO,L 117-129,240,42,90,.467,26,54,.481,16,36,.444,17,26,.654,117,46,87,.529,29,54,.537,17,33,.515,20,30,.667,129
450,MIL,2018-03-14,117,@,ORL,L 117-126,240,49,98,.500,39,74,.527,10,24,.417,9,12,.750,117,44,87,.506,26,53,.491,18,34,.529,20,23,.870,126
451,GSW,2018-03-14,117,,LAL,W 117-106,240,44,81,.543,38,61,.623,6,20,.300,23,28,.821,117,38,84,.452,26,46,.565,12,38,.316,18,28,.643,106
452,BOS,2018-03-08,117,@,MIN,W 117-109,240,43,87,.494,32,55,.582,11,32,.344,20,27,.741,117,44,94,.468,32,63,.508,12,31,.387,9,13,.692,109
453,WAS,2018-03-06,117,,MIA,W 117-113 (OT),265,40,80,.500,26,56,.464,14,24,.583,23,27,.852,117,42,94,.447,33,61,.541,9,33,.273,20,27,.741,113
454,CLE,2018-03-03,117,,DEN,L 117-126,240,46,88,.523,37,64,.578,9,24,.375,16,21,.762,117,47,86,.547,28,51,.549,19,35,.543,13,15,.867,126
455,TOR,2018-02-28,117,@,ORL,W 117-104,240,45,83,.542,33,53,.623,12,30,.400,15,24,.625,117,39,82,.476,26,52,.500,13,30,.433,13,23,.565,104
456,PHO,2018-02-23,117,,LAC,L 117-128,240,45,103,.437,36,72,.500,9,31,.290,18,31,.581,117,45,87,.517,31,55,.564,14,32,.438,24,32,.750,128
457,LAL,2018-02-14,117,@,NOP,L 117-139,240,46,90,.511,36,68,.529,10,22,.455,15,18,.833,117,53,99,.535,39,67,.582,14,32,.438,19,21,.905,139
458,GSW,2018-02-14,117,@,POR,L 117-123,240,43,90,.478,30,53,.566,13,37,.351,18,19,.947,117,45,93,.484,33,60,.550,12,33,.364,21,24,.875,123
459,DEN,2018-02-13,117,,SAS,W 117-109,240,46,93,.495,36,61,.590,10,32,.313,15,18,.833,117,44,82,.537,38,60,.633,6,22,.273,15,22,.682,109
460,POR,2018-01-20,117,,DAL,W 117-108,240,45,86,.523,27,50,.540,18,36,.500,9,10,.900,117,38,83,.458,28,58,.483,10,25,.400,22,28,.786,108
461,NYK,2018-01-19,117,@,UTA,W 117-115,240,44,89,.494,33,69,.478,11,20,.550,18,23,.783,117,42,91,.462,31,60,.517,11,31,.355,20,30,.667,115
462,PHI,2018-01-15,117,,TOR,W 117-111,240,40,81,.494,34,56,.607,6,25,.240,31,38,.816,117,38,95,.400,29,63,.460,9,32,.281,26,30,.867,111
463,POR,2018-01-09,117,@,OKC,W 117-106,240,43,81,.531,33,58,.569,10,23,.435,21,26,.808,117,37,84,.440,24,53,.453,13,31,.419,19,26,.731,106
464,LAC,2018-01-04,117,,OKC,L 117-127,240,45,100,.450,36,70,.514,9,30,.300,18,23,.783,117,51,95,.537,36,61,.590,15,34,.441,10,14,.714,127
465,MIA,2017-12-30,117,@,ORL,W 117-111,240,45,88,.511,33,64,.516,12,24,.500,15,18,.833,117,44,81,.543,32,54,.593,12,27,.444,11,15,.733,111
466,BOS,2017-12-23,117,,CHI,W 117-92,240,44,92,.478,32,60,.533,12,32,.375,17,21,.810,117,34,86,.395,27,67,.403,7,19,.368,17,25,.680,92
467,ATL,2017-12-22,117,@,OKC,L 117-120,240,44,85,.518,29,53,.547,15,32,.469,14,17,.824,117,44,82,.537,31,57,.544,13,25,.520,19,31,.613,120
468,CHI,2017-12-18,117,,PHI,W 117-115,240,44,92,.478,31,64,.484,13,28,.464,16,19,.842,117,44,91,.484,30,58,.517,14,33,.424,13,18,.722,115
469,PHI,2017-12-15,117,,OKC,L 117-119 (3OT),315,44,100,.440,31,54,.574,13,46,.283,16,20,.800,117,47,113,.416,32,78,.410,15,35,.429,10,19,.526,119
470,DEN,2017-12-15,117,,NOP,W 117-111 (OT),265,46,100,.460,30,64,.469,16,36,.444,9,14,.643,117,43,91,.473,28,57,.491,15,34,.441,10,14,.714,111
471,POR,2017-12-09,117,,HOU,L 117-124,240,45,88,.511,27,47,.574,18,41,.439,9,12,.750,117,40,75,.533,30,50,.600,10,25,.400,34,42,.810,124
472,MIL,2017-12-09,117,,UTA,W 117-100,240,44,81,.543,37,64,.578,7,17,.412,22,26,.846,117,33,76,.434,25,53,.472,8,23,.348,26,37,.703,100
473,ATL,2017-12-09,117,,ORL,W 117-110,240,41,80,.513,24,47,.511,17,33,.515,18,25,.720,117,45,92,.489,32,58,.552,13,34,.382,7,8,.875,110
474,SAS,2017-12-06,117,,MIA,W 117-105,240,46,87,.529,33,62,.532,13,25,.520,12,14,.857,117,39,72,.542,21,38,.553,18,34,.529,9,12,.750,105
475,HOU,2017-11-27,117,,BRK,W 117-103,240,42,86,.488,22,36,.611,20,50,.400,13,20,.650,117,40,86,.465,30,47,.638,10,39,.256,13,17,.765,103
476,HOU,2017-11-25,117,,NYK,W 117-102,240,41,94,.436,23,47,.489,18,47,.383,17,22,.773,117,42,85,.494,38,68,.559,4,17,.235,14,19,.737,102
477,HOU,2017-11-09,117,,CLE,W 117-113,240,36,77,.468,20,31,.645,16,46,.348,29,36,.806,117,45,81,.556,33,54,.611,12,27,.444,11,14,.786,113
478,NOP,2017-11-07,117,@,IND,W 117-112,240,44,87,.506,30,52,.577,14,35,.400,15,22,.682,117,44,93,.473,35,69,.507,9,24,.375,15,18,.833,112
479,ATL,2017-11-05,117,@,CLE,W 117-115,240,41,86,.477,30,61,.492,11,25,.440,24,34,.706,117,42,96,.438,32,60,.533,10,36,.278,21,23,.913,115
480,MIL,2017-10-29,117,@,ATL,W 117-106,240,44,81,.543,31,55,.564,13,26,.500,16,21,.762,117,36,77,.468,23,48,.479,13,29,.448,21,26,.808,106
481,WAS,2017-10-27,117,@,GSW,L 117-120,240,43,97,.443,28,64,.438,15,33,.455,16,22,.727,117,46,95,.484,36,57,.632,10,38,.263,18,20,.900,120
482,GSW,2017-10-25,117,,TOR,W 117-112,240,43,77,.558,31,51,.608,12,26,.462,19,22,.864,117,43,94,.457,35,60,.583,8,34,.235,18,19,.947,112
483,SAS,2017-10-25,117,@,MIA,W 117-100,240,42,76,.553,32,59,.542,10,17,.588,23,30,.767,117,37,80,.463,28,54,.519,9,26,.346,17,18,.944,100
484,PHO,2017-10-23,117,,SAC,W 117-115,240,42,77,.545,32,47,.681,10,30,.333,23,27,.852,117,43,99,.434,34,77,.442,9,22,.409,20,29,.690,115
485,TOR,2017-10-19,117,,CHI,W 117-100,240,39,83,.470,26,54,.481,13,29,.448,26,28,.929,117,37,89,.416,27,57,.474,10,32,.313,16,18,.889,100
486,ATL,2017-10-18,117,@,DAL,W 117-111,240,48,94,.511,39,76,.513,9,18,.500,12,15,.800,117,38,86,.442,21,41,.512,17,45,.378,18,21,.857,111
487,MIA,2018-04-11,116,,TOR,W 116-109 (OT),265,46,106,.434,35,80,.438,11,26,.423,13,20,.650,116,42,92,.457,33,62,.532,9,30,.300,16,21,.762,109
488,SAS,2018-04-07,116,,POR,W 116-105,240,47,84,.560,40,63,.635,7,21,.333,15,21,.714,116,42,88,.477,31,60,.517,11,28,.393,10,11,.909,105
489,MIL,2018-03-29,116,@,GSW,W 116-107,240,48,87,.552,37,67,.552,11,20,.550,9,10,.900,116,41,75,.547,31,55,.564,10,20,.500,15,15,1.000,107
490,WAS,2018-03-27,116,,SAS,W 116-106,240,46,85,.541,36,61,.590,10,24,.417,14,18,.778,116,39,87,.448,29,62,.468,10,25,.400,18,33,.545,106
491,TOR,2018-03-23,116,,BRK,W 116-112,240,41,86,.477,27,58,.466,14,28,.500,20,29,.690,116,41,84,.488,30,57,.526,11,27,.407,19,31,.613,112
492,BRK,2018-03-16,116,@,PHI,L 116-120,240,40,89,.449,25,59,.424,15,30,.500,21,27,.778,116,43,95,.453,31,68,.456,12,27,.444,22,26,.846,120
493,UTA,2018-03-15,116,,PHO,W 116-88,240,42,97,.433,30,61,.492,12,36,.333,20,32,.625,116,32,83,.386,25,67,.373,7,16,.438,17,24,.708,88
494,TOR,2018-03-13,116,@,BRK,W 116-102,240,44,91,.484,33,60,.550,11,31,.355,17,21,.810,116,35,86,.407,20,50,.400,15,36,.417,17,19,.895,102
495,MIN,2018-03-13,116,@,WAS,W 116-111,240,46,87,.529,39,66,.591,7,21,.333,17,19,.895,116,42,82,.512,34,62,.548,8,20,.400,19,25,.760,111
496,UTA,2018-03-11,116,@,NOP,W 116-99,240,40,96,.417,28,64,.438,12,32,.375,24,25,.960,116,41,93,.441,35,72,.486,6,21,.286,11,13,.846,99
497,LAC,2018-03-09,116,,CLE,W 116-102,240,43,89,.483,32,61,.525,11,28,.393,19,30,.633,116,39,87,.448,27,51,.529,12,36,.333,12,18,.667,102
498,WAS,2018-03-09,116,@,NOP,W 116-97,240,46,96,.479,37,70,.529,9,26,.346,15,20,.750,116,38,82,.463,32,62,.516,6,20,.300,15,18,.833,97
499,LAL,2018-03-09,116,@,DEN,L 116-125,240,45,92,.489,31,57,.544,14,35,.400,12,16,.750,116,42,83,.506,27,52,.519,15,31,.484,26,30,.867,125
500,LAC,2018-03-06,116,,NOP,L 116-121,240,46,99,.465,39,72,.542,7,27,.259,17,26,.654,116,46,103,.447,33,73,.452,13,30,.433,16,18,.889,121
501,LAL,2018-03-03,116,@,SAS,W 116-112,240,40,92,.435,25,58,.431,15,34,.441,21,27,.778,116,44,98,.449,37,68,.544,7,30,.233,17,20,.850,112
502,UTA,2018-03-02,116,,MIN,W 116-108,240,40,78,.513,31,49,.633,9,29,.310,27,35,.771,116,38,74,.514,29,57,.509,9,17,.529,23,31,.742,108
503,PHO,2018-03-02,116,,OKC,L 116-124,240,46,96,.479,35,71,.493,11,25,.440,13,18,.722,116,46,96,.479,35,62,.565,11,34,.324,21,29,.724,124
504,SAC,2018-03-01,116,,BRK,W 116-111 (OT),265,50,97,.515,44,83,.530,6,14,.429,10,12,.833,116,40,96,.417,23,50,.460,17,46,.370,14,17,.824,111
505,SAS,2018-02-28,116,,NOP,L 116-121,240,48,99,.485,39,73,.534,9,26,.346,11,14,.786,116,50,99,.505,41,73,.562,9,26,.346,12,15,.800,121
506,POR,2018-02-27,116,,SAC,W 116-99,240,44,84,.524,29,50,.580,15,34,.441,13,17,.765,116,39,88,.443,32,66,.485,7,22,.318,14,15,.933,99
507,PHO,2018-02-26,116,@,NOP,L 116-125,240,42,97,.433,35,73,.479,7,24,.292,25,32,.781,116,43,91,.473,35,63,.556,8,28,.286,31,40,.775,125
508,PHI,2018-02-24,116,,ORL,W 116-105,240,42,81,.519,33,54,.611,9,27,.333,23,27,.852,116,38,85,.447,25,54,.463,13,31,.419,16,19,.842,105
509,IND,2018-02-23,116,,ATL,W 116-93,240,48,101,.475,39,73,.534,9,28,.321,11,13,.846,116,37,82,.451,30,51,.588,7,31,.226,12,19,.632,93
510,PHI,2018-02-22,116,@,CHI,W 116-115,240,42,82,.512,31,53,.585,11,29,.379,21,35,.600,116,44,97,.454,26,63,.413,18,34,.529,9,15,.600,115
511,ORL,2018-02-06,116,,CLE,W 116-98,240,46,88,.523,40,66,.606,6,22,.273,18,27,.667,116,36,84,.429,24,47,.511,12,37,.324,14,20,.700,98
512,BRK,2018-01-31,116,,PHI,W 116-108,240,39,77,.506,26,45,.578,13,32,.406,25,28,.893,116,36,76,.474,29,58,.500,7,18,.389,29,34,.853,108
513,MIL,2018-01-26,116,,BRK,W 116-91,240,43,83,.518,31,60,.517,12,23,.522,18,20,.900,116,33,89,.371,25,55,.455,8,34,.235,17,20,.850,91
514,IND,2018-01-24,116,,PHO,W 116-101,240,45,80,.563,36,56,.643,9,24,.375,17,25,.680,116,35,84,.417,26,49,.531,9,35,.257,22,29,.759,101
515,HOU,2018-01-20,116,,GSW,W 116-108,240,41,87,.471,27,50,.540,14,37,.378,20,29,.690,116,40,82,.488,23,46,.500,17,36,.472,11,15,.733,108
516,PHI,2018-01-20,116,,MIL,W 116-94,240,45,85,.529,35,60,.583,10,25,.400,16,19,.842,116,33,82,.402,23,50,.460,10,32,.313,18,22,.818,94
517,HOU,2018-01-18,116,,MIN,W 116-98,240,42,88,.477,25,49,.510,17,39,.436,15,17,.882,116,38,81,.469,30,57,.526,8,24,.333,14,21,.667,98
518,NOP,2018-01-16,116,@,BOS,W 116-113 (OT),265,45,100,.450,38,73,.521,7,27,.259,19,25,.760,116,40,101,.396,21,51,.412,19,50,.380,14,16,.875,113
519,HOU,2018-01-08,116,@,CHI,W 116-107,240,39,86,.453,19,32,.594,20,54,.370,18,24,.750,116,40,86,.465,28,58,.483,12,28,.429,15,18,.833,107
520,MIN,2018-01-06,116,,NOP,W 116-98,240,44,90,.489,35,72,.486,9,18,.500,19,21,.905,116,33,78,.423,27,49,.551,6,29,.207,26,28,.929,98
521,HOU,2018-01-03,116,@,ORL,W 116-98,240,42,89,.472,27,55,.491,15,34,.441,17,21,.810,116,35,91,.385,29,60,.483,6,31,.194,22,25,.880,98
522,DAL,2017-12-31,116,@,OKC,W 116-113,240,46,89,.517,31,55,.564,15,34,.441,9,14,.643,116,43,89,.483,33,57,.579,10,32,.313,17,23,.739,113
523,HOU,2017-12-20,116,,LAL,L 116-122,240,37,90,.411,20,48,.417,17,42,.405,25,32,.781,116,40,85,.471,25,50,.500,15,35,.429,27,43,.628,122
524,CLE,2017-12-19,116,@,MIL,L 116-119,240,40,80,.500,24,39,.615,16,41,.390,20,24,.833,116,43,82,.524,32,53,.604,11,29,.379,22,27,.815,119
525,WAS,2017-12-19,116,,NOP,W 116-106,240,46,92,.500,32,57,.561,14,35,.400,10,14,.714,116,34,80,.425,29,60,.483,5,20,.250,33,40,.825,106
526,GSW,2017-12-18,116,@,LAL,W 116-114 (OT),265,43,107,.402,32,73,.438,11,34,.324,19,21,.905,116,41,92,.446,31,67,.463,10,25,.400,22,35,.629,114
527,CHO,2017-12-11,116,@,OKC,W 116-103,240,43,81,.531,30,56,.536,13,25,.520,17,24,.708,116,35,85,.412,26,59,.441,9,26,.346,24,25,.960,103
528,DEN,2017-12-10,116,@,IND,L 116-126 (OT),265,43,95,.453,26,53,.491,17,42,.405,13,16,.813,116,49,93,.527,39,68,.574,10,25,.400,18,22,.818,126
529,TOR,2017-12-08,116,@,MEM,W 116-107,240,37,78,.474,24,47,.511,13,31,.419,29,33,.879,116,41,82,.500,32,55,.582,9,27,.333,16,22,.727,107
530,SAC,2017-12-08,116,@,NOP,W 116-109 (OT),265,47,97,.485,34,67,.507,13,30,.433,9,14,.643,116,41,89,.461,31,61,.508,10,28,.357,17,19,.895,109
531,UTA,2017-12-04,116,,WAS,W 116-69,240,43,76,.566,27,42,.643,16,34,.471,14,18,.778,116,23,80,.288,19,60,.317,4,20,.200,19,23,.826,69
532,POR,2017-12-02,116,,NOP,L 116-123,240,47,105,.448,36,70,.514,11,35,.314,11,11,1.000,116,45,86,.523,30,55,.545,15,31,.484,18,25,.720,123
533,BOS,2017-12-02,116,,PHO,W 116-111,240,42,80,.525,28,49,.571,14,31,.452,18,23,.783,116,48,101,.475,41,77,.532,7,24,.292,8,11,.727,111
534,CLE,2017-12-02,116,,MEM,W 116-111,240,42,75,.560,31,51,.608,11,24,.458,21,23,.913,116,43,84,.512,30,61,.492,13,23,.565,12,14,.857,111
535,ATL,2017-11-24,116,,NYK,W 116-104,240,47,99,.475,34,68,.500,13,31,.419,9,12,.750,116,40,78,.513,28,48,.583,12,30,.400,12,14,.857,104
536,LAC,2017-11-22,116,@,ATL,W 116-103,240,44,76,.579,29,46,.630,15,30,.500,13,19,.684,116,40,83,.482,30,54,.556,10,29,.345,13,15,.867,103
537,CLE,2017-11-20,116,@,DET,W 116-88,240,42,80,.525,26,47,.553,16,33,.485,16,17,.941,116,34,77,.442,21,47,.447,13,30,.433,7,13,.538,88
538,PHI,2017-11-18,116,,GSW,L 116-124,240,47,97,.485,37,68,.544,10,29,.345,12,16,.750,116,50,91,.549,43,68,.632,7,23,.304,17,20,.850,124
539,PHO,2017-11-16,116,,HOU,L 116-142,240,47,104,.452,37,74,.500,10,30,.333,12,21,.571,116,43,90,.478,22,46,.478,21,44,.477,35,38,.921,142
540,NOP,2017-11-15,116,,TOR,L 116-125,240,46,91,.505,36,64,.563,10,27,.370,14,14,1.000,116,45,76,.592,29,42,.690,16,34,.471,19,20,.950,125
541,IND,2017-11-15,116,@,MEM,W 116-113,240,43,85,.506,31,61,.508,12,24,.500,18,20,.900,116,44,86,.512,36,54,.667,8,32,.250,17,22,.773,113
542,WAS,2017-11-01,116,,PHO,L 116-122,240,41,92,.446,31,62,.500,10,30,.333,24,30,.800,116,41,83,.494,32,59,.542,9,24,.375,31,38,.816,122
543,NYK,2017-10-30,116,,DEN,W 116-110,240,41,82,.500,28,50,.560,13,32,.406,21,23,.913,116,35,85,.412,17,44,.386,18,41,.439,22,31,.710,110
544,OKC,2017-10-27,116,@,MIN,L 116-119,240,43,86,.500,35,58,.603,8,28,.286,22,25,.880,116,42,86,.488,34,64,.531,8,22,.364,27,35,.771,119
545,BRK,2017-10-22,116,,ATL,W 116-104,240,41,87,.471,30,60,.500,11,27,.407,23,34,.676,116,32,94,.340,25,67,.373,7,27,.259,33,36,.917,104
546,CLE,2017-10-20,116,@,MIL,W 116-97,240,44,81,.543,33,55,.600,11,26,.423,17,17,1.000,116,38,82,.463,27,47,.574,11,35,.314,10,12,.833,97
547,ORL,2017-10-18,116,,MIA,W 116-109,240,43,90,.478,35,69,.507,8,21,.381,22,29,.759,116,44,101,.436,36,71,.507,8,30,.267,13,17,.765,109
548,LAL,2018-04-11,115,@,LAC,W 115-100,240,42,88,.477,25,49,.510,17,39,.436,14,16,.875,115,41,83,.494,35,65,.538,6,18,.333,12,28,.429,100
549,OKC,2018-04-09,115,@,MIA,W 115-93,240,35,81,.432,21,46,.457,14,35,.400,31,38,.816,115,40,87,.460,35,65,.538,5,22,.227,8,14,.571,93
550,MIL,2018-04-07,115,@,NYK,W 115-102,240,45,93,.484,35,68,.515,10,25,.400,15,17,.882,115,41,95,.432,32,74,.432,9,21,.429,11,11,1.000,102
551,LAC,2018-04-07,115,,DEN,L 115-134,240,43,87,.494,37,70,.529,6,17,.353,23,34,.676,115,53,85,.624,41,56,.732,12,29,.414,16,23,.696,134
552,WAS,2018-04-05,115,@,CLE,L 115-119,240,47,94,.500,38,73,.521,9,21,.429,12,14,.857,115,42,77,.545,29,50,.580,13,27,.481,22,28,.786,119
553,MIA,2018-04-04,115,@,ATL,W 115-86,240,42,94,.447,25,56,.446,17,38,.447,14,17,.824,115,33,90,.367,24,60,.400,9,30,.300,11,17,.647,86
554,PHI,2018-04-04,115,@,DET,W 115-108,240,44,89,.494,31,59,.525,13,30,.433,14,19,.737,115,39,88,.443,23,52,.442,16,36,.444,14,23,.609,108
555,DAL,2018-04-03,115,,POR,W 115-109,240,42,92,.457,25,48,.521,17,44,.386,14,20,.700,115,39,87,.448,29,47,.617,10,40,.250,21,24,.875,109
556,DET,2018-03-31,115,@,NYK,W 115-109,240,44,85,.518,34,61,.557,10,24,.417,17,22,.773,115,43,91,.473,30,62,.484,13,29,.448,10,12,.833,109
557,NOP,2018-03-20,115,,DAL,W 115-105,240,48,91,.527,38,66,.576,10,25,.400,9,15,.600,115,43,90,.478,33,55,.600,10,35,.286,9,11,.818,105
558,HOU,2018-03-20,115,@,POR,W 115-111,240,38,79,.481,19,43,.442,19,36,.528,20,29,.690,115,40,81,.494,29,53,.547,11,28,.393,20,27,.741,111
559,DET,2018-03-20,115,@,PHO,W 115-88,240,43,97,.443,28,61,.459,15,36,.417,14,16,.875,115,34,90,.378,27,56,.482,7,34,.206,13,20,.650,88
560,MEM,2018-03-19,115,@,BRK,L 115-118,240,46,88,.523,36,65,.554,10,23,.435,13,20,.650,115,36,72,.500,20,32,.625,16,40,.400,30,40,.750,118
561,DAL,2018-03-16,115,@,TOR,L 115-122 (OT),265,48,91,.527,42,69,.609,6,22,.273,13,18,.722,115,43,91,.473,33,61,.541,10,30,.333,26,31,.839,122
562,CHO,2018-03-13,115,@,NOP,L 115-119,240,45,93,.484,38,67,.567,7,26,.269,18,22,.818,115,52,104,.500,43,82,.524,9,22,.409,6,8,.750,119
563,POR,2018-03-12,115,,MIA,W 115-99,240,38,83,.458,24,47,.511,14,36,.389,25,30,.833,115,39,91,.429,29,60,.483,10,31,.323,11,16,.688,99
564,PHO,2018-03-10,115,@,CHO,L 115-122,240,42,83,.506,24,51,.471,18,32,.563,13,19,.684,115,44,87,.506,31,55,.564,13,32,.406,21,27,.778,122
565,OKC,2018-03-08,115,,PHO,W 115-87,240,42,80,.525,29,47,.617,13,33,.394,18,27,.667,115,31,92,.337,22,55,.400,9,37,.243,16,18,.889,87
566,ORL,2018-03-02,115,,DET,W 115-106 (OT),265,44,86,.512,31,50,.620,13,36,.361,14,19,.737,115,40,92,.435,28,63,.444,12,29,.414,14,24,.583,106
567,MIA,2018-02-24,115,,MEM,W 115-89,240,41,89,.461,29,56,.518,12,33,.364,21,27,.778,115,35,80,.438,30,69,.435,5,11,.455,14,17,.824,89
568,CHI,2018-02-22,115,,PHI,L 115-116,240,44,97,.454,26,63,.413,18,34,.529,9,15,.600,115,42,82,.512,31,53,.585,11,29,.379,21,35,.600,116
569,TOR,2018-02-13,115,,MIA,W 115-112,240,42,90,.467,29,55,.527,13,35,.371,18,23,.783,115,42,86,.488,30,57,.526,12,29,.414,16,19,.842,112
570,UTA,2018-02-11,115,@,POR,W 115-96,240,41,88,.466,28,62,.452,13,26,.500,20,22,.909,115,33,81,.407,24,56,.429,9,25,.360,21,25,.840,96
571,DET,2018-02-11,115,@,ATL,L 115-118,240,38,83,.458,25,50,.500,13,33,.394,26,33,.788,115,38,78,.487,28,49,.571,10,29,.345,32,37,.865,118
572,DET,2018-02-07,115,,BRK,W 115-106,240,44,92,.478,35,68,.515,9,24,.375,18,25,.720,115,39,90,.433,22,39,.564,17,51,.333,11,12,.917,106
573,PHI,2018-02-06,115,,WAS,W 115-102,240,45,82,.549,31,54,.574,14,28,.500,11,14,.786,115,41,93,.441,34,66,.515,7,27,.259,13,18,.722,102
574,CHO,2018-02-04,115,@,PHO,W 115-110,240,40,96,.417,30,58,.517,10,38,.263,25,29,.862,115,41,77,.532,26,48,.542,15,29,.517,13,13,1.000,110
575,DEN,2018-02-03,115,,GSW,W 115-108,240,39,91,.429,27,62,.435,12,29,.414,25,29,.862,115,43,86,.500,35,55,.636,8,31,.258,14,23,.609,108
576,WAS,2018-02-03,115,@,ORL,W 115-98,240,46,85,.541,39,59,.661,7,26,.269,16,18,.889,115,34,77,.442,24,45,.533,10,32,.313,20,22,.909,98
577,CLE,2018-01-26,115,,IND,W 115-108,240,46,82,.561,33,45,.733,13,37,.351,10,13,.769,115,43,91,.473,30,60,.500,13,31,.419,9,11,.818,108
578,NOP,2018-01-26,115,,HOU,W 115-113,240,44,82,.537,33,55,.600,11,27,.407,16,21,.762,115,36,78,.462,24,42,.571,12,36,.333,29,35,.829,113
579,PHI,2018-01-24,115,,CHI,W 115-101,240,42,81,.519,26,49,.531,16,32,.500,15,20,.750,115,36,94,.383,25,57,.439,11,37,.297,18,22,.818,101
580,MIN,2018-01-20,115,,TOR,W 115-109,240,38,81,.469,31,65,.477,7,16,.438,32,42,.762,115,39,83,.470,27,50,.540,12,33,.364,19,21,.905,109
581,UTA,2018-01-19,115,,NYK,L 115-117,240,42,91,.462,31,60,.517,11,31,.355,20,30,.667,115,44,89,.494,33,69,.478,11,20,.550,18,23,.783,117
582,SAC,2018-01-11,115,,LAC,L 115-121,240,42,85,.494,34,59,.576,8,26,.308,23,28,.821,115,43,84,.512,30,53,.566,13,31,.419,22,30,.733,121
583,DAL,2018-01-10,115,@,CHO,W 115-111,240,39,83,.470,24,47,.511,15,36,.417,22,28,.786,115,43,84,.512,33,58,.569,10,26,.385,15,30,.500,111
584,CHI,2018-01-03,115,,TOR,L 115-124,240,43,93,.462,30,60,.500,13,33,.394,16,19,.842,115,45,92,.489,30,54,.556,15,38,.395,19,19,1.000,124
585,CHI,2017-12-26,115,@,MIL,W 115-106,240,45,103,.437,35,75,.467,10,28,.357,15,25,.600,115,39,83,.470,29,52,.558,10,31,.323,18,24,.750,106
586,MEM,2017-12-23,115,,LAC,W 115-112,240,40,90,.444,27,59,.458,13,31,.419,22,25,.880,115,39,79,.494,26,45,.578,13,34,.382,21,28,.750,112
587,MIN,2017-12-23,115,@,PHO,W 115-106,240,42,84,.500,36,68,.529,6,16,.375,25,29,.862,115,40,86,.465,29,54,.537,11,32,.344,15,24,.625,106
588,CLE,2017-12-21,115,,CHI,W 115-112,240,42,82,.512,30,53,.566,12,29,.414,19,22,.864,115,47,85,.553,35,54,.648,12,31,.387,6,8,.750,112
589,PHI,2017-12-18,115,@,CHI,L 115-117,240,44,91,.484,30,58,.517,14,33,.424,13,18,.722,115,44,92,.478,31,64,.484,13,28,.464,16,19,.842,117
590,HOU,2017-12-16,115,,MIL,W 115-111,240,35,76,.461,24,41,.585,11,35,.314,34,42,.810,115,38,82,.463,30,55,.545,8,27,.296,27,33,.818,111
591,CHI,2017-12-15,115,@,MIL,W 115-109,240,42,86,.488,34,64,.531,8,22,.364,23,35,.657,115,40,83,.482,31,50,.620,9,33,.273,20,29,.690,109
592,NOP,2017-12-13,115,,MIL,W 115-108,240,45,80,.563,32,55,.582,13,25,.520,12,15,.800,115,44,95,.463,36,68,.529,8,27,.296,12,19,.632,108
593,TOR,2017-12-13,115,@,PHO,W 115-109,240,40,92,.435,31,66,.470,9,26,.346,26,31,.839,115,37,83,.446,29,59,.492,8,24,.333,27,34,.794,109
594,NOP,2017-12-04,115,,GSW,L 115-125,240,45,91,.495,29,52,.558,16,39,.410,9,15,.600,115,45,87,.517,29,54,.537,16,33,.485,19,27,.704,125
595,PHO,2017-12-04,115,@,PHI,W 115-101,240,44,91,.484,34,69,.493,10,22,.455,17,22,.773,115,39,91,.429,32,61,.525,7,30,.233,16,16,1.000,101
596,IND,2017-12-04,115,,NYK,W 115-97,240,46,86,.535,35,60,.583,11,26,.423,12,15,.800,115,40,91,.440,34,68,.500,6,23,.261,11,16,.688,97
597,DEN,2017-12-02,115,,LAL,W 115-100,240,40,87,.460,28,56,.500,12,31,.387,23,28,.821,115,38,86,.442,29,56,.518,9,30,.300,15,21,.714,100
598,IND,2017-12-01,115,@,TOR,L 115-120,240,45,102,.441,37,76,.487,8,26,.308,17,22,.773,115,48,97,.495,38,65,.585,10,32,.313,14,21,.667,120
599,NYK,2017-11-29,115,,MIA,W 115-86,240,44,73,.603,39,60,.650,5,13,.385,22,26,.846,115,32,84,.381,22,46,.478,10,38,.263,12,20,.600,86
600,SAS,2017-11-27,115,,DAL,W 115-108,240,43,82,.524,33,58,.569,10,24,.417,19,21,.905,115,41,85,.482,27,53,.509,14,32,.438,12,17,.706,108
601,LAL,2017-11-27,115,@,LAC,L 115-120,240,44,91,.484,33,61,.541,11,30,.367,16,24,.667,115,41,85,.482,31,57,.544,10,28,.357,28,30,.933,120
602,NOP,2017-11-24,115,@,PHO,W 115-91,240,45,91,.495,36,64,.563,9,27,.333,16,22,.727,115,37,94,.394,35,74,.473,2,20,.100,15,18,.833,91
603,PHI,2017-11-15,115,@,LAL,W 115-109,240,42,86,.488,35,54,.648,7,32,.219,24,30,.800,115,42,109,.385,39,82,.476,3,27,.111,22,27,.815,109
604,CLE,2017-11-15,115,@,CHO,W 115-107,240,42,95,.442,29,57,.509,13,38,.342,18,20,.900,115,41,86,.477,35,60,.583,6,26,.231,19,28,.679,107
605,PHO,2017-11-08,115,,MIA,L 115-126,240,40,88,.455,28,59,.475,12,29,.414,23,30,.767,115,43,81,.531,31,51,.608,12,30,.400,28,35,.800,126
606,CLE,2017-11-05,115,,ATL,L 115-117,240,42,96,.438,32,60,.533,10,36,.278,21,23,.913,115,41,86,.477,30,61,.492,11,25,.440,24,34,.706,117
607,ORL,2017-10-30,115,@,NOP,W 115-99,240,43,85,.506,27,51,.529,16,34,.471,13,18,.722,115,39,85,.459,32,57,.561,7,28,.250,14,18,.778,99
608,PHI,2017-10-30,115,@,HOU,W 115-107,240,44,80,.550,34,56,.607,10,24,.417,17,24,.708,115,33,83,.398,20,36,.556,13,47,.277,28,38,.737,107
609,DET,2017-10-29,115,@,GSW,W 115-107,240,43,93,.462,31,66,.470,12,27,.444,17,17,1.000,115,44,77,.571,34,50,.680,10,27,.370,9,12,.750,107
610,SAC,2017-10-23,115,@,PHO,L 115-117,240,43,99,.434,34,77,.442,9,22,.409,20,29,.690,115,42,77,.545,32,47,.681,10,30,.333,23,27,.852,117
611,MIN,2017-10-22,115,@,OKC,W 115-113,240,43,86,.500,33,61,.541,10,25,.400,19,23,.826,115,46,96,.479,35,65,.538,11,31,.355,10,16,.625,113
612,WAS,2017-10-20,115,,DET,W 115-111,240,40,75,.533,34,58,.586,6,17,.353,29,35,.829,115,43,87,.494,33,64,.516,10,23,.435,15,20,.750,111
613,PHI,2017-10-18,115,@,WAS,L 115-120,240,43,93,.462,28,58,.483,15,35,.429,14,19,.737,115,42,97,.433,36,75,.480,6,22,.273,30,38,.789,120
614,BRK,2018-04-09,114,,CHI,W 114-105,240,41,82,.500,23,40,.575,18,42,.429,14,15,.933,114,43,89,.483,31,61,.508,12,28,.429,7,12,.583,105
615,CHO,2018-04-03,114,@,CHI,L 114-120,240,40,81,.494,27,47,.574,13,34,.382,21,28,.750,114,46,99,.465,31,65,.477,15,34,.441,13,18,.722,120
616,ATL,2018-03-28,114,@,MIN,L 114-126,240,41,77,.532,28,50,.560,13,27,.481,19,23,.826,114,48,90,.533,35,60,.583,13,30,.433,17,21,.810,126
617,TOR,2018-03-27,114,,DEN,W 114-110,240,47,92,.511,34,58,.586,13,34,.382,7,9,.778,114,42,89,.472,29,59,.492,13,30,.433,13,14,.929,110
618,BRK,2018-03-25,114,,CLE,L 114-121,240,38,83,.458,21,46,.457,17,37,.459,21,26,.808,114,44,87,.506,32,59,.542,12,28,.429,21,26,.808,121
619,HOU,2018-03-24,114,,NOP,W 114-91,240,45,93,.484,27,46,.587,18,47,.383,6,8,.750,114,38,96,.396,32,75,.427,6,21,.286,9,12,.750,91
620,CLE,2018-03-17,114,@,CHI,W 114-109,240,44,87,.506,31,50,.620,13,37,.351,13,20,.650,114,41,91,.451,25,57,.439,16,34,.471,11,15,.733,109
621,BRK,2018-03-17,114,,DAL,W 114-106,240,43,84,.512,29,48,.604,14,36,.389,14,19,.737,114,41,92,.446,29,70,.414,12,22,.545,12,14,.857,106
622,DAL,2018-03-10,114,,MEM,W 114-80,240,37,77,.481,27,48,.563,10,29,.345,30,35,.857,114,30,84,.357,23,66,.348,7,18,.389,13,17,.765,80
623,NOP,2018-03-07,114,@,SAC,W 114-101,240,47,83,.566,36,57,.632,11,26,.423,9,9,1.000,114,39,93,.419,30,65,.462,9,28,.321,14,17,.824,101
624,CHO,2018-03-06,114,,PHI,L 114-128,240,40,80,.500,29,51,.569,11,29,.379,23,31,.742,114,50,87,.575,34,54,.630,16,33,.485,12,15,.800,128
625,GSW,2018-03-06,114,,BRK,W 114-101,240,47,83,.566,36,60,.600,11,23,.478,9,11,.818,114,36,85,.424,27,51,.529,9,34,.265,20,25,.800,101
626,GSW,2018-03-02,114,@,ATL,W 114-109,240,42,79,.532,31,48,.646,11,31,.355,19,22,.864,114,38,86,.442,23,51,.451,15,35,.429,18,20,.900,109
627,CHO,2018-02-25,114,,DET,W 114-98,240,42,88,.477,26,53,.491,16,35,.457,14,23,.609,114,42,85,.494,38,67,.567,4,18,.222,10,14,.714,98
628,DEN,2018-02-25,114,,HOU,L 114-119,240,44,91,.484,34,62,.548,10,29,.345,16,24,.667,114,39,77,.506,24,42,.571,15,35,.429,26,32,.813,119
629,MEM,2018-02-14,114,,OKC,L 114-121,240,44,86,.512,30,59,.508,14,27,.519,12,15,.800,114,40,81,.494,23,44,.523,17,37,.459,24,35,.686,121
630,SAC,2018-02-13,114,@,DAL,W 114-109,240,47,87,.540,35,58,.603,12,29,.414,8,12,.667,114,38,83,.458,23,43,.535,15,40,.375,18,23,.783,109
631,LAC,2018-02-12,114,@,BRK,W 114-101,240,48,85,.565,42,69,.609,6,16,.375,12,14,.857,114,41,89,.461,29,49,.592,12,40,.300,7,10,.700,101
632,CHI,2018-02-09,114,,MIN,W 114-113,240,41,83,.494,32,57,.561,9,26,.346,23,30,.767,114,41,87,.471,33,65,.508,8,22,.364,23,28,.821,113
633,NOP,2018-02-02,114,@,OKC,W 114-100,240,46,90,.511,33,66,.500,13,24,.542,9,13,.692,114,37,97,.381,28,61,.459,9,36,.250,17,20,.850,100
634,SAC,2018-01-30,114,@,NOP,W 114-103,240,46,97,.474,36,71,.507,10,26,.385,12,14,.857,114,39,77,.506,30,52,.577,9,25,.360,16,22,.727,103
635,HOU,2018-01-30,114,,ORL,W 114-107,240,39,77,.506,26,42,.619,13,35,.371,23,28,.821,114,42,83,.506,27,52,.519,15,31,.484,8,10,.800,107
636,CLE,2018-01-30,114,@,DET,L 114-125,240,38,84,.452,25,49,.510,13,35,.371,25,32,.781,114,49,93,.527,40,70,.571,9,23,.391,18,28,.643,125
637,IND,2018-01-27,114,,ORL,W 114-112,240,47,87,.540,42,69,.609,5,18,.278,15,19,.789,114,42,77,.545,34,52,.654,8,25,.320,20,32,.625,112
638,MIN,2018-01-24,114,@,POR,L 114-123,240,45,84,.536,39,68,.574,6,16,.375,18,22,.818,114,45,82,.549,28,51,.549,17,31,.548,16,21,.762,123
639,SAS,2018-01-23,114,,CLE,W 114-102,240,47,94,.500,39,66,.591,8,28,.286,12,16,.750,114,35,72,.486,29,51,.569,6,21,.286,26,31,.839,102
640,OKC,2018-01-17,114,,LAL,W 114-90,240,46,95,.484,34,60,.567,12,35,.343,10,12,.833,114,38,81,.469,28,55,.509,10,26,.385,4,4,1.000,90
641,LAL,2018-01-15,114,@,MEM,L 114-123,240,38,96,.396,26,61,.426,12,35,.343,26,31,.839,114,42,82,.512,32,60,.533,10,22,.455,29,34,.853,123
642,BOS,2018-01-11,114,@,PHI,W 114-103,240,43,89,.483,30,54,.556,13,35,.371,15,19,.789,114,38,82,.463,27,54,.500,11,28,.393,16,18,.889,103
643,DET,2018-01-10,114,@,BRK,W 114-80,240,48,93,.516,38,72,.528,10,21,.476,8,12,.667,114,27,74,.365,15,37,.405,12,37,.324,14,15,.933,80
644,MIA,2018-01-10,114,@,IND,W 114-106,240,43,81,.531,30,51,.588,13,30,.433,15,21,.714,114,43,87,.494,42,69,.609,1,18,.056,19,29,.655,106
645,DAL,2018-01-09,114,,ORL,W 114-99,240,43,83,.518,34,57,.596,9,26,.346,19,22,.864,114,36,79,.456,25,50,.500,11,29,.379,16,22,.727,99
646,DEN,2018-01-08,114,@,GSW,L 114-124,240,47,95,.495,39,76,.513,8,19,.421,12,16,.750,114,48,85,.565,35,55,.636,13,30,.433,15,21,.714,124
647,TOR,2018-01-08,114,@,BRK,W 114-113 (OT),265,43,101,.426,33,67,.493,10,34,.294,18,23,.783,114,39,100,.390,27,67,.403,12,33,.364,23,28,.821,113
648,PHO,2018-01-07,114,,OKC,W 114-100,240,39,88,.443,22,49,.449,17,39,.436,19,23,.826,114,40,86,.465,32,59,.542,8,27,.296,12,21,.571,100
649,PHI,2018-01-05,114,,DET,W 114-78,240,44,90,.489,30,60,.500,14,30,.467,12,13,.923,114,30,78,.385,23,56,.411,7,22,.318,11,19,.579,78
650,HOU,2018-01-04,114,,GSW,L 114-124,240,42,89,.472,25,39,.641,17,50,.340,13,22,.591,114,48,87,.552,35,57,.614,13,30,.433,15,20,.750,124
651,MIN,2018-01-01,114,,LAL,W 114-96,240,40,81,.494,33,61,.541,7,20,.350,27,30,.900,114,34,76,.447,26,50,.520,8,26,.308,20,29,.690,96
652,WAS,2017-12-31,114,,CHI,W 114-110,240,43,93,.462,27,57,.474,16,36,.444,12,17,.706,114,42,92,.457,34,57,.596,8,35,.229,18,22,.818,110
653,MEM,2017-12-31,114,@,SAC,W 114-96,240,41,76,.539,27,46,.587,14,30,.467,18,24,.750,114,37,86,.430,28,62,.452,9,24,.375,13,25,.520,96
654,POR,2017-12-28,114,,PHI,W 114-110,240,35,75,.467,27,51,.529,8,24,.333,36,47,.766,114,42,87,.483,26,55,.473,16,32,.500,10,14,.714,110
655,TOR,2017-12-21,114,@,PHI,W 114-109,240,35,85,.412,23,50,.460,12,35,.343,32,35,.914,114,45,86,.523,36,57,.632,9,29,.310,10,14,.714,109
656,LAL,2017-12-18,114,,GSW,L 114-116 (OT),265,41,92,.446,31,67,.463,10,25,.400,22,35,.629,114,43,107,.402,32,73,.438,11,34,.324,19,21,.905,116
657,DET,2017-12-17,114,,ORL,W 114-110,240,42,89,.472,25,55,.455,17,34,.500,13,16,.813,114,41,85,.482,24,52,.462,17,33,.515,11,17,.647,110
658,ATL,2017-12-12,114,@,CLE,L 114-123,240,43,92,.467,27,56,.482,16,36,.444,12,13,.923,114,48,86,.558,28,48,.583,20,38,.526,7,10,.700,123
659,DEN,2017-12-06,114,@,NOP,L 114-123,240,41,94,.436,25,59,.424,16,35,.457,16,22,.727,114,46,86,.535,34,55,.618,12,31,.387,19,29,.655,123
660,ATL,2017-12-02,114,@,BRK,W 114-102,240,47,99,.475,37,72,.514,10,27,.370,10,14,.714,114,34,82,.415,17,40,.425,17,42,.405,17,21,.810,102
661,UTA,2017-12-01,114,,NOP,W 114-108,240,42,85,.494,30,55,.545,12,30,.400,18,25,.720,114,42,87,.483,27,57,.474,15,30,.500,9,15,.600,108
662,ATL,2017-11-30,114,,CLE,L 114-121,240,41,79,.519,29,48,.604,12,31,.387,20,24,.833,114,41,79,.519,23,40,.575,18,39,.462,21,27,.778,121
663,NOP,2017-11-20,114,,OKC,W 114-107,240,41,80,.513,34,55,.618,7,25,.280,25,32,.781,114,38,89,.427,27,54,.500,11,35,.314,20,26,.769,107
664,DEN,2017-11-20,114,@,SAC,W 114-98,240,42,86,.488,27,54,.500,15,32,.469,15,20,.750,114,41,86,.477,33,66,.500,8,20,.400,8,9,.889,98
665,NOP,2017-11-17,114,@,DEN,L 114-146,240,48,91,.527,36,58,.621,12,33,.364,6,10,.600,114,56,89,.629,38,54,.704,18,35,.514,16,21,.762,146
666,PHI,2017-11-11,114,@,GSW,L 114-135,240,44,94,.468,32,66,.485,12,28,.429,14,20,.700,114,48,82,.585,34,55,.618,14,27,.519,25,26,.962,135
667,UTA,2017-11-11,114,,BRK,W 114-106,240,41,85,.482,30,56,.536,11,29,.379,21,25,.840,114,35,76,.461,28,53,.528,7,23,.304,29,39,.744,106
668,DET,2017-11-08,114,,IND,W 114-97,240,43,83,.518,31,56,.554,12,27,.444,16,25,.640,114,38,88,.432,31,64,.484,7,24,.292,14,18,.778,97
669,CHI,2017-11-07,114,@,TOR,L 114-119,240,40,80,.500,29,51,.569,11,29,.379,23,28,.821,114,44,81,.543,31,56,.554,13,25,.520,18,24,.750,119
670,BRK,2017-10-31,114,,PHO,L 114-122,240,42,102,.412,33,71,.465,9,31,.290,21,30,.700,114,45,96,.469,35,74,.473,10,22,.455,22,24,.917,122
671,NYK,2017-10-29,114,@,CLE,W 114-95,240,42,89,.472,29,61,.475,13,28,.464,17,21,.810,114,31,81,.383,21,48,.438,10,33,.303,23,27,.852,95
672,POR,2017-10-28,114,,PHO,W 114-107,240,40,91,.440,29,65,.446,11,26,.423,23,28,.821,114,37,87,.425,28,61,.459,9,26,.346,24,30,.800,107
673,ORL,2017-10-27,114,,SAS,W 114-87,240,48,84,.571,37,61,.607,11,23,.478,7,14,.500,114,30,89,.337,26,65,.400,4,24,.167,23,27,.852,87
674,NOP,2017-10-26,114,@,SAC,W 114-106,240,42,86,.488,29,54,.537,13,32,.406,17,23,.739,114,38,81,.469,31,61,.508,7,20,.350,23,25,.920,106
675,OKC,2017-10-25,114,,IND,W 114-96,240,43,89,.483,33,62,.532,10,27,.370,18,26,.692,114,28,83,.337,18,54,.333,10,29,.345,30,35,.857,96
676,ORL,2017-10-21,114,@,CLE,W 114-93,240,40,90,.444,23,55,.418,17,35,.486,17,20,.850,114,33,86,.384,26,61,.426,7,25,.280,20,27,.741,93
677,POR,2017-10-20,114,@,IND,W 114-96,240,46,95,.484,37,76,.487,9,19,.474,13,17,.765,114,35,78,.449,31,60,.517,4,18,.222,22,33,.667,96
678,WAS,2018-04-10,113,,BOS,W 113-101,240,41,83,.494,26,53,.491,15,30,.500,16,20,.800,113,33,87,.379,20,54,.370,13,33,.394,22,27,.815,101
679,ATL,2018-04-10,113,,PHI,L 113-121,240,41,98,.418,28,61,.459,13,37,.351,18,26,.692,113,43,87,.494,26,50,.520,17,37,.459,18,30,.600,121
680,MIN,2018-04-09,113,,MEM,W 113-94,240,42,87,.483,35,65,.538,7,22,.318,22,26,.846,113,35,85,.412,30,67,.448,5,18,.278,19,21,.905,94
681,NOP,2018-04-09,113,@,LAC,W 113-100,240,44,95,.463,33,65,.508,11,30,.367,14,20,.700,113,45,98,.459,43,81,.531,2,17,.118,8,19,.421,100
682,MIN,2018-04-06,113,@,LAL,W 113-96,240,43,100,.430,35,74,.473,8,26,.308,19,26,.731,113,31,79,.392,23,55,.418,8,24,.333,26,32,.813,96
683,DET,2018-04-06,113,,DAL,W 113-106 (OT),265,46,92,.500,34,62,.548,12,30,.400,9,17,.529,113,40,92,.435,27,53,.509,13,39,.333,13,18,.722,106
684,LAC,2018-04-03,113,,SAS,W 113-110,240,37,82,.451,32,66,.485,5,16,.313,34,43,.791,113,39,88,.443,31,64,.484,8,24,.333,24,28,.857,110
685,CHI,2018-04-01,113,,WAS,W 113-94,240,43,82,.524,25,48,.521,18,34,.529,9,13,.692,113,37,81,.457,29,51,.569,8,30,.267,12,12,1.000,94
686,POR,2018-04-01,113,,MEM,W 113-98,240,39,84,.464,27,46,.587,12,38,.316,23,25,.920,113,40,88,.455,31,67,.463,9,21,.429,9,12,.750,98
687,IND,2018-03-25,113,,MIA,W 113-107 (OT),265,44,90,.489,36,67,.537,8,23,.348,17,21,.810,113,41,86,.477,27,51,.529,14,35,.400,11,14,.786,107
688,LAC,2018-03-16,113,@,OKC,L 113-121,240,42,86,.488,31,60,.517,11,26,.423,18,23,.783,113,46,94,.489,35,62,.565,11,32,.344,18,22,.818,121
689,DET,2018-03-15,113,@,DEN,L 113-120,240,44,92,.478,30,65,.462,14,27,.519,11,17,.647,113,43,85,.506,31,57,.544,12,28,.429,22,28,.786,120
690,POR,2018-03-15,113,,CLE,W 113-105,240,43,96,.448,31,61,.508,12,35,.343,15,19,.789,113,41,80,.513,30,47,.638,11,33,.333,12,21,.571,105
691,CLE,2018-03-11,113,@,LAL,L 113-127,240,41,88,.466,29,57,.509,12,31,.387,19,23,.826,113,48,96,.500,35,62,.565,13,34,.382,18,20,.900,127
692,LAC,2018-03-10,113,,ORL,W 113-105,240,41,78,.526,34,60,.567,7,18,.389,24,28,.857,113,38,84,.452,30,60,.500,8,24,.333,21,27,.778,105
693,CLE,2018-03-07,113,@,DEN,W 113-108,240,44,87,.506,31,58,.534,13,29,.448,12,18,.667,113,42,86,.488,32,59,.542,10,27,.370,14,18,.778,108
694,MIA,2018-03-06,113,@,WAS,L 113-117 (OT),265,42,94,.447,33,61,.541,9,33,.273,20,27,.741,113,40,80,.500,26,56,.464,14,24,.583,23,27,.852,117
695,ATL,2018-03-04,113,,PHO,W 113-112,240,43,94,.457,26,61,.426,17,33,.515,10,12,.833,113,46,92,.500,35,66,.530,11,26,.423,9,15,.600,112
696,MIA,2018-03-01,113,,LAL,L 113-131,240,46,95,.484,37,64,.578,9,31,.290,12,16,.750,113,47,79,.595,31,50,.620,16,29,.552,21,26,.808,131
697,LAL,2018-02-24,113,@,SAC,W 113-108,240,41,91,.451,24,53,.453,17,38,.447,14,20,.700,113,42,94,.447,29,69,.420,13,25,.520,11,17,.647,108
698,ORL,2018-02-22,113,,NYK,L 113-120,240,43,83,.518,32,59,.542,11,24,.458,16,23,.696,113,48,99,.485,41,74,.554,7,25,.280,17,21,.810,120
699,NYK,2018-02-14,113,,WAS,L 113-118,240,45,97,.464,36,78,.462,9,19,.474,14,18,.778,113,48,88,.545,41,66,.621,7,22,.318,15,19,.789,118
700,NYK,2018-02-11,113,@,IND,L 113-121,240,41,93,.441,32,58,.552,9,35,.257,22,25,.880,113,47,94,.500,35,66,.530,12,28,.429,15,22,.682,121
701,PHO,2018-02-10,113,,DEN,L 113-123,240,46,84,.548,39,65,.600,7,19,.368,14,25,.560,113,45,88,.511,32,59,.542,13,29,.448,20,22,.909,123
702,MIN,2018-02-09,113,@,CHI,L 113-114,240,41,87,.471,33,65,.508,8,22,.364,23,28,.821,113,41,83,.494,32,57,.561,9,26,.346,23,30,.767,114
703,TOR,2018-02-08,113,,NYK,W 113-88,240,43,95,.453,27,52,.519,16,43,.372,11,14,.786,113,33,83,.398,26,56,.464,7,27,.259,15,18,.833,88
704,BRK,2018-02-06,113,,HOU,L 113-123,240,41,85,.482,25,50,.500,16,35,.457,15,17,.882,113,45,81,.556,29,48,.604,16,33,.485,17,21,.810,123
705,LAC,2018-02-03,113,,CHI,W 113-103,240,40,88,.455,31,63,.492,9,25,.360,24,28,.857,113,35,97,.361,23,60,.383,12,37,.324,21,21,1.000,103
706,HOU,2018-01-28,113,,PHO,W 113-102,240,32,72,.444,21,35,.600,11,37,.297,38,49,.776,113,36,85,.424,28,52,.538,8,33,.242,22,26,.846,102
707,SAS,2018-01-28,113,,SAC,W 113-98,240,45,90,.500,34,65,.523,11,25,.440,12,17,.706,113,35,82,.427,17,48,.354,18,34,.529,10,11,.909,98
708,HOU,2018-01-26,113,@,NOP,L 113-115,240,36,78,.462,24,42,.571,12,36,.333,29,35,.829,113,44,82,.537,33,55,.600,11,27,.407,16,21,.762,115
709,MIN,2018-01-25,113,@,GSW,L 113-126,240,46,101,.455,40,81,.494,6,20,.300,15,18,.833,113,48,89,.539,27,52,.519,21,37,.568,9,15,.600,126
710,BOS,2018-01-24,113,@,LAC,W 113-102,240,39,93,.419,25,53,.472,14,40,.350,21,22,.955,113,35,79,.443,30,58,.517,5,21,.238,27,39,.692,102
711,LAC,2018-01-20,113,@,UTA,L 113-125,240,36,82,.439,25,46,.543,11,36,.306,30,38,.789,113,45,82,.549,34,54,.630,11,28,.393,24,32,.750,125
712,CHI,2018-01-20,113,@,ATL,W 113-97,240,40,80,.500,26,48,.542,14,32,.438,19,21,.905,113,35,92,.380,24,44,.545,11,48,.229,16,23,.696,97
713,BOS,2018-01-16,113,,NOP,L 113-116 (OT),265,40,101,.396,21,51,.412,19,50,.380,14,16,.875,113,45,100,.450,38,73,.521,7,27,.259,19,25,.760,116
714,LAC,2018-01-15,113,,HOU,W 113-102,240,44,79,.557,34,54,.630,10,25,.400,15,20,.750,113,38,94,.404,25,50,.500,13,44,.295,13,16,.813,102
715,BRK,2018-01-13,113,@,WAS,L 113-119 (OT),265,42,99,.424,30,56,.536,12,43,.279,17,20,.850,113,46,93,.495,36,70,.514,10,23,.435,17,23,.739,119
716,POR,2018-01-12,113,@,NOP,L 113-119,240,45,101,.446,33,59,.559,12,42,.286,11,14,.786,113,45,82,.549,38,63,.603,7,19,.368,22,23,.957,119
717,BRK,2018-01-08,113,,TOR,L 113-114 (OT),265,39,100,.390,27,67,.403,12,33,.364,23,28,.821,113,43,101,.426,33,67,.493,10,34,.294,18,23,.783,114
718,ATL,2018-01-07,113,@,LAL,L 113-132,240,41,94,.436,29,60,.483,12,34,.353,19,23,.826,113,48,86,.558,32,50,.640,16,36,.444,20,25,.800,132
719,LAC,2018-01-02,113,,MEM,W 113-105,240,39,71,.549,30,48,.625,9,23,.391,26,31,.839,113,38,79,.481,30,53,.566,8,26,.308,21,33,.636,105
720,OKC,2017-12-31,113,,DAL,L 113-116,240,43,89,.483,33,57,.579,10,32,.313,17,23,.739,113,46,89,.517,31,55,.564,15,34,.441,9,14,.643,116
721,ATL,2017-12-27,113,,WAS,W 113-99,240,41,94,.436,30,57,.526,11,37,.297,20,29,.690,113,35,81,.432,26,57,.456,9,24,.375,20,26,.769,99
722,BRK,2017-12-27,113,@,NOP,L 113-128,240,41,90,.456,22,52,.423,19,38,.500,12,14,.857,113,48,90,.533,31,57,.544,17,33,.515,15,19,.789,128
723,GSW,2017-12-22,113,,LAL,W 113-106,240,42,85,.494,35,61,.574,7,24,.292,22,27,.815,113,40,94,.426,29,65,.446,11,29,.379,15,22,.682,106
724,MIA,2017-12-22,113,,DAL,W 113-101,240,46,72,.639,30,47,.638,16,25,.640,5,6,.833,113,38,75,.507,21,40,.525,17,35,.486,8,11,.727,101
725,NYK,2017-12-12,113,,LAL,W 113-109 (OT),265,48,101,.475,39,79,.494,9,22,.409,8,11,.727,113,42,102,.412,29,67,.433,13,35,.371,12,15,.800,109
726,LAC,2017-12-09,113,,WAS,W 113-112,240,39,80,.488,25,48,.521,14,32,.438,21,24,.875,113,42,82,.512,29,50,.580,13,32,.406,15,23,.652,112
727,MIN,2017-12-06,113,@,LAC,W 113-107,240,45,82,.549,38,63,.603,7,19,.368,16,21,.762,113,44,99,.444,34,67,.507,10,32,.313,9,15,.600,107
728,PHO,2017-12-05,113,@,TOR,L 113-126,240,37,75,.493,28,51,.549,9,24,.375,30,38,.789,113,44,92,.478,29,56,.518,15,36,.417,23,26,.885,126
729,CLE,2017-12-04,113,@,CHI,W 113-91,240,42,81,.519,29,45,.644,13,36,.361,16,17,.941,113,34,82,.415,25,48,.521,9,34,.265,14,18,.778,91
730,CHO,2017-11-29,113,@,TOR,L 113-126,240,37,79,.468,28,60,.467,9,19,.474,30,35,.857,113,52,98,.531,38,66,.576,14,32,.438,8,11,.727,126
731,WAS,2017-11-29,113,@,PHI,L 113-118,240,36,89,.404,27,67,.403,9,22,.409,32,37,.865,113,37,81,.457,34,63,.540,3,18,.167,41,64,.641,118
732,CLE,2017-11-27,113,@,PHI,W 113-91,240,41,86,.477,26,49,.531,15,37,.405,16,20,.800,113,36,96,.375,33,68,.485,3,28,.107,16,20,.800,91
733,SAC,2017-11-22,113,,LAL,W 113-102,240,47,85,.553,37,64,.578,10,21,.476,9,14,.643,113,39,78,.500,24,49,.490,15,29,.517,9,15,.600,102
734,MIL,2017-11-22,113,@,PHO,W 113-107 (OT),265,42,97,.433,34,68,.500,8,29,.276,21,31,.677,113,37,93,.398,30,71,.423,7,22,.318,26,33,.788,107
735,PHO,2017-11-19,113,,CHI,W 113-105,240,45,89,.506,38,62,.613,7,27,.259,16,22,.727,113,42,101,.416,30,65,.462,12,36,.333,9,14,.643,105
736,LAL,2017-11-17,113,,PHO,L 113-122,240,45,91,.495,38,66,.576,7,25,.280,16,24,.667,113,48,103,.466,35,71,.493,13,32,.406,13,19,.684,122
737,LAC,2017-11-17,113,@,CLE,L 113-118 (OT),265,46,103,.447,36,68,.529,10,35,.286,11,14,.786,113,42,90,.467,31,57,.544,11,33,.333,23,29,.793,118
738,MEM,2017-11-15,113,,IND,L 113-116,240,44,86,.512,36,54,.667,8,32,.250,17,22,.773,113,43,85,.506,31,61,.508,12,24,.500,18,20,.900,116
739,HOU,2017-11-14,113,,TOR,L 113-129,240,33,79,.418,21,40,.525,12,39,.308,35,41,.854,113,41,78,.526,27,48,.563,14,30,.467,33,42,.786,129
740,WAS,2017-11-11,113,,ATL,W 113-94,240,42,78,.538,35,54,.648,7,24,.292,22,28,.786,113,34,83,.410,20,50,.400,14,33,.424,12,17,.706,94
741,CLE,2017-11-09,113,@,HOU,L 113-117,240,45,81,.556,33,54,.611,12,27,.444,11,14,.786,113,36,77,.468,20,31,.645,16,46,.348,29,36,.806,117
742,CHO,2017-11-07,113,@,NYK,L 113-118,240,42,91,.462,27,54,.500,15,37,.405,14,17,.824,113,45,75,.600,33,50,.660,12,25,.480,16,21,.762,118
743,DAL,2017-11-07,113,@,WAS,W 113-99,240,43,91,.473,32,61,.525,11,30,.367,16,20,.800,113,32,75,.427,22,50,.440,10,25,.400,25,32,.781,99
744,MEM,2017-11-04,113,@,LAC,W 113-104,240,40,84,.476,27,53,.509,13,31,.419,20,24,.833,113,38,83,.458,34,57,.596,4,26,.154,24,31,.774,104
745,POR,2017-11-02,113,,LAL,W 113-110,240,40,86,.465,31,64,.484,9,22,.409,24,27,.889,113,43,79,.544,39,61,.639,4,18,.222,20,27,.741,110
746,BOS,2017-11-01,113,,SAC,W 113-86,240,40,82,.488,23,41,.561,17,41,.415,16,19,.842,113,35,81,.432,29,61,.475,6,20,.300,10,12,.833,86
747,LAL,2017-10-31,113,,DET,W 113-93,240,45,91,.495,33,65,.508,12,26,.462,11,14,.786,113,41,94,.436,31,61,.508,10,33,.303,1,3,.333,93
748,LAC,2017-10-30,113,,GSW,L 113-141,240,39,86,.453,29,61,.475,10,25,.400,25,30,.833,113,52,89,.584,38,60,.633,14,29,.483,23,30,.767,141
749,ORL,2017-10-29,113,@,CHO,L 113-120,240,41,97,.423,30,64,.469,11,33,.333,20,26,.769,113,53,97,.546,47,79,.595,6,18,.333,8,17,.471,120
750,OKC,2017-10-22,113,,MIN,L 113-115,240,46,96,.479,35,65,.538,11,31,.355,10,16,.625,113,43,86,.500,33,61,.541,10,25,.400,19,23,.826,115
751,MIL,2017-10-21,113,,POR,W 113-110,240,42,80,.525,35,62,.565,7,18,.389,22,30,.733,113,34,81,.420,23,53,.434,11,28,.393,31,35,.886,110
752,MIN,2018-04-11,112,,DEN,W 112-106 (OT),265,42,89,.472,33,66,.500,9,23,.391,19,25,.760,112,41,90,.456,28,58,.483,13,32,.406,11,18,.611,106
753,ATL,2018-04-08,112,@,BOS,W 112-106,240,43,86,.500,28,51,.549,15,35,.429,11,14,.786,112,42,82,.512,33,59,.559,9,23,.391,13,20,.650,106
754,UTA,2018-04-08,112,@,LAL,W 112-97,240,42,83,.506,29,47,.617,13,36,.361,15,22,.682,112,37,93,.398,32,68,.471,5,25,.200,18,22,.818,97
755,TOR,2018-04-08,112,,ORL,W 112-101,240,39,78,.500,22,38,.579,17,40,.425,17,24,.708,112,42,89,.472,35,66,.530,7,23,.304,10,17,.588,101
756,SAS,2018-04-04,112,@,LAL,L 112-122 (OT),265,42,97,.433,33,74,.446,9,23,.391,19,27,.704,112,47,86,.547,34,62,.548,13,24,.542,15,18,.833,122
757,CLE,2018-04-03,112,,TOR,W 112-106,240,38,77,.494,25,47,.532,13,30,.433,23,26,.885,112,42,94,.447,31,60,.517,11,34,.324,11,14,.786,106
758,GSW,2018-03-31,112,@,SAC,W 112-96,240,41,83,.494,32,57,.561,9,26,.346,21,28,.750,112,36,87,.414,28,59,.475,8,28,.286,16,19,.842,96
759,DET,2018-03-26,112,,LAL,W 112-106,240,44,100,.440,31,67,.463,13,33,.394,11,15,.733,112,40,85,.471,34,62,.548,6,23,.261,20,25,.800,106
760,BRK,2018-03-23,112,@,TOR,L 112-116,240,41,84,.488,30,57,.526,11,27,.407,19,31,.613,112,41,86,.477,27,58,.466,14,28,.500,20,29,.690,116
761,DAL,2018-03-22,112,,UTA,L 112-119,240,42,85,.494,25,53,.472,17,32,.531,11,14,.786,112,46,87,.529,34,58,.586,12,29,.414,15,16,.938,119
762,LAC,2018-03-13,112,@,CHI,W 112-106,240,37,76,.487,29,47,.617,8,29,.276,30,41,.732,112,43,101,.426,36,72,.500,7,29,.241,13,15,.867,106
763,LAL,2018-03-13,112,,DEN,W 112-103,240,40,90,.444,25,50,.500,15,40,.375,17,25,.680,112,38,86,.442,25,46,.543,13,40,.325,14,19,.737,103
764,IND,2018-03-09,112,,ATL,W 112-87,240,45,91,.495,31,63,.492,14,28,.500,8,10,.800,112,34,82,.415,24,49,.490,10,33,.303,9,10,.900,87
765,NYK,2018-03-09,112,@,MIL,L 112-120,240,47,98,.480,40,70,.571,7,28,.250,11,14,.786,112,41,73,.562,33,55,.600,8,18,.444,30,39,.769,120
766,OKC,2018-03-06,112,,HOU,L 112-122,240,46,93,.495,34,59,.576,12,34,.353,8,11,.727,112,38,72,.528,21,39,.538,17,33,.515,29,34,.853,122
767,CLE,2018-03-05,112,,DET,W 112-90,240,43,88,.489,31,55,.564,12,33,.364,14,17,.824,112,34,87,.391,22,53,.415,12,34,.353,10,15,.667,90
768,PHO,2018-03-04,112,@,ATL,L 112-113,240,46,92,.500,35,66,.530,11,26,.423,9,15,.600,112,43,94,.457,26,61,.426,17,33,.515,10,12,.833,113
769,SAS,2018-03-03,112,,LAL,L 112-116,240,44,98,.449,37,68,.544,7,30,.233,17,20,.850,112,40,92,.435,25,58,.431,15,34,.441,21,27,.778,116
770,OKC,2018-02-26,112,,ORL,W 112-105,240,42,88,.477,31,63,.492,11,25,.440,17,20,.850,112,39,84,.464,27,55,.491,12,29,.414,15,21,.714,105
771,GSW,2018-02-24,112,,OKC,W 112-80,240,42,89,.472,25,51,.490,17,38,.447,11,13,.846,112,29,88,.330,20,54,.370,9,34,.265,13,21,.619,80
772,NYK,2018-02-24,112,,BOS,L 112-121,240,45,96,.469,39,69,.565,6,27,.222,16,20,.800,112,42,93,.452,29,60,.483,13,33,.394,24,28,.857,121
773,CLE,2018-02-23,112,@,MEM,W 112-89,240,40,87,.460,29,58,.500,11,29,.379,21,22,.955,112,33,84,.393,24,60,.400,9,24,.375,14,18,.778,89
774,OKC,2018-02-13,112,,CLE,L 112-120,240,40,90,.444,29,55,.527,11,35,.314,21,30,.700,112,45,88,.511,29,52,.558,16,36,.444,14,22,.636,120
775,MIA,2018-02-13,112,@,TOR,L 112-115,240,42,86,.488,30,57,.526,12,29,.414,16,19,.842,112,42,90,.467,29,55,.527,13,35,.371,18,23,.783,115
776,PHI,2018-02-10,112,,LAC,W 112-98,240,43,90,.478,30,57,.526,13,33,.394,13,17,.765,112,38,88,.432,30,56,.536,8,32,.250,14,23,.609,98
777,LAL,2018-02-06,112,,PHO,W 112-93,240,39,83,.470,28,57,.491,11,26,.423,23,26,.885,112,36,94,.383,28,65,.431,8,29,.276,13,23,.565,93
778,PHI,2018-01-28,112,@,OKC,L 112-122,240,38,76,.500,27,47,.574,11,29,.379,25,31,.806,112,45,92,.489,35,59,.593,10,33,.303,22,30,.733,122
779,LAC,2018-01-28,112,@,NOP,W 112-103,240,45,96,.469,36,68,.529,9,28,.321,13,18,.722,112,38,85,.447,29,50,.580,9,35,.257,18,25,.720,103
780,ORL,2018-01-27,112,@,IND,L 112-114,240,42,77,.545,34,52,.654,8,25,.320,20,32,.625,112,47,87,.540,42,69,.609,5,18,.278,15,19,.789,114
781,WAS,2018-01-25,112,@,OKC,L 112-121,240,42,86,.488,26,51,.510,16,35,.457,12,16,.750,112,45,87,.517,36,60,.600,9,27,.333,22,29,.759,121
782,NYK,2018-01-23,112,@,GSW,L 112-123,240,43,83,.518,34,61,.557,9,22,.409,17,19,.895,112,46,83,.554,33,53,.623,13,30,.433,18,20,.900,123
783,CHO,2018-01-22,112,,SAC,W 112-107,240,38,86,.442,22,46,.478,16,40,.400,20,25,.800,112,43,97,.443,33,75,.440,10,22,.455,11,15,.733,107
784,DET,2018-01-19,112,,WAS,L 112-122,240,40,80,.500,30,50,.600,10,30,.333,22,26,.846,112,41,82,.500,25,47,.532,16,35,.457,24,27,.889,122
785,CHI,2018-01-17,112,,GSW,L 112-119,240,45,106,.425,35,67,.522,10,39,.256,12,13,.923,112,42,84,.500,29,51,.569,13,33,.394,22,25,.880,119
786,SAS,2018-01-13,112,,DEN,W 112-80,240,41,79,.519,27,52,.519,14,27,.519,16,18,.889,112,29,83,.349,22,55,.400,7,28,.250,15,17,.882,80
787,HOU,2018-01-12,112,@,PHO,W 112-95,240,39,94,.415,24,47,.511,15,47,.319,19,22,.864,112,37,80,.463,23,47,.489,14,33,.424,7,9,.778,95
788,POR,2018-01-10,112,@,HOU,L 112-121,240,40,83,.482,31,57,.544,9,26,.346,23,32,.719,112,45,100,.450,33,62,.532,12,38,.316,19,25,.760,121
789,NOP,2018-01-08,112,,DET,W 112-109,240,46,82,.561,40,60,.667,6,22,.273,14,21,.667,112,41,93,.441,33,66,.500,8,27,.296,19,22,.864,109
790,PHI,2018-01-03,112,,SAS,W 112-106,240,36,80,.450,29,58,.500,7,22,.318,33,43,.767,112,39,87,.448,31,62,.500,8,25,.320,20,23,.870,106
791,OKC,2017-12-25,112,,HOU,W 112-107,240,43,79,.544,35,61,.574,8,18,.444,18,23,.783,112,35,81,.432,23,44,.523,12,37,.324,25,31,.806,107
792,ATL,2017-12-23,112,,DAL,W 112-107,240,42,75,.560,32,51,.627,10,24,.417,18,22,.818,112,43,85,.506,34,52,.654,9,33,.273,12,15,.800,107
793,LAC,2017-12-23,112,@,MEM,L 112-115,240,39,79,.494,26,45,.578,13,34,.382,21,28,.750,112,40,90,.444,27,59,.458,13,31,.419,22,25,.880,115
794,CHI,2017-12-21,112,@,CLE,L 112-115,240,47,85,.553,35,54,.648,12,31,.387,6,8,.750,112,42,82,.512,30,53,.566,12,29,.414,19,22,.864,115
795,CHI,2017-12-20,112,,ORL,W 112-94,240,44,87,.506,33,55,.600,11,32,.344,13,14,.929,112,35,89,.393,30,62,.484,5,27,.185,19,23,.826,94
796,MIN,2017-12-20,112,@,DEN,W 112-104,240,43,87,.494,35,63,.556,8,24,.333,18,19,.947,112,36,72,.500,23,44,.523,13,28,.464,19,24,.792,104
797,BOS,2017-12-18,112,@,IND,W 112-111,240,44,79,.557,28,53,.528,16,26,.615,8,14,.571,112,37,79,.468,30,58,.517,7,21,.333,30,38,.789,111
798,LAL,2017-12-14,112,@,CLE,L 112-121,240,47,95,.495,38,64,.594,9,31,.290,9,14,.643,112,43,86,.500,28,50,.560,15,36,.417,20,25,.800,121
799,GSW,2017-12-14,112,,DAL,W 112-97,240,47,78,.603,36,56,.643,11,22,.500,7,9,.778,112,37,82,.451,27,53,.509,10,29,.345,13,17,.765,97
800,MIN,2017-12-12,112,,PHI,L 112-118 (OT),265,44,108,.407,39,79,.494,5,29,.172,19,27,.704,112,40,80,.500,29,54,.537,11,26,.423,27,32,.844,118
801,WAS,2017-12-09,112,@,LAC,L 112-113,240,42,82,.512,29,50,.580,13,32,.406,15,23,.652,112,39,80,.488,25,48,.521,14,32,.438,21,24,.875,113
802,HOU,2017-12-07,112,@,UTA,W 112-101,240,38,81,.469,20,39,.513,18,42,.429,18,24,.750,112,34,77,.442,23,47,.489,11,30,.367,22,27,.815,101
803,MIN,2017-12-03,112,,LAC,W 112-106,240,38,88,.432,30,62,.484,8,26,.308,28,31,.903,112,37,73,.507,22,39,.564,15,34,.441,17,22,.773,106
804,ORL,2017-12-01,112,,GSW,L 112-133,240,44,96,.458,33,68,.485,11,28,.393,13,18,.722,112,55,88,.625,43,64,.672,12,24,.500,11,11,1.000,133
805,MIL,2017-11-28,112,@,SAC,W 112-87,240,42,71,.592,33,49,.673,9,22,.409,19,31,.613,112,31,77,.403,26,60,.433,5,17,.294,20,29,.690,87
806,TOR,2017-11-25,112,@,ATL,W 112-78,240,46,84,.548,33,52,.635,13,32,.406,7,9,.778,112,26,75,.347,20,48,.417,6,27,.222,20,23,.870,78
807,DET,2017-11-12,112,,MIA,W 112-103,240,42,87,.483,28,59,.475,14,28,.500,14,20,.700,112,39,90,.433,26,53,.491,13,37,.351,12,16,.750,103
808,OKC,2017-11-12,112,,DAL,W 112-99,240,36,72,.500,21,40,.525,15,32,.469,25,33,.758,112,37,87,.425,26,50,.520,11,37,.297,14,18,.778,99
809,PHO,2017-11-10,112,,ORL,L 112-128,240,44,94,.468,39,70,.557,5,24,.208,19,25,.760,112,43,82,.524,30,54,.556,13,28,.464,29,43,.674,128
810,ORL,2017-11-08,112,,NYK,W 112-99,240,43,80,.538,30,52,.577,13,28,.464,13,22,.591,112,42,80,.525,37,68,.544,5,12,.417,10,13,.769,99
811,IND,2017-11-07,112,,NOP,L 112-117,240,44,93,.473,35,69,.507,9,24,.375,15,18,.833,112,44,87,.506,30,52,.577,14,35,.400,15,22,.682,117
812,DEN,2017-11-07,112,,BRK,W 112-104,240,44,93,.473,35,59,.593,9,34,.265,15,20,.750,112,38,89,.427,27,54,.500,11,35,.314,17,22,.773,104
813,MIN,2017-11-05,112,,CHO,W 112-94,240,38,83,.458,28,59,.475,10,24,.417,26,30,.867,112,37,89,.416,28,61,.459,9,28,.321,11,21,.524,94
814,SAS,2017-11-05,112,,PHO,W 112-95,240,44,88,.500,33,66,.500,11,22,.500,13,18,.722,112,37,81,.457,29,58,.500,8,23,.348,13,22,.591,95
815,MIN,2017-11-04,112,,DAL,W 112-99,240,43,79,.544,33,55,.600,10,24,.417,16,20,.800,112,40,87,.460,30,60,.500,10,27,.370,9,12,.750,99
816,BRK,2017-11-03,112,@,LAL,L 112-124,240,37,91,.407,28,53,.528,9,38,.237,29,38,.763,112,48,94,.511,39,73,.534,9,21,.429,19,27,.704,124
817,GSW,2017-11-02,112,@,SAS,W 112-92,240,43,83,.518,29,55,.527,14,28,.500,12,16,.750,112,34,87,.391,27,63,.429,7,24,.292,17,23,.739,92
818,UTA,2017-11-01,112,,POR,W 112-103 (OT),265,34,90,.378,21,61,.344,13,29,.448,31,36,.861,112,37,93,.398,28,59,.475,9,34,.265,20,27,.741,103
819,PHI,2017-10-28,112,@,DAL,W 112-110,240,43,87,.494,27,52,.519,16,35,.457,10,14,.714,112,38,74,.514,19,34,.559,19,40,.475,15,19,.789,110
820,BRK,2017-10-25,112,,CLE,W 112-107,240,40,93,.430,23,47,.489,17,46,.370,15,21,.714,112,39,81,.481,27,46,.587,12,35,.343,17,26,.654,107
821,TOR,2017-10-25,112,@,GSW,L 112-117,240,43,94,.457,35,60,.583,8,34,.235,18,19,.947,112,43,77,.558,31,51,.608,12,26,.462,19,22,.864,117
822,CHI,2017-10-24,112,@,CLE,L 112-119,240,42,88,.477,25,55,.455,17,33,.515,11,13,.846,112,43,83,.518,27,45,.600,16,38,.421,17,22,.773,119
823,LAL,2017-10-22,112,,NOP,L 112-119,240,44,90,.489,35,63,.556,9,27,.333,15,20,.750,112,47,83,.566,37,51,.725,10,32,.313,15,21,.714,119
824,MIA,2017-10-21,112,,IND,W 112-108,240,45,87,.517,31,53,.585,14,34,.412,8,14,.571,112,43,96,.448,36,77,.468,7,19,.368,15,21,.714,108
825,BOS,2018-04-06,111,,CHI,W 111-104,240,45,81,.556,31,47,.660,14,34,.412,7,17,.412,111,40,86,.465,26,56,.464,14,30,.467,10,17,.588,104
826,MIL,2018-04-05,111,,BRK,L 111-119,240,41,93,.441,36,73,.493,5,20,.250,24,30,.800,111,41,75,.547,22,36,.611,19,39,.487,18,21,.857,119
827,GSW,2018-04-03,111,@,OKC,W 111-107,240,41,83,.494,33,54,.611,8,29,.276,21,24,.875,111,35,93,.376,26,55,.473,9,38,.237,28,37,.757,107
828,IND,2018-04-01,111,@,LAC,W 111-104,240,42,86,.488,31,58,.534,11,28,.393,16,21,.762,111,42,82,.512,33,57,.579,9,25,.360,11,14,.786,104
829,LAC,2018-03-28,111,@,PHO,W 111-99,240,43,80,.538,35,63,.556,8,17,.471,17,25,.680,111,38,88,.432,28,54,.519,10,34,.294,13,18,.722,99
830,BRK,2018-03-28,111,@,ORL,W 111-104,240,40,87,.460,28,53,.528,12,34,.353,19,22,.864,111,40,92,.435,29,61,.475,11,31,.355,13,16,.813,104
831,CHO,2018-03-21,111,@,BRK,W 111-105,240,36,94,.383,33,78,.423,3,16,.188,36,47,.766,111,39,93,.419,26,56,.464,13,37,.351,14,21,.667,105
832,POR,2018-03-20,111,,HOU,L 111-115,240,40,81,.494,29,53,.547,11,28,.393,20,27,.741,111,38,79,.481,19,43,.442,19,36,.528,20,29,.690,115
833,CHI,2018-03-15,111,@,MEM,W 111-110,240,35,80,.438,20,39,.513,15,41,.366,26,33,.788,111,38,87,.437,25,52,.481,13,35,.371,21,25,.840,110
834,WAS,2018-03-13,111,,MIN,L 111-116,240,42,82,.512,34,62,.548,8,20,.400,19,25,.760,111,46,87,.529,39,66,.591,7,21,.333,17,19,.895,116
835,CHO,2018-03-08,111,,BRK,L 111-125,240,41,85,.482,37,66,.561,4,19,.211,25,30,.833,111,47,92,.511,36,60,.600,11,32,.344,20,22,.909,125
836,POR,2018-03-06,111,,NYK,W 111-87,240,35,81,.432,15,48,.313,20,33,.606,21,24,.875,111,35,83,.422,28,64,.438,7,19,.368,10,15,.667,87
837,BRK,2018-03-01,111,@,SAC,L 111-116 (OT),265,40,96,.417,23,50,.460,17,46,.370,14,17,.824,111,50,97,.515,44,83,.530,6,14,.429,10,12,.833,116
838,OKC,2018-02-28,111,@,DAL,W 111-110 (OT),265,42,93,.452,32,57,.561,10,36,.278,17,19,.895,111,44,91,.484,31,55,.564,13,36,.361,9,15,.600,110
839,NYK,2018-02-26,111,,GSW,L 111-125,240,47,96,.490,37,71,.521,10,25,.400,7,9,.778,111,44,85,.518,29,54,.537,15,31,.484,22,26,.846,125
840,CHO,2018-02-22,111,,BRK,W 111-96,240,42,87,.483,31,66,.470,11,21,.524,16,20,.800,111,36,93,.387,22,50,.440,14,43,.326,10,14,.714,96
841,LAL,2018-02-15,111,@,MIN,L 111-119,240,43,94,.457,36,63,.571,7,31,.226,18,26,.692,111,42,90,.467,36,66,.545,6,24,.250,29,31,.935,119
842,MIN,2018-02-11,111,,SAC,W 111-106,240,37,74,.500,28,50,.560,9,24,.375,28,32,.875,111,42,88,.477,32,63,.508,10,25,.400,12,17,.706,106
843,MIL,2018-02-10,111,@,ORL,W 111-104,240,43,82,.524,34,57,.596,9,25,.360,16,20,.800,111,37,83,.446,29,53,.547,8,30,.267,22,26,.846,104
844,TOR,2018-02-06,111,,BOS,W 111-91,240,40,80,.500,23,44,.523,17,36,.472,14,17,.824,111,33,83,.398,23,60,.383,10,23,.435,15,20,.750,91
845,WAS,2018-02-05,111,@,IND,W 111-102,240,45,82,.549,38,57,.667,7,25,.280,14,17,.824,111,37,80,.463,25,51,.490,12,29,.414,16,25,.640,102
846,DET,2018-02-05,111,,POR,W 111-91,240,44,88,.500,29,58,.500,15,30,.500,8,12,.667,111,37,94,.394,27,61,.443,10,33,.303,7,8,.875,91
847,ORL,2018-02-05,111,@,MIA,W 111-109,240,41,84,.488,28,54,.519,13,30,.433,16,19,.842,111,40,93,.430,37,70,.529,3,23,.130,26,35,.743,109
848,DET,2018-02-03,111,,MIA,W 111-107,240,44,84,.524,35,58,.603,9,26,.346,14,17,.824,111,44,91,.484,30,55,.545,14,36,.389,5,7,.714,107
849,SAS,2018-02-03,111,,UTA,L 111-120,240,44,91,.484,34,65,.523,10,26,.385,13,18,.722,111,39,69,.565,27,46,.587,12,23,.522,30,36,.833,120
850,NYK,2018-01-30,111,,BRK,W 111-95,240,39,89,.438,26,63,.413,13,26,.500,20,25,.800,111,36,87,.414,27,50,.540,9,37,.243,14,16,.875,95
851,BOS,2018-01-29,111,@,DEN,W 111-110,240,43,91,.473,26,55,.473,17,36,.472,8,10,.800,111,42,93,.452,32,60,.533,10,33,.303,16,21,.762,110
852,LAL,2018-01-28,111,@,TOR,L 111-123,240,40,91,.440,32,66,.485,8,25,.320,23,33,.697,111,46,92,.500,34,61,.557,12,31,.387,19,25,.760,123
853,MIN,2018-01-27,111,,BRK,W 111-97,240,42,96,.438,38,75,.507,4,21,.190,23,26,.885,111,38,82,.463,29,52,.558,9,30,.300,12,15,.800,97
854,NOP,2018-01-20,111,,MEM,W 111-104,240,39,78,.500,32,51,.627,7,27,.259,26,32,.813,111,37,82,.451,22,47,.468,15,35,.429,15,16,.938,104
855,PHO,2018-01-16,111,@,POR,L 111-118,240,37,89,.416,21,48,.438,16,41,.390,21,22,.955,111,46,91,.505,29,56,.518,17,35,.486,9,10,.900,118
856,TOR,2018-01-15,111,@,PHI,L 111-117,240,38,95,.400,29,63,.460,9,32,.281,26,30,.867,111,40,81,.494,34,56,.607,6,25,.240,31,38,.816,117
857,MIA,2018-01-15,111,@,CHI,L 111-119,240,40,84,.476,28,48,.583,12,36,.333,19,24,.792,111,42,88,.477,26,49,.531,16,39,.410,19,22,.864,119
858,CHO,2018-01-10,111,,DAL,L 111-115,240,43,84,.512,33,58,.569,10,26,.385,15,30,.500,111,39,83,.470,24,47,.511,15,36,.417,22,28,.786,115
859,POR,2018-01-07,111,,SAS,W 111-110,240,48,92,.522,40,69,.580,8,23,.348,7,10,.700,111,40,81,.494,29,58,.500,11,23,.478,19,26,.731,110
860,PHO,2018-01-03,111,@,DEN,L 111-134,240,39,92,.424,26,57,.456,13,35,.371,20,28,.714,111,51,82,.622,39,55,.709,12,27,.444,20,22,.909,134
861,MIA,2018-01-03,111,,DET,W 111-104,240,43,84,.512,26,50,.520,17,34,.500,8,11,.727,111,41,86,.477,32,62,.516,9,24,.375,13,16,.813,104
862,SAC,2018-01-02,111,,CHO,L 111-131,240,45,87,.517,38,70,.543,7,17,.412,14,18,.778,111,51,89,.573,36,57,.632,15,32,.469,14,18,.778,131
863,ORL,2017-12-30,111,,MIA,L 111-117,240,44,81,.543,32,54,.593,12,27,.444,11,15,.733,111,45,88,.511,33,64,.516,12,24,.500,15,18,.833,117
864,BRK,2017-12-29,111,@,MIA,W 111-87,240,39,79,.494,28,53,.528,11,26,.423,22,25,.880,111,30,89,.337,27,63,.429,3,26,.115,24,31,.774,87
865,TOR,2017-12-29,111,,ATL,W 111-98,240,46,105,.438,33,68,.485,13,37,.351,6,8,.750,111,38,88,.432,29,64,.453,9,24,.375,13,20,.650,98
866,CHO,2017-12-29,111,@,GSW,W 111-100,240,41,89,.461,35,69,.507,6,20,.300,23,34,.676,111,40,87,.460,32,65,.492,8,22,.364,12,13,.923,100
867,PHO,2017-12-29,111,@,SAC,W 111-101,240,41,85,.482,28,55,.509,13,30,.433,16,24,.667,111,37,80,.463,29,57,.509,8,23,.348,19,23,.826,101
868,WAS,2017-12-25,111,@,BOS,W 111-103,240,43,93,.462,37,67,.552,6,26,.231,19,28,.679,111,39,81,.481,25,52,.481,14,29,.483,11,17,.647,103
869,CHO,2017-12-23,111,,MIL,W 111-106,240,36,74,.486,27,53,.509,9,21,.429,30,40,.750,111,42,87,.483,34,61,.557,8,26,.308,14,17,.824,106
870,NOP,2017-12-22,111,@,ORL,W 111-97,240,43,86,.500,33,56,.589,10,30,.333,15,24,.625,111,36,85,.424,32,65,.492,4,20,.200,21,29,.724,97
871,CHO,2017-12-20,111,,TOR,L 111-129,240,39,85,.459,32,62,.516,7,23,.304,26,35,.743,111,49,91,.538,33,58,.569,16,33,.485,15,18,.833,129
872,IND,2017-12-18,111,,BOS,L 111-112,240,37,79,.468,30,58,.517,7,21,.333,30,38,.789,111,44,79,.557,28,53,.528,16,26,.615,8,14,.571,112
873,NYK,2017-12-16,111,,OKC,W 111-96,240,38,69,.551,24,46,.522,14,23,.609,21,26,.808,111,36,85,.424,24,58,.414,12,27,.444,12,20,.600,96
874,MIL,2017-12-16,111,@,HOU,L 111-115,240,38,82,.463,30,55,.545,8,27,.296,27,33,.818,111,35,76,.461,24,41,.585,11,35,.314,34,42,.810,115
875,NOP,2017-12-15,111,@,DEN,L 111-117 (OT),265,43,91,.473,28,57,.491,15,34,.441,10,14,.714,111,46,100,.460,30,64,.469,16,36,.444,9,14,.643,117
876,NYK,2017-12-14,111,@,BRK,W 111-104,240,41,89,.461,31,69,.449,10,20,.500,19,22,.864,111,37,83,.446,25,41,.610,12,42,.286,18,23,.783,104
877,GSW,2017-12-11,111,,POR,W 111-104,240,44,80,.550,34,60,.567,10,20,.500,13,17,.765,111,37,88,.420,30,60,.500,7,28,.250,23,25,.920,104
878,NYK,2017-12-10,111,,ATL,W 111-107,240,39,80,.488,34,63,.540,5,17,.294,28,34,.824,111,37,77,.481,28,46,.609,9,31,.290,24,30,.800,107
879,CHO,2017-12-08,111,,CHI,L 111-119 (OT),265,40,100,.400,30,71,.423,10,29,.345,21,29,.724,111,48,99,.485,42,81,.519,6,18,.333,17,22,.773,119
880,BOS,2017-12-04,111,,MIL,W 111-100,240,43,78,.551,33,56,.589,10,22,.455,15,19,.789,111,35,78,.449,26,57,.456,9,21,.429,21,24,.875,100
881,MEM,2017-12-02,111,@,CLE,L 111-116,240,43,84,.512,30,61,.492,13,23,.565,12,14,.857,111,42,75,.560,31,51,.608,11,24,.458,21,23,.913,116
882,PHO,2017-12-02,111,@,BOS,L 111-116,240,48,101,.475,41,77,.532,7,24,.292,8,11,.727,111,42,80,.525,28,49,.571,14,31,.452,18,23,.783,116
883,OKC,2017-12-01,111,,MIN,W 111-107,240,41,79,.519,33,53,.623,8,26,.308,21,22,.955,111,39,76,.513,27,52,.519,12,24,.500,17,21,.810,107
884,DEN,2017-11-30,111,,CHI,W 111-110,240,38,83,.458,26,52,.500,12,31,.387,23,31,.742,111,44,82,.537,35,58,.603,9,24,.375,13,21,.619,110
885,ORL,2017-11-25,111,@,PHI,L 111-130,240,39,86,.453,27,55,.491,12,31,.387,21,31,.677,111,48,95,.505,32,61,.525,16,34,.471,18,20,.900,130
886,BRK,2017-11-19,111,,GSW,L 111-118,240,34,95,.358,18,47,.383,16,48,.333,27,39,.692,111,46,90,.511,36,66,.545,10,24,.417,16,23,.696,118
887,DAL,2017-11-18,111,,MIL,W 111-79,240,38,79,.481,19,41,.463,19,38,.500,16,19,.842,111,28,74,.378,22,49,.449,6,25,.240,17,31,.548,79
888,MIN,2017-11-17,111,@,DAL,W 111-87,240,39,84,.464,26,54,.481,13,30,.433,20,23,.870,111,32,86,.372,24,48,.500,8,38,.211,15,17,.882,87
889,CLE,2017-11-11,111,@,DAL,W 111-104,240,35,81,.432,23,50,.460,12,31,.387,29,35,.829,111,39,92,.424,29,58,.500,10,34,.294,16,21,.762,104
890,NOP,2017-11-11,111,,LAC,W 111-103,240,43,80,.538,37,64,.578,6,16,.375,19,24,.792,111,35,86,.407,25,60,.417,10,26,.385,23,27,.852,103
891,HOU,2017-11-11,111,,MEM,W 111-96,240,37,83,.446,21,38,.553,16,45,.356,21,28,.750,111,38,79,.481,32,59,.542,6,20,.300,14,18,.778,96
892,DET,2017-11-10,111,,ATL,W 111-104,240,39,89,.438,27,59,.458,12,30,.400,21,27,.778,111,44,89,.494,36,65,.554,8,24,.333,8,11,.727,104
893,LAC,2017-11-10,111,@,OKC,L 111-120,240,39,84,.464,27,54,.500,12,30,.400,21,30,.700,111,40,78,.513,29,52,.558,11,26,.423,29,40,.725,120
894,WAS,2017-11-09,111,,LAL,W 111-95,240,43,83,.518,36,62,.581,7,21,.333,18,20,.900,111,31,86,.360,28,63,.444,3,23,.130,30,41,.732,95
895,TOR,2017-11-01,111,@,DEN,L 111-129,240,42,85,.494,31,54,.574,11,31,.355,16,25,.640,111,47,88,.534,31,56,.554,16,32,.500,19,29,.655,129
896,BRK,2017-10-29,111,,DEN,L 111-124,240,39,96,.406,27,65,.415,12,31,.387,21,31,.677,111,47,94,.500,36,74,.486,11,20,.550,19,22,.864,124
897,MEM,2017-10-21,111,,GSW,W 111-101,240,36,77,.468,26,50,.520,10,27,.370,29,37,.784,111,33,84,.393,21,46,.457,12,38,.316,23,27,.852,101
898,DET,2017-10-21,111,@,NYK,W 111-107,240,44,91,.484,35,61,.574,9,30,.300,14,15,.933,111,37,81,.457,29,51,.569,8,30,.267,25,31,.806,107
899,DET,2017-10-20,111,@,WAS,L 111-115,240,43,87,.494,33,64,.516,10,23,.435,15,20,.750,111,40,75,.533,34,58,.586,6,17,.353,29,35,.829,115
900,DAL,2017-10-18,111,,ATL,L 111-117,240,38,86,.442,21,41,.512,17,45,.378,18,21,.857,111,48,94,.511,39,76,.513,9,18,.500,12,15,.800,117
901,BOS,2018-04-11,110,,BRK,W 110-97,240,46,102,.451,40,78,.513,6,24,.250,12,15,.800,110,37,91,.407,26,51,.510,11,40,.275,12,16,.750,97
902,NYK,2018-04-11,110,@,CLE,W 110-98,240,43,85,.506,31,58,.534,12,27,.444,12,13,.923,110,37,94,.394,31,70,.443,6,24,.250,18,28,.643,98
903,LAL,2018-04-03,110,@,UTA,L 110-117,240,36,74,.486,22,46,.478,14,28,.500,24,36,.667,110,43,89,.483,29,56,.518,14,33,.424,17,27,.630,117
904,SAS,2018-04-03,110,@,LAC,L 110-113,240,39,88,.443,31,64,.484,8,24,.333,24,28,.857,110,37,82,.451,32,66,.485,5,16,.313,34,43,.791,113
905,BRK,2018-03-31,110,@,MIA,W 110-109 (OT),265,39,91,.429,29,56,.518,10,35,.286,22,28,.786,110,43,95,.453,36,78,.462,7,17,.412,16,21,.762,109
906,BOS,2018-03-31,110,,TOR,W 110-99,240,40,88,.455,33,71,.465,7,17,.412,23,27,.852,110,37,80,.463,29,45,.644,8,35,.229,17,22,.773,99
907,DEN,2018-03-27,110,@,TOR,L 110-114,240,42,89,.472,29,59,.492,13,30,.433,13,14,.929,110,47,92,.511,34,58,.586,13,34,.382,7,9,.778,114
908,UTA,2018-03-25,110,@,GSW,W 110-91,240,42,87,.483,30,59,.508,12,28,.429,14,18,.778,110,38,91,.418,32,76,.421,6,15,.400,9,10,.900,91
909,IND,2018-03-19,110,,LAL,W 110-100,240,43,87,.494,37,66,.561,6,21,.286,18,19,.947,110,38,86,.442,30,53,.566,8,33,.242,16,23,.696,100
910,NYK,2018-03-19,110,,CHI,W 110-92,240,43,96,.448,32,61,.525,11,35,.314,13,17,.765,110,33,92,.359,30,62,.484,3,30,.100,23,31,.742,92
911,MEM,2018-03-15,110,,CHI,L 110-111,240,38,87,.437,25,52,.481,13,35,.371,21,25,.840,110,35,80,.438,20,39,.513,15,41,.366,26,33,.788,111
912,NYK,2018-03-15,110,,PHI,L 110-118,240,45,87,.517,40,67,.597,5,20,.250,15,24,.625,110,41,91,.451,26,54,.481,15,37,.405,21,34,.618,118
913,DAL,2018-03-13,110,@,NYK,W 110-97,240,40,89,.449,26,54,.481,14,35,.400,16,18,.889,110,40,82,.488,32,57,.561,8,25,.320,9,12,.750,97
914,UTA,2018-03-13,110,,DET,W 110-79,240,42,76,.553,29,42,.690,13,34,.382,13,23,.565,110,30,80,.375,25,55,.455,5,25,.200,14,19,.737,79
915,GSW,2018-03-08,110,,SAS,W 110-107,240,41,95,.432,33,65,.508,8,30,.267,20,23,.870,110,43,95,.453,37,73,.507,6,22,.273,15,18,.833,107
916,HOU,2018-03-07,110,@,MIL,W 110-99,240,39,82,.476,25,42,.595,14,40,.350,18,27,.667,110,38,83,.458,29,55,.527,9,28,.321,14,19,.737,99
917,MEM,2018-03-07,110,@,CHI,L 110-119,240,40,82,.488,30,53,.566,10,29,.345,20,25,.800,110,42,79,.532,31,50,.620,11,29,.379,24,32,.750,119
918,PHI,2018-03-04,110,@,MIL,L 110-118,240,39,70,.557,25,42,.595,14,28,.500,18,22,.818,110,47,95,.495,37,72,.514,10,23,.435,14,22,.636,118
919,PHI,2018-03-02,110,,CHO,W 110-99,240,41,81,.506,32,57,.561,9,24,.375,19,25,.760,110,34,81,.420,23,57,.404,11,24,.458,20,32,.625,99
920,PHO,2018-02-28,110,@,MEM,W 110-102,240,38,83,.458,32,62,.516,6,21,.286,28,38,.737,110,33,87,.379,20,56,.357,13,31,.419,23,28,.821,102
921,DAL,2018-02-28,110,,OKC,L 110-111 (OT),265,44,91,.484,31,55,.564,13,36,.361,9,15,.600,110,42,93,.452,32,57,.561,10,36,.278,17,19,.895,111
922,DET,2018-02-28,110,,MIL,W 110-87,240,42,95,.442,33,66,.500,9,29,.310,17,22,.773,110,28,73,.384,20,49,.408,8,24,.333,23,28,.821,87
923,SAS,2018-02-25,110,@,CLE,W 110-94,240,38,86,.442,29,67,.433,9,19,.474,25,32,.781,110,38,91,.418,30,57,.526,8,34,.235,10,14,.714,94
924,BOS,2018-02-23,110,@,DET,W 110-98,240,41,85,.482,24,46,.522,17,39,.436,11,18,.611,110,37,85,.435,27,52,.519,10,33,.303,14,21,.667,98
925,WAS,2018-02-22,110,@,CLE,W 110-103,240,44,92,.478,32,62,.516,12,30,.400,10,10,1.000,110,42,84,.500,34,49,.694,8,35,.229,11,19,.579,103
926,OKC,2018-02-22,110,@,SAC,W 110-107,240,38,86,.442,24,51,.471,14,35,.400,20,24,.833,110,42,91,.462,30,64,.469,12,27,.444,11,15,.733,107
927,OKC,2018-02-11,110,,MEM,W 110-92,240,34,77,.442,18,40,.450,16,37,.432,26,40,.650,110,32,82,.390,26,54,.481,6,28,.214,22,24,.917,92
928,BOS,2018-02-08,110,@,WAS,W 110-104 (OT),265,39,84,.464,30,58,.517,9,26,.346,23,34,.676,110,38,95,.400,26,69,.377,12,26,.462,16,20,.800,104
929,PHO,2018-02-04,110,,CHO,L 110-115,240,41,77,.532,26,48,.542,15,29,.517,13,13,1.000,110,40,96,.417,30,58,.517,10,38,.263,25,29,.862,115
930,ATL,2018-02-02,110,@,BOS,L 110-119,240,34,80,.425,23,49,.469,11,31,.355,31,34,.912,110,45,89,.506,34,65,.523,11,24,.458,18,20,.900,119
931,ATL,2018-01-31,110,,CHO,L 110-123,240,39,77,.506,27,45,.600,12,32,.375,20,22,.909,110,46,90,.511,29,58,.500,17,32,.531,14,18,.778,123
932,DEN,2018-01-29,110,,BOS,L 110-111,240,42,93,.452,32,60,.533,10,33,.303,16,21,.762,110,43,91,.473,26,55,.473,17,36,.472,8,10,.800,111
933,MIL,2018-01-28,110,@,CHI,W 110-96,240,41,77,.532,28,49,.571,13,28,.464,15,25,.600,110,36,87,.414,24,53,.453,12,34,.353,12,15,.800,96
934,ATL,2018-01-26,110,@,CHO,L 110-121,240,37,79,.468,22,49,.449,15,30,.500,21,25,.840,110,40,88,.455,27,54,.500,13,34,.382,28,32,.875,121
935,BRK,2018-01-12,110,@,ATL,W 110-105,240,40,87,.460,27,53,.509,13,34,.382,17,26,.654,110,37,80,.463,26,52,.500,11,28,.393,20,26,.769,105
936,MIL,2018-01-10,110,,ORL,W 110-103,240,45,82,.549,41,63,.651,4,19,.211,16,25,.640,110,39,90,.433,31,61,.508,8,29,.276,17,18,.944,103
937,ATL,2018-01-10,110,@,DEN,W 110-97,240,40,80,.500,28,53,.528,12,27,.444,18,18,1.000,110,38,95,.400,29,58,.500,9,37,.243,12,20,.600,97
938,SAS,2018-01-07,110,@,POR,L 110-111,240,40,81,.494,29,58,.500,11,23,.478,19,26,.731,110,48,92,.522,40,69,.580,8,23,.348,7,10,.700,111
939,MIL,2018-01-06,110,@,WAS,W 110-103,240,39,80,.488,32,58,.552,7,22,.318,25,30,.833,110,37,78,.474,29,57,.509,8,21,.381,21,29,.724,103
940,POR,2018-01-05,110,,ATL,W 110-89,240,43,80,.538,30,50,.600,13,30,.433,11,14,.786,110,30,83,.361,22,57,.386,8,26,.308,21,25,.840,89
941,MIL,2018-01-05,110,,TOR,L 110-129,240,41,77,.532,34,60,.567,7,17,.412,21,29,.724,110,48,86,.558,38,53,.717,10,33,.303,23,28,.821,129
942,POR,2018-01-02,110,@,CLE,L 110-127,240,42,90,.467,29,58,.500,13,32,.406,13,19,.684,110,43,83,.518,30,51,.588,13,32,.406,28,37,.757,127
943,PHO,2017-12-31,110,,PHI,L 110-123,240,37,88,.420,27,61,.443,10,27,.370,26,34,.765,110,43,77,.558,33,53,.623,10,24,.417,27,34,.794,123
944,CHI,2017-12-31,110,@,WAS,L 110-114,240,42,92,.457,34,57,.596,8,35,.229,18,22,.818,110,43,93,.462,27,57,.474,16,36,.444,12,17,.706,114
945,PHI,2017-12-28,110,@,POR,L 110-114,240,42,87,.483,26,55,.473,16,32,.500,10,14,.714,110,35,75,.467,27,51,.529,8,24,.333,36,47,.766,114
946,DAL,2017-12-20,110,,DET,W 110-93,240,40,75,.533,26,45,.578,14,30,.467,16,20,.800,110,33,77,.429,26,53,.491,7,24,.292,20,22,.909,93
947,ATL,2017-12-18,110,,MIA,W 110-104,240,38,83,.458,30,61,.492,8,22,.364,26,31,.839,110,36,79,.456,29,54,.537,7,25,.280,25,30,.833,104
948,ORL,2017-12-17,110,@,DET,L 110-114,240,41,85,.482,24,52,.462,17,33,.515,11,17,.647,110,42,89,.472,25,55,.455,17,34,.500,13,16,.813,114
949,ORL,2017-12-09,110,@,ATL,L 110-117,240,45,92,.489,32,58,.552,13,34,.382,7,8,.875,110,41,80,.513,24,47,.511,17,33,.515,18,25,.720,117
950,LAL,2017-12-09,110,@,CHO,W 110-99,240,43,85,.506,34,58,.586,9,27,.333,15,21,.714,110,41,93,.441,33,68,.485,8,25,.320,9,14,.643,99
951,ORL,2017-12-06,110,,ATL,W 110-106 (OT),265,46,98,.469,40,70,.571,6,28,.214,12,18,.667,110,40,93,.430,29,66,.439,11,27,.407,15,20,.750,106
952,BRK,2017-12-04,110,@,ATL,W 110-90,240,41,85,.482,26,49,.531,15,36,.417,13,15,.867,110,30,82,.366,21,52,.404,9,30,.300,21,27,.778,90
953,CHI,2017-11-30,110,@,DEN,L 110-111,240,44,82,.537,35,58,.603,9,24,.375,13,21,.619,110,38,83,.458,26,52,.500,12,31,.387,23,31,.742,111
954,SAC,2017-11-27,110,@,GSW,W 110-106,240,42,79,.532,33,62,.532,9,17,.529,17,21,.810,110,40,80,.500,24,43,.558,16,37,.432,10,14,.714,106
955,GSW,2017-11-25,110,,NOP,W 110-95,240,39,94,.415,29,61,.475,10,33,.303,22,27,.815,110,34,84,.405,23,53,.434,11,31,.355,16,23,.696,95
956,UTA,2017-11-22,110,,CHI,W 110-80,240,40,86,.465,26,51,.510,14,35,.400,16,19,.842,110,29,78,.372,24,57,.421,5,21,.238,17,20,.850,80
957,BOS,2017-11-20,110,@,DAL,W 110-102 (OT),265,38,84,.452,25,48,.521,13,36,.361,21,26,.808,110,39,96,.406,32,63,.508,7,33,.212,17,20,.850,102
958,BOS,2017-11-18,110,@,ATL,W 110-99,240,39,82,.476,23,48,.479,16,34,.471,16,20,.800,110,37,78,.474,28,54,.519,9,24,.375,16,20,.800,99
959,MIL,2017-11-13,110,,MEM,W 110-103,240,40,82,.488,28,60,.467,12,22,.545,18,25,.720,110,37,76,.487,26,50,.520,11,26,.423,18,21,.857,103
960,WAS,2017-11-13,110,,SAC,W 110-92,240,44,86,.512,33,52,.635,11,34,.324,11,12,.917,110,34,84,.405,22,61,.361,12,23,.522,12,18,.667,92
961,GSW,2017-11-13,110,,ORL,W 110-100,240,44,88,.500,36,65,.554,8,23,.348,14,16,.875,110,37,88,.420,27,56,.482,10,32,.313,16,18,.889,100
962,MIN,2017-11-11,110,@,PHO,L 110-118,240,39,96,.406,35,76,.461,4,20,.200,28,35,.800,110,46,86,.535,36,60,.600,10,26,.385,16,24,.667,118
963,BOS,2017-11-06,110,@,ATL,W 110-107,240,39,81,.481,25,45,.556,14,36,.389,18,22,.818,110,39,81,.481,26,55,.473,13,26,.500,16,20,.800,107
964,UTA,2017-11-05,110,@,HOU,L 110-137,240,38,88,.432,25,54,.463,13,34,.382,21,24,.875,110,48,81,.593,25,42,.595,23,39,.590,18,21,.857,137
965,IND,2017-11-03,110,@,PHI,L 110-121,240,45,97,.464,37,69,.536,8,28,.286,12,19,.632,110,46,92,.500,28,56,.500,18,36,.500,11,14,.786,121
966,LAL,2017-11-02,110,@,POR,L 110-113,240,43,79,.544,39,61,.639,4,18,.222,20,27,.741,110,40,86,.465,31,64,.484,9,22,.409,24,27,.889,113
967,OKC,2017-10-31,110,@,MIL,W 110-91,240,40,81,.494,28,53,.528,12,28,.429,18,21,.857,110,32,77,.416,23,46,.500,9,31,.290,18,22,.818,91
968,DEN,2017-10-30,110,@,NYK,L 110-116,240,35,85,.412,17,44,.386,18,41,.439,22,31,.710,110,41,82,.500,28,50,.560,13,32,.406,21,23,.913,116
969,WAS,2017-10-29,110,@,SAC,W 110-83,240,40,85,.471,23,51,.451,17,34,.500,13,20,.650,110,32,82,.390,26,60,.433,6,22,.273,13,16,.813,83
970,DAL,2017-10-28,110,,PHI,L 110-112,240,38,74,.514,19,34,.559,19,40,.475,15,19,.789,110,43,87,.494,27,52,.519,16,35,.457,10,14,.714,112
971,CHO,2017-10-25,110,,DEN,W 110-93,240,38,81,.469,25,50,.500,13,31,.419,21,26,.808,110,38,100,.380,30,69,.435,8,31,.258,9,15,.600,93
972,BOS,2017-10-24,110,,NYK,W 110-89,240,37,75,.493,23,46,.500,14,29,.483,22,27,.815,110,36,85,.424,35,73,.479,1,12,.083,16,25,.640,89
973,POR,2017-10-21,110,@,MIL,L 110-113,240,34,81,.420,23,53,.434,11,28,.393,31,35,.886,110,42,80,.525,35,62,.565,7,18,.389,22,30,.733,113
974,TOR,2018-04-11,109,@,MIA,L 109-116 (OT),265,42,92,.457,33,62,.532,9,30,.300,16,21,.762,109,46,106,.434,35,80,.438,11,26,.423,13,20,.650,116
975,NYK,2018-04-09,109,,CLE,L 109-123,240,46,87,.529,35,57,.614,11,30,.367,6,12,.500,109,40,85,.471,21,40,.525,19,45,.422,24,28,.857,123
976,PHI,2018-04-08,109,,DAL,W 109-97,240,46,91,.505,38,64,.594,8,27,.296,9,14,.643,109,40,94,.426,29,54,.537,11,40,.275,6,13,.462,97
977,POR,2018-04-03,109,@,DAL,L 109-115,240,39,87,.448,29,47,.617,10,40,.250,21,24,.875,109,42,92,.457,25,48,.521,17,44,.386,14,20,.700,115
978,OKC,2018-04-01,109,@,NOP,W 109-104,240,41,95,.432,32,64,.500,9,31,.290,18,25,.720,109,38,83,.458,27,51,.529,11,32,.344,17,23,.739,104
979,MIA,2018-03-31,109,,BRK,L 109-110 (OT),265,43,95,.453,36,78,.462,7,17,.412,16,21,.762,109,39,91,.429,29,56,.518,10,35,.286,22,28,.786,110
980,NYK,2018-03-31,109,,DET,L 109-115,240,43,91,.473,30,62,.484,13,29,.448,10,12,.833,109,44,85,.518,34,61,.557,10,24,.417,17,22,.773,115
981,IND,2018-03-23,109,,LAC,W 109-104,240,43,93,.462,32,62,.516,11,31,.355,12,14,.857,109,42,76,.553,32,50,.640,10,26,.385,10,14,.714,104
982,LAC,2018-03-20,109,@,MIN,L 109-123,240,40,93,.430,32,69,.464,8,24,.333,21,26,.808,109,45,86,.523,35,61,.574,10,25,.400,23,24,.958,123
983,LAC,2018-03-18,109,,POR,L 109-122,240,40,89,.449,31,66,.470,9,23,.391,20,27,.741,109,46,92,.500,32,63,.508,14,29,.483,16,20,.800,122
984,PHO,2018-03-17,109,,GSW,L 109-124,240,39,82,.476,28,58,.483,11,24,.458,20,29,.690,109,50,95,.526,37,64,.578,13,31,.419,11,14,.786,124
985,WAS,2018-03-17,109,,IND,W 109-102,240,40,74,.541,30,54,.556,10,20,.500,19,23,.826,109,39,86,.453,27,62,.435,12,24,.500,12,15,.800,102
986,CHI,2018-03-17,109,,CLE,L 109-114,240,41,91,.451,25,57,.439,16,34,.471,11,15,.733,109,44,87,.506,31,50,.620,13,37,.351,13,20,.650,114
987,HOU,2018-03-12,109,,SAS,W 109-93,240,39,80,.488,26,36,.722,13,44,.295,18,23,.783,109,33,81,.407,22,53,.415,11,28,.393,16,23,.696,93
988,MIN,2018-03-11,109,,GSW,W 109-103,240,44,95,.463,38,75,.507,6,20,.300,15,21,.714,109,37,91,.407,27,55,.491,10,36,.278,19,21,.905,103
989,MIN,2018-03-08,109,,BOS,L 109-117,240,44,94,.468,32,63,.508,12,31,.387,9,13,.692,109,43,87,.494,32,55,.582,11,32,.344,20,27,.741,117
990,DAL,2018-03-04,109,,NOP,L 109-126,240,40,90,.444,30,67,.448,10,23,.435,19,25,.760,109,49,91,.538,37,65,.569,12,26,.462,16,21,.762,126
991,ATL,2018-03-02,109,,GSW,L 109-114,240,38,86,.442,23,51,.451,15,35,.429,18,20,.900,109,42,79,.532,31,48,.646,11,31,.355,19,22,.864,114
992,GSW,2018-02-28,109,@,WAS,W 109-101,240,37,72,.514,27,48,.563,10,24,.417,25,30,.833,109,36,90,.400,25,58,.431,11,32,.344,18,21,.857,101
993,BOS,2018-02-26,109,,MEM,W 109-98,240,39,86,.453,27,49,.551,12,37,.324,19,27,.704,109,34,78,.436,29,55,.527,5,23,.217,25,32,.781,98
994,DAL,2018-02-26,109,,IND,W 109-103,240,40,88,.455,26,51,.510,14,37,.378,15,18,.833,109,41,87,.471,36,67,.537,5,20,.250,16,23,.696,103
995,WAS,2018-02-25,109,,PHI,W 109-94,240,43,79,.544,31,54,.574,12,25,.480,11,12,.917,109,31,86,.360,22,53,.415,9,33,.273,23,31,.742,94
996,DAL,2018-02-13,109,,SAC,L 109-114,240,38,83,.458,23,43,.535,15,40,.375,18,23,.783,109,47,87,.540,35,58,.603,12,29,.414,8,12,.667,114
997,SAS,2018-02-13,109,@,DEN,L 109-117,240,44,82,.537,38,60,.633,6,22,.273,15,22,.682,109,46,93,.495,36,61,.590,10,32,.313,15,18,.833,117
998,POR,2018-02-08,109,,CHO,W 109-103 (OT),265,41,90,.456,32,59,.542,9,31,.290,18,22,.818,109,38,98,.388,25,65,.385,13,33,.394,14,17,.824,103
999,HOU,2018-02-07,109,@,MIA,W 109-101,240,38,74,.514,26,43,.605,12,31,.387,21,26,.808,109,39,88,.443,26,56,.464,13,32,.406,10,12,.833,101
1000,NOP,2018-02-05,109,,UTA,L 109-133,240,47,93,.505,39,71,.549,8,22,.364,7,13,.538,109,52,89,.584,38,68,.559,14,21,.667,15,17,.882,133
1001,MIA,2018-02-05,109,,ORL,L 109-111,240,40,93,.430,37,70,.529,3,23,.130,26,35,.743,109,41,84,.488,28,54,.519,13,30,.433,16,19,.842,111
1002,MIL,2018-02-04,109,@,BRK,W 109-94,240,42,81,.519,34,62,.548,8,19,.421,17,21,.810,109,37,90,.411,28,61,.459,9,29,.310,11,14,.786,94
1003,TOR,2018-01-30,109,,MIN,W 109-104,240,39,81,.481,30,52,.577,9,29,.310,22,26,.846,109,42,85,.494,37,73,.507,5,12,.417,15,24,.625,104
1004,PHO,2018-01-29,109,@,MEM,L 109-120,240,38,82,.463,31,59,.525,7,23,.304,26,36,.722,109,47,83,.566,36,61,.590,11,22,.500,15,18,.833,120
1005,GSW,2018-01-27,109,,BOS,W 109-105,240,38,84,.452,28,57,.491,10,27,.370,23,26,.885,109,37,85,.435,23,57,.404,14,28,.500,17,24,.708,105
1006,LAC,2018-01-26,109,@,MEM,W 109-100,240,39,80,.488,29,53,.547,10,27,.370,21,29,.724,109,39,81,.481,31,54,.574,8,27,.296,14,18,.778,100
1007,OKC,2018-01-23,109,,BRK,W 109-108,240,40,94,.426,33,69,.478,7,25,.280,22,32,.688,109,37,79,.468,21,41,.512,16,38,.421,18,25,.720,108
1008,MIL,2018-01-22,109,,PHO,W 109-105,240,38,71,.535,33,54,.611,5,17,.294,28,37,.757,109,39,79,.494,30,53,.566,9,26,.346,18,20,.900,105
1009,TOR,2018-01-20,109,@,MIN,L 109-115,240,39,83,.470,27,50,.540,12,33,.364,19,21,.905,109,38,81,.469,31,65,.477,7,16,.438,32,42,.762,115
1010,LAC,2018-01-17,109,,DEN,W 109-104,240,40,87,.460,30,57,.526,10,30,.333,19,31,.613,109,42,97,.433,37,72,.514,5,25,.200,15,18,.833,104
1011,WAS,2018-01-17,109,@,CHO,L 109-133,240,40,82,.488,27,59,.458,13,23,.565,16,23,.696,109,48,98,.490,33,67,.493,15,31,.484,22,26,.846,133
1012,IND,2018-01-15,109,@,UTA,W 109-94,240,41,77,.532,27,51,.529,14,26,.538,13,15,.867,109,36,81,.444,27,48,.563,9,33,.273,13,17,.765,94
1013,IND,2018-01-08,109,,MIL,W 109-96,240,44,79,.557,37,57,.649,7,22,.318,14,20,.700,109,34,74,.459,27,47,.574,7,27,.259,21,27,.778,96
1014,DET,2018-01-08,109,@,NOP,L 109-112,240,41,93,.441,33,66,.500,8,27,.296,19,22,.864,109,46,82,.561,40,60,.667,6,22,.273,14,21,.667,112
1015,SAC,2017-12-27,109,,CLE,W 109-95,240,41,79,.519,29,49,.592,12,30,.400,15,18,.833,109,32,74,.432,20,43,.465,12,31,.387,19,25,.760,95
1016,MEM,2017-12-27,109,@,LAL,W 109-99,240,35,71,.493,30,50,.600,5,21,.238,34,39,.872,109,35,93,.376,27,65,.415,8,28,.286,21,33,.636,99
1017,SAS,2017-12-26,109,,BRK,W 109-97,240,41,80,.513,34,64,.531,7,16,.438,20,24,.833,109,39,93,.419,27,61,.443,12,32,.375,7,9,.778,97
1018,NOP,2017-12-23,109,@,MIA,W 109-94,240,39,73,.534,24,48,.500,15,25,.600,16,19,.842,109,36,85,.424,26,53,.491,10,32,.313,12,15,.800,94
1019,MIL,2017-12-22,109,,CHO,W 109-104,240,41,87,.471,33,58,.569,8,29,.276,19,23,.826,109,39,88,.443,27,62,.435,12,26,.462,14,17,.824,104
1020,PHI,2017-12-21,109,,TOR,L 109-114,240,45,86,.523,36,57,.632,9,29,.310,10,14,.714,109,35,85,.412,23,50,.460,12,35,.343,32,35,.914,114
1021,SAS,2017-12-18,109,,LAC,W 109-91,240,40,82,.488,31,58,.534,9,24,.375,20,25,.800,109,37,84,.440,28,55,.509,9,29,.310,8,16,.500,91
1022,CHO,2017-12-18,109,,NYK,W 109-91,240,43,88,.489,34,68,.500,9,20,.450,14,16,.875,109,36,86,.419,33,68,.485,3,18,.167,16,20,.800,91
1023,IND,2017-12-17,109,@,BRK,W 109-97,240,43,76,.566,35,58,.603,8,18,.444,15,19,.789,109,34,81,.420,22,48,.458,12,33,.364,17,21,.810,97
1024,CLE,2017-12-16,109,,UTA,W 109-100,240,42,79,.532,32,57,.561,10,22,.455,15,17,.882,109,37,81,.457,20,47,.426,17,34,.500,9,14,.643,100
1025,MIL,2017-12-15,109,,CHI,L 109-115,240,40,83,.482,31,50,.620,9,33,.273,20,29,.690,109,42,86,.488,34,64,.531,8,22,.364,23,35,.657,115
1026,SAS,2017-12-15,109,@,HOU,L 109-124,240,46,94,.489,36,68,.529,10,26,.385,7,13,.538,109,43,91,.473,25,41,.610,18,50,.360,20,25,.800,124
1027,PHO,2017-12-13,109,,TOR,L 109-115,240,37,83,.446,29,59,.492,8,24,.333,27,34,.794,109,40,92,.435,31,66,.470,9,26,.346,26,31,.839,115
1028,LAL,2017-12-12,109,@,NYK,L 109-113 (OT),265,42,102,.412,29,67,.433,13,35,.371,12,15,.800,109,48,101,.475,39,79,.494,9,22,.409,8,11,.727,113
1029,NOP,2017-12-08,109,,SAC,L 109-116 (OT),265,41,89,.461,31,61,.508,10,28,.357,17,19,.895,109,47,97,.485,34,67,.507,13,30,.433,9,14,.643,116
1030,MIL,2017-12-08,109,,DAL,W 109-102,240,36,79,.456,28,55,.509,8,24,.333,29,34,.853,109,35,75,.467,25,51,.490,10,24,.417,22,26,.846,102
1031,WAS,2017-12-07,109,@,PHO,W 109-99,240,41,81,.506,33,60,.550,8,21,.381,19,25,.760,109,36,78,.462,29,55,.527,7,23,.304,20,28,.714,99
1032,MIL,2017-12-02,109,,SAC,W 109-104,240,34,69,.493,28,50,.560,6,19,.316,35,42,.833,109,37,77,.481,26,53,.491,11,24,.458,19,21,.905,104
1033,WAS,2017-12-01,109,,DET,W 109-91,240,43,89,.483,36,68,.529,7,21,.333,16,19,.842,109,35,79,.443,26,49,.531,9,30,.300,12,19,.632,91
1034,BRK,2017-11-29,109,@,DAL,W 109-104,240,42,90,.467,31,61,.508,11,29,.379,14,25,.560,109,39,84,.464,30,57,.526,9,27,.333,17,21,.810,104
1035,ORL,2017-11-27,109,@,IND,L 109-121,240,40,92,.435,24,51,.471,16,41,.390,13,16,.813,109,42,79,.532,27,53,.509,15,26,.577,22,26,.846,121
1036,MIA,2017-11-24,109,@,MIN,W 109-97,240,38,80,.475,19,41,.463,19,39,.487,14,16,.875,109,37,84,.440,30,67,.448,7,17,.412,16,26,.615,97
1037,BRK,2017-11-22,109,@,CLE,L 109-119,240,42,81,.519,28,44,.636,14,37,.378,11,16,.688,109,43,82,.524,29,48,.604,14,34,.412,19,27,.704,119
1038,DEN,2017-11-19,109,@,LAL,L 109-127,240,36,84,.429,23,53,.434,13,31,.419,24,35,.686,109,53,100,.530,41,68,.603,12,32,.375,9,16,.563,127
1039,LAL,2017-11-15,109,,PHI,L 109-115,240,42,109,.385,39,82,.476,3,27,.111,22,27,.815,109,42,86,.488,35,54,.648,7,32,.219,24,30,.800,115
1040,BOS,2017-11-14,109,@,BRK,W 109-102,240,39,86,.453,30,59,.508,9,27,.333,22,27,.815,109,39,88,.443,25,53,.472,14,35,.400,10,16,.625,102
1041,PHI,2017-11-13,109,@,LAC,W 109-105,240,38,77,.494,31,45,.689,7,32,.219,26,35,.743,109,36,82,.439,24,50,.480,12,32,.375,21,32,.656,105
1042,MIN,2017-11-13,109,@,UTA,W 109-98,240,37,71,.521,27,51,.529,10,20,.500,25,29,.862,109,37,84,.440,23,44,.523,14,40,.350,10,11,.909,98
1043,SAC,2017-11-09,109,,PHI,W 109-108,240,40,93,.430,28,66,.424,12,27,.444,17,28,.607,109,37,87,.425,22,50,.440,15,37,.405,19,27,.704,108
1044,TOR,2017-11-03,109,@,UTA,W 109-100,240,38,71,.535,27,41,.659,11,30,.367,22,28,.786,109,35,80,.438,27,57,.474,8,23,.348,22,24,.917,100
1045,ATL,2017-11-01,109,@,PHI,L 109-119,240,41,94,.436,33,71,.465,8,23,.348,19,27,.704,109,46,99,.465,33,64,.516,13,35,.371,14,25,.560,119
1046,HOU,2017-10-27,109,@,CHO,W 109-93,240,38,85,.447,16,28,.571,22,57,.386,11,13,.846,109,33,88,.375,22,59,.373,11,29,.379,16,28,.571,93
1047,WAS,2017-10-23,109,@,DEN,W 109-104,240,37,84,.440,28,54,.519,9,30,.300,26,28,.929,109,39,80,.488,31,57,.544,8,23,.348,18,23,.783,104
1048,CHO,2017-10-20,109,,ATL,W 109-91,240,37,86,.430,26,50,.520,11,36,.306,24,30,.800,109,36,95,.379,29,65,.446,7,30,.233,12,14,.857,91
1049,MIA,2017-10-18,109,@,ORL,L 109-116,240,44,101,.436,36,71,.507,8,30,.267,13,17,.765,109,43,90,.478,35,69,.507,8,21,.381,22,29,.759,116
1050,TOR,2018-04-09,108,@,DET,W 108-98,240,46,87,.529,34,48,.708,12,39,.308,4,4,1.000,108,35,78,.449,26,48,.542,9,30,.300,19,25,.760,98
1051,OKC,2018-04-07,108,@,HOU,W 108-102,240,36,91,.396,26,58,.448,10,33,.303,26,33,.788,108,36,76,.474,22,39,.564,14,37,.378,16,23,.696,102
1052,DET,2018-04-04,108,,PHI,L 108-115,240,39,88,.443,23,52,.442,16,36,.444,14,23,.609,108,44,89,.494,31,59,.525,13,30,.433,14,19,.737,115
1053,DET,2018-04-01,108,@,BRK,W 108-96,240,38,84,.452,31,65,.477,7,19,.368,25,32,.781,108,37,87,.425,25,44,.568,12,43,.279,10,15,.667,96
1054,MEM,2018-03-28,108,,POR,W 108-103,240,41,84,.488,28,59,.475,13,25,.520,13,23,.565,108,38,79,.481,30,49,.612,8,30,.267,19,30,.633,103
1055,POR,2018-03-25,108,@,OKC,W 108-105,240,42,90,.467,33,56,.589,9,34,.265,15,19,.789,108,37,84,.440,29,57,.509,8,27,.296,23,28,.821,105
1056,MIN,2018-03-24,108,@,PHI,L 108-120,240,37,96,.385,31,73,.425,6,23,.261,28,38,.737,108,42,88,.477,29,51,.569,13,37,.351,23,36,.639,120
1057,MIN,2018-03-23,108,@,NYK,W 108-104,240,35,75,.467,25,49,.510,10,26,.385,28,32,.875,108,40,92,.435,28,64,.438,12,28,.429,12,17,.706,104
1058,DEN,2018-03-23,108,@,WAS,W 108-100,240,37,85,.435,20,51,.392,17,34,.500,17,18,.944,108,38,80,.475,24,52,.462,14,28,.500,10,14,.714,100
1059,PHI,2018-03-19,108,,CHO,W 108-94,240,42,93,.452,24,49,.490,18,44,.409,6,8,.750,108,32,84,.381,26,62,.419,6,22,.273,24,30,.800,94
1060,NOP,2018-03-18,108,,BOS,W 108-89,240,41,82,.500,35,64,.547,6,18,.333,20,25,.800,108,35,87,.402,26,61,.426,9,26,.346,10,20,.500,89
1061,SAS,2018-03-13,108,,ORL,W 108-72,240,40,84,.476,31,65,.477,9,19,.474,19,23,.826,108,28,82,.341,21,59,.356,7,23,.304,9,9,1.000,72
1062,TOR,2018-03-09,108,,HOU,W 108-105,240,41,85,.482,26,47,.553,15,38,.395,11,14,.786,108,40,81,.494,31,54,.574,9,27,.333,16,23,.696,105
1063,GSW,2018-03-09,108,@,POR,L 108-125,240,38,78,.487,26,50,.520,12,28,.429,20,24,.833,108,44,89,.494,28,50,.560,16,39,.410,21,27,.778,125
1064,MIA,2018-03-08,108,,PHI,W 108-99,240,42,89,.472,28,63,.444,14,26,.538,10,18,.556,108,34,86,.395,19,49,.388,15,37,.405,16,21,.762,99
1065,LAL,2018-03-07,108,,ORL,W 108-107,240,43,88,.489,32,55,.582,11,33,.333,11,12,.917,108,42,84,.500,30,56,.536,12,28,.429,11,19,.579,107
1066,DEN,2018-03-07,108,,CLE,L 108-113,240,42,86,.488,32,59,.542,10,27,.370,14,18,.778,108,44,87,.506,31,58,.534,13,29,.448,12,18,.667,113
1067,POR,2018-03-05,108,@,LAL,W 108-103,240,35,83,.422,25,60,.417,10,23,.435,28,38,.737,108,34,87,.391,23,50,.460,11,37,.297,24,31,.774,103
1068,POR,2018-03-03,108,,OKC,W 108-100,240,39,88,.443,28,55,.509,11,33,.333,19,23,.826,108,40,91,.440,34,64,.531,6,27,.222,14,21,.667,100
1069,CHI,2018-03-02,108,,DAL,W 108-100,240,42,89,.472,32,62,.516,10,27,.370,14,20,.700,108,35,84,.417,22,55,.400,13,29,.448,17,21,.810,100
1070,MIN,2018-03-02,108,@,UTA,L 108-116,240,38,74,.514,29,57,.509,9,17,.529,23,31,.742,108,40,78,.513,31,49,.633,9,29,.310,27,35,.771,116
1071,DEN,2018-03-02,108,@,MEM,W 108-102,240,40,73,.548,34,51,.667,6,22,.273,22,26,.846,108,40,91,.440,30,64,.469,10,27,.370,12,15,.800,102
1072,PHI,2018-03-01,108,@,CLE,W 108-97,240,40,90,.444,30,60,.500,10,30,.333,18,27,.667,108,36,87,.414,27,55,.491,9,32,.281,16,23,.696,97
1073,POR,2018-03-01,108,,MIN,W 108-99,240,36,92,.391,27,62,.435,9,30,.300,27,35,.771,108,38,85,.447,34,65,.523,4,20,.200,19,21,.905,99
1074,SAC,2018-02-24,108,,LAL,L 108-113,240,42,94,.447,29,69,.420,13,25,.520,11,17,.647,108,41,91,.451,24,53,.453,17,38,.447,14,20,.700,113
1075,IND,2018-02-14,108,@,BRK,W 108-103,240,39,90,.433,33,75,.440,6,15,.400,24,28,.857,108,35,83,.422,22,48,.458,13,35,.371,20,27,.741,103
1076,MIN,2018-02-13,108,,HOU,L 108-126,240,40,84,.476,34,61,.557,6,23,.261,22,23,.957,108,41,83,.494,19,36,.528,22,47,.468,22,29,.759,126
1077,PHI,2018-02-12,108,,NYK,W 108-92,240,41,75,.547,31,56,.554,10,19,.526,16,24,.667,108,31,79,.392,25,55,.455,6,24,.250,24,28,.857,92
1078,LAC,2018-02-09,108,@,DET,W 108-95,240,42,91,.462,32,61,.525,10,30,.333,14,15,.933,108,36,88,.409,26,57,.456,10,31,.323,13,17,.765,95
1079,ATL,2018-02-06,108,,MEM,W 108-82,240,42,83,.506,34,58,.586,8,25,.320,16,21,.762,108,34,79,.430,30,57,.526,4,22,.182,10,13,.769,82
1080,LAL,2018-02-04,108,@,OKC,W 108-104,240,42,86,.488,29,56,.518,13,30,.433,11,18,.611,108,40,89,.449,33,64,.516,7,25,.280,17,25,.680,104
1081,GSW,2018-02-03,108,@,DEN,L 108-115,240,43,86,.500,35,55,.636,8,31,.258,14,23,.609,108,39,91,.429,27,62,.435,12,29,.414,25,29,.862,115
1082,MIN,2018-02-01,108,,MIL,W 108-89,240,42,78,.538,35,59,.593,7,19,.368,17,20,.850,108,32,85,.376,26,56,.464,6,29,.207,19,25,.760,89
1083,PHI,2018-01-31,108,@,BRK,L 108-116,240,36,76,.474,29,58,.500,7,18,.389,29,34,.853,108,39,77,.506,26,45,.578,13,32,.406,25,28,.893,116
1084,CHI,2018-01-31,108,@,POR,L 108-124,240,41,99,.414,28,65,.431,13,34,.382,13,22,.591,108,46,82,.561,31,50,.620,15,32,.469,17,20,.850,124
1085,DET,2018-01-27,108,,OKC,L 108-121,240,39,84,.464,27,51,.529,12,33,.364,18,24,.750,108,45,93,.484,31,60,.517,14,33,.424,17,23,.739,121
1086,IND,2018-01-26,108,@,CLE,L 108-115,240,43,91,.473,30,60,.500,13,31,.419,9,11,.818,108,46,82,.561,33,45,.733,13,37,.351,10,13,.769,115
1087,LAL,2018-01-26,108,@,CHI,W 108-103,240,41,91,.451,36,67,.537,5,24,.208,21,28,.750,108,35,93,.376,18,57,.316,17,36,.472,16,24,.667,103
1088,TOR,2018-01-24,108,@,ATL,W 108-93,240,39,89,.438,25,53,.472,14,36,.389,16,25,.640,108,37,94,.394,30,73,.411,7,21,.333,12,17,.706,93
1089,SAS,2018-01-24,108,@,MEM,W 108-85,240,38,82,.463,28,58,.483,10,24,.417,22,25,.880,108,36,83,.434,34,65,.523,2,18,.111,11,14,.786,85
1090,LAL,2018-01-23,108,,BOS,W 108-107,240,40,91,.440,33,65,.508,7,26,.269,21,36,.583,108,42,90,.467,27,46,.587,15,44,.341,8,10,.800,107
1091,BRK,2018-01-23,108,@,OKC,L 108-109,240,37,79,.468,21,41,.512,16,38,.421,18,25,.720,108,40,94,.426,33,69,.478,7,25,.280,22,32,.688,109
1092,GSW,2018-01-20,108,@,HOU,L 108-116,240,40,82,.488,23,46,.500,17,36,.472,11,15,.733,108,41,87,.471,27,50,.540,14,37,.378,20,29,.690,116
1093,DAL,2018-01-20,108,@,POR,L 108-117,240,38,83,.458,28,58,.483,10,25,.400,22,28,.786,108,45,86,.523,27,50,.540,18,36,.500,9,10,.900,117
1094,PHO,2018-01-19,108,@,DEN,W 108-100,240,40,81,.494,26,48,.542,14,33,.424,14,20,.700,108,35,78,.449,21,42,.500,14,36,.389,16,21,.762,100
1095,ORL,2018-01-16,108,,MIN,W 108-102,240,40,90,.444,29,59,.492,11,31,.355,17,19,.895,108,43,98,.439,36,82,.439,7,16,.438,9,10,.900,102
1096,CLE,2018-01-15,108,,GSW,L 108-118,240,43,94,.457,36,66,.545,7,28,.250,15,22,.682,108,41,85,.482,29,53,.547,12,32,.375,24,30,.800,118
1097,NYK,2018-01-12,108,@,MIN,L 108-118,240,45,83,.542,33,59,.559,12,24,.500,6,9,.667,108,49,95,.516,39,68,.574,10,27,.370,10,16,.625,118
1098,GSW,2018-01-12,108,@,MIL,W 108-94,240,44,79,.557,39,64,.609,5,15,.333,15,18,.833,108,36,85,.424,25,57,.439,11,28,.393,11,12,.917,94
1099,LAC,2018-01-08,108,,ATL,W 108-107,240,38,85,.447,29,67,.433,9,18,.500,23,34,.676,108,38,96,.396,28,59,.475,10,37,.270,21,29,.724,107
1100,DET,2018-01-06,108,,HOU,W 108-101,240,38,75,.507,26,50,.520,12,25,.480,20,27,.741,108,38,90,.422,23,43,.535,15,47,.319,10,11,.909,101
1101,CHO,2018-01-05,108,@,LAL,W 108-94,240,42,99,.424,30,66,.455,12,33,.364,12,16,.750,108,38,94,.404,29,58,.500,9,36,.250,9,12,.750,94
1102,NOP,2018-01-03,108,@,UTA,W 108-98,240,41,82,.500,27,52,.519,14,30,.467,12,12,1.000,108,38,84,.452,31,52,.596,7,32,.219,15,17,.882,98
1103,BOS,2017-12-31,108,,BRK,W 108-105,240,39,79,.494,25,46,.543,14,33,.424,16,25,.640,108,39,95,.411,28,59,.475,11,36,.306,16,19,.842,105
1104,SAS,2017-12-23,108,@,SAC,W 108-99,240,44,88,.500,33,65,.508,11,23,.478,9,11,.818,108,40,86,.465,28,64,.438,12,22,.545,7,11,.636,99
1105,LAC,2017-12-20,108,,PHO,W 108-95,240,41,87,.471,31,57,.544,10,30,.333,16,24,.667,108,35,97,.361,27,62,.435,8,35,.229,17,19,.895,95
1106,MIN,2017-12-18,108,,POR,W 108-107,240,42,91,.462,35,72,.486,7,19,.368,17,21,.810,108,46,84,.548,36,60,.600,10,24,.417,5,5,1.000,107
1107,TOR,2017-12-17,108,,SAC,W 108-93,240,36,85,.424,23,55,.418,13,30,.433,23,28,.821,108,38,81,.469,27,55,.491,11,26,.423,6,8,.750,93
1108,PHO,2017-12-16,108,@,MIN,W 108-106,240,33,72,.458,22,48,.458,11,24,.458,31,35,.886,108,40,95,.421,31,68,.456,9,27,.333,17,24,.708,106
1109,MIL,2017-12-13,108,@,NOP,L 108-115,240,44,95,.463,36,68,.529,8,27,.296,12,19,.632,108,45,80,.563,32,55,.582,13,25,.520,12,15,.800,115
1110,HOU,2017-12-13,108,,CHO,W 108-96,240,39,88,.443,22,43,.512,17,45,.378,13,19,.684,108,36,87,.414,32,66,.485,4,21,.190,20,27,.741,96
1111,CHI,2017-12-11,108,,BOS,W 108-85,240,39,81,.481,27,52,.519,12,29,.414,18,25,.720,108,33,83,.398,23,43,.535,10,40,.250,9,14,.643,85
1112,PHI,2017-12-02,108,,DET,W 108-103,240,35,86,.407,25,58,.431,10,28,.357,28,32,.875,108,34,78,.436,25,47,.532,9,31,.290,26,32,.813,103
1113,DAL,2017-12-02,108,,LAC,W 108-82,240,36,79,.456,20,44,.455,16,35,.457,20,26,.769,108,30,86,.349,24,64,.375,6,22,.273,16,23,.696,82
1114,NOP,2017-12-01,108,@,UTA,L 108-114,240,42,87,.483,27,57,.474,15,30,.500,9,15,.600,108,42,85,.494,30,55,.545,12,30,.400,18,25,.720,114
1115,BOS,2017-11-30,108,,PHI,W 108-97,240,40,79,.506,28,50,.560,12,29,.414,16,20,.800,108,35,84,.417,19,52,.365,16,32,.500,11,18,.611,97
1116,OKC,2017-11-29,108,@,ORL,L 108-121,240,38,96,.396,26,64,.406,12,32,.375,20,30,.667,108,45,76,.592,32,46,.696,13,30,.433,18,26,.692,121
1117,CLE,2017-11-28,108,,MIA,W 108-97,240,40,81,.494,29,48,.604,11,33,.333,17,23,.739,108,37,84,.440,27,53,.509,10,31,.323,13,20,.650,97
1118,BOS,2017-11-27,108,,DET,L 108-118,240,40,77,.519,24,44,.545,16,33,.485,12,21,.571,108,44,85,.518,33,60,.550,11,25,.440,19,23,.826,118
1119,DAL,2017-11-27,108,@,SAS,L 108-115,240,41,85,.482,27,53,.509,14,32,.438,12,17,.706,108,43,82,.524,33,58,.569,10,24,.417,19,21,.905,115
1120,PHO,2017-11-26,108,@,MIN,L 108-119,240,43,85,.506,30,59,.508,13,26,.500,9,12,.750,108,49,93,.527,40,72,.556,9,21,.429,12,17,.706,119
1121,POR,2017-11-25,108,@,WAS,W 108-105,240,41,80,.513,32,56,.571,9,24,.375,17,22,.773,108,41,89,.461,33,66,.500,8,23,.348,15,16,.938,105
1122,MIL,2017-11-25,108,@,UTA,L 108-121,240,41,77,.532,33,56,.589,8,21,.381,18,23,.783,108,46,81,.568,28,49,.571,18,32,.563,11,19,.579,121
1123,BOS,2017-11-25,108,@,IND,W 108-98,240,45,80,.563,35,55,.636,10,25,.400,8,9,.889,108,38,78,.487,31,55,.564,7,23,.304,15,15,1.000,98
1124,OKC,2017-11-22,108,,GSW,W 108-91,240,41,90,.456,33,65,.508,8,25,.320,18,26,.692,108,33,80,.413,23,49,.469,10,31,.323,15,18,.833,91
1125,NYK,2017-11-22,108,,TOR,W 108-100,240,43,93,.462,35,69,.507,8,24,.333,14,17,.824,108,37,87,.425,23,49,.469,14,38,.368,12,18,.667,100
1126,PHI,2017-11-09,108,@,SAC,L 108-109,240,37,87,.425,22,50,.440,15,37,.405,19,27,.704,108,40,93,.430,28,66,.424,12,27,.444,17,28,.607,109
1127,NYK,2017-11-05,108,,IND,W 108-101,240,44,88,.500,38,65,.585,6,23,.261,14,19,.737,108,37,79,.468,25,54,.463,12,25,.480,15,17,.882,101
1128,DEN,2017-11-04,108,,GSW,L 108-127,240,40,87,.460,34,63,.540,6,24,.250,22,27,.815,108,50,91,.549,32,51,.627,18,40,.450,9,17,.529,127
1129,DET,2017-11-04,108,,SAC,W 108-99,240,40,79,.506,27,55,.491,13,24,.542,15,22,.682,108,40,76,.526,30,55,.545,10,21,.476,9,13,.692,99
1130,SAS,2017-11-03,108,,CHO,W 108-101,240,39,83,.470,30,56,.536,9,27,.333,21,26,.808,108,33,80,.413,25,56,.446,8,24,.333,27,42,.643,101
1131,BOS,2017-10-30,108,,SAS,W 108-94,240,42,88,.477,31,57,.544,11,31,.355,13,16,.813,108,36,87,.414,24,61,.393,12,26,.462,10,20,.500,94
1132,IND,2017-10-21,108,@,MIA,L 108-112,240,43,96,.448,36,77,.468,7,19,.368,15,21,.714,108,45,87,.517,31,53,.585,14,34,.412,8,14,.571,112
1133,LAC,2017-10-19,108,@,LAL,W 108-92,240,42,107,.393,30,74,.405,12,33,.364,12,13,.923,108,37,91,.407,33,75,.440,4,16,.250,14,23,.609,92
1134,MIL,2017-10-18,108,@,BOS,W 108-100,240,38,76,.500,31,55,.564,7,21,.333,25,30,.833,108,39,91,.429,28,63,.444,11,28,.393,11,21,.524,100
1135,OKC,2018-04-03,107,,GSW,L 107-111,240,35,93,.376,26,55,.473,9,38,.237,28,37,.757,107,41,83,.494,33,54,.611,8,29,.276,21,24,.875,111
1136,DEN,2018-04-03,107,,IND,W 107-104,240,41,89,.461,31,57,.544,10,32,.313,15,20,.750,107,41,84,.488,32,65,.492,9,19,.474,13,16,.813,104
1137,PHO,2018-04-01,107,@,GSW,L 107-117,240,41,90,.456,30,59,.508,11,31,.355,14,16,.875,107,48,89,.539,35,61,.574,13,28,.464,8,9,.889,117
1138,WAS,2018-03-31,107,,CHO,W 107-93,240,40,88,.455,22,49,.449,18,39,.462,9,12,.750,107,35,77,.455,29,54,.537,6,23,.261,17,27,.630,93
1139,UTA,2018-03-30,107,,MEM,W 107-97,240,40,74,.541,28,43,.651,12,31,.387,15,26,.577,107,39,81,.481,30,58,.517,9,23,.391,10,15,.667,97
1140,CLE,2018-03-30,107,,NOP,W 107-102,240,43,90,.478,33,66,.500,10,24,.417,11,15,.733,107,43,89,.483,32,63,.508,11,26,.423,5,6,.833,102
1141,GSW,2018-03-29,107,,MIL,L 107-116,240,41,75,.547,31,55,.564,10,20,.500,15,15,1.000,107,48,87,.552,37,67,.552,11,20,.550,9,10,.900,116
1142,POR,2018-03-27,107,@,NOP,W 107-103,240,44,105,.419,34,73,.466,10,32,.313,9,10,.900,107,43,94,.457,39,70,.557,4,24,.167,13,14,.929,103
1143,MIA,2018-03-25,107,@,IND,L 107-113 (OT),265,41,86,.477,27,51,.529,14,35,.400,11,14,.786,107,44,90,.489,36,67,.537,8,23,.348,17,21,.810,113
1144,HOU,2018-03-17,107,@,NOP,W 107-101,240,39,93,.419,24,52,.462,15,41,.366,14,18,.778,107,41,83,.494,33,59,.559,8,24,.333,11,12,.917,101
1145,PHO,2018-03-13,107,,CLE,L 107-129,240,38,98,.388,32,66,.485,6,32,.188,25,30,.833,107,43,87,.494,26,52,.500,17,35,.486,26,30,.867,129
1146,ATL,2018-03-13,107,,OKC,L 107-119,240,37,87,.425,24,56,.429,13,31,.419,20,24,.833,107,42,89,.472,26,54,.481,16,35,.457,19,25,.760,119
1147,SAS,2018-03-08,107,@,GSW,L 107-110,240,43,95,.453,37,73,.507,6,22,.273,15,18,.833,107,41,95,.432,33,65,.508,8,30,.267,20,23,.870,110
1148,ORL,2018-03-07,107,@,LAL,L 107-108,240,42,84,.500,30,56,.536,12,28,.429,11,19,.579,107,43,88,.489,32,55,.582,11,33,.333,11,12,.917,108
1149,DEN,2018-03-06,107,@,DAL,L 107-118,240,38,92,.413,27,56,.482,11,36,.306,20,26,.769,107,43,90,.478,28,63,.444,15,27,.556,17,23,.739,118
1150,ORL,2018-03-03,107,,MEM,W 107-100,240,36,72,.500,28,47,.596,8,25,.320,27,33,.818,107,38,93,.409,32,71,.451,6,22,.273,18,26,.692,100
1151,ATL,2018-02-28,107,,IND,W 107-102,240,38,87,.437,29,58,.500,9,29,.310,22,27,.815,107,38,90,.422,27,58,.466,11,32,.344,15,20,.750,102
1152,WAS,2018-02-27,107,@,MIL,W 107-104,240,42,88,.477,35,68,.515,7,20,.350,16,22,.727,107,35,77,.455,25,51,.490,10,26,.385,24,28,.857,104
1153,SAC,2018-02-22,107,,OKC,L 107-110,240,42,91,.462,30,64,.469,12,27,.444,11,15,.733,107,38,86,.442,24,51,.471,14,35,.400,20,24,.833,110
1154,UTA,2018-02-14,107,,PHO,W 107-97,240,39,92,.424,29,58,.500,10,34,.294,19,22,.864,107,34,79,.430,22,50,.440,12,29,.414,17,24,.708,97
1155,ATL,2018-02-09,107,,CLE,L 107-123,240,37,83,.446,21,39,.538,16,44,.364,17,19,.895,107,46,86,.535,31,51,.608,15,35,.429,16,24,.667,123
1156,NOP,2018-02-03,107,@,MIN,L 107-118,240,42,101,.416,34,68,.500,8,33,.242,15,17,.882,107,48,95,.505,38,74,.514,10,21,.476,12,16,.750,118
1157,MIA,2018-02-03,107,@,DET,L 107-111,240,44,91,.484,30,55,.545,14,36,.389,5,7,.714,107,44,84,.524,35,58,.603,9,26,.346,14,17,.824,111
1158,ORL,2018-01-30,107,@,HOU,L 107-114,240,42,83,.506,27,52,.519,15,31,.484,8,10,.800,107,39,77,.506,26,42,.619,13,35,.371,23,28,.821,114
1159,MIL,2018-01-29,107,,PHI,W 107-95,240,38,80,.475,27,52,.519,11,28,.393,20,22,.909,107,36,82,.439,34,56,.607,2,26,.077,21,23,.913,95
1160,NYK,2018-01-26,107,@,PHO,W 107-85,240,41,85,.482,32,60,.533,9,25,.360,16,22,.727,107,33,94,.351,22,61,.361,11,33,.333,8,13,.615,85
1161,POR,2018-01-26,107,@,DAL,W 107-93,240,39,79,.494,29,49,.592,10,30,.333,19,23,.826,107,35,89,.393,25,59,.424,10,30,.333,13,17,.765,93
1162,BOS,2018-01-23,107,@,LAL,L 107-108,240,42,90,.467,27,46,.587,15,44,.341,8,10,.800,107,40,91,.440,33,65,.508,7,26,.269,21,36,.583,108
1163,SAC,2018-01-22,107,@,CHO,L 107-112,240,43,97,.443,33,75,.440,10,22,.455,11,15,.733,107,38,86,.442,22,46,.478,16,40,.400,20,25,.800,112
1164,NYK,2018-01-21,107,@,LAL,L 107-127,240,44,81,.543,32,56,.571,12,25,.480,7,10,.700,107,51,91,.560,41,65,.631,10,26,.385,15,21,.714,127
1165,DET,2018-01-15,107,,CHO,L 107-118,240,42,86,.488,27,57,.474,15,29,.517,8,11,.727,107,43,84,.512,33,63,.524,10,21,.476,22,33,.667,118
1166,LAL,2018-01-13,107,@,DAL,W 107-101 (OT),265,43,95,.453,35,69,.507,8,26,.308,13,18,.722,107,34,90,.378,23,47,.489,11,43,.256,22,28,.786,101
1167,CHI,2018-01-13,107,,DET,W 107-105,240,42,87,.483,25,51,.490,17,36,.472,6,9,.667,107,41,92,.446,29,63,.460,12,29,.414,11,14,.786,105
1168,UTA,2018-01-10,107,@,WAS,W 107-104,240,43,92,.467,32,59,.542,11,33,.333,10,13,.769,107,41,78,.526,31,53,.585,10,25,.400,12,17,.706,104
1169,ATL,2018-01-08,107,@,LAC,L 107-108,240,38,96,.396,28,59,.475,10,37,.270,21,29,.724,107,38,85,.447,29,67,.433,9,18,.500,23,34,.676,108
1170,CHI,2018-01-08,107,,HOU,L 107-116,240,40,86,.465,28,58,.483,12,28,.429,15,18,.833,107,39,86,.453,19,32,.594,20,54,.370,18,24,.750,116
1171,SAS,2018-01-08,107,@,SAC,W 107-100,240,44,90,.489,33,64,.516,11,26,.423,8,13,.615,107,40,82,.488,32,59,.542,8,23,.348,12,16,.750,100
1172,MIA,2018-01-05,107,,NYK,W 107-103 (OT),265,38,94,.404,26,52,.500,12,42,.286,19,20,.950,107,39,80,.488,34,67,.507,5,13,.385,20,23,.870,103
1173,MIN,2017-12-31,107,@,IND,W 107-90,240,41,86,.477,37,67,.552,4,19,.211,21,25,.840,107,33,85,.388,23,60,.383,10,25,.400,14,18,.778,90
1174,PHI,2017-12-30,107,@,DEN,W 107-102,240,45,93,.484,37,69,.536,8,24,.333,9,10,.900,107,35,87,.402,28,55,.509,7,32,.219,25,34,.735,102
1175,IND,2017-12-29,107,@,CHI,L 107-119,240,43,93,.462,36,71,.507,7,22,.318,14,20,.700,107,43,85,.506,25,46,.543,18,39,.462,15,15,1.000,119
1176,NYK,2017-12-28,107,@,SAS,L 107-119,240,41,90,.456,36,76,.474,5,14,.357,20,22,.909,107,41,80,.513,32,60,.533,9,20,.450,28,39,.718,119
1177,TOR,2017-12-27,107,@,OKC,L 107-124,240,36,85,.424,25,47,.532,11,38,.289,24,26,.923,107,46,87,.529,37,62,.597,9,25,.360,23,33,.697,124
1178,DEN,2017-12-26,107,,UTA,W 107-83,240,39,81,.481,28,51,.549,11,30,.367,18,22,.818,107,27,84,.321,17,49,.347,10,35,.286,19,23,.826,83
1179,MIA,2017-12-26,107,,ORL,W 107-89,240,41,91,.451,30,58,.517,11,33,.333,14,17,.824,107,33,81,.407,28,61,.459,5,20,.250,18,22,.818,89
1180,DET,2017-12-26,107,,IND,W 107-83,240,41,82,.500,29,48,.604,12,34,.353,13,16,.813,107,34,77,.442,28,56,.500,6,21,.286,9,13,.692,83
1181,HOU,2017-12-25,107,@,OKC,L 107-112,240,35,81,.432,23,44,.523,12,37,.324,25,31,.806,107,43,79,.544,35,61,.574,8,18,.444,18,23,.783,112
1182,DAL,2017-12-23,107,@,ATL,L 107-112,240,43,85,.506,34,52,.654,9,33,.273,12,15,.800,107,42,75,.560,32,51,.627,10,24,.417,18,22,.818,112
1183,OKC,2017-12-20,107,,UTA,W 107-79,240,40,77,.519,32,54,.593,8,23,.348,19,22,.864,107,26,73,.356,19,42,.452,7,31,.226,20,27,.741,79
1184,POR,2017-12-18,107,@,MIN,L 107-108,240,46,84,.548,36,60,.600,10,24,.417,5,5,1.000,107,42,91,.462,35,72,.486,7,19,.368,17,21,.810,108
1185,UTA,2017-12-15,107,@,BOS,W 107-95,240,40,83,.482,27,58,.466,13,25,.520,14,18,.778,107,35,86,.407,26,55,.473,9,31,.290,16,19,.842,95
1186,MIA,2017-12-11,107,@,MEM,W 107-82,240,37,66,.561,23,39,.590,14,27,.519,19,24,.792,107,28,72,.389,20,45,.444,8,27,.296,18,27,.667,82
1187,ATL,2017-12-10,107,@,NYK,L 107-111,240,37,77,.481,28,46,.609,9,31,.290,24,30,.800,107,39,80,.488,34,63,.540,5,17,.294,28,34,.824,111
1188,MEM,2017-12-08,107,,TOR,L 107-116,240,41,82,.500,32,55,.582,9,27,.333,16,22,.727,107,37,78,.474,24,47,.511,13,31,.419,29,33,.879,116
1189,LAL,2017-12-07,107,@,PHI,W 107-104,240,42,96,.438,31,68,.456,11,28,.393,12,24,.500,107,39,81,.481,29,55,.527,10,26,.385,16,21,.762,104
1190,LAC,2017-12-06,107,,MIN,L 107-113,240,44,99,.444,34,67,.507,10,32,.313,9,15,.600,107,45,82,.549,38,63,.603,7,19,.368,16,21,.762,113
1191,MIN,2017-12-01,107,@,OKC,L 107-111,240,39,76,.513,27,52,.519,12,24,.500,17,21,.810,107,41,79,.519,33,53,.623,8,26,.308,21,22,.955,111
1192,SAC,2017-12-01,107,@,CHI,W 107-106,240,45,85,.529,39,67,.582,6,18,.333,11,14,.786,107,42,90,.467,29,54,.537,13,36,.361,9,13,.692,106
1193,LAC,2017-11-30,107,,UTA,L 107-126,240,38,70,.543,28,41,.683,10,29,.345,21,30,.700,107,49,85,.576,32,50,.640,17,35,.486,11,14,.786,126
1194,PHO,2017-11-29,107,@,DET,L 107-131,240,39,84,.464,32,62,.516,7,22,.318,22,28,.786,107,51,89,.573,38,61,.623,13,28,.464,16,21,.762,131
1195,IND,2017-11-24,107,,TOR,W 107-104,240,38,83,.458,27,57,.474,11,26,.423,20,27,.741,107,40,81,.494,31,51,.608,9,30,.300,15,20,.750,104
1196,PHO,2017-11-22,107,,MIL,L 107-113 (OT),265,37,93,.398,30,71,.423,7,22,.318,26,33,.788,107,42,97,.433,34,68,.500,8,29,.276,21,31,.677,113
1197,NOP,2017-11-22,107,,SAS,W 107-90,240,39,81,.481,32,57,.561,7,24,.292,22,24,.917,107,35,88,.398,29,64,.453,6,24,.250,14,15,.933,90
1198,NYK,2017-11-20,107,,LAC,W 107-85,240,35,81,.432,22,47,.468,13,34,.382,24,25,.960,107,30,80,.375,20,48,.417,10,32,.313,15,21,.714,85
1199,OKC,2017-11-20,107,@,NOP,L 107-114,240,38,89,.427,27,54,.500,11,35,.314,20,26,.769,107,41,80,.513,34,55,.618,7,25,.280,25,32,.781,114
1200,PHI,2017-11-20,107,,UTA,W 107-86,240,44,85,.518,40,70,.571,4,15,.267,15,22,.682,107,30,85,.353,21,57,.368,9,28,.321,17,19,.895,86
1201,IND,2017-11-17,107,,DET,W 107-100,240,39,89,.438,24,61,.393,15,28,.536,14,21,.667,107,39,93,.419,25,60,.417,14,33,.424,8,10,.800,100
1202,TOR,2017-11-17,107,,NYK,W 107-84,240,44,78,.564,35,52,.673,9,26,.346,10,11,.909,107,30,91,.330,21,68,.309,9,23,.391,15,17,.882,84
1203,UTA,2017-11-17,107,@,BRK,L 107-118,240,39,79,.494,27,53,.509,12,26,.462,17,24,.708,107,43,84,.512,26,47,.553,17,37,.459,15,20,.750,118
1204,CHO,2017-11-15,107,,CLE,L 107-115,240,41,86,.477,35,60,.583,6,26,.231,19,28,.679,107,42,95,.442,29,57,.509,13,38,.342,18,20,.900,115
1205,ORL,2017-11-11,107,@,DEN,L 107-125,240,41,87,.471,30,56,.536,11,31,.355,14,20,.700,107,46,87,.529,34,58,.586,12,29,.414,21,27,.778,125
1206,BOS,2017-11-08,107,,LAL,W 107-96,240,38,98,.388,31,69,.449,7,29,.241,24,31,.774,107,37,85,.435,32,61,.525,5,24,.208,17,23,.739,96
1207,LAC,2017-11-07,107,@,SAS,L 107-120,240,42,82,.512,31,52,.596,11,30,.367,12,17,.706,107,45,84,.536,30,56,.536,15,28,.536,15,19,.789,120
1208,ATL,2017-11-06,107,,BOS,L 107-110,240,39,81,.481,26,55,.473,13,26,.500,16,20,.800,107,39,81,.481,25,45,.556,14,36,.389,18,22,.818,110
1209,LAL,2017-11-05,107,,MEM,W 107-102,240,40,85,.471,31,58,.534,9,27,.333,18,23,.783,107,40,87,.460,29,50,.580,11,37,.297,11,14,.786,102
1210,WAS,2017-11-05,107,@,TOR,W 107-96,240,40,85,.471,29,62,.468,11,23,.478,16,23,.696,107,37,80,.463,32,56,.571,5,24,.208,17,27,.630,96
1211,PHO,2017-11-03,107,@,NYK,L 107-120,240,34,97,.351,25,65,.385,9,32,.281,30,37,.811,107,45,87,.517,37,61,.607,8,26,.308,22,25,.880,120
1212,CLE,2017-11-01,107,,IND,L 107-124,240,43,86,.500,36,55,.655,7,31,.226,14,20,.700,107,49,90,.544,33,64,.516,16,26,.615,10,13,.769,124
1213,HOU,2017-10-30,107,,PHI,L 107-115,240,33,83,.398,20,36,.556,13,47,.277,28,38,.737,107,44,80,.550,34,56,.607,10,24,.417,17,24,.708,115
1214,GSW,2017-10-29,107,,DET,L 107-115,240,44,77,.571,34,50,.680,10,27,.370,9,12,.750,107,43,93,.462,31,66,.470,12,27,.444,17,17,1.000,115
1215,PHO,2017-10-28,107,@,POR,L 107-114,240,37,87,.425,28,61,.459,9,26,.346,24,30,.800,107,40,91,.440,29,65,.446,11,26,.423,23,28,.821,114
1216,NYK,2017-10-27,107,,BRK,W 107-86,240,44,98,.449,35,71,.493,9,27,.333,10,17,.588,107,30,75,.400,19,45,.422,11,30,.367,15,21,.714,86
1217,CLE,2017-10-25,107,@,BRK,L 107-112,240,39,81,.481,27,46,.587,12,35,.343,17,26,.654,107,40,93,.430,23,47,.489,17,46,.370,15,21,.714,112
1218,MIN,2017-10-24,107,,IND,L 107-130,240,42,86,.488,33,62,.532,9,24,.375,14,22,.636,107,56,84,.667,46,62,.742,10,22,.455,8,11,.727,130
1219,HOU,2017-10-21,107,,DAL,W 107-91,240,39,82,.476,28,35,.800,11,47,.234,18,22,.818,107,31,84,.369,18,53,.340,13,31,.419,16,21,.762,91
1220,NYK,2017-10-21,107,,DET,L 107-111,240,37,81,.457,29,51,.569,8,30,.267,25,31,.806,107,44,91,.484,35,61,.574,9,30,.300,14,15,.933,111
1221,SAS,2017-10-18,107,,MIN,W 107-99,240,41,89,.461,33,68,.485,8,21,.381,17,19,.895,107,37,85,.435,29,66,.439,8,19,.421,17,23,.739,99
1222,DEN,2018-04-11,106,@,MIN,L 106-112 (OT),265,41,90,.456,28,58,.483,13,32,.406,11,18,.611,106,42,89,.472,33,66,.500,9,23,.391,19,25,.760,112
1223,BOS,2018-04-08,106,,ATL,L 106-112,240,42,82,.512,33,59,.559,9,23,.391,13,20,.650,106,43,86,.500,28,51,.549,15,35,.429,11,14,.786,112
1224,DAL,2018-04-06,106,@,DET,L 106-113 (OT),265,40,92,.435,27,53,.509,13,39,.333,13,18,.722,106,46,92,.500,34,62,.548,12,30,.400,9,17,.529,113
1225,GSW,2018-04-05,106,@,IND,L 106-126,240,37,83,.446,28,54,.519,9,29,.310,23,24,.958,106,50,93,.538,35,64,.547,15,29,.517,11,15,.733,126
1226,MIL,2018-04-03,106,,BOS,W 106-102,240,43,79,.544,38,59,.644,5,20,.250,15,21,.714,106,38,81,.469,31,58,.534,7,23,.304,19,24,.792,102
1227,TOR,2018-04-03,106,@,CLE,L 106-112,240,42,94,.447,31,60,.517,11,34,.324,11,14,.786,106,38,77,.494,25,47,.532,13,30,.433,23,26,.885,112
1228,IND,2018-03-29,106,@,SAC,W 106-103,240,40,80,.500,32,54,.593,8,26,.308,18,20,.900,106,42,78,.538,29,47,.617,13,31,.419,6,9,.667,103
1229,SAS,2018-03-27,106,@,WAS,L 106-116,240,39,87,.448,29,62,.468,10,25,.400,18,33,.545,106,46,85,.541,36,61,.590,10,24,.417,14,18,.778,116
1230,LAL,2018-03-26,106,@,DET,L 106-112,240,40,85,.471,34,62,.548,6,23,.261,20,25,.800,106,44,100,.440,31,67,.463,13,33,.394,11,15,.733,112
1231,MIL,2018-03-25,106,,SAS,W 106-103,240,42,86,.488,33,59,.559,9,27,.333,13,18,.722,106,41,92,.446,37,75,.493,4,17,.235,17,21,.810,103
1232,TOR,2018-03-25,106,,LAC,L 106-117,240,41,92,.446,25,56,.446,16,36,.444,8,14,.571,106,44,95,.463,36,77,.468,8,18,.444,21,27,.778,117
1233,GSW,2018-03-23,106,,ATL,W 106-94,240,42,93,.452,30,63,.476,12,30,.400,10,11,.909,106,37,84,.440,26,52,.500,11,32,.344,9,20,.450,94
1234,DET,2018-03-19,106,@,SAC,W 106-90,240,37,79,.468,23,50,.460,14,29,.483,18,22,.818,106,40,88,.455,34,65,.523,6,23,.261,4,9,.444,90
1235,DAL,2018-03-17,106,@,BRK,L 106-114,240,41,92,.446,29,70,.414,12,22,.545,12,14,.857,106,43,84,.512,29,48,.604,14,36,.389,14,19,.737,114
1236,TOR,2018-03-15,106,@,IND,W 106-99,240,35,79,.443,23,47,.489,12,32,.375,24,28,.857,106,40,93,.430,33,69,.478,7,24,.292,12,17,.706,99
1237,LAL,2018-03-14,106,@,GSW,L 106-117,240,38,84,.452,26,46,.565,12,38,.316,18,28,.643,106,44,81,.543,38,61,.623,6,20,.300,23,28,.821,117
1238,CHI,2018-03-13,106,,LAC,L 106-112,240,43,101,.426,36,72,.500,7,29,.241,13,15,.867,106,37,76,.487,29,47,.617,8,29,.276,30,41,.732,112
1239,OKC,2018-03-12,106,,SAC,W 106-101,240,38,84,.452,22,48,.458,16,36,.444,14,18,.778,106,38,93,.409,26,60,.433,12,33,.364,13,16,.813,101
1240,NYK,2018-03-11,106,,TOR,L 106-132,240,40,88,.455,33,67,.493,7,21,.333,19,24,.792,106,47,93,.505,31,58,.534,16,35,.457,22,25,.880,132
1241,TOR,2018-03-06,106,,ATL,W 106-90,240,34,88,.386,24,52,.462,10,36,.278,28,33,.848,106,34,80,.425,28,59,.475,6,21,.286,16,21,.762,90
1242,DET,2018-03-02,106,@,ORL,L 106-115 (OT),265,40,92,.435,28,63,.444,12,29,.414,14,24,.583,106,44,86,.512,31,50,.620,13,36,.361,14,19,.737,115
1243,CHO,2018-02-28,106,@,BOS,L 106-134,240,42,91,.462,33,64,.516,9,27,.333,13,22,.591,106,54,87,.621,42,67,.627,12,20,.600,14,15,.933,134
1244,POR,2018-02-24,106,@,PHO,W 106-104,240,39,99,.394,33,69,.478,6,30,.200,22,30,.733,106,39,87,.448,28,61,.459,11,26,.423,15,21,.714,104
1245,SAC,2018-02-11,106,@,MIN,L 106-111,240,42,88,.477,32,63,.508,10,25,.400,12,17,.706,106,37,74,.500,28,50,.560,9,24,.375,28,32,.875,111
1246,UTA,2018-02-09,106,,CHO,W 106-94,240,41,84,.488,31,55,.564,10,29,.345,14,17,.824,106,35,85,.412,26,61,.426,9,24,.375,15,19,.789,94
1247,LAL,2018-02-08,106,,OKC,W 106-81,240,42,96,.438,32,65,.492,10,31,.323,12,13,.923,106,32,90,.356,24,56,.429,8,34,.235,9,19,.474,81
1248,BRK,2018-02-07,106,@,DET,L 106-115,240,39,90,.433,22,39,.564,17,51,.333,11,12,.917,106,44,92,.478,35,68,.515,9,24,.375,18,25,.720,115
1249,DAL,2018-02-03,106,@,SAC,W 106-99,240,41,83,.494,28,42,.667,13,41,.317,11,14,.786,106,43,82,.524,35,55,.636,8,27,.296,5,6,.833,99
1250,SAS,2018-01-30,106,,DEN,W 106-104,240,46,92,.500,37,68,.544,9,24,.375,5,5,1.000,106,40,86,.465,30,63,.476,10,23,.435,14,14,1.000,104
1251,MIA,2018-01-20,106,@,CHO,W 106-105,240,43,87,.494,30,59,.508,13,28,.464,7,12,.583,106,41,90,.456,34,63,.540,7,27,.259,16,21,.762,105
1252,MEM,2018-01-19,106,,SAC,W 106-88,240,39,88,.443,29,54,.537,10,34,.294,18,23,.783,106,32,80,.400,21,53,.396,11,27,.407,13,18,.722,88
1253,MIA,2018-01-17,106,@,MIL,W 106-101,240,38,82,.463,28,58,.483,10,24,.417,20,27,.741,106,33,76,.434,22,48,.458,11,28,.393,24,32,.750,101
1254,GSW,2018-01-10,106,,LAC,L 106-125,240,38,79,.481,30,56,.536,8,23,.348,22,26,.846,106,46,94,.489,35,70,.500,11,24,.458,22,28,.786,125
1255,IND,2018-01-10,106,,MIA,L 106-114,240,43,87,.494,42,69,.609,1,18,.056,19,29,.655,106,43,81,.531,30,51,.588,13,30,.433,15,21,.714,114
1256,OKC,2018-01-09,106,,POR,L 106-117,240,37,84,.440,24,53,.453,13,31,.419,19,26,.731,106,43,81,.531,33,58,.569,10,23,.435,21,26,.808,117
1257,SAC,2018-01-06,106,,DEN,W 106-98,240,42,94,.447,33,69,.478,9,25,.360,13,17,.765,106,35,76,.461,22,42,.524,13,34,.382,15,21,.714,98
1258,SAS,2018-01-03,106,@,PHI,L 106-112,240,39,87,.448,31,62,.500,8,25,.320,20,23,.870,106,36,80,.450,29,58,.500,7,22,.318,33,43,.767,112
1259,LAC,2017-12-31,106,,CHO,W 106-98,240,36,76,.474,26,48,.542,10,28,.357,24,27,.889,106,36,93,.387,25,60,.417,11,33,.333,15,19,.789,98
1260,LAL,2017-12-29,106,,LAC,L 106-121,240,46,94,.489,43,75,.573,3,19,.158,11,16,.688,106,42,86,.488,33,54,.611,9,32,.281,28,34,.824,121
1261,MIL,2017-12-26,106,,CHI,L 106-115,240,39,83,.470,29,52,.558,10,31,.323,18,24,.750,106,45,103,.437,35,75,.467,10,28,.357,15,25,.600,115
1262,MIL,2017-12-23,106,@,CHO,L 106-111,240,42,87,.483,34,61,.557,8,26,.308,14,17,.824,106,36,74,.486,27,53,.509,9,21,.429,30,40,.750,111
1263,PHO,2017-12-23,106,,MIN,L 106-115,240,40,86,.465,29,54,.537,11,32,.344,15,24,.625,106,42,84,.500,36,68,.529,6,16,.375,25,29,.862,115
1264,LAL,2017-12-22,106,@,GSW,L 106-113,240,40,94,.426,29,65,.446,11,29,.379,15,22,.682,106,42,85,.494,35,61,.574,7,24,.292,22,27,.815,113
1265,NOP,2017-12-19,106,@,WAS,L 106-116,240,34,80,.425,29,60,.483,5,20,.250,33,40,.825,106,46,92,.500,32,57,.561,14,35,.400,10,14,.714,116
1266,CLE,2017-12-17,106,@,WAS,W 106-99,240,41,87,.471,27,53,.509,14,34,.412,10,12,.833,106,39,91,.429,27,58,.466,12,33,.364,9,16,.563,99
1267,MIN,2017-12-16,106,,PHO,L 106-108,240,40,95,.421,31,68,.456,9,27,.333,17,24,.708,106,33,72,.458,22,48,.458,11,24,.458,31,35,.886,108
1268,LAC,2017-12-13,106,@,ORL,W 106-95,240,39,88,.443,27,62,.435,12,26,.462,16,20,.800,106,37,88,.420,28,61,.459,9,27,.333,12,21,.571,95
1269,IND,2017-12-08,106,,CLE,W 106-102,240,38,86,.442,23,47,.489,15,39,.385,15,24,.625,106,37,85,.435,26,49,.531,11,36,.306,17,22,.773,102
1270,ATL,2017-12-06,106,@,ORL,L 106-110 (OT),265,40,93,.430,29,66,.439,11,27,.407,15,20,.750,106,46,98,.469,40,70,.571,6,28,.214,12,18,.667,110
1271,WAS,2017-12-05,106,@,POR,W 106-92,240,42,89,.472,31,64,.484,11,25,.440,11,14,.786,106,32,78,.410,20,51,.392,12,27,.444,16,21,.762,92
1272,LAC,2017-12-03,106,@,MIN,L 106-112,240,37,73,.507,22,39,.564,15,34,.441,17,22,.773,106,38,88,.432,30,62,.484,8,26,.308,28,31,.903,112
1273,CHI,2017-12-01,106,,SAC,L 106-107,240,42,90,.467,29,54,.537,13,36,.361,9,13,.692,106,45,85,.529,39,67,.582,6,18,.333,11,14,.786,107
1274,UTA,2017-11-28,106,,DEN,W 106-77,240,42,87,.483,28,55,.509,14,32,.438,8,9,.889,106,28,78,.359,21,44,.477,7,34,.206,14,16,.875,77
1275,GSW,2017-11-27,106,,SAC,L 106-110,240,40,80,.500,24,43,.558,16,37,.432,10,14,.714,106,42,79,.532,33,62,.532,9,17,.529,17,21,.810,110
1276,SAS,2017-11-25,106,@,CHO,W 106-86,240,39,81,.481,33,56,.589,6,25,.240,22,25,.880,106,31,84,.369,27,59,.458,4,25,.160,20,26,.769,86
1277,NYK,2017-11-15,106,,UTA,W 106-101,240,38,81,.469,29,60,.483,9,21,.429,21,25,.840,106,34,79,.430,17,44,.386,17,35,.486,16,17,.941,101
1278,NOP,2017-11-13,106,,ATL,W 106-105,240,41,75,.547,28,42,.667,13,33,.394,11,17,.647,106,40,87,.460,23,51,.451,17,36,.472,8,9,.889,105
1279,BRK,2017-11-11,106,@,UTA,L 106-114,240,35,76,.461,28,53,.528,7,23,.304,29,39,.744,106,41,85,.482,30,56,.536,11,29,.379,21,25,.840,114
1280,ATL,2017-10-29,106,,MIL,L 106-117,240,36,77,.468,23,48,.479,13,29,.448,21,26,.808,106,44,81,.543,31,55,.564,13,26,.500,16,21,.762,117
1281,SAC,2017-10-26,106,,NOP,L 106-114,240,38,81,.469,31,61,.508,7,20,.350,23,25,.920,106,42,86,.488,29,54,.537,13,32,.406,17,23,.739,114
1282,UTA,2017-10-18,106,,DEN,W 106-96,240,41,81,.506,32,57,.561,9,24,.375,15,16,.938,106,36,77,.468,23,50,.460,13,27,.481,11,12,.917,96
1283,HOU,2018-04-10,105,@,LAL,W 105-99,240,37,88,.420,21,41,.512,16,47,.340,15,16,.938,105,38,90,.422,28,54,.519,10,36,.278,13,15,.867,99
1284,CHI,2018-04-09,105,@,BRK,L 105-114,240,43,89,.483,31,61,.508,12,28,.429,7,12,.583,105,41,82,.500,23,40,.575,18,42,.429,14,15,.933,114
1285,POR,2018-04-07,105,@,SAS,L 105-116,240,42,88,.477,31,60,.517,11,28,.393,10,11,.909,105,47,84,.560,40,63,.635,7,21,.333,15,21,.714,116
1286,ORL,2018-04-04,105,,DAL,W 105-100,240,39,86,.453,31,57,.544,8,29,.276,19,27,.704,105,39,89,.438,29,59,.492,10,30,.333,12,17,.706,100
1287,POR,2018-03-30,105,,LAC,W 105-96,240,41,95,.432,33,65,.508,8,30,.267,15,16,.938,105,36,89,.404,32,76,.421,4,13,.308,20,35,.571,96
1288,CHO,2018-03-28,105,,CLE,L 105-118,240,39,76,.513,34,55,.618,5,21,.238,22,24,.917,105,45,93,.484,34,65,.523,11,28,.393,17,20,.850,118
1289,LAC,2018-03-27,105,,MIL,W 105-98,240,40,86,.465,25,58,.431,15,28,.536,10,18,.556,105,38,83,.458,32,60,.533,6,23,.261,16,23,.696,98
1290,OKC,2018-03-25,105,,POR,L 105-108,240,37,84,.440,29,57,.509,8,27,.296,23,28,.821,105,42,90,.467,33,56,.589,9,34,.265,15,19,.789,108
1291,ORL,2018-03-24,105,,PHO,W 105-99,240,37,84,.440,26,54,.481,11,30,.367,20,27,.741,105,36,89,.404,29,60,.483,7,29,.241,20,26,.769,99
1292,BOS,2018-03-23,105,@,POR,W 105-100,240,35,77,.455,24,59,.407,11,18,.611,24,26,.923,105,40,91,.440,32,58,.552,8,33,.242,12,15,.800,100
1293,OKC,2018-03-23,105,,MIA,W 105-99,240,36,84,.429,28,58,.483,8,26,.308,25,33,.758,105,34,87,.391,21,57,.368,13,30,.433,18,20,.900,99
1294,CHI,2018-03-23,105,,MIL,L 105-118,240,36,87,.414,24,61,.393,12,26,.462,21,23,.913,105,43,87,.494,28,57,.491,15,30,.500,17,19,.895,118
1295,SAC,2018-03-22,105,,ATL,W 105-90,240,43,93,.462,33,72,.458,10,21,.476,9,9,1.000,105,33,84,.393,21,48,.438,12,36,.333,12,18,.667,90
1296,MEM,2018-03-21,105,@,PHI,L 105-119,240,40,99,.404,31,72,.431,9,27,.333,16,20,.800,105,46,84,.548,35,53,.660,11,31,.355,16,20,.800,119
1297,BRK,2018-03-21,105,,CHO,L 105-111,240,39,93,.419,26,56,.464,13,37,.351,14,21,.667,105,36,94,.383,33,78,.423,3,16,.188,36,47,.766,111
1298,DAL,2018-03-20,105,@,NOP,L 105-115,240,43,90,.478,33,55,.600,10,35,.286,9,11,.818,105,48,91,.527,38,66,.576,10,25,.400,9,15,.600,115
1299,CLE,2018-03-15,105,@,POR,L 105-113,240,41,80,.513,30,47,.638,11,33,.333,12,21,.571,105,43,96,.448,31,61,.508,12,35,.343,15,19,.789,113
1300,HOU,2018-03-11,105,@,DAL,W 105-82,240,39,84,.464,22,39,.564,17,45,.378,10,14,.714,105,33,94,.351,28,63,.444,5,31,.161,11,18,.611,82
1301,ORL,2018-03-10,105,@,LAC,L 105-113,240,38,84,.452,30,60,.500,8,24,.333,21,27,.778,105,41,78,.526,34,60,.567,7,18,.389,24,28,.857,113
1302,HOU,2018-03-09,105,@,TOR,L 105-108,240,40,81,.494,31,54,.574,9,27,.333,16,23,.696,105,41,85,.482,26,47,.553,15,38,.395,11,14,.786,108
1303,BOS,2018-03-05,105,@,CHI,W 105-89,240,41,84,.488,29,48,.604,12,36,.333,11,12,.917,105,32,81,.395,20,48,.417,12,33,.364,13,20,.650,89
1304,MIA,2018-03-03,105,,DET,W 105-96,240,37,82,.451,25,53,.472,12,29,.414,19,28,.679,105,37,89,.416,30,65,.462,7,24,.292,15,21,.714,96
1305,NYK,2018-03-02,105,@,LAC,L 105-128,240,41,89,.461,30,64,.469,11,25,.440,12,16,.750,105,50,89,.562,41,64,.641,9,25,.360,19,24,.792,128
1306,HOU,2018-02-28,105,@,LAC,W 105-92,240,36,85,.424,23,42,.548,13,43,.302,20,24,.833,105,36,79,.456,29,56,.518,7,23,.304,13,19,.684,92
1307,ORL,2018-02-26,105,@,OKC,L 105-112,240,39,84,.464,27,55,.491,12,29,.414,15,21,.714,105,42,88,.477,31,63,.492,11,25,.440,17,20,.850,112
1308,ORL,2018-02-24,105,@,PHI,L 105-116,240,38,85,.447,25,54,.463,13,31,.419,16,19,.842,105,42,81,.519,33,54,.611,9,27,.333,23,27,.852,116
1309,WAS,2018-02-23,105,,CHO,L 105-122,240,40,81,.494,31,56,.554,9,25,.360,16,17,.941,105,44,90,.489,27,51,.529,17,39,.436,17,20,.850,122
1310,CHI,2018-02-12,105,,ORL,W 105-101,240,40,88,.455,31,56,.554,9,32,.281,16,21,.762,105,37,84,.440,27,53,.509,10,31,.323,17,19,.895,101
1311,SAS,2018-02-10,105,@,GSW,L 105-122,240,43,94,.457,38,67,.567,5,27,.185,14,19,.737,105,48,85,.565,36,58,.621,12,27,.444,14,15,.933,122
1312,GSW,2018-02-06,105,,OKC,L 105-125,240,37,76,.487,29,48,.604,8,28,.286,23,31,.742,105,44,93,.473,32,62,.516,12,31,.387,25,33,.758,125
1313,POR,2018-02-02,105,@,TOR,L 105-130,240,37,73,.507,30,52,.577,7,21,.333,24,33,.727,105,46,99,.465,27,59,.458,19,40,.475,19,21,.905,130
1314,LAL,2018-01-31,105,@,ORL,L 105-127,240,39,83,.470,35,63,.556,4,20,.200,23,30,.767,105,44,81,.543,26,49,.531,18,32,.563,21,29,.724,127
1315,IND,2018-01-31,105,,MEM,W 105-101,240,37,70,.529,27,44,.614,10,26,.385,21,31,.677,105,39,82,.476,27,56,.482,12,26,.462,11,15,.733,101
1316,IND,2018-01-29,105,,CHO,W 105-96,240,45,83,.542,39,62,.629,6,21,.286,9,11,.818,105,37,83,.446,28,52,.538,9,31,.290,13,20,.650,96
1317,ATL,2018-01-29,105,,MIN,W 105-100,240,39,79,.494,26,45,.578,13,34,.382,14,16,.875,105,39,83,.470,32,64,.500,7,19,.368,15,18,.833,100
1318,BOS,2018-01-27,105,@,GSW,L 105-109,240,37,85,.435,23,57,.404,14,28,.500,17,24,.708,105,38,84,.452,28,57,.491,10,27,.370,23,26,.885,109
1319,SAC,2018-01-23,105,@,ORL,W 105-99,240,43,87,.494,35,61,.574,8,26,.308,11,13,.846,105,36,83,.434,25,52,.481,11,31,.355,16,19,.842,99
1320,MEM,2018-01-22,105,,PHI,W 105-101,240,33,78,.423,23,52,.442,10,26,.385,29,35,.829,105,32,71,.451,18,40,.450,14,31,.452,23,31,.742,101
1321,PHO,2018-01-22,105,@,MIL,L 105-109,240,39,79,.494,30,53,.566,9,26,.346,18,20,.900,105,38,71,.535,33,54,.611,5,17,.294,28,37,.757,109
1322,CHO,2018-01-20,105,,MIA,L 105-106,240,41,90,.456,34,63,.540,7,27,.259,16,21,.762,105,43,87,.494,30,59,.508,13,28,.464,7,12,.583,106
1323,SAC,2018-01-17,105,,UTA,L 105-120,240,38,72,.528,25,51,.490,13,21,.619,16,20,.800,105,46,81,.568,34,52,.654,12,29,.414,16,20,.800,120
1324,MEM,2018-01-17,105,,NYK,W 105-99,240,41,91,.451,31,63,.492,10,28,.357,13,17,.765,105,35,82,.427,28,55,.509,7,27,.259,22,23,.957,99
1325,DEN,2018-01-16,105,,DAL,W 105-102,240,40,86,.465,32,60,.533,8,26,.308,17,26,.654,105,38,78,.487,30,51,.588,8,27,.296,18,22,.818,102
1326,SAC,2018-01-13,105,@,LAC,L 105-126,240,43,85,.506,37,68,.544,6,17,.353,13,22,.591,105,46,82,.561,34,51,.667,12,31,.387,22,26,.846,126
1327,DET,2018-01-13,105,@,CHI,L 105-107,240,41,92,.446,29,63,.460,12,29,.414,11,14,.786,105,42,87,.483,25,51,.490,17,36,.472,6,9,.667,107
1328,ATL,2018-01-12,105,,BRK,L 105-110,240,37,80,.463,26,52,.500,11,28,.393,20,26,.769,105,40,87,.460,27,53,.509,13,34,.382,17,26,.654,110
1329,MEM,2018-01-10,105,,NOP,W 105-102,240,37,88,.420,32,69,.464,5,19,.263,26,32,.813,105,34,77,.442,23,42,.548,11,35,.314,23,34,.676,102
1330,LAC,2018-01-06,105,,GSW,L 105-121,240,39,91,.429,36,80,.450,3,11,.273,24,30,.800,105,39,94,.415,26,55,.473,13,39,.333,30,37,.811,121
1331,MEM,2018-01-02,105,@,LAC,L 105-113,240,38,79,.481,30,53,.566,8,26,.308,21,33,.636,105,39,71,.549,30,48,.625,9,23,.391,26,31,.839,113
1332,BRK,2017-12-31,105,@,BOS,L 105-108,240,39,95,.411,28,59,.475,11,36,.306,16,19,.842,105,39,79,.494,25,46,.543,14,33,.424,16,25,.640,108
1333,NYK,2017-12-30,105,@,NOP,W 105-103,240,41,94,.436,36,75,.480,5,19,.263,18,21,.857,105,38,84,.452,32,58,.552,6,26,.231,21,27,.778,103
1334,PHI,2017-12-25,105,@,NYK,W 105-98,240,35,82,.427,25,54,.463,10,28,.357,25,30,.833,105,38,94,.404,34,79,.430,4,15,.267,18,28,.643,98
1335,IND,2017-12-20,105,@,ATL,W 105-95,240,40,82,.488,33,61,.541,7,21,.333,18,19,.947,105,35,81,.432,27,52,.519,8,29,.276,17,20,.850,95
1336,DET,2017-12-14,105,@,ATL,W 105-91,240,41,90,.456,28,60,.467,13,30,.433,10,12,.833,105,32,70,.457,21,39,.538,11,31,.355,16,26,.615,91
1337,CLE,2017-12-09,105,,PHI,W 105-98,240,36,75,.480,22,46,.478,14,29,.483,19,25,.760,105,37,78,.474,26,45,.578,11,33,.333,13,13,1.000,98
1338,SAS,2017-12-08,105,,BOS,W 105-102,240,38,81,.469,30,54,.556,8,27,.296,21,24,.875,105,38,83,.458,27,45,.600,11,38,.289,15,17,.882,102
1339,MIA,2017-12-06,105,@,SAS,L 105-117,240,39,72,.542,21,38,.553,18,34,.529,9,12,.750,105,46,87,.529,33,62,.532,13,25,.520,12,14,.857,117
1340,DEN,2017-12-04,105,@,DAL,L 105-122,240,38,91,.418,24,55,.436,14,36,.389,15,23,.652,105,49,86,.570,37,60,.617,12,26,.462,12,17,.706,122
1341,ORL,2017-12-03,105,@,NYK,W 105-100,240,37,82,.451,31,54,.574,6,28,.214,25,29,.862,105,43,93,.462,38,78,.487,5,15,.333,9,10,.900,100
1342,MIA,2017-12-01,105,,CHO,W 105-100,240,39,80,.488,25,45,.556,14,35,.400,13,21,.619,105,38,79,.481,33,59,.559,5,20,.250,19,21,.905,100
1343,WAS,2017-11-25,105,,POR,L 105-108,240,41,89,.461,33,66,.500,8,23,.348,15,16,.938,105,41,80,.513,32,56,.571,9,24,.375,17,22,.773,108
1344,IND,2017-11-20,105,@,ORL,W 105-97,240,37,89,.416,29,69,.420,8,20,.400,23,29,.793,105,35,84,.417,22,46,.478,13,38,.342,14,23,.609,97
1345,CHI,2017-11-19,105,@,PHO,L 105-113,240,42,101,.416,30,65,.462,12,36,.333,9,14,.643,105,45,89,.506,38,62,.613,7,27,.259,16,22,.727,113
1346,HOU,2017-11-18,105,@,MEM,W 105-83,240,35,78,.449,17,35,.486,18,43,.419,17,21,.810,105,31,86,.360,24,59,.407,7,27,.259,14,19,.737,83
1347,LAC,2017-11-13,105,,PHI,L 105-109,240,36,82,.439,24,50,.480,12,32,.375,21,32,.656,105,38,77,.494,31,45,.689,7,32,.219,26,35,.743,109
1348,ATL,2017-11-13,105,@,NOP,L 105-106,240,40,87,.460,23,51,.451,17,36,.472,8,9,.889,105,41,75,.547,28,42,.667,13,33,.394,11,17,.647,106
1349,IND,2017-11-10,105,@,CHI,W 105-87,240,43,84,.512,31,55,.564,12,29,.414,7,12,.583,105,37,93,.398,30,66,.455,7,27,.259,6,9,.667,87
1350,CHI,2017-11-03,105,@,ORL,W 105-83,240,40,85,.471,26,56,.464,14,29,.483,11,12,.917,105,35,86,.407,25,51,.490,10,35,.286,3,5,.600,83
1351,DET,2017-11-03,105,,MIL,W 105-96,240,37,78,.474,29,52,.558,8,26,.308,23,28,.821,105,39,83,.470,29,58,.500,10,25,.400,8,9,.889,96
1352,DEN,2017-10-27,105,@,ATL,W 105-100,240,42,91,.462,38,71,.535,4,20,.200,17,23,.739,105,37,89,.416,23,56,.411,14,33,.424,12,12,1.000,100
1353,HOU,2017-10-25,105,@,PHI,W 105-104,240,36,75,.480,24,36,.667,12,39,.308,21,24,.875,105,43,97,.443,31,61,.508,12,36,.333,6,10,.600,104
1354,OKC,2017-10-19,105,,NYK,W 105-84,240,39,90,.433,28,52,.538,11,38,.289,16,22,.727,105,32,79,.405,25,55,.455,7,24,.292,13,19,.684,84
1355,HOU,2017-10-18,105,@,SAC,W 105-100,240,33,83,.398,21,38,.553,12,45,.267,27,29,.931,105,42,88,.477,34,65,.523,8,23,.348,8,10,.800,100
1356,CHI,2018-04-06,104,@,BOS,L 104-111,240,40,86,.465,26,56,.464,14,30,.467,10,17,.588,104,45,81,.556,31,47,.660,14,34,.412,7,17,.412,111
1357,IND,2018-04-03,104,@,DEN,L 104-107,240,41,84,.488,32,65,.492,9,19,.474,13,16,.813,104,41,89,.461,31,57,.544,10,32,.313,15,20,.750,107
1358,WAS,2018-04-03,104,@,HOU,L 104-120,240,38,72,.528,26,47,.553,12,25,.480,16,23,.696,104,43,84,.512,27,38,.711,16,46,.348,18,27,.667,120
1359,NOP,2018-04-01,104,,OKC,L 104-109,240,38,83,.458,27,51,.529,11,32,.344,17,23,.739,104,41,95,.432,32,64,.500,9,31,.290,18,25,.720,109
1360,LAC,2018-04-01,104,,IND,L 104-111,240,42,82,.512,33,57,.579,9,25,.360,11,14,.786,104,42,86,.488,31,58,.534,11,28,.393,16,21,.762,111
1361,HOU,2018-03-30,104,,PHO,W 104-103,240,35,81,.432,21,43,.488,14,38,.368,20,29,.690,104,41,84,.488,29,52,.558,12,32,.375,9,13,.692,103
1362,ORL,2018-03-28,104,,BRK,L 104-111,240,40,92,.435,29,61,.475,11,31,.355,13,16,.813,104,40,87,.460,28,53,.528,12,34,.353,19,22,.864,111
1363,DEN,2018-03-26,104,@,PHI,L 104-123,240,36,84,.429,25,52,.481,11,32,.344,21,34,.618,104,46,91,.505,33,62,.532,13,29,.448,18,25,.720,123
1364,BOS,2018-03-25,104,@,SAC,W 104-93,240,40,72,.556,28,50,.560,12,22,.545,12,17,.706,104,38,82,.463,31,56,.554,7,26,.269,10,10,1.000,93
1365,LAC,2018-03-23,104,@,IND,L 104-109,240,42,76,.553,32,50,.640,10,26,.385,10,14,.714,104,43,93,.462,32,62,.516,11,31,.355,12,14,.857,109
1366,NYK,2018-03-23,104,,MIN,L 104-108,240,40,92,.435,28,64,.438,12,28,.429,12,17,.706,104,35,75,.467,25,49,.510,10,26,.385,28,32,.875,108
1367,SAC,2018-03-11,104,@,DEN,L 104-130,240,39,91,.429,33,60,.550,6,31,.194,20,26,.769,104,50,89,.562,35,52,.673,15,37,.405,15,21,.714,130
1368,OKC,2018-03-10,104,,SAS,W 104-94,240,39,85,.459,29,57,.509,10,28,.357,16,24,.667,104,40,86,.465,30,66,.455,10,20,.500,4,7,.571,94
1369,UTA,2018-03-07,104,@,IND,W 104-84,240,41,80,.513,30,49,.612,11,31,.355,11,16,.688,104,34,88,.386,31,65,.477,3,23,.130,13,17,.765,84
1370,ORL,2018-02-28,104,,TOR,L 104-117,240,39,82,.476,26,52,.500,13,30,.433,13,23,.565,104,45,83,.542,33,53,.623,12,30,.400,15,24,.625,117
1371,MIL,2018-02-27,104,,WAS,L 104-107,240,35,77,.455,25,51,.490,10,26,.385,24,28,.857,104,42,88,.477,35,68,.515,7,20,.350,16,22,.727,107
1372,ATL,2018-02-26,104,,LAL,L 104-123,240,36,96,.375,28,60,.467,8,36,.222,24,34,.706,104,47,90,.522,32,57,.561,15,33,.455,14,19,.737,123
1373,BRK,2018-02-26,104,,CHI,W 104-87,240,40,90,.444,24,48,.500,16,42,.381,8,8,1.000,104,33,93,.355,27,70,.386,6,23,.261,15,23,.652,87
1374,PHO,2018-02-24,104,,POR,L 104-106,240,39,87,.448,28,61,.459,11,26,.423,15,21,.714,104,39,99,.394,33,69,.478,6,30,.200,22,30,.733,106
1375,CHI,2018-02-24,104,@,MIN,L 104-122,240,42,90,.467,36,67,.537,6,23,.261,14,20,.700,104,46,94,.489,35,59,.593,11,35,.314,19,26,.731,122
1376,CHO,2018-02-14,104,@,ORL,W 104-102,240,38,88,.432,25,58,.431,13,30,.433,15,19,.789,104,36,86,.419,21,49,.429,15,37,.405,15,17,.882,102
1377,PHI,2018-02-14,104,,MIA,W 104-102,240,39,92,.424,30,57,.526,9,35,.257,17,25,.680,104,35,77,.455,24,50,.480,11,27,.407,21,29,.724,102
1378,DET,2018-02-14,104,,ATL,W 104-98,240,35,83,.422,22,50,.440,13,33,.394,21,25,.840,104,38,89,.427,32,56,.571,6,33,.182,16,19,.842,98
1379,HOU,2018-02-11,104,,DAL,W 104-97,240,34,78,.436,21,33,.636,13,45,.289,23,33,.697,104,38,93,.409,28,62,.452,10,31,.323,11,16,.688,97
1380,ORL,2018-02-10,104,,MIL,L 104-111,240,37,83,.446,29,53,.547,8,30,.267,22,26,.846,104,43,82,.524,34,57,.596,9,25,.360,16,20,.800,111
1381,DEN,2018-02-09,104,@,HOU,L 104-130,240,42,88,.477,39,60,.650,3,28,.107,17,21,.810,104,43,86,.500,24,45,.533,19,41,.463,25,34,.735,130
1382,WAS,2018-02-08,104,,BOS,L 104-110 (OT),265,38,95,.400,26,69,.377,12,26,.462,16,20,.800,104,39,84,.464,30,58,.517,9,26,.346,23,34,.676,110
1383,LAC,2018-02-05,104,,DAL,W 104-101,240,42,87,.483,32,60,.533,10,27,.370,10,12,.833,104,33,80,.413,16,38,.421,17,42,.405,18,20,.900,101
1384,SAC,2018-02-05,104,,CHI,W 104-98,240,37,84,.440,26,52,.500,11,32,.344,19,25,.760,104,32,80,.400,18,44,.409,14,36,.389,20,24,.833,98
1385,CHO,2018-02-05,104,@,DEN,L 104-121,240,39,77,.506,28,51,.549,11,26,.423,15,24,.625,104,46,81,.568,28,47,.596,18,34,.529,11,13,.846,121
1386,OKC,2018-02-04,104,,LAL,L 104-108,240,40,89,.449,33,64,.516,7,25,.280,17,25,.680,104,42,86,.488,29,56,.518,13,30,.433,11,18,.611,108
1387,SAC,2018-02-02,104,,GSW,L 104-119,240,42,95,.442,32,70,.457,10,25,.400,10,15,.667,104,44,80,.550,27,47,.574,17,33,.515,14,16,.875,119
1388,DET,2018-02-01,104,,MEM,W 104-102,240,35,76,.461,28,51,.549,7,25,.280,27,37,.730,104,40,96,.417,32,65,.492,8,31,.258,14,14,1.000,102
1389,DEN,2018-01-30,104,@,SAS,L 104-106,240,40,86,.465,30,63,.476,10,23,.435,14,14,1.000,104,46,92,.500,37,68,.544,9,24,.375,5,5,1.000,106
1390,MIN,2018-01-30,104,@,TOR,L 104-109,240,42,85,.494,37,73,.507,5,12,.417,15,24,.625,104,39,81,.481,30,52,.577,9,29,.310,22,26,.846,109
1391,POR,2018-01-30,104,@,LAC,W 104-96,240,36,98,.367,23,68,.338,13,30,.433,19,22,.864,104,35,85,.412,29,63,.460,6,22,.273,20,26,.769,96
1392,DET,2018-01-28,104,@,CLE,L 104-121,240,40,95,.421,26,59,.441,14,36,.389,10,13,.769,104,42,83,.506,27,48,.563,15,35,.429,22,26,.846,121
1393,ATL,2018-01-27,104,,WAS,L 104-129,240,38,88,.432,26,45,.578,12,43,.279,16,21,.762,104,49,85,.576,31,53,.585,18,32,.563,13,14,.929,129
1394,HOU,2018-01-24,104,@,DAL,W 104-97,240,36,82,.439,15,31,.484,21,51,.412,11,23,.478,104,35,82,.427,20,47,.426,15,35,.429,12,18,.667,97
1395,ATL,2018-01-22,104,,UTA,W 104-90,240,40,83,.482,28,57,.491,12,26,.462,12,12,1.000,104,33,76,.434,29,61,.475,4,15,.267,20,28,.714,90
1396,DEN,2018-01-22,104,,POR,W 104-101,240,34,83,.410,24,53,.453,10,30,.333,26,33,.788,104,36,85,.424,28,60,.467,8,25,.320,21,26,.808,101
1397,MEM,2018-01-20,104,@,NOP,L 104-111,240,37,82,.451,22,47,.468,15,35,.429,15,16,.938,104,39,78,.500,32,51,.627,7,27,.259,26,32,.813,111
1398,CLE,2018-01-18,104,,ORL,W 104-103,240,38,85,.447,28,51,.549,10,34,.294,18,27,.667,104,41,88,.466,36,66,.545,5,22,.227,16,21,.762,103
1399,DEN,2018-01-17,104,@,LAC,L 104-109,240,42,97,.433,37,72,.514,5,25,.200,15,18,.833,104,40,87,.460,30,57,.526,10,30,.333,19,31,.613,109
1400,BRK,2018-01-15,104,,NYK,L 104-119,240,32,87,.368,21,55,.382,11,32,.344,29,36,.806,104,42,82,.512,33,66,.500,9,16,.563,26,37,.703,119
1401,BRK,2018-01-15,104,,NYK,L 104-119,240,32,87,.368,21,55,.382,11,32,.344,29,36,.806,104,42,82,.512,33,66,.500,9,16,.563,26,37,.703,119
1402,WAS,2018-01-10,104,,UTA,L 104-107,240,41,78,.526,31,53,.585,10,25,.400,12,17,.706,104,43,92,.467,32,59,.542,11,33,.333,10,13,.769,107
1403,MIN,2018-01-10,104,,OKC,W 104-88,240,39,80,.488,32,60,.533,7,20,.350,19,27,.704,104,32,80,.400,26,55,.473,6,25,.240,18,24,.750,88
1404,DET,2018-01-03,104,@,MIA,L 104-111,240,41,86,.477,32,62,.516,9,24,.375,13,16,.813,104,43,84,.512,26,50,.520,17,34,.500,8,11,.727,111
1405,PHO,2018-01-02,104,,ATL,W 104-103,240,39,77,.506,32,55,.582,7,22,.318,19,26,.731,104,36,87,.414,26,56,.464,10,31,.323,21,25,.840,103
1406,UTA,2017-12-30,104,,CLE,W 104-101,240,38,82,.463,28,51,.549,10,31,.323,18,21,.857,104,34,81,.420,22,41,.537,12,40,.300,21,26,.808,101
1407,ATL,2017-12-30,104,,POR,W 104-89,240,40,89,.449,26,59,.441,14,30,.467,10,15,.667,104,36,85,.424,29,60,.483,7,25,.280,10,13,.769,89
1408,LAL,2017-12-25,104,,MIN,L 104-121,240,40,92,.435,30,62,.484,10,30,.333,14,20,.700,104,49,84,.583,38,52,.731,11,32,.344,12,14,.857,121
1409,DET,2017-12-22,104,,NYK,W 104-101,240,38,88,.432,28,63,.444,10,25,.400,18,25,.720,104,44,97,.454,36,73,.493,8,24,.333,5,6,.833,101
1410,CHO,2017-12-22,104,@,MIL,L 104-109,240,39,88,.443,27,62,.435,12,26,.462,14,17,.824,104,41,87,.471,33,58,.569,8,29,.276,19,23,.826,109
1411,SAC,2017-12-20,104,@,BRK,W 104-99,240,40,82,.488,33,63,.524,7,19,.368,17,20,.850,104,32,82,.390,17,40,.425,15,42,.357,20,23,.870,99
1412,DEN,2017-12-20,104,,MIN,L 104-112,240,36,72,.500,23,44,.523,13,28,.464,19,24,.792,104,43,87,.494,35,63,.556,8,24,.333,18,19,.947,112
1413,MIA,2017-12-18,104,@,ATL,L 104-110,240,36,79,.456,29,54,.537,7,25,.280,25,30,.833,104,38,83,.458,30,61,.492,8,22,.364,26,31,.839,110
1414,MIA,2017-12-15,104,@,CHO,W 104-98,240,39,78,.500,28,47,.596,11,31,.355,15,17,.882,104,34,83,.410,24,56,.429,10,27,.370,20,27,.741,98
1415,DET,2017-12-15,104,@,IND,W 104-98,240,39,93,.419,26,61,.426,13,32,.406,13,17,.765,104,35,87,.402,26,57,.456,9,30,.300,19,25,.760,98
1416,BRK,2017-12-14,104,,NYK,L 104-111,240,37,83,.446,25,41,.610,12,42,.286,18,23,.783,104,41,89,.461,31,69,.449,10,20,.500,19,22,.864,111
1417,POR,2017-12-11,104,@,GSW,L 104-111,240,37,88,.420,30,60,.500,7,28,.250,23,25,.920,104,44,80,.550,34,60,.567,10,20,.500,13,17,.765,111
1418,CHI,2017-12-09,104,,NYK,W 104-102,240,42,82,.512,35,57,.614,7,25,.280,13,23,.565,104,43,91,.473,36,67,.537,7,24,.292,9,9,1.000,102
1419,SAS,2017-12-09,104,@,PHO,W 104-101,240,40,87,.460,34,68,.500,6,19,.316,18,25,.720,104,35,80,.438,28,55,.509,7,25,.280,24,30,.800,101
1420,PHI,2017-12-07,104,,LAL,L 104-107,240,39,81,.481,29,55,.527,10,26,.385,16,21,.762,104,42,96,.438,31,68,.456,11,28,.393,12,24,.500,107
1421,MIL,2017-12-06,104,,DET,W 104-100,240,39,79,.494,31,57,.544,8,22,.364,18,26,.692,104,36,87,.414,26,57,.456,10,30,.333,18,27,.667,100
1422,CHO,2017-12-04,104,,ORL,W 104-94,240,34,84,.405,31,67,.463,3,17,.176,33,40,.825,104,36,82,.439,26,50,.520,10,32,.313,12,14,.857,94
1423,SAC,2017-12-02,104,@,MIL,L 104-109,240,37,77,.481,26,53,.491,11,24,.458,19,21,.905,104,34,69,.493,28,50,.560,6,19,.316,35,42,.833,109
1424,DAL,2017-11-29,104,,BRK,L 104-109,240,39,84,.464,30,57,.526,9,27,.333,17,21,.810,104,42,90,.467,31,61,.508,11,29,.379,14,25,.560,109
1425,SAS,2017-11-29,104,,MEM,W 104-95,240,38,75,.507,30,55,.545,8,20,.400,20,24,.833,104,35,77,.455,24,55,.436,11,22,.500,14,16,.875,95
1426,PHO,2017-11-28,104,@,CHI,W 104-99,240,38,87,.437,27,57,.474,11,30,.367,17,23,.739,104,38,94,.404,22,54,.407,16,40,.400,7,10,.700,99
1427,NYK,2017-11-24,104,@,ATL,L 104-116,240,40,78,.513,28,48,.583,12,30,.400,12,14,.857,104,47,99,.475,34,68,.500,13,31,.419,9,12,.750,116
1428,TOR,2017-11-24,104,@,IND,L 104-107,240,40,81,.494,31,51,.608,9,30,.300,15,20,.750,104,38,83,.458,27,57,.474,11,26,.423,20,27,.741,107
1429,DEN,2017-11-24,104,,MEM,W 104-92,240,40,79,.506,31,47,.660,9,32,.281,15,26,.577,104,36,73,.493,27,49,.551,9,24,.375,11,16,.688,92
1430,MIA,2017-11-22,104,,BOS,W 104-98,240,40,81,.494,30,53,.566,10,28,.357,14,16,.875,104,35,84,.417,26,58,.448,9,26,.346,19,27,.704,98
1431,SAS,2017-11-17,104,,OKC,W 104-101,240,34,77,.442,20,42,.476,14,35,.400,22,28,.786,104,39,89,.438,30,66,.455,9,23,.391,14,21,.667,101
1432,CLE,2017-11-13,104,@,NYK,W 104-101,240,35,88,.398,19,43,.442,16,45,.356,18,22,.818,104,38,88,.432,30,63,.476,8,25,.320,17,22,.773,101
1433,DAL,2017-11-11,104,,CLE,L 104-111,240,39,92,.424,29,58,.500,10,34,.294,16,21,.762,104,35,81,.432,23,50,.460,12,31,.387,29,35,.829,111
1434,ATL,2017-11-10,104,@,DET,L 104-111,240,44,89,.494,36,65,.554,8,24,.333,8,11,.727,104,39,89,.438,27,59,.458,12,30,.400,21,27,.778,111
1435,PHI,2017-11-07,104,@,UTA,W 104-97,240,34,81,.420,22,54,.407,12,27,.444,24,30,.800,104,30,99,.303,21,60,.350,9,39,.231,28,35,.800,97
1436,BRK,2017-11-07,104,@,DEN,L 104-112,240,38,89,.427,27,54,.500,11,35,.314,17,22,.773,104,44,93,.473,35,59,.593,9,34,.265,15,20,.750,112
1437,BOS,2017-11-05,104,@,ORL,W 104-88,240,39,89,.438,28,56,.500,11,33,.333,15,20,.750,104,33,91,.363,27,62,.435,6,29,.207,16,18,.889,88
1438,MIA,2017-11-05,104,@,LAC,W 104-101,240,37,84,.440,23,48,.479,14,36,.389,16,19,.842,104,34,87,.391,25,56,.446,9,31,.290,24,30,.800,101
1439,LAC,2017-11-04,104,,MEM,L 104-113,240,38,83,.458,34,57,.596,4,26,.154,24,31,.774,104,40,84,.476,27,53,.509,13,31,.419,20,24,.833,113
1440,ATL,2017-11-03,104,,HOU,L 104-119,240,39,81,.481,28,48,.583,11,33,.333,15,18,.833,104,42,89,.472,26,42,.619,16,47,.340,19,23,.826,119
1441,MIN,2017-11-01,104,@,NOP,W 104-98,240,41,83,.494,35,61,.574,6,22,.273,16,24,.667,104,36,84,.429,28,53,.528,8,31,.258,18,21,.857,98
1442,CHO,2017-10-30,104,@,MEM,W 104-99,240,37,89,.416,30,72,.417,7,17,.412,23,29,.793,104,32,93,.344,24,58,.414,8,35,.229,27,33,.818,99
1443,UTA,2017-10-30,104,,DAL,W 104-89,240,38,81,.469,22,46,.478,16,35,.457,12,15,.800,104,34,76,.447,22,52,.423,12,24,.500,9,11,.818,89
1444,LAC,2017-10-26,104,@,POR,W 104-103,240,36,77,.468,27,49,.551,9,28,.321,23,36,.639,104,35,89,.393,21,58,.362,14,31,.452,19,22,.864,103
1445,PHI,2017-10-25,104,,HOU,L 104-105,240,43,97,.443,31,61,.508,12,36,.333,6,10,.600,104,36,75,.480,24,36,.667,12,39,.308,21,24,.875,105
1446,MIA,2017-10-23,104,,ATL,W 104-93,240,39,85,.459,25,48,.521,14,37,.378,12,18,.667,104,36,76,.474,29,59,.492,7,17,.412,14,18,.778,93
1447,DEN,2017-10-23,104,,WAS,L 104-109,240,39,80,.488,31,57,.544,8,23,.348,18,23,.783,104,37,84,.440,28,54,.519,9,30,.300,26,28,.929,109
1448,ATL,2017-10-22,104,@,BRK,L 104-116,240,32,94,.340,25,67,.373,7,27,.259,33,36,.917,104,41,87,.471,30,60,.500,11,27,.407,23,34,.676,116
1449,PHO,2018-04-06,103,,NOP,L 103-122,240,37,94,.394,28,61,.459,9,33,.273,20,26,.769,103,45,99,.455,29,61,.475,16,38,.421,16,20,.800,122
1450,ATL,2018-04-06,103,@,WAS,W 103-97,240,38,79,.481,27,46,.587,11,33,.333,16,23,.696,103,35,87,.402,26,62,.419,9,25,.360,18,23,.783,97
1451,PHO,2018-03-30,103,@,HOU,L 103-104,240,41,84,.488,29,52,.558,12,32,.375,9,13,.692,103,35,81,.432,21,43,.488,14,38,.368,20,29,.690,104
1452,MIA,2018-03-29,103,,CHI,W 103-92,240,37,82,.451,30,55,.545,7,27,.259,22,24,.917,103,33,90,.367,27,64,.422,6,26,.231,20,26,.769,92
1453,SAS,2018-03-29,103,,OKC,W 103-99,240,34,81,.420,21,50,.420,13,31,.419,22,30,.733,103,37,85,.435,26,55,.473,11,30,.367,14,21,.667,99
1454,DET,2018-03-29,103,,WAS,W 103-92,240,41,84,.488,35,63,.556,6,21,.286,15,20,.750,103,37,89,.416,31,57,.544,6,32,.188,12,15,.800,92
1455,SAC,2018-03-29,103,,IND,L 103-106,240,42,78,.538,29,47,.617,13,31,.419,6,9,.667,103,40,80,.500,32,54,.593,8,26,.308,18,20,.900,106
1456,POR,2018-03-28,103,@,MEM,L 103-108,240,38,79,.481,30,49,.612,8,30,.267,19,30,.633,103,41,84,.488,28,59,.475,13,25,.520,13,23,.565,108
1457,LAL,2018-03-28,103,,DAL,W 103-93,240,36,77,.468,27,44,.614,9,33,.273,22,32,.688,103,33,84,.393,20,40,.500,13,44,.295,14,19,.737,93
1458,NOP,2018-03-27,103,,POR,L 103-107,240,43,94,.457,39,70,.557,4,24,.167,13,14,.929,103,44,105,.419,34,73,.466,10,32,.313,9,10,.900,107
1459,DAL,2018-03-27,103,@,SAC,W 103-97,240,36,80,.450,22,40,.550,14,40,.350,17,25,.680,103,38,93,.409,32,70,.457,6,23,.261,15,19,.789,97
1460,SAS,2018-03-25,103,@,MIL,L 103-106,240,41,92,.446,37,75,.493,4,17,.235,17,21,.810,103,42,86,.488,33,59,.559,9,27,.333,13,18,.722,106
1461,UTA,2018-03-17,103,,SAC,W 103-97,240,33,74,.446,27,50,.540,6,24,.250,31,38,.816,103,37,86,.430,23,65,.354,14,21,.667,9,14,.643,97
1462,DEN,2018-03-13,103,@,LAL,L 103-112,240,38,86,.442,25,46,.543,13,40,.325,14,19,.737,103,40,90,.444,25,50,.500,15,40,.375,17,25,.680,112
1463,MEM,2018-03-12,103,,MIL,L 103-121,240,42,89,.472,33,62,.532,9,27,.333,10,19,.526,103,47,81,.580,35,56,.625,12,25,.480,15,22,.682,121
1464,GSW,2018-03-11,103,@,MIN,L 103-109,240,37,91,.407,27,55,.491,10,36,.278,19,21,.905,103,44,95,.463,38,75,.507,6,20,.300,15,21,.714,109
1465,LAL,2018-03-05,103,,POR,L 103-108,240,34,87,.391,23,50,.460,11,37,.297,24,31,.774,103,35,83,.422,25,60,.417,10,23,.435,28,38,.737,108
1466,PHO,2018-03-05,103,@,MIA,L 103-125,240,42,87,.483,32,63,.508,10,24,.417,9,18,.500,103,47,92,.511,35,56,.625,12,36,.333,19,23,.826,125
1467,TOR,2018-03-04,103,,CHO,W 103-98,240,35,83,.422,23,42,.548,12,41,.293,21,27,.778,103,32,85,.376,27,64,.422,5,21,.238,29,35,.829,98
1468,IND,2018-03-02,103,@,MIL,W 103-96,240,37,83,.446,31,67,.463,6,16,.375,23,30,.767,103,31,81,.383,22,56,.393,9,25,.360,25,32,.781,96
1469,CHI,2018-02-27,103,@,CHO,L 103-118,240,39,81,.481,30,57,.526,9,24,.375,16,21,.762,103,44,82,.537,29,47,.617,15,35,.429,15,21,.714,118
1470,IND,2018-02-26,103,@,DAL,L 103-109,240,41,87,.471,36,67,.537,5,20,.250,16,23,.696,103,40,88,.455,26,51,.510,14,37,.378,15,18,.833,109
1471,CLE,2018-02-22,103,,WAS,L 103-110,240,42,84,.500,34,49,.694,8,35,.229,11,19,.579,103,44,92,.478,32,62,.516,12,30,.400,10,10,1.000,110
1472,BRK,2018-02-14,103,,IND,L 103-108,240,35,83,.422,22,48,.458,13,35,.371,20,27,.741,103,39,90,.433,33,75,.440,6,15,.400,24,28,.857,108
1473,DET,2018-02-12,103,,NOP,L 103-118,240,35,95,.368,26,60,.433,9,35,.257,24,32,.750,103,44,100,.440,30,66,.455,14,34,.412,16,16,1.000,118
1474,CHO,2018-02-11,103,,TOR,L 103-123,240,38,89,.427,28,66,.424,10,23,.435,17,23,.739,103,49,87,.563,31,50,.620,18,37,.486,7,10,.700,123
1475,CHO,2018-02-08,103,@,POR,L 103-109 (OT),265,38,98,.388,25,65,.385,13,33,.394,14,17,.824,103,41,90,.456,32,59,.542,9,31,.290,18,22,.818,109
1476,DAL,2018-02-08,103,@,GSW,L 103-121,240,40,92,.435,31,55,.564,9,37,.243,14,17,.824,103,45,88,.511,31,59,.525,14,29,.483,17,20,.850,121
1477,MIL,2018-02-06,103,@,NYK,W 103-89,240,37,82,.451,29,56,.518,8,26,.308,21,27,.778,103,37,89,.416,32,66,.485,5,23,.217,10,15,.667,89
1478,CHI,2018-02-03,103,@,LAC,L 103-113,240,35,97,.361,23,60,.383,12,37,.324,21,21,1.000,103,40,88,.455,31,63,.492,9,25,.360,24,28,.857,113
1479,PHI,2018-02-02,103,,MIA,W 103-97,240,42,85,.494,34,61,.557,8,24,.333,11,15,.733,103,34,87,.391,22,50,.440,12,37,.324,17,26,.654,97
1480,BOS,2018-01-31,103,,NYK,W 103-73,240,40,83,.482,29,57,.509,11,26,.423,12,20,.600,103,28,87,.322,25,70,.357,3,17,.176,14,21,.667,73
1481,NOP,2018-01-30,103,,SAC,L 103-114,240,39,77,.506,30,52,.577,9,25,.360,16,22,.727,103,46,97,.474,36,71,.507,10,26,.385,12,14,.857,114
1482,NOP,2018-01-28,103,,LAC,L 103-112,240,38,85,.447,29,50,.580,9,35,.257,18,25,.720,103,45,96,.469,36,68,.529,9,28,.321,13,18,.722,112
1483,CHI,2018-01-26,103,,LAL,L 103-108,240,35,93,.376,18,57,.316,17,36,.472,16,24,.667,103,41,91,.451,36,67,.537,5,24,.208,21,28,.750,108
1484,ORL,2018-01-21,103,@,BOS,W 103-95,240,43,92,.467,37,71,.521,6,21,.286,11,16,.688,103,37,85,.435,29,58,.500,8,27,.296,13,14,.929,95
1485,ORL,2018-01-18,103,@,CLE,L 103-104,240,41,88,.466,36,66,.545,5,22,.227,16,21,.762,103,38,85,.447,28,51,.549,10,34,.294,18,27,.667,104
1486,POR,2018-01-14,103,@,MIN,L 103-120,240,39,79,.494,28,54,.519,11,25,.440,14,17,.824,103,43,80,.538,36,61,.590,7,19,.368,27,33,.818,120
1487,PHI,2018-01-11,103,,BOS,L 103-114,240,38,82,.463,27,54,.500,11,28,.393,16,18,.889,103,43,89,.483,30,54,.556,13,35,.371,15,19,.789,114
1488,ORL,2018-01-10,103,@,MIL,L 103-110,240,39,90,.433,31,61,.508,8,29,.276,17,18,.944,103,45,82,.549,41,63,.651,4,19,.211,16,25,.640,110
1489,MIA,2018-01-07,103,,UTA,W 103-102,240,40,83,.482,31,54,.574,9,29,.310,14,20,.700,103,37,82,.451,27,50,.540,10,32,.313,18,20,.900,102
1490,WAS,2018-01-06,103,,MIL,L 103-110,240,37,78,.474,29,57,.509,8,21,.381,21,29,.724,103,39,80,.488,32,58,.552,7,22,.318,25,30,.833,110
1491,NYK,2018-01-05,103,@,MIA,L 103-107 (OT),265,39,80,.488,34,67,.507,5,13,.385,20,23,.870,103,38,94,.404,26,52,.500,12,42,.286,19,20,.950,107
1492,SAS,2018-01-05,103,,PHO,W 103-89,240,41,87,.471,30,57,.526,11,30,.367,10,18,.556,103,35,83,.422,28,53,.528,7,30,.233,12,18,.667,89
1493,NYK,2018-01-03,103,@,WAS,L 103-121,240,41,86,.477,34,67,.507,7,19,.368,14,18,.778,103,48,81,.593,39,58,.672,9,23,.391,16,26,.615,121
1494,ATL,2018-01-02,103,@,PHO,L 103-104,240,36,87,.414,26,56,.464,10,31,.323,21,25,.840,103,39,77,.506,32,55,.582,7,22,.318,19,26,.731,104
1495,NOP,2017-12-30,103,,NYK,L 103-105,240,38,84,.452,32,58,.552,6,26,.231,21,27,.778,103,41,94,.436,36,75,.480,5,19,.263,18,21,.857,105
1496,HOU,2017-12-29,103,@,WAS,L 103-121,240,38,89,.427,24,41,.585,14,48,.292,13,16,.813,103,47,88,.534,29,52,.558,18,36,.500,9,12,.750,121
1497,BOS,2017-12-25,103,,WAS,L 103-111,240,39,81,.481,25,52,.481,14,29,.483,11,17,.647,103,43,93,.462,37,67,.552,6,26,.231,19,28,.679,111
1498,ORL,2017-12-23,103,@,WAS,L 103-130,240,42,87,.483,34,61,.557,8,26,.308,11,17,.647,103,47,86,.547,31,56,.554,16,30,.533,20,23,.870,130
1499,OKC,2017-12-23,103,@,UTA,W 103-89,240,39,88,.443,27,59,.458,12,29,.414,13,16,.813,103,33,72,.458,27,46,.587,6,26,.231,17,20,.850,89
1500,CHI,2017-12-13,103,,UTA,W 103-100,240,41,93,.441,34,76,.447,7,17,.412,14,21,.667,103,42,91,.462,33,61,.541,9,30,.300,7,7,1.000,100
1501,DEN,2017-12-12,103,@,DET,W 103-84,240,40,79,.506,30,49,.612,10,30,.333,13,14,.929,103,28,79,.354,19,54,.352,9,25,.360,19,22,.864,84
1502,BRK,2017-12-12,103,,WAS,W 103-98,240,34,84,.405,24,41,.585,10,43,.233,25,33,.758,103,38,95,.400,34,73,.466,4,22,.182,18,22,.818,98
1503,OKC,2017-12-11,103,,CHO,L 103-116,240,35,85,.412,26,59,.441,9,26,.346,24,25,.960,103,43,81,.531,30,56,.536,13,25,.520,17,24,.708,116
1504,DEN,2017-12-08,103,@,ORL,W 103-89,240,42,85,.494,36,64,.563,6,21,.286,13,16,.813,103,33,83,.398,28,62,.452,5,21,.238,18,23,.783,89
1505,DET,2017-12-02,103,@,PHI,L 103-108,240,34,78,.436,25,47,.532,9,31,.290,26,32,.813,103,35,86,.407,25,58,.431,10,28,.357,28,32,.875,108
1506,MIL,2017-11-30,103,@,POR,W 103-91,240,42,87,.483,36,67,.537,6,20,.300,13,15,.867,103,35,83,.422,29,60,.483,6,23,.261,15,17,.882,91
1507,BRK,2017-11-27,103,@,HOU,L 103-117,240,40,86,.465,30,47,.638,10,39,.256,13,17,.765,103,42,86,.488,22,36,.611,20,50,.400,13,20,.650,117
1508,POR,2017-11-27,103,@,NYK,W 103-91,240,37,83,.446,30,62,.484,7,21,.333,22,26,.846,103,35,88,.398,30,73,.411,5,15,.333,16,22,.727,91
1509,ORL,2017-11-24,103,@,BOS,L 103-118,240,41,95,.432,32,71,.451,9,24,.375,12,19,.632,103,42,91,.462,25,49,.510,17,42,.405,17,25,.680,118
1510,ATL,2017-11-22,103,,LAC,L 103-116,240,40,83,.482,30,54,.556,10,29,.345,13,15,.867,103,44,76,.579,29,46,.630,15,30,.500,13,19,.684,116
1511,LAL,2017-11-21,103,,CHI,W 103-94,240,36,90,.400,23,50,.460,13,40,.325,18,25,.720,103,36,94,.383,25,58,.431,11,36,.306,11,16,.688,94
1512,MEM,2017-11-13,103,@,MIL,L 103-110,240,37,76,.487,26,50,.520,11,26,.423,18,21,.857,103,40,82,.488,28,60,.467,12,22,.545,18,25,.720,110
1513,MIA,2017-11-12,103,@,DET,L 103-112,240,39,90,.433,26,53,.491,13,37,.351,12,16,.750,103,42,87,.483,28,59,.475,14,28,.500,14,20,.700,112
1514,LAC,2017-11-11,103,@,NOP,L 103-111,240,35,86,.407,25,60,.417,10,26,.385,23,27,.852,103,43,80,.538,37,64,.578,6,16,.375,19,24,.792,111
1515,POR,2017-11-05,103,,OKC,W 103-99,240,37,74,.500,30,54,.556,7,20,.350,22,28,.786,103,40,89,.449,29,56,.518,11,33,.333,8,15,.533,99
1516,POR,2017-11-01,103,@,UTA,L 103-112 (OT),265,37,93,.398,28,59,.475,9,34,.265,20,27,.741,103,34,90,.378,21,61,.344,13,29,.448,31,36,.861,112
1517,MEM,2017-10-28,103,,HOU,W 103-89,240,40,85,.471,26,52,.500,14,33,.424,9,12,.750,103,29,77,.377,15,39,.385,14,38,.368,17,21,.810,89
1518,POR,2017-10-26,103,,LAC,L 103-104,240,35,89,.393,21,58,.362,14,31,.452,19,22,.864,103,36,77,.468,27,49,.551,9,28,.321,23,36,.639,104
1519,DAL,2017-10-25,103,,MEM,W 103-94,240,36,74,.486,25,48,.521,11,26,.423,20,29,.690,103,33,72,.458,21,41,.512,12,31,.387,16,24,.667,94
1520,POR,2017-10-24,103,,NOP,W 103-93,240,33,88,.375,23,59,.390,10,29,.345,27,33,.818,103,30,76,.395,21,46,.457,9,30,.300,24,32,.750,93
1521,DAL,2017-10-23,103,,GSW,L 103-133,240,38,96,.396,29,67,.433,9,29,.310,18,30,.600,103,48,86,.558,33,47,.702,15,39,.385,22,26,.846,133
1522,MIL,2017-10-23,103,,CHO,W 103-94,240,40,85,.471,31,59,.525,9,26,.346,14,16,.875,103,33,78,.423,26,52,.500,7,26,.269,21,36,.583,94
1523,MEM,2017-10-18,103,,NOP,W 103-91,240,39,92,.424,30,63,.476,9,29,.310,16,28,.571,103,30,79,.380,23,54,.426,7,25,.280,24,29,.828,91
1524,POR,2018-04-11,102,,UTA,W 102-93,240,41,89,.461,32,65,.492,9,24,.375,11,16,.688,102,33,89,.371,25,66,.379,8,23,.348,19,24,.792,93
1525,MIL,2018-04-09,102,,ORL,W 102-86,240,39,91,.429,30,65,.462,9,26,.346,15,18,.833,102,34,82,.415,29,58,.500,5,24,.208,13,20,.650,86
1526,NYK,2018-04-07,102,,MIL,L 102-115,240,41,95,.432,32,74,.432,9,21,.429,11,11,1.000,102,45,93,.484,35,68,.515,10,25,.400,15,17,.882,115
1527,HOU,2018-04-07,102,,OKC,L 102-108,240,36,76,.474,22,39,.564,14,37,.378,16,23,.696,102,36,91,.396,26,58,.448,10,33,.303,26,33,.788,108
1528,BOS,2018-04-03,102,@,MIL,L 102-106,240,38,81,.469,31,58,.534,7,23,.304,19,24,.792,102,43,79,.544,38,59,.644,5,20,.250,15,21,.714,106
1529,CHO,2018-04-01,102,,PHI,L 102-119,240,33,82,.402,24,52,.462,9,30,.300,27,34,.794,102,48,94,.511,34,62,.548,14,32,.438,9,10,.900,119
1530,NOP,2018-03-30,102,@,CLE,L 102-107,240,43,89,.483,32,63,.508,11,26,.423,5,6,.833,102,43,90,.478,33,66,.500,10,24,.417,11,15,.733,107
1531,BOS,2018-03-26,102,@,PHO,W 102-94,240,37,87,.425,23,58,.397,14,29,.483,14,14,1.000,102,36,81,.444,24,46,.522,12,35,.343,10,19,.526,94
1532,CHO,2018-03-24,102,@,DAL,W 102-98,240,35,92,.380,23,67,.343,12,25,.480,20,29,.690,102,36,91,.396,24,50,.480,12,41,.293,14,19,.737,98
1533,CHI,2018-03-21,102,,DEN,L 102-135,240,39,89,.438,26,51,.510,13,38,.342,11,14,.786,102,51,83,.614,31,48,.646,20,35,.571,13,16,.813,135
1534,IND,2018-03-17,102,@,WAS,L 102-109,240,39,86,.453,27,62,.435,12,24,.500,12,15,.800,102,40,74,.541,30,54,.556,10,20,.500,19,23,.826,109
1535,BRK,2018-03-13,102,,TOR,L 102-116,240,35,86,.407,20,50,.400,15,36,.417,17,19,.895,102,44,91,.484,33,60,.550,11,31,.355,17,21,.810,116
1536,WAS,2018-03-10,102,@,MIA,L 102-129,240,34,77,.442,27,57,.474,7,20,.350,27,34,.794,102,52,88,.591,42,60,.700,10,28,.357,15,21,.714,129
1537,CLE,2018-03-09,102,@,LAC,L 102-116,240,39,87,.448,27,51,.529,12,36,.333,12,18,.667,102,43,89,.483,32,61,.525,11,28,.393,19,30,.633,116
1538,SAC,2018-03-04,102,,NYK,W 102-99,240,39,86,.453,26,56,.464,13,30,.433,11,11,1.000,102,40,88,.455,34,67,.507,6,21,.286,13,18,.722,99
1539,MEM,2018-03-02,102,,DEN,L 102-108,240,40,91,.440,30,64,.469,10,27,.370,12,15,.800,102,40,73,.548,34,51,.667,6,22,.273,22,26,.846,108
1540,TOR,2018-03-02,102,@,WAS,W 102-95,240,36,78,.462,26,45,.578,10,33,.303,20,32,.625,102,36,79,.456,27,55,.491,9,24,.375,14,21,.667,95
1541,IND,2018-02-28,102,@,ATL,L 102-107,240,38,90,.422,27,58,.466,11,32,.344,15,20,.750,102,38,87,.437,29,58,.500,9,29,.310,22,27,.815,107
1542,MEM,2018-02-28,102,,PHO,L 102-110,240,33,87,.379,20,56,.357,13,31,.419,23,28,.821,102,38,83,.458,32,62,.516,6,21,.286,28,38,.737,110
1543,MIA,2018-02-27,102,,PHI,W 102-101,240,36,82,.439,27,55,.491,9,27,.333,21,28,.750,102,35,84,.417,23,53,.434,12,31,.387,19,23,.826,101
1544,DAL,2018-02-23,102,@,LAL,L 102-124,240,37,91,.407,18,49,.367,19,42,.452,9,11,.818,102,48,93,.516,35,60,.583,13,33,.394,15,20,.750,124
1545,MIN,2018-02-23,102,@,HOU,L 102-120,240,40,94,.426,30,68,.441,10,26,.385,12,16,.750,102,40,83,.482,26,45,.578,14,38,.368,26,30,.867,120
1546,MIA,2018-02-14,102,@,PHI,L 102-104,240,35,77,.455,24,50,.480,11,27,.407,21,29,.724,102,39,92,.424,30,57,.526,9,35,.257,17,25,.680,104
1547,ORL,2018-02-14,102,,CHO,L 102-104,240,36,86,.419,21,49,.429,15,37,.405,15,17,.882,102,38,88,.432,25,58,.431,13,30,.433,15,19,.789,104
1548,WAS,2018-02-06,102,@,PHI,L 102-115,240,41,93,.441,34,66,.515,7,27,.259,13,18,.722,102,45,82,.549,31,54,.574,14,28,.500,11,14,.786,115
1549,IND,2018-02-05,102,,WAS,L 102-111,240,37,80,.463,25,51,.490,12,29,.414,16,25,.640,102,45,82,.549,38,57,.667,7,25,.280,14,17,.824,111
1550,LAL,2018-02-02,102,@,BRK,W 102-99,240,39,92,.424,29,66,.439,10,26,.385,14,20,.700,102,37,82,.451,28,53,.528,9,29,.310,16,23,.696,99
1551,HOU,2018-02-01,102,@,SAS,W 102-91,240,37,83,.446,23,41,.561,14,42,.333,14,17,.824,102,35,83,.422,29,59,.492,6,24,.250,15,17,.882,91
1552,MEM,2018-02-01,102,@,DET,L 102-104,240,40,96,.417,32,65,.492,8,31,.258,14,14,1.000,102,35,76,.461,28,51,.549,7,25,.280,27,37,.730,104
1553,PHO,2018-01-31,102,,DAL,W 102-88,240,40,83,.482,29,53,.547,11,30,.367,11,15,.733,102,32,88,.364,22,52,.423,10,36,.278,14,26,.538,88
1554,WAS,2018-01-30,102,,OKC,W 102-96,240,34,89,.382,27,64,.422,7,25,.280,27,29,.931,102,30,80,.375,21,48,.438,9,32,.281,27,34,.794,96
1555,PHO,2018-01-28,102,@,HOU,L 102-113,240,36,85,.424,28,52,.538,8,33,.242,22,26,.846,102,32,72,.444,21,35,.600,11,37,.297,38,49,.776,113
1556,LAC,2018-01-24,102,,BOS,L 102-113,240,35,79,.443,30,58,.517,5,21,.238,27,39,.692,102,39,93,.419,25,53,.472,14,40,.350,21,22,.955,113
1557,CLE,2018-01-23,102,@,SAS,L 102-114,240,35,72,.486,29,51,.569,6,21,.286,26,31,.839,102,47,94,.500,39,66,.591,8,28,.286,12,16,.750,114
1558,DAL,2018-01-16,102,@,DEN,L 102-105,240,38,78,.487,30,51,.588,8,27,.296,18,22,.818,102,40,86,.465,32,60,.533,8,26,.308,17,26,.654,105
1559,MIN,2018-01-16,102,@,ORL,L 102-108,240,43,98,.439,36,82,.439,7,16,.438,9,10,.900,102,40,90,.444,29,59,.492,11,31,.355,17,19,.895,108
1560,HOU,2018-01-15,102,@,LAC,L 102-113,240,38,94,.404,25,50,.500,13,44,.295,13,16,.813,102,44,79,.557,34,54,.630,10,25,.400,15,20,.750,113
1561,ATL,2018-01-15,102,,SAS,W 102-99,240,40,86,.465,31,61,.508,9,25,.360,13,14,.929,102,37,87,.425,29,65,.446,8,22,.364,17,20,.850,99
1562,NOP,2018-01-10,102,@,MEM,L 102-105,240,34,77,.442,23,42,.548,11,35,.314,23,34,.676,102,37,88,.420,32,69,.464,5,19,.263,26,32,.813,105
1563,UTA,2018-01-07,102,@,MIA,L 102-103,240,37,82,.451,27,50,.540,10,32,.313,18,20,.900,102,40,83,.482,31,54,.574,9,29,.310,14,20,.700,103
1564,WAS,2018-01-05,102,@,MEM,W 102-100,240,33,84,.393,23,57,.404,10,27,.370,26,34,.765,102,35,86,.407,25,56,.446,10,30,.333,20,26,.769,100
1565,BOS,2018-01-03,102,,CLE,W 102-88,240,41,92,.446,29,56,.518,12,36,.333,8,11,.727,102,31,89,.348,23,57,.404,8,32,.250,18,18,1.000,88
1566,DEN,2017-12-30,102,,PHI,L 102-107,240,35,87,.402,28,55,.509,7,32,.219,25,34,.735,102,45,93,.484,37,69,.536,8,24,.333,9,10,.900,107
1567,ORL,2017-12-28,102,,DET,W 102-89,240,37,82,.451,26,56,.464,11,26,.423,17,17,1.000,102,35,87,.402,26,64,.406,9,23,.391,10,14,.714,89
1568,MIL,2017-12-28,102,,MIN,W 102-96,240,41,75,.547,36,60,.600,5,15,.333,15,16,.938,102,34,71,.479,25,43,.581,9,28,.321,19,26,.731,96
1569,BOS,2017-12-27,102,@,CHO,W 102-91,240,37,78,.474,22,44,.500,15,34,.441,13,13,1.000,102,32,87,.368,25,64,.391,7,23,.304,20,29,.690,91
1570,TOR,2017-12-23,102,,PHI,W 102-86,240,35,85,.412,26,58,.448,9,27,.333,23,26,.885,102,33,80,.413,26,53,.491,7,27,.259,13,20,.650,86
1571,DEN,2017-12-22,102,@,POR,W 102-85,240,42,85,.494,35,60,.583,7,25,.280,11,15,.733,102,35,83,.422,29,61,.475,6,22,.273,9,16,.563,85
1572,NYK,2017-12-21,102,,BOS,W 102-93,240,36,79,.456,28,65,.431,8,14,.571,22,26,.846,102,33,86,.384,20,48,.417,13,38,.342,14,19,.737,93
1573,BOS,2017-12-16,102,@,MEM,W 102-93,240,39,80,.488,25,50,.500,14,30,.467,10,14,.714,102,32,79,.405,18,45,.400,14,34,.412,15,17,.882,93
1574,POR,2017-12-13,102,@,MIA,W 102-95,240,36,72,.500,26,44,.591,10,28,.357,20,23,.870,102,34,72,.472,21,42,.500,13,30,.433,14,23,.609,95
1575,TOR,2017-12-10,102,@,SAC,W 102-87,240,39,87,.448,28,50,.560,11,37,.297,13,19,.684,102,35,73,.479,25,50,.500,10,23,.435,7,14,.500,87
1576,OKC,2017-12-09,102,@,MEM,W 102-101 (OT),265,36,92,.391,24,58,.414,12,34,.353,18,31,.581,102,39,88,.443,26,55,.473,13,33,.394,10,17,.588,101
1577,NYK,2017-12-09,102,@,CHI,L 102-104,240,43,91,.473,36,67,.537,7,24,.292,9,9,1.000,102,42,82,.512,35,57,.614,7,25,.280,13,23,.565,104
1578,DAL,2017-12-08,102,@,MIL,L 102-109,240,35,75,.467,25,51,.490,10,24,.417,22,26,.846,102,36,79,.456,28,55,.509,8,24,.333,29,34,.853,109
1579,BOS,2017-12-08,102,@,SAS,L 102-105,240,38,83,.458,27,45,.600,11,38,.289,15,17,.882,102,38,81,.469,30,54,.556,8,27,.296,21,24,.875,105
1580,GSW,2017-12-08,102,@,DET,W 102-98,240,39,81,.481,32,55,.582,7,26,.269,17,22,.773,102,38,92,.413,26,65,.400,12,27,.444,10,19,.526,98
1581,CLE,2017-12-08,102,@,IND,L 102-106,240,37,85,.435,26,49,.531,11,36,.306,17,22,.773,102,38,86,.442,23,47,.489,15,39,.385,15,24,.625,106
1582,BRK,2017-12-02,102,,ATL,L 102-114,240,34,82,.415,17,40,.425,17,42,.405,17,21,.810,102,47,99,.475,37,72,.514,10,27,.370,10,14,.714,114
1583,NOP,2017-11-29,102,,MIN,L 102-120,240,39,84,.464,25,49,.510,14,35,.400,10,11,.909,102,47,81,.580,38,58,.655,9,23,.391,17,19,.895,120
1584,NYK,2017-11-25,102,@,HOU,L 102-117,240,42,85,.494,38,68,.559,4,17,.235,14,19,.737,102,41,94,.436,23,47,.489,18,47,.383,17,22,.773,117
1585,LAL,2017-11-22,102,@,SAC,L 102-113,240,39,78,.500,24,49,.490,15,29,.517,9,15,.600,102,47,85,.553,37,64,.578,10,21,.476,9,14,.643,113
1586,MIN,2017-11-20,102,@,CHO,L 102-118,240,37,90,.411,31,63,.492,6,27,.222,22,26,.846,102,42,85,.494,31,59,.525,11,26,.423,23,29,.793,118
1587,DAL,2017-11-20,102,,BOS,L 102-110 (OT),265,39,96,.406,32,63,.508,7,33,.212,17,20,.850,102,38,84,.452,25,48,.521,13,36,.361,21,26,.808,110
1588,POR,2017-11-18,102,,SAC,W 102-90,240,38,70,.543,28,49,.571,10,21,.476,16,21,.762,102,34,89,.382,26,72,.361,8,17,.471,14,18,.778,90
1589,CHO,2017-11-18,102,,LAC,W 102-87,240,34,87,.391,23,61,.377,11,26,.423,23,29,.793,102,33,83,.398,25,54,.463,8,29,.276,13,19,.684,87
1590,WAS,2017-11-15,102,@,MIA,W 102-93,240,32,78,.410,23,59,.390,9,19,.474,29,31,.935,102,32,78,.410,19,48,.396,13,30,.433,16,19,.842,93
1591,BRK,2017-11-14,102,,BOS,L 102-109,240,39,88,.443,25,53,.472,14,35,.400,10,16,.625,102,39,86,.453,30,59,.508,9,27,.333,22,27,.815,109
1592,DEN,2017-11-09,102,,OKC,W 102-94,240,38,82,.463,29,55,.527,9,27,.333,17,22,.773,102,38,90,.422,27,60,.450,11,30,.367,7,14,.500,94
1593,MEM,2017-11-05,102,@,LAL,L 102-107,240,40,87,.460,29,50,.580,11,37,.297,11,14,.786,102,40,85,.471,31,58,.534,9,27,.333,18,23,.783,107
1594,LAL,2017-10-25,102,,WAS,W 102-99 (OT),265,41,92,.446,34,62,.548,7,30,.233,13,16,.813,102,39,95,.411,33,69,.478,6,26,.231,15,23,.652,99
1595,LAC,2017-10-24,102,,UTA,W 102-84,240,39,83,.470,29,54,.537,10,29,.345,14,21,.667,102,34,79,.430,27,51,.529,7,28,.250,9,11,.818,84
1596,BOS,2017-10-20,102,@,PHI,W 102-92,240,35,84,.417,25,55,.455,10,29,.345,22,32,.688,102,35,92,.380,25,60,.417,10,32,.313,12,16,.750,92
1597,DET,2017-10-18,102,,CHO,W 102-90,240,41,96,.427,32,70,.457,9,26,.346,11,12,.917,102,29,73,.397,20,43,.465,9,30,.300,23,29,.793,90
1598,CLE,2017-10-17,102,,BOS,W 102-99,240,38,83,.458,33,61,.541,5,22,.227,21,25,.840,102,36,88,.409,28,56,.500,8,32,.250,19,25,.760,99
1599,ORL,2018-04-11,101,,WAS,W 101-92,240,33,77,.429,20,45,.444,13,32,.406,22,27,.815,101,33,95,.347,23,61,.377,10,34,.294,16,27,.593,92
1600,BOS,2018-04-10,101,@,WAS,L 101-113,240,33,87,.379,20,54,.370,13,33,.394,22,27,.815,101,41,83,.494,26,53,.491,15,30,.500,16,20,.800,113
1601,ORL,2018-04-08,101,@,TOR,L 101-112,240,42,89,.472,35,66,.530,7,23,.304,10,17,.588,101,39,78,.500,22,38,.579,17,40,.425,17,24,.708,112
1602,MIA,2018-04-03,101,,ATL,W 101-98,240,41,91,.451,33,58,.569,8,33,.242,11,13,.846,101,37,88,.420,24,55,.436,13,33,.394,11,15,.733,98
1603,PHI,2018-03-30,101,@,ATL,W 101-91,240,42,95,.442,34,57,.596,8,38,.211,9,13,.692,101,36,101,.356,27,62,.435,9,39,.231,10,15,.667,91
1604,NYK,2018-03-28,101,@,PHI,L 101-118,240,36,94,.383,27,63,.429,9,31,.290,20,26,.769,101,45,98,.459,36,67,.537,9,31,.290,19,27,.704,118
1605,MEM,2018-03-26,101,@,MIN,W 101-93,240,40,84,.476,25,53,.472,15,31,.484,6,9,.667,101,33,79,.418,25,55,.455,8,24,.333,19,24,.792,93
1606,NYK,2018-03-25,101,@,WAS,W 101-97,240,41,88,.466,35,66,.530,6,22,.273,13,15,.867,101,37,87,.425,31,68,.456,6,19,.316,17,23,.739,97
1607,CHO,2018-03-17,101,@,NYK,L 101-124,240,33,90,.367,24,57,.421,9,33,.273,26,32,.813,101,49,100,.490,37,74,.500,12,26,.462,14,18,.778,124
1608,NOP,2018-03-17,101,,HOU,L 101-107,240,41,83,.494,33,59,.559,8,24,.333,11,12,.917,101,39,93,.419,24,52,.462,15,41,.366,14,18,.778,107
1609,MIN,2018-03-17,101,@,SAS,L 101-117,240,39,81,.481,32,69,.464,7,12,.583,16,20,.800,101,49,96,.510,43,70,.614,6,26,.231,13,14,.929,117
1610,MEM,2018-03-17,101,,DEN,W 101-94,240,33,81,.407,20,49,.408,13,32,.406,22,28,.786,101,32,87,.368,23,54,.426,9,33,.273,21,29,.724,94
1611,HOU,2018-03-15,101,,LAC,W 101-96,240,35,90,.389,23,49,.469,12,41,.293,19,23,.826,101,44,97,.454,40,79,.506,4,18,.222,4,8,.500,96
1612,IND,2018-03-13,101,@,PHI,W 101-98,240,38,95,.400,33,71,.465,5,24,.208,20,25,.800,101,35,75,.467,25,45,.556,10,30,.333,18,22,.818,98
1613,SAC,2018-03-12,101,@,OKC,L 101-106,240,38,93,.409,26,60,.433,12,33,.364,13,16,.813,101,38,84,.452,22,48,.458,16,36,.444,14,18,.778,106
1614,SAC,2018-03-07,101,,NOP,L 101-114,240,39,93,.419,30,65,.462,9,28,.321,14,17,.824,101,47,83,.566,36,57,.632,11,26,.423,9,9,1.000,114
1615,BRK,2018-03-06,101,@,GSW,L 101-114,240,36,85,.424,27,51,.529,9,34,.265,20,25,.800,101,47,83,.566,36,60,.600,11,23,.478,9,11,.818,114
1616,WAS,2018-02-28,101,,GSW,L 101-109,240,36,90,.400,25,58,.431,11,32,.344,18,21,.857,101,37,72,.514,27,48,.563,10,24,.417,25,30,.833,109
1617,PHI,2018-02-27,101,@,MIA,L 101-102,240,35,84,.417,23,53,.434,12,31,.387,19,23,.826,101,36,82,.439,27,55,.491,9,27,.333,21,28,.750,102
1618,UTA,2018-02-12,101,,SAS,W 101-99,240,35,84,.417,24,60,.400,11,24,.458,20,30,.667,101,38,85,.447,32,60,.533,6,25,.240,17,25,.680,99
1619,BRK,2018-02-12,101,,LAC,L 101-114,240,41,89,.461,29,49,.592,12,40,.300,7,10,.700,101,48,85,.565,42,69,.609,6,16,.375,12,14,.857,114
1620,ORL,2018-02-12,101,@,CHI,L 101-105,240,37,84,.440,27,53,.509,10,31,.323,17,19,.895,101,40,88,.455,31,56,.554,9,32,.281,16,21,.762,105
1621,WAS,2018-02-10,101,@,CHI,W 101-90,240,38,82,.463,25,44,.568,13,38,.342,12,14,.857,101,34,80,.425,25,48,.521,9,32,.281,13,16,.813,90
1622,MIA,2018-02-07,101,,HOU,L 101-109,240,39,88,.443,26,56,.464,13,32,.406,10,12,.833,101,38,74,.514,26,43,.605,12,31,.387,21,26,.808,109
1623,DAL,2018-02-05,101,@,LAC,L 101-104,240,33,80,.413,16,38,.421,17,42,.405,18,20,.900,101,42,87,.483,32,60,.533,10,27,.370,10,12,.833,104
1624,TOR,2018-02-04,101,,MEM,W 101-86,240,41,89,.461,35,54,.648,6,35,.171,13,15,.867,101,29,81,.358,21,56,.375,8,25,.320,20,23,.870,86
1625,MEM,2018-01-31,101,@,IND,L 101-105,240,39,82,.476,27,56,.482,12,26,.462,11,15,.733,101,37,70,.529,27,44,.614,10,26,.385,21,31,.677,105
1626,NOP,2018-01-24,101,@,CHO,W 101-96,240,39,87,.448,30,61,.492,9,26,.346,14,18,.778,101,36,85,.424,30,64,.469,6,21,.286,18,31,.581,96
1627,PHO,2018-01-24,101,@,IND,L 101-116,240,35,84,.417,26,49,.531,9,35,.257,22,29,.759,101,45,80,.563,36,56,.643,9,24,.375,17,25,.680,116
1628,CHI,2018-01-24,101,@,PHI,L 101-115,240,36,94,.383,25,57,.439,11,37,.297,18,22,.818,101,42,81,.519,26,49,.531,16,32,.500,15,20,.750,115
1629,PHI,2018-01-22,101,@,MEM,L 101-105,240,32,71,.451,18,40,.450,14,31,.452,23,31,.742,101,33,78,.423,23,52,.442,10,26,.385,29,35,.829,105
1630,POR,2018-01-22,101,@,DEN,L 101-104,240,36,85,.424,28,60,.467,8,25,.320,21,26,.808,101,34,83,.410,24,53,.453,10,30,.333,26,33,.788,104
1631,BRK,2018-01-21,101,@,DET,W 101-100,240,37,80,.463,24,49,.490,13,31,.419,14,20,.700,101,38,90,.422,29,61,.475,9,29,.310,15,17,.882,100
1632,BRK,2018-01-19,101,,MIA,W 101-95,240,36,76,.474,27,44,.614,9,32,.281,20,26,.769,101,35,84,.417,28,62,.452,7,22,.318,18,25,.720,95
1633,MIL,2018-01-17,101,,MIA,L 101-106,240,33,76,.434,22,48,.458,11,28,.393,24,32,.750,101,38,82,.463,28,58,.483,10,24,.417,20,27,.741,106
1634,OKC,2018-01-13,101,@,CHO,W 101-91,240,39,97,.402,31,71,.437,8,26,.308,15,20,.750,101,33,83,.398,24,55,.436,9,28,.321,16,23,.696,91
1635,DAL,2018-01-13,101,,LAL,L 101-107 (OT),265,34,90,.378,23,47,.489,11,43,.256,22,28,.786,101,43,95,.453,35,69,.507,8,26,.308,13,18,.722,107
1636,HOU,2018-01-06,101,@,DET,L 101-108,240,38,90,.422,23,43,.535,15,47,.319,10,11,.909,101,38,75,.507,26,50,.520,12,25,.480,20,27,.741,108
1637,IND,2018-01-03,101,@,MIL,L 101-122,240,41,84,.488,38,69,.551,3,15,.200,16,19,.842,101,44,75,.587,35,58,.603,9,17,.529,25,28,.893,122
1638,CLE,2017-12-30,101,@,UTA,L 101-104,240,34,81,.420,22,41,.537,12,40,.300,21,26,.808,101,38,82,.463,28,51,.549,10,31,.323,18,21,.857,104
1639,SAC,2017-12-29,101,,PHO,L 101-111,240,37,80,.463,29,57,.509,8,23,.348,19,23,.826,101,41,85,.482,28,55,.509,13,30,.433,16,24,.667,111
1640,UTA,2017-12-27,101,@,GSW,L 101-126,240,37,92,.402,31,69,.449,6,23,.261,21,27,.778,101,51,86,.593,40,63,.635,11,23,.478,13,17,.765,126
1641,DAL,2017-12-22,101,@,MIA,L 101-113,240,38,75,.507,21,40,.525,17,35,.486,8,11,.727,101,46,72,.639,30,47,.638,16,25,.640,5,6,.833,113
1642,NYK,2017-12-22,101,@,DET,L 101-104,240,44,97,.454,36,73,.493,8,24,.333,5,6,.833,101,38,88,.432,28,63,.444,10,25,.400,18,25,.720,104
1643,SAC,2017-12-19,101,@,PHI,W 101-95,240,41,91,.451,34,64,.531,7,27,.259,12,23,.522,101,34,81,.420,24,46,.522,10,35,.286,17,24,.708,95
1644,MEM,2017-12-09,101,,OKC,L 101-102 (OT),265,39,88,.443,26,55,.473,13,33,.394,10,17,.588,101,36,92,.391,24,58,.414,12,34,.353,18,31,.581,102
1645,MIA,2017-12-09,101,@,BRK,W 101-89,240,42,90,.467,34,63,.540,8,27,.296,9,14,.643,101,33,81,.407,26,54,.481,7,27,.259,16,19,.842,89
1646,PHO,2017-12-09,101,,SAS,L 101-104,240,35,80,.438,28,55,.509,7,25,.280,24,30,.800,101,40,87,.460,34,68,.500,6,19,.316,18,25,.720,104
1647,UTA,2017-12-07,101,,HOU,L 101-112,240,34,77,.442,23,47,.489,11,30,.367,22,27,.815,101,38,81,.469,20,39,.513,18,42,.429,18,24,.750,112
1648,CLE,2017-12-06,101,,SAC,W 101-95,240,37,78,.474,23,39,.590,14,39,.359,13,21,.619,101,39,86,.453,29,54,.537,10,32,.313,7,13,.538,95
1649,GSW,2017-12-06,101,@,CHO,W 101-87,240,40,84,.476,29,54,.537,11,30,.367,10,13,.769,101,34,97,.351,28,78,.359,6,19,.316,13,17,.765,87
1650,PHI,2017-12-04,101,,PHO,L 101-115,240,39,91,.429,32,61,.525,7,30,.233,16,16,1.000,101,44,91,.484,34,69,.493,10,22,.455,17,22,.773,115
1651,PHI,2017-11-22,101,,POR,W 101-81,240,39,90,.433,28,58,.483,11,32,.344,12,17,.706,101,30,89,.337,23,63,.365,7,26,.269,14,24,.583,81
1652,OKC,2017-11-17,101,@,SAS,L 101-104,240,39,89,.438,30,66,.455,9,23,.391,14,21,.667,101,34,77,.442,20,42,.476,14,35,.400,22,28,.786,104
1653,UTA,2017-11-15,101,@,NYK,L 101-106,240,34,79,.430,17,44,.386,17,35,.486,16,17,.941,101,38,81,.469,29,60,.483,9,21,.429,21,25,.840,106
1654,NYK,2017-11-13,101,,CLE,L 101-104,240,38,88,.432,30,63,.476,8,25,.320,17,22,.773,101,35,88,.398,19,43,.442,16,45,.356,18,22,.818,104
1655,BRK,2017-11-10,101,@,POR,W 101-97,240,39,91,.429,27,53,.509,12,38,.316,11,19,.579,101,40,95,.421,32,72,.444,8,23,.348,9,11,.818,97
1656,MIN,2017-11-08,101,@,GSW,L 101-125,240,38,92,.413,33,68,.485,5,24,.208,20,27,.741,101,48,85,.565,33,49,.673,15,36,.417,14,18,.778,125
1657,LAC,2017-11-05,101,,MIA,L 101-104,240,34,87,.391,25,56,.446,9,31,.290,24,30,.800,101,37,84,.440,23,48,.479,14,36,.389,16,19,.842,104
1658,IND,2017-11-05,101,@,NYK,L 101-108,240,37,79,.468,25,54,.463,12,25,.480,15,17,.882,101,44,88,.500,38,65,.585,6,23,.261,14,19,.737,108
1659,BOS,2017-11-03,101,@,OKC,W 101-94,240,36,84,.429,23,56,.411,13,28,.464,16,24,.667,101,35,87,.402,22,52,.423,13,35,.371,11,14,.786,94
1660,CHO,2017-11-03,101,@,SAS,L 101-108,240,33,80,.413,25,56,.446,8,24,.333,27,42,.643,101,39,83,.470,30,56,.536,9,27,.333,21,26,.808,108
1661,ORL,2017-11-01,101,@,MEM,W 101-99,240,38,75,.507,25,46,.543,13,29,.448,12,14,.857,101,39,82,.476,29,52,.558,10,30,.333,11,16,.688,99
1662,IND,2017-10-31,101,,SAC,W 101-83,240,36,85,.424,24,56,.429,12,29,.414,17,22,.773,101,37,88,.420,35,74,.473,2,14,.143,7,14,.500,83
1663,CLE,2017-10-28,101,@,NOP,L 101-123,240,36,78,.462,24,46,.522,12,32,.375,17,23,.739,101,49,95,.516,36,62,.581,13,33,.394,12,16,.750,123
1664,OKC,2017-10-28,101,@,CHI,W 101-69,240,39,88,.443,26,54,.481,13,34,.382,10,14,.714,101,22,78,.282,12,41,.293,10,37,.270,15,20,.750,69
1665,TOR,2017-10-27,101,@,LAL,W 101-92,240,40,93,.430,33,64,.516,7,29,.241,14,20,.700,101,36,79,.456,33,56,.589,3,23,.130,17,24,.708,92
1666,MIN,2017-10-25,101,@,DET,L 101-122,240,37,85,.435,28,60,.467,9,25,.360,18,21,.857,101,48,92,.522,33,58,.569,15,34,.441,11,17,.647,122
1667,SAS,2017-10-23,101,,TOR,W 101-97,240,40,90,.444,35,70,.500,5,20,.250,16,23,.696,101,34,80,.425,24,43,.558,10,37,.270,19,24,.792,97
1668,GSW,2017-10-21,101,@,MEM,L 101-111,240,33,84,.393,21,46,.457,12,38,.316,23,27,.852,101,36,77,.468,26,50,.520,10,27,.370,29,37,.784,111
1669,LAC,2018-04-11,100,,LAL,L 100-115,240,41,83,.494,35,65,.538,6,18,.333,12,28,.429,100,42,88,.477,25,49,.510,17,39,.436,14,16,.875,115
1670,LAC,2018-04-09,100,,NOP,L 100-113,240,45,98,.459,43,81,.531,2,17,.118,8,19,.421,100,44,95,.463,33,65,.508,11,30,.367,14,20,.700,113
1671,PHO,2018-04-08,100,,GSW,L 100-117,240,39,92,.424,29,57,.509,10,35,.286,12,16,.750,100,47,90,.522,34,58,.586,13,32,.406,10,15,.667,117
1672,ORL,2018-04-06,100,,CHO,L 100-137,240,42,94,.447,33,71,.465,9,23,.391,7,13,.538,100,48,86,.558,31,55,.564,17,31,.548,24,26,.923,137
1673,DEN,2018-04-05,100,,MIN,W 100-96,240,35,89,.393,24,53,.453,11,36,.306,19,22,.864,100,39,91,.429,33,67,.493,6,24,.250,12,16,.750,96
1674,DAL,2018-04-04,100,@,ORL,L 100-105,240,39,89,.438,29,59,.492,10,30,.333,12,17,.706,100,39,86,.453,31,57,.544,8,29,.276,19,27,.704,105
1675,SAS,2018-04-01,100,,HOU,W 100-83,240,40,81,.494,34,64,.531,6,17,.353,14,21,.667,100,26,77,.338,19,46,.413,7,31,.226,24,29,.828,83
1676,LAL,2018-03-24,100,@,MEM,W 100-93,240,35,86,.407,22,48,.458,13,38,.342,17,25,.680,100,35,84,.417,30,55,.545,5,29,.172,18,22,.818,93
1677,POR,2018-03-23,100,,BOS,L 100-105,240,40,91,.440,32,58,.552,8,33,.242,12,15,.800,100,35,77,.455,24,59,.407,11,18,.611,24,26,.923,105
1678,WAS,2018-03-23,100,,DEN,L 100-108,240,38,80,.475,24,52,.462,14,28,.500,10,14,.714,100,37,85,.435,20,51,.392,17,34,.500,17,18,.944,108
1679,HOU,2018-03-22,100,,DET,W 100-96 (OT),265,35,99,.354,23,48,.479,12,51,.235,18,28,.643,100,40,95,.421,34,57,.596,6,38,.158,10,19,.526,96
1680,BOS,2018-03-20,100,,OKC,W 100-99,240,36,87,.414,23,51,.451,13,36,.361,15,16,.938,100,35,85,.412,25,58,.431,10,27,.370,19,29,.655,99
1681,LAL,2018-03-19,100,@,IND,L 100-110,240,38,86,.442,30,53,.566,8,33,.242,16,23,.696,100,43,87,.494,37,66,.561,6,21,.286,18,19,.947,110
1682,POR,2018-03-17,100,,DET,W 100-87,240,38,87,.437,30,56,.536,8,31,.258,16,18,.889,100,31,80,.388,21,55,.382,10,25,.400,15,20,.750,87
1683,SAS,2018-03-05,100,,MEM,W 100-98,240,35,76,.461,29,54,.537,6,22,.273,24,31,.774,100,42,80,.525,34,58,.586,8,22,.364,6,9,.667,98
1684,MEM,2018-03-03,100,@,ORL,L 100-107,240,38,93,.409,32,71,.451,6,22,.273,18,26,.692,100,36,72,.500,28,47,.596,8,25,.320,27,33,.818,107
1685,OKC,2018-03-03,100,@,POR,L 100-108,240,40,91,.440,34,64,.531,6,27,.222,14,21,.667,100,39,88,.443,28,55,.509,11,33,.333,19,23,.826,108
1686,DAL,2018-03-02,100,@,CHI,L 100-108,240,35,84,.417,22,55,.400,13,29,.448,17,21,.810,100,42,89,.472,32,62,.516,10,27,.370,14,20,.700,108
1687,SAC,2018-02-26,100,,MIN,L 100-118,240,40,84,.476,32,62,.516,8,22,.364,12,13,.923,100,39,76,.513,32,60,.533,7,16,.438,33,36,.917,118
1688,POR,2018-02-23,100,@,UTA,W 100-81,240,39,87,.448,30,63,.476,9,24,.375,13,14,.929,100,33,78,.423,27,53,.509,6,25,.240,9,11,.818,81
1689,HOU,2018-02-14,100,,SAC,W 100-91,240,33,83,.398,19,34,.559,14,49,.286,20,22,.909,100,38,87,.437,28,55,.509,10,32,.313,5,8,.625,91
1690,PHI,2018-02-09,100,,NOP,W 100-82,240,39,93,.419,25,59,.424,14,34,.412,8,9,.889,100,33,95,.347,25,64,.391,8,31,.258,8,16,.500,82
1691,SAC,2018-02-09,100,,POR,L 100-118,240,38,90,.422,29,67,.433,9,23,.391,15,21,.714,100,43,88,.489,28,53,.528,15,35,.429,17,18,.944,118
1692,ORL,2018-02-08,100,,ATL,W 100-98,240,36,84,.429,27,55,.491,9,29,.310,19,22,.864,100,37,87,.425,25,57,.439,12,30,.400,12,18,.667,98
1693,IND,2018-02-03,100,,PHI,W 100-92,240,35,79,.443,26,52,.500,9,27,.333,21,25,.840,100,33,87,.379,23,55,.418,10,32,.313,16,24,.667,92
1694,OKC,2018-02-02,100,,NOP,L 100-114,240,37,97,.381,28,61,.459,9,36,.250,17,20,.850,100,46,90,.511,33,66,.500,13,24,.542,9,13,.692,114
1695,MIN,2018-01-29,100,@,ATL,L 100-105,240,39,83,.470,32,64,.500,7,19,.368,15,18,.833,100,39,79,.494,26,45,.578,13,34,.382,14,16,.875,105
1696,MEM,2018-01-26,100,,LAC,L 100-109,240,39,81,.481,31,54,.574,8,27,.296,14,18,.778,100,39,80,.488,29,53,.547,10,27,.370,21,29,.724,109
1697,DET,2018-01-21,100,,BRK,L 100-101,240,38,90,.422,29,61,.475,9,29,.310,15,17,.882,100,37,80,.463,24,49,.490,13,31,.419,14,20,.700,101
1698,DEN,2018-01-19,100,,PHO,L 100-108,240,35,78,.449,21,42,.500,14,36,.389,16,21,.762,100,40,81,.494,26,48,.542,14,33,.424,14,20,.700,108
1699,POR,2018-01-18,100,,IND,W 100-86,240,37,94,.394,27,62,.435,10,32,.313,16,16,1.000,100,36,91,.396,29,65,.446,7,26,.269,7,13,.538,86
1700,SAS,2018-01-17,100,@,BRK,W 100-95,240,34,82,.415,25,63,.397,9,19,.474,23,31,.742,100,35,83,.422,22,47,.468,13,36,.361,12,18,.667,95
1701,SAC,2018-01-08,100,,SAS,L 100-107,240,40,82,.488,32,59,.542,8,23,.348,12,16,.750,100,44,90,.489,33,64,.516,11,26,.423,8,13,.615,107
1702,OKC,2018-01-07,100,@,PHO,L 100-114,240,40,86,.465,32,59,.542,8,27,.296,12,21,.571,100,39,88,.443,22,49,.449,17,39,.436,19,23,.826,114
1703,NYK,2018-01-07,100,@,DAL,W 100-96,240,38,83,.458,32,67,.478,6,16,.375,18,20,.900,100,35,92,.380,29,68,.426,6,24,.250,20,24,.833,96
1704,MEM,2018-01-05,100,,WAS,L 100-102,240,35,86,.407,25,56,.446,10,30,.333,20,26,.769,100,33,84,.393,23,57,.404,10,27,.370,26,34,.765,102
1705,SAS,2018-01-02,100,@,NYK,W 100-91,240,31,82,.378,21,55,.382,10,27,.370,28,34,.824,100,35,87,.402,28,65,.431,7,22,.318,14,18,.778,91
1706,GSW,2017-12-29,100,,CHO,L 100-111,240,40,87,.460,32,65,.492,8,22,.364,12,13,.923,100,41,89,.461,35,69,.507,6,20,.300,23,34,.676,111
1707,UTA,2017-12-21,100,,SAS,W 100-89,240,34,74,.459,22,48,.458,12,26,.462,20,24,.833,100,34,78,.436,24,57,.421,10,21,.476,11,16,.688,89
1708,UTA,2017-12-16,100,@,CLE,L 100-109,240,37,81,.457,20,47,.426,17,34,.500,9,14,.643,100,42,79,.532,32,57,.561,10,22,.455,15,17,.882,109
1709,WAS,2017-12-15,100,,LAC,W 100-91,240,39,88,.443,32,57,.561,7,31,.226,15,23,.652,100,33,86,.384,26,62,.419,7,24,.292,18,29,.621,91
1710,UTA,2017-12-13,100,@,CHI,L 100-103,240,42,91,.462,33,61,.541,9,30,.300,7,7,1.000,100,41,93,.441,34,76,.447,7,17,.412,14,21,.667,103
1711,OKC,2017-12-13,100,@,IND,W 100-95,240,36,88,.409,23,59,.390,13,29,.448,15,24,.625,100,40,89,.449,29,58,.500,11,31,.355,4,6,.667,95
1712,UTA,2017-12-09,100,@,MIL,L 100-117,240,33,76,.434,25,53,.472,8,23,.348,26,37,.703,100,44,81,.543,37,64,.578,7,17,.412,22,26,.846,117
1713,BRK,2017-12-07,100,,OKC,W 100-95,240,35,80,.438,24,43,.558,11,37,.297,19,30,.633,100,38,98,.388,31,74,.419,7,24,.292,12,23,.522,95
1714,DET,2017-12-06,100,@,MIL,L 100-104,240,36,87,.414,26,57,.456,10,30,.333,18,27,.667,100,39,79,.494,31,57,.544,8,22,.364,18,26,.692,104
1715,OKC,2017-12-05,100,,UTA,W 100-94,240,39,81,.481,35,63,.556,4,18,.222,18,26,.692,100,34,79,.430,23,46,.500,11,33,.333,15,21,.714,94
1716,MIL,2017-12-04,100,@,BOS,L 100-111,240,35,78,.449,26,57,.456,9,21,.429,21,24,.875,100,43,78,.551,33,56,.589,10,22,.455,15,19,.789,111
1717,NYK,2017-12-03,100,,ORL,L 100-105,240,43,93,.462,38,78,.487,5,15,.333,9,10,.900,100,37,82,.451,31,54,.574,6,28,.214,25,29,.862,105
1718,LAL,2017-12-02,100,@,DEN,L 100-115,240,38,86,.442,29,56,.518,9,30,.300,15,21,.714,100,40,87,.460,28,56,.500,12,31,.387,23,28,.821,115
1719,CHO,2017-12-01,100,@,MIA,L 100-105,240,38,79,.481,33,59,.559,5,20,.250,19,21,.905,100,39,80,.488,25,45,.556,14,35,.400,13,21,.619,105
1720,MIA,2017-11-26,100,@,CHI,W 100-93,240,34,75,.453,21,43,.488,13,32,.406,19,23,.826,100,33,89,.371,19,56,.339,14,33,.424,13,16,.813,93
1721,CLE,2017-11-24,100,,CHO,W 100-99,240,38,83,.458,25,44,.568,13,39,.333,11,15,.733,100,36,94,.383,25,65,.385,11,29,.379,16,27,.593,99
1722,TOR,2017-11-22,100,@,NYK,L 100-108,240,37,87,.425,23,49,.469,14,38,.368,12,18,.667,100,43,93,.462,35,69,.507,8,24,.333,14,17,.824,108
1723,POR,2017-11-20,100,@,MEM,W 100-92,240,33,83,.398,27,68,.397,6,15,.400,28,32,.875,100,33,86,.384,25,56,.446,8,30,.267,18,23,.783,92
1724,DET,2017-11-19,100,@,MIN,W 100-97,240,39,83,.470,31,58,.534,8,25,.320,14,20,.700,100,40,78,.513,35,56,.625,5,22,.227,12,18,.667,97
1725,TOR,2017-11-19,100,,WAS,W 100-91,240,40,90,.444,30,51,.588,10,39,.256,10,14,.714,100,34,81,.420,23,62,.371,11,19,.579,12,21,.571,91
1726,DET,2017-11-17,100,@,IND,L 100-107,240,39,93,.419,25,60,.417,14,33,.424,8,10,.800,100,39,89,.438,24,61,.393,15,28,.536,14,21,.667,107
1727,ORL,2017-11-13,100,@,GSW,L 100-110,240,37,88,.420,27,56,.482,10,32,.313,16,18,.889,100,44,88,.500,36,65,.554,8,23,.348,14,16,.875,110
1728,LAL,2017-11-13,100,@,PHO,W 100-93,240,39,92,.424,25,59,.424,14,33,.424,8,13,.615,100,37,95,.389,30,69,.435,7,26,.269,12,20,.600,93
1729,UTA,2017-11-03,100,,TOR,L 100-109,240,35,80,.438,27,57,.474,8,23,.348,22,24,.917,100,38,71,.535,27,41,.659,11,30,.367,22,28,.786,109
1730,ATL,2017-10-27,100,,DEN,L 100-105,240,37,89,.416,23,56,.411,14,33,.424,12,12,1.000,100,42,91,.462,38,71,.535,4,20,.200,17,23,.739,105
1731,MIA,2017-10-25,100,,SAS,L 100-117,240,37,80,.463,28,54,.519,9,26,.346,17,18,.944,100,42,76,.553,32,59,.542,10,17,.588,23,30,.767,117
1732,MIN,2017-10-20,100,,UTA,W 100-97,240,36,81,.444,29,59,.492,7,22,.318,21,26,.808,100,37,77,.481,28,55,.509,9,22,.409,14,17,.824,97
1733,CHI,2017-10-19,100,@,TOR,L 100-117,240,37,89,.416,27,57,.474,10,32,.313,16,18,.889,100,39,83,.470,26,54,.481,13,29,.448,26,28,.929,117
1734,BOS,2017-10-18,100,,MIL,L 100-108,240,39,91,.429,28,63,.444,11,28,.393,11,21,.524,100,38,76,.500,31,55,.564,7,21,.333,25,30,.833,108
1735,SAC,2017-10-18,100,,HOU,L 100-105,240,42,88,.477,34,65,.523,8,23,.348,8,10,.800,100,33,83,.398,21,38,.553,12,45,.267,27,29,.931,105
1736,LAL,2018-04-10,99,,HOU,L 99-105,240,38,90,.422,28,54,.519,10,36,.278,13,15,.867,99,37,88,.420,21,41,.512,16,47,.340,15,16,.938,105
1737,TOR,2018-03-31,99,@,BOS,L 99-110,240,37,80,.463,29,45,.644,8,35,.229,17,22,.773,99,40,88,.455,33,71,.465,7,17,.412,23,27,.852,110
1738,OKC,2018-03-29,99,@,SAS,L 99-103,240,37,85,.435,26,55,.473,11,30,.367,14,21,.667,99,34,81,.420,21,50,.420,13,31,.419,22,30,.733,103
1739,PHO,2018-03-28,99,,LAC,L 99-111,240,38,88,.432,28,54,.519,10,34,.294,13,18,.722,99,43,80,.538,35,63,.556,8,17,.471,17,25,.680,111
1740,ATL,2018-03-25,99,@,HOU,L 99-118,240,39,88,.443,28,48,.583,11,40,.275,10,11,.909,99,44,90,.489,24,38,.632,20,52,.385,10,11,.909,118
1741,PHO,2018-03-24,99,@,ORL,L 99-105,240,36,89,.404,29,60,.483,7,29,.241,20,26,.769,99,37,84,.440,26,54,.481,11,30,.367,20,27,.741,105
1742,MIA,2018-03-23,99,@,OKC,L 99-105,240,34,87,.391,21,57,.368,13,30,.433,18,20,.900,99,36,84,.429,28,58,.483,8,26,.308,25,33,.758,105
1743,ATL,2018-03-20,99,@,UTA,W 99-94,240,38,94,.404,29,61,.475,9,33,.273,14,19,.737,99,33,89,.371,27,55,.491,6,34,.176,22,25,.880,94
1744,OKC,2018-03-20,99,@,BOS,L 99-100,240,35,85,.412,25,58,.431,10,27,.370,19,29,.655,99,36,87,.414,23,51,.451,13,36,.361,15,16,.938,100
1745,IND,2018-03-15,99,,TOR,L 99-106,240,40,93,.430,33,69,.478,7,24,.292,12,17,.706,99,35,79,.443,23,47,.489,12,32,.375,24,28,.857,106
1746,MIA,2018-03-12,99,@,POR,L 99-115,240,39,91,.429,29,60,.483,10,31,.323,11,16,.688,99,38,83,.458,24,47,.511,14,36,.389,25,30,.833,115
1747,NOP,2018-03-11,99,,UTA,L 99-116,240,41,93,.441,35,72,.486,6,21,.286,11,13,.846,99,40,96,.417,28,64,.438,12,32,.375,24,25,.960,116
1748,IND,2018-03-11,99,@,BOS,W 99-97,240,39,81,.481,27,59,.458,12,22,.545,9,10,.900,99,34,81,.420,22,44,.500,12,37,.324,17,21,.810,97
1749,DET,2018-03-09,99,,CHI,W 99-83,240,38,81,.469,29,54,.537,9,27,.333,14,18,.778,99,33,93,.355,24,62,.387,9,31,.290,8,10,.800,83
1750,PHI,2018-03-08,99,@,MIA,L 99-108,240,34,86,.395,19,49,.388,15,37,.405,16,21,.762,99,42,89,.472,28,63,.444,14,26,.538,10,18,.556,108
1751,MIL,2018-03-07,99,,HOU,L 99-110,240,38,83,.458,29,55,.527,9,28,.321,14,19,.737,99,39,82,.476,25,42,.595,14,40,.350,18,27,.667,110
1752,NYK,2018-03-04,99,@,SAC,L 99-102,240,40,88,.455,34,67,.507,6,21,.286,13,18,.722,99,39,86,.453,26,56,.464,13,30,.433,11,11,1.000,102
1753,CHO,2018-03-02,99,@,PHI,L 99-110,240,34,81,.420,23,57,.404,11,24,.458,20,32,.625,99,41,81,.506,32,57,.561,9,24,.375,19,25,.760,110
1754,MIN,2018-03-01,99,@,POR,L 99-108,240,38,85,.447,34,65,.523,4,20,.200,19,21,.905,99,36,92,.391,27,62,.435,9,30,.300,27,35,.771,108
1755,SAC,2018-02-27,99,@,POR,L 99-116,240,39,88,.443,32,66,.485,7,22,.318,14,15,.933,99,44,84,.524,29,50,.580,15,34,.441,13,17,.765,116
1756,SAS,2018-02-12,99,@,UTA,L 99-101,240,38,85,.447,32,60,.533,6,25,.240,17,25,.680,99,35,84,.417,24,60,.400,11,24,.458,20,30,.667,101
1757,BOS,2018-02-11,99,,CLE,L 99-121,240,36,89,.404,26,51,.510,10,38,.263,17,22,.773,99,45,84,.536,29,54,.537,16,30,.533,15,20,.750,121
1758,ATL,2018-02-04,99,@,NYK,W 99-96,240,35,87,.402,20,54,.370,15,33,.455,14,19,.737,99,41,94,.436,36,71,.507,5,23,.217,9,15,.600,96
1759,SAC,2018-02-03,99,,DAL,L 99-106,240,43,82,.524,35,55,.636,8,27,.296,5,6,.833,99,41,83,.494,28,42,.667,13,41,.317,11,14,.786,106
1760,BRK,2018-02-02,99,,LAL,L 99-102,240,37,82,.451,28,53,.528,9,29,.310,16,23,.696,99,39,92,.424,29,66,.439,10,26,.385,14,20,.700,102
1761,GSW,2018-01-30,99,@,UTA,L 99-129,240,39,85,.459,34,60,.567,5,25,.200,16,21,.762,99,53,91,.582,39,63,.619,14,28,.500,9,14,.643,129
1762,ORL,2018-01-23,99,,SAC,L 99-105,240,36,83,.434,25,52,.481,11,31,.355,16,19,.842,99,43,87,.494,35,61,.574,8,26,.308,11,13,.846,105
1763,HOU,2018-01-22,99,,MIA,W 99-90,240,36,81,.444,21,44,.477,15,37,.405,12,18,.667,99,39,82,.476,32,52,.615,7,30,.233,5,9,.556,90
1764,LAL,2018-01-19,99,,IND,W 99-86,240,44,80,.550,35,52,.673,9,28,.321,2,14,.143,99,37,97,.381,35,72,.486,2,25,.080,10,13,.769,86
1765,NYK,2018-01-17,99,@,MEM,L 99-105,240,35,82,.427,28,55,.509,7,27,.259,22,23,.957,99,41,91,.451,31,63,.492,10,28,.357,13,17,.765,105
1766,SAS,2018-01-15,99,@,ATL,L 99-102,240,37,87,.425,29,65,.446,8,22,.364,17,20,.850,99,40,86,.465,31,61,.508,9,25,.360,13,14,.929,102
1767,CHO,2018-01-12,99,,UTA,W 99-88,240,32,78,.410,23,51,.451,9,27,.333,26,34,.765,99,28,77,.364,16,42,.381,12,35,.343,20,23,.870,88
1768,CLE,2018-01-11,99,@,TOR,L 99-133,240,34,89,.382,28,63,.444,6,26,.231,25,30,.833,99,53,106,.500,35,64,.547,18,42,.429,9,13,.692,133
1769,LAL,2018-01-09,99,,SAC,W 99-86,240,37,77,.481,25,42,.595,12,35,.343,13,21,.619,99,30,87,.345,22,66,.333,8,21,.381,18,27,.667,86
1770,ORL,2018-01-09,99,@,DAL,L 99-114,240,36,79,.456,25,50,.500,11,29,.379,16,22,.727,99,43,83,.518,34,57,.596,9,26,.346,19,22,.864,114
1771,CLE,2018-01-08,99,@,MIN,L 99-127,240,37,84,.440,24,46,.522,13,38,.342,12,16,.750,99,52,100,.520,42,69,.609,10,31,.323,13,17,.765,127
1772,DEN,2018-01-05,99,,UTA,W 99-91,240,38,86,.442,24,51,.471,14,35,.400,9,15,.600,99,38,84,.452,26,51,.510,12,33,.364,3,6,.500,91
1773,BOS,2017-12-28,99,,HOU,W 99-98,240,37,82,.451,29,53,.547,8,29,.276,17,24,.708,99,30,80,.375,16,37,.432,14,43,.326,24,31,.774,98
1774,LAL,2017-12-27,99,,MEM,L 99-109,240,35,93,.376,27,65,.415,8,28,.286,21,33,.636,99,35,71,.493,30,50,.600,5,21,.238,34,39,.872,109
1775,WAS,2017-12-27,99,@,ATL,L 99-113,240,35,81,.432,26,57,.456,9,24,.375,20,26,.769,99,41,94,.436,30,57,.526,11,37,.297,20,29,.690,113
1776,PHO,2017-12-26,99,,MEM,W 99-97,240,32,72,.444,24,50,.480,8,22,.364,27,35,.771,99,35,87,.402,32,67,.478,3,20,.150,24,29,.828,97
1777,GSW,2017-12-25,99,,CLE,W 99-92,240,38,82,.463,28,45,.622,10,37,.270,13,17,.765,99,28,88,.318,13,52,.250,15,36,.417,21,25,.840,92
1778,SAC,2017-12-23,99,,SAS,L 99-108,240,40,86,.465,28,64,.438,12,22,.545,7,11,.636,99,44,88,.500,33,65,.508,11,23,.478,9,11,.818,108
1779,BRK,2017-12-20,99,,SAC,L 99-104,240,32,82,.390,17,40,.425,15,42,.357,20,23,.870,99,40,82,.488,33,63,.524,7,19,.368,17,20,.850,104
1780,UTA,2017-12-18,99,@,HOU,L 99-120,240,42,91,.462,34,64,.531,8,27,.296,7,8,.875,99,40,77,.519,23,34,.676,17,43,.395,23,27,.852,120
1781,WAS,2017-12-17,99,,CLE,L 99-106,240,39,91,.429,27,58,.466,12,33,.364,9,16,.563,99,41,87,.471,27,53,.509,14,34,.412,10,12,.833,106
1782,SAC,2017-12-12,99,,PHO,W 99-92,240,38,89,.427,31,67,.463,7,22,.318,16,22,.727,99,37,90,.411,30,58,.517,7,32,.219,11,14,.786,92
1783,CHO,2017-12-09,99,,LAL,L 99-110,240,41,93,.441,33,68,.485,8,25,.320,9,14,.643,99,43,85,.506,34,58,.586,9,27,.333,15,21,.714,110
1784,PHO,2017-12-07,99,,WAS,L 99-109,240,36,78,.462,29,55,.527,7,23,.304,20,28,.714,99,41,81,.506,33,60,.550,8,21,.381,19,25,.760,109
1785,NYK,2017-12-06,99,,MEM,W 99-88,240,35,67,.522,26,53,.491,9,14,.643,20,27,.741,99,29,70,.414,17,42,.405,12,28,.429,18,22,.818,88
1786,CHI,2017-11-28,99,,PHO,L 99-104,240,38,94,.404,22,54,.407,16,40,.400,7,10,.700,99,38,87,.437,27,57,.474,11,30,.367,17,23,.739,104
1787,DET,2017-11-24,99,@,OKC,W 99-98,240,39,84,.464,25,47,.532,14,37,.378,7,9,.778,99,42,98,.429,34,66,.515,8,32,.250,6,8,.750,98
1788,CHO,2017-11-24,99,@,CLE,L 99-100,240,36,94,.383,25,65,.385,11,29,.379,16,27,.593,99,38,83,.458,25,44,.568,13,39,.333,11,15,.733,100
1789,WAS,2017-11-20,99,@,MIL,W 99-88,240,39,74,.527,30,50,.600,9,24,.375,12,17,.706,99,35,79,.443,31,57,.544,4,22,.182,14,19,.737,88
1790,ATL,2017-11-18,99,,BOS,L 99-110,240,37,78,.474,28,54,.519,9,24,.375,16,20,.800,99,39,82,.476,23,48,.479,16,34,.471,16,20,.800,110
1791,POR,2017-11-15,99,,ORL,W 99-94,240,38,87,.437,24,60,.400,14,27,.519,9,13,.692,99,37,79,.468,26,50,.520,11,29,.379,9,9,1.000,94
1792,MIL,2017-11-15,99,,DET,W 99-95,240,38,78,.487,30,56,.536,8,22,.364,15,20,.750,99,30,85,.353,15,48,.313,15,37,.405,20,23,.870,95
1793,POR,2017-11-13,99,,DEN,W 99-82,240,38,73,.521,31,52,.596,7,21,.333,16,18,.889,99,30,84,.357,21,52,.404,9,32,.281,13,15,.867,82
1794,DAL,2017-11-12,99,@,OKC,L 99-112,240,37,87,.425,26,50,.520,11,37,.297,14,18,.778,99,36,72,.500,21,40,.525,15,32,.469,25,33,.758,112
1795,NYK,2017-11-08,99,@,ORL,L 99-112,240,42,80,.525,37,68,.544,5,12,.417,10,13,.769,99,43,80,.538,30,52,.577,13,28,.464,13,22,.591,112
1796,WAS,2017-11-07,99,,DAL,L 99-113,240,32,75,.427,22,50,.440,10,25,.400,25,32,.781,99,43,91,.473,32,61,.525,11,30,.367,16,20,.800,113
1797,OKC,2017-11-05,99,@,POR,L 99-103,240,40,89,.449,29,56,.518,11,33,.333,8,15,.533,99,37,74,.500,30,54,.556,7,20,.350,22,28,.786,103
1798,SAC,2017-11-04,99,@,DET,L 99-108,240,40,76,.526,30,55,.545,10,21,.476,9,13,.692,99,40,79,.506,27,55,.491,13,24,.542,15,22,.682,108
1799,DAL,2017-11-04,99,@,MIN,L 99-112,240,40,87,.460,30,60,.500,10,27,.370,9,12,.750,99,43,79,.544,33,55,.600,10,24,.417,16,20,.800,112
1800,NOP,2017-11-03,99,@,DAL,W 99-94,240,36,89,.404,29,60,.483,7,29,.241,20,26,.769,99,34,88,.386,25,54,.463,9,34,.265,17,22,.773,94
1801,MEM,2017-11-01,99,,ORL,L 99-101,240,39,82,.476,29,52,.558,10,30,.333,11,16,.688,99,38,75,.507,25,46,.543,13,29,.448,12,14,.857,101
1802,NOP,2017-10-30,99,,ORL,L 99-115,240,39,85,.459,32,57,.561,7,28,.250,14,18,.778,99,43,85,.506,27,51,.529,16,34,.471,13,18,.722,115
1803,MEM,2017-10-30,99,,CHO,L 99-104,240,32,93,.344,24,58,.414,8,35,.229,27,33,.818,99,37,89,.416,30,72,.417,7,17,.412,23,29,.793,104
1804,TOR,2017-10-30,99,@,POR,W 99-85,240,39,87,.448,31,63,.492,8,24,.333,13,17,.765,99,31,80,.388,23,54,.426,8,26,.308,15,19,.789,85
1805,WAS,2017-10-25,99,@,LAL,L 99-102 (OT),265,39,95,.411,33,69,.478,6,26,.231,15,23,.652,99,41,92,.446,34,62,.548,7,30,.233,13,16,.813,102
1806,MIN,2017-10-18,99,@,SAS,L 99-107,240,37,85,.435,29,66,.439,8,19,.421,17,23,.739,99,41,89,.461,33,68,.485,8,21,.381,17,19,.895,107
1807,BOS,2017-10-17,99,@,CLE,L 99-102,240,36,88,.409,28,56,.500,8,32,.250,19,25,.760,99,38,83,.458,33,61,.541,5,22,.227,21,25,.840,102
1808,CLE,2018-04-11,98,,NYK,L 98-110,240,37,94,.394,31,70,.443,6,24,.250,18,28,.643,98,43,85,.506,31,58,.534,12,27,.444,12,13,.923,110
1809,SAS,2018-04-11,98,@,NOP,L 98-122,240,37,92,.402,29,68,.426,8,24,.333,16,19,.842,98,52,88,.591,47,69,.681,5,19,.263,13,19,.684,122
1810,SAS,2018-04-09,98,,SAC,W 98-85,240,34,82,.415,28,55,.509,6,27,.222,24,29,.828,98,33,81,.407,25,63,.397,8,18,.444,11,17,.647,85
1811,DET,2018-04-09,98,,TOR,L 98-108,240,35,78,.449,26,48,.542,9,30,.300,19,25,.760,98,46,87,.529,34,48,.708,12,39,.308,4,4,1.000,108
1812,MIA,2018-04-06,98,@,NYK,L 98-122,240,35,88,.398,28,61,.459,7,27,.259,21,22,.955,98,45,89,.506,27,52,.519,18,37,.486,14,21,.667,122
1813,ATL,2018-04-03,98,@,MIA,L 98-101,240,37,88,.420,24,55,.436,13,33,.394,11,15,.733,98,41,91,.451,33,58,.569,8,33,.242,11,13,.846,101
1814,MEM,2018-04-01,98,@,POR,L 98-113,240,40,88,.455,31,67,.463,9,21,.429,9,12,.750,98,39,84,.464,27,46,.587,12,38,.316,23,25,.920,113
1815,CLE,2018-04-01,98,,DAL,W 98-87,240,35,85,.412,24,59,.407,11,26,.423,17,23,.739,98,32,79,.405,19,42,.452,13,37,.351,10,11,.909,87
1816,MIA,2018-03-27,98,,CLE,W 98-79,240,37,78,.474,28,49,.571,9,29,.310,15,20,.750,98,31,85,.365,27,59,.458,4,26,.154,13,19,.684,79
1817,MIL,2018-03-27,98,@,LAC,L 98-105,240,38,83,.458,32,60,.533,6,23,.261,16,23,.696,98,40,86,.465,25,58,.431,15,28,.536,10,18,.556,105
1818,DAL,2018-03-24,98,,CHO,L 98-102,240,36,91,.396,24,50,.480,12,41,.293,14,19,.737,98,35,92,.380,23,67,.343,12,25,.480,20,29,.690,102
1819,ORL,2018-03-22,98,,PHI,L 98-118,240,37,91,.407,27,58,.466,10,33,.303,14,22,.636,98,42,89,.472,27,52,.519,15,37,.405,19,24,.792,118
1820,NYK,2018-03-21,98,@,MIA,L 98-119,240,39,89,.438,29,58,.500,10,31,.323,10,12,.833,98,45,81,.556,30,47,.638,15,34,.441,14,19,.737,119
1821,SAS,2018-03-21,98,,WAS,W 98-90,240,39,79,.494,32,56,.571,7,23,.304,13,18,.722,98,35,83,.422,27,58,.466,8,25,.320,12,16,.750,90
1822,SAC,2018-03-16,98,@,GSW,W 98-93,240,36,83,.434,22,52,.423,14,31,.452,12,17,.706,98,34,81,.420,22,55,.400,12,26,.462,13,18,.722,93
1823,SAS,2018-03-15,98,,NOP,W 98-93,240,37,99,.374,30,73,.411,7,26,.269,17,19,.895,98,36,90,.400,30,74,.405,6,16,.375,15,16,.938,93
1824,PHI,2018-03-13,98,,IND,L 98-101,240,35,75,.467,25,45,.556,10,30,.333,18,22,.818,98,38,95,.400,33,71,.465,5,24,.208,20,25,.800,101
1825,MEM,2018-03-05,98,@,SAS,L 98-100,240,42,80,.525,34,58,.586,8,22,.364,6,9,.667,98,35,76,.461,29,54,.537,6,22,.273,24,31,.774,100
1826,IND,2018-03-04,98,@,WAS,W 98-95,240,34,77,.442,26,52,.500,8,25,.320,22,24,.917,98,35,83,.422,25,56,.446,10,27,.370,15,19,.789,95
1827,CHO,2018-03-04,98,@,TOR,L 98-103,240,32,85,.376,27,64,.422,5,21,.238,29,35,.829,98,35,83,.422,23,42,.548,12,41,.293,21,27,.778,103
1828,UTA,2018-03-03,98,@,SAC,W 98-91,240,34,82,.415,23,50,.460,11,32,.344,19,29,.655,98,34,89,.382,25,59,.424,9,30,.300,14,17,.824,91
1829,MEM,2018-02-26,98,@,BOS,L 98-109,240,34,78,.436,29,55,.527,5,23,.217,25,32,.781,98,39,86,.453,27,49,.551,12,37,.324,19,27,.704,109
1830,DET,2018-02-25,98,@,CHO,L 98-114,240,42,85,.494,38,67,.567,4,18,.222,10,14,.714,98,42,88,.477,26,53,.491,16,35,.457,14,23,.609,114
1831,DET,2018-02-23,98,,BOS,L 98-110,240,37,85,.435,27,52,.519,10,33,.303,14,21,.667,98,41,85,.482,24,46,.522,17,39,.436,11,18,.611,110
1832,CHI,2018-02-14,98,,TOR,L 98-122,240,39,91,.429,35,67,.522,4,24,.167,16,20,.800,98,48,92,.522,34,54,.630,14,38,.368,12,15,.800,122
1833,ATL,2018-02-14,98,@,DET,L 98-104,240,38,89,.427,32,56,.571,6,33,.182,16,19,.842,98,35,83,.422,22,50,.440,13,33,.394,21,25,.840,104
1834,LAC,2018-02-10,98,@,PHI,L 98-112,240,38,88,.432,30,56,.536,8,32,.250,14,23,.609,98,43,90,.478,30,57,.526,13,33,.394,13,17,.765,112
1835,ATL,2018-02-08,98,@,ORL,L 98-100,240,37,87,.425,25,57,.439,12,30,.400,12,18,.667,98,36,84,.429,27,55,.491,9,29,.310,19,22,.864,100
1836,CLE,2018-02-06,98,@,ORL,L 98-116,240,36,84,.429,24,47,.511,12,37,.324,14,20,.700,98,46,88,.523,40,66,.606,6,22,.273,18,27,.667,116
1837,CHI,2018-02-05,98,@,SAC,L 98-104,240,32,80,.400,18,44,.409,14,36,.389,20,24,.833,98,37,84,.440,26,52,.500,11,32,.344,19,25,.760,104
1838,ORL,2018-02-03,98,,WAS,L 98-115,240,34,77,.442,24,45,.533,10,32,.313,20,22,.909,98,46,85,.541,39,59,.661,7,26,.269,16,18,.889,115
1839,SAC,2018-01-28,98,@,SAS,L 98-113,240,35,82,.427,17,48,.354,18,34,.529,10,11,.909,98,45,90,.500,34,65,.523,11,25,.440,12,17,.706,113
1840,UTA,2018-01-24,98,@,DET,W 98-95 (OT),265,38,96,.396,28,65,.431,10,31,.323,12,16,.750,98,38,97,.392,31,66,.470,7,31,.226,12,18,.667,95
1841,DAL,2018-01-22,98,,WAS,W 98-75,240,38,87,.437,28,56,.500,10,31,.323,12,17,.706,98,26,86,.302,19,54,.352,7,32,.219,16,27,.593,75
1842,MIN,2018-01-18,98,@,HOU,L 98-116,240,38,81,.469,30,57,.526,8,24,.333,14,21,.667,98,42,88,.477,25,49,.510,17,39,.436,15,17,.882,116
1843,NOP,2018-01-06,98,@,MIN,L 98-116,240,33,78,.423,27,49,.551,6,29,.207,26,28,.929,98,44,90,.489,35,72,.486,9,18,.500,19,21,.905,116
1844,DEN,2018-01-06,98,@,SAC,L 98-106,240,35,76,.461,22,42,.524,13,34,.382,15,21,.714,98,42,94,.447,33,69,.478,9,25,.360,13,17,.765,106
1845,BRK,2018-01-03,98,,MIN,W 98-97,240,37,72,.514,23,42,.548,14,30,.467,10,11,.909,98,36,80,.450,35,69,.507,1,11,.091,24,30,.800,97
1846,UTA,2018-01-03,98,,NOP,L 98-108,240,38,84,.452,31,52,.596,7,32,.219,15,17,.882,98,41,82,.500,27,52,.519,14,30,.467,12,12,1.000,108
1847,ORL,2018-01-03,98,,HOU,L 98-116,240,35,91,.385,29,60,.483,6,31,.194,22,25,.880,98,42,89,.472,27,55,.491,15,34,.441,17,21,.810,116
1848,BRK,2018-01-01,98,,ORL,W 98-95,240,36,82,.439,27,57,.474,9,25,.360,17,23,.739,98,35,96,.365,29,65,.446,6,31,.194,19,25,.760,95
1849,CHO,2017-12-31,98,@,LAC,L 98-106,240,36,93,.387,25,60,.417,11,33,.333,15,19,.789,98,36,76,.474,26,48,.542,10,28,.357,24,27,.889,106
1850,ATL,2017-12-29,98,@,TOR,L 98-111,240,38,88,.432,29,64,.453,9,24,.375,13,20,.650,98,46,105,.438,33,68,.485,13,37,.351,6,8,.750,111
1851,HOU,2017-12-28,98,@,BOS,L 98-99,240,30,80,.375,16,37,.432,14,43,.326,24,31,.774,98,37,82,.451,29,53,.547,8,29,.276,17,24,.708,99
1852,DAL,2017-12-27,98,@,IND,W 98-94,240,40,78,.513,32,49,.653,8,29,.276,10,15,.667,98,38,79,.481,28,54,.519,10,25,.400,8,10,.800,94
1853,DAL,2017-12-26,98,,TOR,W 98-93,240,40,94,.426,34,70,.486,6,24,.250,12,16,.750,98,30,89,.337,21,58,.362,9,31,.290,24,32,.750,93
1854,NYK,2017-12-25,98,,PHI,L 98-105,240,38,94,.404,34,79,.430,4,15,.267,18,28,.643,98,35,82,.427,25,54,.463,10,28,.357,25,30,.833,105
1855,SAS,2017-12-16,98,,DAL,W 98-96,240,39,86,.453,34,61,.557,5,25,.200,15,18,.833,98,39,80,.488,29,52,.558,10,28,.357,8,9,.889,96
1856,CHO,2017-12-15,98,,MIA,L 98-104,240,34,83,.410,24,56,.429,10,27,.370,20,27,.741,98,39,78,.500,28,47,.596,11,31,.355,15,17,.882,104
1857,IND,2017-12-15,98,,DET,L 98-104,240,35,87,.402,26,57,.456,9,30,.300,19,25,.760,98,39,93,.419,26,61,.426,13,32,.406,13,17,.765,104
1858,WAS,2017-12-12,98,@,BRK,L 98-103,240,38,95,.400,34,73,.466,4,22,.182,18,22,.818,98,34,84,.405,24,41,.585,10,43,.233,25,33,.758,103
1859,PHI,2017-12-09,98,@,CLE,L 98-105,240,37,78,.474,26,45,.578,11,33,.333,13,13,1.000,98,36,75,.480,22,46,.478,14,29,.483,19,25,.760,105
1860,DET,2017-12-08,98,,GSW,L 98-102,240,38,92,.413,26,65,.400,12,27,.444,10,19,.526,98,39,81,.481,32,55,.582,7,26,.269,17,22,.773,102
1861,IND,2017-12-06,98,,CHI,W 98-96,240,39,87,.448,27,53,.509,12,34,.353,8,10,.800,98,39,83,.470,29,57,.509,10,26,.385,8,16,.500,96
1862,BRK,2017-11-26,98,@,MEM,W 98-88,240,33,74,.446,20,45,.444,13,29,.448,19,23,.826,98,32,80,.400,24,55,.436,8,25,.320,16,18,.889,88
1863,IND,2017-11-25,98,,BOS,L 98-108,240,38,78,.487,31,55,.564,7,23,.304,15,15,1.000,98,45,80,.563,35,55,.636,10,25,.400,8,9,.889,108
1864,OKC,2017-11-24,98,,DET,L 98-99,240,42,98,.429,34,66,.515,8,32,.250,6,8,.750,98,39,84,.464,25,47,.532,14,37,.378,7,9,.778,99
1865,BOS,2017-11-22,98,@,MIA,L 98-104,240,35,84,.417,26,58,.448,9,26,.346,19,27,.704,98,40,81,.494,30,53,.566,10,28,.357,14,16,.875,104
1866,SAC,2017-11-20,98,,DEN,L 98-114,240,41,86,.477,33,66,.500,8,20,.400,8,9,.889,98,42,86,.488,27,54,.500,15,32,.469,15,20,.750,114
1867,MIN,2017-11-15,98,,SAS,W 98-86,240,39,87,.448,30,69,.435,9,18,.500,11,16,.688,98,33,79,.418,26,55,.473,7,24,.292,13,15,.867,86
1868,UTA,2017-11-13,98,,MIN,L 98-109,240,37,84,.440,23,44,.523,14,40,.350,10,11,.909,98,37,71,.521,27,51,.529,10,20,.500,25,29,.862,109
1869,MIL,2017-11-11,98,,LAL,W 98-90,240,35,85,.412,29,62,.468,6,23,.261,22,26,.846,98,31,74,.419,25,52,.481,6,22,.273,22,37,.595,90
1870,MEM,2017-11-07,98,@,POR,W 98-97,240,35,73,.479,28,54,.519,7,19,.368,21,25,.840,98,36,81,.444,30,62,.484,6,19,.316,19,20,.950,97
1871,BRK,2017-11-06,98,@,PHO,W 98-92,240,35,87,.402,27,55,.491,8,32,.250,20,29,.690,98,30,86,.349,24,61,.393,6,25,.240,26,35,.743,92
1872,NOP,2017-11-01,98,,MIN,L 98-104,240,36,84,.429,28,53,.528,8,31,.258,18,21,.857,98,41,83,.494,35,61,.574,6,22,.273,16,24,.667,104
1873,DAL,2017-11-01,98,@,LAC,L 98-119,240,35,89,.393,23,53,.434,12,36,.333,16,20,.800,98,41,78,.526,28,50,.560,13,28,.464,24,29,.828,119
1874,MEM,2017-10-23,98,@,HOU,W 98-90,240,29,68,.426,23,49,.469,6,19,.316,34,37,.919,98,32,77,.416,23,39,.590,9,38,.237,17,23,.739,90
1875,BRK,2018-04-11,97,@,BOS,L 97-110,240,37,91,.407,26,51,.510,11,40,.275,12,16,.750,97,46,102,.451,40,78,.513,6,24,.250,12,15,.800,110
1876,DAL,2018-04-10,97,,PHO,L 97-124,240,37,97,.381,29,64,.453,8,33,.242,15,22,.682,97,48,76,.632,35,50,.700,13,26,.500,15,21,.714,124
1877,LAL,2018-04-08,97,,UTA,L 97-112,240,37,93,.398,32,68,.471,5,25,.200,18,22,.818,97,42,83,.506,29,47,.617,13,36,.361,15,22,.682,112
1878,DAL,2018-04-08,97,@,PHI,L 97-109,240,40,94,.426,29,54,.537,11,40,.275,6,13,.462,97,46,91,.505,38,64,.594,8,27,.296,9,14,.643,109
1879,WAS,2018-04-06,97,,ATL,L 97-103,240,35,87,.402,26,62,.419,9,25,.360,18,23,.783,97,38,79,.481,27,46,.587,11,33,.333,16,23,.696,103
1880,PHO,2018-04-03,97,,SAC,W 97-94,240,35,77,.455,29,60,.483,6,17,.353,21,33,.636,97,33,89,.371,22,62,.355,11,27,.407,17,23,.739,94
1881,ORL,2018-04-03,97,@,NYK,W 97-73,240,37,88,.420,26,52,.500,11,36,.306,12,18,.667,97,30,86,.349,26,59,.441,4,27,.148,9,12,.750,73
1882,MIN,2018-04-01,97,,UTA,L 97-121,240,38,90,.422,30,66,.455,8,24,.333,13,14,.929,97,46,76,.605,35,48,.729,11,28,.393,18,25,.720,121
1883,MEM,2018-03-30,97,@,UTA,L 97-107,240,39,81,.481,30,58,.517,9,23,.391,10,15,.667,97,40,74,.541,28,43,.651,12,31,.387,15,26,.577,107
1884,BOS,2018-03-28,97,@,UTA,W 97-94,240,35,79,.443,23,58,.397,12,21,.571,15,20,.750,97,34,82,.415,25,49,.510,9,33,.273,17,21,.810,94
1885,SAC,2018-03-27,97,,DAL,L 97-103,240,38,93,.409,32,70,.457,6,23,.261,15,19,.789,97,36,80,.450,22,40,.550,14,40,.350,17,25,.680,103
1886,WAS,2018-03-25,97,,NYK,L 97-101,240,37,87,.425,31,68,.456,6,19,.316,17,23,.739,97,41,88,.466,35,66,.530,6,22,.273,13,15,.867,101
1887,SAC,2018-03-17,97,@,UTA,L 97-103,240,37,86,.430,23,65,.354,14,21,.667,9,14,.643,97,33,74,.446,27,50,.540,6,24,.250,31,38,.816,103
1888,NYK,2018-03-13,97,,DAL,L 97-110,240,40,82,.488,32,57,.561,8,25,.320,9,12,.750,97,40,89,.449,26,54,.481,14,35,.400,16,18,.889,110
1889,BRK,2018-03-11,97,,PHI,L 97-120,240,33,85,.388,23,57,.404,10,28,.357,21,24,.875,97,50,95,.526,41,69,.594,9,26,.346,11,18,.611,120
1890,BOS,2018-03-11,97,,IND,L 97-99,240,34,81,.420,22,44,.500,12,37,.324,17,21,.810,97,39,81,.481,27,59,.458,12,22,.545,9,10,.900,99
1891,NOP,2018-03-09,97,,WAS,L 97-116,240,38,82,.463,32,62,.516,6,20,.300,15,18,.833,97,46,96,.479,37,70,.529,9,26,.346,15,20,.750,116
1892,CLE,2018-03-01,97,,PHI,L 97-108,240,36,87,.414,27,55,.491,9,32,.281,16,23,.696,97,40,90,.444,30,60,.500,10,30,.333,18,27,.667,108
1893,UTA,2018-02-24,97,,DAL,W 97-90,240,34,85,.400,25,53,.472,9,32,.281,20,26,.769,97,34,83,.410,24,48,.500,10,35,.286,12,14,.857,90
1894,PHO,2018-02-14,97,@,UTA,L 97-107,240,34,79,.430,22,50,.440,12,29,.414,17,24,.708,97,39,92,.424,29,58,.500,10,34,.294,19,22,.864,107
1895,MIL,2018-02-13,97,,ATL,W 97-92,240,38,88,.432,30,63,.476,8,25,.320,13,17,.765,97,33,86,.384,21,51,.412,12,35,.343,14,20,.700,92
1896,DAL,2018-02-11,97,@,HOU,L 97-104,240,38,93,.409,28,62,.452,10,31,.323,11,16,.688,97,34,78,.436,21,33,.636,13,45,.289,23,33,.697,104
1897,IND,2018-02-09,97,@,BOS,W 97-91,240,37,83,.446,32,63,.508,5,20,.250,18,22,.818,97,34,89,.382,27,62,.435,7,27,.259,16,20,.800,91
1898,BOS,2018-02-04,97,,POR,W 97-96,240,35,85,.412,20,49,.408,15,36,.417,12,17,.706,97,36,91,.396,23,60,.383,13,31,.419,11,14,.786,96
1899,PHO,2018-02-02,97,,UTA,L 97-129,240,36,87,.414,27,54,.500,9,33,.273,16,19,.842,97,51,90,.567,36,61,.590,15,29,.517,12,17,.706,129
1900,MIA,2018-02-02,97,@,PHI,L 97-103,240,34,87,.391,22,50,.440,12,37,.324,17,26,.654,97,42,85,.494,34,61,.557,8,24,.333,11,15,.733,103
1901,BRK,2018-01-27,97,@,MIN,L 97-111,240,38,82,.463,29,52,.558,9,30,.300,12,15,.800,97,42,96,.438,38,75,.507,4,21,.190,23,26,.885,111
1902,PHI,2018-01-26,97,@,SAS,W 97-78,240,38,79,.481,29,58,.500,9,21,.429,12,18,.667,97,30,75,.400,27,51,.529,3,24,.125,15,18,.833,78
1903,UTA,2018-01-26,97,@,TOR,W 97-93,240,36,87,.414,26,66,.394,10,21,.476,15,21,.714,97,37,95,.389,30,68,.441,7,27,.259,12,17,.706,93
1904,DAL,2018-01-24,97,,HOU,L 97-104,240,35,82,.427,20,47,.426,15,35,.429,12,18,.667,97,36,82,.439,15,31,.484,21,51,.412,11,23,.478,104
1905,ATL,2018-01-20,97,,CHI,L 97-113,240,35,92,.380,24,44,.545,11,48,.229,16,23,.696,97,40,80,.500,26,48,.542,14,32,.438,19,21,.905,113
1906,MIA,2018-01-14,97,,MIL,W 97-79,240,35,76,.461,24,47,.511,11,29,.379,16,20,.800,97,25,79,.316,21,51,.412,4,28,.143,25,27,.926,79
1907,PHO,2018-01-14,97,,IND,L 97-120,240,35,85,.412,26,48,.542,9,37,.243,18,24,.750,97,48,88,.545,37,65,.569,11,23,.478,13,14,.929,120
1908,IND,2018-01-12,97,,CLE,W 97-95,240,39,85,.459,29,64,.453,10,21,.476,9,12,.750,97,37,85,.435,30,51,.588,7,34,.206,14,19,.737,95
1909,DEN,2018-01-10,97,,ATL,L 97-110,240,38,95,.400,29,58,.500,9,37,.243,12,20,.600,97,40,80,.500,28,53,.528,12,27,.444,18,18,1.000,110
1910,MIN,2018-01-03,97,@,BRK,L 97-98,240,36,80,.450,35,69,.507,1,11,.091,24,30,.800,97,37,72,.514,23,42,.548,14,30,.467,10,11,.909,98
1911,MIL,2017-12-29,97,@,OKC,W 97-95,240,40,85,.471,31,56,.554,9,29,.310,8,17,.471,97,38,83,.458,31,58,.534,7,25,.280,12,20,.600,95
1912,BRK,2017-12-26,97,@,SAS,L 97-109,240,39,93,.419,27,61,.443,12,32,.375,7,9,.778,97,41,80,.513,34,64,.531,7,16,.438,20,24,.833,109
1913,MEM,2017-12-26,97,@,PHO,L 97-99,240,35,87,.402,32,67,.478,3,20,.150,24,29,.828,97,32,72,.444,24,50,.480,8,22,.364,27,35,.771,99
1914,ORL,2017-12-22,97,,NOP,L 97-111,240,36,85,.424,32,65,.492,4,20,.200,21,29,.724,97,43,86,.500,33,56,.589,10,30,.333,15,24,.625,111
1915,PHO,2017-12-21,97,,MEM,W 97-95,240,33,81,.407,23,55,.418,10,26,.385,21,27,.778,97,39,90,.433,34,64,.531,5,26,.192,12,16,.750,95
1916,GSW,2017-12-20,97,,MEM,W 97-84,240,34,74,.459,27,53,.509,7,21,.333,22,25,.880,97,28,84,.333,16,53,.302,12,31,.387,16,19,.842,84
1917,PHO,2017-12-18,97,@,DAL,W 97-91,240,35,79,.443,25,54,.463,10,25,.400,17,22,.773,97,32,88,.364,21,51,.412,11,37,.297,16,17,.941,91
1918,BRK,2017-12-17,97,,IND,L 97-109,240,34,81,.420,22,48,.458,12,33,.364,17,21,.810,97,43,76,.566,35,58,.603,8,18,.444,15,19,.789,109
1919,DAL,2017-12-14,97,@,GSW,L 97-112,240,37,82,.451,27,53,.509,10,29,.345,13,17,.765,97,47,78,.603,36,56,.643,11,22,.500,7,9,.778,112
1920,MIN,2017-12-10,97,,DAL,W 97-92,240,36,72,.500,29,53,.547,7,19,.368,18,23,.783,97,37,81,.457,26,50,.520,11,31,.355,7,9,.778,92
1921,BOS,2017-12-06,97,,DAL,W 97-90,240,36,87,.414,24,53,.453,12,34,.353,13,17,.765,97,34,86,.395,25,58,.431,9,28,.321,13,17,.765,90
1922,NYK,2017-12-04,97,@,IND,L 97-115,240,40,91,.440,34,68,.500,6,23,.261,11,16,.688,97,46,86,.535,35,60,.583,11,26,.423,12,15,.800,115
1923,PHI,2017-11-30,97,@,BOS,L 97-108,240,35,84,.417,19,52,.365,16,32,.500,11,18,.611,97,40,79,.506,28,50,.560,12,29,.414,16,20,.800,108
1924,IND,2017-11-29,97,@,HOU,L 97-118,240,42,88,.477,35,60,.583,7,28,.250,6,6,1.000,97,42,86,.488,24,46,.522,18,40,.450,16,21,.762,118
1925,MIA,2017-11-28,97,@,CLE,L 97-108,240,37,84,.440,27,53,.509,10,31,.323,13,20,.650,97,40,81,.494,29,48,.604,11,33,.333,17,23,.739,108
1926,LAC,2017-11-25,97,@,SAC,W 97-95,240,38,80,.475,29,52,.558,9,28,.321,12,13,.923,97,38,83,.458,27,62,.435,11,21,.524,8,9,.889,95
1927,DAL,2017-11-25,97,,OKC,W 97-81,240,37,75,.493,22,40,.550,15,35,.429,8,11,.727,97,29,80,.363,16,45,.356,13,35,.371,10,13,.769,81
1928,MIN,2017-11-24,97,,MIA,L 97-109,240,37,84,.440,30,67,.448,7,17,.412,16,26,.615,97,38,80,.475,19,41,.463,19,39,.487,14,16,.875,109
1929,ORL,2017-11-20,97,,IND,L 97-105,240,35,84,.417,22,46,.478,13,38,.342,14,23,.609,97,37,89,.416,29,69,.420,8,20,.400,23,29,.793,105
1930,MIN,2017-11-19,97,,DET,L 97-100,240,40,78,.513,35,56,.625,5,22,.227,12,18,.667,97,39,83,.470,31,58,.534,8,25,.320,14,20,.700,100
1931,SAS,2017-11-14,97,@,DAL,W 97-91,240,35,79,.443,29,53,.547,6,26,.231,21,27,.778,97,33,81,.407,23,47,.489,10,34,.294,15,18,.833,91
1932,POR,2017-11-10,97,,BRK,L 97-101,240,40,95,.421,32,72,.444,8,23,.348,9,11,.818,97,39,91,.429,27,53,.509,12,38,.316,11,19,.579,101
1933,IND,2017-11-08,97,@,DET,L 97-114,240,38,88,.432,31,64,.484,7,24,.292,14,18,.778,97,43,83,.518,31,56,.554,12,27,.444,16,25,.640,114
1934,UTA,2017-11-07,97,,PHI,L 97-104,240,30,99,.303,21,60,.350,9,39,.231,28,35,.800,97,34,81,.420,22,54,.407,12,27,.444,24,30,.800,104
1935,POR,2017-11-07,97,,MEM,L 97-98,240,36,81,.444,30,62,.484,6,19,.316,19,20,.950,97,35,73,.479,28,54,.519,7,19,.368,21,25,.840,98
1936,GSW,2017-11-06,97,,MIA,W 97-80,240,32,87,.368,21,55,.382,11,32,.344,22,24,.917,97,30,83,.361,22,57,.386,8,26,.308,12,17,.706,80
1937,MIA,2017-11-01,97,,CHI,W 97-91,240,34,83,.410,22,52,.423,12,31,.387,17,19,.895,97,36,89,.404,29,61,.475,7,28,.250,12,19,.632,91
1938,NYK,2017-11-01,97,,HOU,L 97-119,240,39,90,.433,31,64,.484,8,26,.308,11,13,.846,97,42,88,.477,23,36,.639,19,52,.365,16,21,.762,119
1939,IND,2017-10-29,97,,SAS,W 97-94,240,36,77,.468,26,55,.473,10,22,.455,15,20,.750,97,36,90,.400,27,62,.435,9,28,.321,13,18,.722,94
1940,PHO,2017-10-25,97,,UTA,W 97-88,240,42,96,.438,36,77,.468,6,19,.316,7,9,.778,97,32,77,.416,26,52,.500,6,25,.240,18,25,.720,88
1941,PHI,2017-10-23,97,@,DET,W 97-86,240,35,75,.467,26,51,.510,9,24,.375,18,24,.750,97,33,85,.388,27,55,.491,6,30,.200,14,19,.737,86
1942,TOR,2017-10-23,97,@,SAS,L 97-101,240,34,80,.425,24,43,.558,10,37,.270,19,24,.792,97,40,90,.444,35,70,.500,5,20,.250,16,23,.696,101
1943,UTA,2017-10-20,97,@,MIN,L 97-100,240,37,77,.481,28,55,.509,9,22,.409,14,17,.824,97,36,81,.444,29,59,.492,7,22,.318,21,26,.808,100
1944,MIL,2017-10-20,97,,CLE,L 97-116,240,38,82,.463,27,47,.574,11,35,.314,10,12,.833,97,44,81,.543,33,55,.600,11,26,.423,17,17,1.000,116
1945,SAC,2018-04-11,96,,HOU,W 96-83,240,38,80,.475,31,54,.574,7,26,.269,13,20,.650,96,31,82,.378,18,36,.500,13,46,.283,8,12,.667,83
1946,CHI,2018-04-07,96,,BRK,L 96-124,240,36,88,.409,30,59,.508,6,29,.207,18,21,.857,96,46,92,.500,22,37,.595,24,55,.436,8,11,.727,124
1947,LAL,2018-04-06,96,,MIN,L 96-113,240,31,79,.392,23,55,.418,8,24,.333,26,32,.813,96,43,100,.430,35,74,.473,8,26,.308,19,26,.731,113
1948,HOU,2018-04-05,96,,POR,W 96-94,240,34,73,.466,21,36,.583,13,37,.351,15,24,.625,96,39,85,.459,32,63,.508,7,22,.318,9,14,.643,94
1949,MIN,2018-04-05,96,@,DEN,L 96-100,240,39,91,.429,33,67,.493,6,24,.250,12,16,.750,96,35,89,.393,24,53,.453,11,36,.306,19,22,.864,100
1950,TOR,2018-04-04,96,,BOS,W 96-78,240,40,92,.435,30,59,.508,10,33,.303,6,8,.750,96,25,75,.333,22,53,.415,3,22,.136,25,28,.893,78
1951,BRK,2018-04-01,96,,DET,L 96-108,240,37,87,.425,25,44,.568,12,43,.279,10,15,.667,96,38,84,.452,31,65,.477,7,19,.368,25,32,.781,108
1952,SAC,2018-03-31,96,,GSW,L 96-112,240,36,87,.414,28,59,.475,8,28,.286,16,19,.842,96,41,83,.494,32,57,.561,9,26,.346,21,28,.750,112
1953,LAC,2018-03-30,96,@,POR,L 96-105,240,36,89,.404,32,76,.421,4,13,.308,20,35,.571,96,41,95,.432,33,65,.508,8,30,.267,15,16,.938,105
1954,DET,2018-03-22,96,@,HOU,L 96-100 (OT),265,40,95,.421,34,57,.596,6,38,.158,10,19,.526,96,35,99,.354,23,48,.479,12,51,.235,18,28,.643,100
1955,NOP,2018-03-21,96,,IND,W 96-92,240,34,79,.430,26,56,.464,8,23,.348,20,24,.833,96,34,93,.366,27,71,.380,7,22,.318,17,18,.944,92
1956,LAC,2018-03-15,96,@,HOU,L 96-101,240,44,97,.454,40,79,.506,4,18,.222,4,8,.500,96,35,90,.389,23,49,.469,12,41,.293,19,23,.826,101
1957,DET,2018-03-03,96,@,MIA,L 96-105,240,37,89,.416,30,65,.462,7,24,.292,15,21,.714,96,37,82,.451,25,53,.472,12,29,.414,19,28,.679,105
1958,MIL,2018-03-02,96,,IND,L 96-103,240,31,81,.383,22,56,.393,9,25,.360,25,32,.781,96,37,83,.446,31,67,.463,6,16,.375,23,30,.767,103
1959,HOU,2018-02-26,96,@,UTA,W 96-85,240,34,79,.430,25,46,.543,9,33,.273,19,25,.760,96,31,71,.437,24,42,.571,7,29,.241,16,22,.727,85
1960,BRK,2018-02-22,96,@,CHO,L 96-111,240,36,93,.387,22,50,.440,14,43,.326,10,14,.714,96,42,87,.483,31,66,.470,11,21,.524,16,20,.800,111
1961,POR,2018-02-11,96,,UTA,L 96-115,240,33,81,.407,24,56,.429,9,25,.360,21,25,.840,96,41,88,.466,28,62,.452,13,26,.500,20,22,.909,115
1962,POR,2018-02-04,96,@,BOS,L 96-97,240,36,91,.396,23,60,.383,13,31,.419,11,14,.786,96,35,85,.412,20,49,.408,15,36,.417,12,17,.706,97
1963,NYK,2018-02-04,96,,ATL,L 96-99,240,41,94,.436,36,71,.507,5,23,.217,9,15,.600,96,35,87,.402,20,54,.370,15,33,.455,14,19,.737,99
1964,LAC,2018-01-30,96,,POR,L 96-104,240,35,85,.412,29,63,.460,6,22,.273,20,26,.769,96,36,98,.367,23,68,.338,13,30,.433,19,22,.864,104
1965,OKC,2018-01-30,96,@,WAS,L 96-102,240,30,80,.375,21,48,.438,9,32,.281,27,34,.794,96,34,89,.382,27,64,.422,7,25,.280,27,29,.931,102
1966,CHO,2018-01-29,96,@,IND,L 96-105,240,37,83,.446,28,52,.538,9,31,.290,13,20,.650,96,45,83,.542,39,62,.629,6,21,.286,9,11,.818,105
1967,CHI,2018-01-28,96,,MIL,L 96-110,240,36,87,.414,24,53,.453,12,34,.353,12,15,.800,96,41,77,.532,28,49,.571,13,28,.464,15,25,.600,110
1968,CHO,2018-01-24,96,,NOP,L 96-101,240,36,85,.424,30,64,.469,6,21,.286,18,31,.581,96,39,87,.448,30,61,.492,9,26,.346,14,18,.778,101
1969,TOR,2018-01-17,96,,DET,W 96-91,240,34,80,.425,23,49,.469,11,31,.355,17,23,.739,96,37,88,.420,27,60,.450,10,28,.357,7,15,.467,91
1970,MIL,2018-01-08,96,@,IND,L 96-109,240,34,74,.459,27,47,.574,7,27,.259,21,27,.778,96,44,79,.557,37,57,.649,7,22,.318,14,20,.700,109
1971,DAL,2018-01-07,96,,NYK,L 96-100,240,35,92,.380,29,68,.426,6,24,.250,20,24,.833,96,38,83,.458,32,67,.478,6,16,.375,18,20,.900,100
1972,LAL,2018-01-03,96,,OKC,L 96-133,240,38,92,.413,27,59,.458,11,33,.333,9,15,.600,96,56,93,.602,42,63,.667,14,30,.467,7,9,.778,133
1973,LAL,2018-01-01,96,@,MIN,L 96-114,240,34,76,.447,26,50,.520,8,26,.308,20,29,.690,96,40,81,.494,33,61,.541,7,20,.350,27,30,.900,114
1974,SAC,2017-12-31,96,,MEM,L 96-114,240,37,86,.430,28,62,.452,9,24,.375,13,25,.520,96,41,76,.539,27,46,.587,14,30,.467,18,24,.750,114
1975,MIN,2017-12-28,96,@,MIL,L 96-102,240,34,71,.479,25,43,.581,9,28,.321,19,26,.731,96,41,75,.547,36,60,.600,5,15,.333,15,16,.938,102
1976,DEN,2017-12-23,96,@,GSW,W 96-81,240,38,82,.463,31,54,.574,7,28,.250,13,15,.867,96,32,84,.381,29,57,.509,3,27,.111,14,17,.824,81
1977,OKC,2017-12-16,96,@,NYK,L 96-111,240,36,85,.424,24,58,.414,12,27,.444,12,20,.600,96,38,69,.551,24,46,.522,14,23,.609,21,26,.808,111
1978,DAL,2017-12-16,96,@,SAS,L 96-98,240,39,80,.488,29,52,.558,10,28,.357,8,9,.889,96,39,86,.453,34,61,.557,5,25,.200,15,18,.833,98
1979,MEM,2017-12-15,96,,ATL,W 96-94,240,36,78,.462,24,53,.453,12,25,.480,12,17,.706,96,34,77,.442,22,46,.478,12,31,.387,14,16,.875,94
1980,SAC,2017-12-14,96,@,MIN,L 96-119,240,36,87,.414,22,54,.407,14,33,.424,10,12,.833,96,46,82,.561,36,61,.590,10,21,.476,17,20,.850,119
1981,CHO,2017-12-13,96,@,HOU,L 96-108,240,36,87,.414,32,66,.485,4,21,.190,20,27,.741,96,39,88,.443,22,43,.512,17,45,.378,13,19,.684,108
1982,LAC,2017-12-11,96,,TOR,W 96-91,240,34,92,.370,26,56,.464,8,36,.222,20,24,.833,96,32,80,.400,25,51,.490,7,29,.241,20,26,.769,91
1983,CHI,2017-12-06,96,@,IND,L 96-98,240,39,83,.470,29,57,.509,10,26,.385,8,16,.500,96,39,87,.448,27,53,.509,12,34,.353,8,10,.800,98
1984,SAS,2017-12-04,96,,DET,W 96-93,240,35,82,.427,21,51,.412,14,31,.452,12,12,1.000,96,35,85,.412,27,58,.466,8,27,.296,15,24,.625,93
1985,SAS,2017-11-20,96,,ATL,W 96-85,240,40,89,.449,30,58,.517,10,31,.323,6,6,1.000,96,37,85,.435,29,55,.527,8,30,.267,3,8,.375,85
1986,MEM,2017-11-11,96,@,HOU,L 96-111,240,38,79,.481,32,59,.542,6,20,.300,14,18,.778,96,37,83,.446,21,38,.553,16,45,.356,21,28,.750,111
1987,LAL,2017-11-08,96,@,BOS,L 96-107,240,37,85,.435,32,61,.525,5,24,.208,17,23,.739,96,38,98,.388,31,69,.449,7,29,.241,24,31,.774,107
1988,TOR,2017-11-05,96,,WAS,L 96-107,240,37,80,.463,32,56,.571,5,24,.208,17,27,.630,96,40,85,.471,29,62,.468,11,23,.478,16,23,.696,107
1989,NOP,2017-11-04,96,@,CHI,W 96-90 (OT),265,35,87,.402,26,56,.464,9,31,.290,17,22,.773,96,35,99,.354,24,57,.421,11,42,.262,9,12,.750,90
1990,MIL,2017-11-03,96,@,DET,L 96-105,240,39,83,.470,29,58,.500,10,25,.400,8,9,.889,96,37,78,.474,29,52,.558,8,26,.308,23,28,.821,105
1991,BOS,2017-10-28,96,@,MIA,W 96-90,240,34,81,.420,28,58,.483,6,23,.261,22,26,.846,96,34,79,.430,27,48,.563,7,31,.226,15,16,.938,90
1992,UTA,2017-10-28,96,,LAL,W 96-81,240,37,79,.468,24,48,.500,13,31,.419,9,13,.692,96,31,81,.383,26,59,.441,5,22,.227,14,20,.700,81
1993,MEM,2017-10-26,96,,DAL,W 96-91,240,30,73,.411,20,39,.513,10,34,.294,26,30,.867,96,32,94,.340,22,60,.367,10,34,.294,17,20,.850,91
1994,BOS,2017-10-26,96,@,MIL,W 96-89,240,33,78,.423,22,48,.458,11,30,.367,19,22,.864,96,35,77,.455,24,52,.462,11,25,.440,8,14,.571,89
1995,IND,2017-10-25,96,@,OKC,L 96-114,240,28,83,.337,18,54,.333,10,29,.345,30,35,.857,96,43,89,.483,33,62,.532,10,27,.370,18,26,.692,114
1996,UTA,2017-10-21,96,,OKC,W 96-87,240,38,77,.494,29,48,.604,9,29,.310,11,14,.786,96,32,78,.410,21,45,.467,11,33,.333,12,19,.632,87
1997,DEN,2017-10-21,96,,SAC,W 96-79,240,37,85,.435,27,55,.491,10,30,.333,12,20,.600,96,31,85,.365,23,63,.365,8,22,.364,9,13,.692,79
1998,IND,2017-10-20,96,,POR,L 96-114,240,35,78,.449,31,60,.517,4,18,.222,22,33,.667,96,46,95,.484,37,76,.487,9,19,.474,13,17,.765,114
1999,DEN,2017-10-18,96,@,UTA,L 96-106,240,36,77,.468,23,50,.460,13,27,.481,11,12,.917,96,41,81,.506,32,57,.561,9,24,.375,15,16,.938,106
2000,MIL,2018-04-11,95,@,PHI,L 95-130,240,37,90,.411,30,65,.462,7,25,.280,14,16,.875,95,52,105,.495,37,69,.536,15,36,.417,11,15,.733,130
2001,LAC,2018-04-05,95,@,UTA,L 95-117,240,35,79,.443,32,62,.516,3,17,.176,22,28,.786,95,44,83,.530,34,56,.607,10,27,.370,19,28,.679,117
2002,MEM,2018-04-04,95,@,NOP,L 95-123,240,37,93,.398,27,61,.443,10,32,.313,11,15,.733,95,45,86,.523,29,50,.580,16,36,.444,17,19,.895,123
2003,BRK,2018-04-03,95,@,PHI,L 95-121,240,34,81,.420,17,39,.436,17,42,.405,10,23,.435,95,50,91,.549,41,70,.586,9,21,.429,12,18,.667,121
2004,CHI,2018-03-24,95,@,DET,L 95-117,240,39,97,.402,28,62,.452,11,35,.314,6,9,.667,95,43,87,.494,27,45,.600,16,42,.381,15,18,.833,117
2005,PHO,2018-03-23,95,@,CLE,L 95-120,240,38,87,.437,31,59,.525,7,28,.250,12,20,.600,95,47,95,.495,39,66,.591,8,29,.276,18,24,.750,120
2006,UTA,2018-03-09,95,@,MEM,W 95-78,240,33,74,.446,20,42,.476,13,32,.406,16,22,.727,95,31,83,.373,25,61,.410,6,22,.273,10,14,.714,78
2007,WAS,2018-03-04,95,,IND,L 95-98,240,35,83,.422,25,56,.446,10,27,.370,15,19,.789,95,34,77,.442,26,52,.500,8,25,.320,22,24,.917,98
2008,WAS,2018-03-02,95,,TOR,L 95-102,240,36,79,.456,27,55,.491,9,24,.375,14,21,.667,95,36,78,.462,26,45,.578,10,33,.303,20,32,.625,102
2009,DET,2018-02-09,95,,LAC,L 95-108,240,36,88,.409,26,57,.456,10,31,.323,13,17,.765,95,42,91,.462,32,61,.525,10,30,.333,14,15,.933,108
2010,BRK,2018-01-30,95,@,NYK,L 95-111,240,36,87,.414,27,50,.540,9,37,.243,14,16,.875,95,39,89,.438,26,63,.413,13,26,.500,20,25,.800,111
2011,MIA,2018-01-29,95,@,DAL,W 95-88,240,34,75,.453,22,44,.500,12,31,.387,15,19,.789,95,33,86,.384,25,57,.439,8,29,.276,14,16,.875,88
2012,PHI,2018-01-29,95,@,MIL,L 95-107,240,36,82,.439,34,56,.607,2,26,.077,21,23,.913,95,38,80,.475,27,52,.519,11,28,.393,20,22,.909,107
2013,MIA,2018-01-27,95,,CHO,W 95-91,240,38,85,.447,30,59,.508,8,26,.308,11,18,.611,95,29,84,.345,24,60,.400,5,24,.208,28,35,.800,91
2014,DET,2018-01-24,95,,UTA,L 95-98 (OT),265,38,97,.392,31,66,.470,7,31,.226,12,18,.667,95,38,96,.396,28,65,.431,10,31,.323,12,16,.750,98
2015,BOS,2018-01-21,95,,ORL,L 95-103,240,37,85,.435,29,58,.500,8,27,.296,13,14,.929,95,43,92,.467,37,71,.521,6,21,.286,11,16,.688,103
2016,MIA,2018-01-19,95,@,BRK,L 95-101,240,35,84,.417,28,62,.452,7,22,.318,18,25,.720,95,36,76,.474,27,44,.614,9,32,.281,20,26,.769,101
2017,BRK,2018-01-17,95,,SAS,L 95-100,240,35,83,.422,22,47,.468,13,36,.361,12,18,.667,95,34,82,.415,25,63,.397,9,19,.474,23,31,.742,100
2018,WAS,2018-01-15,95,,MIL,L 95-104,240,32,76,.421,26,55,.473,6,21,.286,25,31,.806,95,38,81,.469,30,65,.462,8,16,.500,20,29,.690,104
2019,OKC,2018-01-15,95,,SAC,W 95-88,240,36,86,.419,27,56,.482,9,30,.300,14,29,.483,95,33,84,.393,26,54,.481,7,30,.233,15,25,.600,88
2020,CLE,2018-01-12,95,@,IND,L 95-97,240,37,85,.435,30,51,.588,7,34,.206,14,19,.737,95,39,85,.459,29,64,.453,10,21,.476,9,12,.750,97
2021,PHO,2018-01-12,95,,HOU,L 95-112,240,37,80,.463,23,47,.489,14,33,.424,7,9,.778,95,39,94,.415,24,47,.511,15,47,.319,19,22,.864,112
2022,ORL,2018-01-01,95,@,BRK,L 95-98,240,35,96,.365,29,65,.446,6,31,.194,19,25,.760,95,36,82,.439,27,57,.474,9,25,.360,17,23,.739,98
2023,OKC,2017-12-29,95,,MIL,L 95-97,240,38,83,.458,31,58,.534,7,25,.280,12,20,.600,95,40,85,.471,31,56,.554,9,29,.310,8,17,.471,97
2024,CLE,2017-12-27,95,@,SAC,L 95-109,240,32,74,.432,20,43,.465,12,31,.387,19,25,.760,95,41,79,.519,29,49,.592,12,30,.400,15,18,.833,109
2025,SAC,2017-12-26,95,@,LAC,L 95-122,240,40,96,.417,33,74,.446,7,22,.318,8,12,.667,95,44,81,.543,31,50,.620,13,31,.419,21,27,.778,122
2026,POR,2017-12-23,95,@,LAL,W 95-92,240,39,95,.411,29,70,.414,10,25,.400,7,14,.500,95,36,85,.424,28,60,.467,8,25,.320,12,20,.600,92
2027,MEM,2017-12-21,95,@,PHO,L 95-97,240,39,90,.433,34,64,.531,5,26,.192,12,16,.750,95,33,81,.407,23,55,.418,10,26,.385,21,27,.778,97
2028,PHO,2017-12-20,95,@,LAC,L 95-108,240,35,97,.361,27,62,.435,8,35,.229,17,19,.895,95,41,87,.471,31,57,.544,10,30,.333,16,24,.667,108
2029,ATL,2017-12-20,95,,IND,L 95-105,240,35,81,.432,27,52,.519,8,29,.276,17,20,.850,95,40,82,.488,33,61,.541,7,21,.333,18,19,.947,105
2030,PHI,2017-12-19,95,,SAC,L 95-101,240,34,81,.420,24,46,.522,10,35,.286,17,24,.708,95,41,91,.451,34,64,.531,7,27,.259,12,23,.522,101
2031,OKC,2017-12-18,95,,DEN,W 95-94,240,39,81,.481,32,57,.561,7,24,.292,10,15,.667,95,37,86,.430,25,49,.510,12,37,.324,8,12,.667,94
2032,BOS,2017-12-15,95,,UTA,L 95-107,240,35,86,.407,26,55,.473,9,31,.290,16,19,.842,95,40,83,.482,27,58,.466,13,25,.520,14,18,.778,107
2033,POR,2017-12-15,95,@,ORL,W 95-88,240,37,86,.430,29,68,.426,8,18,.444,13,15,.867,95,32,84,.381,22,55,.400,10,29,.345,14,19,.737,88
2034,IND,2017-12-13,95,,OKC,L 95-100,240,40,89,.449,29,58,.500,11,31,.355,4,6,.667,95,36,88,.409,23,59,.390,13,29,.448,15,24,.625,100
2035,MIA,2017-12-13,95,,POR,L 95-102,240,34,72,.472,21,42,.500,13,30,.433,14,23,.609,95,36,72,.500,26,44,.591,10,28,.357,20,23,.870,102
2036,ORL,2017-12-13,95,,LAC,L 95-106,240,37,88,.420,28,61,.459,9,27,.333,12,21,.571,95,39,88,.443,27,62,.435,12,26,.462,16,20,.800,106
2037,DAL,2017-12-12,95,,SAS,W 95-89,240,38,89,.427,29,65,.446,9,24,.375,10,12,.833,95,35,87,.402,28,59,.475,7,28,.250,12,19,.632,89
2038,OKC,2017-12-07,95,@,BRK,L 95-100,240,38,98,.388,31,74,.419,7,24,.292,12,23,.522,95,35,80,.438,24,43,.558,11,37,.297,19,30,.633,100
2039,SAC,2017-12-06,95,@,CLE,L 95-101,240,39,86,.453,29,54,.537,10,32,.313,7,13,.538,95,37,78,.474,23,39,.590,14,39,.359,13,21,.619,101
2040,MEM,2017-12-04,95,,MIN,W 95-92,240,34,72,.472,28,51,.549,6,21,.286,21,24,.875,95,35,79,.443,31,62,.500,4,17,.235,18,19,.947,92
2041,MIA,2017-12-03,95,,GSW,L 95-123,240,33,81,.407,19,44,.432,14,37,.378,15,17,.882,95,47,84,.560,36,54,.667,11,30,.367,18,24,.750,123
2042,LAL,2017-12-03,95,,HOU,L 95-118,240,32,84,.381,23,56,.411,9,28,.321,22,30,.733,95,45,90,.500,31,53,.585,14,37,.378,14,17,.824,118
2043,SAS,2017-12-01,95,@,MEM,W 95-79,240,31,70,.443,20,43,.465,11,27,.407,22,32,.688,95,30,74,.405,25,59,.424,5,15,.333,14,18,.778,79
2044,MEM,2017-11-29,95,@,SAS,L 95-104,240,35,77,.455,24,55,.436,11,22,.500,14,16,.875,95,38,75,.507,30,55,.545,8,20,.400,20,24,.833,104
2045,SAC,2017-11-25,95,,LAC,L 95-97,240,38,83,.458,27,62,.435,11,21,.524,8,9,.889,95,38,80,.475,29,52,.558,9,28,.321,12,13,.923,97
2046,NOP,2017-11-25,95,@,GSW,L 95-110,240,34,84,.405,23,53,.434,11,31,.355,16,23,.696,95,39,94,.415,29,61,.475,10,33,.303,22,27,.815,110
2047,DAL,2017-11-22,95,@,MEM,W 95-94,240,39,91,.429,30,63,.476,9,28,.321,8,16,.500,95,37,81,.457,30,52,.577,7,29,.241,13,14,.929,94
2048,DEN,2017-11-22,95,@,HOU,L 95-125,240,35,87,.402,25,54,.463,10,33,.303,15,23,.652,95,45,82,.549,27,41,.659,18,41,.439,17,23,.739,125
2049,MIA,2017-11-19,95,,IND,L 95-120,240,35,83,.422,22,46,.478,13,37,.351,12,14,.857,95,51,85,.600,40,62,.645,11,23,.478,7,8,.875,120
2050,DET,2017-11-15,95,@,MIL,L 95-99,240,30,85,.353,15,48,.313,15,37,.405,20,23,.870,95,38,78,.487,30,56,.536,8,22,.364,15,20,.750,99
2051,BOS,2017-11-12,95,,TOR,W 95-94,240,35,87,.402,25,61,.410,10,26,.385,15,19,.789,95,32,69,.464,22,45,.489,10,24,.417,20,23,.870,94
2052,IND,2017-11-12,95,,HOU,L 95-118,240,37,83,.446,29,61,.475,8,22,.364,13,21,.619,95,43,90,.478,26,43,.605,17,47,.362,15,18,.833,118
2053,LAL,2017-11-09,95,@,WAS,L 95-111,240,31,86,.360,28,63,.444,3,23,.130,30,41,.732,95,43,83,.518,36,62,.581,7,21,.333,18,20,.900,111
2054,PHO,2017-11-05,95,@,SAS,L 95-112,240,37,81,.457,29,58,.500,8,23,.348,13,22,.591,95,44,88,.500,33,66,.500,11,22,.500,13,18,.722,112
2055,DEN,2017-11-03,95,,MIA,W 95-94,240,36,80,.450,27,57,.474,9,23,.391,14,25,.560,95,36,77,.468,21,40,.525,15,37,.405,7,11,.636,94
2056,CLE,2017-10-29,95,,NYK,L 95-114,240,31,81,.383,21,48,.438,10,33,.303,23,27,.852,95,42,89,.472,29,61,.475,13,28,.464,17,21,.810,114
2057,DET,2017-10-28,95,@,LAC,W 95-87,240,36,88,.409,27,60,.450,9,28,.321,14,21,.667,95,28,84,.333,13,46,.283,15,38,.395,16,22,.727,87
2058,MEM,2018-04-09,94,@,MIN,L 94-113,240,35,85,.412,30,67,.448,5,18,.278,19,21,.905,94,42,87,.483,35,65,.538,7,22,.318,22,26,.846,113
2059,SAC,2018-04-06,94,@,MEM,W 94-93,240,40,85,.471,34,61,.557,6,24,.250,8,12,.667,94,37,84,.440,31,60,.517,6,24,.250,13,18,.722,93
2060,POR,2018-04-05,94,@,HOU,L 94-96,240,39,85,.459,32,63,.508,7,22,.318,9,14,.643,94,34,73,.466,21,36,.583,13,37,.351,15,24,.625,96
2061,SAC,2018-04-03,94,@,PHO,L 94-97,240,33,89,.371,22,62,.355,11,27,.407,17,23,.739,94,35,77,.455,29,60,.483,6,17,.353,21,33,.636,97
2062,WAS,2018-04-01,94,@,CHI,L 94-113,240,37,81,.457,29,51,.569,8,30,.267,12,12,1.000,94,43,82,.524,25,48,.521,18,34,.529,9,13,.692,113
2063,ATL,2018-04-01,94,,ORL,W 94-88,240,41,85,.482,30,49,.612,11,36,.306,1,1,1.000,94,33,96,.344,23,60,.383,10,36,.278,12,13,.923,88
2064,UTA,2018-03-28,94,,BOS,L 94-97,240,34,82,.415,25,49,.510,9,33,.273,17,21,.810,94,35,79,.443,23,58,.397,12,21,.571,15,20,.750,97
2065,PHO,2018-03-26,94,,BOS,L 94-102,240,36,81,.444,24,46,.522,12,35,.343,10,19,.526,94,37,87,.425,23,58,.397,14,29,.483,14,14,1.000,102
2066,ATL,2018-03-23,94,@,GSW,L 94-106,240,37,84,.440,26,52,.500,11,32,.344,9,20,.450,94,42,93,.452,30,63,.476,12,30,.400,10,11,.909,106
2067,UTA,2018-03-20,94,,ATL,L 94-99,240,33,89,.371,27,55,.491,6,34,.176,22,25,.880,94,38,94,.404,29,61,.475,9,33,.273,14,19,.737,99
2068,CHO,2018-03-19,94,@,PHI,L 94-108,240,32,84,.381,26,62,.419,6,22,.273,24,30,.800,94,42,93,.452,24,49,.490,18,44,.409,6,8,.750,108
2069,DEN,2018-03-17,94,@,MEM,L 94-101,240,32,87,.368,23,54,.426,9,33,.273,21,29,.724,94,33,81,.407,20,49,.408,13,32,.406,22,28,.786,101
2070,SAS,2018-03-10,94,@,OKC,L 94-104,240,40,86,.465,30,66,.455,10,20,.500,4,7,.571,94,39,85,.459,29,57,.509,10,28,.357,16,24,.667,104
2071,SAC,2018-03-09,94,,ORL,W 94-88,240,36,83,.434,27,58,.466,9,25,.360,13,15,.867,94,33,78,.423,24,49,.490,9,29,.310,13,16,.813,88
2072,UTA,2018-03-05,94,,ORL,W 94-80,240,36,73,.493,26,42,.619,10,31,.323,12,18,.667,94,29,85,.341,18,51,.353,11,34,.324,11,14,.786,80
2073,DET,2018-02-26,94,@,TOR,L 94-123,240,36,94,.383,29,72,.403,7,22,.318,15,20,.750,94,42,80,.525,25,42,.595,17,38,.447,22,23,.957,123
2074,CLE,2018-02-25,94,,SAS,L 94-110,240,38,91,.418,30,57,.526,8,34,.235,10,14,.714,94,38,86,.442,29,67,.433,9,19,.474,25,32,.781,110
2075,PHI,2018-02-25,94,@,WAS,L 94-109,240,31,86,.360,22,53,.415,9,33,.273,23,31,.742,94,43,79,.544,31,54,.574,12,25,.480,11,12,.917,109
2076,CHO,2018-02-09,94,@,UTA,L 94-106,240,35,85,.412,26,61,.426,9,24,.375,15,19,.789,94,41,84,.488,31,55,.564,10,29,.345,14,17,.824,106
2077,BRK,2018-02-04,94,,MIL,L 94-109,240,37,90,.411,28,61,.459,9,29,.310,11,14,.786,94,42,81,.519,34,62,.548,8,19,.421,17,21,.810,109
2078,IND,2018-01-21,94,@,SAS,W 94-86,240,37,84,.440,33,65,.508,4,19,.211,16,17,.941,94,35,82,.427,26,48,.542,9,34,.265,7,12,.583,86
2079,MIL,2018-01-20,94,@,PHI,L 94-116,240,33,82,.402,23,50,.460,10,32,.313,18,22,.818,94,45,85,.529,35,60,.583,10,25,.400,16,19,.842,116
2080,ATL,2018-01-17,94,,NOP,W 94-93,240,37,89,.416,27,49,.551,10,40,.250,10,13,.769,94,35,80,.438,25,53,.472,10,27,.370,13,19,.684,93
2081,UTA,2018-01-15,94,,IND,L 94-109,240,36,81,.444,27,48,.563,9,33,.273,13,17,.765,94,41,77,.532,27,51,.529,14,26,.538,13,15,.867,109
2082,MIL,2018-01-12,94,,GSW,L 94-108,240,36,85,.424,25,57,.439,11,28,.393,11,12,.917,94,44,79,.557,39,64,.609,5,15,.333,15,18,.833,108
2083,LAL,2018-01-05,94,,CHO,L 94-108,240,38,94,.404,29,58,.500,9,36,.250,9,12,.750,94,42,99,.424,30,66,.455,12,33,.364,12,16,.750,108
2084,IND,2017-12-27,94,,DAL,L 94-98,240,38,79,.481,28,54,.519,10,25,.400,8,10,.800,94,40,78,.513,32,49,.653,8,29,.276,10,15,.667,98
2085,MIA,2017-12-23,94,,NOP,L 94-109,240,36,85,.424,26,53,.491,10,32,.313,12,15,.800,94,39,73,.534,24,48,.500,15,25,.600,16,19,.842,109
2086,ORL,2017-12-20,94,@,CHI,L 94-112,240,35,89,.393,30,62,.484,5,27,.185,19,23,.826,94,44,87,.506,33,55,.600,11,32,.344,13,14,.929,112
2087,DEN,2017-12-18,94,@,OKC,L 94-95,240,37,86,.430,25,49,.510,12,37,.324,8,12,.667,94,39,81,.481,32,57,.561,7,24,.292,10,15,.667,95
2088,ATL,2017-12-15,94,@,MEM,L 94-96,240,34,77,.442,22,46,.478,12,31,.387,14,16,.875,94,36,78,.462,24,53,.453,12,25,.480,12,17,.706,96
2089,UTA,2017-12-05,94,@,OKC,L 94-100,240,34,79,.430,23,46,.500,11,33,.333,15,21,.714,94,39,81,.481,35,63,.556,4,18,.222,18,26,.692,100
2090,ORL,2017-12-04,94,@,CHO,L 94-104,240,36,82,.439,26,50,.520,10,32,.313,12,14,.857,94,34,84,.405,31,67,.463,3,17,.176,33,40,.825,104
2091,CHI,2017-11-24,94,@,GSW,L 94-143,240,35,99,.354,22,63,.349,13,36,.361,11,15,.733,94,53,91,.582,37,55,.673,16,36,.444,21,21,1.000,143
2092,MEM,2017-11-22,94,,DAL,L 94-95,240,37,81,.457,30,52,.577,7,29,.241,13,14,.929,94,39,91,.429,30,63,.476,9,28,.321,8,16,.500,95
2093,CHI,2017-11-21,94,@,LAL,L 94-103,240,36,94,.383,25,58,.431,11,36,.306,11,16,.688,94,36,90,.400,23,50,.460,13,40,.325,18,25,.720,103
2094,ORL,2017-11-15,94,@,POR,L 94-99,240,37,79,.468,26,50,.520,11,29,.379,9,9,1.000,94,38,87,.437,24,60,.400,14,27,.519,9,13,.692,99
2095,TOR,2017-11-12,94,@,BOS,L 94-95,240,32,69,.464,22,45,.489,10,24,.417,20,23,.870,94,35,87,.402,25,61,.410,10,26,.385,15,19,.789,95
2096,ATL,2017-11-11,94,@,WAS,L 94-113,240,34,83,.410,20,50,.400,14,33,.424,12,17,.706,94,42,78,.538,35,54,.648,7,24,.292,22,28,.786,113
2097,CHI,2017-11-11,94,@,SAS,L 94-133,240,40,86,.465,34,63,.540,6,23,.261,8,13,.615,94,51,85,.600,33,58,.569,18,27,.667,13,16,.813,133
2098,MIL,2017-11-10,94,@,SAS,W 94-87,240,41,89,.461,36,71,.507,5,18,.278,7,14,.500,94,34,80,.425,25,51,.490,9,29,.310,10,11,.909,87
2099,OKC,2017-11-09,94,@,DEN,L 94-102,240,38,90,.422,27,60,.450,11,30,.367,7,14,.500,94,38,82,.463,29,55,.527,9,27,.333,17,22,.773,102
2100,SAC,2017-11-07,94,,OKC,W 94-86,240,37,79,.468,28,55,.509,9,24,.375,11,12,.917,94,29,86,.337,19,49,.388,10,37,.270,18,23,.783,86
2101,CHO,2017-11-05,94,@,MIN,L 94-112,240,37,89,.416,28,61,.459,9,28,.321,11,21,.524,94,38,83,.458,28,59,.475,10,24,.417,26,30,.867,112
2102,MIA,2017-11-03,94,@,DEN,L 94-95,240,36,77,.468,21,40,.525,15,37,.405,7,11,.636,94,36,80,.450,27,57,.474,9,23,.391,14,25,.560,95
2103,OKC,2017-11-03,94,,BOS,L 94-101,240,35,87,.402,22,52,.423,13,35,.371,11,14,.786,94,36,84,.429,23,56,.411,13,28,.464,16,24,.667,101
2104,DAL,2017-11-03,94,,NOP,L 94-99,240,34,88,.386,25,54,.463,9,34,.265,17,22,.773,94,36,89,.404,29,60,.483,7,29,.241,20,26,.769,99
2105,SAS,2017-10-30,94,@,BOS,L 94-108,240,36,87,.414,24,61,.393,12,26,.462,10,20,.500,94,42,88,.477,31,57,.544,11,31,.355,13,16,.813,108
2106,SAS,2017-10-29,94,@,IND,L 94-97,240,36,90,.400,27,62,.435,9,28,.321,13,18,.722,94,36,77,.468,26,55,.473,10,22,.455,15,20,.750,97
2107,MEM,2017-10-25,94,@,DAL,L 94-103,240,33,72,.458,21,41,.512,12,31,.387,16,24,.667,94,36,74,.486,25,48,.521,11,26,.423,20,29,.690,103
2108,CHO,2017-10-23,94,@,MIL,L 94-103,240,33,78,.423,26,52,.500,7,26,.269,21,36,.583,94,40,85,.471,31,59,.525,9,26,.346,14,16,.875,103
2109,PHI,2017-10-21,94,@,TOR,L 94-128,240,32,82,.390,24,58,.414,8,24,.333,22,36,.611,94,42,89,.472,29,45,.644,13,44,.295,31,37,.838,128
2110,UTA,2018-04-11,93,@,POR,L 93-102,240,33,89,.371,25,66,.379,8,23,.348,19,24,.792,93,41,89,.461,32,65,.492,9,24,.375,11,16,.688,102
2111,IND,2018-04-10,93,,CHO,L 93-119,240,40,99,.404,32,68,.471,8,31,.258,5,8,.625,93,46,99,.465,28,57,.491,18,42,.429,9,12,.750,119
2112,MIA,2018-04-09,93,,OKC,L 93-115,240,40,87,.460,35,65,.538,5,22,.227,8,14,.571,93,35,81,.432,21,46,.457,14,35,.400,31,38,.816,115
2113,MEM,2018-04-06,93,,SAC,L 93-94,240,37,84,.440,31,60,.517,6,24,.250,13,18,.722,93,40,85,.471,34,61,.557,6,24,.250,8,12,.667,94
2114,CHO,2018-03-31,93,@,WAS,L 93-107,240,35,77,.455,29,54,.537,6,23,.261,17,27,.630,93,40,88,.455,22,49,.449,18,39,.462,9,12,.750,107
2115,MIN,2018-03-30,93,@,DAL,W 93-92,240,35,83,.422,27,58,.466,8,25,.320,15,17,.882,93,38,86,.442,27,58,.466,11,28,.393,5,7,.714,92
2116,DAL,2018-03-28,93,@,LAL,L 93-103,240,33,84,.393,20,40,.500,13,44,.295,14,19,.737,93,36,77,.468,27,44,.614,9,33,.273,22,32,.688,103
2117,MIN,2018-03-26,93,,MEM,L 93-101,240,33,79,.418,25,55,.455,8,24,.333,19,24,.792,93,40,84,.476,25,53,.472,15,31,.484,6,9,.667,101
2118,SAC,2018-03-25,93,,BOS,L 93-104,240,38,82,.463,31,56,.554,7,26,.269,10,10,1.000,93,40,72,.556,28,50,.560,12,22,.545,12,17,.706,104
2119,MEM,2018-03-24,93,,LAL,L 93-100,240,35,84,.417,30,55,.545,5,29,.172,18,22,.818,93,35,86,.407,22,48,.458,13,38,.342,17,25,.680,100
2120,TOR,2018-03-20,93,@,ORL,W 93-86,240,35,77,.455,21,41,.512,14,36,.389,9,17,.529,93,37,90,.411,28,65,.431,9,25,.360,3,5,.600,86
2121,GSW,2018-03-16,93,,SAC,L 93-98,240,34,81,.420,22,55,.400,12,26,.462,13,18,.722,93,36,83,.434,22,52,.423,14,31,.452,12,17,.706,98
2122,NOP,2018-03-15,93,@,SAS,L 93-98,240,36,90,.400,30,74,.405,6,16,.375,15,16,.938,93,37,99,.374,30,73,.411,7,26,.269,17,19,.895,98
2123,SAS,2018-03-12,93,@,HOU,L 93-109,240,33,81,.407,22,53,.415,11,28,.393,16,23,.696,93,39,80,.488,26,36,.722,13,44,.295,18,23,.783,109
2124,ATL,2018-02-23,93,@,IND,L 93-116,240,37,82,.451,30,51,.588,7,31,.226,12,19,.632,93,48,101,.475,39,73,.534,9,28,.321,11,13,.846,116
2125,PHO,2018-02-06,93,@,LAL,L 93-112,240,36,94,.383,28,65,.431,8,29,.276,13,23,.565,93,39,83,.470,28,57,.491,11,26,.423,23,26,.885,112
2126,DAL,2018-01-26,93,,POR,L 93-107,240,35,89,.393,25,59,.424,10,30,.333,13,17,.765,93,39,79,.494,29,49,.592,10,30,.333,19,23,.826,107
2127,TOR,2018-01-26,93,,UTA,L 93-97,240,37,95,.389,30,68,.441,7,27,.259,12,17,.706,93,36,87,.414,26,66,.394,10,21,.476,15,21,.714,97
2128,ATL,2018-01-24,93,,TOR,L 93-108,240,37,94,.394,30,73,.411,7,21,.333,12,17,.706,93,39,89,.438,25,53,.472,14,36,.389,16,25,.640,108
2129,NOP,2018-01-17,93,@,ATL,L 93-94,240,35,80,.438,25,53,.472,10,27,.370,13,19,.684,93,37,89,.416,27,49,.551,10,40,.250,10,13,.769,94
2130,LAL,2018-01-11,93,,SAS,W 93-81,240,36,87,.414,23,49,.469,13,38,.342,8,14,.571,93,31,76,.408,23,56,.411,8,20,.400,11,15,.733,81
2131,DET,2017-12-30,93,,SAS,W 93-79,240,36,81,.444,28,57,.491,8,24,.333,13,16,.813,93,31,84,.369,26,58,.448,5,26,.192,12,13,.923,79
2132,TOR,2017-12-26,93,@,DAL,L 93-98,240,30,89,.337,21,58,.362,9,31,.290,24,32,.750,93,40,94,.426,34,70,.486,6,24,.250,12,16,.750,98
2133,BOS,2017-12-21,93,@,NYK,L 93-102,240,33,86,.384,20,48,.417,13,38,.342,14,19,.737,93,36,79,.456,28,65,.431,8,14,.571,22,26,.846,102
2134,DET,2017-12-20,93,@,DAL,L 93-110,240,33,77,.429,26,53,.491,7,24,.292,20,22,.909,93,40,75,.533,26,45,.578,14,30,.467,16,20,.800,110
2135,SAS,2017-12-20,93,@,POR,W 93-91,240,41,79,.519,35,62,.565,6,17,.353,5,6,.833,93,38,96,.396,32,71,.451,6,25,.240,9,14,.643,91
2136,SAC,2017-12-17,93,@,TOR,L 93-108,240,38,81,.469,27,55,.491,11,26,.423,6,8,.750,93,36,85,.424,23,55,.418,13,30,.433,23,28,.821,108
2137,POR,2017-12-16,93,@,CHO,W 93-91,240,37,79,.468,27,55,.491,10,24,.417,9,18,.500,93,33,96,.344,26,65,.400,7,31,.226,18,28,.643,91
2138,MEM,2017-12-16,93,,BOS,L 93-102,240,32,79,.405,18,45,.400,14,34,.412,15,17,.882,93,39,80,.488,25,50,.500,14,30,.467,10,14,.714,102
2139,WAS,2017-12-13,93,,MEM,W 93-87,240,36,77,.468,27,55,.491,9,22,.409,12,24,.500,93,31,81,.383,21,53,.396,10,28,.357,15,16,.938,87
2140,DET,2017-12-04,93,@,SAS,L 93-96,240,35,85,.412,27,58,.466,8,27,.296,15,24,.625,93,35,82,.427,21,51,.412,14,31,.452,12,12,1.000,96
2141,CHI,2017-11-26,93,,MIA,L 93-100,240,33,89,.371,19,56,.339,14,33,.424,13,16,.813,93,34,75,.453,21,43,.488,13,32,.406,19,23,.826,100
2142,MIA,2017-11-15,93,,WAS,L 93-102,240,32,78,.410,19,48,.396,13,30,.433,16,19,.842,93,32,78,.410,23,59,.390,9,19,.474,29,31,.935,102
2143,PHO,2017-11-13,93,,LAL,L 93-100,240,37,95,.389,30,69,.435,7,26,.269,12,20,.600,93,39,92,.424,25,59,.424,14,33,.424,8,13,.615,100
2144,DET,2017-10-31,93,@,LAL,L 93-113,240,41,94,.436,31,61,.508,10,33,.303,1,3,.333,93,45,91,.495,33,65,.508,12,26,.462,11,14,.786,113
2145,CHO,2017-10-27,93,,HOU,L 93-109,240,33,88,.375,22,59,.373,11,29,.379,16,28,.571,93,38,85,.447,16,28,.571,22,57,.386,11,13,.846,109
2146,DEN,2017-10-25,93,@,CHO,L 93-110,240,38,100,.380,30,69,.435,8,31,.258,9,15,.600,93,38,81,.469,25,50,.500,13,31,.419,21,26,.808,110
2147,NOP,2017-10-24,93,@,POR,L 93-103,240,30,76,.395,21,46,.457,9,30,.300,24,32,.750,93,33,88,.375,23,59,.390,10,29,.345,27,33,.818,103
2148,ATL,2017-10-23,93,@,MIA,L 93-104,240,36,76,.474,29,59,.492,7,17,.412,14,18,.778,93,39,85,.459,25,48,.521,14,37,.378,12,18,.667,104
2149,CLE,2017-10-21,93,,ORL,L 93-114,240,33,86,.384,26,61,.426,7,25,.280,20,27,.741,93,40,90,.444,23,55,.418,17,35,.486,17,20,.850,114
2150,SAC,2017-10-20,93,@,DAL,W 93-88,240,37,87,.425,27,64,.422,10,23,.435,9,13,.692,93,31,75,.413,20,42,.476,11,33,.333,15,21,.714,88
2151,WAS,2018-04-11,92,@,ORL,L 92-101,240,33,95,.347,23,61,.377,10,34,.294,16,27,.593,92,33,77,.429,20,45,.444,13,32,.406,22,27,.815,101
2152,TOR,2018-04-06,92,,IND,W 92-73,240,36,84,.429,27,54,.500,9,30,.300,11,16,.688,92,26,87,.299,19,66,.288,7,21,.333,14,20,.700,73
2153,DAL,2018-03-30,92,,MIN,L 92-93,240,38,86,.442,27,58,.466,11,28,.393,5,7,.714,92,35,83,.422,27,58,.466,8,25,.320,15,17,.882,93
2154,CHI,2018-03-29,92,@,MIA,L 92-103,240,33,90,.367,27,64,.422,6,26,.231,20,26,.769,92,37,82,.451,30,55,.545,7,27,.259,22,24,.917,103
2155,WAS,2018-03-29,92,@,DET,L 92-103,240,37,89,.416,31,57,.544,6,32,.188,12,15,.800,92,41,84,.488,35,63,.556,6,21,.286,15,20,.750,103
2156,IND,2018-03-27,92,@,GSW,W 92-81,240,39,81,.481,33,60,.550,6,21,.286,8,12,.667,92,35,86,.407,30,69,.435,5,17,.294,6,9,.667,81
2157,IND,2018-03-21,92,@,NOP,L 92-96,240,34,93,.366,27,71,.380,7,22,.318,17,18,.944,92,34,79,.430,26,56,.464,8,23,.348,20,24,.833,96
2158,CHI,2018-03-19,92,@,NYK,L 92-110,240,33,92,.359,30,62,.484,3,30,.100,23,31,.742,92,43,96,.448,32,61,.525,11,35,.314,13,17,.765,110
2159,MIA,2018-03-16,92,@,LAL,W 92-91,240,36,94,.383,26,58,.448,10,36,.278,10,14,.714,92,32,76,.421,23,57,.404,9,19,.474,18,22,.818,91
2160,BOS,2018-03-16,92,@,ORL,W 92-83,240,31,82,.378,22,56,.393,9,26,.346,21,28,.750,92,34,87,.391,29,59,.492,5,28,.179,10,11,.909,83
2161,IND,2018-03-05,92,,MIL,W 92-89,240,33,77,.429,23,60,.383,10,17,.588,16,21,.762,92,34,76,.447,27,53,.509,7,23,.304,14,16,.875,89
2162,LAC,2018-02-28,92,,HOU,L 92-105,240,36,79,.456,29,56,.518,7,23,.304,13,19,.684,92,36,85,.424,23,42,.548,13,43,.302,20,24,.833,105
2163,ATL,2018-02-13,92,@,MIL,L 92-97,240,33,86,.384,21,51,.412,12,35,.343,14,20,.700,92,38,88,.432,30,63,.476,8,25,.320,13,17,.765,97
2164,NYK,2018-02-12,92,@,PHI,L 92-108,240,31,79,.392,25,55,.455,6,24,.250,24,28,.857,92,41,75,.547,31,56,.554,10,19,.526,16,24,.667,108
2165,MEM,2018-02-11,92,@,OKC,L 92-110,240,32,82,.390,26,54,.481,6,28,.214,22,24,.917,92,34,77,.442,18,40,.450,16,37,.432,26,40,.650,110
2166,UTA,2018-02-07,92,@,MEM,W 92-88,240,29,69,.420,23,47,.489,6,22,.273,28,33,.848,92,34,81,.420,26,58,.448,8,23,.348,12,16,.750,88
2167,PHI,2018-02-03,92,@,IND,L 92-100,240,33,87,.379,23,55,.418,10,32,.313,16,24,.667,92,35,79,.443,26,52,.500,9,27,.333,21,25,.840,100
2168,MIL,2018-02-02,92,,NYK,W 92-90,240,33,76,.434,26,52,.500,7,24,.292,19,26,.731,92,36,89,.404,31,64,.484,5,25,.200,13,17,.765,90
2169,CHI,2017-12-27,92,,NYK,W 92-87,240,35,86,.407,25,58,.431,10,28,.357,12,16,.750,92,37,91,.407,33,68,.485,4,23,.174,9,13,.692,87
2170,CLE,2017-12-25,92,@,GSW,L 92-99,240,28,88,.318,13,52,.250,15,36,.417,21,25,.840,92,38,82,.463,28,45,.622,10,37,.270,13,17,.765,99
2171,CHI,2017-12-23,92,@,BOS,L 92-117,240,34,86,.395,27,67,.403,7,19,.368,17,25,.680,92,44,92,.478,32,60,.533,12,32,.375,17,21,.810,117
2172,LAL,2017-12-23,92,,POR,L 92-95,240,36,85,.424,28,60,.467,8,25,.320,12,20,.600,92,39,95,.411,29,70,.414,10,25,.400,7,14,.500,95
2173,PHO,2017-12-12,92,@,SAC,L 92-99,240,37,90,.411,30,58,.517,7,32,.219,11,14,.786,92,38,89,.427,31,67,.463,7,22,.318,16,22,.727,99
2174,DAL,2017-12-10,92,@,MIN,L 92-97,240,37,81,.457,26,50,.520,11,31,.355,7,9,.778,92,36,72,.500,29,53,.547,7,19,.368,18,23,.783,97
2175,POR,2017-12-05,92,,WAS,L 92-106,240,32,78,.410,20,51,.392,12,27,.444,16,21,.762,92,42,89,.472,31,64,.484,11,25,.440,11,14,.786,106
2176,MIN,2017-12-04,92,@,MEM,L 92-95,240,35,79,.443,31,62,.500,4,17,.235,18,19,.947,92,34,72,.472,28,51,.549,6,21,.286,21,24,.875,95
2177,WAS,2017-11-28,92,@,MIN,W 92-89,240,36,83,.434,26,55,.473,10,28,.357,10,17,.588,92,35,85,.412,25,55,.455,10,30,.333,9,14,.643,89
2178,MEM,2017-11-24,92,@,DEN,L 92-104,240,36,73,.493,27,49,.551,9,24,.375,11,16,.688,92,40,79,.506,31,47,.660,9,32,.281,15,26,.577,104
2179,MEM,2017-11-20,92,,POR,L 92-100,240,33,86,.384,25,56,.446,8,30,.267,18,23,.783,92,33,83,.398,27,68,.397,6,15,.400,28,32,.875,100
2180,BOS,2017-11-16,92,,GSW,W 92-88,240,26,79,.329,19,47,.404,7,32,.219,33,38,.868,92,33,82,.402,23,50,.460,10,32,.313,12,19,.632,88
2181,OKC,2017-11-15,92,,CHI,W 92-79,240,26,72,.361,18,42,.429,8,30,.267,32,37,.865,92,26,75,.347,15,46,.326,11,29,.379,16,20,.800,79
2182,SAC,2017-11-13,92,@,WAS,L 92-110,240,34,84,.405,22,61,.361,12,23,.522,12,18,.667,92,44,86,.512,33,52,.635,11,34,.324,11,12,.917,110
2183,PHO,2017-11-06,92,,BRK,L 92-98,240,30,86,.349,24,61,.393,6,25,.240,26,35,.743,92,35,87,.402,27,55,.491,8,32,.250,20,29,.690,98
2184,SAS,2017-11-02,92,,GSW,L 92-112,240,34,87,.391,27,63,.429,7,24,.292,17,23,.739,92,43,83,.518,29,55,.527,14,28,.500,12,16,.750,112
2185,LAL,2017-10-27,92,,TOR,L 92-101,240,36,79,.456,33,56,.589,3,23,.130,17,24,.708,92,40,93,.430,33,64,.516,7,29,.241,14,20,.700,101
2186,PHI,2017-10-20,92,,BOS,L 92-102,240,35,92,.380,25,60,.417,10,32,.313,12,16,.750,92,35,84,.417,25,55,.455,10,29,.345,22,32,.688,102
2187,LAL,2017-10-19,92,,LAC,L 92-108,240,37,91,.407,33,75,.440,4,16,.250,14,23,.609,92,42,107,.393,30,74,.405,12,33,.364,12,13,.923,108
2188,ATL,2018-03-30,91,,PHI,L 91-101,240,36,101,.356,27,62,.435,9,39,.231,10,15,.667,91,42,95,.442,34,57,.596,8,38,.211,9,13,.692,101
2189,GSW,2018-03-25,91,,UTA,L 91-110,240,38,91,.418,32,76,.421,6,15,.400,9,10,.900,91,42,87,.483,30,59,.508,12,28,.429,14,18,.778,110
2190,NOP,2018-03-24,91,@,HOU,L 91-114,240,38,96,.396,32,75,.427,6,21,.286,9,12,.750,91,45,93,.484,27,46,.587,18,47,.383,6,8,.750,114
2191,LAL,2018-03-16,91,,MIA,L 91-92,240,32,76,.421,23,57,.404,9,19,.474,18,22,.818,91,36,94,.383,26,58,.448,10,36,.278,10,14,.714,92
2192,SAC,2018-03-03,91,,UTA,L 91-98,240,34,89,.382,25,59,.424,9,30,.300,14,17,.824,91,34,82,.415,23,50,.460,11,32,.344,19,29,.655,98
2193,SAC,2018-02-14,91,@,HOU,L 91-100,240,38,87,.437,28,55,.509,10,32,.313,5,8,.625,91,33,83,.398,19,34,.559,14,49,.286,20,22,.909,100
2194,MIA,2018-02-09,91,,MIL,W 91-85,240,32,88,.364,22,62,.355,10,26,.385,17,18,.944,91,32,76,.421,26,56,.464,6,20,.300,15,17,.882,85
2195,BOS,2018-02-09,91,,IND,L 91-97,240,34,89,.382,27,62,.435,7,27,.259,16,20,.800,91,37,83,.446,32,63,.508,5,20,.250,18,22,.818,97
2196,BOS,2018-02-06,91,@,TOR,L 91-111,240,33,83,.398,23,60,.383,10,23,.435,15,20,.750,91,40,80,.500,23,44,.523,17,36,.472,14,17,.824,111
2197,POR,2018-02-05,91,@,DET,L 91-111,240,37,94,.394,27,61,.443,10,33,.303,7,8,.875,91,44,88,.500,29,58,.500,15,30,.500,8,12,.667,111
2198,SAS,2018-02-01,91,,HOU,L 91-102,240,35,83,.422,29,59,.492,6,24,.250,15,17,.882,91,37,83,.446,23,41,.561,14,42,.333,14,17,.824,102
2199,CLE,2018-01-31,91,,MIA,W 91-89,240,28,80,.350,22,54,.407,6,26,.231,29,38,.763,91,36,83,.434,33,55,.600,3,28,.107,14,25,.560,89
2200,CHO,2018-01-27,91,@,MIA,L 91-95,240,29,84,.345,24,60,.400,5,24,.208,28,35,.800,91,38,85,.447,30,59,.508,8,26,.308,11,18,.611,95
2201,DEN,2018-01-27,91,,DAL,W 91-89,240,34,81,.420,22,48,.458,12,33,.364,11,15,.733,91,34,85,.400,23,54,.426,11,31,.355,10,19,.526,89
2202,BRK,2018-01-26,91,@,MIL,L 91-116,240,33,89,.371,25,55,.455,8,34,.235,17,20,.850,91,43,83,.518,31,60,.517,12,23,.522,18,20,.900,116
2203,DET,2018-01-17,91,@,TOR,L 91-96,240,37,88,.420,27,60,.450,10,28,.357,7,15,.467,91,34,80,.425,23,49,.469,11,31,.355,17,23,.739,96
2204,CHO,2018-01-13,91,,OKC,L 91-101,240,33,83,.398,24,55,.436,9,28,.321,16,23,.696,91,39,97,.402,31,71,.437,8,26,.308,15,20,.750,101
2205,UTA,2018-01-05,91,@,DEN,L 91-99,240,38,84,.452,26,51,.510,12,33,.364,3,6,.500,91,38,86,.442,24,51,.471,14,35,.400,9,15,.600,99
2206,BOS,2018-01-05,91,,MIN,W 91-84,240,38,94,.404,32,58,.552,6,36,.167,9,13,.692,91,28,76,.368,21,53,.396,7,23,.304,21,28,.750,84
2207,NYK,2018-01-02,91,,SAS,L 91-100,240,35,87,.402,28,65,.431,7,22,.318,14,18,.778,91,31,82,.378,21,55,.382,10,27,.370,28,34,.824,100
2208,CHO,2017-12-27,91,,BOS,L 91-102,240,32,87,.368,25,64,.391,7,23,.304,20,29,.690,91,37,78,.474,22,44,.500,15,34,.441,13,13,1.000,102
2209,POR,2017-12-20,91,,SAS,L 91-93,240,38,96,.396,32,71,.451,6,25,.240,9,14,.643,91,41,79,.519,35,62,.565,6,17,.353,5,6,.833,93
2210,LAC,2017-12-18,91,@,SAS,L 91-109,240,37,84,.440,28,55,.509,9,29,.310,8,16,.500,91,40,82,.488,31,58,.534,9,24,.375,20,25,.800,109
2211,DAL,2017-12-18,91,,PHO,L 91-97,240,32,88,.364,21,51,.412,11,37,.297,16,17,.941,91,35,79,.443,25,54,.463,10,25,.400,17,22,.773,97
2212,NYK,2017-12-18,91,@,CHO,L 91-109,240,36,86,.419,33,68,.485,3,18,.167,16,20,.800,91,43,88,.489,34,68,.500,9,20,.450,14,16,.875,109
2213,CHO,2017-12-16,91,,POR,L 91-93,240,33,96,.344,26,65,.400,7,31,.226,18,28,.643,91,37,79,.468,27,55,.491,10,24,.417,9,18,.500,93
2214,LAC,2017-12-15,91,@,WAS,L 91-100,240,33,86,.384,26,62,.419,7,24,.292,18,29,.621,91,39,88,.443,32,57,.561,7,31,.226,15,23,.652,100
2215,ATL,2017-12-14,91,,DET,L 91-105,240,32,70,.457,21,39,.538,11,31,.355,16,26,.615,91,41,90,.456,28,60,.467,13,30,.433,10,12,.833,105
2216,TOR,2017-12-11,91,@,LAC,L 91-96,240,32,80,.400,25,51,.490,7,29,.241,20,26,.769,91,34,92,.370,26,56,.464,8,36,.222,20,24,.833,96
2217,BOS,2017-12-10,91,@,DET,W 91-81,240,33,79,.418,22,49,.449,11,30,.367,14,18,.778,91,28,84,.333,18,51,.353,10,33,.303,15,19,.789,81
2218,CHI,2017-12-04,91,,CLE,L 91-113,240,34,82,.415,25,48,.521,9,34,.265,14,18,.778,91,42,81,.519,29,45,.644,13,36,.361,16,17,.941,113
2219,DET,2017-12-01,91,@,WAS,L 91-109,240,35,79,.443,26,49,.531,9,30,.300,12,19,.632,91,43,89,.483,36,68,.529,7,21,.333,16,19,.842,109
2220,POR,2017-11-30,91,,MIL,L 91-103,240,35,83,.422,29,60,.483,6,23,.261,15,17,.882,91,42,87,.483,36,67,.537,6,20,.300,13,15,.867,103
2221,NYK,2017-11-27,91,,POR,L 91-103,240,35,88,.398,30,73,.411,5,15,.333,16,22,.727,91,37,83,.446,30,62,.484,7,21,.333,22,26,.846,103
2222,PHI,2017-11-27,91,,CLE,L 91-113,240,36,96,.375,33,68,.485,3,28,.107,16,20,.800,91,41,86,.477,26,49,.531,15,37,.405,16,20,.800,113
2223,PHO,2017-11-24,91,,NOP,L 91-115,240,37,94,.394,35,74,.473,2,20,.100,15,18,.833,91,45,91,.495,36,64,.563,9,27,.333,16,22,.727,115
2224,GSW,2017-11-22,91,@,OKC,L 91-108,240,33,80,.413,23,49,.469,10,31,.323,15,18,.833,91,41,90,.456,33,65,.508,8,25,.320,18,26,.692,108
2225,WAS,2017-11-19,91,@,TOR,L 91-100,240,34,81,.420,23,62,.371,11,19,.579,12,21,.571,91,40,90,.444,30,51,.588,10,39,.256,10,14,.714,100
2226,MIA,2017-11-17,91,@,WAS,W 91-88,240,34,83,.410,24,48,.500,10,35,.286,13,18,.722,91,32,84,.381,22,49,.449,10,35,.286,14,16,.875,88
2227,DAL,2017-11-14,91,,SAS,L 91-97,240,33,81,.407,23,47,.489,10,34,.294,15,18,.833,91,35,79,.443,29,53,.547,6,26,.231,21,27,.778,97
2228,SAC,2017-11-11,91,@,NYK,L 91-118,240,30,80,.375,23,58,.397,7,22,.318,24,30,.800,91,47,90,.522,35,63,.556,12,27,.444,12,15,.800,118
2229,CHI,2017-11-01,91,@,MIA,L 91-97,240,36,89,.404,29,61,.475,7,28,.250,12,19,.632,91,34,83,.410,22,52,.423,12,31,.387,17,19,.895,97
2230,MIL,2017-10-31,91,,OKC,L 91-110,240,32,77,.416,23,46,.500,9,31,.290,18,22,.818,91,40,81,.494,28,53,.528,12,28,.429,18,21,.857,110
2231,DAL,2017-10-26,91,@,MEM,L 91-96,240,32,94,.340,22,60,.367,10,34,.294,17,20,.850,91,30,73,.411,20,39,.513,10,34,.294,26,30,.867,96
2232,CHI,2017-10-26,91,,ATL,W 91-86,240,31,86,.360,24,54,.444,7,32,.219,22,29,.759,91,32,81,.395,21,53,.396,11,28,.393,11,13,.846,86
2233,DAL,2017-10-21,91,@,HOU,L 91-107,240,31,84,.369,18,53,.340,13,31,.419,16,21,.762,91,39,82,.476,28,35,.800,11,47,.234,18,22,.818,107
2234,ATL,2017-10-20,91,@,CHO,L 91-109,240,36,95,.379,29,65,.446,7,30,.233,12,14,.857,91,37,86,.430,26,50,.520,11,36,.306,24,30,.800,109
2235,NOP,2017-10-18,91,@,MEM,L 91-103,240,30,79,.380,23,54,.426,7,25,.280,24,29,.828,91,39,92,.424,30,63,.476,9,29,.310,16,28,.571,103
2236,CHI,2018-03-30,90,@,ORL,W 90-82,240,30,84,.357,16,43,.372,14,41,.341,16,23,.696,90,31,94,.330,24,55,.436,7,39,.179,13,14,.929,82
2237,ATL,2018-03-22,90,@,SAC,L 90-105,240,33,84,.393,21,48,.438,12,36,.333,12,18,.667,90,43,93,.462,33,72,.458,10,21,.476,9,9,1.000,105
2238,WAS,2018-03-21,90,@,SAS,L 90-98,240,35,83,.422,27,58,.466,8,25,.320,12,16,.750,90,39,79,.494,32,56,.571,7,23,.304,13,18,.722,98
2239,SAC,2018-03-19,90,,DET,L 90-106,240,40,88,.455,34,65,.523,6,23,.261,4,9,.444,90,37,79,.468,23,50,.460,14,29,.483,18,22,.818,106
2240,ATL,2018-03-06,90,@,TOR,L 90-106,240,34,80,.425,28,59,.475,6,21,.286,16,21,.762,90,34,88,.386,24,52,.462,10,36,.278,28,33,.848,106
2241,DET,2018-03-05,90,@,CLE,L 90-112,240,34,87,.391,22,53,.415,12,34,.353,10,15,.667,90,43,88,.489,31,55,.564,12,33,.364,14,17,.824,112
2242,DAL,2018-02-24,90,@,UTA,L 90-97,240,34,83,.410,24,48,.500,10,35,.286,12,14,.857,90,34,85,.400,25,53,.472,9,32,.281,20,26,.769,97
2243,CHI,2018-02-10,90,,WAS,L 90-101,240,34,80,.425,25,48,.521,9,32,.281,13,16,.813,90,38,82,.463,25,44,.568,13,38,.342,12,14,.857,101
2244,NYK,2018-02-02,90,@,MIL,L 90-92,240,36,89,.404,31,64,.484,5,25,.200,13,17,.765,90,33,76,.434,26,52,.500,7,24,.292,19,26,.731,92
2245,MIA,2018-01-22,90,@,HOU,L 90-99,240,39,82,.476,32,52,.615,7,30,.233,5,9,.556,90,36,81,.444,21,44,.477,15,37,.405,12,18,.667,99
2246,UTA,2018-01-22,90,@,ATL,L 90-104,240,33,76,.434,29,61,.475,4,15,.267,20,28,.714,90,40,83,.482,28,57,.491,12,26,.462,12,12,1.000,104
2247,LAL,2018-01-17,90,@,OKC,L 90-114,240,38,81,.469,28,55,.509,10,26,.385,4,4,1.000,90,46,95,.484,34,60,.567,12,35,.343,10,12,.833,114
2248,MIA,2018-01-09,90,@,TOR,W 90-89,240,39,97,.402,35,75,.467,4,22,.182,8,10,.800,90,35,90,.389,28,69,.406,7,21,.333,12,15,.800,89
2249,IND,2017-12-31,90,,MIN,L 90-107,240,33,85,.388,23,60,.383,10,25,.400,14,18,.778,90,41,86,.477,37,67,.552,4,19,.211,21,25,.840,107
2250,MIA,2017-12-20,90,@,BOS,W 90-89,240,33,75,.440,23,47,.489,10,28,.357,14,25,.560,90,30,80,.375,17,48,.354,13,32,.406,16,21,.762,89
2251,MIA,2017-12-16,90,,LAC,W 90-85,240,31,82,.378,19,47,.404,12,35,.343,16,21,.762,90,35,80,.438,27,52,.519,8,28,.286,7,14,.500,85
2252,DAL,2017-12-06,90,@,BOS,L 90-97,240,34,86,.395,25,58,.431,9,28,.321,13,17,.765,90,36,87,.414,24,53,.453,12,34,.353,13,17,.765,97
2253,ATL,2017-12-04,90,,BRK,L 90-110,240,30,82,.366,21,52,.404,9,30,.300,21,27,.778,90,41,85,.482,26,49,.531,15,36,.417,13,15,.867,110
2254,OKC,2017-12-03,90,,SAS,W 90-87,240,37,87,.425,31,65,.477,6,22,.273,10,21,.476,90,31,76,.408,23,48,.479,8,28,.286,17,23,.739,87
2255,SAS,2017-11-22,90,@,NOP,L 90-107,240,35,88,.398,29,64,.453,6,24,.250,14,15,.933,90,39,81,.481,32,57,.561,7,24,.292,22,24,.917,107
2256,SAC,2017-11-18,90,@,POR,L 90-102,240,34,89,.382,26,72,.361,8,17,.471,14,18,.778,90,38,70,.543,28,49,.571,10,21,.476,16,21,.762,102
2257,LAL,2017-11-11,90,@,MIL,L 90-98,240,31,74,.419,25,52,.481,6,22,.273,22,37,.595,90,35,85,.412,29,62,.468,6,23,.261,22,26,.846,98
2258,BOS,2017-11-10,90,,CHO,W 90-87,240,30,84,.357,21,53,.396,9,31,.290,21,25,.840,90,31,80,.388,25,58,.431,6,22,.273,19,33,.576,87
2259,CHI,2017-11-04,90,,NOP,L 90-96 (OT),265,35,99,.354,24,57,.421,11,42,.262,9,12,.750,90,35,87,.402,26,56,.464,9,31,.290,17,22,.773,96
2260,MIA,2017-10-28,90,,BOS,L 90-96,240,34,79,.430,27,48,.563,7,31,.226,15,16,.938,90,34,81,.420,28,58,.483,6,23,.261,22,26,.846,96
2261,HOU,2017-10-23,90,,MEM,L 90-98,240,32,77,.416,23,39,.590,9,38,.237,17,23,.739,90,29,68,.426,23,49,.469,6,19,.316,34,37,.919,98
2262,CHO,2017-10-18,90,@,DET,L 90-102,240,29,73,.397,20,43,.465,9,30,.300,23,29,.793,90,41,96,.427,32,70,.457,9,26,.346,11,12,.917,102
2263,SAS,2018-03-19,89,,GSW,W 89-75,240,33,82,.402,25,59,.424,8,23,.348,15,21,.714,89,30,74,.405,27,55,.491,3,19,.158,12,16,.750,75
2264,BOS,2018-03-18,89,@,NOP,L 89-108,240,35,87,.402,26,61,.426,9,26,.346,10,20,.500,89,41,82,.500,35,64,.547,6,18,.333,20,25,.800,108
2265,MIL,2018-03-05,89,@,IND,L 89-92,240,34,76,.447,27,53,.509,7,23,.304,14,16,.875,89,33,77,.429,23,60,.383,10,17,.588,16,21,.762,92
2266,CHI,2018-03-05,89,,BOS,L 89-105,240,32,81,.395,20,48,.417,12,33,.364,13,20,.650,89,41,84,.488,29,48,.604,12,36,.333,11,12,.917,105
2267,MEM,2018-02-24,89,@,MIA,L 89-115,240,35,80,.438,30,69,.435,5,11,.455,14,17,.824,89,41,89,.461,29,56,.518,12,33,.364,21,27,.778,115
2268,MEM,2018-02-23,89,,CLE,L 89-112,240,33,84,.393,24,60,.400,9,24,.375,14,18,.778,89,40,87,.460,29,58,.500,11,29,.379,21,22,.955,112
2269,NYK,2018-02-06,89,,MIL,L 89-103,240,37,89,.416,32,66,.485,5,23,.217,10,15,.667,89,37,82,.451,29,56,.518,8,26,.308,21,27,.778,103
2270,MIL,2018-02-01,89,@,MIN,L 89-108,240,32,85,.376,26,56,.464,6,29,.207,19,25,.760,89,42,78,.538,35,59,.593,7,19,.368,17,20,.850,108
2271,MIA,2018-01-31,89,@,CLE,L 89-91,240,36,83,.434,33,55,.600,3,28,.107,14,25,.560,89,28,80,.350,22,54,.407,6,26,.231,29,38,.763,91
2272,DAL,2018-01-27,89,@,DEN,L 89-91,240,34,85,.400,23,54,.426,11,31,.355,10,19,.526,89,34,81,.420,22,48,.458,12,33,.364,11,15,.733,91
2273,SAC,2018-01-25,89,@,MIA,W 89-88,240,38,81,.469,33,69,.478,5,12,.417,8,14,.571,89,31,82,.378,19,48,.396,12,34,.353,14,18,.778,88
2274,PHI,2018-01-18,89,@,BOS,W 89-80,240,34,73,.466,28,56,.500,6,17,.353,15,17,.882,89,30,74,.405,23,45,.511,7,29,.241,13,17,.765,80
2275,TOR,2018-01-09,89,,MIA,L 89-90,240,35,90,.389,28,69,.406,7,21,.333,12,15,.800,89,39,97,.402,35,75,.467,4,22,.182,8,10,.800,90
2276,PHO,2018-01-05,89,@,SAS,L 89-103,240,35,83,.422,28,53,.528,7,30,.233,12,18,.667,89,41,87,.471,30,57,.526,11,30,.367,10,18,.556,103
2277,ATL,2018-01-05,89,@,POR,L 89-110,240,30,83,.361,22,57,.386,8,26,.308,21,25,.840,89,43,80,.538,30,50,.600,13,30,.433,11,14,.786,110
2278,POR,2017-12-30,89,@,ATL,L 89-104,240,36,85,.424,29,60,.483,7,25,.280,10,13,.769,89,40,89,.449,26,59,.441,14,30,.467,10,15,.667,104
2279,DET,2017-12-28,89,@,ORL,L 89-102,240,35,87,.402,26,64,.406,9,23,.391,10,14,.714,89,37,82,.451,26,56,.464,11,26,.423,17,17,1.000,102
2280,ORL,2017-12-26,89,@,MIA,L 89-107,240,33,81,.407,28,61,.459,5,20,.250,18,22,.818,89,41,91,.451,30,58,.517,11,33,.333,14,17,.824,107
2281,UTA,2017-12-23,89,,OKC,L 89-103,240,33,72,.458,27,46,.587,6,26,.231,17,20,.850,89,39,88,.443,27,59,.458,12,29,.414,13,16,.813,103
2282,SAS,2017-12-21,89,@,UTA,L 89-100,240,34,78,.436,24,57,.421,10,21,.476,11,16,.688,89,34,74,.459,22,48,.458,12,26,.462,20,24,.833,100
2283,BOS,2017-12-20,89,,MIA,L 89-90,240,30,80,.375,17,48,.354,13,32,.406,16,21,.762,89,33,75,.440,23,47,.489,10,28,.357,14,25,.560,90
2284,SAS,2017-12-12,89,@,DAL,L 89-95,240,35,87,.402,28,59,.475,7,28,.250,12,19,.632,89,38,89,.427,29,65,.446,9,24,.375,10,12,.833,95
2285,BRK,2017-12-09,89,,MIA,L 89-101,240,33,81,.407,26,54,.481,7,27,.259,16,19,.842,89,42,90,.467,34,63,.540,8,27,.296,9,14,.643,101
2286,ORL,2017-12-08,89,,DEN,L 89-103,240,33,83,.398,28,62,.452,5,21,.238,18,23,.783,89,42,85,.494,36,64,.563,6,21,.286,13,16,.813,103
2287,MIN,2017-11-28,89,,WAS,L 89-92,240,35,85,.412,25,55,.455,10,30,.333,9,14,.643,89,36,83,.434,26,55,.473,10,28,.357,10,17,.588,92
2288,DAL,2017-10-30,89,@,UTA,L 89-104,240,34,76,.447,22,52,.423,12,24,.500,9,11,.818,89,38,81,.469,22,46,.478,16,35,.457,12,15,.800,104
2289,HOU,2017-10-28,89,@,MEM,L 89-103,240,29,77,.377,15,39,.385,14,38,.368,17,21,.810,89,40,85,.471,26,52,.500,14,33,.424,9,12,.750,103
2290,MIL,2017-10-26,89,,BOS,L 89-96,240,35,77,.455,24,52,.462,11,25,.440,8,14,.571,89,33,78,.423,22,48,.458,11,30,.367,19,22,.864,96
2291,NYK,2017-10-24,89,@,BOS,L 89-110,240,36,85,.424,35,73,.479,1,12,.083,16,25,.640,89,37,75,.493,23,46,.500,14,29,.483,22,27,.815,110
2292,DEN,2018-04-09,88,,POR,W 88-82,240,31,83,.373,25,57,.439,6,26,.231,20,26,.769,88,31,94,.330,24,61,.393,7,33,.212,13,18,.722,82
2293,ORL,2018-04-01,88,@,ATL,L 88-94,240,33,96,.344,23,60,.383,10,36,.278,12,13,.923,88,41,85,.482,30,49,.612,11,36,.306,1,1,1.000,94
2294,PHO,2018-03-20,88,,DET,L 88-115,240,34,90,.378,27,56,.482,7,34,.206,13,20,.650,88,43,97,.443,28,61,.459,15,36,.417,14,16,.875,115
2295,PHO,2018-03-15,88,@,UTA,L 88-116,240,32,83,.386,25,67,.373,7,16,.438,17,24,.708,88,42,97,.433,30,61,.492,12,36,.333,20,32,.625,116
2296,ORL,2018-03-09,88,@,SAC,L 88-94,240,33,78,.423,24,49,.490,9,29,.310,13,16,.813,88,36,83,.434,27,58,.466,9,25,.360,13,15,.867,94
2297,NYK,2018-02-08,88,@,TOR,L 88-113,240,33,83,.398,26,56,.464,7,27,.259,15,18,.833,88,43,95,.453,27,52,.519,16,43,.372,11,14,.786,113
2298,MEM,2018-02-07,88,,UTA,L 88-92,240,34,81,.420,26,58,.448,8,23,.348,12,16,.750,88,29,69,.420,23,47,.489,6,22,.273,28,33,.848,92
2299,CLE,2018-02-03,88,,HOU,L 88-120,240,34,87,.391,26,57,.456,8,30,.267,12,16,.750,88,44,93,.473,25,42,.595,19,51,.373,13,16,.813,120
2300,DAL,2018-01-31,88,@,PHO,L 88-102,240,32,88,.364,22,52,.423,10,36,.278,14,26,.538,88,40,83,.482,29,53,.547,11,30,.367,11,15,.733,102
2301,DAL,2018-01-29,88,,MIA,L 88-95,240,33,86,.384,25,57,.439,8,29,.276,14,16,.875,88,34,75,.453,22,44,.500,12,31,.387,15,19,.789,95
2302,MIA,2018-01-25,88,,SAC,L 88-89,240,31,82,.378,19,48,.396,12,34,.353,14,18,.778,88,38,81,.469,33,69,.478,5,12,.417,8,14,.571,89
2303,SAC,2018-01-19,88,@,MEM,L 88-106,240,32,80,.400,21,53,.396,11,27,.407,13,18,.722,88,39,88,.443,29,54,.537,10,34,.294,18,23,.783,106
2304,SAC,2018-01-15,88,@,OKC,L 88-95,240,33,84,.393,26,54,.481,7,30,.233,15,25,.600,88,36,86,.419,27,56,.482,9,30,.300,14,29,.483,95
2305,UTA,2018-01-12,88,@,CHO,L 88-99,240,28,77,.364,16,42,.381,12,35,.343,20,23,.870,88,32,78,.410,23,51,.451,9,27,.333,26,34,.765,99
2306,OKC,2018-01-10,88,@,MIN,L 88-104,240,32,80,.400,26,55,.473,6,25,.240,18,24,.750,88,39,80,.488,32,60,.533,7,20,.350,19,27,.704,104
2307,CLE,2018-01-03,88,@,BOS,L 88-102,240,31,89,.348,23,57,.404,8,32,.250,18,18,1.000,88,41,92,.446,29,56,.518,12,36,.333,8,11,.727,102
2308,ORL,2017-12-15,88,,POR,L 88-95,240,32,84,.381,22,55,.400,10,29,.345,14,19,.737,88,37,86,.430,29,68,.426,8,18,.444,13,15,.867,95
2309,MEM,2017-12-06,88,@,NYK,L 88-99,240,29,70,.414,17,42,.405,12,28,.429,18,22,.818,88,35,67,.522,26,53,.491,9,14,.643,20,27,.741,99
2310,MEM,2017-11-26,88,,BRK,L 88-98,240,32,80,.400,24,55,.436,8,25,.320,16,18,.889,88,33,74,.446,20,45,.444,13,29,.448,19,23,.826,98
2311,MIL,2017-11-20,88,,WAS,L 88-99,240,35,79,.443,31,57,.544,4,22,.182,14,19,.737,88,39,74,.527,30,50,.600,9,24,.375,12,17,.706,99
2312,DET,2017-11-20,88,,CLE,L 88-116,240,34,77,.442,21,47,.447,13,30,.433,7,13,.538,88,42,80,.525,26,47,.553,16,33,.485,16,17,.941,116
2313,WAS,2017-11-17,88,,MIA,L 88-91,240,32,84,.381,22,49,.449,10,35,.286,14,16,.875,88,34,83,.410,24,48,.500,10,35,.286,13,18,.722,91
2314,GSW,2017-11-16,88,@,BOS,L 88-92,240,33,82,.402,23,50,.460,10,32,.313,12,19,.632,88,26,79,.329,19,47,.404,7,32,.219,33,38,.868,92
2315,ORL,2017-11-05,88,,BOS,L 88-104,240,33,91,.363,27,62,.435,6,29,.207,16,18,.889,88,39,89,.438,28,56,.500,11,33,.333,15,20,.750,104
2316,UTA,2017-10-25,88,@,PHO,L 88-97,240,32,77,.416,26,52,.500,6,25,.240,18,25,.720,88,42,96,.438,36,77,.468,6,19,.316,7,9,.778,97
2317,PHO,2017-10-21,88,@,LAC,L 88-130,240,27,71,.380,21,47,.447,6,24,.250,28,38,.737,88,48,88,.545,36,62,.581,12,26,.462,22,30,.733,130
2318,DAL,2017-10-20,88,,SAC,L 88-93,240,31,75,.413,20,42,.476,11,33,.333,15,21,.714,88,37,87,.425,27,64,.422,10,23,.435,9,13,.692,93
2319,CHI,2018-04-11,87,,DET,L 87-119,240,32,86,.372,21,52,.404,11,34,.324,12,18,.667,87,47,89,.528,32,54,.593,15,35,.429,10,10,1.000,119
2320,DAL,2018-04-01,87,@,CLE,L 87-98,240,32,79,.405,19,42,.452,13,37,.351,10,11,.909,87,35,85,.412,24,59,.407,11,26,.423,17,23,.739,98
2321,DET,2018-03-17,87,@,POR,L 87-100,240,31,80,.388,21,55,.382,10,25,.400,15,20,.750,87,38,87,.437,30,56,.536,8,31,.258,16,18,.889,100
2322,ATL,2018-03-09,87,@,IND,L 87-112,240,34,82,.415,24,49,.490,10,33,.303,9,10,.900,87,45,91,.495,31,63,.492,14,28,.500,8,10,.800,112
2323,PHO,2018-03-08,87,@,OKC,L 87-115,240,31,92,.337,22,55,.400,9,37,.243,16,18,.889,87,42,80,.525,29,47,.617,13,33,.394,18,27,.667,115
2324,NYK,2018-03-06,87,@,POR,L 87-111,240,35,83,.422,28,64,.438,7,19,.368,10,15,.667,87,35,81,.432,15,48,.313,20,33,.606,21,24,.875,111
2325,MIL,2018-02-28,87,@,DET,L 87-110,240,28,73,.384,20,49,.408,8,24,.333,23,28,.821,87,42,95,.442,33,66,.500,9,29,.310,17,22,.773,110
2326,CHI,2018-02-26,87,@,BRK,L 87-104,240,33,93,.355,27,70,.386,6,23,.261,15,23,.652,87,40,90,.444,24,48,.500,16,42,.381,8,8,1.000,104
2327,DEN,2018-01-12,87,,MEM,W 87-78,240,27,70,.386,20,48,.417,7,22,.318,26,32,.813,87,30,77,.390,23,53,.434,7,24,.292,11,14,.786,78
2328,BOS,2018-01-06,87,@,BRK,W 87-85,240,37,98,.378,32,80,.400,5,18,.278,8,15,.533,87,30,91,.330,24,60,.400,6,31,.194,19,22,.864,85
2329,MIA,2017-12-29,87,,BRK,L 87-111,240,30,89,.337,27,63,.429,3,26,.115,24,31,.774,87,39,79,.494,28,53,.528,11,26,.423,22,25,.880,111
2330,NYK,2017-12-27,87,@,CHI,L 87-92,240,37,91,.407,33,68,.485,4,23,.174,9,13,.692,87,35,86,.407,25,58,.431,10,28,.357,12,16,.750,92
2331,BRK,2017-12-15,87,@,TOR,L 87-120,240,32,76,.421,25,53,.472,7,23,.304,16,19,.842,87,54,97,.557,47,69,.681,7,28,.250,5,9,.556,120
2332,MEM,2017-12-13,87,@,WAS,L 87-93,240,31,81,.383,21,53,.396,10,28,.357,15,16,.938,87,36,77,.468,27,55,.491,9,22,.409,12,24,.500,93
2333,SAC,2017-12-10,87,,TOR,L 87-102,240,35,73,.479,25,50,.500,10,23,.435,7,14,.500,87,39,87,.448,28,50,.560,11,37,.297,13,19,.684,102
2334,CHO,2017-12-06,87,,GSW,L 87-101,240,34,97,.351,28,78,.359,6,19,.316,13,17,.765,87,40,84,.476,29,54,.537,11,30,.367,10,13,.769,101
2335,SAS,2017-12-03,87,@,OKC,L 87-90,240,31,76,.408,23,48,.479,8,28,.286,17,23,.739,87,37,87,.425,31,65,.477,6,22,.273,10,21,.476,90
2336,SAC,2017-11-28,87,,MIL,L 87-112,240,31,77,.403,26,60,.433,5,17,.294,20,29,.690,87,42,71,.592,33,49,.673,9,22,.409,19,31,.613,112
2337,LAC,2017-11-18,87,@,CHO,L 87-102,240,33,83,.398,25,54,.463,8,29,.276,13,19,.684,87,34,87,.391,23,61,.377,11,26,.423,23,29,.793,102
2338,DAL,2017-11-17,87,,MIN,L 87-111,240,32,86,.372,24,48,.500,8,38,.211,15,17,.882,87,39,84,.464,26,54,.481,13,30,.433,20,23,.870,111
2339,SAS,2017-11-10,87,,MIL,L 87-94,240,34,80,.425,25,51,.490,9,29,.310,10,11,.909,87,41,89,.461,36,71,.507,5,18,.278,7,14,.500,94
2340,CHI,2017-11-10,87,,IND,L 87-105,240,37,93,.398,30,66,.455,7,27,.259,6,9,.667,87,43,84,.512,31,55,.564,12,29,.414,7,12,.583,105
2341,CHO,2017-11-10,87,@,BOS,L 87-90,240,31,80,.388,25,58,.431,6,22,.273,19,33,.576,87,30,84,.357,21,53,.396,9,31,.290,21,25,.840,90
2342,LAC,2017-10-28,87,,DET,L 87-95,240,28,84,.333,13,46,.283,15,38,.395,16,22,.727,87,36,88,.409,27,60,.450,9,28,.321,14,21,.667,95
2343,SAS,2017-10-27,87,@,ORL,L 87-114,240,30,89,.337,26,65,.400,4,24,.167,23,27,.852,87,48,84,.571,37,61,.607,11,23,.478,7,14,.500,114
2344,OKC,2017-10-21,87,@,UTA,L 87-96,240,32,78,.410,21,45,.467,11,33,.333,12,19,.632,87,38,77,.494,29,48,.604,9,29,.310,11,14,.786,96
2345,SAS,2017-10-21,87,@,CHI,W 87-77,240,38,93,.409,37,81,.457,1,12,.083,10,16,.625,87,31,82,.378,23,54,.426,8,28,.286,7,9,.778,77
2346,ORL,2018-04-09,86,@,MIL,L 86-102,240,34,82,.415,29,58,.500,5,24,.208,13,20,.650,86,39,91,.429,30,65,.462,9,26,.346,15,18,.833,102
2347,ATL,2018-04-04,86,,MIA,L 86-115,240,33,90,.367,24,60,.400,9,30,.300,11,17,.647,86,42,94,.447,25,56,.446,17,38,.447,14,17,.824,115
2348,CHI,2018-03-27,86,@,HOU,L 86-118,240,34,89,.382,26,52,.500,8,37,.216,10,17,.588,86,41,93,.441,23,36,.639,18,57,.316,18,21,.857,118
2349,ORL,2018-03-20,86,,TOR,L 86-93,240,37,90,.411,28,65,.431,9,25,.360,3,5,.600,86,35,77,.455,21,41,.512,14,36,.389,9,17,.529,93
2350,MEM,2018-02-04,86,@,TOR,L 86-101,240,29,81,.358,21,56,.375,8,25,.320,20,23,.870,86,41,89,.461,35,54,.648,6,35,.171,13,15,.867,101
2351,SAS,2018-01-21,86,,IND,L 86-94,240,35,82,.427,26,48,.542,9,34,.265,7,12,.583,86,37,84,.440,33,65,.508,4,19,.211,16,17,.941,94
2352,TOR,2018-01-19,86,,SAS,W 86-83,240,34,85,.400,25,59,.424,9,26,.346,9,14,.643,86,31,91,.341,26,71,.366,5,20,.250,16,20,.800,83
2353,IND,2018-01-19,86,@,LAL,L 86-99,240,37,97,.381,35,72,.486,2,25,.080,10,13,.769,86,44,80,.550,35,52,.673,9,28,.321,2,14,.143,99
2354,IND,2018-01-18,86,@,POR,L 86-100,240,36,91,.396,29,65,.446,7,26,.269,7,13,.538,86,37,94,.394,27,62,.435,10,32,.313,16,16,1.000,100
2355,SAC,2018-01-09,86,@,LAL,L 86-99,240,30,87,.345,22,66,.333,8,21,.381,18,27,.667,86,37,77,.481,25,42,.595,12,35,.343,13,21,.619,99
2356,CHI,2018-01-06,86,@,IND,L 86-125,240,30,80,.375,20,48,.417,10,32,.313,16,20,.800,86,48,86,.558,33,55,.600,15,31,.484,14,18,.778,125
2357,PHI,2017-12-23,86,@,TOR,L 86-102,240,33,80,.413,26,53,.491,7,27,.259,13,20,.650,86,35,85,.412,26,58,.448,9,27,.333,23,26,.885,102
2358,MIA,2017-11-29,86,@,NYK,L 86-115,240,32,84,.381,22,46,.478,10,38,.263,12,20,.600,86,44,73,.603,39,60,.650,5,13,.385,22,26,.846,115
2359,CHO,2017-11-25,86,,SAS,L 86-106,240,31,84,.369,27,59,.458,4,25,.160,20,26,.769,86,39,81,.481,33,56,.589,6,25,.240,22,25,.880,106
2360,UTA,2017-11-20,86,@,PHI,L 86-107,240,30,85,.353,21,57,.368,9,28,.321,17,19,.895,86,44,85,.518,40,70,.571,4,15,.267,15,22,.682,107
2361,SAC,2017-11-17,86,,POR,W 86-82,240,36,85,.424,32,71,.451,4,14,.286,10,15,.667,86,30,81,.370,23,56,.411,7,25,.280,15,16,.938,82
2362,SAS,2017-11-15,86,@,MIN,L 86-98,240,33,79,.418,26,55,.473,7,24,.292,13,15,.867,86,39,87,.448,30,69,.435,9,18,.500,11,16,.688,98
2363,OKC,2017-11-07,86,@,SAC,L 86-94,240,29,86,.337,19,49,.388,10,37,.270,18,23,.783,86,37,79,.468,28,55,.509,9,24,.375,11,12,.917,94
2364,SAC,2017-11-01,86,@,BOS,L 86-113,240,35,81,.432,29,61,.475,6,20,.300,10,12,.833,86,40,82,.488,23,41,.561,17,41,.415,16,19,.842,113
2365,BRK,2017-10-27,86,@,NYK,L 86-107,240,30,75,.400,19,45,.422,11,30,.367,15,21,.714,86,44,98,.449,35,71,.493,9,27,.333,10,17,.588,107
2366,ATL,2017-10-26,86,@,CHI,L 86-91,240,32,81,.395,21,53,.396,11,28,.393,11,13,.846,86,31,86,.360,24,54,.444,7,32,.219,22,29,.759,91
2367,DET,2017-10-23,86,,PHI,L 86-97,240,33,85,.388,27,55,.491,6,30,.200,14,19,.737,86,35,75,.467,26,51,.510,9,24,.375,18,24,.750,97
2368,SAC,2018-04-09,85,@,SAS,L 85-98,240,33,81,.407,25,63,.397,8,18,.444,11,17,.647,85,34,82,.415,28,55,.509,6,27,.222,24,29,.828,98
2369,UTA,2018-02-26,85,,HOU,L 85-96,240,31,71,.437,24,42,.571,7,29,.241,16,22,.727,85,34,79,.430,25,46,.543,9,33,.273,19,25,.760,96
2370,MIL,2018-02-09,85,@,MIA,L 85-91,240,32,76,.421,26,56,.464,6,20,.300,15,17,.882,85,32,88,.364,22,62,.355,10,26,.385,17,18,.944,91
2371,PHO,2018-01-26,85,,NYK,L 85-107,240,33,94,.351,22,61,.361,11,33,.333,8,13,.615,85,41,85,.482,32,60,.533,9,25,.360,16,22,.727,107
2372,MEM,2018-01-24,85,,SAS,L 85-108,240,36,83,.434,34,65,.523,2,18,.111,11,14,.786,85,38,82,.463,28,58,.483,10,24,.417,22,25,.880,108
2373,BRK,2018-01-06,85,,BOS,L 85-87,240,30,91,.330,24,60,.400,6,31,.194,19,22,.864,85,37,98,.378,32,80,.400,5,18,.278,8,15,.533,87
2374,POR,2017-12-22,85,,DEN,L 85-102,240,35,83,.422,29,61,.475,6,22,.273,9,16,.563,85,42,85,.494,35,60,.583,7,25,.280,11,15,.733,102
2375,LAC,2017-12-16,85,@,MIA,L 85-90,240,35,80,.438,27,52,.519,8,28,.286,7,14,.500,85,31,82,.378,19,47,.404,12,35,.343,16,21,.762,90
2376,BOS,2017-12-11,85,@,CHI,L 85-108,240,33,83,.398,23,43,.535,10,40,.250,9,14,.643,85,39,81,.481,27,52,.519,12,29,.414,18,25,.720,108
2377,LAC,2017-11-20,85,@,NYK,L 85-107,240,30,80,.375,20,48,.417,10,32,.313,15,21,.714,85,35,81,.432,22,47,.468,13,34,.382,24,25,.960,107
2378,ATL,2017-11-20,85,@,SAS,L 85-96,240,37,85,.435,29,55,.527,8,30,.267,3,8,.375,85,40,89,.449,30,58,.517,10,31,.323,6,6,1.000,96
2379,ORL,2017-11-18,85,,UTA,L 85-125,240,31,81,.383,23,52,.442,8,29,.276,15,23,.652,85,47,98,.480,33,64,.516,14,34,.412,17,18,.944,125
2380,POR,2017-10-30,85,,TOR,L 85-99,240,31,80,.388,23,54,.426,8,26,.308,15,19,.789,85,39,87,.448,31,63,.492,8,24,.333,13,17,.765,99
2381,SAC,2018-04-01,84,@,LAL,W 84-83,240,35,92,.380,28,68,.412,7,24,.292,7,14,.500,84,30,75,.400,23,43,.535,7,32,.219,16,25,.640,83
2382,IND,2018-03-07,84,,UTA,L 84-104,240,34,88,.386,31,65,.477,3,23,.130,13,17,.765,84,41,80,.513,30,49,.612,11,31,.355,11,16,.688,104
2383,MIN,2018-01-05,84,@,BOS,L 84-91,240,28,76,.368,21,53,.396,7,23,.304,21,28,.750,84,38,94,.404,32,58,.552,6,36,.167,9,13,.692,91
2384,WAS,2017-12-22,84,@,BRK,L 84-119,240,34,93,.366,29,73,.397,5,20,.250,11,15,.733,84,44,88,.500,30,47,.638,14,41,.341,17,21,.810,119
2385,MEM,2017-12-20,84,@,GSW,L 84-97,240,28,84,.333,16,53,.302,12,31,.387,16,19,.842,84,34,74,.459,27,53,.509,7,21,.333,22,25,.880,97
2386,DET,2017-12-12,84,,DEN,L 84-103,240,28,79,.354,19,54,.352,9,25,.360,19,22,.864,84,40,79,.506,30,49,.612,10,30,.333,13,14,.929,103
2387,NYK,2017-11-17,84,@,TOR,L 84-107,240,30,91,.330,21,68,.309,9,23,.391,15,17,.882,84,44,78,.564,35,52,.673,9,26,.346,10,11,.909,107
2388,MIA,2017-11-10,84,@,UTA,W 84-74,240,30,77,.390,20,52,.385,10,25,.400,14,18,.778,84,25,74,.338,20,53,.377,5,21,.238,19,22,.864,74
2389,UTA,2017-10-24,84,@,LAC,L 84-102,240,34,79,.430,27,51,.529,7,28,.250,9,11,.818,84,39,83,.470,29,54,.537,10,29,.345,14,21,.667,102
2390,NYK,2017-10-19,84,@,OKC,L 84-105,240,32,79,.405,25,55,.455,7,24,.292,13,19,.684,84,39,90,.433,28,52,.538,11,38,.289,16,22,.727,105
2391,HOU,2018-04-11,83,@,SAC,L 83-96,240,31,82,.378,18,36,.500,13,46,.283,8,12,.667,83,38,80,.475,31,54,.574,7,26,.269,13,20,.650,96
2392,LAL,2018-04-01,83,,SAC,L 83-84,240,30,75,.400,23,43,.535,7,32,.219,16,25,.640,83,35,92,.380,28,68,.412,7,24,.292,7,14,.500,84
2393,HOU,2018-04-01,83,@,SAS,L 83-100,240,26,77,.338,19,46,.413,7,31,.226,24,29,.828,83,40,81,.494,34,64,.531,6,17,.353,14,21,.667,100
2394,ORL,2018-03-16,83,,BOS,L 83-92,240,34,87,.391,29,59,.492,5,28,.179,10,11,.909,83,31,82,.378,22,56,.393,9,26,.346,21,28,.750,92
2395,CHI,2018-03-09,83,@,DET,L 83-99,240,33,93,.355,24,62,.387,9,31,.290,8,10,.800,83,38,81,.469,29,54,.537,9,27,.333,14,18,.778,99
2396,PHO,2018-02-12,83,@,GSW,L 83-129,240,33,95,.347,30,72,.417,3,23,.130,14,22,.636,83,52,89,.584,41,63,.651,11,26,.423,14,21,.667,129
2397,SAS,2018-01-19,83,@,TOR,L 83-86,240,31,91,.341,26,71,.366,5,20,.250,16,20,.800,83,34,85,.400,25,59,.424,9,26,.346,9,14,.643,86
2398,IND,2017-12-26,83,@,DET,L 83-107,240,34,77,.442,28,56,.500,6,21,.286,9,13,.692,83,41,82,.500,29,48,.604,12,34,.353,13,16,.813,107
2399,UTA,2017-12-26,83,@,DEN,L 83-107,240,27,84,.321,17,49,.347,10,35,.286,19,23,.826,83,39,81,.481,28,51,.549,11,30,.367,18,22,.818,107
2400,MEM,2017-11-18,83,,HOU,L 83-105,240,31,86,.360,24,59,.407,7,27,.259,14,19,.737,83,35,78,.449,17,35,.486,18,43,.419,17,21,.810,105
2401,ORL,2017-11-03,83,,CHI,L 83-105,240,35,86,.407,25,51,.490,10,35,.286,3,5,.600,83,40,85,.471,26,56,.464,14,29,.483,11,12,.917,105
2402,SAC,2017-10-31,83,@,IND,L 83-101,240,37,88,.420,35,74,.473,2,14,.143,7,14,.500,83,36,85,.424,24,56,.429,12,29,.414,17,22,.773,101
2403,SAC,2017-10-29,83,,WAS,L 83-110,240,32,82,.390,26,60,.433,6,22,.273,13,16,.813,83,40,85,.471,23,51,.451,17,34,.500,13,20,.650,110
2404,POR,2018-04-09,82,@,DEN,L 82-88,240,31,94,.330,24,61,.393,7,33,.212,13,18,.722,82,31,83,.373,25,57,.439,6,26,.231,20,26,.769,88
2405,ORL,2018-03-30,82,,CHI,L 82-90,240,31,94,.330,24,55,.436,7,39,.179,13,14,.929,82,30,84,.357,16,43,.372,14,41,.341,16,23,.696,90
2406,DAL,2018-03-11,82,,HOU,L 82-105,240,33,94,.351,28,63,.444,5,31,.161,11,18,.611,82,39,84,.464,22,39,.564,17,45,.378,10,14,.714,105
2407,NOP,2018-02-09,82,@,PHI,L 82-100,240,33,95,.347,25,64,.391,8,31,.258,8,16,.500,82,39,93,.419,25,59,.424,14,34,.412,8,9,.889,100
2408,MEM,2018-02-06,82,@,ATL,L 82-108,240,34,79,.430,30,57,.526,4,22,.182,10,13,.769,82,42,83,.506,34,58,.586,8,25,.320,16,21,.762,108
2409,MEM,2017-12-11,82,,MIA,L 82-107,240,28,72,.389,20,45,.444,8,27,.296,18,27,.667,82,37,66,.561,23,39,.590,14,27,.519,19,24,.792,107
2410,LAC,2017-12-02,82,@,DAL,L 82-108,240,30,86,.349,24,64,.375,6,22,.273,16,23,.696,82,36,79,.456,20,44,.455,16,35,.457,20,26,.769,108
2411,POR,2017-11-17,82,@,SAC,L 82-86,240,30,81,.370,23,56,.411,7,25,.280,15,16,.938,82,36,85,.424,32,71,.451,4,14,.286,10,15,.667,86
2412,DEN,2017-11-13,82,@,POR,L 82-99,240,30,84,.357,21,52,.404,9,32,.281,13,15,.867,82,38,73,.521,31,52,.596,7,21,.333,16,18,.889,99
2413,GSW,2018-03-27,81,,IND,L 81-92,240,35,86,.407,30,69,.435,5,17,.294,6,9,.667,81,39,81,.481,33,60,.550,6,21,.286,8,12,.667,92
2414,UTA,2018-02-23,81,,POR,L 81-100,240,33,78,.423,27,53,.509,6,25,.240,9,11,.818,81,39,87,.448,30,63,.476,9,24,.375,13,14,.929,100
2415,OKC,2018-02-08,81,@,LAL,L 81-106,240,32,90,.356,24,56,.429,8,34,.235,9,19,.474,81,42,96,.438,32,65,.492,10,31,.323,12,13,.923,106
2416,PHO,2018-02-07,81,,SAS,L 81-129,240,33,97,.340,30,65,.462,3,32,.094,12,18,.667,81,46,93,.495,30,61,.492,16,32,.500,21,27,.778,129
2417,SAS,2018-01-11,81,@,LAL,L 81-93,240,31,76,.408,23,56,.411,8,20,.400,11,15,.733,81,36,87,.414,23,49,.469,13,38,.342,8,14,.571,93
2418,GSW,2017-12-23,81,,DEN,L 81-96,240,32,84,.381,29,57,.509,3,27,.111,14,17,.824,81,38,82,.463,31,54,.574,7,28,.250,13,15,.867,96
2419,DET,2017-12-10,81,,BOS,L 81-91,240,28,84,.333,18,51,.353,10,33,.303,15,19,.789,81,33,79,.418,22,49,.449,11,30,.367,14,18,.778,91
2420,OKC,2017-11-25,81,@,DAL,L 81-97,240,29,80,.363,16,45,.356,13,35,.371,10,13,.769,81,37,75,.493,22,40,.550,15,35,.429,8,11,.727,97
2421,POR,2017-11-22,81,@,PHI,L 81-101,240,30,89,.337,23,63,.365,7,26,.269,14,24,.583,81,39,90,.433,28,58,.483,11,32,.344,12,17,.706,101
2422,LAL,2017-10-28,81,@,UTA,L 81-96,240,31,81,.383,26,59,.441,5,22,.227,14,20,.700,81,37,79,.468,24,48,.500,13,31,.419,9,13,.692,96
2423,MEM,2018-03-10,80,@,DAL,L 80-114,240,30,84,.357,23,66,.348,7,18,.389,13,17,.765,80,37,77,.481,27,48,.563,10,29,.345,30,35,.857,114
2424,ORL,2018-03-05,80,@,UTA,L 80-94,240,29,85,.341,18,51,.353,11,34,.324,11,14,.786,80,36,73,.493,26,42,.619,10,31,.323,12,18,.667,94
2425,OKC,2018-02-24,80,@,GSW,L 80-112,240,29,88,.330,20,54,.370,9,34,.265,13,21,.619,80,42,89,.472,25,51,.490,17,38,.447,11,13,.846,112
2426,BOS,2018-01-18,80,,PHI,L 80-89,240,30,74,.405,23,45,.511,7,29,.241,13,17,.765,80,34,73,.466,28,56,.500,6,17,.353,15,17,.882,89
2427,DEN,2018-01-13,80,@,SAS,L 80-112,240,29,83,.349,22,55,.400,7,28,.250,15,17,.882,80,41,79,.519,27,52,.519,14,27,.519,16,18,.889,112
2428,BRK,2018-01-10,80,,DET,L 80-114,240,27,74,.365,15,37,.405,12,37,.324,14,15,.933,80,48,93,.516,38,72,.528,10,21,.476,8,12,.667,114
2429,CHI,2017-11-22,80,@,UTA,L 80-110,240,29,78,.372,24,57,.421,5,21,.238,17,20,.850,80,40,86,.465,26,51,.510,14,35,.400,16,19,.842,110
2430,SAC,2017-11-15,80,@,ATL,L 80-126,240,31,88,.352,25,60,.417,6,28,.214,12,20,.600,80,50,79,.633,34,47,.723,16,32,.500,10,16,.625,126
2431,MIA,2017-11-06,80,@,GSW,L 80-97,240,30,83,.361,22,57,.386,8,26,.308,12,17,.706,80,32,87,.368,21,55,.382,11,32,.344,22,24,.917,97
2432,GSW,2018-04-10,79,@,UTA,L 79-119,240,30,86,.349,25,67,.373,5,19,.263,14,16,.875,79,48,90,.533,35,55,.636,13,35,.371,10,13,.769,119
2433,CLE,2018-03-27,79,@,MIA,L 79-98,240,31,85,.365,27,59,.458,4,26,.154,13,19,.684,79,37,78,.474,28,49,.571,9,29,.310,15,20,.750,98
2434,MEM,2018-03-22,79,@,CHO,L 79-140,240,30,78,.385,26,60,.433,4,18,.222,15,21,.714,79,49,92,.533,30,52,.577,19,40,.475,23,27,.852,140
2435,DET,2018-03-13,79,@,UTA,L 79-110,240,30,80,.375,25,55,.455,5,25,.200,14,19,.737,79,42,76,.553,29,42,.690,13,34,.382,13,23,.565,110
2436,MIL,2018-01-14,79,@,MIA,L 79-97,240,25,79,.316,21,51,.412,4,28,.143,25,27,.926,79,35,76,.461,24,47,.511,11,29,.379,16,20,.800,97
2437,SAS,2017-12-30,79,@,DET,L 79-93,240,31,84,.369,26,58,.448,5,26,.192,12,13,.923,79,36,81,.444,28,57,.491,8,24,.333,13,16,.813,93
2438,UTA,2017-12-20,79,@,OKC,L 79-107,240,26,73,.356,19,42,.452,7,31,.226,20,27,.741,79,40,77,.519,32,54,.593,8,23,.348,19,22,.864,107
2439,MEM,2017-12-01,79,,SAS,L 79-95,240,30,74,.405,25,59,.424,5,15,.333,14,18,.778,79,31,70,.443,20,43,.465,11,27,.407,22,32,.688,95
2440,MIL,2017-11-18,79,@,DAL,L 79-111,240,28,74,.378,22,49,.449,6,25,.240,17,31,.548,79,38,79,.481,19,41,.463,19,38,.500,16,19,.842,111
2441,CHI,2017-11-15,79,@,OKC,L 79-92,240,26,75,.347,15,46,.326,11,29,.379,16,20,.800,79,26,72,.361,18,42,.429,8,30,.267,32,37,.865,92
2442,SAC,2017-10-21,79,@,DEN,L 79-96,240,31,85,.365,23,63,.365,8,22,.364,9,13,.692,79,37,85,.435,27,55,.491,10,30,.333,12,20,.600,96
2443,BOS,2018-04-04,78,@,TOR,L 78-96,240,25,75,.333,22,53,.415,3,22,.136,25,28,.893,78,40,92,.435,30,59,.508,10,33,.303,6,8,.750,96
2444,MEM,2018-03-09,78,,UTA,L 78-95,240,31,83,.373,25,61,.410,6,22,.273,10,14,.714,78,33,74,.446,20,42,.476,13,32,.406,16,22,.727,95
2445,SAS,2018-01-26,78,,PHI,L 78-97,240,30,75,.400,27,51,.529,3,24,.125,15,18,.833,78,38,79,.481,29,58,.500,9,21,.429,12,18,.667,97
2446,MEM,2018-01-12,78,@,DEN,L 78-87,240,30,77,.390,23,53,.434,7,24,.292,11,14,.786,78,27,70,.386,20,48,.417,7,22,.318,26,32,.813,87
2447,DET,2018-01-05,78,@,PHI,L 78-114,240,30,78,.385,23,56,.411,7,22,.318,11,19,.579,78,44,90,.489,30,60,.500,14,30,.467,12,13,.923,114
2448,ATL,2017-11-25,78,,TOR,L 78-112,240,26,75,.347,20,48,.417,6,27,.222,20,23,.870,78,46,84,.548,33,52,.635,13,32,.406,7,9,.778,112
2449,DEN,2017-11-28,77,@,UTA,L 77-106,240,28,78,.359,21,44,.477,7,34,.206,14,16,.875,77,42,87,.483,28,55,.509,14,32,.438,8,9,.889,106
2450,CHI,2017-10-21,77,,SAS,L 77-87,240,31,82,.378,23,54,.426,8,28,.286,7,9,.778,77,38,93,.409,37,81,.457,1,12,.083,10,16,.625,87
2451,PHO,2017-10-18,76,,POR,L 76-124,240,28,89,.315,21,62,.339,7,27,.259,13,18,.722,76,44,90,.489,30,66,.455,14,24,.583,22,28,.786,124
2452,GSW,2018-03-19,75,@,SAS,L 75-89,240,30,74,.405,27,55,.491,3,19,.158,12,16,.750,75,33,82,.402,25,59,.424,8,23,.348,15,21,.714,89
2453,WAS,2018-01-22,75,@,DAL,L 75-98,240,26,86,.302,19,54,.352,7,32,.219,16,27,.593,75,38,87,.437,28,56,.500,10,31,.323,12,17,.706,98
2454,UTA,2017-11-10,74,,MIA,L 74-84,240,25,74,.338,20,53,.377,5,21,.238,19,22,.864,74,30,77,.390,20,52,.385,10,25,.400,14,18,.778,84
2455,IND,2018-04-06,73,@,TOR,L 73-92,240,26,87,.299,19,66,.288,7,21,.333,14,20,.700,73,36,84,.429,27,54,.500,9,30,.300,11,16,.688,92
2456,NYK,2018-04-03,73,,ORL,L 73-97,240,30,86,.349,26,59,.441,4,27,.148,9,12,.750,73,37,88,.420,26,52,.500,11,36,.306,12,18,.667,97
2457,NYK,2018-01-31,73,@,BOS,L 73-103,240,28,87,.322,25,70,.357,3,17,.176,14,21,.667,73,40,83,.482,29,57,.509,11,26,.423,12,20,.600,103
2458,ORL,2018-03-13,72,@,SAS,L 72-108,240,28,82,.341,21,59,.356,7,23,.304,9,9,1.000,72,40,84,.476,31,65,.477,9,19,.474,19,23,.826,108
2459,WAS,2017-12-04,69,@,UTA,L 69-116,240,23,80,.288,19,60,.317,4,20,.200,19,23,.826,69,43,76,.566,27,42,.643,16,34,.471,14,18,.778,116
2460,CHI,2017-10-28,69,,OKC,L 69-101,240,22,78,.282,12,41,.293,10,37,.270,15,20,.750,69,39,88,.443,26,54,.481,13,34,.382,10,14,.714,101
