Rk,Team,Date,PTS,,Opp,Result,MP,FG,FGA,FG%,2P,2PA,2P%,3P,3PA,3P%,FT,FTA,FT%,PTS,FG,FGA,FG%,2P,2PA,2P%,3P,3PA,3P%,FT,FTA,FT%,PTS
1,IND,2023-11-21,157,@,ATL,W 157-152,240,57,94,.606,35,49,.714,22,45,.489,21,28,.750,157,57,95,.600,42,64,.656,15,31,.484,23,28,.821,152
2,BOS,2023-11-01,155,,IND,W 155-104,240,54,95,.568,34,60,.567,20,35,.571,27,28,.964,155,46,101,.455,41,64,.641,5,37,.135,7,12,.583,104
3,UTA,2024-01-03,154,,DET,W 154-148 (OT),265,53,103,.515,37,71,.521,16,32,.500,32,35,.914,154,56,105,.533,37,64,.578,19,41,.463,17,22,.773,148
4,NOP,2024-01-23,153,,UTA,W 153-124,240,60,104,.577,37,58,.638,23,46,.500,10,15,.667,153,43,92,.467,31,56,.554,12,36,.333,26,32,.813,124
5,ATL,2023-11-21,152,,IND,L 152-157,240,57,95,.600,42,64,.656,15,31,.484,23,28,.821,152,57,94,.606,35,49,.714,22,45,.489,21,28,.750,157
6,IND,2023-11-06,152,,SAS,W 152-111,240,55,95,.579,35,57,.614,20,38,.526,22,23,.957,152,40,94,.426,32,68,.471,8,26,.308,23,30,.767,111
7,LAC,2023-12-18,151,@,IND,W 151-127,240,56,98,.571,37,60,.617,19,38,.500,20,23,.870,151,49,95,.516,37,62,.597,12,33,.364,17,21,.810,127
8,IND,2024-01-05,150,,ATL,W 150-116,240,60,94,.638,41,55,.745,19,39,.487,11,13,.846,150,40,93,.430,30,51,.588,10,42,.238,26,30,.867,116
9,LAC,2024-02-05,149,@,ATL,W 149-144,240,52,89,.584,31,54,.574,21,35,.600,24,31,.774,149,51,95,.537,31,56,.554,20,39,.513,22,27,.815,144
10,DAL,2024-01-26,148,@,ATL,W 148-143,240,51,85,.600,32,50,.640,19,35,.543,27,32,.844,148,51,97,.526,36,63,.571,15,34,.441,26,30,.867,143
11,DET,2024-01-03,148,@,UTA,L 148-154 (OT),265,56,105,.533,37,64,.578,19,41,.463,17,22,.773,148,53,103,.515,37,71,.521,16,32,.500,32,35,.914,154
12,BRK,2024-01-29,147,,UTA,W 147-114,240,54,105,.514,33,60,.550,21,45,.467,18,19,.947,147,39,86,.453,30,59,.508,9,27,.333,27,34,.794,114
13,DAL,2023-12-06,147,,UTA,W 147-97,240,56,101,.554,34,52,.654,22,49,.449,13,19,.684,147,35,87,.402,23,54,.426,12,33,.364,15,18,.833,97
14,ATL,2023-11-22,147,,BRK,W 147-145 (OT),265,51,116,.440,33,67,.493,18,49,.367,27,29,.931,147,55,113,.487,40,78,.513,15,35,.429,20,24,.833,145
15,NOP,2023-12-17,146,@,SAS,W 146-110,240,55,98,.561,33,56,.589,22,42,.524,14,22,.636,146,40,94,.426,25,52,.481,15,42,.357,15,21,.714,110
16,MIL,2023-12-16,146,,DET,W 146-114,240,50,88,.568,31,46,.674,19,42,.452,27,32,.844,146,43,96,.448,37,68,.544,6,28,.214,22,26,.846,114
17,PHI,2023-12-11,146,,WAS,W 146-101,240,52,95,.547,32,49,.653,20,46,.435,22,25,.880,146,36,85,.424,27,54,.500,9,31,.290,20,31,.645,101
18,MIL,2023-12-05,146,,NYK,W 146-122,240,55,91,.604,32,53,.604,23,38,.605,13,19,.684,146,43,87,.494,36,64,.563,7,23,.304,29,33,.879,122
19,PHI,2023-11-06,146,,WAS,W 146-128,240,51,91,.560,39,60,.650,12,31,.387,32,36,.889,146,49,96,.510,35,62,.565,14,34,.412,16,20,.800,128
20,LAL,2024-01-27,145,@,GSW,W 145-144 (2OT),290,49,101,.485,40,74,.541,9,27,.333,38,43,.884,145,55,119,.462,32,61,.525,23,58,.397,11,16,.688,144
21,BOS,2024-01-13,145,,HOU,W 145-113,240,51,95,.537,27,48,.563,24,47,.511,19,25,.760,145,40,99,.404,33,69,.478,7,30,.233,26,30,.867,113
22,UTA,2024-01-12,145,,TOR,W 145-113,240,52,93,.559,31,50,.620,21,43,.488,20,26,.769,145,35,81,.432,18,47,.383,17,34,.500,26,37,.703,113
23,BOS,2023-12-23,145,@,LAC,W 145-108,240,49,94,.521,24,41,.585,25,53,.472,22,28,.786,145,41,89,.461,30,55,.545,11,34,.324,15,15,1.000,108
24,BRK,2023-11-22,145,@,ATL,L 145-147 (OT),265,55,113,.487,40,78,.513,15,35,.429,20,24,.833,145,51,116,.440,33,67,.493,18,49,.367,27,29,.931,147
25,ATL,2024-02-05,144,,LAC,L 144-149,240,51,95,.537,31,56,.554,20,39,.513,22,27,.815,144,52,89,.584,31,54,.574,21,35,.600,24,31,.774,149
26,GSW,2024-01-27,144,,LAL,L 144-145 (2OT),290,55,119,.462,32,61,.525,23,58,.397,11,16,.688,144,49,101,.485,40,74,.541,9,27,.333,38,43,.884,145
27,MIL,2023-12-27,144,@,BRK,W 144-122,240,52,89,.584,29,38,.763,23,51,.451,17,23,.739,144,45,101,.446,38,69,.551,7,32,.219,25,29,.862,122
28,DAL,2023-12-23,144,,SAS,W 144-119,240,52,100,.520,29,55,.527,23,45,.511,17,21,.810,144,44,98,.449,30,53,.566,14,45,.311,17,24,.708,119
29,IND,2023-12-20,144,,CHO,W 144-113,240,49,80,.613,31,41,.756,18,39,.462,28,30,.933,144,45,95,.474,37,64,.578,8,31,.258,15,19,.789,113
30,BOS,2023-12-20,144,@,SAC,W 144-119,240,51,92,.554,29,50,.580,22,42,.524,20,24,.833,144,43,91,.473,22,47,.468,21,44,.477,12,23,.522,119
31,LAC,2023-12-16,144,,NYK,W 144-122,240,50,88,.568,34,55,.618,16,33,.485,28,34,.824,144,44,94,.468,33,59,.559,11,35,.314,23,26,.885,122
32,IND,2023-12-02,144,@,MIA,W 144-129,240,56,85,.659,40,53,.755,16,32,.500,16,20,.800,144,48,89,.539,36,64,.563,12,25,.480,21,24,.875,129
33,DAL,2023-11-10,144,,LAC,W 144-126,240,51,98,.520,32,56,.571,19,42,.452,23,26,.885,144,43,88,.489,35,61,.574,8,27,.296,32,36,.889,126
34,ATL,2024-01-26,143,,DAL,L 143-148,240,51,97,.526,36,63,.571,15,34,.441,26,30,.867,143,51,85,.600,32,50,.640,19,35,.543,27,32,.844,148
35,BOS,2024-01-25,143,@,MIA,W 143-110,240,51,80,.638,29,40,.725,22,40,.550,19,20,.950,143,42,94,.447,26,52,.500,16,42,.381,10,13,.769,110
36,MIL,2024-01-14,143,,SAC,W 143-142 (OT),265,48,92,.522,28,49,.571,20,43,.465,27,32,.844,143,55,105,.524,38,64,.594,17,41,.415,15,20,.750,142
37,SAC,2023-12-18,143,,WAS,W 143-131,240,53,100,.530,36,57,.632,17,43,.395,20,26,.769,143,44,85,.518,26,47,.553,18,38,.474,25,30,.833,131
38,IND,2023-10-25,143,,WAS,W 143-120,240,56,107,.523,36,64,.563,20,43,.465,11,12,.917,143,44,96,.458,35,72,.486,9,24,.375,23,29,.793,120
39,SAC,2024-01-14,142,@,MIL,L 142-143 (OT),265,55,105,.524,38,64,.594,17,41,.415,15,20,.750,142,48,92,.522,28,49,.571,20,43,.465,27,32,.844,143
40,IND,2024-01-03,142,,MIL,W 142-130,240,50,90,.556,36,55,.655,14,35,.400,28,34,.824,142,46,92,.500,32,55,.582,14,37,.378,24,32,.750,130
41,DEN,2023-12-28,142,,MEM,W 142-105,240,55,96,.573,35,55,.636,20,41,.488,12,14,.857,142,37,89,.416,24,54,.444,13,35,.371,18,25,.720,105
42,NOP,2023-12-13,142,@,WAS,W 142-122,240,50,96,.521,34,62,.548,16,34,.471,26,30,.867,142,42,82,.512,23,38,.605,19,44,.432,19,24,.792,122
43,MIA,2023-11-30,142,,IND,W 142-132,240,48,86,.558,40,65,.615,8,21,.381,38,45,.844,142,50,98,.510,39,55,.709,11,43,.256,21,32,.656,132
44,MIL,2023-11-20,142,@,WAS,W 142-129,240,55,94,.585,44,65,.677,11,29,.379,21,28,.750,142,55,99,.556,45,70,.643,10,29,.345,9,11,.818,129
45,TOR,2023-11-19,142,,DET,W 142-113,240,55,102,.539,41,66,.621,14,36,.389,18,29,.621,142,39,83,.470,30,57,.526,9,26,.346,26,35,.743,113
46,ATL,2024-02-03,141,,GSW,W 141-134 (OT),265,55,114,.482,41,71,.577,14,43,.326,17,22,.773,141,50,112,.446,32,56,.571,18,56,.321,16,20,.800,134
47,MIL,2024-01-27,141,,NOP,W 141-117,240,51,91,.560,31,46,.674,20,45,.444,19,25,.760,141,40,85,.471,31,62,.500,9,23,.391,28,36,.778,117
48,LAL,2024-01-25,141,,CHI,W 141-132,240,53,87,.609,33,56,.589,20,31,.645,15,20,.750,141,47,88,.534,35,51,.686,12,37,.324,26,29,.897,132
49,MIL,2024-01-20,141,@,DET,W 141-135,240,47,85,.553,35,53,.660,12,32,.375,35,49,.714,141,44,94,.468,23,57,.404,21,37,.568,26,32,.813,135
50,NOP,2024-01-10,141,@,GSW,W 141-105,240,54,94,.574,35,54,.648,19,40,.475,14,19,.737,141,39,89,.438,27,50,.540,12,39,.308,15,18,.833,105
51,ATL,2024-01-03,141,,OKC,W 141-138,240,48,95,.505,34,56,.607,14,39,.359,31,33,.939,141,50,91,.549,32,55,.582,18,36,.500,20,26,.769,138
52,GSW,2023-11-03,141,@,OKC,W 141-139,240,49,92,.533,31,52,.596,18,40,.450,25,30,.833,141,50,83,.602,35,54,.648,15,29,.517,24,30,.800,139
53,PHO,2024-02-04,140,@,WAS,W 140-112,240,54,88,.614,43,63,.683,11,25,.440,21,26,.808,140,47,96,.490,40,64,.625,7,32,.219,11,17,.647,112
54,OKC,2024-01-24,140,@,SAS,W 140-114,240,54,96,.563,36,56,.643,18,40,.450,14,16,.875,140,43,86,.500,34,54,.630,9,32,.281,19,25,.760,114
55,GSW,2024-01-12,140,@,CHI,W 140-131,240,49,94,.521,29,47,.617,20,47,.426,22,30,.733,140,50,86,.581,32,46,.696,18,40,.450,13,16,.813,131
56,CLE,2024-01-03,140,,WAS,W 140-101,240,54,101,.535,34,59,.576,20,42,.476,12,16,.750,140,42,101,.416,30,66,.455,12,35,.343,5,11,.455,101
57,IND,2023-12-30,140,,NYK,W 140-126,240,50,85,.588,27,42,.643,23,43,.535,17,21,.810,140,45,95,.474,28,58,.483,17,37,.459,19,27,.704,126
58,MIL,2023-12-13,140,,IND,W 140-126,240,48,89,.539,41,62,.661,7,27,.259,37,48,.771,140,45,100,.450,34,64,.531,11,36,.306,25,32,.781,126
59,PHO,2023-11-19,140,@,UTA,W 140-137 (2OT),290,50,102,.490,32,57,.561,18,45,.400,22,26,.846,140,48,115,.417,33,69,.478,15,46,.326,26,32,.813,137
60,OKC,2024-01-11,139,,POR,W 139-77,240,53,93,.570,39,58,.672,14,35,.400,19,22,.864,139,28,101,.277,17,52,.327,11,49,.224,10,16,.625,77
61,ATL,2024-01-10,139,,PHI,W 139-132 (OT),265,48,102,.471,36,68,.529,12,34,.353,31,42,.738,139,46,102,.451,34,68,.500,12,34,.353,28,33,.848,132
62,DAL,2024-01-05,139,,POR,W 139-103,240,56,96,.583,39,58,.672,17,38,.447,10,15,.667,139,39,95,.411,26,55,.473,13,40,.325,12,17,.706,103
63,NYK,2023-12-15,139,@,PHO,W 139-122,240,49,82,.598,32,53,.604,17,29,.586,24,28,.857,139,47,90,.522,36,62,.581,11,28,.393,17,21,.810,122
64,ORL,2023-11-29,139,,WAS,W 139-120,240,51,84,.607,34,57,.596,17,27,.630,20,24,.833,139,41,87,.471,30,58,.517,11,29,.379,27,35,.771,120
65,OKC,2023-11-03,139,,GSW,L 139-141,240,50,83,.602,35,54,.648,15,29,.517,24,30,.800,139,49,92,.533,31,52,.596,18,40,.450,25,30,.833,141
66,NOP,2024-02-05,138,,TOR,W 138-100,240,53,104,.510,34,59,.576,19,45,.422,13,13,1.000,138,40,84,.476,30,53,.566,10,31,.323,10,15,.667,100
67,ATL,2024-01-30,138,,LAL,W 138-122,240,53,101,.525,37,63,.587,16,38,.421,16,18,.889,138,48,90,.533,36,57,.632,12,33,.364,14,25,.560,122
68,HOU,2024-01-26,138,@,CHO,W 138-104,240,50,89,.562,37,56,.661,13,33,.394,25,31,.806,138,35,85,.412,26,56,.464,9,29,.310,25,32,.781,104
69,LAC,2024-01-08,138,,PHO,W 138-111,240,53,85,.624,38,56,.679,15,29,.517,17,23,.739,138,38,77,.494,28,47,.596,10,30,.333,25,29,.862,111
70,SAC,2024-01-03,138,,ORL,W 138-135 (2OT),290,51,105,.486,36,65,.554,15,40,.375,21,31,.677,138,44,90,.489,19,46,.413,25,44,.568,22,27,.815,135
71,OKC,2024-01-03,138,@,ATL,L 138-141,240,50,91,.549,32,55,.582,18,36,.500,20,26,.769,138,48,95,.505,34,56,.607,14,39,.359,31,33,.939,141
72,OKC,2023-12-08,138,,GSW,W 138-136 (OT),265,51,98,.520,46,69,.667,5,29,.172,31,36,.861,138,49,104,.471,30,56,.536,19,48,.396,19,23,.826,136
73,PHI,2023-11-27,138,,LAL,W 138-94,240,47,93,.505,25,47,.532,22,46,.478,22,26,.846,138,39,83,.470,32,55,.582,7,28,.250,9,13,.692,94
74,POR,2024-01-24,137,@,HOU,W 137-131 (OT),265,50,98,.510,35,63,.556,15,35,.429,22,24,.917,137,50,94,.532,38,58,.655,12,36,.333,19,22,.864,131
75,WAS,2023-12-15,137,,IND,W 137-123,240,52,92,.565,39,65,.600,13,27,.481,20,26,.769,137,48,107,.449,33,67,.493,15,40,.375,12,16,.750,123
76,ATL,2023-11-30,137,@,SAS,W 137-135,240,49,96,.510,35,63,.556,14,33,.424,25,29,.862,137,48,89,.539,30,48,.625,18,41,.439,21,23,.913,135
77,UTA,2023-11-19,137,,PHO,L 137-140 (2OT),290,48,115,.417,33,69,.478,15,46,.326,26,32,.813,137,50,102,.490,32,57,.561,18,45,.400,22,26,.846,140
78,PHI,2023-11-12,137,,IND,W 137-126,240,53,105,.505,39,72,.542,14,33,.424,17,20,.850,137,47,90,.522,31,51,.608,16,39,.410,16,19,.842,126
79,CLE,2024-02-05,136,,SAC,W 136-110,240,51,88,.580,28,47,.596,23,41,.561,11,17,.647,136,43,93,.462,26,49,.531,17,44,.386,7,12,.583,110
80,BRK,2024-02-03,136,@,PHI,W 136-121,240,49,95,.516,29,44,.659,20,51,.392,18,23,.783,136,44,96,.458,32,67,.478,12,29,.414,21,27,.778,121
81,LAC,2024-02-02,136,@,DET,W 136-125,240,53,89,.596,39,60,.650,14,29,.483,16,19,.842,136,45,89,.506,28,49,.571,17,40,.425,18,24,.750,125
82,PHO,2024-01-31,136,@,BRK,W 136-120,240,49,79,.620,35,51,.686,14,28,.500,24,32,.750,136,47,94,.500,31,55,.564,16,39,.410,10,13,.769,120
83,OKC,2024-01-08,136,@,WAS,W 136-128,240,52,88,.591,38,60,.633,14,28,.500,18,24,.750,136,44,89,.494,29,57,.509,15,32,.469,25,29,.862,128
84,HOU,2024-01-01,136,,DET,W 136-113,240,51,91,.560,36,56,.643,15,35,.429,19,24,.792,136,40,83,.482,27,54,.500,13,29,.448,20,27,.741,113
85,NYK,2023-12-11,136,,TOR,W 136-130,240,52,86,.605,35,57,.614,17,29,.586,15,23,.652,136,47,96,.490,33,57,.579,14,39,.359,22,30,.733,130
86,GSW,2023-12-08,136,@,OKC,L 136-138 (OT),265,49,104,.471,30,56,.536,19,48,.396,19,23,.826,136,51,98,.520,46,69,.667,5,29,.172,31,36,.861,138
87,ATL,2023-11-25,136,@,WAS,W 136-108,240,52,102,.510,34,65,.523,18,37,.486,14,20,.700,136,43,88,.489,33,50,.660,10,38,.263,12,12,1.000,108
88,IND,2023-11-24,136,,DET,W 136-113,240,49,102,.480,33,64,.516,16,38,.421,22,24,.917,136,43,90,.478,36,72,.500,7,18,.389,20,24,.833,113
89,DAL,2023-11-12,136,@,NOP,W 136-124,240,50,102,.490,30,49,.612,20,53,.377,16,21,.762,136,47,92,.511,30,56,.536,17,36,.472,13,22,.591,124
90,OKC,2024-02-04,135,,TOR,W 135-127 (2OT),290,52,110,.473,29,47,.617,23,63,.365,8,8,1.000,135,48,101,.475,34,66,.515,14,35,.400,17,21,.810,127
91,HOU,2024-02-02,135,,TOR,W 135-106,240,55,93,.591,44,62,.710,11,31,.355,14,17,.824,135,40,91,.440,29,58,.500,11,33,.333,15,20,.750,106
92,HOU,2024-01-29,135,,LAL,W 135-119,240,52,98,.531,40,62,.645,12,36,.333,19,25,.760,135,45,91,.495,32,56,.571,13,35,.371,16,26,.615,119
93,DET,2024-01-20,135,,MIL,L 135-141,240,44,94,.468,23,57,.404,21,37,.568,26,32,.813,135,47,85,.553,35,53,.660,12,32,.375,35,49,.714,141
94,CLE,2024-01-17,135,,MIL,W 135-95,240,55,93,.591,43,65,.662,12,28,.429,13,19,.684,135,38,95,.400,26,53,.491,12,42,.286,7,10,.700,95
95,SAS,2024-01-12,135,,CHO,W 135-99,240,45,87,.517,27,49,.551,18,38,.474,27,34,.794,135,32,89,.360,22,55,.400,10,34,.294,25,28,.893,99
96,MIL,2024-01-11,135,,BOS,W 135-102,240,52,92,.565,34,50,.680,18,42,.429,13,16,.813,135,34,91,.374,25,56,.446,9,35,.257,25,30,.833,102
97,SAC,2024-01-05,135,,TOR,W 135-130,240,52,100,.520,31,62,.500,21,38,.553,10,15,.667,135,47,87,.540,34,50,.680,13,37,.351,23,27,.852,130
98,ORL,2024-01-03,135,@,SAC,L 135-138 (2OT),290,44,90,.489,19,46,.413,25,44,.568,22,27,.815,135,51,105,.486,36,65,.554,15,40,.375,21,31,.677,138
99,CLE,2023-12-18,135,,HOU,W 135-130 (OT),265,47,97,.485,28,49,.571,19,48,.396,22,34,.647,135,47,102,.461,35,69,.507,12,33,.364,24,27,.889,130
100,PHI,2023-12-16,135,@,CHO,W 135-82,240,53,88,.602,39,57,.684,14,31,.452,15,17,.882,135,33,91,.363,26,56,.464,7,35,.200,9,11,.818,82
101,TOR,2023-12-13,135,,ATL,W 135-128,240,50,87,.575,32,53,.604,18,34,.529,17,24,.708,135,48,100,.480,30,59,.508,18,41,.439,14,19,.737,128
102,SAS,2023-11-30,135,,ATL,L 135-137,240,48,89,.539,30,48,.625,18,41,.439,21,23,.913,135,49,96,.510,35,63,.556,14,33,.424,25,29,.862,137
103,GSW,2024-02-03,134,@,ATL,L 134-141 (OT),265,50,112,.446,32,56,.571,18,56,.321,16,20,.800,134,55,114,.482,41,71,.577,14,43,.326,17,22,.773,141
104,UTA,2024-01-27,134,@,CHO,W 134-122,240,52,93,.559,35,52,.673,17,41,.415,13,17,.765,134,47,92,.511,34,60,.567,13,32,.406,15,21,.714,122
105,IND,2024-01-25,134,,PHI,W 134-122,240,53,93,.570,41,65,.631,12,28,.429,16,21,.762,134,42,87,.483,35,58,.603,7,29,.241,31,43,.721,122
106,SAC,2024-01-25,134,@,GSW,W 134-133,240,48,91,.527,26,43,.605,22,48,.458,16,19,.842,134,48,86,.558,29,49,.592,19,37,.514,18,23,.783,133
107,GSW,2024-01-24,134,,ATL,W 134-112,240,51,91,.560,35,58,.603,16,33,.485,16,22,.727,134,39,94,.415,25,51,.490,14,43,.326,20,26,.769,112
108,LAL,2024-01-21,134,,POR,W 134-110,240,47,86,.547,34,53,.642,13,33,.394,27,29,.931,134,42,90,.467,33,61,.541,9,29,.310,17,20,.850,110
109,OKC,2024-01-18,134,@,UTA,W 134-129,240,48,86,.558,34,54,.630,14,32,.438,24,28,.857,134,43,89,.483,30,57,.526,13,32,.406,30,36,.833,129
110,POR,2024-01-07,134,@,BRK,W 134-127 (OT),265,45,95,.474,25,57,.439,20,38,.526,24,30,.800,134,46,91,.505,32,54,.593,14,37,.378,21,25,.840,127
111,BOS,2023-12-31,134,@,SAS,W 134-101,240,51,95,.537,36,53,.679,15,42,.357,17,22,.773,134,40,94,.426,28,49,.571,12,45,.267,9,12,.750,101
112,POR,2023-12-29,134,,SAS,W 134-128,240,48,95,.505,32,68,.471,16,27,.593,22,27,.815,134,48,94,.511,34,61,.557,14,33,.424,18,25,.720,128
113,OKC,2023-12-21,134,,LAC,W 134-115,240,51,87,.586,35,53,.660,16,34,.471,16,18,.889,134,44,93,.473,27,50,.540,17,43,.395,10,12,.833,115
114,ATL,2023-12-20,134,@,HOU,W 134-127,240,47,91,.516,30,51,.588,17,40,.425,23,28,.821,134,44,89,.494,28,55,.509,16,34,.471,23,23,1.000,127
115,OKC,2023-12-11,134,,UTA,W 134-120,240,50,96,.521,32,58,.552,18,38,.474,16,17,.941,134,44,92,.478,32,54,.593,12,38,.316,20,21,.952,120
116,DEN,2023-11-29,134,,HOU,W 134-124,240,48,95,.505,29,52,.558,19,43,.442,19,26,.731,134,47,86,.547,31,45,.689,16,41,.390,14,19,.737,124
117,OKC,2023-11-19,134,@,POR,W 134-91,240,49,81,.605,27,45,.600,22,36,.611,14,14,1.000,134,34,85,.400,25,51,.490,9,34,.265,14,21,.667,91
118,LAL,2023-11-14,134,,MEM,W 134-107,240,47,81,.580,25,46,.543,22,35,.629,18,24,.750,134,39,106,.368,19,53,.358,20,53,.377,9,12,.750,107
119,IND,2023-11-08,134,,UTA,W 134-118,240,52,101,.515,39,60,.650,13,41,.317,17,20,.850,134,45,96,.469,34,69,.493,11,27,.407,17,18,.944,118
120,DEN,2023-11-06,134,,NOP,W 134-116,240,51,95,.537,36,56,.643,15,39,.385,17,23,.739,134,45,90,.500,32,60,.533,13,30,.433,13,15,.867,116
121,DET,2024-02-07,133,@,SAC,W 133-120,240,47,84,.560,30,53,.566,17,31,.548,22,22,1.000,133,45,95,.474,30,51,.588,15,44,.341,15,22,.682,120
122,SAC,2024-02-02,133,@,IND,W 133-122,240,51,90,.567,38,56,.679,13,34,.382,18,28,.643,133,46,85,.541,36,56,.643,10,29,.345,20,24,.833,122
123,IND,2024-01-26,133,,PHO,W 133-131,240,58,109,.532,50,83,.602,8,26,.308,9,15,.600,133,51,89,.573,38,59,.644,13,30,.433,16,18,.889,131
124,GSW,2024-01-25,133,,SAC,L 133-134,240,48,86,.558,29,49,.592,19,37,.514,18,23,.783,133,48,91,.527,26,43,.605,22,48,.458,16,19,.842,134
125,PHI,2024-01-22,133,,SAS,W 133-123,240,48,97,.495,43,77,.558,5,20,.250,32,40,.800,133,43,93,.462,30,52,.577,13,41,.317,24,27,.889,123
126,IND,2024-01-08,133,,BOS,W 133-131,240,48,91,.527,29,51,.569,19,40,.475,18,22,.818,133,47,90,.522,30,55,.545,17,35,.486,20,29,.690,131
127,TOR,2024-01-07,133,@,GSW,W 133-118,240,55,94,.585,40,61,.656,15,33,.455,8,14,.571,133,45,100,.450,31,54,.574,14,46,.304,14,15,.933,118
128,NOP,2024-01-07,133,@,SAC,W 133-100,240,50,82,.610,31,47,.660,19,35,.543,14,16,.875,133,38,91,.418,23,46,.500,15,45,.333,9,12,.750,100
129,PHO,2023-12-29,133,,CHO,W 133-119,240,46,74,.622,28,44,.636,18,30,.600,23,24,.958,133,44,92,.478,21,46,.457,23,46,.500,8,8,1.000,119
130,LAL,2023-12-28,133,,CHO,W 133-112,240,52,97,.536,37,67,.552,15,30,.500,14,14,1.000,133,40,85,.471,25,52,.481,15,33,.455,17,28,.607,112
131,MIL,2023-12-11,133,,CHI,W 133-129 (OT),265,44,86,.512,29,49,.592,15,37,.405,30,37,.811,133,47,114,.412,32,80,.400,15,34,.441,20,25,.800,129
132,BOS,2023-12-08,133,,NYK,W 133-123,240,48,91,.527,29,44,.659,19,47,.404,18,21,.857,133,44,88,.500,29,51,.569,15,37,.405,20,27,.741,123
133,LAL,2023-12-07,133,,NOP,W 133-89,240,47,86,.547,30,51,.588,17,35,.486,22,29,.759,133,34,95,.358,27,64,.422,7,31,.226,14,20,.700,89
134,OKC,2023-11-30,133,,LAL,W 133-110,240,50,94,.532,36,52,.692,14,42,.333,19,22,.864,133,36,81,.444,25,48,.521,11,33,.333,27,32,.844,110
135,LAL,2023-11-29,133,@,DET,W 133-107,240,45,88,.511,33,54,.611,12,34,.353,31,38,.816,133,40,97,.412,25,61,.410,15,36,.417,12,14,.857,107
136,PHO,2023-11-15,133,,MIN,W 133-115,240,51,85,.600,34,54,.630,17,31,.548,14,15,.933,133,42,92,.457,37,65,.569,5,27,.185,26,28,.929,115
137,UTA,2023-11-01,133,,MEM,W 133-109,240,47,87,.540,25,44,.568,22,43,.512,17,24,.708,133,35,96,.365,21,42,.500,14,54,.259,25,32,.781,109
138,BRK,2023-10-30,133,@,CHO,W 133-121,240,49,87,.563,37,54,.685,12,33,.364,23,32,.719,133,47,96,.490,39,65,.600,8,31,.258,19,20,.950,121
139,IND,2024-02-06,132,,HOU,W 132-129,240,54,86,.628,39,54,.722,15,32,.469,9,14,.643,132,50,97,.515,38,72,.528,12,25,.480,17,23,.739,129
140,CHI,2024-01-25,132,@,LAL,L 132-141,240,47,88,.534,35,51,.686,12,37,.324,26,29,.897,132,53,87,.609,33,56,.589,20,31,.645,15,20,.750,141
141,PHO,2024-01-24,132,@,DAL,W 132-109,240,51,85,.600,37,51,.725,14,34,.412,16,22,.727,132,41,89,.461,24,46,.522,17,43,.395,10,18,.556,109
142,NOP,2024-01-17,132,,CHO,W 132-112,240,44,88,.500,19,41,.463,25,47,.532,19,23,.826,132,39,90,.433,20,45,.444,19,45,.422,15,18,.833,112
143,UTA,2024-01-15,132,,IND,W 132-105,240,45,81,.556,34,56,.607,11,25,.440,31,35,.886,132,38,95,.400,29,64,.453,9,31,.290,20,25,.800,105
144,UTA,2024-01-13,132,,LAL,W 132-125,240,42,93,.452,30,56,.536,12,37,.324,36,39,.923,132,46,92,.500,33,63,.524,13,29,.448,20,24,.833,125
145,PHI,2024-01-10,132,@,ATL,L 132-139 (OT),265,46,102,.451,34,68,.500,12,34,.353,28,33,.848,132,48,102,.471,36,68,.529,12,34,.353,31,42,.738,139
146,LAL,2024-01-09,132,,TOR,W 132-131,240,44,81,.543,28,45,.622,16,36,.444,28,36,.778,132,53,94,.564,36,59,.610,17,35,.486,8,13,.615,131
147,UTA,2024-01-08,132,@,MIL,W 132-116,240,47,90,.522,27,46,.587,20,44,.455,18,22,.818,132,42,94,.447,25,58,.431,17,36,.472,15,19,.789,116
148,DAL,2023-12-30,132,@,GSW,W 132-122,240,49,88,.557,33,48,.688,16,40,.400,18,22,.818,132,47,103,.456,28,55,.509,19,48,.396,9,13,.692,122
149,TOR,2023-12-27,132,@,WAS,W 132-102,240,52,91,.571,37,53,.698,15,38,.395,13,19,.684,132,42,90,.467,34,57,.596,8,33,.242,10,15,.667,102
150,MIL,2023-12-19,132,,SAS,W 132-119,240,50,106,.472,32,57,.561,18,49,.367,14,18,.778,132,46,96,.479,37,66,.561,9,30,.300,18,21,.857,119
151,GSW,2023-12-19,132,,BOS,W 132-126 (OT),265,50,109,.459,30,59,.508,20,50,.400,12,14,.857,132,47,114,.412,30,56,.536,17,58,.293,15,17,.882,126
152,LAC,2023-12-11,132,,POR,W 132-127,240,49,89,.551,36,55,.655,13,34,.382,21,22,.955,132,43,90,.478,24,50,.480,19,40,.475,22,26,.846,127
153,MIL,2023-12-02,132,,ATL,W 132-121,240,53,89,.596,39,56,.696,14,33,.424,12,15,.800,132,45,101,.446,30,63,.476,15,38,.395,16,21,.762,121
154,IND,2023-11-30,132,@,MIA,L 132-142,240,50,98,.510,39,55,.709,11,43,.256,21,32,.656,132,48,86,.558,40,65,.615,8,21,.381,38,45,.844,142
155,DEN,2023-11-26,132,,SAS,W 132-120,240,50,89,.562,38,61,.623,12,28,.429,20,25,.800,132,42,93,.452,28,56,.500,14,37,.378,22,26,.846,120
156,TOR,2023-11-22,132,@,IND,W 132-131,240,48,90,.533,37,63,.587,11,27,.407,25,30,.833,132,50,91,.549,32,52,.615,18,39,.462,13,16,.813,131
157,MIL,2023-11-18,132,,DAL,W 132-125,240,49,94,.521,32,49,.653,17,45,.378,17,20,.850,132,51,103,.495,35,56,.625,16,47,.340,7,10,.700,125
158,IND,2023-11-14,132,@,PHI,W 132-126,240,48,93,.516,35,56,.625,13,37,.351,23,33,.697,132,43,86,.500,37,64,.578,6,22,.273,34,35,.971,126
159,SAC,2023-11-13,132,,CLE,W 132-120,240,49,83,.590,29,41,.707,20,42,.476,14,22,.636,132,45,91,.495,29,56,.518,16,35,.457,14,17,.824,120
160,WAS,2023-11-08,132,@,CHO,W 132-116,240,47,97,.485,29,54,.537,18,43,.419,20,25,.800,132,41,79,.519,33,54,.611,8,25,.320,26,35,.743,116
161,SAS,2023-11-02,132,@,PHO,W 132-121,240,51,98,.520,33,61,.541,18,37,.486,12,13,.923,132,43,80,.538,27,48,.563,16,32,.500,19,26,.731,121
162,SAC,2023-10-29,132,,LAL,W 132-127 (OT),265,49,104,.471,32,56,.571,17,48,.354,17,24,.708,132,43,98,.439,28,53,.528,15,45,.333,26,34,.765,127
163,BOS,2024-02-04,131,,MEM,W 131-91,240,48,99,.485,29,48,.604,19,51,.373,16,18,.889,131,35,92,.380,24,54,.444,11,38,.289,10,12,.833,91
164,DAL,2024-01-29,131,,ORL,W 131-129,240,43,69,.623,30,42,.714,13,27,.481,32,43,.744,131,45,88,.511,27,50,.540,18,38,.474,21,28,.750,129
165,PHO,2024-01-26,131,@,IND,L 131-133,240,51,89,.573,38,59,.644,13,30,.433,16,18,.889,131,58,109,.532,50,83,.602,8,26,.308,9,15,.600,133
166,HOU,2024-01-24,131,,POR,L 131-137 (OT),265,50,94,.532,38,58,.655,12,36,.333,19,22,.864,131,50,98,.510,35,63,.556,15,35,.429,22,24,.917,137
167,SAS,2024-01-20,131,@,WAS,W 131-127,240,51,96,.531,39,65,.600,12,31,.387,17,23,.739,131,49,103,.476,40,74,.541,9,29,.310,20,23,.870,127
168,CHI,2024-01-12,131,,GSW,L 131-140,240,50,86,.581,32,46,.696,18,40,.450,13,16,.813,131,49,94,.521,29,47,.617,20,47,.426,22,30,.733,140
169,SAC,2024-01-09,131,@,DET,W 131-110,240,54,94,.574,41,61,.672,13,33,.394,10,14,.714,131,40,85,.471,26,48,.542,14,37,.378,16,21,.762,110
170,TOR,2024-01-09,131,@,LAL,L 131-132,240,53,94,.564,36,59,.610,17,35,.486,8,13,.615,131,44,81,.543,28,45,.622,16,36,.444,28,36,.778,132
171,BOS,2024-01-08,131,@,IND,L 131-133,240,47,90,.522,30,55,.545,17,35,.486,20,29,.690,131,48,91,.527,29,51,.569,19,40,.475,18,22,.818,133
172,DEN,2024-01-07,131,,DET,W 131-114,240,47,80,.588,37,53,.698,10,27,.370,27,31,.871,131,42,89,.472,33,65,.508,9,24,.375,21,30,.700,114
173,LAC,2024-01-03,131,@,PHO,W 131-122,240,42,76,.553,24,42,.571,18,34,.529,29,32,.906,131,42,79,.532,27,44,.614,15,35,.429,23,26,.885,122
174,PHI,2023-12-29,131,@,HOU,W 131-127,240,45,86,.523,33,53,.623,12,33,.364,29,33,.879,131,49,91,.538,35,61,.574,14,30,.467,15,21,.714,127
175,WAS,2023-12-18,131,@,SAC,L 131-143,240,44,85,.518,26,47,.553,18,38,.474,25,30,.833,131,53,100,.530,36,57,.632,17,43,.395,20,26,.769,143
176,DAL,2023-12-16,131,@,POR,W 131-120,240,48,97,.495,32,50,.640,16,47,.340,19,21,.905,131,47,94,.500,40,62,.645,7,32,.219,19,22,.864,120
177,IND,2023-12-11,131,@,DET,W 131-123,240,52,92,.565,39,61,.639,13,31,.419,14,19,.737,131,45,81,.556,35,52,.673,10,29,.345,23,30,.767,123
178,SAC,2023-12-11,131,,BRK,W 131-118,240,48,94,.511,23,49,.469,25,45,.556,10,14,.714,131,42,88,.477,28,59,.475,14,29,.483,20,21,.952,118
179,PHI,2023-12-06,131,@,WAS,W 131-126,240,47,92,.511,39,65,.600,8,27,.296,29,34,.853,131,52,92,.565,38,57,.667,14,35,.400,8,8,1.000,126
180,LAC,2023-11-29,131,@,SAC,W 131-117,240,50,93,.538,36,65,.554,14,28,.500,17,22,.773,131,40,86,.465,27,45,.600,13,41,.317,24,28,.857,117
181,MIL,2023-11-28,131,@,MIA,W 131-124,240,47,88,.534,34,53,.642,13,35,.371,24,27,.889,131,48,94,.511,34,64,.531,14,30,.467,14,21,.667,124
182,MIL,2023-11-24,131,,WAS,W 131-128,240,48,92,.522,39,61,.639,9,31,.290,26,33,.788,131,48,100,.480,33,63,.524,15,37,.405,17,21,.810,128
183,IND,2023-11-22,131,,TOR,L 131-132,240,50,91,.549,32,52,.615,18,39,.462,13,16,.813,131,48,90,.533,37,63,.587,11,27,.407,25,30,.833,132
184,LAL,2023-11-21,131,,UTA,W 131-99,240,49,86,.570,38,57,.667,11,29,.379,22,27,.815,131,38,98,.388,27,54,.500,11,44,.250,12,16,.750,99
185,PHO,2023-11-17,131,@,UTA,W 131-128,240,45,86,.523,27,53,.509,18,33,.545,23,26,.885,131,43,85,.506,27,49,.551,16,36,.444,26,31,.839,128
186,NOP,2023-11-14,131,,DAL,W 131-110,240,49,94,.521,35,56,.625,14,38,.368,19,26,.731,131,38,90,.422,24,48,.500,14,42,.333,20,26,.769,110
187,POR,2024-01-29,130,,PHI,W 130-104,240,46,84,.548,34,56,.607,12,28,.429,26,29,.897,130,37,83,.446,32,54,.593,5,29,.172,25,28,.893,104
188,BRK,2024-01-19,130,@,LAL,W 130-112,240,50,95,.526,31,48,.646,19,47,.404,11,14,.786,130,40,90,.444,28,57,.491,12,33,.364,20,24,.833,112
189,SAS,2024-01-10,130,@,DET,W 130-108,240,49,94,.521,40,67,.597,9,27,.333,23,27,.852,130,44,96,.458,34,64,.531,10,32,.313,10,13,.769,108
190,TOR,2024-01-05,130,@,SAC,L 130-135,240,47,87,.540,34,50,.680,13,37,.351,23,27,.852,130,52,100,.520,31,62,.500,21,38,.553,10,15,.667,135
191,DEN,2024-01-04,130,@,GSW,W 130-127,240,48,85,.565,39,59,.661,9,26,.346,25,29,.862,130,49,90,.544,34,54,.630,15,36,.417,14,16,.875,127
192,MIL,2024-01-03,130,@,IND,L 130-142,240,46,92,.500,32,55,.582,14,37,.378,24,32,.750,130,50,90,.556,36,55,.655,14,35,.400,28,34,.824,142
193,ATL,2023-12-31,130,@,WAS,W 130-126,240,47,95,.495,35,63,.556,12,32,.375,24,37,.649,130,46,98,.469,29,45,.644,17,53,.321,17,21,.810,126
194,UTA,2023-12-26,130,@,SAS,W 130-118,240,47,95,.495,31,52,.596,16,43,.372,20,22,.909,130,44,98,.449,28,63,.444,16,35,.457,14,21,.667,118
195,POR,2023-12-26,130,,SAC,W 130-113,240,49,98,.500,33,58,.569,16,40,.400,16,20,.800,130,45,93,.484,35,51,.686,10,42,.238,13,16,.813,113
196,MIL,2023-12-23,130,@,NYK,W 130-111,240,48,91,.527,32,59,.542,16,32,.500,18,23,.783,130,41,93,.441,32,64,.500,9,29,.310,20,21,.952,111
197,HOU,2023-12-18,130,@,CLE,L 130-135 (OT),265,47,102,.461,35,69,.507,12,33,.364,24,27,.889,130,47,97,.485,28,49,.571,19,48,.396,22,34,.647,135
198,ATL,2023-12-18,130,,DET,W 130-124,240,46,85,.541,30,49,.612,16,36,.444,22,27,.815,130,48,94,.511,39,72,.542,9,22,.409,19,27,.704,124
199,DEN,2023-12-18,130,,DAL,W 130-104,240,49,87,.563,35,61,.574,14,26,.538,18,22,.818,130,41,92,.446,28,54,.519,13,38,.342,9,19,.474,104
200,TOR,2023-12-11,130,@,NYK,L 130-136,240,47,96,.490,33,57,.579,14,39,.359,22,30,.733,130,52,86,.605,35,57,.614,17,29,.586,15,23,.652,136
201,ORL,2023-12-01,130,,WAS,W 130-125,240,46,89,.517,34,58,.586,12,31,.387,26,33,.788,130,45,89,.506,32,61,.525,13,28,.464,22,31,.710,125
202,ORL,2023-11-26,130,,CHO,W 130-117,240,47,87,.540,37,60,.617,10,27,.370,26,33,.788,130,44,83,.530,31,53,.585,13,30,.433,16,25,.640,117
203,OKC,2023-11-18,130,@,GSW,W 130-123 (OT),265,52,100,.520,44,77,.571,8,23,.348,18,20,.900,130,44,97,.454,26,51,.510,18,46,.391,17,21,.810,123
204,MIL,2023-11-17,130,@,CHO,W 130-99,240,49,89,.551,27,44,.614,22,45,.489,10,13,.769,130,37,91,.407,31,65,.477,6,26,.231,19,22,.864,99
205,DAL,2023-11-15,130,@,WAS,W 130-117,240,48,92,.522,31,50,.620,17,42,.405,17,29,.586,130,43,89,.483,31,53,.585,12,36,.333,19,23,.826,117
206,CHI,2023-11-06,130,,UTA,W 130-113,240,48,93,.516,30,59,.508,18,34,.529,16,19,.842,130,41,86,.477,25,43,.581,16,43,.372,15,17,.882,113
207,LAL,2023-11-01,130,,LAC,W 130-125 (OT),265,46,90,.511,35,58,.603,11,32,.344,27,36,.750,130,47,99,.475,33,65,.508,14,34,.412,17,27,.630,125
208,TOR,2023-11-01,130,,MIL,W 130-111,240,51,91,.560,36,53,.679,15,38,.395,13,14,.929,130,35,76,.461,22,42,.524,13,34,.382,28,38,.737,111
209,ATL,2023-11-01,130,,WAS,W 130-121,240,46,92,.500,37,60,.617,9,32,.281,29,32,.906,130,51,101,.505,41,61,.672,10,40,.250,9,14,.643,121
210,GSW,2023-10-30,130,@,NOP,W 130-102,240,51,98,.520,36,57,.632,15,41,.366,13,20,.650,130,38,93,.409,28,54,.519,10,39,.256,16,26,.615,102
211,SAC,2023-10-25,130,@,UTA,W 130-114,240,47,102,.461,28,51,.549,19,51,.373,17,20,.850,130,41,91,.451,32,63,.508,9,28,.321,23,31,.742,114
212,HOU,2024-02-06,129,@,IND,L 129-132,240,50,97,.515,38,72,.528,12,25,.480,17,23,.739,129,54,86,.628,39,54,.722,15,32,.469,9,14,.643,132
213,CHI,2024-02-06,129,,MIN,W 129-123 (OT),265,45,93,.484,33,63,.524,12,30,.400,27,32,.844,129,42,92,.457,22,47,.468,20,45,.444,19,26,.731,123
214,MIL,2024-02-03,129,@,DAL,W 129-117,240,50,88,.568,38,58,.655,12,30,.400,17,25,.680,129,40,81,.494,24,42,.571,16,39,.410,21,23,.913,117
215,ATL,2024-02-02,129,,PHO,W 129-120,240,49,95,.516,32,51,.627,17,44,.386,14,18,.778,129,47,88,.534,33,51,.647,14,37,.378,12,14,.857,120
216,BOS,2024-01-30,129,,IND,W 129-124,240,47,87,.540,30,51,.588,17,36,.472,18,22,.818,129,50,108,.463,38,69,.551,12,39,.308,12,15,.800,124
217,ORL,2024-01-29,129,@,DAL,L 129-131,240,45,88,.511,27,50,.540,18,38,.474,21,28,.750,129,43,69,.623,30,42,.714,13,27,.481,32,43,.744,131
218,UTA,2024-01-18,129,,OKC,L 129-134,240,43,89,.483,30,57,.526,13,32,.406,30,36,.833,129,48,86,.558,34,54,.630,14,32,.438,24,28,.857,134
219,DET,2024-01-15,129,@,WAS,W 129-117,240,50,90,.556,38,59,.644,12,31,.387,17,23,.739,129,44,95,.463,25,54,.463,19,41,.463,10,11,.909,117
220,MIL,2024-01-13,129,,GSW,W 129-118,240,51,94,.543,38,63,.603,13,31,.419,14,17,.824,129,47,98,.480,32,62,.516,15,36,.417,9,14,.643,118
221,NOP,2023-12-31,129,,LAL,W 129-109,240,45,87,.517,28,53,.528,17,34,.500,22,27,.815,129,39,82,.476,29,50,.580,10,32,.313,21,25,.840,109
222,DET,2023-12-30,129,,TOR,W 129-127,240,41,82,.500,29,54,.537,12,28,.429,35,40,.875,129,46,91,.505,34,67,.507,12,24,.500,23,28,.821,127
223,OKC,2023-12-27,129,,NYK,W 129-120,240,49,90,.544,35,58,.603,14,32,.438,17,22,.773,129,41,82,.500,27,48,.563,14,34,.412,24,30,.800,120
224,PHO,2023-12-27,129,@,HOU,W 129-113,240,47,82,.573,33,49,.673,14,33,.424,21,26,.808,129,40,96,.417,23,55,.418,17,41,.415,16,22,.727,113
225,OKC,2023-12-26,129,,MIN,W 129-106,240,49,81,.605,31,42,.738,18,39,.462,13,16,.813,129,34,73,.466,22,46,.478,12,27,.444,26,32,.813,106
226,NYK,2023-12-25,129,,MIL,W 129-122,240,50,92,.543,42,66,.636,8,26,.308,21,26,.808,129,45,95,.474,32,53,.604,13,42,.310,19,24,.792,122
227,LAL,2023-12-23,129,@,OKC,W 129-120,240,47,90,.522,31,58,.534,16,32,.500,19,23,.826,129,46,95,.484,33,54,.611,13,41,.317,15,19,.789,120
228,GSW,2023-12-22,129,,WAS,W 129-118,240,47,97,.485,29,52,.558,18,45,.400,17,20,.850,129,44,97,.454,33,62,.532,11,35,.314,19,24,.792,118
229,SAS,2023-12-15,129,,LAL,W 129-115,240,47,95,.495,29,53,.547,18,42,.429,17,19,.895,129,43,89,.483,32,53,.604,11,36,.306,18,28,.643,115
230,PHI,2023-12-13,129,@,DET,W 129-111,240,45,87,.517,34,57,.596,11,30,.367,28,34,.824,129,39,88,.443,29,55,.527,10,33,.303,23,30,.767,111
231,CHI,2023-12-11,129,@,MIL,L 129-133 (OT),265,47,114,.412,32,80,.400,15,34,.441,20,25,.800,129,44,86,.512,29,49,.592,15,37,.405,30,37,.811,133
232,DEN,2023-12-11,129,@,ATL,W 129-122,240,47,88,.534,35,59,.593,12,29,.414,23,29,.793,129,44,96,.458,27,52,.519,17,44,.386,17,18,.944,122
233,BRK,2023-12-02,129,,ORL,W 129-101,240,46,91,.505,32,57,.561,14,34,.412,23,31,.742,129,35,88,.398,26,59,.441,9,29,.310,22,27,.815,101
234,MIA,2023-12-02,129,,IND,L 129-144,240,48,89,.539,36,64,.563,12,25,.480,21,24,.875,129,56,85,.659,40,53,.755,16,32,.500,16,20,.800,144
235,CHO,2023-11-30,129,@,BRK,W 129-128,240,46,91,.505,25,55,.455,21,36,.583,16,16,1.000,129,52,105,.495,38,69,.551,14,36,.389,10,15,.667,128
236,MIA,2023-11-22,129,@,CLE,W 129-96,240,46,88,.523,26,53,.491,20,35,.571,17,21,.810,129,36,77,.468,22,47,.468,14,30,.467,10,14,.714,96
237,WAS,2023-11-20,129,,MIL,L 129-142,240,55,99,.556,45,70,.643,10,29,.345,9,11,.818,129,55,94,.585,44,65,.677,11,29,.379,21,28,.750,142
238,NOP,2023-11-20,129,,SAC,W 129-93,240,50,92,.543,38,64,.594,12,28,.429,17,21,.810,129,33,87,.379,22,42,.524,11,45,.244,16,24,.667,93
239,SAC,2023-11-19,129,@,DAL,W 129-113,240,48,90,.533,31,50,.620,17,40,.425,16,21,.762,129,41,88,.466,29,54,.537,12,34,.353,19,26,.731,113
240,SAC,2023-11-17,129,@,SAS,W 129-120,240,46,85,.541,28,43,.651,18,42,.429,19,24,.792,129,43,92,.467,28,56,.500,15,36,.417,19,23,.826,120
241,NYK,2023-11-12,129,,CHO,W 129-107,240,47,87,.540,32,51,.627,15,36,.417,20,30,.667,129,44,94,.468,32,59,.542,12,35,.343,7,11,.636,107
242,MIL,2023-11-06,129,@,BRK,W 129-125,240,46,96,.479,30,48,.625,16,48,.333,21,24,.875,129,49,101,.485,33,56,.589,16,45,.356,11,13,.846,125
243,CLE,2024-01-31,128,,DET,W 128-121,240,47,89,.528,35,54,.648,12,35,.343,22,23,.957,128,45,81,.556,29,50,.580,16,31,.516,15,19,.789,121
244,CHO,2024-01-22,128,@,MIN,W 128-125,240,50,88,.568,36,51,.706,14,37,.378,14,18,.778,128,44,84,.524,26,43,.605,18,41,.439,19,25,.760,125
245,LAC,2024-01-16,128,,OKC,W 128-117,240,47,87,.540,27,44,.614,20,43,.465,14,23,.609,128,42,83,.506,26,49,.531,16,34,.471,17,20,.850,117
246,LAC,2024-01-12,128,@,MEM,W 128-119,240,49,89,.551,34,58,.586,15,31,.484,15,20,.750,128,41,95,.432,23,51,.451,18,44,.409,19,27,.704,119
247,DAL,2024-01-11,128,,NYK,W 128-124,240,44,88,.500,27,47,.574,17,41,.415,23,30,.767,128,44,89,.494,30,47,.638,14,42,.333,22,28,.786,124
248,OKC,2024-01-10,128,@,MIA,W 128-120,240,51,86,.593,37,53,.698,14,33,.424,12,16,.750,128,41,89,.461,26,53,.491,15,36,.417,23,28,.821,120
249,WAS,2024-01-08,128,,OKC,L 128-136,240,44,89,.494,29,57,.509,15,32,.469,25,29,.862,128,52,88,.591,38,60,.633,14,28,.500,18,24,.750,136
250,NYK,2024-01-05,128,@,PHI,W 128-92,240,43,89,.483,25,48,.521,18,41,.439,24,25,.960,128,33,81,.407,27,58,.466,6,23,.261,20,27,.741,92
251,SAS,2023-12-29,128,@,POR,L 128-134,240,48,94,.511,34,61,.557,14,33,.424,18,25,.720,128,48,95,.505,32,68,.471,16,27,.593,22,27,.815,134
252,BOS,2023-12-28,128,,DET,W 128-122 (OT),265,48,99,.485,37,60,.617,11,39,.282,21,25,.840,128,48,101,.475,34,58,.586,14,43,.326,12,19,.632,122
253,DAL,2023-12-25,128,@,PHO,W 128-114,240,45,84,.536,29,40,.725,16,44,.364,22,30,.733,128,40,90,.444,26,49,.531,14,41,.341,20,25,.800,114
254,MIL,2023-12-17,128,,HOU,W 128-119,240,45,90,.500,32,54,.593,13,36,.361,25,32,.781,128,45,85,.529,34,58,.586,11,27,.407,18,21,.857,119
255,BOS,2023-12-15,128,,ORL,W 128-111,240,48,92,.522,30,50,.600,18,42,.429,14,20,.700,128,42,87,.483,28,52,.538,14,35,.400,13,18,.722,111
256,SAC,2023-12-14,128,,OKC,W 128-123,240,47,95,.495,29,50,.580,18,45,.400,16,21,.762,128,44,102,.431,33,66,.500,11,36,.306,24,27,.889,123
257,ATL,2023-12-13,128,@,TOR,L 128-135,240,48,100,.480,30,59,.508,18,41,.439,14,19,.737,128,50,87,.575,32,53,.604,18,34,.529,17,24,.708,135
258,IND,2023-12-07,128,@,MIL,W 128-119,240,50,102,.490,43,69,.623,7,33,.212,21,25,.840,128,43,96,.448,31,63,.492,12,33,.364,21,28,.750,119
259,BRK,2023-11-30,128,,CHO,L 128-129,240,52,105,.495,38,69,.551,14,36,.389,10,15,.667,128,46,91,.505,25,55,.455,21,36,.583,16,16,1.000,129
260,CLE,2023-11-28,128,,ATL,W 128-105,240,50,93,.538,37,57,.649,13,36,.361,15,17,.882,128,35,101,.347,22,57,.386,13,44,.295,22,24,.917,105
261,WAS,2023-11-24,128,@,MIL,L 128-131,240,48,100,.480,33,63,.524,15,37,.405,17,21,.810,128,48,92,.522,39,61,.639,9,31,.290,26,33,.788,131
262,ORL,2023-11-19,128,@,IND,W 128-116,240,43,87,.494,36,67,.537,7,20,.350,35,42,.833,128,42,95,.442,34,64,.531,8,31,.258,24,31,.774,116
263,UTA,2023-11-17,128,,PHO,L 128-131,240,43,85,.506,27,49,.551,16,36,.444,26,31,.839,128,45,86,.523,27,53,.509,18,33,.545,23,26,.885,131
264,OKC,2023-11-16,128,@,GSW,W 128-109,240,44,87,.506,25,55,.455,19,32,.594,21,23,.913,128,40,98,.408,26,57,.456,14,41,.341,15,19,.789,109
265,MIL,2023-11-15,128,@,TOR,W 128-112,240,44,85,.518,24,46,.522,20,39,.513,20,21,.952,128,38,96,.396,29,63,.460,9,33,.273,27,31,.871,112
266,OKC,2023-11-08,128,,CLE,W 128-120,240,44,86,.512,32,58,.552,12,28,.429,28,30,.933,128,42,83,.506,33,54,.611,9,29,.310,27,37,.730,120
267,HOU,2023-11-08,128,,LAL,W 128-94,240,51,93,.548,37,60,.617,14,33,.424,12,19,.632,128,36,85,.424,29,60,.483,7,25,.280,15,24,.625,94
268,WAS,2023-11-06,128,@,PHI,L 128-146,240,49,96,.510,35,62,.565,14,34,.412,16,20,.800,128,51,91,.560,39,60,.650,12,31,.387,32,36,.889,146
269,HOU,2023-11-01,128,,CHO,W 128-119,240,44,84,.524,23,47,.489,21,37,.568,19,23,.826,128,45,90,.500,34,63,.540,11,27,.407,18,25,.720,119
270,DEN,2023-10-29,128,@,OKC,W 128-95,240,53,88,.602,42,61,.689,11,27,.407,11,13,.846,128,37,90,.411,31,58,.534,6,32,.188,15,18,.833,95
271,GSW,2024-02-07,127,@,PHI,W 127-104,240,47,94,.500,31,56,.554,16,38,.421,17,22,.773,127,41,98,.418,33,66,.500,8,32,.250,14,14,1.000,104
272,TOR,2024-02-04,127,@,OKC,L 127-135 (2OT),290,48,101,.475,34,66,.515,14,35,.400,17,21,.810,127,52,110,.473,29,47,.617,23,63,.365,8,8,1.000,135
273,PHI,2024-02-01,127,@,UTA,W 127-124,240,47,94,.500,33,62,.532,14,32,.438,19,21,.905,127,45,87,.517,33,51,.647,12,36,.333,22,25,.880,124
274,LAC,2024-01-26,127,@,TOR,W 127-107,240,48,95,.505,39,63,.619,9,32,.281,22,24,.917,127,44,96,.458,38,64,.594,6,32,.188,13,22,.591,107
275,LAC,2024-01-23,127,,LAL,W 127-116,240,52,88,.591,38,61,.623,14,27,.519,9,12,.750,127,45,92,.489,34,60,.567,11,32,.344,15,22,.682,116
276,WAS,2024-01-20,127,,SAS,L 127-131,240,49,103,.476,40,74,.541,9,29,.310,20,23,.870,127,51,96,.531,39,65,.600,12,31,.387,17,23,.739,131
277,HOU,2024-01-20,127,,UTA,W 127-126 (OT),265,50,117,.427,37,78,.474,13,39,.333,14,22,.636,127,48,105,.457,35,62,.565,13,43,.302,17,22,.773,126
278,LAL,2024-01-17,127,,DAL,W 127-110,240,49,91,.538,37,63,.587,12,28,.429,17,24,.708,127,42,91,.462,31,51,.608,11,40,.275,15,18,.833,110
279,PHO,2024-01-14,127,@,POR,W 127-116,240,46,76,.605,33,48,.688,13,28,.464,22,27,.815,127,40,89,.449,20,47,.426,20,42,.476,16,22,.727,116
280,WAS,2024-01-13,127,@,ATL,W 127-99,240,47,97,.485,35,65,.538,12,32,.375,21,26,.808,127,32,93,.344,21,53,.396,11,40,.275,24,33,.727,99
281,PHO,2024-01-11,127,@,LAL,W 127-109,240,46,93,.495,32,54,.593,14,39,.359,21,23,.913,127,40,80,.500,27,46,.587,13,34,.382,16,25,.640,109
282,BOS,2024-01-10,127,,MIN,W 127-120 (OT),265,39,90,.433,20,43,.465,19,47,.404,30,31,.968,127,44,95,.463,30,61,.492,14,34,.412,18,20,.900,120
283,BRK,2024-01-07,127,,POR,L 127-134 (OT),265,46,91,.505,32,54,.593,14,37,.378,21,25,.840,127,45,95,.474,25,57,.439,20,38,.526,24,30,.800,134
284,MEM,2024-01-05,127,@,LAL,W 127-113,240,44,82,.537,21,37,.568,23,45,.511,16,20,.800,127,42,85,.494,32,57,.561,10,28,.357,19,27,.704,113
285,GSW,2024-01-04,127,,DEN,L 127-130,240,49,90,.544,34,54,.630,15,36,.417,14,16,.875,127,48,85,.565,39,59,.661,9,26,.346,25,29,.862,130
286,OKC,2024-01-02,127,,BOS,W 127-123,240,48,91,.527,30,51,.588,18,40,.450,13,17,.765,127,42,92,.457,27,52,.519,15,40,.375,24,29,.828,123
287,UTA,2024-01-01,127,,DAL,W 127-90,240,49,96,.510,37,52,.712,12,44,.273,17,18,.944,127,37,93,.398,26,53,.491,11,40,.275,5,10,.500,90
288,TOR,2023-12-30,127,@,DET,L 127-129,240,46,91,.505,34,67,.507,12,24,.500,23,28,.821,127,41,82,.500,29,54,.537,12,28,.429,35,40,.875,129
289,HOU,2023-12-29,127,,PHI,L 127-131,240,49,91,.538,35,61,.574,14,30,.467,15,21,.714,127,45,86,.523,33,53,.623,12,33,.364,29,33,.879,131
290,ORL,2023-12-26,127,@,WAS,W 127-119,240,49,93,.527,37,67,.552,12,26,.462,17,25,.680,127,43,87,.494,27,45,.600,16,42,.381,17,21,.810,119
291,PHI,2023-12-20,127,,MIN,W 127-113,240,45,84,.536,37,62,.597,8,22,.364,29,32,.906,127,42,82,.512,33,57,.579,9,25,.360,20,24,.833,113
292,HOU,2023-12-20,127,,ATL,L 127-134,240,44,89,.494,28,55,.509,16,34,.471,23,23,1.000,127,47,91,.516,30,51,.588,17,40,.425,23,28,.821,134
293,IND,2023-12-18,127,,LAC,L 127-151,240,49,95,.516,37,62,.597,12,33,.364,17,21,.810,127,56,98,.571,37,60,.617,19,38,.500,20,23,.870,151
294,CLE,2023-12-16,127,,ATL,W 127-119,240,49,101,.485,33,59,.559,16,42,.381,13,15,.867,127,41,85,.482,26,49,.531,15,36,.417,22,25,.880,119
295,MIN,2023-12-16,127,,IND,W 127-109,240,48,86,.558,30,56,.536,18,30,.600,13,16,.813,127,45,90,.500,39,69,.565,6,21,.286,13,16,.813,109
296,DAL,2023-12-12,127,,LAL,W 127-125,240,44,89,.494,23,46,.500,21,43,.488,18,21,.857,127,49,91,.538,34,62,.548,15,29,.517,12,18,.667,125
297,POR,2023-12-11,127,@,LAC,L 127-132,240,43,90,.478,24,50,.480,19,40,.475,22,26,.846,127,49,89,.551,36,55,.655,13,34,.382,21,22,.955,132
298,MIN,2023-12-08,127,@,MEM,W 127-103,240,44,88,.500,29,50,.580,15,38,.395,24,26,.923,127,37,86,.430,22,51,.431,15,35,.429,14,19,.737,103
299,NOP,2023-12-04,127,@,SAC,W 127-117,240,47,87,.540,33,56,.589,14,31,.452,19,23,.826,127,38,85,.447,24,44,.545,14,41,.341,27,33,.818,117
300,PHI,2023-11-25,127,@,OKC,W 127-123,240,38,83,.458,24,42,.571,14,41,.341,37,45,.822,127,43,98,.439,27,55,.491,16,43,.372,21,26,.808,123
301,UTA,2023-11-10,127,@,MEM,W 127-121,240,41,76,.539,23,39,.590,18,37,.486,27,29,.931,127,46,101,.455,27,53,.509,19,48,.396,10,13,.769,121
302,TOR,2023-11-08,127,@,DAL,W 127-116,240,49,99,.495,38,63,.603,11,36,.306,18,27,.667,127,40,84,.476,23,43,.535,17,41,.415,19,31,.613,116
303,ATL,2023-10-30,127,,MIN,W 127-113,240,48,86,.558,34,56,.607,14,30,.467,17,18,.944,127,44,90,.489,28,57,.491,16,33,.485,9,15,.600,113
304,ATL,2023-10-29,127,@,MIL,W 127-110,240,47,93,.505,32,56,.571,15,37,.405,18,22,.818,127,39,86,.453,23,42,.548,16,44,.364,16,20,.800,110
305,LAL,2023-10-29,127,@,SAC,L 127-132 (OT),265,43,98,.439,28,53,.528,15,45,.333,26,34,.765,127,49,104,.471,32,56,.571,17,48,.354,17,24,.708,132
306,OKC,2024-02-02,126,,CHO,W 126-106,240,44,75,.587,27,39,.692,17,36,.472,21,27,.778,126,41,92,.446,27,61,.443,14,31,.452,10,14,.714,106
307,ATL,2024-01-28,126,,TOR,W 126-125,240,44,95,.463,38,68,.559,6,27,.222,32,40,.800,126,41,89,.461,26,58,.448,15,31,.484,28,32,.875,125
308,MIL,2024-01-24,126,,CLE,W 126-116,240,45,90,.500,34,61,.557,11,29,.379,25,28,.893,126,46,91,.505,33,53,.623,13,38,.342,11,15,.733,116
309,CLE,2024-01-22,126,@,ORL,W 126-99,240,45,80,.563,25,42,.595,20,38,.526,16,22,.727,126,34,74,.459,23,45,.511,11,29,.379,20,30,.667,99
310,UTA,2024-01-20,126,@,HOU,L 126-127 (OT),265,48,105,.457,35,62,.565,13,43,.302,17,22,.773,126,50,117,.427,37,78,.474,13,39,.333,14,22,.636,127
311,NYK,2024-01-20,126,,TOR,W 126-100,240,48,88,.545,34,49,.694,14,39,.359,16,20,.800,126,38,92,.413,27,58,.466,11,34,.324,13,23,.565,100
312,IND,2024-01-18,126,@,SAC,W 126-121,240,49,89,.551,36,56,.643,13,33,.394,15,19,.789,126,44,85,.518,29,48,.604,15,37,.405,18,32,.563,121
313,PHI,2024-01-16,126,,DEN,W 126-121,240,43,76,.566,28,45,.622,15,31,.484,25,34,.735,126,45,89,.506,33,60,.550,12,29,.414,19,25,.760,121
314,IND,2024-01-12,126,@,ATL,W 126-108,240,53,79,.671,42,61,.689,11,18,.611,9,12,.750,126,40,89,.449,29,59,.492,11,30,.367,17,23,.739,108
315,LAC,2024-01-10,126,,TOR,W 126-120,240,49,93,.527,34,59,.576,15,34,.441,13,13,1.000,126,46,84,.548,34,54,.630,12,30,.400,16,18,.889,120
316,BOS,2024-01-05,126,,UTA,W 126-97,240,39,90,.433,22,41,.537,17,49,.347,31,36,.861,126,34,94,.362,28,60,.467,6,34,.176,23,34,.676,97
317,DAL,2024-01-03,126,,POR,W 126-97,240,42,84,.500,29,54,.537,13,30,.433,29,41,.707,126,34,87,.391,21,47,.447,13,40,.325,16,22,.727,97
318,WAS,2023-12-31,126,,ATL,L 126-130,240,46,98,.469,29,45,.644,17,53,.321,17,21,.810,126,47,95,.495,35,63,.556,12,32,.375,24,37,.649,130
319,NYK,2023-12-30,126,@,IND,L 126-140,240,45,95,.474,28,58,.483,17,37,.459,19,27,.704,126,50,85,.588,27,42,.643,23,43,.535,17,21,.810,140
320,BOS,2023-12-25,126,@,LAL,W 126-115,240,46,91,.505,33,49,.673,13,42,.310,21,28,.750,126,43,90,.478,30,58,.517,13,32,.406,16,21,.762,115
321,GSW,2023-12-23,126,,POR,W 126-106,240,48,83,.578,38,50,.760,10,33,.303,20,24,.833,126,38,84,.452,25,49,.510,13,35,.371,17,25,.680,106
322,BRK,2023-12-23,126,,DET,W 126-115,240,45,86,.523,35,62,.565,10,24,.417,26,32,.813,126,39,79,.494,24,44,.545,15,35,.429,22,29,.759,115
323,UTA,2023-12-23,126,@,TOR,W 126-119,240,48,91,.527,31,53,.585,17,38,.447,13,14,.929,126,45,94,.479,32,62,.516,13,32,.406,16,19,.842,119
324,BOS,2023-12-19,126,@,GSW,L 126-132 (OT),265,47,114,.412,30,56,.536,17,58,.293,15,17,.882,126,50,109,.459,30,59,.508,20,50,.400,12,14,.857,132
325,IND,2023-12-13,126,@,MIL,L 126-140,240,45,100,.450,34,64,.531,11,36,.306,25,32,.781,126,48,89,.539,41,62,.661,7,27,.259,37,48,.771,140
326,WAS,2023-12-06,126,,PHI,L 126-131,240,52,92,.565,38,57,.667,14,35,.400,8,8,1.000,126,47,92,.511,39,65,.600,8,27,.296,29,34,.853,131
327,OKC,2023-12-02,126,@,DAL,W 126-120,240,44,100,.440,24,56,.429,20,44,.455,18,22,.818,126,39,87,.448,20,35,.571,19,52,.365,23,35,.657,120
328,WAS,2023-11-27,126,@,DET,W 126-107,240,45,89,.506,35,60,.583,10,29,.345,26,28,.929,126,43,102,.422,35,64,.547,8,38,.211,13,19,.684,107
329,ORL,2023-11-21,126,,TOR,W 126-107,240,50,100,.500,38,69,.551,12,31,.387,14,20,.700,126,38,75,.507,24,47,.511,14,28,.500,17,22,.773,107
330,PHI,2023-11-17,126,@,ATL,W 126-116,240,43,88,.489,30,58,.517,13,30,.433,27,28,.964,126,40,89,.449,28,56,.500,12,33,.364,24,30,.800,116
331,ATL,2023-11-14,126,@,DET,W 126-120,240,45,87,.517,33,54,.611,12,33,.364,24,26,.923,126,47,90,.522,37,61,.607,10,29,.345,16,23,.696,120
332,PHI,2023-11-14,126,,IND,L 126-132,240,43,86,.500,37,64,.578,6,22,.273,34,35,.971,126,48,93,.516,35,56,.625,13,37,.351,23,33,.697,132
333,IND,2023-11-12,126,@,PHI,L 126-137,240,47,90,.522,31,51,.608,16,39,.410,16,19,.842,126,53,105,.505,39,72,.542,14,33,.424,17,20,.850,137
334,LAC,2023-11-10,126,@,DAL,L 126-144,240,43,88,.489,35,61,.574,8,27,.296,32,36,.889,126,51,98,.520,32,56,.571,19,42,.452,23,26,.885,144
335,IND,2023-11-09,126,,MIL,W 126-124,240,44,92,.478,24,44,.545,20,48,.417,18,20,.900,126,46,87,.529,37,60,.617,9,27,.333,23,26,.885,124
336,NYK,2023-11-08,126,,SAS,W 126-105,240,46,100,.460,27,58,.466,19,42,.452,15,22,.682,126,44,90,.489,35,56,.625,9,34,.265,8,13,.615,105
337,OKC,2023-11-06,126,,ATL,W 126-117,240,45,94,.479,31,59,.525,14,35,.400,22,23,.957,126,38,102,.373,24,60,.400,14,42,.333,27,32,.844,117
338,BOS,2023-10-30,126,@,WAS,W 126-107,240,51,102,.500,32,49,.653,19,53,.358,5,7,.714,126,39,87,.448,28,51,.549,11,36,.306,18,26,.692,107
339,PHI,2023-10-29,126,,POR,W 126-98,240,40,82,.488,29,54,.537,11,28,.393,35,40,.875,126,36,94,.383,29,63,.460,7,31,.226,19,22,.864,98
340,PHO,2023-10-28,126,,UTA,W 126-104,240,45,85,.529,35,48,.729,10,37,.270,26,28,.929,126,40,91,.440,28,54,.519,12,37,.324,12,14,.857,104
341,SAS,2023-10-27,126,,HOU,W 126-122 (OT),265,46,94,.489,33,52,.635,13,42,.310,21,28,.750,126,52,100,.520,44,68,.647,8,32,.250,10,20,.500,122
342,NYK,2023-10-27,126,@,ATL,W 126-120,240,43,90,.478,23,46,.500,20,44,.455,20,28,.714,126,42,87,.483,30,55,.545,12,32,.375,24,30,.800,120
343,DAL,2023-10-25,126,@,SAS,W 126-119,240,47,99,.475,32,52,.615,15,47,.319,17,23,.739,126,46,89,.517,35,54,.648,11,35,.314,16,22,.727,119
344,BOS,2024-02-07,125,,ATL,W 125-117,240,49,93,.527,32,44,.727,17,49,.347,10,11,.909,125,43,102,.422,30,61,.492,13,41,.317,18,20,.900,117
345,DET,2024-02-02,125,,LAC,L 125-136,240,45,89,.506,28,49,.571,17,40,.425,18,24,.750,125,53,89,.596,39,60,.650,14,29,.483,16,19,.842,136
346,LAC,2024-01-31,125,@,WAS,W 125-109,240,47,100,.470,35,70,.500,12,30,.400,19,22,.864,125,45,97,.464,36,68,.529,9,29,.310,10,15,.667,109
347,TOR,2024-01-28,125,@,ATL,L 125-126,240,41,89,.461,26,58,.448,15,31,.484,28,32,.875,125,44,95,.463,38,68,.559,6,27,.222,32,40,.800,126
348,NYK,2024-01-27,125,,MIA,W 125-109,240,45,87,.517,28,54,.519,17,33,.515,18,26,.692,125,41,88,.466,27,51,.529,14,37,.378,13,16,.813,109
349,MIN,2024-01-22,125,,CHO,L 125-128,240,44,84,.524,26,43,.605,18,41,.439,19,25,.760,125,50,88,.568,36,51,.706,14,37,.378,14,18,.778,128
350,LAC,2024-01-21,125,,BRK,W 125-114,240,42,83,.506,29,57,.509,13,26,.500,28,33,.848,125,44,90,.489,30,51,.588,14,39,.359,12,16,.750,114
351,CHI,2024-01-20,125,,MEM,W 125-96,240,47,91,.516,33,58,.569,14,33,.424,17,21,.810,125,32,75,.427,19,33,.576,13,42,.310,19,23,.826,96
352,DAL,2024-01-15,125,,NOP,W 125-120,240,39,85,.459,21,42,.500,18,43,.419,29,35,.829,125,41,81,.506,34,58,.586,7,23,.304,31,41,.756,120
353,LAL,2024-01-13,125,@,UTA,L 125-132,240,46,92,.500,33,63,.524,13,29,.448,20,24,.833,125,42,93,.452,30,56,.536,12,37,.324,36,39,.923,132
354,DEN,2024-01-12,125,,NOP,W 125-113,240,50,90,.556,36,57,.632,14,33,.424,11,15,.733,125,42,89,.472,29,56,.518,13,33,.394,16,22,.727,113
355,MIL,2024-01-04,125,@,SAS,W 125-121,240,49,92,.533,37,58,.638,12,34,.353,15,19,.789,125,46,95,.484,32,55,.582,14,40,.350,15,17,.882,121
356,MEM,2023-12-23,125,@,ATL,W 125-119,240,50,97,.515,39,64,.609,11,33,.333,14,22,.636,125,45,96,.469,32,53,.604,13,43,.302,16,20,.800,119
357,UTA,2023-12-18,125,,BRK,W 125-108,240,45,91,.495,31,57,.544,14,34,.412,21,24,.875,125,39,90,.433,23,51,.451,16,39,.410,14,20,.700,108
358,SAC,2023-12-16,125,,UTA,W 125-104,240,46,85,.541,24,40,.600,22,45,.489,11,15,.733,125,38,86,.442,26,49,.531,12,37,.324,16,21,.762,104
359,ATL,2023-12-15,125,@,TOR,W 125-104,240,52,101,.515,36,60,.600,16,41,.390,5,6,.833,125,40,77,.519,30,46,.652,10,31,.323,14,25,.560,104
360,LAL,2023-12-12,125,@,DAL,L 125-127,240,49,91,.538,34,62,.548,15,29,.517,12,18,.667,125,44,89,.494,23,46,.500,21,43,.488,18,21,.857,127
361,PHI,2023-12-08,125,,ATL,W 125-114,240,42,87,.483,31,57,.544,11,30,.367,30,37,.811,125,41,104,.394,28,65,.431,13,39,.333,19,21,.905,114
362,DAL,2023-12-08,125,@,POR,W 125-112,240,47,91,.516,35,52,.673,12,39,.308,19,22,.864,125,39,105,.371,21,52,.404,18,53,.340,16,18,.889,112
363,WAS,2023-12-01,125,@,ORL,L 125-130,240,45,89,.506,32,61,.525,13,28,.464,22,31,.710,125,46,89,.517,34,58,.586,12,31,.387,26,33,.788,130
364,BOS,2023-12-01,125,,PHI,W 125-119,240,39,77,.506,23,44,.523,16,33,.485,31,36,.861,125,43,94,.457,27,59,.458,16,35,.457,17,23,.739,119
365,DAL,2023-11-18,125,@,MIL,L 125-132,240,51,103,.495,35,56,.625,16,47,.340,7,10,.700,125,49,94,.521,32,49,.653,17,45,.378,17,20,.850,132
366,SAC,2023-11-15,125,@,LAL,W 125-110,240,48,96,.500,32,52,.615,16,44,.364,13,17,.765,125,42,83,.506,31,54,.574,11,29,.379,15,19,.789,110
367,BRK,2023-11-06,125,,MIL,L 125-129,240,49,101,.485,33,56,.589,16,45,.356,11,13,.846,125,46,96,.479,30,48,.625,16,48,.333,21,24,.875,129
368,CHO,2023-11-04,125,@,IND,W 125-124,240,47,88,.534,39,68,.574,8,20,.400,23,23,1.000,125,45,93,.484,23,48,.479,22,45,.489,12,16,.750,124
369,DEN,2023-11-03,125,,DAL,W 125-114,240,49,93,.527,36,63,.571,13,30,.433,14,19,.737,125,41,86,.477,24,44,.545,17,42,.405,15,17,.882,114
370,NOP,2023-11-02,125,,DET,W 125-116,240,39,80,.488,25,48,.521,14,32,.438,33,35,.943,125,41,94,.436,28,56,.500,13,38,.342,21,26,.808,116
371,LAC,2023-11-01,125,@,LAL,L 125-130 (OT),265,47,99,.475,33,65,.508,14,34,.412,17,27,.630,125,46,90,.511,35,58,.603,11,32,.344,27,36,.750,130
372,DAL,2023-10-30,125,@,MEM,W 125-110,240,42,84,.500,19,37,.514,23,47,.489,18,24,.750,125,42,92,.457,28,55,.509,14,37,.378,12,20,.600,110
373,IND,2023-10-28,125,@,CLE,W 125-113,240,48,98,.490,33,60,.550,15,38,.395,14,17,.824,125,43,99,.434,31,68,.456,12,31,.387,15,24,.625,113
374,DAL,2023-10-27,125,,BRK,W 125-120,240,44,91,.484,29,55,.527,15,36,.417,22,28,.786,125,45,92,.489,24,49,.490,21,43,.488,9,10,.900,120
375,UTA,2024-02-06,124,,OKC,W 124-117,240,46,89,.517,32,54,.593,14,35,.400,18,20,.900,124,43,90,.478,24,53,.453,19,37,.514,12,18,.667,117
376,LAL,2024-02-05,124,@,CHO,W 124-118,240,50,89,.562,42,55,.764,8,34,.235,16,19,.842,124,47,96,.490,34,64,.531,13,32,.406,11,14,.786,118
377,UTA,2024-02-01,124,,PHI,L 124-127,240,45,87,.517,33,51,.647,12,36,.333,22,25,.880,124,47,94,.500,33,62,.532,14,32,.438,19,21,.905,127
378,IND,2024-01-30,124,@,BOS,L 124-129,240,50,108,.463,38,69,.551,12,39,.308,12,15,.800,124,47,87,.540,30,51,.588,17,36,.472,18,22,.818,129
379,UTA,2024-01-23,124,@,NOP,L 124-153,240,43,92,.467,31,56,.554,12,36,.333,26,32,.813,124,60,104,.577,37,58,.638,23,46,.500,10,15,.667,153
380,PHI,2024-01-19,124,@,ORL,W 124-109,240,42,87,.483,29,57,.509,13,30,.433,27,29,.931,124,37,78,.474,27,55,.491,10,23,.435,25,27,.926,109
381,CHO,2024-01-19,124,,SAS,W 124-120,240,47,84,.560,31,55,.564,16,29,.552,14,16,.875,124,47,84,.560,32,52,.615,15,32,.469,11,17,.647,120
382,MIN,2024-01-17,124,@,DET,W 124-117,240,47,93,.505,32,63,.508,15,30,.500,15,21,.714,124,46,89,.517,34,58,.586,12,31,.387,13,19,.684,117
383,PHI,2024-01-15,124,,HOU,W 124-115,240,40,83,.482,25,52,.481,15,31,.484,29,34,.853,124,44,88,.500,36,61,.590,8,27,.296,19,32,.594,115
384,NYK,2024-01-11,124,@,DAL,L 124-128,240,44,89,.494,30,47,.638,14,42,.333,22,28,.786,124,44,88,.500,27,47,.574,17,41,.415,23,30,.767,128
385,CHI,2024-01-10,124,,HOU,W 124-119 (OT),265,42,95,.442,23,48,.479,19,47,.404,21,25,.840,124,48,101,.475,37,56,.661,11,45,.244,12,20,.600,119
386,UTA,2024-01-10,124,,DEN,W 124-111,240,46,83,.554,33,50,.660,13,33,.394,19,23,.826,124,37,81,.457,24,48,.500,13,33,.394,24,28,.857,111
387,BRK,2024-01-05,124,,OKC,W 124-115,240,41,91,.451,27,52,.519,14,39,.359,28,33,.848,124,45,84,.536,36,53,.679,9,31,.290,16,24,.667,115
388,TOR,2024-01-01,124,,CLE,W 124-121,240,42,87,.483,31,57,.544,11,30,.367,29,40,.725,124,43,89,.483,31,53,.585,12,36,.333,23,26,.885,121
389,OKC,2023-12-31,124,,BRK,W 124-108,240,45,83,.542,27,50,.540,18,33,.545,16,20,.800,124,38,100,.380,26,54,.481,12,46,.261,20,31,.645,108
390,CHI,2023-12-20,124,,LAL,W 124-108,240,48,88,.545,30,54,.556,18,34,.529,10,11,.909,124,42,94,.447,30,57,.526,12,37,.324,12,15,.800,108
391,CLE,2023-12-20,124,,UTA,W 124-116,240,45,96,.469,22,45,.489,23,51,.451,11,16,.688,124,40,78,.513,27,48,.563,13,30,.433,23,28,.821,116
392,DET,2023-12-18,124,@,ATL,L 124-130,240,48,94,.511,39,72,.542,9,22,.409,19,27,.704,124,46,85,.541,30,49,.612,16,36,.444,22,27,.815,130
393,GSW,2023-12-16,124,,BRK,W 124-120,240,44,91,.484,27,59,.458,17,32,.531,19,20,.950,124,45,93,.484,28,50,.560,17,43,.395,13,15,.867,120
394,PHI,2023-12-15,124,,DET,W 124-92,240,41,98,.418,27,61,.443,14,37,.378,28,31,.903,124,35,81,.432,31,60,.517,4,21,.190,18,23,.783,92
395,CHI,2023-12-14,124,@,MIA,W 124-116,240,45,93,.484,31,57,.544,14,36,.389,20,30,.667,124,37,80,.463,22,46,.478,15,34,.441,27,35,.771,116
396,DEN,2023-12-14,124,,BRK,W 124-101,240,47,99,.475,35,63,.556,12,36,.333,18,21,.857,124,39,95,.411,31,65,.477,8,30,.267,15,20,.750,101
397,BRK,2023-12-08,124,,WAS,W 124-97,240,50,104,.481,40,71,.563,10,33,.303,14,18,.778,124,38,91,.418,32,58,.552,6,33,.182,15,21,.714,97
398,CHI,2023-12-02,124,,NOP,W 124-118,240,48,88,.545,31,48,.646,17,40,.425,11,15,.733,124,41,82,.500,33,57,.579,8,25,.320,28,35,.800,118
399,NOP,2023-11-29,124,,PHI,W 124-114,240,42,78,.538,32,48,.667,10,30,.333,30,34,.882,124,42,81,.519,28,47,.596,14,34,.412,16,18,.889,114
400,HOU,2023-11-29,124,@,DEN,L 124-134,240,47,86,.547,31,45,.689,16,41,.390,14,19,.737,124,48,95,.505,29,52,.558,19,43,.442,19,26,.731,134
401,SAC,2023-11-28,124,,GSW,W 124-123,240,41,91,.451,26,47,.553,15,44,.341,27,42,.643,124,40,83,.482,23,42,.548,17,41,.415,26,30,.867,123
402,MIA,2023-11-28,124,,MIL,L 124-131,240,48,94,.511,34,64,.531,14,30,.467,14,21,.667,124,47,88,.534,34,53,.642,13,35,.371,24,27,.889,131
403,BOS,2023-11-28,124,,CHI,W 124-97,240,47,90,.522,26,41,.634,21,49,.429,9,12,.750,124,39,90,.433,30,62,.484,9,28,.321,10,18,.556,97
404,SAC,2023-11-24,124,@,MIN,W 124-111,240,49,100,.490,32,65,.492,17,35,.486,9,11,.818,124,36,82,.439,24,49,.490,12,33,.364,27,29,.931,111
405,ORL,2023-11-22,124,,DEN,W 124-119,240,44,81,.543,34,52,.654,10,29,.345,26,30,.867,124,44,93,.473,29,58,.500,15,35,.429,16,21,.762,119
406,LAC,2023-11-20,124,@,SAS,W 124-99,240,45,95,.474,33,59,.559,12,36,.333,22,25,.880,124,39,90,.433,29,52,.558,10,38,.263,11,14,.786,99
407,BRK,2023-11-14,124,,ORL,W 124-104,240,46,85,.541,27,46,.587,19,39,.487,13,20,.650,124,36,82,.439,20,36,.556,16,46,.348,16,21,.762,104
408,NOP,2023-11-12,124,,DAL,L 124-136,240,47,92,.511,30,56,.536,17,36,.472,13,22,.591,124,50,102,.490,30,49,.612,20,53,.377,16,21,.762,136
409,CHO,2023-11-10,124,@,WAS,W 124-117,240,50,110,.455,44,82,.537,6,28,.214,18,28,.643,124,43,88,.489,29,50,.580,14,38,.368,17,20,.850,117
410,MIL,2023-11-09,124,@,IND,L 124-126,240,46,87,.529,37,60,.617,9,27,.333,23,26,.885,124,44,92,.478,24,44,.545,20,48,.417,18,20,.900,126
411,DAL,2023-11-05,124,,CHO,W 124-118,240,43,91,.473,29,49,.592,14,42,.333,24,32,.750,124,49,99,.495,41,69,.594,8,30,.267,12,21,.571,118
412,IND,2023-11-04,124,,CHO,L 124-125,240,45,93,.484,23,48,.479,22,45,.489,12,16,.750,124,47,88,.534,39,68,.574,8,20,.400,23,23,1.000,125
413,BOS,2023-11-04,124,@,BRK,W 124-114,240,43,90,.478,28,45,.622,15,45,.333,23,27,.852,124,43,100,.430,26,48,.542,17,52,.327,11,17,.647,114
414,OKC,2023-10-30,124,,DET,W 124-112,240,44,83,.530,31,54,.574,13,29,.448,23,28,.821,124,39,91,.429,24,63,.381,15,28,.536,19,24,.792,112
415,OKC,2023-10-25,124,@,CHI,W 124-104,240,45,82,.549,26,43,.605,19,39,.487,15,18,.833,124,39,94,.415,27,52,.519,12,42,.286,14,18,.778,104
416,TOR,2024-02-07,123,@,CHO,W 123-117,240,43,81,.531,26,48,.542,17,33,.515,20,24,.833,123,44,90,.489,28,51,.549,16,39,.410,13,20,.650,117
417,NYK,2024-02-06,123,,MEM,W 123-113,240,48,86,.558,37,59,.627,11,27,.407,16,20,.800,123,41,80,.513,20,43,.465,21,37,.568,10,16,.625,113
418,MIN,2024-02-06,123,@,CHI,L 123-129 (OT),265,42,92,.457,22,47,.468,20,45,.444,19,26,.731,123,45,93,.484,33,63,.524,12,30,.400,27,32,.844,129
419,UTA,2024-02-04,123,,MIL,W 123-108,240,43,89,.483,26,45,.578,17,44,.386,20,24,.833,123,39,84,.464,24,43,.558,15,41,.366,15,25,.600,108
420,SAC,2024-02-03,123,@,CHI,W 123-115,240,42,84,.500,27,45,.600,15,39,.385,24,29,.828,123,42,91,.462,31,57,.544,11,34,.324,20,22,.909,115
421,UTA,2024-01-25,123,@,WAS,W 123-108,240,50,97,.515,37,66,.561,13,31,.419,10,12,.833,123,43,88,.489,36,58,.621,7,30,.233,15,20,.750,108
422,SAS,2024-01-22,123,@,PHI,L 123-133,240,43,93,.462,30,52,.577,13,41,.317,24,27,.889,123,48,97,.495,43,77,.558,5,20,.250,32,40,.800,133
423,PHO,2024-01-19,123,@,NOP,W 123-109,240,46,93,.495,31,52,.596,15,41,.366,16,21,.762,123,41,93,.441,31,51,.608,10,42,.238,17,23,.739,109
424,SAC,2024-01-10,123,@,CHO,W 123-98,240,46,89,.517,33,54,.611,13,35,.371,18,23,.783,123,35,87,.402,19,49,.388,16,38,.421,12,16,.750,98
425,BOS,2024-01-02,123,@,OKC,L 123-127,240,42,92,.457,27,52,.519,15,40,.375,24,29,.828,123,48,91,.527,30,51,.588,18,40,.450,13,17,.765,127
426,SAC,2023-12-31,123,@,MEM,W 123-92,240,47,92,.511,31,59,.525,16,33,.485,13,17,.765,123,30,82,.366,18,42,.429,12,40,.300,20,28,.714,92
427,IND,2023-12-26,123,@,HOU,W 123-117,240,43,82,.524,24,39,.615,19,43,.442,18,21,.857,123,47,97,.485,42,73,.575,5,24,.208,18,22,.818,117
428,NOP,2023-12-21,123,@,CLE,W 123-104,240,47,86,.547,32,51,.627,15,35,.429,14,16,.875,123,41,87,.471,24,43,.558,17,44,.386,5,8,.625,104
429,IND,2023-12-15,123,@,WAS,L 123-137,240,48,107,.449,33,67,.493,15,40,.375,12,16,.750,123,52,92,.565,39,65,.600,13,27,.481,20,26,.769,137
430,OKC,2023-12-14,123,@,SAC,L 123-128,240,44,102,.431,33,66,.500,11,36,.306,24,27,.889,123,47,95,.495,29,50,.580,18,45,.400,16,21,.762,128
431,DET,2023-12-11,123,,IND,L 123-131,240,45,81,.556,35,52,.673,10,29,.345,23,30,.767,123,52,92,.565,39,61,.639,13,31,.419,14,19,.737,131
432,ORL,2023-12-08,123,,DET,W 123-91,240,49,89,.551,39,63,.619,10,26,.385,15,19,.789,123,34,81,.420,28,51,.549,6,30,.200,17,24,.708,91
433,NYK,2023-12-08,123,@,BOS,L 123-133,240,44,88,.500,29,51,.569,15,37,.405,20,27,.741,123,48,91,.527,29,44,.659,19,47,.404,18,21,.857,133
434,SAC,2023-12-02,123,,DEN,W 123-117,240,48,99,.485,32,65,.492,16,34,.471,11,15,.733,123,49,99,.495,43,74,.581,6,25,.240,13,20,.650,117
435,MIN,2023-12-02,123,@,CHO,W 123-117,240,43,84,.512,32,53,.604,11,31,.355,26,30,.867,123,44,91,.484,32,66,.485,12,25,.480,17,19,.895,117
436,GSW,2023-11-28,123,@,SAC,L 123-124,240,40,83,.482,23,42,.548,17,41,.415,26,30,.867,123,41,91,.451,26,47,.553,15,44,.341,27,42,.643,124
437,OKC,2023-11-25,123,,PHI,L 123-127,240,43,98,.439,27,55,.491,16,43,.372,21,26,.808,123,38,83,.458,24,42,.571,14,41,.341,37,45,.822,127
438,PHO,2023-11-22,123,,GSW,W 123-115,240,34,76,.447,23,48,.479,11,28,.393,44,52,.846,123,43,90,.478,33,58,.569,10,32,.313,19,29,.655,115
439,GSW,2023-11-18,123,,OKC,L 123-130 (OT),265,44,97,.454,26,51,.510,18,46,.391,17,21,.810,123,52,100,.520,44,77,.571,8,23,.348,18,20,.900,130
440,OKC,2023-11-14,123,,SAS,W 123-87,240,46,89,.517,31,50,.620,15,39,.385,16,20,.800,123,36,93,.387,27,63,.429,9,30,.300,6,9,.667,87
441,TOR,2023-11-05,123,@,SAS,W 123-116 (OT),265,44,97,.454,25,49,.510,19,48,.396,16,26,.615,123,48,96,.500,38,64,.594,10,32,.313,10,13,.769,116
442,ATL,2023-11-04,123,@,NOP,W 123-105,240,45,93,.484,31,52,.596,14,41,.341,19,24,.792,123,40,84,.476,32,53,.604,8,31,.258,17,21,.810,105
443,DEN,2023-11-04,123,,CHI,W 123-101,240,42,81,.519,26,45,.578,16,36,.444,23,30,.767,123,39,86,.453,32,60,.533,7,26,.269,16,23,.696,101
444,MIN,2023-11-04,123,,UTA,W 123-95,240,45,81,.556,36,57,.632,9,24,.375,24,31,.774,123,35,91,.385,23,48,.479,12,43,.279,13,17,.765,95
445,LAC,2023-10-29,123,,SAS,W 123-83,240,47,91,.516,31,49,.633,16,42,.381,13,21,.619,123,30,80,.375,19,47,.404,11,33,.333,12,16,.750,83
446,LAC,2023-10-25,123,,POR,W 123-111,240,47,90,.522,31,56,.554,16,34,.471,13,16,.813,123,44,93,.473,34,61,.557,10,32,.313,13,17,.765,111
447,IND,2024-02-02,122,,SAC,L 122-133,240,46,85,.541,36,56,.643,10,29,.345,20,24,.833,122,51,90,.567,38,56,.679,13,34,.382,18,28,.643,133
448,LAL,2024-01-30,122,@,ATL,L 122-138,240,48,90,.533,36,57,.632,12,33,.364,14,25,.560,122,53,101,.525,37,63,.587,16,38,.421,16,18,.889,138
449,CHO,2024-01-27,122,,UTA,L 122-134,240,47,92,.511,34,60,.567,13,32,.406,15,21,.714,122,52,93,.559,35,52,.673,17,41,.415,13,17,.765,134
450,NYK,2024-01-25,122,,DEN,W 122-84,240,45,85,.529,30,47,.638,15,38,.395,17,20,.850,122,34,84,.405,29,58,.500,5,26,.192,11,13,.846,84
451,PHI,2024-01-25,122,@,IND,L 122-134,240,42,87,.483,35,58,.603,7,29,.241,31,43,.721,122,53,93,.570,41,65,.631,12,28,.429,16,21,.762,134
452,SAC,2024-01-22,122,,ATL,W 122-107,240,43,93,.462,31,55,.564,12,38,.316,24,27,.889,122,36,93,.387,22,53,.415,14,40,.350,21,27,.778,107
453,MIL,2024-01-22,122,@,DET,W 122-113,240,42,94,.447,32,55,.582,10,39,.256,28,34,.824,122,40,89,.449,30,59,.508,10,30,.333,23,29,.793,113
454,CHI,2024-01-13,122,@,SAS,W 122-116,240,46,90,.511,31,56,.554,15,34,.441,15,20,.750,122,39,95,.411,21,49,.429,18,46,.391,20,23,.870,116
455,MIN,2024-01-05,122,@,HOU,W 122-95,240,46,88,.523,32,55,.582,14,33,.424,16,20,.800,122,36,90,.400,24,58,.414,12,32,.375,11,15,.733,95
456,ORL,2024-01-05,122,@,DEN,W 122-120,240,41,82,.500,24,46,.522,17,36,.472,23,34,.676,122,48,95,.505,39,62,.629,9,33,.273,15,19,.789,120
457,PHO,2024-01-03,122,,LAC,L 122-131,240,42,79,.532,27,44,.614,15,35,.429,23,26,.885,122,42,76,.553,24,42,.571,18,34,.529,29,32,.906,131
458,IND,2024-01-01,122,@,MIL,W 122-113,240,43,97,.443,38,62,.613,5,35,.143,31,38,.816,122,41,93,.441,31,53,.585,10,40,.250,21,26,.808,113
459,GSW,2023-12-30,122,,DAL,L 122-132,240,47,103,.456,28,55,.509,19,48,.396,9,13,.692,122,49,88,.557,33,48,.688,16,40,.400,18,22,.818,132
460,DET,2023-12-28,122,@,BOS,L 122-128 (OT),265,48,101,.475,34,58,.586,14,43,.326,12,19,.632,122,48,99,.485,37,60,.617,11,39,.282,21,25,.840,128
461,BRK,2023-12-27,122,,MIL,L 122-144,240,45,101,.446,38,69,.551,7,32,.219,25,29,.862,122,52,89,.584,29,38,.763,23,51,.451,17,23,.739,144
462,MIL,2023-12-25,122,@,NYK,L 122-129,240,45,95,.474,32,53,.604,13,42,.310,19,24,.792,122,50,92,.543,42,66,.636,8,26,.308,21,26,.808,129
463,MIA,2023-12-22,122,,ATL,W 122-113,240,40,86,.465,23,47,.489,17,39,.436,25,30,.833,122,42,96,.438,23,42,.548,19,54,.352,10,14,.714,113
464,HOU,2023-12-22,122,,DAL,W 122-96,240,46,95,.484,35,57,.614,11,38,.289,19,23,.826,122,35,101,.347,28,61,.459,7,40,.175,19,26,.731,96
465,DEN,2023-12-22,122,@,BRK,W 122-117,240,45,87,.517,34,61,.557,11,26,.423,21,25,.840,122,43,89,.483,30,56,.536,13,33,.394,18,26,.692,117
466,NYK,2023-12-16,122,@,LAC,L 122-144,240,44,94,.468,33,59,.559,11,35,.314,23,26,.885,122,50,88,.568,34,55,.618,16,33,.485,28,34,.824,144
467,PHO,2023-12-15,122,,NYK,L 122-139,240,47,90,.522,36,62,.581,11,28,.393,17,21,.810,122,49,82,.598,32,53,.604,17,29,.586,24,28,.857,139
468,UTA,2023-12-14,122,@,POR,W 122-114,240,49,92,.533,38,59,.644,11,33,.333,13,14,.929,122,43,103,.417,27,58,.466,16,45,.356,12,18,.667,114
469,WAS,2023-12-13,122,,NOP,L 122-142,240,42,82,.512,23,38,.605,19,44,.432,19,24,.792,122,50,96,.521,34,62,.548,16,34,.471,26,30,.867,142
470,LAL,2023-12-13,122,@,SAS,W 122-119,240,49,91,.538,35,56,.625,14,35,.400,10,17,.588,122,45,96,.469,29,59,.492,16,37,.432,13,18,.722,119
471,ATL,2023-12-11,122,,DEN,L 122-129,240,44,96,.458,27,52,.519,17,44,.386,17,18,.944,122,47,88,.534,35,59,.593,12,29,.414,23,29,.793,129
472,NYK,2023-12-05,122,@,MIL,L 122-146,240,43,87,.494,36,64,.563,7,23,.304,29,33,.879,122,55,91,.604,32,53,.604,23,38,.605,13,19,.684,146
473,IND,2023-12-04,122,,BOS,W 122-112,240,43,94,.457,24,54,.444,19,40,.475,17,21,.810,122,46,97,.474,34,56,.607,12,41,.293,8,12,.667,112
474,CLE,2023-11-21,122,@,PHI,W 122-119 (OT),265,46,94,.489,37,69,.536,9,25,.360,21,25,.840,122,40,96,.417,29,61,.475,11,35,.314,28,34,.824,119
475,NYK,2023-11-18,122,@,CHO,W 122-108,240,46,91,.505,30,54,.556,16,37,.432,14,19,.737,122,40,82,.488,23,47,.489,17,35,.486,11,13,.846,108
476,MIA,2023-11-16,122,,BRK,W 122-115,240,42,81,.519,27,46,.587,15,35,.429,23,24,.958,122,40,85,.471,26,49,.531,14,36,.389,21,27,.778,115
477,LAL,2023-11-10,122,@,PHO,W 122-119,240,42,84,.500,30,57,.526,12,27,.444,26,34,.765,122,42,94,.447,27,57,.474,15,37,.405,20,27,.741,119
478,MIN,2023-11-08,122,,NOP,W 122-101,240,45,82,.549,30,45,.667,15,37,.405,17,24,.708,122,36,93,.387,28,65,.431,8,28,.286,21,22,.955,101
479,HOU,2023-11-06,122,,SAC,W 122-97,240,43,75,.573,28,44,.636,15,31,.484,21,27,.778,122,36,81,.444,22,41,.537,14,40,.350,11,20,.550,97
480,MIL,2023-10-30,122,,MIA,W 122-114,240,44,87,.506,32,50,.640,12,37,.324,22,30,.733,122,41,86,.477,28,52,.538,13,34,.382,19,20,.950,114
481,GSW,2023-10-27,122,@,SAC,W 122-114,240,48,87,.552,34,55,.618,14,32,.438,12,14,.857,122,41,94,.436,29,54,.537,12,40,.300,20,29,.690,114
482,HOU,2023-10-27,122,@,SAS,L 122-126 (OT),265,52,100,.520,44,68,.647,8,32,.250,10,20,.500,122,46,94,.489,33,52,.635,13,42,.310,21,28,.750,126
483,MIA,2024-02-06,121,,ORL,W 121-95,240,47,87,.540,34,51,.667,13,36,.361,14,18,.778,121,35,80,.438,25,45,.556,10,35,.286,15,21,.714,95
484,PHI,2024-02-03,121,,BRK,L 121-136,240,44,96,.458,32,67,.478,12,29,.414,21,27,.778,121,49,95,.516,29,44,.659,20,51,.392,18,23,.783,136
485,GSW,2024-02-02,121,@,MEM,W 121-101,240,46,83,.554,35,54,.648,11,29,.379,18,22,.818,121,35,87,.402,21,41,.512,14,46,.304,17,24,.708,101
486,DET,2024-01-31,121,@,CLE,L 121-128,240,45,81,.556,29,50,.580,16,31,.516,15,19,.789,121,47,89,.528,35,54,.648,12,35,.343,22,23,.957,128
487,MIN,2024-01-31,121,,DAL,W 121-87,240,45,80,.563,32,50,.640,13,30,.433,18,30,.600,121,31,76,.408,25,47,.532,6,29,.207,19,26,.731,87
488,SAC,2024-01-18,121,,IND,L 121-126,240,44,85,.518,29,48,.604,15,37,.405,18,32,.563,121,49,89,.551,36,56,.643,13,33,.394,15,19,.789,126
489,TOR,2024-01-17,121,,MIA,W 121-97,240,45,88,.511,25,50,.500,20,38,.526,11,18,.611,121,41,90,.456,35,62,.565,6,28,.214,9,12,.750,97
490,DEN,2024-01-16,121,@,PHI,L 121-126,240,45,89,.506,33,60,.550,12,29,.414,19,25,.760,121,43,76,.566,28,45,.622,15,31,.484,25,34,.735,126
491,MEM,2024-01-07,121,@,PHO,W 121-115,240,43,97,.443,26,48,.542,17,49,.347,18,24,.750,121,46,102,.451,38,74,.514,8,28,.286,15,22,.682,115
492,NYK,2024-01-06,121,@,WAS,W 121-105,240,43,87,.494,29,51,.569,14,36,.389,21,24,.875,121,40,85,.471,27,48,.563,13,37,.351,12,20,.600,105
493,SAS,2024-01-04,121,,MIL,L 121-125,240,46,95,.484,32,55,.582,14,40,.350,15,17,.882,121,49,92,.533,37,58,.638,12,34,.353,15,19,.789,125
494,GSW,2024-01-02,121,,ORL,W 121-115,240,42,78,.538,29,43,.674,13,35,.371,24,37,.649,121,41,92,.446,27,56,.482,14,36,.389,19,23,.826,115
495,CLE,2024-01-01,121,@,TOR,L 121-124,240,43,89,.483,31,53,.585,12,36,.333,23,26,.885,121,42,87,.483,31,57,.544,11,30,.367,29,40,.725,124
496,LAC,2024-01-01,121,,MIA,W 121-104,240,47,80,.588,33,51,.647,14,29,.483,13,14,.929,121,35,83,.422,24,49,.490,11,34,.324,23,29,.793,104
497,PHI,2023-12-22,121,,TOR,W 121-111,240,44,83,.530,30,52,.577,14,31,.452,19,21,.905,121,39,87,.448,30,54,.556,9,33,.273,24,28,.857,111
498,NYK,2023-12-20,121,@,BRK,W 121-102,240,44,95,.463,31,62,.500,13,33,.394,20,25,.800,121,37,101,.366,22,54,.407,15,47,.319,13,17,.765,102
499,LAC,2023-12-14,121,,GSW,W 121-113,240,41,81,.506,28,49,.571,13,32,.406,26,30,.867,121,40,92,.435,24,47,.511,16,45,.356,17,19,.895,113
500,NOP,2023-12-11,121,,MIN,W 121-107,240,40,82,.488,30,55,.545,10,27,.370,31,40,.775,121,40,91,.440,27,55,.491,13,36,.361,14,19,.737,107
501,CHI,2023-12-08,121,@,SAS,W 121-112,240,47,102,.461,34,74,.459,13,28,.464,14,24,.583,121,39,83,.470,22,41,.537,17,42,.405,17,20,.850,112
502,CLE,2023-12-06,121,,ORL,W 121-111,240,46,86,.535,32,52,.615,14,34,.412,15,20,.750,121,41,84,.488,39,61,.639,2,23,.087,27,37,.730,111
503,ATL,2023-12-02,121,@,MIL,L 121-132,240,45,101,.446,30,63,.476,15,38,.395,16,21,.762,121,53,89,.596,39,56,.696,14,33,.424,12,15,.800,132
504,NOP,2023-12-01,121,,SAS,W 121-106,240,42,85,.494,32,54,.593,10,31,.323,27,29,.931,121,38,83,.458,22,44,.500,16,39,.410,14,17,.824,106
505,DAL,2023-11-28,121,,HOU,W 121-115,240,42,89,.472,30,55,.545,12,34,.353,25,29,.862,121,42,85,.494,34,56,.607,8,29,.276,23,29,.793,115
506,LAL,2023-11-25,121,@,CLE,W 121-115,240,47,90,.522,38,63,.603,9,27,.333,18,21,.857,121,43,91,.473,34,63,.540,9,28,.321,20,23,.870,115
507,TOR,2023-11-24,121,,CHI,W 121-108,240,44,83,.530,31,44,.705,13,39,.333,20,27,.741,121,42,82,.512,30,55,.545,12,27,.444,12,19,.632,108
508,POR,2023-11-22,121,,UTA,W 121-105,240,47,92,.511,30,53,.566,17,39,.436,10,15,.667,121,37,79,.468,27,48,.563,10,31,.323,21,26,.808,105
509,CHO,2023-11-20,121,,BOS,W 121-118 (OT),265,46,104,.442,33,65,.508,13,39,.333,16,17,.941,121,42,97,.433,26,47,.553,16,50,.320,18,28,.643,118
510,GSW,2023-11-20,121,,HOU,W 121-116,240,36,77,.468,15,34,.441,21,43,.488,28,33,.848,121,44,95,.463,31,54,.574,13,41,.317,15,19,.789,116
511,PHI,2023-11-19,121,@,BRK,W 121-99,240,44,94,.468,28,59,.475,16,35,.457,17,18,.944,121,38,81,.469,27,53,.509,11,28,.393,12,16,.750,99
512,CLE,2023-11-19,121,,DEN,W 121-109,240,45,82,.549,34,55,.618,11,27,.407,20,26,.769,121,39,82,.476,25,53,.472,14,29,.483,17,23,.739,109
513,MIN,2023-11-18,121,@,NOP,W 121-120,240,43,80,.538,30,49,.612,13,31,.419,22,27,.815,121,44,86,.512,32,57,.561,12,29,.414,20,23,.870,120
514,BOS,2023-11-10,121,,BRK,W 121-107,240,41,94,.436,22,42,.524,19,52,.365,20,28,.714,121,38,85,.447,23,48,.479,15,37,.405,16,18,.889,107
515,MEM,2023-11-10,121,,UTA,L 121-127,240,46,101,.455,27,53,.509,19,48,.396,10,13,.769,121,41,76,.539,23,39,.590,18,37,.486,27,29,.931,127
516,SAC,2023-11-08,121,,POR,W 121-118 (OT),265,41,89,.461,30,52,.577,11,37,.297,28,38,.737,121,44,87,.506,36,65,.554,8,22,.364,22,29,.759,118
517,MIA,2023-11-03,121,,WAS,W 121-114,240,48,80,.600,35,53,.660,13,27,.481,12,14,.857,121,46,81,.568,33,53,.623,13,28,.464,9,17,.529,114
518,IND,2023-11-03,121,,CLE,W 121-116,240,45,86,.523,30,55,.545,15,31,.484,16,24,.667,121,44,84,.524,36,56,.643,8,28,.286,20,25,.800,116
519,PHO,2023-11-02,121,,SAS,L 121-132,240,43,80,.538,27,48,.563,16,32,.500,19,26,.731,121,51,98,.520,33,61,.541,18,37,.486,12,13,.923,132
520,WAS,2023-11-01,121,@,ATL,L 121-130,240,51,101,.505,41,61,.672,10,40,.250,9,14,.643,121,46,92,.500,37,60,.617,9,32,.281,29,32,.906,130
521,CHO,2023-10-30,121,,BRK,L 121-133,240,47,96,.490,39,65,.600,8,31,.258,19,20,.950,121,49,87,.563,37,54,.685,12,33,.364,23,32,.719,133
522,SAC,2024-02-07,120,,DET,L 120-133,240,45,95,.474,30,51,.588,15,44,.341,15,22,.682,120,47,84,.560,30,53,.566,17,31,.548,22,22,1.000,133
523,PHO,2024-02-02,120,@,ATL,L 120-129,240,47,88,.534,33,51,.647,14,37,.378,12,14,.857,120,49,95,.516,32,51,.627,17,44,.386,14,18,.778,129
524,DEN,2024-02-02,120,,POR,W 120-108,240,46,91,.505,34,55,.618,12,36,.333,16,17,.941,120,37,80,.463,27,52,.519,10,28,.357,24,30,.800,108
525,BRK,2024-01-31,120,,PHO,L 120-136,240,47,94,.500,31,55,.564,16,39,.410,10,13,.769,120,49,79,.620,35,51,.686,14,28,.500,24,32,.750,136
526,DET,2024-01-28,120,,OKC,W 120-104,240,47,95,.495,36,69,.522,11,26,.423,15,19,.789,120,44,92,.478,36,64,.563,8,28,.286,8,12,.667,104
527,SAC,2024-01-27,120,@,DAL,W 120-115,240,43,80,.538,32,50,.640,11,30,.367,23,30,.767,120,43,98,.439,27,52,.519,16,46,.348,13,18,.722,115
528,SAS,2024-01-19,120,@,CHO,L 120-124,240,47,84,.560,32,52,.615,15,32,.469,11,17,.647,120,47,84,.560,31,55,.564,16,29,.552,14,16,.875,124
529,NOP,2024-01-15,120,@,DAL,L 120-125,240,41,81,.506,34,58,.586,7,23,.304,31,41,.756,120,39,85,.459,21,42,.500,18,43,.419,29,35,.829,125
530,MIA,2024-01-10,120,,OKC,L 120-128,240,41,89,.461,26,53,.491,15,36,.417,23,28,.821,120,51,86,.593,37,53,.698,14,33,.424,12,16,.750,128
531,TOR,2024-01-10,120,@,LAC,L 120-126,240,46,84,.548,34,54,.630,12,30,.400,16,18,.889,120,49,93,.527,34,59,.576,15,34,.441,13,13,1.000,126
532,MIN,2024-01-10,120,@,BOS,L 120-127 (OT),265,44,95,.463,30,61,.492,14,34,.412,18,20,.900,120,39,90,.433,20,43,.465,19,47,.404,30,31,.968,127
533,MEM,2024-01-09,120,@,DAL,W 120-103,240,44,91,.484,30,54,.556,14,37,.378,18,21,.857,120,36,82,.439,27,55,.491,9,27,.333,22,27,.815,103
534,MIA,2024-01-08,120,,HOU,W 120-113,240,41,82,.500,26,46,.565,15,36,.417,23,32,.719,120,37,88,.420,23,47,.489,14,41,.341,25,28,.893,113
535,UTA,2024-01-06,120,@,PHI,W 120-109,240,46,80,.575,38,50,.760,8,30,.267,20,24,.833,120,42,104,.404,35,66,.530,7,38,.184,18,23,.783,109
536,DEN,2024-01-05,120,,ORL,L 120-122,240,48,95,.505,39,62,.629,9,33,.273,15,19,.789,120,41,82,.500,24,46,.522,17,36,.472,23,34,.676,122
537,BOS,2023-12-29,120,,TOR,W 120-118,240,43,88,.489,26,49,.531,17,39,.436,17,20,.850,120,44,95,.463,27,51,.529,17,44,.386,13,20,.650,118
538,IND,2023-12-28,120,@,CHI,W 120-104,240,43,85,.506,24,43,.558,19,42,.452,15,22,.682,120,40,97,.412,33,70,.471,7,27,.259,17,22,.773,104
539,NYK,2023-12-27,120,@,OKC,L 120-129,240,41,82,.500,27,48,.563,14,34,.412,24,30,.800,120,49,90,.544,35,58,.603,14,32,.438,17,22,.773,129
540,DEN,2023-12-25,120,,GSW,W 120-114,240,40,82,.488,26,48,.542,14,34,.412,26,32,.813,120,40,87,.460,26,47,.553,14,40,.350,20,23,.870,114
541,OKC,2023-12-23,120,,LAL,L 120-129,240,46,95,.484,33,54,.611,13,41,.317,15,19,.789,120,47,90,.522,31,58,.534,16,32,.500,19,23,.826,129
542,SAC,2023-12-22,120,,PHO,W 120-105,240,44,83,.530,32,45,.711,12,38,.316,20,26,.769,120,39,88,.443,34,63,.540,5,25,.200,22,28,.786,105
543,LAC,2023-12-20,120,@,DAL,W 120-111,240,43,77,.558,32,46,.696,11,31,.355,23,25,.920,120,39,91,.429,25,48,.521,14,43,.326,19,27,.704,111
544,POR,2023-12-16,120,,DAL,L 120-131,240,47,94,.500,40,62,.645,7,32,.219,19,22,.864,120,48,97,.495,32,50,.640,16,47,.340,19,21,.905,131
545,BRK,2023-12-16,120,@,GSW,L 120-124,240,45,93,.484,28,50,.560,17,43,.395,13,15,.867,120,44,91,.484,27,59,.458,17,32,.531,19,20,.950,124
546,BOS,2023-12-12,120,,CLE,W 120-113,240,38,84,.452,20,40,.500,18,44,.409,26,26,1.000,120,44,92,.478,25,47,.532,19,45,.422,6,9,.667,113
547,DAL,2023-12-11,120,@,MEM,W 120-113,240,43,86,.500,26,46,.565,17,40,.425,17,19,.895,120,41,89,.461,23,45,.511,18,44,.409,13,16,.813,113
548,UTA,2023-12-11,120,@,OKC,L 120-134,240,44,92,.478,32,54,.593,12,38,.316,20,21,.952,120,50,96,.521,32,58,.552,18,38,.474,16,17,.941,134
549,DAL,2023-12-02,120,,OKC,L 120-126,240,39,87,.448,20,35,.571,19,52,.365,23,35,.657,120,44,100,.440,24,56,.429,20,44,.455,18,22,.818,126
550,CHI,2023-11-30,120,,MIL,W 120-113 (OT),265,45,98,.459,32,61,.525,13,37,.351,17,22,.773,120,44,98,.449,28,50,.560,16,48,.333,9,13,.692,113
551,GSW,2023-11-30,120,,LAC,W 120-114,240,41,82,.500,26,43,.605,15,39,.385,23,31,.742,120,42,95,.442,30,63,.476,12,32,.375,18,24,.750,114
552,WAS,2023-11-29,120,@,ORL,L 120-139,240,41,87,.471,30,58,.517,11,29,.379,27,35,.771,120,51,84,.607,34,57,.596,17,27,.630,20,24,.833,139
553,SAS,2023-11-26,120,@,DEN,L 120-132,240,42,93,.452,28,56,.500,14,37,.378,22,26,.846,120,50,89,.562,38,61,.623,12,28,.429,20,25,.800,132
554,PHO,2023-11-21,120,,POR,W 120-107,240,43,76,.566,36,59,.610,7,17,.412,27,28,.964,120,38,87,.437,24,56,.429,14,31,.452,17,20,.850,107
555,MEM,2023-11-18,120,@,SAS,W 120-108,240,40,86,.465,29,53,.547,11,33,.333,29,36,.806,120,36,83,.434,21,43,.488,15,40,.375,21,26,.808,108
556,NOP,2023-11-18,120,,MIN,L 120-121,240,44,86,.512,32,57,.561,12,29,.414,20,23,.870,120,43,80,.538,30,49,.612,13,31,.419,22,27,.815,121
557,SAS,2023-11-17,120,,SAC,L 120-129,240,43,92,.467,28,56,.500,15,36,.417,19,23,.826,120,46,85,.541,28,43,.651,18,42,.429,19,24,.792,129
558,NYK,2023-11-17,120,@,WAS,W 120-99,240,45,91,.495,29,53,.547,16,38,.421,14,20,.700,120,37,82,.451,27,50,.540,10,32,.313,15,16,.938,99
559,DET,2023-11-14,120,,ATL,L 120-126,240,47,90,.522,37,61,.607,10,29,.345,16,23,.696,120,45,87,.517,33,54,.611,12,33,.364,24,26,.923,126
560,CLE,2023-11-13,120,@,SAC,L 120-132,240,45,91,.495,29,56,.518,16,35,.457,14,17,.824,120,49,83,.590,29,41,.707,20,42,.476,14,22,.636,132
561,ATL,2023-11-09,120,@,ORL,W 120-119,240,41,85,.482,26,46,.565,15,39,.385,23,30,.767,120,42,90,.467,32,63,.508,10,27,.370,25,35,.714,119
562,MIL,2023-11-08,120,,DET,W 120-118,240,41,90,.456,30,53,.566,11,37,.297,27,32,.844,120,48,98,.490,41,69,.594,7,29,.241,15,16,.938,118
563,CLE,2023-11-08,120,@,OKC,L 120-128,240,42,83,.506,33,54,.611,9,29,.310,27,37,.730,120,44,86,.512,32,58,.552,12,28,.429,28,30,.933,128
564,GSW,2023-11-06,120,@,DET,W 120-109,240,46,97,.474,34,56,.607,12,41,.293,16,21,.762,120,38,80,.475,25,50,.500,13,30,.433,20,21,.952,109
565,PHO,2023-11-05,120,@,DET,W 120-106,240,43,86,.500,35,65,.538,8,21,.381,26,29,.897,120,43,87,.494,35,64,.547,8,23,.348,12,14,.857,106
566,ORL,2023-11-04,120,,LAL,W 120-101,240,46,101,.455,34,68,.500,12,33,.364,16,19,.842,120,37,84,.440,29,54,.537,8,30,.267,19,21,.905,101
567,BRK,2023-10-27,120,@,DAL,L 120-125,240,45,92,.489,24,49,.490,21,43,.488,9,10,.900,120,44,91,.484,29,55,.527,15,36,.417,22,28,.786,125
568,UTA,2023-10-27,120,,LAC,W 120-118,240,42,96,.438,26,55,.473,16,41,.390,20,22,.909,120,41,77,.532,27,42,.643,14,35,.400,22,28,.786,118
569,ATL,2023-10-27,120,,NYK,L 120-126,240,42,87,.483,30,55,.545,12,32,.375,24,30,.800,120,43,90,.478,23,46,.500,20,44,.455,20,28,.714,126
570,WAS,2023-10-25,120,@,IND,L 120-143,240,44,96,.458,35,72,.486,9,24,.375,23,29,.793,120,56,107,.523,36,64,.563,20,43,.465,11,12,.917,143
571,DAL,2024-02-06,119,@,BRK,W 119-107,240,46,91,.505,27,48,.563,19,43,.442,8,13,.615,119,41,91,.451,29,58,.500,12,33,.364,13,15,.867,107
572,POR,2024-01-31,119,,MIL,W 119-116,240,49,92,.533,37,64,.578,12,28,.429,9,9,1.000,119,45,92,.489,32,47,.681,13,45,.289,13,18,.722,116
573,GSW,2024-01-30,119,,PHI,W 119-107,240,44,79,.557,30,47,.638,14,32,.438,17,19,.895,119,39,85,.459,26,55,.473,13,30,.433,16,21,.762,107
574,LAL,2024-01-29,119,@,HOU,L 119-135,240,45,91,.495,32,56,.571,13,35,.371,16,26,.615,119,52,98,.531,40,62,.645,12,36,.333,19,25,.760,135
575,BOS,2024-01-22,119,@,DAL,W 119-110,240,41,88,.466,26,42,.619,15,46,.326,22,30,.733,119,43,97,.443,29,57,.509,14,40,.350,10,14,.714,110
576,PHO,2024-01-16,119,,SAC,W 119-117,240,42,85,.494,25,48,.521,17,37,.459,18,20,.900,119,46,92,.500,28,52,.538,18,40,.450,7,12,.583,117
577,MEM,2024-01-12,119,,LAC,L 119-128,240,41,95,.432,23,51,.451,18,44,.409,19,27,.704,119,49,89,.551,34,58,.586,15,31,.484,15,20,.750,128
578,HOU,2024-01-10,119,@,CHI,L 119-124 (OT),265,48,101,.475,37,56,.661,11,45,.244,12,20,.600,119,42,95,.442,23,48,.479,19,47,.404,21,25,.840,124
579,CHI,2024-01-08,119,@,CHO,W 119-112 (OT),265,45,92,.489,36,66,.545,9,26,.346,20,24,.833,119,40,94,.426,23,52,.442,17,42,.405,15,17,.882,112
580,CHO,2023-12-29,119,@,PHO,L 119-133,240,44,92,.478,21,46,.457,23,46,.500,8,8,1.000,119,46,74,.622,28,44,.636,18,30,.600,23,24,.958,133
581,OKC,2023-12-29,119,@,DEN,W 119-93,240,46,91,.505,34,56,.607,12,35,.343,15,16,.938,119,36,85,.424,26,48,.542,10,37,.270,11,15,.733,93
582,MIL,2023-12-29,119,@,CLE,W 119-111,240,41,80,.513,29,51,.569,12,29,.414,25,28,.893,119,49,103,.476,43,60,.717,6,43,.140,7,9,.778,111
583,WAS,2023-12-26,119,,ORL,L 119-127,240,43,87,.494,27,45,.600,16,42,.381,17,21,.810,119,49,93,.527,37,67,.552,12,26,.462,17,25,.680,127
584,MIA,2023-12-25,119,,PHI,W 119-113,240,40,84,.476,28,52,.538,12,32,.375,27,35,.771,119,40,94,.426,23,49,.469,17,45,.378,16,25,.640,113
585,TOR,2023-12-23,119,,UTA,L 119-126,240,45,94,.479,32,62,.516,13,32,.406,16,19,.842,119,48,91,.527,31,53,.585,17,38,.447,13,14,.929,126
586,ATL,2023-12-23,119,,MEM,L 119-125,240,45,96,.469,32,53,.604,13,43,.302,16,20,.800,119,50,97,.515,39,64,.609,11,33,.333,14,22,.636,125
587,SAS,2023-12-23,119,@,DAL,L 119-144,240,44,98,.449,30,53,.566,14,45,.311,17,24,.708,119,52,100,.520,29,55,.527,23,45,.511,17,21,.810,144
588,UTA,2023-12-21,119,@,DET,W 119-111,240,43,94,.457,32,64,.500,11,30,.367,22,24,.917,119,43,86,.500,34,55,.618,9,31,.290,16,19,.842,111
589,SAC,2023-12-20,119,,BOS,L 119-144,240,43,91,.473,22,47,.468,21,44,.477,12,23,.522,119,51,92,.554,29,50,.580,22,42,.524,20,24,.833,144
590,SAS,2023-12-19,119,@,MIL,L 119-132,240,46,96,.479,37,66,.561,9,30,.300,18,21,.857,119,50,106,.472,32,57,.561,18,49,.367,14,18,.778,132
591,HOU,2023-12-17,119,@,MIL,L 119-128,240,45,85,.529,34,58,.586,11,27,.407,18,21,.857,119,45,90,.500,32,54,.593,13,36,.361,25,32,.781,128
592,ATL,2023-12-16,119,@,CLE,L 119-127,240,41,85,.482,26,49,.531,15,36,.417,22,25,.880,119,49,101,.485,33,59,.559,16,42,.381,13,15,.867,127
593,MIN,2023-12-14,119,@,DAL,W 119-101,240,44,88,.500,30,57,.526,14,31,.452,17,25,.680,119,39,83,.470,32,51,.627,7,32,.219,16,18,.889,101
594,SAS,2023-12-13,119,,LAL,L 119-122,240,45,96,.469,29,59,.492,16,37,.432,13,18,.722,119,49,91,.538,35,56,.625,14,35,.400,10,17,.588,122
595,PHO,2023-12-12,119,,GSW,W 119-116,240,38,84,.452,24,45,.533,14,39,.359,29,34,.853,119,41,92,.446,25,46,.543,16,46,.348,18,27,.667,116
596,LAC,2023-12-12,119,,SAC,W 119-99,240,44,84,.524,33,55,.600,11,29,.379,20,21,.952,119,36,86,.419,26,49,.531,10,37,.270,17,24,.708,99
597,CHO,2023-12-08,119,,TOR,W 119-116,240,44,79,.557,31,54,.574,13,25,.520,18,20,.900,119,47,93,.505,41,61,.672,6,32,.188,16,21,.762,116
598,MIL,2023-12-07,119,,IND,L 119-128,240,43,96,.448,31,63,.492,12,33,.364,21,28,.750,119,50,102,.490,43,69,.623,7,33,.212,21,25,.840,128
599,NYK,2023-12-01,119,@,TOR,W 119-106,240,45,90,.500,29,54,.537,16,36,.444,13,16,.813,119,44,100,.440,38,68,.559,6,32,.188,12,17,.706,106
600,DEN,2023-12-01,119,@,PHO,W 119-111,240,50,88,.568,38,56,.679,12,32,.375,7,12,.583,119,39,84,.464,30,57,.526,9,27,.333,24,26,.923,111
601,DEN,2023-12-01,119,@,PHO,W 119-111,240,50,88,.568,38,56,.679,12,32,.375,7,12,.583,119,39,84,.464,30,57,.526,9,27,.333,24,26,.923,111
602,MIN,2023-11-26,119,@,MEM,W 119-97,240,43,81,.531,28,47,.596,15,34,.441,18,23,.783,119,34,88,.386,24,51,.471,10,37,.270,19,27,.704,97
603,DEN,2023-11-22,119,@,ORL,L 119-124,240,44,93,.473,29,58,.500,15,35,.429,16,21,.762,119,44,81,.543,34,52,.654,10,29,.345,26,30,.867,124
604,BOS,2023-11-22,119,,MIL,W 119-116,240,44,84,.524,27,42,.643,17,42,.405,14,17,.824,119,45,101,.446,32,67,.478,13,34,.382,13,17,.765,116
605,PHI,2023-11-21,119,,CLE,L 119-122 (OT),265,40,96,.417,29,61,.475,11,35,.314,28,34,.824,119,46,94,.489,37,69,.536,9,25,.360,21,25,.840,122
606,CHI,2023-11-12,119,,DET,W 119-108,240,44,91,.484,33,61,.541,11,30,.367,20,25,.800,119,38,88,.432,27,56,.482,11,32,.344,21,26,.808,108
607,PHO,2023-11-10,119,,LAL,L 119-122,240,42,94,.447,27,57,.474,15,37,.405,20,27,.741,119,42,84,.500,30,57,.526,12,27,.444,26,34,.765,122
608,ORL,2023-11-09,119,,ATL,L 119-120,240,42,90,.467,32,63,.508,10,27,.370,25,35,.714,119,41,85,.482,26,46,.565,15,39,.385,23,30,.767,120
609,CHO,2023-11-01,119,@,HOU,L 119-128,240,45,90,.500,34,63,.540,11,27,.407,18,25,.720,119,44,84,.524,23,47,.489,21,37,.568,19,23,.826,128
610,BOS,2023-10-27,119,,MIA,W 119-111,240,45,95,.474,29,56,.518,16,39,.410,13,19,.684,119,38,89,.427,22,56,.393,16,33,.485,19,23,.826,111
611,SAS,2023-10-25,119,,DAL,L 119-126,240,46,89,.517,35,54,.648,11,35,.314,16,22,.727,119,47,99,.475,32,52,.615,15,47,.319,17,23,.739,126
612,DEN,2023-10-24,119,,LAL,W 119-107,240,48,91,.527,34,57,.596,14,34,.412,9,12,.750,119,41,90,.456,31,61,.508,10,29,.345,15,20,.750,107
613,CHO,2024-02-05,118,,LAL,L 118-124,240,47,96,.490,34,64,.531,13,32,.406,11,14,.786,118,50,89,.562,42,55,.764,8,34,.235,16,19,.842,124
614,DAL,2024-02-05,118,@,PHI,W 118-102,240,42,87,.483,25,44,.568,17,43,.395,17,23,.739,118,40,93,.430,32,64,.500,8,29,.276,14,20,.700,102
615,TOR,2024-01-30,118,@,CHI,W 118-107,240,43,83,.518,29,54,.537,14,29,.483,18,20,.900,118,38,75,.507,27,43,.628,11,32,.344,20,27,.741,107
616,NYK,2024-01-30,118,,UTA,W 118-103,240,44,94,.468,31,60,.517,13,34,.382,17,18,.944,118,39,86,.453,27,50,.540,12,36,.333,13,17,.765,103
617,WAS,2024-01-29,118,@,SAS,W 118-113,240,46,86,.535,37,61,.607,9,25,.360,17,24,.708,118,43,92,.467,31,62,.500,12,30,.400,15,17,.882,113
618,CLE,2024-01-29,118,,LAC,W 118-108,240,42,86,.488,29,46,.630,13,40,.325,21,26,.808,118,38,80,.475,27,46,.587,11,34,.324,21,28,.750,108
619,PHO,2024-01-29,118,@,MIA,W 118-105,240,46,94,.489,32,54,.593,14,40,.350,12,17,.706,118,33,84,.393,19,48,.396,14,36,.389,25,25,1.000,105
620,BOS,2024-01-29,118,,NOP,W 118-112,240,43,85,.506,26,39,.667,17,46,.370,15,20,.750,118,46,91,.505,36,56,.643,10,35,.286,10,13,.769,112
621,WAS,2024-01-27,118,@,DET,W 118-104,240,45,100,.450,34,66,.515,11,34,.324,17,21,.810,118,37,85,.435,28,53,.528,9,32,.281,21,27,.778,104
622,MIN,2024-01-24,118,@,WAS,W 118-107,240,42,100,.420,33,68,.485,9,32,.281,25,29,.862,118,37,77,.481,27,53,.509,10,24,.417,23,29,.793,107
623,POR,2024-01-19,118,,IND,W 118-115,240,42,84,.500,38,72,.528,4,12,.333,30,35,.857,118,39,91,.429,19,44,.432,20,47,.426,17,25,.680,115
624,MIN,2024-01-18,118,,MEM,W 118-103,240,45,82,.549,33,54,.611,12,28,.429,16,21,.762,118,39,85,.459,25,51,.490,14,34,.412,11,17,.647,103
625,NOP,2024-01-13,118,@,DAL,W 118-108,240,39,79,.494,27,49,.551,12,30,.400,28,37,.757,118,37,82,.451,22,41,.537,15,41,.366,19,20,.950,108
626,GSW,2024-01-13,118,@,MIL,L 118-129,240,47,98,.480,32,62,.516,15,36,.417,9,14,.643,118,51,94,.543,38,63,.603,13,31,.419,14,17,.824,129
627,GSW,2024-01-07,118,,TOR,L 118-133,240,45,100,.450,31,54,.574,14,46,.304,14,15,.933,118,55,94,.585,40,61,.656,15,33,.455,8,14,.571,133
628,BOS,2024-01-06,118,@,IND,W 118-101,240,46,90,.511,30,49,.612,16,41,.390,10,19,.526,118,38,92,.413,30,50,.600,8,42,.190,17,22,.773,101
629,TOR,2023-12-29,118,@,BOS,L 118-120,240,44,95,.463,27,51,.529,17,44,.386,13,20,.650,118,43,88,.489,26,49,.531,17,39,.436,17,20,.850,120
630,MIN,2023-12-28,118,,DAL,W 118-110,240,38,74,.514,21,41,.512,17,33,.515,25,34,.735,118,40,90,.444,26,57,.456,14,33,.424,16,19,.842,110
631,SAS,2023-12-28,118,@,POR,W 118-105,240,41,85,.482,31,49,.633,10,36,.278,26,28,.929,118,35,101,.347,24,65,.369,11,36,.306,24,32,.750,105
632,SAS,2023-12-26,118,,UTA,L 118-130,240,44,98,.449,28,63,.444,16,35,.457,14,21,.667,118,47,95,.495,31,52,.596,16,43,.372,20,22,.909,130
633,CHI,2023-12-26,118,,ATL,W 118-113,240,42,92,.457,35,67,.522,7,25,.280,27,31,.871,118,41,89,.461,28,44,.636,13,45,.289,18,21,.857,113
634,BRK,2023-12-26,118,@,DET,W 118-112,240,41,82,.500,32,60,.533,9,22,.409,27,43,.628,118,40,90,.444,31,65,.477,9,25,.360,23,32,.719,112
635,WAS,2023-12-22,118,@,GSW,L 118-129,240,44,97,.454,33,62,.532,11,35,.314,19,24,.792,118,47,97,.485,29,52,.558,18,45,.400,17,20,.850,129
636,MIL,2023-12-21,118,,ORL,W 118-114,240,38,90,.422,27,53,.509,11,37,.297,31,35,.886,118,45,99,.455,37,66,.561,8,33,.242,16,23,.696,114
637,MIN,2023-12-21,118,,LAL,W 118-111,240,42,87,.483,28,51,.549,14,36,.389,20,25,.800,118,41,83,.494,31,59,.525,10,24,.417,19,24,.792,111
638,WAS,2023-12-21,118,@,POR,W 118-117,240,42,84,.500,30,54,.556,12,30,.400,22,32,.688,118,43,95,.453,29,65,.446,14,30,.467,17,23,.739,117
639,GSW,2023-12-17,118,@,POR,W 118-114,240,46,87,.529,33,49,.673,13,38,.342,13,19,.684,118,40,85,.471,27,50,.540,13,35,.371,21,23,.913,114
640,MIA,2023-12-16,118,,CHI,W 118-116,240,43,83,.518,30,48,.625,13,35,.371,19,25,.760,118,37,77,.481,21,39,.538,16,38,.421,26,29,.897,116
641,OKC,2023-12-16,118,@,DEN,W 118-117,240,43,84,.512,36,63,.571,7,21,.333,25,30,.833,118,42,93,.452,30,61,.492,12,32,.375,21,24,.875,117
642,BRK,2023-12-11,118,@,SAC,L 118-131,240,42,88,.477,28,59,.475,14,29,.483,20,21,.952,118,48,94,.511,23,49,.469,25,45,.556,10,14,.714,131
643,UTA,2023-12-02,118,,POR,W 118-113 (OT),265,46,94,.489,39,60,.650,7,34,.206,19,24,.792,118,38,95,.400,25,55,.455,13,40,.325,24,27,.889,113
644,NOP,2023-12-02,118,@,CHI,L 118-124,240,41,82,.500,33,57,.579,8,25,.320,28,35,.800,118,48,88,.545,31,48,.646,17,40,.425,11,15,.733,124
645,NYK,2023-11-30,118,,DET,W 118-112,240,41,88,.466,25,47,.532,16,41,.390,20,28,.714,118,43,81,.531,28,46,.609,15,35,.429,11,17,.647,112
646,BRK,2023-11-26,118,,CHI,W 118-109,240,41,83,.494,16,30,.533,25,53,.472,11,15,.733,118,40,83,.482,28,51,.549,12,32,.375,17,22,.773,109
647,GSW,2023-11-24,118,,SAS,W 118-112,240,40,81,.494,21,39,.538,19,42,.452,19,24,.792,118,45,100,.450,33,53,.623,12,47,.255,10,12,.833,112
648,BOS,2023-11-20,118,@,CHO,L 118-121 (OT),265,42,97,.433,26,47,.553,16,50,.320,18,28,.643,118,46,104,.442,33,65,.508,13,39,.333,16,17,.941,121
649,MIA,2023-11-20,118,@,CHI,W 118-100,240,42,84,.500,25,49,.510,17,35,.486,17,20,.850,118,37,81,.457,26,44,.591,11,37,.297,15,16,.938,100
650,MIL,2023-11-13,118,,CHI,W 118-109,240,42,89,.472,27,42,.643,15,47,.319,19,27,.704,118,38,100,.380,24,58,.414,14,42,.333,19,21,.905,109
651,MIA,2023-11-12,118,@,SAS,W 118-113,240,39,89,.438,27,58,.466,12,31,.387,28,30,.933,118,42,91,.462,23,47,.489,19,44,.432,10,12,.833,113
652,CLE,2023-11-11,118,@,GSW,W 118-110,240,37,86,.430,26,56,.464,11,30,.367,33,43,.767,118,37,90,.411,24,52,.462,13,38,.342,23,30,.767,110
653,UTA,2023-11-08,118,@,IND,L 118-134,240,45,96,.469,34,69,.493,11,27,.407,17,18,.944,118,52,101,.515,39,60,.650,13,41,.317,17,20,.850,134
654,DET,2023-11-08,118,@,MIL,L 118-120,240,48,98,.490,41,69,.594,7,29,.241,15,16,.938,118,41,90,.456,30,53,.566,11,37,.297,27,32,.844,120
655,POR,2023-11-08,118,@,SAC,L 118-121 (OT),265,44,87,.506,36,65,.554,8,22,.364,22,29,.759,118,41,89,.461,30,52,.577,11,37,.297,28,38,.737,121
656,CHO,2023-11-05,118,@,DAL,L 118-124,240,49,99,.495,41,69,.594,8,30,.267,12,21,.571,118,43,91,.473,29,49,.592,14,42,.333,24,32,.750,124
657,LAC,2023-10-31,118,,ORL,W 118-102,240,44,89,.494,30,58,.517,14,31,.452,16,23,.696,118,38,81,.469,31,51,.608,7,30,.233,19,33,.576,102
658,DET,2023-10-28,118,,CHI,W 118-102,240,45,86,.523,33,58,.569,12,28,.429,16,20,.800,118,39,93,.419,28,65,.431,11,28,.393,13,16,.813,102
659,LAC,2023-10-27,118,@,UTA,L 118-120,240,41,77,.532,27,42,.643,14,35,.400,22,28,.786,118,42,96,.438,26,55,.473,16,41,.390,20,22,.909,120
660,MIL,2023-10-26,118,,PHI,W 118-117,240,41,81,.506,30,51,.588,11,30,.367,25,36,.694,118,41,80,.513,25,45,.556,16,35,.457,19,28,.679,117
661,ATL,2024-02-07,117,@,BOS,L 117-125,240,43,102,.422,30,61,.492,13,41,.317,18,20,.900,117,49,93,.527,32,44,.727,17,49,.347,10,11,.909,125
662,NOP,2024-02-07,117,@,LAC,W 117-106,240,47,88,.534,35,56,.625,12,32,.375,11,16,.688,117,36,78,.462,24,46,.522,12,32,.375,22,26,.846,106
663,CHO,2024-02-07,117,,TOR,L 117-123,240,44,90,.489,28,51,.549,16,39,.410,13,20,.650,117,43,81,.531,26,48,.542,17,33,.515,20,24,.833,123
664,OKC,2024-02-06,117,@,UTA,L 117-124,240,43,90,.478,24,53,.453,19,37,.514,12,18,.667,117,46,89,.517,32,54,.593,14,35,.400,18,20,.900,124
665,CLE,2024-02-03,117,@,SAS,W 117-101,240,46,97,.474,33,53,.623,13,44,.295,12,13,.923,117,36,98,.367,24,58,.414,12,40,.300,17,21,.810,101
666,DAL,2024-02-03,117,,MIL,L 117-129,240,40,81,.494,24,42,.571,16,39,.410,21,23,.913,117,50,88,.568,38,58,.655,12,30,.400,17,25,.680,129
667,CHI,2024-01-31,117,@,CHO,W 117-110,240,45,87,.517,34,58,.586,11,29,.379,16,22,.727,117,40,90,.444,24,44,.545,16,46,.348,14,17,.824,110
668,NOP,2024-01-27,117,@,MIL,L 117-141,240,40,85,.471,31,62,.500,9,23,.391,28,36,.778,117,51,91,.560,31,46,.674,20,45,.444,19,25,.760,141
669,PHO,2024-01-21,117,,IND,W 117-110,240,47,82,.573,39,57,.684,8,25,.320,15,18,.833,117,41,94,.436,27,63,.429,14,31,.452,14,23,.609,110
670,DET,2024-01-17,117,,MIN,L 117-124,240,46,89,.517,34,58,.586,12,31,.387,13,19,.684,117,47,93,.505,32,63,.508,15,30,.500,15,21,.714,124
671,BOS,2024-01-17,117,,SAS,W 117-98,240,42,90,.467,24,52,.462,18,38,.474,15,19,.789,117,39,93,.419,32,59,.542,7,34,.206,13,16,.813,98
672,OKC,2024-01-16,117,@,LAC,L 117-128,240,42,83,.506,26,49,.531,16,34,.471,17,20,.850,117,47,87,.540,27,44,.614,20,43,.465,14,23,.609,128
673,SAC,2024-01-16,117,@,PHO,L 117-119,240,46,92,.500,28,52,.538,18,40,.450,7,12,.583,117,42,85,.494,25,48,.521,17,37,.459,18,20,.900,119
674,WAS,2024-01-15,117,,DET,L 117-129,240,44,95,.463,25,54,.463,19,41,.463,10,11,.909,117,50,90,.556,38,59,.644,12,31,.387,17,23,.739,129
675,DEN,2024-01-14,117,,IND,W 117-109,240,46,71,.648,36,51,.706,10,20,.500,15,23,.652,117,43,92,.467,35,63,.556,8,29,.276,15,22,.682,109
676,ORL,2024-01-07,117,,ATL,W 117-110 (OT),265,43,98,.439,26,57,.456,17,41,.415,14,22,.636,117,42,91,.462,33,61,.541,9,30,.300,17,29,.586,110
677,CLE,2024-01-07,117,,SAS,W 117-115,240,43,88,.489,27,45,.600,16,43,.372,15,21,.714,117,41,86,.477,27,49,.551,14,37,.378,19,22,.864,115
678,NOP,2024-01-03,117,@,MIN,W 117-106,240,45,81,.556,33,55,.600,12,26,.462,15,17,.882,117,37,82,.451,27,51,.529,10,31,.323,22,27,.815,106
679,UTA,2023-12-30,117,,MIA,W 117-109,240,43,93,.462,32,52,.615,11,41,.268,20,28,.714,117,34,78,.436,25,47,.532,9,31,.290,32,40,.800,109
680,SAC,2023-12-29,117,@,ATL,W 117-110,240,46,89,.517,29,44,.659,17,45,.378,8,15,.533,117,37,94,.394,22,51,.431,15,43,.349,21,25,.840,110
681,ORL,2023-12-29,117,,NYK,W 117-108,240,40,89,.449,33,56,.589,7,33,.212,30,40,.750,117,38,86,.442,32,56,.571,6,30,.200,26,29,.897,108
682,LAC,2023-12-29,117,,MEM,W 117-106,240,43,87,.494,32,48,.667,11,39,.282,20,25,.800,117,38,87,.437,25,47,.532,13,40,.325,17,20,.850,106
683,HOU,2023-12-26,117,,IND,L 117-123,240,47,97,.485,42,73,.575,5,24,.208,18,22,.818,117,43,82,.524,24,39,.615,19,43,.442,18,21,.857,123
684,ORL,2023-12-23,117,@,IND,W 117-110,240,39,73,.534,33,55,.600,6,18,.333,33,41,.805,117,43,82,.524,28,48,.583,15,34,.441,9,13,.692,110
685,BRK,2023-12-22,117,,DEN,L 117-122,240,43,89,.483,30,56,.536,13,33,.394,18,26,.692,117,45,87,.517,34,61,.557,11,26,.423,21,25,.840,122
686,POR,2023-12-21,117,,WAS,L 117-118,240,43,95,.453,29,65,.446,14,30,.467,17,23,.739,117,42,84,.500,30,54,.556,12,30,.400,22,32,.688,118
687,DEN,2023-12-16,117,,OKC,L 117-118,240,42,93,.452,30,61,.492,12,32,.375,21,24,.875,117,43,84,.512,36,63,.571,7,21,.333,25,30,.833,118
688,UTA,2023-12-13,117,,NYK,W 117-113,240,43,98,.439,27,56,.482,16,42,.381,15,21,.714,117,41,94,.436,32,55,.582,9,39,.231,22,32,.688,113
689,HOU,2023-12-13,117,,MEM,W 117-104,240,39,86,.453,27,54,.500,12,32,.375,27,37,.730,117,35,82,.427,25,44,.568,10,38,.263,24,34,.706,104
690,LAC,2023-12-08,117,@,UTA,W 117-103,240,43,88,.489,28,54,.519,15,34,.441,16,21,.762,117,38,84,.452,29,53,.547,9,31,.290,18,24,.750,103
691,SAC,2023-12-04,117,,NOP,L 117-127,240,38,85,.447,24,44,.545,14,41,.341,27,33,.818,117,47,87,.540,33,56,.589,14,31,.452,19,23,.826,127
692,CHO,2023-12-02,117,,MIN,L 117-123,240,44,91,.484,32,66,.485,12,25,.480,17,19,.895,117,43,84,.512,32,53,.604,11,31,.355,26,30,.867,123
693,DEN,2023-12-02,117,@,SAC,L 117-123,240,49,99,.495,43,74,.581,6,25,.240,13,20,.650,117,48,99,.485,32,65,.492,16,34,.471,11,15,.733,123
694,SAC,2023-11-29,117,,LAC,L 117-131,240,40,86,.465,27,45,.600,13,41,.317,24,28,.857,117,50,93,.538,36,65,.554,14,28,.500,17,22,.773,131
695,CHO,2023-11-26,117,@,ORL,L 117-130,240,44,83,.530,31,53,.585,13,30,.433,16,25,.640,117,47,87,.540,37,60,.617,10,27,.370,26,33,.788,130
696,CHO,2023-11-22,117,,WAS,W 117-114,240,43,91,.473,27,54,.500,16,37,.432,15,21,.714,117,44,97,.454,33,65,.508,11,32,.344,15,18,.833,114
697,NOP,2023-11-22,117,,SAC,W 117-112,240,41,87,.471,34,57,.596,7,30,.233,28,37,.757,117,34,76,.447,19,32,.594,15,44,.341,29,35,.829,112
698,MIN,2023-11-20,117,,NYK,W 117-100,240,41,80,.513,30,46,.652,11,34,.324,24,32,.750,117,32,92,.348,23,54,.426,9,38,.237,27,34,.794,100
699,BOS,2023-11-15,117,@,PHI,W 117-107,240,42,88,.477,24,38,.632,18,50,.360,15,19,.789,117,39,85,.459,28,55,.509,11,30,.367,18,22,.818,107
700,WAS,2023-11-15,117,,DAL,L 117-130,240,43,89,.483,31,53,.585,12,36,.333,19,23,.826,117,48,92,.522,31,50,.620,17,42,.405,17,29,.586,130
701,BOS,2023-11-11,117,,TOR,W 117-94,240,47,86,.547,32,42,.762,15,44,.341,8,13,.615,117,35,91,.385,25,54,.463,10,37,.270,14,16,.875,94
702,MIA,2023-11-11,117,@,ATL,W 117-109,240,41,84,.488,29,46,.630,12,38,.316,23,25,.920,117,38,87,.437,20,41,.488,18,46,.391,15,18,.833,109
703,WAS,2023-11-10,117,,CHO,L 117-124,240,43,88,.489,29,50,.580,14,38,.368,17,20,.850,117,50,110,.455,44,82,.537,6,28,.214,18,28,.643,124
704,MIN,2023-11-10,117,@,SAS,W 117-110,240,43,87,.494,33,60,.550,10,27,.370,21,27,.778,117,43,92,.467,31,58,.534,12,34,.353,12,19,.632,110
705,DAL,2023-11-06,117,@,ORL,W 117-102,240,41,82,.500,26,42,.619,15,40,.375,20,28,.714,117,40,85,.471,32,58,.552,8,27,.296,14,18,.778,102
706,ATL,2023-11-06,117,@,OKC,L 117-126,240,38,102,.373,24,60,.400,14,42,.333,27,32,.844,117,45,94,.479,31,59,.525,14,35,.400,22,23,.957,126
707,PHI,2023-10-26,117,@,MIL,L 117-118,240,41,80,.513,25,45,.556,16,35,.457,19,28,.679,117,41,81,.506,30,51,.588,11,30,.367,25,36,.694,118
708,MIA,2024-02-07,116,,SAS,W 116-104,240,43,87,.494,31,49,.633,12,38,.316,18,23,.783,116,41,90,.456,29,53,.547,12,37,.324,10,17,.588,104
709,MIL,2024-01-31,116,@,POR,L 116-119,240,45,92,.489,32,47,.681,13,45,.289,13,18,.722,116,49,92,.533,37,64,.578,12,28,.429,9,9,1.000,119
710,IND,2024-01-28,116,,MEM,W 116-110,240,44,90,.489,31,55,.564,13,35,.371,15,16,.938,116,38,82,.463,27,52,.519,11,30,.367,23,31,.742,110
711,SAS,2024-01-26,116,,POR,W 116-100,240,42,92,.457,32,58,.552,10,34,.294,22,26,.846,116,38,90,.422,28,53,.528,10,37,.270,14,19,.737,100
712,CLE,2024-01-24,116,@,MIL,L 116-126,240,46,91,.505,33,53,.623,13,38,.342,11,15,.733,116,45,90,.500,34,61,.557,11,29,.379,25,28,.893,126
713,LAL,2024-01-23,116,@,LAC,L 116-127,240,45,92,.489,34,60,.567,11,32,.344,15,22,.682,116,52,88,.591,38,61,.623,14,27,.519,9,12,.750,127
714,BOS,2024-01-21,116,@,HOU,W 116-107,240,43,98,.439,26,51,.510,17,47,.362,13,18,.722,116,41,94,.436,31,59,.525,10,35,.286,15,22,.682,107
715,CLE,2024-01-20,116,@,ATL,W 116-95,240,43,85,.506,27,42,.643,16,43,.372,14,16,.875,116,37,93,.398,26,55,.473,11,38,.289,10,15,.667,95
716,CHI,2024-01-18,116,@,TOR,W 116-110,240,48,91,.527,42,67,.627,6,24,.250,14,17,.824,116,42,83,.506,32,45,.711,10,38,.263,16,20,.800,110
717,MEM,2024-01-15,116,,GSW,W 116-107,240,32,86,.372,12,32,.375,20,54,.370,32,40,.800,116,44,90,.489,34,59,.576,10,31,.323,9,10,.900,107
718,POR,2024-01-14,116,,PHO,L 116-127,240,40,89,.449,20,47,.426,20,42,.476,16,22,.727,116,46,76,.605,33,48,.688,13,28,.464,22,27,.815,127
719,SAS,2024-01-13,116,,CHI,L 116-122,240,39,95,.411,21,49,.429,18,46,.391,20,23,.870,116,46,90,.511,31,56,.554,15,34,.441,15,20,.750,122
720,MIN,2024-01-12,116,,POR,W 116-93,240,44,80,.550,33,49,.673,11,31,.355,17,24,.708,116,30,77,.390,20,49,.408,10,28,.357,23,34,.676,93
721,MIL,2024-01-08,116,,UTA,L 116-132,240,42,94,.447,25,58,.431,17,36,.472,15,19,.789,116,47,90,.522,27,46,.587,20,44,.455,18,22,.818,132
722,ATL,2024-01-05,116,@,IND,L 116-150,240,40,93,.430,30,51,.588,10,42,.238,26,30,.867,116,60,94,.638,41,55,.745,19,39,.487,11,13,.846,150
723,TOR,2024-01-03,116,@,MEM,W 116-111,240,41,85,.482,29,59,.492,12,26,.462,22,27,.815,116,40,94,.426,25,52,.481,15,42,.357,16,19,.842,111
724,NYK,2024-01-03,116,,CHI,W 116-100,240,46,89,.517,31,51,.608,15,38,.395,9,11,.818,116,37,89,.416,24,57,.421,13,32,.406,13,16,.813,100
725,MEM,2023-12-26,116,@,NOP,W 116-115 (OT),265,39,90,.433,28,44,.636,11,46,.239,27,32,.844,116,42,97,.433,32,66,.485,10,31,.323,21,33,.636,115
726,MEM,2023-12-21,116,,IND,W 116-103,240,43,84,.512,27,49,.551,16,35,.457,14,21,.667,116,38,90,.422,20,38,.526,18,52,.346,9,11,.818,103
727,UTA,2023-12-20,116,@,CLE,L 116-124,240,40,78,.513,27,48,.563,13,30,.433,23,28,.821,116,45,96,.469,22,45,.489,23,51,.451,11,16,.688,124
728,OKC,2023-12-18,116,,MEM,W 116-97,240,42,92,.457,31,56,.554,11,36,.306,21,23,.913,116,30,85,.353,11,31,.355,19,54,.352,18,21,.857,97
729,CHI,2023-12-16,116,@,MIA,L 116-118,240,37,77,.481,21,39,.538,16,38,.421,26,29,.897,116,43,83,.518,30,48,.625,13,35,.371,19,25,.760,118
730,BOS,2023-12-14,116,,CLE,W 116-107,240,43,85,.506,30,49,.612,13,36,.361,17,20,.850,116,40,83,.482,29,50,.580,11,33,.333,16,17,.941,107
731,MIA,2023-12-14,116,,CHI,L 116-124,240,37,80,.463,22,46,.478,15,34,.441,27,35,.771,116,45,93,.484,31,57,.544,14,36,.389,20,30,.667,124
732,BRK,2023-12-13,116,@,PHO,W 116-112,240,41,89,.461,26,48,.542,15,41,.366,19,24,.792,116,40,84,.476,31,56,.554,9,28,.321,23,27,.852,112
733,GSW,2023-12-12,116,@,PHO,L 116-119,240,41,92,.446,25,46,.543,16,46,.348,18,27,.667,116,38,84,.452,24,45,.533,14,39,.359,29,34,.853,119
734,MIA,2023-12-11,116,@,CHO,W 116-114,240,37,77,.481,22,42,.524,15,35,.429,27,34,.794,116,40,84,.476,23,43,.535,17,41,.415,17,22,.773,114
735,TOR,2023-12-08,116,@,CHO,L 116-119,240,47,93,.505,41,61,.672,6,32,.188,16,21,.762,116,44,79,.557,31,54,.574,13,25,.520,18,20,.900,119
736,MEM,2023-12-06,116,@,DET,W 116-102,240,47,91,.516,36,65,.554,11,26,.423,11,14,.786,116,41,91,.451,30,56,.536,11,35,.314,9,9,1.000,102
737,PHO,2023-12-02,116,,MEM,W 116-109,240,36,83,.434,27,57,.474,9,26,.346,35,43,.814,116,39,86,.453,30,55,.545,9,31,.290,22,24,.917,109
738,PHO,2023-11-26,116,@,NYK,W 116-113,240,42,91,.462,26,53,.491,16,38,.421,16,21,.762,116,39,86,.453,27,57,.474,12,29,.414,23,32,.719,113
739,NOP,2023-11-24,116,@,LAC,W 116-106,240,43,88,.489,33,64,.516,10,24,.417,20,27,.741,116,42,92,.457,31,55,.564,11,37,.297,11,17,.647,106
740,OKC,2023-11-22,116,,CHI,W 116-102,240,37,75,.493,26,46,.565,11,29,.379,31,38,.816,116,34,88,.386,17,44,.386,17,44,.386,17,17,1.000,102
741,MIL,2023-11-22,116,@,BOS,L 116-119,240,45,101,.446,32,67,.478,13,34,.382,13,17,.765,116,44,84,.524,27,42,.643,17,42,.405,14,17,.824,119
742,HOU,2023-11-20,116,@,GSW,L 116-121,240,44,95,.463,31,54,.574,13,41,.317,15,19,.789,116,36,77,.468,15,34,.441,21,43,.488,28,33,.848,121
743,IND,2023-11-19,116,,ORL,L 116-128,240,42,95,.442,34,64,.531,8,31,.258,24,31,.774,116,43,87,.494,36,67,.537,7,20,.350,35,42,.833,128
744,ATL,2023-11-17,116,,PHI,L 116-126,240,40,89,.449,28,56,.500,12,33,.364,24,30,.800,116,43,88,.489,30,58,.517,13,30,.433,27,28,.964,126
745,NYK,2023-11-15,116,@,ATL,W 116-114,240,45,94,.479,29,60,.483,16,34,.471,10,11,.909,116,41,75,.547,29,44,.659,12,31,.387,20,26,.769,114
746,MIN,2023-11-12,116,@,GSW,W 116-110,240,43,82,.524,34,55,.618,9,27,.333,21,30,.700,116,37,96,.385,25,53,.472,12,43,.279,24,28,.857,110
747,LAL,2023-11-12,116,,POR,W 116-110,240,41,84,.488,37,65,.569,4,19,.211,30,37,.811,116,45,90,.500,32,53,.604,13,37,.351,7,9,.778,110
748,DAL,2023-11-08,116,,TOR,L 116-127,240,40,84,.476,23,43,.535,17,41,.415,19,31,.613,116,49,99,.495,38,63,.603,11,36,.306,18,27,.667,127
749,PHO,2023-11-08,116,@,CHI,W 116-115 (OT),265,38,90,.422,19,42,.452,19,48,.396,21,25,.840,116,42,96,.438,28,63,.444,14,33,.424,17,23,.739,115
750,CHO,2023-11-08,116,,WAS,L 116-132,240,41,79,.519,33,54,.611,8,25,.320,26,35,.743,116,47,97,.485,29,54,.537,18,43,.419,20,25,.800,132
751,NOP,2023-11-06,116,@,DEN,L 116-134,240,45,90,.500,32,60,.533,13,30,.433,13,15,.867,116,51,95,.537,36,56,.643,15,39,.385,17,23,.739,134
752,SAS,2023-11-05,116,,TOR,L 116-123 (OT),265,48,96,.500,38,64,.594,10,32,.313,10,13,.769,116,44,97,.454,25,49,.510,19,48,.396,16,26,.615,123
753,CLE,2023-11-03,116,@,IND,L 116-121,240,44,84,.524,36,56,.643,8,28,.286,20,25,.800,116,45,86,.523,30,55,.545,15,31,.484,16,24,.667,121
754,DET,2023-11-02,116,@,NOP,L 116-125,240,41,94,.436,28,56,.500,13,38,.342,21,26,.808,116,39,80,.488,25,48,.521,14,32,.438,33,35,.943,125
755,CHO,2023-10-25,116,,ATL,W 116-110,240,43,86,.500,32,49,.653,11,37,.297,19,26,.731,116,39,93,.419,34,64,.531,5,29,.172,27,33,.818,110
756,ORL,2023-10-25,116,,HOU,W 116-86,240,42,87,.483,33,53,.623,9,34,.265,23,26,.885,116,32,79,.405,20,45,.444,12,34,.353,10,16,.625,86
757,IND,2024-02-04,115,@,CHO,W 115-99,240,45,92,.489,34,59,.576,11,33,.333,14,18,.778,115,35,88,.398,27,59,.458,8,29,.276,21,25,.840,99
758,CHI,2024-02-03,115,,SAC,L 115-123,240,42,91,.462,31,57,.544,11,34,.324,20,22,.909,115,42,84,.500,27,45,.600,15,39,.385,24,29,.828,123
759,MIA,2024-01-31,115,,SAC,W 115-106,240,42,84,.500,29,56,.518,13,28,.464,18,23,.783,115,41,93,.441,29,53,.547,12,40,.300,12,18,.667,106
760,DAL,2024-01-27,115,,SAC,L 115-120,240,43,98,.439,27,52,.519,16,46,.348,13,18,.722,115,43,80,.538,32,50,.640,11,30,.367,23,30,.767,120
761,LAC,2024-01-27,115,@,BOS,W 115-96,240,45,102,.441,35,62,.565,10,40,.250,15,18,.833,115,36,100,.360,26,60,.433,10,40,.250,14,16,.875,96
762,PHO,2024-01-22,115,,CHI,W 115-113,240,44,85,.518,30,51,.588,14,34,.412,13,17,.765,115,45,93,.484,31,56,.554,14,37,.378,9,14,.643,113
763,IND,2024-01-19,115,@,POR,L 115-118,240,39,91,.429,19,44,.432,20,47,.426,17,25,.680,115,42,84,.500,38,72,.528,4,12,.333,30,35,.857,118
764,HOU,2024-01-15,115,@,PHI,L 115-124,240,44,88,.500,36,61,.590,8,27,.296,19,32,.594,115,40,83,.482,25,52,.481,15,31,.484,29,34,.853,124
765,DAL,2024-01-07,115,,MIN,W 115-108,240,43,95,.453,28,55,.509,15,40,.375,14,20,.700,115,41,94,.436,28,53,.528,13,41,.317,13,21,.619,108
766,PHO,2024-01-07,115,,MEM,L 115-121,240,46,102,.451,38,74,.514,8,28,.286,15,22,.682,115,43,97,.443,26,48,.542,17,49,.347,18,24,.750,121
767,SAS,2024-01-07,115,@,CLE,L 115-117,240,41,86,.477,27,49,.551,14,37,.378,19,22,.864,115,43,88,.489,27,45,.600,16,43,.372,15,21,.714,117
768,OKC,2024-01-05,115,@,BRK,L 115-124,240,45,84,.536,36,53,.679,9,31,.290,16,24,.667,115,41,91,.451,27,52,.519,14,39,.359,28,33,.848,124
769,ORL,2024-01-02,115,@,GSW,L 115-121,240,41,92,.446,27,56,.482,14,36,.389,19,23,.826,115,42,78,.538,29,43,.674,13,35,.371,24,37,.649,121
770,NOP,2023-12-26,115,,MEM,L 115-116 (OT),265,42,97,.433,32,66,.485,10,31,.323,21,33,.636,115,39,90,.433,28,44,.636,11,46,.239,27,32,.844,116
771,LAL,2023-12-25,115,,BOS,L 115-126,240,43,90,.478,30,58,.517,13,32,.406,16,21,.762,115,46,91,.505,33,49,.673,13,42,.310,21,28,.750,126
772,DET,2023-12-23,115,@,BRK,L 115-126,240,39,79,.494,24,44,.545,15,35,.429,22,29,.759,115,45,86,.523,35,62,.565,10,24,.417,26,32,.813,126
773,LAC,2023-12-21,115,@,OKC,L 115-134,240,44,93,.473,27,50,.540,17,43,.395,10,12,.833,115,51,87,.586,35,53,.660,16,34,.471,16,18,.889,134
774,MIA,2023-12-20,115,@,ORL,W 115-106,240,40,83,.482,25,54,.463,15,29,.517,20,24,.833,115,41,89,.461,32,53,.604,9,36,.250,15,19,.789,106
775,MEM,2023-12-19,115,@,NOP,W 115-113,240,41,82,.500,31,51,.608,10,31,.323,23,29,.793,115,40,85,.471,29,60,.483,11,25,.440,22,24,.917,113
776,LAL,2023-12-15,115,@,SAS,L 115-129,240,43,89,.483,32,53,.604,11,36,.306,18,28,.643,115,47,95,.495,29,53,.547,18,42,.429,17,19,.895,129
777,MIA,2023-12-13,115,,CHO,W 115-104,240,41,86,.477,26,56,.464,15,30,.500,18,19,.947,115,41,77,.532,29,46,.630,12,31,.387,10,11,.909,104
778,NYK,2023-11-28,115,,CHO,W 115-91,240,41,88,.466,26,50,.520,15,38,.395,18,20,.900,115,37,89,.416,24,58,.414,13,31,.419,4,7,.571,91
779,HOU,2023-11-28,115,@,DAL,L 115-121,240,42,85,.494,34,56,.607,8,29,.276,23,29,.793,115,42,89,.472,30,55,.545,12,34,.353,25,29,.862,121
780,BRK,2023-11-28,115,,TOR,W 115-103,240,40,89,.449,27,51,.529,13,38,.342,22,26,.846,115,39,101,.386,26,65,.400,13,36,.361,12,19,.632,103
781,CLE,2023-11-25,115,,LAL,L 115-121,240,43,91,.473,34,63,.540,9,28,.321,20,23,.870,115,47,90,.522,38,63,.603,9,27,.333,18,21,.857,121
782,GSW,2023-11-22,115,@,PHO,L 115-123,240,43,90,.478,33,58,.569,10,32,.313,19,29,.655,115,34,76,.447,23,48,.479,11,28,.393,44,52,.846,123
783,NOP,2023-11-17,115,,DEN,W 115-110,240,46,88,.523,34,65,.523,12,23,.522,11,21,.524,115,47,96,.490,37,56,.661,10,40,.250,6,12,.500,110
784,BRK,2023-11-16,115,@,MIA,L 115-122,240,40,85,.471,26,49,.531,14,36,.389,21,27,.778,115,42,81,.519,27,46,.587,15,35,.429,23,24,.958,122
785,MIN,2023-11-15,115,@,PHO,L 115-133,240,42,92,.457,37,65,.569,5,27,.185,26,28,.929,115,51,85,.600,34,54,.630,17,31,.548,14,15,.933,133
786,UTA,2023-11-14,115,,POR,W 115-99,240,44,95,.463,31,52,.596,13,43,.302,14,15,.933,115,37,88,.420,26,53,.491,11,35,.314,14,20,.700,99
787,CHI,2023-11-08,115,,PHO,L 115-116 (OT),265,42,96,.438,28,63,.444,14,33,.424,17,23,.739,115,38,90,.422,19,42,.452,19,48,.396,21,25,.840,116
788,CLE,2023-11-05,115,,GSW,W 115-104,240,41,83,.494,30,46,.652,11,37,.297,22,28,.786,115,34,94,.362,18,53,.340,16,41,.390,20,30,.667,104
789,POR,2023-11-03,115,,MEM,W 115-113 (OT),265,39,96,.406,30,64,.469,9,32,.281,28,36,.778,115,47,96,.490,37,61,.607,10,35,.286,9,13,.692,113
790,ORL,2023-11-02,115,@,UTA,W 115-113,240,39,85,.459,29,56,.518,10,29,.345,27,36,.750,115,41,89,.461,29,56,.518,12,33,.364,19,26,.731,113
791,SAS,2023-10-31,115,@,PHO,W 115-114,240,43,92,.467,29,55,.527,14,37,.378,15,20,.750,115,42,83,.506,24,44,.545,18,39,.462,12,15,.800,114
792,CLE,2024-02-07,114,@,WAS,W 114-106,240,43,88,.489,31,53,.585,12,35,.343,16,22,.727,114,42,94,.447,26,54,.481,16,40,.400,6,9,.667,106
793,PHO,2024-02-06,114,,MIL,W 114-106,240,44,87,.506,36,59,.610,8,28,.286,18,27,.667,114,39,90,.433,26,50,.520,13,40,.325,15,25,.600,106
794,NOP,2024-02-02,114,@,SAS,W 114-113,240,46,95,.484,39,69,.565,7,26,.269,15,21,.714,114,46,96,.479,36,57,.632,10,39,.256,11,18,.611,113
795,LAL,2024-02-01,114,@,BOS,W 114-105,240,38,94,.404,19,58,.328,19,36,.528,19,26,.731,114,41,97,.423,25,49,.510,16,48,.333,7,7,1.000,105
796,UTA,2024-01-29,114,@,BRK,L 114-147,240,39,86,.453,30,59,.508,9,27,.333,27,34,.794,114,54,105,.514,33,60,.550,21,45,.467,18,19,.947,147
797,SAS,2024-01-24,114,,OKC,L 114-140,240,43,86,.500,34,54,.630,9,32,.281,19,25,.760,114,54,96,.563,36,56,.643,18,40,.450,14,16,.875,140
798,DEN,2024-01-23,114,@,IND,W 114-109,240,44,88,.500,33,55,.600,11,33,.333,15,17,.882,114,43,87,.494,38,66,.576,5,21,.238,18,21,.857,109
799,BRK,2024-01-21,114,@,LAC,L 114-125,240,44,90,.489,30,51,.588,14,39,.359,12,16,.750,114,42,83,.506,29,57,.509,13,26,.500,28,33,.848,125
800,DET,2024-01-07,114,@,DEN,L 114-131,240,42,89,.472,33,65,.508,9,24,.375,21,30,.700,114,47,80,.588,37,53,.698,10,27,.370,27,31,.871,131
801,CLE,2024-01-05,114,,WAS,W 114-90,240,41,77,.532,25,44,.568,16,33,.485,16,23,.696,114,35,84,.417,26,54,.481,9,30,.300,11,15,.733,90
802,MIA,2023-12-28,114,@,GSW,W 114-102,240,44,91,.484,34,60,.567,10,31,.323,16,22,.727,114,37,88,.420,29,55,.527,8,33,.242,20,25,.800,102
803,GSW,2023-12-25,114,@,DEN,L 114-120,240,40,87,.460,26,47,.553,14,40,.350,20,23,.870,114,40,82,.488,26,48,.542,14,34,.412,26,32,.813,120
804,PHO,2023-12-25,114,,DAL,L 114-128,240,40,90,.444,26,49,.531,14,41,.341,20,25,.800,114,45,84,.536,29,40,.725,16,44,.364,22,30,.733,128
805,CHI,2023-12-21,114,,SAS,W 114-95,240,49,90,.544,42,62,.677,7,28,.250,9,11,.818,114,37,81,.457,27,51,.529,10,30,.333,11,16,.688,95
806,ORL,2023-12-21,114,@,MIL,L 114-118,240,45,99,.455,37,66,.561,8,33,.242,16,23,.696,114,38,90,.422,27,53,.509,11,37,.297,31,35,.886,118
807,TOR,2023-12-18,114,,CHO,W 114-99,240,44,86,.512,36,57,.632,8,29,.276,18,22,.818,114,39,89,.438,31,57,.544,8,32,.250,13,13,1.000,99
808,NYK,2023-12-18,114,@,LAL,W 114-109,240,42,88,.477,32,58,.552,10,30,.333,20,23,.870,114,42,99,.424,29,58,.500,13,41,.317,12,13,.923,109
809,BOS,2023-12-17,114,,ORL,W 114-97,240,45,95,.474,28,59,.475,17,36,.472,7,8,.875,114,34,89,.382,23,53,.434,11,36,.306,18,24,.750,97
810,POR,2023-12-17,114,,GSW,L 114-118,240,40,85,.471,27,50,.540,13,35,.371,21,23,.913,114,46,87,.529,33,49,.673,13,38,.342,13,19,.684,118
811,DET,2023-12-16,114,@,MIL,L 114-146,240,43,96,.448,37,68,.544,6,28,.214,22,26,.846,114,50,88,.568,31,46,.674,19,42,.452,27,32,.844,146
812,POR,2023-12-14,114,,UTA,L 114-122,240,43,103,.417,27,58,.466,16,45,.356,12,18,.667,114,49,92,.533,38,59,.644,11,33,.333,13,14,.929,122
813,DEN,2023-12-12,114,@,CHI,W 114-106,240,39,83,.470,25,53,.472,14,30,.467,22,32,.688,114,36,86,.419,23,46,.500,13,40,.325,21,23,.913,106
814,CHO,2023-12-11,114,,MIA,L 114-116,240,40,84,.476,23,43,.535,17,41,.415,17,22,.773,114,37,77,.481,22,42,.524,15,35,.429,27,34,.794,116
815,ATL,2023-12-08,114,@,PHI,L 114-125,240,41,104,.394,28,65,.431,13,39,.333,19,21,.905,114,42,87,.483,31,57,.544,11,30,.367,30,37,.811,125
816,HOU,2023-12-08,114,@,DEN,W 114-106,240,35,82,.427,22,43,.512,13,39,.333,31,42,.738,114,38,90,.422,28,62,.452,10,28,.357,20,27,.741,106
817,SAC,2023-12-08,114,@,PHO,W 114-106,240,42,92,.457,28,53,.528,14,39,.359,16,20,.800,114,40,83,.482,29,51,.569,11,32,.344,15,23,.652,106
818,BRK,2023-12-06,114,@,ATL,W 114-113,240,43,94,.457,32,67,.478,11,27,.407,17,24,.708,114,42,94,.447,30,59,.508,12,35,.343,17,18,.944,113
819,LAC,2023-11-30,114,@,GSW,L 114-120,240,42,95,.442,30,63,.476,12,32,.375,18,24,.750,114,41,82,.500,26,43,.605,15,39,.385,23,31,.742,120
820,PHI,2023-11-29,114,@,NOP,L 114-124,240,42,81,.519,28,47,.596,14,34,.412,16,18,.889,114,42,78,.538,32,48,.667,10,30,.333,30,34,.882,124
821,UTA,2023-11-27,114,,NOP,W 114-112,240,37,88,.420,20,40,.500,17,48,.354,23,28,.821,114,44,88,.500,37,66,.561,7,22,.318,17,25,.680,112
822,POR,2023-11-27,114,@,IND,W 114-110,240,40,85,.471,31,67,.463,9,18,.500,25,31,.806,114,42,88,.477,34,55,.618,8,33,.242,18,24,.750,110
823,WAS,2023-11-22,114,@,CHO,L 114-117,240,44,97,.454,33,65,.508,11,32,.344,15,18,.833,114,43,91,.473,27,54,.500,16,37,.432,15,21,.714,117
824,ATL,2023-11-15,114,,NYK,L 114-116,240,41,75,.547,29,44,.659,12,31,.387,20,26,.769,114,45,94,.479,29,60,.483,16,34,.471,10,11,.909,116
825,BOS,2023-11-13,114,,NYK,W 114-98,240,40,79,.506,21,36,.583,19,43,.442,15,16,.938,114,33,79,.418,18,44,.409,15,35,.429,17,24,.708,98
826,PHI,2023-11-10,114,@,DET,W 114-106,240,35,83,.422,26,55,.473,9,28,.321,35,41,.854,114,40,86,.465,32,58,.552,8,28,.286,18,22,.818,106
827,MIN,2023-11-06,114,,BOS,W 114-109 (OT),265,44,85,.518,31,48,.646,13,37,.351,13,25,.520,114,36,92,.391,25,53,.472,11,39,.282,26,34,.765,109
828,BRK,2023-11-04,114,,BOS,L 114-124,240,43,100,.430,26,48,.542,17,52,.327,11,17,.647,114,43,90,.478,28,45,.622,15,45,.333,23,27,.852,124
829,DAL,2023-11-03,114,@,DEN,L 114-125,240,41,86,.477,24,44,.545,17,42,.405,15,17,.882,114,49,93,.527,36,63,.571,13,30,.433,14,19,.737,125
830,WAS,2023-11-03,114,@,MIA,L 114-121,240,46,81,.568,33,53,.623,13,28,.464,9,17,.529,114,48,80,.600,35,53,.660,13,27,.481,12,14,.857,121
831,PHI,2023-11-02,114,,TOR,W 114-99,240,42,92,.457,33,67,.493,9,25,.360,21,25,.840,114,38,79,.481,28,51,.549,10,28,.357,13,19,.684,99
832,DAL,2023-11-01,114,,CHI,W 114-105,240,37,81,.457,17,33,.515,20,48,.417,20,28,.714,114,42,89,.472,31,56,.554,11,33,.333,10,11,.909,105
833,PHO,2023-10-31,114,,SAS,L 114-115,240,42,83,.506,24,44,.545,18,39,.462,12,15,.800,114,43,92,.467,29,55,.527,14,37,.378,15,20,.750,115
834,MIA,2023-10-30,114,@,MIL,L 114-122,240,41,86,.477,28,52,.538,13,34,.382,19,20,.950,114,44,87,.506,32,50,.640,12,37,.324,22,30,.733,122
835,PHI,2023-10-28,114,@,TOR,W 114-107,240,43,86,.500,33,58,.569,10,28,.357,18,21,.857,114,38,87,.437,21,55,.382,17,32,.531,14,19,.737,107
836,SAC,2023-10-27,114,,GSW,L 114-122,240,41,94,.436,29,54,.537,12,40,.300,20,29,.690,114,48,87,.552,34,55,.618,14,32,.438,12,14,.857,122
837,CLE,2023-10-25,114,@,BRK,W 114-113,240,44,94,.468,27,51,.529,17,43,.395,9,10,.900,114,42,84,.500,33,57,.579,9,27,.333,20,26,.769,113
838,UTA,2023-10-25,114,,SAC,L 114-130,240,41,91,.451,32,63,.508,9,28,.321,23,31,.742,114,47,102,.461,28,51,.549,19,51,.373,17,20,.850,130
839,MEM,2024-02-06,113,@,NYK,L 113-123,240,41,80,.513,20,43,.465,21,37,.568,10,16,.625,113,48,86,.558,37,59,.627,11,27,.407,16,20,.800,123
840,LAL,2024-02-03,113,@,NYK,W 113-105,240,39,80,.488,27,49,.551,12,31,.387,23,27,.852,113,41,100,.410,31,65,.477,10,35,.286,13,15,.867,105
841,SAS,2024-02-02,113,,NOP,L 113-114,240,46,96,.479,36,57,.632,10,39,.256,11,18,.611,113,46,95,.484,39,69,.565,7,26,.269,15,21,.714,114
842,NYK,2024-01-29,113,@,CHO,W 113-92,240,44,84,.524,32,47,.681,12,37,.324,13,16,.813,113,37,81,.457,26,49,.531,11,32,.344,7,14,.500,92
843,DEN,2024-01-29,113,,MIL,W 113-107,240,44,91,.484,40,73,.548,4,18,.222,21,24,.875,113,36,84,.429,20,44,.455,16,40,.400,19,25,.760,107
844,SAS,2024-01-29,113,,WAS,L 113-118,240,43,92,.467,31,62,.500,12,30,.400,15,17,.882,113,46,86,.535,37,61,.607,9,25,.360,17,24,.708,118
845,ORL,2024-01-28,113,,PHO,W 113-98,240,41,92,.446,29,56,.518,12,36,.333,19,26,.731,113,41,73,.562,37,59,.627,4,14,.286,12,21,.571,98
846,SAS,2024-01-27,113,,MIN,W 113-112,240,46,84,.548,33,54,.611,13,30,.433,8,15,.533,113,45,79,.570,31,53,.585,14,26,.538,8,15,.533,112
847,DET,2024-01-24,113,,CHO,W 113-106,240,43,86,.500,28,48,.583,15,38,.395,12,20,.600,113,38,87,.437,23,49,.469,15,38,.395,15,19,.789,106
848,CHI,2024-01-22,113,@,PHO,L 113-115,240,45,93,.484,31,56,.554,14,37,.378,9,14,.643,113,44,85,.518,30,51,.588,14,34,.412,13,17,.765,115
849,DET,2024-01-22,113,,MIL,L 113-122,240,40,89,.449,30,59,.508,10,30,.333,23,29,.793,113,42,94,.447,32,55,.582,10,39,.256,28,34,.824,122
850,DEN,2024-01-21,113,@,WAS,W 113-104,240,43,88,.489,35,66,.530,8,22,.364,19,28,.679,113,39,91,.429,31,64,.484,8,27,.296,18,22,.818,104
851,NYK,2024-01-18,113,,WAS,W 113-109,240,39,86,.453,26,48,.542,13,38,.342,22,26,.846,113,41,90,.456,31,59,.525,10,31,.323,17,22,.773,109
852,HOU,2024-01-13,113,@,BOS,L 113-145,240,40,99,.404,33,69,.478,7,30,.233,26,30,.867,113,51,95,.537,27,48,.563,24,47,.511,19,25,.760,145
853,NOP,2024-01-12,113,@,DEN,L 113-125,240,42,89,.472,29,56,.518,13,33,.394,16,22,.727,113,50,90,.556,36,57,.632,14,33,.424,11,15,.733,125
854,TOR,2024-01-12,113,@,UTA,L 113-145,240,35,81,.432,18,47,.383,17,34,.500,26,37,.703,113,52,93,.559,31,50,.620,21,43,.488,20,26,.769,145
855,MIN,2024-01-09,113,@,ORL,W 113-92,240,43,80,.538,31,50,.620,12,30,.400,15,19,.789,113,34,94,.362,21,52,.404,13,42,.310,11,18,.611,92
856,HOU,2024-01-08,113,@,MIA,L 113-120,240,37,88,.420,23,47,.489,14,41,.341,25,28,.893,113,41,82,.500,26,46,.565,15,36,.417,23,32,.719,120
857,PHO,2024-01-05,113,,MIA,W 113-97,240,44,87,.506,30,52,.577,14,35,.400,11,17,.647,113,34,83,.410,24,46,.522,10,37,.270,19,22,.864,97
858,GSW,2024-01-05,113,,DET,W 113-109,240,38,82,.463,22,44,.500,16,38,.421,21,25,.840,113,44,98,.449,31,54,.574,13,44,.295,8,10,.800,109
859,LAL,2024-01-05,113,,MEM,L 113-127,240,42,85,.494,32,57,.561,10,28,.357,19,27,.704,113,44,82,.537,21,37,.568,23,45,.511,16,20,.800,127
860,MIL,2024-01-01,113,,IND,L 113-122,240,41,93,.441,31,53,.585,10,40,.250,21,26,.808,113,43,97,.443,38,62,.613,5,35,.143,31,38,.816,122
861,DET,2024-01-01,113,@,HOU,L 113-136,240,40,83,.482,27,54,.500,13,29,.448,20,27,.741,113,51,91,.560,36,56,.643,15,35,.429,19,24,.792,136
862,HOU,2023-12-27,113,,PHO,L 113-129,240,40,96,.417,23,55,.418,17,41,.415,16,22,.727,113,47,82,.573,33,49,.673,14,33,.424,21,26,.808,129
863,CLE,2023-12-27,113,@,DAL,W 113-110,240,40,92,.435,23,49,.469,17,43,.395,16,23,.696,113,39,88,.443,29,51,.569,10,37,.270,22,26,.846,110
864,LAC,2023-12-26,113,,CHO,W 113-104,240,40,85,.471,26,51,.510,14,34,.412,19,25,.760,113,43,93,.462,37,64,.578,6,29,.207,12,16,.750,104
865,SAC,2023-12-26,113,@,POR,L 113-130,240,45,93,.484,35,51,.686,10,42,.238,13,16,.813,113,49,98,.500,33,58,.569,16,40,.400,16,20,.800,130
866,ATL,2023-12-26,113,@,CHI,L 113-118,240,41,89,.461,28,44,.636,13,45,.289,18,21,.857,113,42,92,.457,35,67,.522,7,25,.280,27,31,.871,118
867,PHI,2023-12-25,113,@,MIA,L 113-119,240,40,94,.426,23,49,.469,17,45,.378,16,25,.640,113,40,84,.476,28,52,.538,12,32,.375,27,35,.771,119
868,ATL,2023-12-22,113,@,MIA,L 113-122,240,42,96,.438,23,42,.548,19,54,.352,10,14,.714,113,40,86,.465,23,47,.489,17,39,.436,25,30,.833,122
869,MIN,2023-12-20,113,@,PHI,L 113-127,240,42,82,.512,33,57,.579,9,25,.360,20,24,.833,113,45,84,.536,37,62,.597,8,22,.364,29,32,.906,127
870,CHO,2023-12-20,113,@,IND,L 113-144,240,45,95,.474,37,64,.578,8,31,.258,15,19,.789,113,49,80,.613,31,41,.756,18,39,.462,28,30,.933,144
871,DEN,2023-12-20,113,@,TOR,W 113-104,240,49,98,.500,37,65,.569,12,33,.364,3,7,.429,113,43,90,.478,34,63,.540,9,27,.333,9,13,.692,104
872,NOP,2023-12-19,113,,MEM,L 113-115,240,40,85,.471,29,60,.483,11,25,.440,22,24,.917,113,41,82,.500,31,51,.608,10,31,.323,23,29,.793,115
873,GSW,2023-12-14,113,@,LAC,L 113-121,240,40,92,.435,24,47,.511,16,45,.356,17,19,.895,113,41,81,.506,28,49,.571,13,32,.406,26,30,.867,121
874,NYK,2023-12-13,113,@,UTA,L 113-117,240,41,94,.436,32,55,.582,9,39,.231,22,32,.688,113,43,98,.439,27,56,.482,16,42,.381,15,21,.714,117
875,CLE,2023-12-12,113,@,BOS,L 113-120,240,44,92,.478,25,47,.532,19,45,.422,6,9,.667,113,38,84,.452,20,40,.500,18,44,.409,26,26,1.000,120
876,MEM,2023-12-11,113,,DAL,L 113-120,240,41,89,.461,23,45,.511,18,44,.409,13,16,.813,113,43,86,.500,26,46,.565,17,40,.425,17,19,.895,120
877,ATL,2023-12-06,113,,BRK,L 113-114,240,42,94,.447,30,59,.508,12,35,.343,17,18,.944,113,43,94,.457,32,67,.478,11,27,.407,17,24,.708,114
878,POR,2023-12-02,113,@,UTA,L 113-118 (OT),265,38,95,.400,25,55,.455,13,40,.325,24,27,.889,113,46,94,.489,39,60,.650,7,34,.206,19,24,.792,118
879,LAC,2023-12-02,113,,GSW,W 113-112,240,44,90,.489,31,51,.608,13,39,.333,12,14,.857,113,38,86,.442,21,43,.488,17,43,.395,19,24,.792,112
880,MIL,2023-11-30,113,@,CHI,L 113-120 (OT),265,44,98,.449,28,50,.560,16,48,.333,9,13,.692,113,45,98,.459,32,61,.525,13,37,.351,17,22,.773,120
881,DEN,2023-11-27,113,@,LAC,W 113-104,240,44,92,.478,34,70,.486,10,22,.455,15,28,.536,113,35,85,.412,29,65,.446,6,20,.300,28,34,.824,104
882,NYK,2023-11-26,113,,PHO,L 113-116,240,39,86,.453,27,57,.474,12,29,.414,23,32,.719,113,42,91,.462,26,53,.491,16,38,.421,16,21,.762,116
883,BOS,2023-11-26,113,,ATL,W 113-103,240,42,95,.442,29,48,.604,13,47,.277,16,20,.800,113,36,88,.409,17,35,.486,19,53,.358,12,19,.632,103
884,DET,2023-11-24,113,@,IND,L 113-136,240,43,90,.478,36,72,.500,7,18,.389,20,24,.833,113,49,102,.480,33,64,.516,16,38,.421,22,24,.917,136
885,ORL,2023-11-24,113,,BOS,W 113-96,240,43,85,.506,32,57,.561,11,28,.393,16,22,.727,113,31,76,.408,24,47,.511,7,29,.241,27,37,.730,96
886,DET,2023-11-19,113,@,TOR,L 113-142,240,39,83,.470,30,57,.526,9,26,.346,26,35,.743,113,55,102,.539,41,66,.621,14,36,.389,18,29,.621,142
887,DAL,2023-11-19,113,,SAC,L 113-129,240,41,88,.466,29,54,.537,12,34,.353,19,26,.731,113,48,90,.533,31,50,.620,17,40,.425,16,21,.762,129
888,SAS,2023-11-12,113,,MIA,L 113-118,240,42,91,.462,23,47,.489,19,44,.432,10,12,.833,113,39,89,.438,27,58,.466,12,31,.387,28,30,.933,118
889,UTA,2023-11-06,113,@,CHI,L 113-130,240,41,86,.477,25,43,.581,16,43,.372,15,17,.882,113,48,93,.516,30,59,.508,18,34,.529,16,19,.842,130
890,MEM,2023-11-03,113,@,POR,L 113-115 (OT),265,47,96,.490,37,61,.607,10,35,.286,9,13,.692,113,39,96,.406,30,64,.469,9,32,.281,28,36,.778,115
891,UTA,2023-11-02,113,,ORL,L 113-115,240,41,89,.461,29,56,.518,12,33,.364,19,26,.731,113,39,85,.459,29,56,.518,10,29,.345,27,36,.750,115
892,MIN,2023-10-30,113,@,ATL,L 113-127,240,44,90,.489,28,57,.491,16,33,.485,9,15,.600,113,48,86,.558,34,56,.607,14,30,.467,17,18,.944,127
893,WAS,2023-10-28,113,,MEM,W 113-106,240,40,93,.430,24,47,.511,16,46,.348,17,22,.773,113,39,91,.429,20,44,.455,19,47,.404,9,9,1.000,106
894,CLE,2023-10-28,113,,IND,L 113-125,240,43,99,.434,31,68,.456,12,31,.387,15,24,.625,113,48,98,.490,33,60,.550,15,38,.395,14,17,.824,125
895,BRK,2023-10-25,113,,CLE,L 113-114,240,42,84,.500,33,57,.579,9,27,.333,20,26,.769,113,44,94,.468,27,51,.529,17,43,.395,9,10,.900,114
896,DEN,2024-02-04,112,,POR,W 112-103,240,42,86,.488,30,58,.517,12,28,.429,16,19,.842,112,39,85,.459,28,54,.519,11,31,.355,14,15,.933,103
897,WAS,2024-02-04,112,,PHO,L 112-140,240,47,96,.490,40,64,.625,7,32,.219,11,17,.647,112,54,88,.614,43,63,.683,11,25,.440,21,26,.808,140
898,NOP,2024-01-29,112,@,BOS,L 112-118,240,46,91,.505,36,56,.643,10,35,.286,10,13,.769,112,43,85,.506,26,39,.667,17,46,.370,15,20,.750,118
899,MIN,2024-01-27,112,@,SAS,L 112-113,240,45,79,.570,31,53,.585,14,26,.538,8,15,.533,112,46,84,.548,33,54,.611,13,30,.433,8,15,.533,113
900,CLE,2024-01-26,112,@,MIL,W 112-100,240,38,92,.413,24,56,.429,14,36,.389,22,31,.710,112,35,87,.402,22,53,.415,13,34,.382,17,24,.708,100
901,ATL,2024-01-24,112,@,GSW,L 112-134,240,39,94,.415,25,51,.490,14,43,.326,20,26,.769,112,51,91,.560,35,58,.603,16,33,.485,16,22,.727,134
902,LAL,2024-01-19,112,,BRK,L 112-130,240,40,90,.444,28,57,.491,12,33,.364,20,24,.833,112,50,95,.526,31,48,.646,19,47,.404,11,14,.786,130
903,CHO,2024-01-17,112,@,NOP,L 112-132,240,39,90,.433,20,45,.444,19,45,.422,15,18,.833,112,44,88,.500,19,41,.463,25,47,.532,19,23,.826,132
904,LAL,2024-01-15,112,,OKC,W 112-105,240,44,84,.524,36,60,.600,8,24,.333,16,18,.889,112,40,96,.417,25,47,.532,15,49,.306,10,11,.909,105
905,OKC,2024-01-13,112,,ORL,W 112-100,240,43,94,.457,35,58,.603,8,36,.222,18,21,.857,112,39,84,.464,32,49,.653,7,35,.200,15,24,.625,100
906,HOU,2024-01-12,112,@,DET,W 112-110,240,41,90,.456,33,60,.550,8,30,.267,22,25,.880,112,44,88,.500,32,53,.604,12,35,.343,10,16,.625,110
907,PHI,2024-01-12,112,,SAC,W 112-93,240,40,93,.430,25,58,.431,15,35,.429,17,18,.944,112,32,95,.337,24,57,.421,8,38,.211,21,26,.808,93
908,IND,2024-01-10,112,,WAS,W 112-104,240,41,92,.446,33,67,.493,8,25,.320,22,24,.917,112,38,88,.432,31,57,.544,7,31,.226,21,30,.700,104
909,NYK,2024-01-09,112,,POR,W 112-84,240,37,89,.416,19,41,.463,18,48,.375,20,23,.870,112,33,86,.384,27,57,.474,6,29,.207,12,18,.667,84
910,CHO,2024-01-08,112,,CHI,L 112-119 (OT),265,40,94,.426,23,52,.442,17,42,.405,15,17,.882,112,45,92,.489,36,66,.545,9,26,.346,20,24,.833,119
911,HOU,2024-01-06,112,,MIL,W 112-108,240,36,83,.434,23,49,.469,13,34,.382,27,32,.844,112,35,76,.461,26,42,.619,9,34,.265,29,42,.690,108
912,HOU,2024-01-03,112,,BRK,W 112-101,240,37,76,.487,18,37,.486,19,39,.487,19,27,.704,112,36,93,.387,23,49,.469,13,44,.295,16,26,.615,101
913,NOP,2024-01-02,112,,BRK,W 112-85,240,41,88,.466,25,49,.510,16,39,.410,14,18,.778,112,35,98,.357,24,55,.436,11,43,.256,4,8,.500,85
914,NYK,2024-01-01,112,,MIN,W 112-106,240,39,89,.438,27,55,.491,12,34,.353,22,28,.786,112,36,76,.474,25,48,.521,11,28,.393,23,29,.793,106
915,PHO,2023-12-31,112,,ORL,W 112-107,240,44,88,.500,36,61,.590,8,27,.296,16,19,.842,112,42,90,.467,30,53,.566,12,37,.324,11,12,.917,107
916,CHO,2023-12-28,112,@,LAL,L 112-133,240,40,85,.471,25,52,.481,15,33,.455,17,28,.607,112,52,97,.536,37,67,.552,15,30,.500,14,14,1.000,133
917,NOP,2023-12-28,112,,UTA,W 112-105,240,45,82,.549,35,55,.636,10,27,.370,12,15,.800,112,36,85,.424,24,46,.522,12,39,.308,21,25,.840,105
918,PHI,2023-12-27,112,@,ORL,W 112-92,240,45,96,.469,35,68,.515,10,28,.357,12,17,.706,112,31,79,.392,22,46,.478,9,33,.273,21,24,.875,92
919,DET,2023-12-26,112,,BRK,L 112-118,240,40,90,.444,31,65,.477,9,25,.360,23,32,.719,112,41,82,.500,32,60,.533,9,22,.409,27,43,.628,118
920,MIN,2023-12-18,112,@,MIA,W 112-108,240,42,85,.494,31,56,.554,11,29,.379,17,19,.895,112,41,87,.471,30,57,.526,11,30,.367,15,18,.833,108
921,PHO,2023-12-17,112,,WAS,W 112-108,240,41,90,.456,34,59,.576,7,31,.226,23,30,.767,112,39,95,.411,25,49,.510,14,46,.304,16,20,.800,108
922,NOP,2023-12-15,112,@,CHO,W 112-107,240,38,80,.475,29,53,.547,9,27,.333,27,32,.844,112,41,92,.446,32,61,.525,9,31,.290,16,21,.762,107
923,PHO,2023-12-13,112,,BRK,L 112-116,240,40,84,.476,31,56,.554,9,28,.321,23,27,.852,112,41,89,.461,26,48,.542,15,41,.366,19,24,.792,116
924,POR,2023-12-08,112,,DAL,L 112-125,240,39,105,.371,21,52,.404,18,53,.340,16,18,.889,112,47,91,.516,35,52,.673,12,39,.308,19,22,.864,125
925,SAS,2023-12-08,112,,CHI,L 112-121,240,39,83,.470,22,41,.537,17,42,.405,17,20,.850,112,47,102,.461,34,74,.459,13,28,.464,14,24,.583,121
926,MIA,2023-12-06,112,@,TOR,W 112-103,240,41,89,.461,27,51,.529,14,38,.368,16,19,.842,112,37,86,.430,23,49,.469,14,37,.378,15,17,.882,103
927,BOS,2023-12-04,112,@,IND,L 112-122,240,46,97,.474,34,56,.607,12,41,.293,8,12,.667,112,43,94,.457,24,54,.444,19,40,.475,17,21,.810,122
928,GSW,2023-12-02,112,@,LAC,L 112-113,240,38,86,.442,21,43,.488,17,43,.395,19,24,.792,112,44,90,.489,31,51,.608,13,39,.333,12,14,.857,113
929,DET,2023-11-30,112,@,NYK,L 112-118,240,43,81,.531,28,46,.609,15,35,.429,11,17,.647,112,41,88,.466,25,47,.532,16,41,.390,20,28,.714,118
930,TOR,2023-11-29,112,,PHO,W 112-105,240,42,93,.452,32,66,.485,10,27,.370,18,21,.857,112,38,94,.404,31,68,.456,7,26,.269,22,23,.957,105
931,NOP,2023-11-27,112,@,UTA,L 112-114,240,44,88,.500,37,66,.561,7,22,.318,17,25,.680,112,37,88,.420,20,40,.500,17,48,.354,23,28,.821,114
932,BRK,2023-11-25,112,,MIA,W 112-97,240,39,78,.500,25,42,.595,14,36,.389,20,23,.870,112,38,87,.437,27,53,.509,11,34,.324,10,13,.769,97
933,SAS,2023-11-24,112,@,GSW,L 112-118,240,45,100,.450,33,53,.623,12,47,.255,10,12,.833,112,40,81,.494,21,39,.538,19,42,.452,19,24,.792,118
934,SAC,2023-11-22,112,@,NOP,L 112-117,240,34,76,.447,19,32,.594,15,44,.341,29,35,.829,112,41,87,.471,34,57,.596,7,30,.233,28,37,.757,117
935,MIN,2023-11-22,112,,PHI,W 112-99,240,43,89,.483,33,63,.524,10,26,.385,16,24,.667,112,34,87,.391,27,55,.491,7,32,.219,24,30,.800,99
936,TOR,2023-11-15,112,,MIL,L 112-128,240,38,96,.396,29,63,.460,9,33,.273,27,31,.871,112,44,85,.518,24,46,.522,20,39,.513,20,21,.952,128
937,ORL,2023-11-11,112,,MIL,W 112-97,240,36,84,.429,26,58,.448,10,26,.385,30,35,.857,112,38,77,.494,29,48,.604,9,29,.310,12,25,.480,97
938,MEM,2023-11-05,112,@,POR,W 112-100,240,45,89,.506,32,57,.561,13,32,.406,9,13,.692,112,37,95,.389,23,50,.460,14,45,.311,12,15,.800,100
939,PHI,2023-11-04,112,,PHO,W 112-100,240,43,90,.478,32,60,.533,11,30,.367,15,18,.833,112,32,89,.360,23,54,.426,9,35,.257,27,33,.818,100
940,CHI,2023-10-30,112,@,IND,W 112-105,240,40,87,.460,34,70,.486,6,17,.353,26,31,.839,112,36,88,.409,24,42,.571,12,46,.261,21,25,.840,105
941,DET,2023-10-30,112,@,OKC,L 112-124,240,39,91,.429,24,63,.381,15,28,.536,19,24,.792,112,44,83,.530,31,54,.574,13,29,.448,23,28,.821,124
942,MIN,2024-02-04,111,,HOU,W 111-90,240,40,90,.444,29,60,.483,11,30,.367,20,27,.741,111,31,88,.352,21,58,.362,10,30,.333,18,27,.667,90
943,ORL,2024-02-04,111,@,DET,W 111-99,240,45,84,.536,35,60,.583,10,24,.417,11,15,.733,111,36,80,.450,28,49,.571,8,31,.258,19,22,.864,99
944,DEN,2024-01-27,111,,PHI,W 111-105,240,37,82,.451,24,45,.533,13,37,.351,24,38,.632,111,43,81,.531,37,59,.627,6,22,.273,13,16,.813,105
945,OKC,2024-01-23,111,,POR,W 111-109,240,43,89,.483,36,66,.545,7,23,.304,18,28,.643,111,37,86,.430,19,47,.404,18,39,.462,17,21,.810,109
946,CLE,2024-01-11,111,,BRK,W 111-102,240,32,82,.390,19,38,.500,13,44,.295,34,43,.791,111,37,82,.451,29,55,.527,8,27,.296,20,28,.714,102
947,DEN,2024-01-10,111,@,UTA,L 111-124,240,37,81,.457,24,48,.500,13,33,.394,24,28,.857,111,46,83,.554,33,50,.660,13,33,.394,19,23,.826,124
948,PHO,2024-01-08,111,@,LAC,L 111-138,240,38,77,.494,28,47,.596,10,30,.333,25,29,.862,111,53,85,.624,38,56,.679,15,29,.517,17,23,.739,138
949,LAC,2024-01-05,111,@,NOP,W 111-95,240,40,82,.488,25,46,.543,15,36,.417,16,20,.800,111,33,92,.359,21,63,.333,12,29,.414,17,23,.739,95
950,MEM,2024-01-03,111,,TOR,L 111-116,240,40,94,.426,25,52,.481,15,42,.357,16,19,.842,111,41,85,.482,29,59,.492,12,26,.462,22,27,.815,116
951,CHO,2024-01-02,111,@,SAC,W 111-104,240,42,82,.512,30,48,.625,12,34,.353,15,19,.789,111,40,92,.435,26,56,.464,14,36,.389,10,17,.588,104
952,DEN,2024-01-01,111,,CHO,W 111-93,240,41,83,.494,26,45,.578,15,38,.395,14,18,.778,111,36,86,.419,26,60,.433,10,26,.385,11,16,.688,93
953,CLE,2023-12-29,111,,MIL,L 111-119,240,49,103,.476,43,60,.717,6,43,.140,7,9,.778,111,41,80,.513,29,51,.569,12,29,.414,25,28,.893,119
954,NYK,2023-12-23,111,,MIL,L 111-130,240,41,93,.441,32,64,.500,9,29,.310,20,21,.952,111,48,91,.527,32,59,.542,16,32,.500,18,23,.783,130
955,TOR,2023-12-22,111,@,PHI,L 111-121,240,39,87,.448,30,54,.556,9,33,.273,24,28,.857,111,44,83,.530,30,52,.577,14,31,.452,19,21,.905,121
956,LAL,2023-12-21,111,@,MIN,L 111-118,240,41,83,.494,31,59,.525,10,24,.417,19,24,.792,111,42,87,.483,28,51,.549,14,36,.389,20,25,.800,118
957,DET,2023-12-21,111,,UTA,L 111-119,240,43,86,.500,34,55,.618,9,31,.290,16,19,.842,111,43,94,.457,32,64,.500,11,30,.367,22,24,.917,119
958,DAL,2023-12-20,111,,LAC,L 111-120,240,39,91,.429,25,48,.521,14,43,.326,19,27,.704,111,43,77,.558,32,46,.696,11,31,.355,23,25,.920,120
959,ORL,2023-12-15,111,@,BOS,L 111-128,240,42,87,.483,28,52,.538,14,35,.400,13,18,.722,111,48,92,.522,30,50,.600,18,42,.429,14,20,.700,128
960,DET,2023-12-13,111,,PHI,L 111-129,240,39,88,.443,29,55,.527,10,33,.303,23,30,.767,111,45,87,.517,34,57,.596,11,30,.367,28,34,.824,129
961,CLE,2023-12-08,111,@,MIA,W 111-99,240,40,87,.460,26,49,.531,14,38,.368,17,26,.654,111,37,86,.430,22,44,.500,15,42,.357,10,15,.667,99
962,LAC,2023-12-06,111,,DEN,W 111-102,240,40,87,.460,28,60,.467,12,27,.444,19,25,.760,111,41,98,.418,29,67,.433,12,31,.387,8,9,.889,102
963,CHI,2023-12-06,111,,CHO,W 111-100,240,38,90,.422,26,65,.400,12,25,.480,23,29,.793,111,39,90,.433,29,53,.547,10,37,.270,12,12,1.000,100
964,ORL,2023-12-06,111,@,CLE,L 111-121,240,41,84,.488,39,61,.639,2,23,.087,27,37,.730,111,46,86,.535,32,52,.615,14,34,.412,15,20,.750,121
965,PHO,2023-12-01,111,,DEN,L 111-119,240,39,84,.464,30,57,.526,9,27,.333,24,26,.923,111,50,88,.568,38,56,.679,12,32,.375,7,12,.583,119
966,MIN,2023-11-24,111,,SAC,L 111-124,240,36,82,.439,24,49,.490,12,33,.364,27,29,.931,111,49,100,.490,32,65,.492,17,35,.486,9,11,.818,124
967,HOU,2023-11-22,111,,MEM,W 111-91,240,40,92,.435,26,49,.531,14,43,.326,17,20,.850,111,27,82,.329,20,50,.400,7,32,.219,30,35,.857,91
968,MIA,2023-11-14,111,@,CHO,W 111-105,240,40,83,.482,32,52,.615,8,31,.258,23,28,.821,111,36,81,.444,21,49,.429,15,32,.469,18,22,.818,105
969,DEN,2023-11-14,111,,LAC,W 111-108,240,39,73,.534,31,50,.620,8,23,.348,25,32,.781,111,37,86,.430,24,57,.421,13,29,.448,21,24,.875,108
970,TOR,2023-11-13,111,,WAS,W 111-107,240,45,90,.500,41,70,.586,4,20,.200,17,25,.680,111,43,84,.512,31,58,.534,12,26,.462,9,12,.750,107
971,OKC,2023-11-12,111,@,PHO,W 111-99,240,40,82,.488,30,55,.545,10,27,.370,21,25,.840,111,32,83,.386,23,54,.426,9,29,.310,26,31,.839,99
972,SAS,2023-11-06,111,@,IND,L 111-152,240,40,94,.426,32,68,.471,8,26,.308,23,30,.767,111,55,95,.579,35,57,.614,20,38,.526,22,23,.957,152
973,NYK,2023-11-06,111,,LAC,W 111-97,240,41,88,.466,29,57,.509,12,31,.387,17,18,.944,111,36,73,.493,25,41,.610,11,32,.344,14,16,.875,97
974,MIL,2023-11-01,111,@,TOR,L 111-130,240,35,76,.461,22,42,.524,13,34,.382,28,38,.737,111,51,91,.560,36,53,.679,15,38,.395,13,14,.929,130
975,DET,2023-10-27,111,@,CHO,W 111-99,240,40,88,.455,30,58,.517,10,30,.333,21,25,.840,111,33,88,.375,26,60,.433,7,28,.250,26,34,.765,99
976,MIA,2023-10-27,111,@,BOS,L 111-119,240,38,89,.427,22,56,.393,16,33,.485,19,23,.826,111,45,95,.474,29,56,.518,16,39,.410,13,19,.684,119
977,NOP,2023-10-25,111,@,MEM,W 111-104,240,40,85,.471,26,53,.491,14,32,.438,17,22,.773,111,38,91,.418,26,48,.542,12,43,.279,16,20,.800,104
978,POR,2023-10-25,111,@,LAC,L 111-123,240,44,93,.473,34,61,.557,10,32,.313,13,17,.765,111,47,90,.522,31,56,.554,16,34,.471,13,16,.813,123
979,SAC,2024-02-05,110,@,CLE,L 110-136,240,43,93,.462,26,49,.531,17,44,.386,7,12,.583,110,51,88,.580,28,47,.596,23,41,.561,11,17,.647,136
980,MIA,2024-02-02,110,@,WAS,W 110-102,240,38,88,.432,31,57,.544,7,31,.226,27,35,.771,110,37,90,.411,26,48,.542,11,42,.262,17,21,.810,102
981,NOP,2024-01-31,110,@,HOU,W 110-99,240,41,82,.500,30,48,.625,11,34,.324,17,24,.708,110,35,87,.402,22,43,.512,13,44,.295,16,17,.941,99
982,CHO,2024-01-31,110,,CHI,L 110-117,240,40,90,.444,24,44,.545,16,46,.348,14,17,.824,110,45,87,.517,34,58,.586,11,29,.379,16,22,.727,117
983,MEM,2024-01-28,110,@,IND,L 110-116,240,38,82,.463,27,52,.519,11,30,.367,23,31,.742,110,44,90,.489,31,55,.564,13,35,.371,15,16,.938,116
984,MIA,2024-01-25,110,,BOS,L 110-143,240,42,94,.447,26,52,.500,16,42,.381,10,13,.769,110,51,80,.638,29,40,.725,22,40,.550,19,20,.950,143
985,DAL,2024-01-22,110,,BOS,L 110-119,240,43,97,.443,29,57,.509,14,40,.350,10,14,.714,110,41,88,.466,26,42,.619,15,46,.326,22,30,.733,119
986,IND,2024-01-21,110,@,PHO,L 110-117,240,41,94,.436,27,63,.429,14,31,.452,14,23,.609,110,47,82,.573,39,57,.684,8,25,.320,15,18,.833,117
987,POR,2024-01-21,110,@,LAL,L 110-134,240,42,90,.467,33,61,.541,9,29,.310,17,20,.850,110,47,86,.547,34,53,.642,13,33,.394,27,29,.931,134
988,TOR,2024-01-18,110,,CHI,L 110-116,240,42,83,.506,32,45,.711,10,38,.263,16,20,.800,110,48,91,.527,42,67,.627,6,24,.250,14,17,.824,116
989,DAL,2024-01-17,110,@,LAL,L 110-127,240,42,91,.462,31,51,.608,11,40,.275,15,18,.833,110,49,91,.538,37,63,.587,12,28,.429,17,24,.708,127
990,DET,2024-01-12,110,,HOU,L 110-112,240,44,88,.500,32,53,.604,12,35,.343,10,16,.625,110,41,90,.456,33,60,.550,8,30,.267,22,25,.880,112
991,DET,2024-01-09,110,,SAC,L 110-131,240,40,85,.471,26,48,.542,14,37,.378,16,21,.762,110,54,94,.574,41,61,.672,13,33,.394,10,14,.714,131
992,ATL,2024-01-07,110,@,ORL,L 110-117 (OT),265,42,91,.462,33,61,.541,9,30,.300,17,29,.586,110,43,98,.439,26,57,.456,17,41,.415,14,22,.636,117
993,MIA,2024-01-03,110,@,LAL,W 110-96,240,41,93,.441,25,51,.490,16,42,.381,12,17,.706,110,35,83,.422,31,53,.585,4,30,.133,22,24,.917,96
994,PHI,2024-01-02,110,,CHI,W 110-97,240,38,80,.475,26,50,.520,12,30,.400,22,30,.733,110,37,96,.385,30,59,.508,7,37,.189,16,23,.696,97
995,WAS,2023-12-29,110,,BRK,W 110-104,240,46,91,.505,31,53,.585,15,38,.395,3,7,.429,110,39,91,.429,30,63,.476,9,28,.321,17,27,.630,104
996,ATL,2023-12-29,110,,SAC,L 110-117,240,37,94,.394,22,51,.431,15,43,.349,21,25,.840,110,46,89,.517,29,44,.659,17,45,.378,8,15,.533,117
997,DAL,2023-12-28,110,@,MIN,L 110-118,240,40,90,.444,26,57,.456,14,33,.424,16,19,.842,110,38,74,.514,21,41,.512,17,33,.515,25,34,.735,118
998,DAL,2023-12-27,110,,CLE,L 110-113,240,39,88,.443,29,51,.569,10,37,.270,22,26,.846,110,40,92,.435,23,49,.469,17,43,.395,16,23,.696,113
999,MIN,2023-12-23,110,@,SAC,W 110-98,240,44,87,.506,34,54,.630,10,33,.303,12,14,.857,110,37,85,.435,29,52,.558,8,33,.242,16,21,.762,98
1000,IND,2023-12-23,110,,ORL,L 110-117,240,43,82,.524,28,48,.583,15,34,.441,9,13,.692,110,39,73,.534,33,55,.600,6,18,.333,33,41,.805,117
1001,SAS,2023-12-17,110,,NOP,L 110-146,240,40,94,.426,25,52,.481,15,42,.357,15,21,.714,110,55,98,.561,33,56,.589,22,42,.524,14,22,.636,146
1002,HOU,2023-12-06,110,,OKC,W 110-101,240,40,83,.482,25,50,.500,15,33,.455,15,22,.682,110,37,87,.425,29,58,.500,8,29,.276,19,24,.792,101
1003,GSW,2023-12-06,110,,POR,W 110-106,240,36,86,.419,26,52,.500,10,34,.294,28,33,.848,110,39,95,.411,23,49,.469,16,46,.348,12,16,.750,106
1004,CLE,2023-12-02,110,@,DET,W 110-101,240,44,89,.494,34,59,.576,10,30,.333,12,18,.667,110,39,83,.470,31,53,.585,8,30,.267,15,23,.652,101
1005,LAL,2023-11-30,110,@,OKC,L 110-133,240,36,81,.444,25,48,.521,11,33,.333,27,32,.844,110,50,94,.532,36,52,.692,14,42,.333,19,22,.864,133
1006,IND,2023-11-27,110,,POR,L 110-114,240,42,88,.477,34,55,.618,8,33,.242,18,24,.750,110,40,85,.471,31,67,.463,9,18,.500,25,31,.806,114
1007,PHO,2023-11-24,110,@,MEM,W 110-89,240,39,76,.513,28,45,.622,11,31,.355,21,28,.750,110,37,80,.463,28,47,.596,9,33,.273,6,10,.600,89
1008,DEN,2023-11-17,110,@,NOP,L 110-115,240,47,96,.490,37,56,.661,10,40,.250,6,12,.500,110,46,88,.523,34,65,.523,12,23,.522,11,21,.524,115
1009,LAL,2023-11-15,110,,SAC,L 110-125,240,42,83,.506,31,54,.574,11,29,.379,15,19,.789,110,48,96,.500,32,52,.615,16,44,.364,13,17,.765,125
1010,DAL,2023-11-14,110,@,NOP,L 110-131,240,38,90,.422,24,48,.500,14,42,.333,20,26,.769,110,49,94,.521,35,56,.625,14,38,.368,19,26,.731,131
1011,GSW,2023-11-12,110,,MIN,L 110-116,240,37,96,.385,25,53,.472,12,43,.279,24,28,.857,110,43,82,.524,34,55,.618,9,27,.333,21,30,.700,116
1012,POR,2023-11-12,110,@,LAL,L 110-116,240,45,90,.500,32,53,.604,13,37,.351,7,9,.778,110,41,84,.488,37,65,.569,4,19,.211,30,37,.811,116
1013,GSW,2023-11-11,110,,CLE,L 110-118,240,37,90,.411,24,52,.462,13,38,.342,23,30,.767,110,37,86,.430,26,56,.464,11,30,.367,33,43,.767,118
1014,SAS,2023-11-10,110,,MIN,L 110-117,240,43,92,.467,31,58,.534,12,34,.353,12,19,.632,110,43,87,.494,33,60,.550,10,27,.370,21,27,.778,117
1015,MIL,2023-11-03,110,,NYK,W 110-105,240,35,82,.427,15,43,.349,20,39,.513,20,28,.714,110,38,96,.396,28,57,.491,10,39,.256,19,25,.760,105
1016,NOP,2023-11-01,110,@,OKC,W 110-106,240,40,102,.392,27,60,.450,13,42,.310,17,29,.586,110,38,88,.432,31,54,.574,7,34,.206,23,25,.920,106
1017,POR,2023-11-01,110,@,DET,W 110-101,240,38,81,.469,31,61,.508,7,20,.350,27,33,.818,110,40,90,.444,29,61,.475,11,29,.379,10,11,.909,101
1018,MIN,2023-11-01,110,,DEN,W 110-89,240,38,83,.458,30,62,.484,8,21,.381,26,27,.963,110,38,96,.396,32,63,.508,6,33,.182,7,10,.700,89
1019,DEN,2023-10-30,110,,UTA,W 110-102,240,47,84,.560,38,56,.679,9,28,.321,7,17,.412,110,42,98,.429,31,61,.508,11,37,.297,7,15,.467,102
1020,MEM,2023-10-30,110,,DAL,L 110-125,240,42,92,.457,28,55,.509,14,37,.378,12,20,.600,110,42,84,.500,19,37,.514,23,47,.489,18,24,.750,125
1021,MIL,2023-10-29,110,,ATL,L 110-127,240,39,86,.453,23,42,.548,16,44,.364,16,20,.800,110,47,93,.505,32,56,.571,15,37,.405,18,22,.818,127
1022,ATL,2023-10-25,110,@,CHO,L 110-116,240,39,93,.419,34,64,.531,5,29,.172,27,33,.818,110,43,86,.500,32,49,.653,11,37,.297,19,26,.731,116
1023,GSW,2024-02-05,109,@,BRK,W 109-98,240,43,93,.462,39,71,.549,4,22,.182,19,23,.826,109,34,89,.382,21,47,.447,13,42,.310,17,22,.773,98
1024,NYK,2024-02-01,109,,IND,W 109-105,240,41,103,.398,33,65,.508,8,38,.211,19,25,.760,109,42,93,.452,29,60,.483,13,33,.394,8,13,.615,105
1025,WAS,2024-01-31,109,,LAC,L 109-125,240,45,97,.464,36,68,.529,9,29,.310,10,15,.667,109,47,100,.470,35,70,.500,12,30,.400,19,22,.864,125
1026,MIA,2024-01-27,109,@,NYK,L 109-125,240,41,88,.466,27,51,.529,14,37,.378,13,16,.813,109,45,87,.517,28,54,.519,17,33,.515,18,26,.692,125
1027,DAL,2024-01-24,109,,PHO,L 109-132,240,41,89,.461,24,46,.522,17,43,.395,10,18,.556,109,51,85,.600,37,51,.725,14,34,.412,16,22,.727,132
1028,POR,2024-01-23,109,@,OKC,L 109-111,240,37,86,.430,19,47,.404,18,39,.462,17,21,.810,109,43,89,.483,36,66,.545,7,23,.304,18,28,.643,111
1029,IND,2024-01-23,109,,DEN,L 109-114,240,43,87,.494,38,66,.576,5,21,.238,18,21,.857,109,44,88,.500,33,55,.600,11,33,.333,15,17,.882,114
1030,ATL,2024-01-19,109,@,MIA,W 109-108,240,40,87,.460,25,52,.481,15,35,.429,14,17,.824,109,38,82,.463,26,51,.510,12,31,.387,20,22,.909,108
1031,NOP,2024-01-19,109,,PHO,L 109-123,240,41,93,.441,31,51,.608,10,42,.238,17,23,.739,109,46,93,.495,31,52,.596,15,41,.366,16,21,.762,123
1032,ORL,2024-01-19,109,,PHI,L 109-124,240,37,78,.474,27,55,.491,10,23,.435,25,27,.926,109,42,87,.483,29,57,.509,13,30,.433,27,29,.931,124
1033,WAS,2024-01-18,109,@,NYK,L 109-113,240,41,90,.456,31,59,.525,10,31,.323,17,22,.773,109,39,86,.453,26,48,.542,13,38,.342,22,26,.846,113
1034,NYK,2024-01-17,109,,HOU,W 109-94,240,39,87,.448,26,50,.520,13,37,.351,18,22,.818,109,35,84,.417,27,54,.500,8,30,.267,16,19,.842,94
1035,CLE,2024-01-15,109,,CHI,W 109-91,240,39,95,.411,19,38,.500,20,57,.351,11,11,1.000,109,35,83,.422,26,51,.510,9,32,.281,12,16,.750,91
1036,ATL,2024-01-15,109,,SAS,W 109-99,240,40,93,.430,27,55,.491,13,38,.342,16,21,.762,109,38,95,.400,27,53,.509,11,42,.262,12,17,.706,99
1037,MIN,2024-01-14,109,,LAC,W 109-105,240,38,67,.567,25,41,.610,13,26,.500,20,31,.645,109,36,83,.434,19,44,.432,17,39,.436,16,18,.889,105
1038,IND,2024-01-14,109,@,DEN,L 109-117,240,43,92,.467,35,63,.556,8,29,.276,15,22,.682,109,46,71,.648,36,51,.706,10,20,.500,15,23,.652,117
1039,LAL,2024-01-11,109,,PHO,L 109-127,240,40,80,.500,27,46,.587,13,34,.382,16,25,.640,109,46,93,.495,32,54,.593,14,39,.359,21,23,.913,127
1040,PHI,2024-01-06,109,,UTA,L 109-120,240,42,104,.404,35,66,.530,7,38,.184,18,23,.783,109,46,80,.575,38,50,.760,8,30,.267,20,24,.833,120
1041,DET,2024-01-05,109,@,GSW,L 109-113,240,44,98,.449,31,54,.574,13,44,.295,8,10,.800,109,38,82,.463,22,44,.500,16,38,.421,21,25,.840,113
1042,PHO,2024-01-01,109,,POR,W 109-88,240,38,80,.475,27,51,.529,11,29,.379,22,33,.667,109,33,80,.413,25,50,.500,8,30,.267,14,19,.737,88
1043,LAL,2023-12-31,109,@,NOP,L 109-129,240,39,82,.476,29,50,.580,10,32,.313,21,25,.840,109,45,87,.517,28,53,.528,17,34,.500,22,27,.815,129
1044,MIA,2023-12-30,109,@,UTA,L 109-117,240,34,78,.436,25,47,.532,9,31,.290,32,40,.800,109,43,93,.462,32,52,.615,11,41,.268,20,28,.714,117
1045,CLE,2023-12-23,109,@,CHI,W 109-95,240,39,88,.443,27,43,.628,12,45,.267,19,26,.731,109,35,80,.438,27,45,.600,8,35,.229,17,19,.895,95
1046,POR,2023-12-19,109,,PHO,W 109-104,240,39,87,.448,25,59,.424,14,28,.500,17,19,.895,109,42,94,.447,37,71,.521,5,23,.217,15,21,.714,104
1047,LAL,2023-12-18,109,,NYK,L 109-114,240,42,99,.424,29,58,.500,13,41,.317,12,13,.923,109,42,88,.477,32,58,.552,10,30,.333,20,23,.870,114
1048,IND,2023-12-16,109,@,MIN,L 109-127,240,45,90,.500,39,69,.565,6,21,.286,13,16,.813,109,48,86,.558,30,56,.536,18,30,.600,13,16,.813,127
1049,MEM,2023-12-02,109,@,PHO,L 109-116,240,39,86,.453,30,55,.545,9,31,.290,22,24,.917,109,36,83,.434,27,57,.474,9,26,.346,35,43,.814,116
1050,CHI,2023-11-26,109,@,BRK,L 109-118,240,40,83,.482,28,51,.549,12,32,.375,17,22,.773,109,41,83,.494,16,30,.533,25,53,.472,11,15,.733,118
1051,LAC,2023-11-22,109,@,SAS,W 109-102,240,39,85,.459,30,57,.526,9,28,.321,22,29,.759,109,35,91,.385,24,53,.453,11,38,.289,21,23,.913,102
1052,DEN,2023-11-19,109,@,CLE,L 109-121,240,39,82,.476,25,53,.472,14,29,.483,17,23,.739,109,45,82,.549,34,55,.618,11,27,.407,20,26,.769,121
1053,GSW,2023-11-16,109,,OKC,L 109-128,240,40,98,.408,26,57,.456,14,41,.341,15,19,.789,109,44,87,.506,25,55,.455,19,32,.594,21,23,.913,128
1054,CLE,2023-11-15,109,@,POR,W 109-95,240,42,75,.560,33,45,.733,9,30,.300,16,21,.762,109,34,91,.374,21,53,.396,13,38,.342,14,16,.875,95
1055,CHI,2023-11-13,109,@,MIL,L 109-118,240,38,100,.380,24,58,.414,14,42,.333,19,21,.905,109,42,89,.472,27,42,.643,15,47,.319,19,27,.704,118
1056,ATL,2023-11-11,109,,MIA,L 109-117,240,38,87,.437,20,41,.488,18,46,.391,15,18,.833,109,41,84,.488,29,46,.630,12,38,.316,23,25,.920,117
1057,BOS,2023-11-06,109,@,MIN,L 109-114 (OT),265,36,92,.391,25,53,.472,11,39,.282,26,34,.765,109,44,85,.518,31,48,.646,13,37,.351,13,25,.520,114
1058,DET,2023-11-06,109,,GSW,L 109-120,240,38,80,.475,25,50,.500,13,30,.433,20,21,.952,109,46,97,.474,34,56,.607,12,41,.293,16,21,.762,120
1059,BRK,2023-11-03,109,@,CHI,W 109-107,240,44,96,.458,26,51,.510,18,45,.400,3,5,.600,109,43,89,.483,32,61,.525,11,28,.393,10,14,.714,107
1060,BRK,2023-11-01,109,@,MIA,W 109-105,240,37,82,.451,21,46,.457,16,36,.444,19,26,.731,109,39,91,.429,26,53,.491,13,38,.342,14,18,.778,105
1061,MEM,2023-11-01,109,@,UTA,L 109-133,240,35,96,.365,21,42,.500,14,54,.259,25,32,.781,109,47,87,.540,25,44,.568,22,43,.512,17,24,.708,133
1062,NYK,2023-10-31,109,@,CLE,W 109-91,240,38,86,.442,25,52,.481,13,34,.382,20,25,.800,109,36,92,.391,26,54,.481,10,38,.263,9,12,.750,91
1063,MIL,2024-02-04,108,@,UTA,L 108-123,240,39,84,.464,24,43,.558,15,41,.366,15,25,.600,108,43,89,.483,26,45,.578,17,44,.386,20,24,.833,123
1064,ORL,2024-02-02,108,@,MIN,W 108-106,240,39,85,.459,30,60,.500,9,25,.360,21,26,.808,108,38,82,.463,26,44,.591,12,38,.316,18,20,.900,106
1065,POR,2024-02-02,108,@,DEN,L 108-120,240,37,80,.463,27,52,.519,10,28,.357,24,30,.800,108,46,91,.505,34,55,.618,12,36,.333,16,17,.941,120
1066,CLE,2024-02-01,108,@,MEM,W 108-101,240,41,86,.477,27,51,.529,14,35,.400,12,18,.667,108,37,90,.411,25,52,.481,12,38,.316,15,17,.882,101
1067,ORL,2024-01-31,108,@,SAS,W 108-98,240,41,86,.477,34,66,.515,7,20,.350,19,23,.826,108,36,80,.450,27,49,.551,9,31,.290,17,24,.708,98
1068,LAC,2024-01-29,108,@,CLE,L 108-118,240,38,80,.475,27,46,.587,11,34,.324,21,28,.750,108,42,86,.488,29,46,.630,13,40,.325,21,26,.808,118
1069,WAS,2024-01-25,108,,UTA,L 108-123,240,43,88,.489,36,58,.621,7,30,.233,15,20,.750,108,50,97,.515,37,66,.561,13,31,.419,10,12,.833,123
1070,NYK,2024-01-23,108,@,BRK,W 108-103,240,40,86,.465,30,57,.526,10,29,.345,18,19,.947,108,42,95,.442,27,53,.509,15,42,.357,4,5,.800,103
1071,MEM,2024-01-22,108,@,TOR,W 108-100,240,44,95,.463,31,61,.508,13,34,.382,7,12,.583,108,35,79,.443,27,56,.482,8,23,.348,22,23,.957,100
1072,MIA,2024-01-19,108,,ATL,L 108-109,240,38,82,.463,26,51,.510,12,31,.387,20,22,.909,108,40,87,.460,25,52,.481,15,35,.429,14,17,.824,109
1073,DAL,2024-01-13,108,,NOP,L 108-118,240,37,82,.451,22,41,.537,15,41,.366,19,20,.950,108,39,79,.494,27,49,.551,12,30,.400,28,37,.757,118
1074,ATL,2024-01-12,108,,IND,L 108-126,240,40,89,.449,29,59,.492,11,30,.367,17,23,.739,108,53,79,.671,42,61,.689,11,18,.611,9,12,.750,126
1075,DET,2024-01-10,108,,SAS,L 108-130,240,44,96,.458,34,64,.531,10,32,.313,10,13,.769,108,49,94,.521,40,67,.597,9,27,.333,23,27,.852,130
1076,MIN,2024-01-07,108,@,DAL,L 108-115,240,41,94,.436,28,53,.528,13,41,.317,13,21,.619,108,43,95,.453,28,55,.509,15,40,.375,14,20,.700,115
1077,MIL,2024-01-06,108,@,HOU,L 108-112,240,35,76,.461,26,42,.619,9,34,.265,29,42,.690,108,36,83,.434,23,49,.469,13,34,.382,27,32,.844,112
1078,BRK,2023-12-31,108,@,OKC,L 108-124,240,38,100,.380,26,54,.481,12,46,.261,20,31,.645,108,45,83,.542,27,50,.540,18,33,.545,16,20,.800,124
1079,MIN,2023-12-30,108,,LAL,W 108-106,240,38,76,.500,26,42,.619,12,34,.353,20,24,.833,108,37,88,.420,30,64,.469,7,24,.292,25,32,.781,106
1080,NYK,2023-12-29,108,@,ORL,L 108-117,240,38,86,.442,32,56,.571,6,30,.200,26,29,.897,108,40,89,.449,33,56,.589,7,33,.212,30,40,.750,117
1081,LAC,2023-12-23,108,,BOS,L 108-145,240,41,89,.461,30,55,.545,11,34,.324,15,15,1.000,108,49,94,.521,24,41,.585,25,53,.472,22,28,.786,145
1082,LAL,2023-12-20,108,@,CHI,L 108-124,240,42,94,.447,30,57,.526,12,37,.324,12,15,.800,108,48,88,.545,30,54,.556,18,34,.529,10,11,.909,124
1083,MIA,2023-12-18,108,,MIN,L 108-112,240,41,87,.471,30,57,.526,11,30,.367,15,18,.833,108,42,85,.494,31,56,.554,11,29,.379,17,19,.895,112
1084,BRK,2023-12-18,108,@,UTA,L 108-125,240,39,90,.433,23,51,.451,16,39,.410,14,20,.700,108,45,91,.495,31,57,.544,14,34,.412,21,24,.875,125
1085,CHI,2023-12-18,108,@,PHI,W 108-104,240,42,89,.472,30,60,.500,12,29,.414,12,15,.800,108,38,88,.432,27,56,.482,11,32,.344,17,19,.895,104
1086,WAS,2023-12-17,108,@,PHO,L 108-112,240,39,95,.411,25,49,.510,14,46,.304,16,20,.800,108,41,90,.456,34,59,.576,7,31,.226,23,30,.767,112
1087,MEM,2023-12-01,108,@,DAL,W 108-94,240,44,90,.489,33,56,.589,11,34,.324,9,11,.818,108,34,92,.370,22,53,.415,12,39,.308,14,21,.667,94
1088,MIL,2023-11-26,108,,POR,W 108-102,240,35,89,.393,21,47,.447,14,42,.333,24,32,.750,108,37,91,.407,24,59,.407,13,32,.406,15,20,.750,102
1089,WAS,2023-11-25,108,,ATL,L 108-136,240,43,88,.489,33,50,.660,10,38,.263,12,12,1.000,108,52,102,.510,34,65,.523,18,37,.486,14,20,.700,136
1090,CHI,2023-11-24,108,@,TOR,L 108-121,240,42,82,.512,30,55,.545,12,27,.444,12,19,.632,108,44,83,.530,31,44,.705,13,39,.333,20,27,.741,121
1091,SAS,2023-11-18,108,,MEM,L 108-120,240,36,83,.434,21,43,.488,15,40,.375,21,26,.808,108,40,86,.465,29,53,.547,11,33,.333,29,36,.806,120
1092,CHO,2023-11-18,108,,NYK,L 108-122,240,40,82,.488,23,47,.489,17,35,.486,11,13,.846,108,46,91,.505,30,54,.556,16,37,.432,14,19,.737,122
1093,CLE,2023-11-17,108,,DET,W 108-100,240,42,82,.512,33,61,.541,9,21,.429,15,21,.714,108,39,91,.429,30,56,.536,9,35,.257,13,15,.867,100
1094,BOS,2023-11-17,108,@,TOR,W 108-105,240,42,92,.457,26,46,.565,16,46,.348,8,9,.889,108,42,87,.483,30,54,.556,12,33,.364,9,14,.643,105
1095,LAC,2023-11-14,108,@,DEN,L 108-111,240,37,86,.430,24,57,.421,13,29,.448,21,24,.875,108,39,73,.534,31,50,.620,8,23,.348,25,32,.781,111
1096,DET,2023-11-12,108,@,CHI,L 108-119,240,38,88,.432,27,56,.482,11,32,.344,21,26,.808,108,44,91,.484,33,61,.541,11,30,.367,20,25,.800,119
1097,DEN,2023-11-08,108,,GSW,W 108-105,240,41,92,.446,30,57,.526,11,35,.314,15,22,.682,108,37,86,.430,26,51,.510,11,35,.314,20,26,.769,105
1098,MIA,2023-11-08,108,@,MEM,W 108-102,240,35,77,.455,24,49,.490,11,28,.393,27,32,.844,108,35,90,.389,24,53,.453,11,37,.297,21,28,.750,102
1099,MIA,2023-11-06,108,,LAL,W 108-107,240,41,88,.466,29,51,.569,12,37,.324,14,16,.875,108,44,81,.543,36,55,.655,8,26,.308,11,14,.786,107
1100,DEN,2023-10-27,108,@,MEM,W 108-104,240,41,88,.466,27,51,.529,14,37,.378,12,18,.667,108,37,85,.435,27,52,.519,10,33,.303,20,24,.833,104
1101,OKC,2023-10-27,108,@,CLE,W 108-105,240,40,87,.460,27,61,.443,13,26,.500,15,19,.789,108,38,92,.413,26,47,.553,12,45,.267,17,23,.739,105
1102,BOS,2023-10-25,108,@,NYK,W 108-104,240,37,77,.481,25,38,.658,12,39,.308,22,26,.846,108,36,97,.371,18,56,.321,18,41,.439,14,26,.538,104
1103,PHO,2023-10-24,108,@,GSW,W 108-104,240,42,95,.442,31,62,.500,11,33,.333,13,17,.765,108,36,101,.356,26,58,.448,10,43,.233,22,28,.786,104
1104,BRK,2024-02-06,107,,DAL,L 107-119,240,41,91,.451,29,58,.500,12,33,.364,13,15,.867,107,46,91,.505,27,48,.563,19,43,.442,8,13,.615,119
1105,PHI,2024-01-30,107,@,GSW,L 107-119,240,39,85,.459,26,55,.473,13,30,.433,16,21,.762,107,44,79,.557,30,47,.638,14,32,.438,17,19,.895,119
1106,CHI,2024-01-30,107,,TOR,L 107-118,240,38,75,.507,27,43,.628,11,32,.344,20,27,.741,107,43,83,.518,29,54,.537,14,29,.483,18,20,.900,118
1107,MIN,2024-01-29,107,@,OKC,W 107-101,240,40,83,.482,26,54,.481,14,29,.483,13,15,.867,107,35,79,.443,21,44,.477,14,35,.400,17,22,.773,101
1108,MIL,2024-01-29,107,@,DEN,L 107-113,240,36,84,.429,20,44,.455,16,40,.400,19,25,.760,107,44,91,.484,40,73,.548,4,18,.222,21,24,.875,113
1109,TOR,2024-01-26,107,,LAC,L 107-127,240,44,96,.458,38,64,.594,6,32,.188,13,22,.591,107,48,95,.505,39,63,.619,9,32,.281,22,24,.917,127
1110,OKC,2024-01-26,107,@,NOP,W 107-83,240,42,88,.477,32,55,.582,10,33,.303,13,14,.929,107,32,82,.390,23,46,.500,9,36,.250,10,14,.714,83
1111,MEM,2024-01-26,107,,ORL,W 107-106,240,42,90,.467,27,49,.551,15,41,.366,8,13,.615,107,38,81,.469,29,47,.617,9,34,.265,21,29,.724,106
1112,WAS,2024-01-24,107,,MIN,L 107-118,240,37,77,.481,27,53,.509,10,24,.417,23,29,.793,107,42,100,.420,33,68,.485,9,32,.281,25,29,.862,118
1113,ATL,2024-01-22,107,@,SAC,L 107-122,240,36,93,.387,22,53,.415,14,40,.350,21,27,.778,107,43,93,.462,31,55,.564,12,38,.316,24,27,.889,122
1114,HOU,2024-01-21,107,,BOS,L 107-116,240,41,94,.436,31,59,.525,10,35,.286,15,22,.682,107,43,98,.439,26,51,.510,17,47,.362,13,18,.722,116
1115,GSW,2024-01-15,107,@,MEM,L 107-116,240,44,90,.489,34,59,.576,10,31,.323,9,10,.900,107,32,86,.372,12,32,.375,20,54,.370,32,40,.800,116
1116,ORL,2023-12-31,107,@,PHO,L 107-112,240,42,90,.467,30,53,.566,12,37,.324,11,12,.917,107,44,88,.500,36,61,.590,8,27,.296,16,19,.842,112
1117,CHO,2023-12-15,107,,NOP,L 107-112,240,41,92,.446,32,61,.525,9,31,.290,16,21,.762,107,38,80,.475,29,53,.547,9,27,.333,27,32,.844,112
1118,CLE,2023-12-14,107,@,BOS,L 107-116,240,40,83,.482,29,50,.580,11,33,.333,16,17,.941,107,43,85,.506,30,49,.612,13,36,.361,17,20,.850,116
1119,MIN,2023-12-11,107,@,NOP,L 107-121,240,40,91,.440,27,55,.491,13,36,.361,14,19,.737,107,40,82,.488,30,55,.545,10,27,.370,31,40,.775,121
1120,LAL,2023-12-02,107,,HOU,W 107-97,240,40,89,.449,32,62,.516,8,27,.296,19,27,.704,107,36,89,.404,25,58,.431,11,31,.355,14,18,.778,97
1121,DET,2023-11-29,107,,LAL,L 107-133,240,40,97,.412,25,61,.410,15,36,.417,12,14,.857,107,45,88,.511,33,54,.611,12,34,.353,31,38,.816,133
1122,DET,2023-11-27,107,,WAS,L 107-126,240,43,102,.422,35,64,.547,8,38,.211,13,19,.684,107,45,89,.506,35,60,.583,10,29,.345,26,28,.929,126
1123,LAC,2023-11-25,107,,DAL,W 107-88,240,38,88,.432,30,59,.508,8,29,.276,23,31,.742,107,34,91,.374,25,53,.472,9,38,.237,11,14,.786,88
1124,TOR,2023-11-21,107,@,ORL,L 107-126,240,38,75,.507,24,47,.511,14,28,.500,17,22,.773,107,50,100,.500,38,69,.551,12,31,.387,14,20,.700,126
1125,POR,2023-11-21,107,@,PHO,L 107-120,240,38,87,.437,24,56,.429,14,31,.452,17,20,.850,107,43,76,.566,36,59,.610,7,17,.412,27,28,.964,120
1126,DEN,2023-11-20,107,@,DET,W 107-103,240,40,87,.460,29,59,.492,11,28,.393,16,21,.762,107,36,81,.444,29,60,.483,7,21,.333,24,26,.923,103
1127,LAL,2023-11-17,107,@,POR,W 107-95,240,40,81,.494,28,52,.538,12,29,.414,15,22,.682,107,36,89,.404,26,52,.500,10,37,.270,13,18,.722,95
1128,PHI,2023-11-15,107,,BOS,L 107-117,240,39,85,.459,28,55,.509,11,30,.367,18,22,.818,107,42,88,.477,24,38,.632,18,50,.360,15,19,.789,117
1129,MEM,2023-11-14,107,@,LAL,L 107-134,240,39,106,.368,19,53,.358,20,53,.377,9,12,.750,107,47,81,.580,25,46,.543,22,35,.629,18,24,.750,134
1130,WAS,2023-11-13,107,@,TOR,L 107-111,240,43,84,.512,31,58,.534,12,26,.462,9,12,.750,107,45,90,.500,41,70,.586,4,20,.200,17,25,.680,111
1131,HOU,2023-11-12,107,,DEN,W 107-104,240,37,87,.425,27,55,.491,10,32,.313,23,29,.793,107,42,91,.462,33,59,.559,9,32,.281,11,14,.786,104
1132,CHO,2023-11-12,107,@,NYK,L 107-129,240,44,94,.468,32,59,.542,12,35,.343,7,11,.636,107,47,87,.540,32,51,.627,15,36,.417,20,30,.667,129
1133,BRK,2023-11-10,107,@,BOS,L 107-121,240,38,85,.447,23,48,.479,15,37,.405,16,18,.889,107,41,94,.436,22,42,.524,19,52,.365,20,28,.714,121
1134,LAL,2023-11-06,107,@,MIA,L 107-108,240,44,81,.543,36,55,.655,8,26,.308,11,14,.786,107,41,88,.466,29,51,.569,12,37,.324,14,16,.875,108
1135,HOU,2023-11-04,107,,SAC,W 107-89,240,40,87,.460,27,51,.529,13,36,.361,14,20,.700,107,32,84,.381,21,43,.488,11,41,.268,14,19,.737,89
1136,CHI,2023-11-03,107,,BRK,L 107-109,240,43,89,.483,32,61,.525,11,28,.393,10,14,.714,107,44,96,.458,26,51,.510,18,45,.400,3,5,.600,109
1137,WAS,2023-10-30,107,,BOS,L 107-126,240,39,87,.448,28,51,.549,11,36,.306,18,26,.692,107,51,102,.500,32,49,.653,19,53,.358,5,7,.714,126
1138,TOR,2023-10-28,107,,PHI,L 107-114,240,38,87,.437,21,55,.382,17,32,.531,14,19,.737,107,43,86,.500,33,58,.569,10,28,.357,18,21,.857,114
1139,LAL,2023-10-24,107,@,DEN,L 107-119,240,41,90,.456,31,61,.508,10,29,.345,15,20,.750,107,48,91,.527,34,57,.596,14,34,.412,9,12,.750,119
1140,LAC,2024-02-07,106,,NOP,L 106-117,240,36,78,.462,24,46,.522,12,32,.375,22,26,.846,106,47,88,.534,35,56,.625,12,32,.375,11,16,.688,117
1141,WAS,2024-02-07,106,,CLE,L 106-114,240,42,94,.447,26,54,.481,16,40,.400,6,9,.667,106,43,88,.489,31,53,.585,12,35,.343,16,22,.727,114
1142,MIL,2024-02-06,106,@,PHO,L 106-114,240,39,90,.433,26,50,.520,13,40,.325,15,25,.600,106,44,87,.506,36,59,.610,8,28,.286,18,27,.667,114
1143,TOR,2024-02-02,106,@,HOU,L 106-135,240,40,91,.440,29,58,.500,11,33,.333,15,20,.750,106,55,93,.591,44,62,.710,11,31,.355,14,17,.824,135
1144,CHO,2024-02-02,106,@,OKC,L 106-126,240,41,92,.446,27,61,.443,14,31,.452,10,14,.714,106,44,75,.587,27,39,.692,17,36,.472,21,27,.778,126
1145,MIN,2024-02-02,106,,ORL,L 106-108,240,38,82,.463,26,44,.591,12,38,.316,18,20,.900,106,39,85,.459,30,60,.500,9,25,.360,21,26,.808,108
1146,SAC,2024-01-31,106,@,MIA,L 106-115,240,41,93,.441,29,53,.547,12,40,.300,12,18,.667,106,42,84,.500,29,56,.518,13,28,.464,18,23,.783,115
1147,BRK,2024-01-27,106,,HOU,W 106-104,240,36,74,.486,24,40,.600,12,34,.353,22,37,.595,106,37,94,.394,27,57,.474,10,37,.270,20,23,.870,104
1148,ORL,2024-01-26,106,@,MEM,L 106-107,240,38,81,.469,29,47,.617,9,34,.265,21,29,.724,106,42,90,.467,27,49,.551,15,41,.366,8,13,.615,107
1149,CHO,2024-01-24,106,@,DET,L 106-113,240,38,87,.437,23,49,.469,15,38,.395,15,19,.789,106,43,86,.500,28,48,.583,15,38,.395,12,20,.600,113
1150,ATL,2024-01-17,106,,ORL,W 106-104,240,39,76,.513,31,51,.608,8,25,.320,20,22,.909,106,39,88,.443,29,53,.547,10,35,.286,16,22,.727,104
1151,NYK,2024-01-13,106,@,MEM,W 106-94,240,40,83,.482,27,45,.600,13,38,.342,13,19,.684,106,36,87,.414,27,49,.551,9,38,.237,13,15,.867,94
1152,LAL,2024-01-07,106,,LAC,W 106-103,240,42,82,.512,31,53,.585,11,29,.379,11,16,.688,106,36,91,.396,22,54,.407,14,37,.378,17,19,.895,103
1153,MIN,2024-01-03,106,,NOP,L 106-117,240,37,82,.451,27,51,.529,10,31,.323,22,27,.815,106,45,81,.556,33,55,.600,12,26,.462,15,17,.882,117
1154,MEM,2024-01-02,106,,SAS,W 106-98,240,37,80,.463,25,42,.595,12,38,.316,20,25,.800,106,36,85,.424,26,54,.481,10,31,.323,16,23,.696,98
1155,MIN,2024-01-01,106,@,NYK,L 106-112,240,36,76,.474,25,48,.521,11,28,.393,23,29,.793,106,39,89,.438,27,55,.491,12,34,.353,22,28,.786,112
1156,LAL,2023-12-30,106,@,MIN,L 106-108,240,37,88,.420,30,64,.469,7,24,.292,25,32,.781,106,38,76,.500,26,42,.619,12,34,.353,20,24,.833,108
1157,MEM,2023-12-29,106,@,LAC,L 106-117,240,38,87,.437,25,47,.532,13,40,.325,17,20,.850,106,43,87,.494,32,48,.667,11,39,.282,20,25,.800,117
1158,MIN,2023-12-26,106,@,OKC,L 106-129,240,34,73,.466,22,46,.478,12,27,.444,26,32,.813,106,49,81,.605,31,42,.738,18,39,.462,13,16,.813,129
1159,HOU,2023-12-23,106,@,NOP,W 106-104,240,35,82,.427,26,53,.491,9,29,.310,27,35,.771,106,38,82,.463,30,51,.588,8,31,.258,20,29,.690,104
1160,POR,2023-12-23,106,@,GSW,L 106-126,240,38,84,.452,25,49,.510,13,35,.371,17,25,.680,106,48,83,.578,38,50,.760,10,33,.303,20,24,.833,126
1161,ORL,2023-12-20,106,,MIA,L 106-115,240,41,89,.461,32,53,.604,9,36,.250,15,19,.789,106,40,83,.482,25,54,.463,15,29,.517,20,24,.833,115
1162,CHI,2023-12-12,106,,DEN,L 106-114,240,36,86,.419,23,46,.500,13,40,.325,21,23,.913,106,39,83,.470,25,53,.472,14,30,.467,22,32,.688,114
1163,DEN,2023-12-08,106,,HOU,L 106-114,240,38,90,.422,28,62,.452,10,28,.357,20,27,.741,106,35,82,.427,22,43,.512,13,39,.333,31,42,.738,114
1164,PHO,2023-12-08,106,,SAC,L 106-114,240,40,83,.482,29,51,.569,11,32,.344,15,23,.652,106,42,92,.457,28,53,.528,14,39,.359,16,20,.800,114
1165,POR,2023-12-06,106,@,GSW,L 106-110,240,39,95,.411,23,49,.469,16,46,.348,12,16,.750,106,36,86,.419,26,52,.500,10,34,.294,28,33,.848,110
1166,LAL,2023-12-05,106,,PHO,W 106-103,240,38,102,.373,29,72,.403,9,30,.300,21,25,.840,106,37,75,.493,25,50,.500,12,25,.480,17,21,.810,103
1167,SAS,2023-12-01,106,@,NOP,L 106-121,240,38,83,.458,22,44,.500,16,39,.410,14,17,.824,106,42,85,.494,32,54,.593,10,31,.323,27,29,.931,121
1168,TOR,2023-12-01,106,,NYK,L 106-119,240,44,100,.440,38,68,.559,6,32,.188,12,17,.706,106,45,90,.500,29,54,.537,16,36,.444,13,16,.813,119
1169,MIN,2023-11-28,106,,OKC,W 106-103,240,33,78,.423,19,45,.422,14,33,.424,26,32,.813,106,37,90,.411,26,60,.433,11,30,.367,18,23,.783,103
1170,LAC,2023-11-24,106,,NOP,L 106-116,240,42,92,.457,31,55,.564,11,37,.297,11,17,.647,106,43,88,.489,33,64,.516,10,24,.417,20,27,.741,116
1171,LAC,2023-11-17,106,,HOU,W 106-100,240,36,83,.434,23,49,.469,13,34,.382,21,30,.700,106,38,88,.432,28,57,.491,10,31,.323,14,20,.700,100
1172,DET,2023-11-10,106,,PHI,L 106-114,240,40,86,.465,32,58,.552,8,28,.286,18,22,.818,106,35,83,.422,26,55,.473,9,28,.321,35,41,.854,114
1173,PHI,2023-11-08,106,,BOS,W 106-103,240,42,95,.442,33,61,.541,9,34,.265,13,15,.867,106,36,91,.396,21,44,.477,15,47,.319,16,19,.842,103
1174,DET,2023-11-05,106,,PHO,L 106-120,240,43,87,.494,35,64,.547,8,23,.348,12,14,.857,106,43,86,.500,35,65,.538,8,21,.381,26,29,.897,120
1175,OKC,2023-11-01,106,,NOP,L 106-110,240,38,88,.432,31,54,.574,7,34,.206,23,25,.920,106,40,102,.392,27,60,.450,13,42,.310,17,29,.586,110
1176,LAL,2023-10-30,106,,ORL,W 106-103,240,42,79,.532,34,52,.654,8,27,.296,14,18,.778,106,38,95,.400,24,60,.400,14,35,.400,13,18,.722,103
1177,GSW,2023-10-29,106,@,HOU,W 106-95,240,35,81,.432,17,36,.472,18,45,.400,18,23,.783,106,34,90,.378,25,57,.439,9,33,.273,18,19,.947,95
1178,MEM,2023-10-28,106,@,WAS,L 106-113,240,39,91,.429,20,44,.455,19,47,.404,9,9,1.000,106,40,93,.430,24,47,.511,16,46,.348,17,22,.773,113
1179,MIN,2023-10-28,106,,MIA,W 106-90,240,44,86,.512,32,52,.615,12,34,.353,6,8,.750,106,35,87,.402,23,49,.469,12,38,.316,8,14,.571,90
1180,NYK,2024-02-03,105,,LAL,L 105-113,240,41,100,.410,31,65,.477,10,35,.286,13,15,.867,105,39,80,.488,27,49,.551,12,31,.387,23,27,.852,113
1181,BOS,2024-02-01,105,,LAL,L 105-114,240,41,97,.423,25,49,.510,16,48,.333,7,7,1.000,105,38,94,.404,19,58,.328,19,36,.528,19,26,.731,114
1182,IND,2024-02-01,105,@,NYK,L 105-109,240,42,93,.452,29,60,.483,13,33,.394,8,13,.615,105,41,103,.398,33,65,.508,8,38,.211,19,25,.760,109
1183,OKC,2024-01-31,105,,DEN,W 105-100,240,37,87,.425,26,61,.426,11,26,.423,20,25,.800,105,37,93,.398,22,56,.393,15,37,.405,11,16,.688,100
1184,MIA,2024-01-29,105,,PHO,L 105-118,240,33,84,.393,19,48,.396,14,36,.389,25,25,1.000,105,46,94,.489,32,54,.593,14,40,.350,12,17,.706,118
1185,PHI,2024-01-27,105,@,DEN,L 105-111,240,43,81,.531,37,59,.627,6,22,.273,13,16,.813,105,37,82,.451,24,45,.533,13,37,.351,24,38,.632,111
1186,MEM,2024-01-24,105,@,MIA,W 105-96,240,36,80,.450,19,44,.432,17,36,.472,16,19,.842,105,33,82,.402,22,48,.458,11,34,.324,19,25,.760,96
1187,ORL,2024-01-21,105,,MIA,W 105-87,240,37,78,.474,28,50,.560,9,28,.321,22,28,.786,105,30,80,.375,18,43,.419,12,37,.324,15,18,.833,87
1188,POR,2024-01-17,105,,BRK,W 105-103,240,42,86,.488,33,59,.559,9,27,.333,12,14,.857,105,35,73,.479,20,35,.571,15,38,.395,18,27,.667,103
1189,BOS,2024-01-15,105,@,TOR,W 105-96,240,33,82,.402,17,43,.395,16,39,.410,23,25,.920,105,38,95,.400,34,63,.540,4,32,.125,16,21,.762,96
1190,IND,2024-01-15,105,@,UTA,L 105-132,240,38,95,.400,29,64,.453,9,31,.290,20,25,.800,105,45,81,.556,34,56,.607,11,25,.440,31,35,.886,132
1191,OKC,2024-01-15,105,@,LAL,L 105-112,240,40,96,.417,25,47,.532,15,49,.306,10,11,.909,105,44,84,.524,36,60,.600,8,24,.333,16,18,.889,112
1192,LAC,2024-01-14,105,@,MIN,L 105-109,240,36,83,.434,19,44,.432,17,39,.436,16,18,.889,105,38,67,.567,25,41,.610,13,26,.500,20,31,.645,109
1193,GSW,2024-01-10,105,,NOP,L 105-141,240,39,89,.438,27,50,.540,12,39,.308,15,18,.833,105,54,94,.574,35,54,.648,19,40,.475,14,19,.737,141
1194,WAS,2024-01-06,105,,NYK,L 105-121,240,40,85,.471,27,48,.563,13,37,.351,12,20,.600,105,43,87,.494,29,51,.569,14,36,.389,21,24,.875,121
1195,CHI,2023-12-30,105,,PHI,W 105-92,240,40,79,.506,33,54,.611,7,25,.280,18,30,.600,105,36,92,.391,27,54,.500,9,38,.237,11,15,.733,92
1196,UTA,2023-12-28,105,@,NOP,L 105-112,240,36,85,.424,24,46,.522,12,39,.308,21,25,.840,105,45,82,.549,35,55,.636,10,27,.370,12,15,.800,112
1197,POR,2023-12-28,105,,SAS,L 105-118,240,35,101,.347,24,65,.369,11,36,.306,24,32,.750,105,41,85,.482,31,49,.633,10,36,.278,26,28,.929,118
1198,MEM,2023-12-28,105,@,DEN,L 105-142,240,37,89,.416,24,54,.444,13,35,.371,18,25,.720,105,55,96,.573,35,55,.636,20,41,.488,12,14,.857,142
1199,PHO,2023-12-22,105,@,SAC,L 105-120,240,39,88,.443,34,63,.540,5,25,.200,22,28,.786,105,44,83,.530,32,45,.711,12,38,.316,20,26,.769,120
1200,MEM,2023-11-29,105,,UTA,W 105-91,240,43,87,.494,30,48,.625,13,39,.333,6,8,.750,105,34,90,.378,18,51,.353,16,39,.410,7,12,.583,91
1201,MEM,2023-11-29,105,,UTA,W 105-91,240,43,87,.494,30,48,.625,13,39,.333,6,8,.750,105,34,90,.378,18,51,.353,16,39,.410,7,12,.583,91
1202,ATL,2023-11-28,105,@,CLE,L 105-128,240,35,101,.347,22,57,.386,13,44,.295,22,24,.917,105,50,93,.538,37,57,.649,13,36,.361,15,17,.882,128
1203,CLE,2023-11-26,105,,TOR,W 105-102,240,45,97,.464,35,66,.530,10,31,.323,5,6,.833,105,37,89,.416,29,57,.509,8,32,.250,20,29,.690,102
1204,UTA,2023-11-25,105,,NOP,W 105-100,240,38,87,.437,23,44,.523,15,43,.349,14,17,.824,105,39,93,.419,28,57,.491,11,36,.306,11,18,.611,100
1205,HOU,2023-11-24,105,,DEN,W 105-86,240,40,82,.488,28,53,.528,12,29,.414,13,15,.867,105,32,94,.340,25,64,.391,7,30,.233,15,21,.714,86
1206,UTA,2023-11-22,105,@,POR,L 105-121,240,37,79,.468,27,48,.563,10,31,.323,21,26,.808,105,47,92,.511,30,53,.566,17,39,.436,10,15,.667,121
1207,LAL,2023-11-19,105,,HOU,W 105-104,240,39,83,.470,33,54,.611,6,29,.207,21,29,.724,105,41,84,.488,27,47,.574,14,37,.378,8,10,.800,104
1208,TOR,2023-11-17,105,,BOS,L 105-108,240,42,87,.483,30,54,.556,12,33,.364,9,14,.643,105,42,92,.457,26,46,.565,16,46,.348,8,9,.889,108
1209,CHO,2023-11-14,105,,MIA,L 105-111,240,36,81,.444,21,49,.429,15,32,.469,18,22,.818,105,40,83,.482,32,52,.615,8,31,.258,23,28,.821,111
1210,MEM,2023-11-12,105,@,LAC,W 105-101,240,37,88,.420,24,47,.511,13,41,.317,18,24,.750,105,37,85,.435,25,51,.490,12,34,.353,15,23,.652,101
1211,SAC,2023-11-10,105,,OKC,W 105-98,240,38,91,.418,25,44,.568,13,47,.277,16,21,.762,105,39,87,.448,32,57,.561,7,30,.233,13,16,.813,98
1212,SAS,2023-11-08,105,@,NYK,L 105-126,240,44,90,.489,35,56,.625,9,34,.265,8,13,.615,105,46,100,.460,27,58,.466,19,42,.452,15,22,.682,126
1213,GSW,2023-11-08,105,@,DEN,L 105-108,240,37,86,.430,26,51,.510,11,35,.314,20,26,.769,105,41,92,.446,30,57,.526,11,35,.314,15,22,.682,108
1214,NOP,2023-11-04,105,,ATL,L 105-123,240,40,84,.476,32,53,.604,8,31,.258,17,21,.810,105,45,93,.484,31,52,.596,14,41,.341,19,24,.792,123
1215,NYK,2023-11-03,105,@,MIL,L 105-110,240,38,96,.396,28,57,.491,10,39,.256,19,25,.760,105,35,82,.427,15,43,.349,20,39,.513,20,28,.714,110
1216,MIA,2023-11-01,105,,BRK,L 105-109,240,39,91,.429,26,53,.491,13,38,.342,14,18,.778,105,37,82,.451,21,46,.457,16,36,.444,19,26,.731,109
1217,CHI,2023-11-01,105,@,DAL,L 105-114,240,42,89,.472,31,56,.554,11,33,.333,10,11,.909,105,37,81,.457,17,33,.515,20,48,.417,20,28,.714,114
1218,IND,2023-10-30,105,,CHI,L 105-112,240,36,88,.409,24,42,.571,12,46,.261,21,25,.840,105,40,87,.460,34,70,.486,6,17,.353,26,31,.839,112
1219,CLE,2023-10-27,105,,OKC,L 105-108,240,38,92,.413,26,47,.553,12,45,.267,17,23,.739,105,40,87,.460,27,61,.443,13,26,.500,15,19,.789,108
1220,PHI,2024-02-07,104,,GSW,L 104-127,240,41,98,.418,33,66,.500,8,32,.250,14,14,1.000,104,47,94,.500,31,56,.554,16,38,.421,17,22,.773,127
1221,SAS,2024-02-07,104,@,MIA,L 104-116,240,41,90,.456,29,53,.547,12,37,.324,10,17,.588,104,43,87,.494,31,49,.633,12,38,.316,18,23,.783,116
1222,PHI,2024-01-29,104,@,POR,L 104-130,240,37,83,.446,32,54,.593,5,29,.172,25,28,.893,104,46,84,.548,34,56,.607,12,28,.429,26,29,.897,130
1223,CHI,2024-01-28,104,@,POR,W 104-96,240,42,90,.467,34,58,.586,8,32,.250,12,17,.706,104,32,79,.405,26,46,.565,6,33,.182,26,29,.897,96
1224,OKC,2024-01-28,104,@,DET,L 104-120,240,44,92,.478,36,64,.563,8,28,.286,8,12,.667,104,47,95,.495,36,69,.522,11,26,.423,15,19,.789,120
1225,DET,2024-01-27,104,,WAS,L 104-118,240,37,85,.435,28,53,.528,9,32,.281,21,27,.778,104,45,100,.450,34,66,.515,11,34,.324,17,21,.810,118
1226,HOU,2024-01-27,104,@,BRK,L 104-106,240,37,94,.394,27,57,.474,10,37,.270,20,23,.870,104,36,74,.486,24,40,.600,12,34,.353,22,37,.595,106
1227,CHO,2024-01-26,104,,HOU,L 104-138,240,35,85,.412,26,56,.464,9,29,.310,25,32,.781,104,50,89,.562,37,56,.661,13,33,.394,25,31,.806,138
1228,WAS,2024-01-21,104,,DEN,L 104-113,240,39,91,.429,31,64,.484,8,27,.296,18,22,.818,104,43,88,.489,35,66,.530,8,22,.364,19,28,.679,113
1229,ORL,2024-01-17,104,@,ATL,L 104-106,240,39,88,.443,29,53,.547,10,35,.286,16,22,.727,104,39,76,.513,31,51,.608,8,25,.320,20,22,.909,106
1230,MIA,2024-01-14,104,,CHO,W 104-87,240,40,81,.494,29,56,.518,11,25,.440,13,16,.813,104,33,95,.347,23,54,.426,10,41,.244,11,15,.733,87
1231,WAS,2024-01-10,104,@,IND,L 104-112,240,38,88,.432,31,57,.544,7,31,.226,21,30,.700,104,41,92,.446,33,67,.493,8,25,.320,22,24,.917,112
1232,CHI,2024-01-05,104,,CHO,W 104-91,240,40,74,.541,30,46,.652,10,28,.357,14,17,.824,104,36,89,.404,26,55,.473,10,34,.294,9,12,.750,91
1233,SAC,2024-01-02,104,,CHO,L 104-111,240,40,92,.435,26,56,.464,14,36,.389,10,17,.588,104,42,82,.512,30,48,.625,12,34,.353,15,19,.789,111
1234,MIA,2024-01-01,104,@,LAC,L 104-121,240,35,83,.422,24,49,.490,11,34,.324,23,29,.793,104,47,80,.588,33,51,.647,14,29,.483,13,14,.929,121
1235,BRK,2023-12-29,104,@,WAS,L 104-110,240,39,91,.429,30,63,.476,9,28,.321,17,27,.630,104,46,91,.505,31,53,.585,15,38,.395,3,7,.429,110
1236,CHI,2023-12-28,104,,IND,L 104-120,240,40,97,.412,33,70,.471,7,27,.259,17,22,.773,104,43,85,.506,24,43,.558,19,42,.452,15,22,.682,120
1237,CHO,2023-12-26,104,@,LAC,L 104-113,240,43,93,.462,37,64,.578,6,29,.207,12,16,.750,104,40,85,.471,26,51,.510,14,34,.412,19,25,.760,113
1238,NOP,2023-12-23,104,,HOU,L 104-106,240,38,82,.463,30,51,.588,8,31,.258,20,29,.690,104,35,82,.427,26,53,.491,9,29,.310,27,35,.771,106
1239,CLE,2023-12-21,104,,NOP,L 104-123,240,41,87,.471,24,43,.558,17,44,.386,5,8,.625,104,47,86,.547,32,51,.627,15,35,.429,14,16,.875,123
1240,TOR,2023-12-20,104,,DEN,L 104-113,240,43,90,.478,34,63,.540,9,27,.333,9,13,.692,104,49,98,.500,37,65,.569,12,33,.364,3,7,.429,113
1241,PHO,2023-12-19,104,@,POR,L 104-109,240,42,94,.447,37,71,.521,5,23,.217,15,21,.714,104,39,87,.448,25,59,.424,14,28,.500,17,19,.895,109
1242,PHI,2023-12-18,104,,CHI,L 104-108,240,38,88,.432,27,56,.482,11,32,.344,17,19,.895,104,42,89,.472,30,60,.500,12,29,.414,12,15,.800,108
1243,DAL,2023-12-18,104,@,DEN,L 104-130,240,41,92,.446,28,54,.519,13,38,.342,9,19,.474,104,49,87,.563,35,61,.574,14,26,.538,18,22,.818,130
1244,UTA,2023-12-16,104,@,SAC,L 104-125,240,38,86,.442,26,49,.531,12,37,.324,16,21,.762,104,46,85,.541,24,40,.600,22,45,.489,11,15,.733,125
1245,TOR,2023-12-15,104,,ATL,L 104-125,240,40,77,.519,30,46,.652,10,31,.323,14,25,.560,104,52,101,.515,36,60,.600,16,41,.390,5,6,.833,125
1246,MEM,2023-12-13,104,@,HOU,L 104-117,240,35,82,.427,25,44,.568,10,38,.263,24,34,.706,104,39,86,.453,27,54,.500,12,32,.375,27,37,.730,117
1247,CHO,2023-12-13,104,@,MIA,L 104-115,240,41,77,.532,29,46,.630,12,31,.387,10,11,.909,104,41,86,.477,26,56,.464,15,30,.500,18,19,.947,115
1248,ORL,2023-12-11,104,,CLE,W 104-94,240,39,84,.464,32,58,.552,7,26,.269,19,25,.760,104,30,85,.353,21,45,.467,9,40,.225,25,33,.758,94
1249,LAC,2023-11-27,104,,DEN,L 104-113,240,35,85,.412,29,65,.446,6,20,.300,28,34,.824,104,44,92,.478,34,70,.486,10,22,.455,15,28,.536,113
1250,DAL,2023-11-22,104,@,LAL,W 104-101,240,38,96,.396,22,46,.478,16,50,.320,12,16,.750,104,39,84,.464,28,55,.509,11,29,.379,12,19,.632,101
1251,HOU,2023-11-19,104,@,LAL,L 104-105,240,41,84,.488,27,47,.574,14,37,.378,8,10,.800,104,39,83,.470,33,54,.611,6,29,.207,21,29,.724,105
1252,ORL,2023-11-14,104,@,BRK,L 104-124,240,36,82,.439,20,36,.556,16,46,.348,16,21,.762,104,46,85,.541,27,46,.587,19,39,.487,13,20,.650,124
1253,MIN,2023-11-14,104,@,GSW,W 104-101,240,36,81,.444,22,47,.468,14,34,.412,18,21,.857,104,37,88,.420,24,49,.490,13,39,.333,14,16,.875,101
1254,DEN,2023-11-12,104,@,HOU,L 104-107,240,42,91,.462,33,59,.559,9,32,.281,11,14,.786,104,37,87,.425,27,55,.491,10,32,.313,23,29,.793,107
1255,HOU,2023-11-10,104,,NOP,W 104-101,240,36,88,.409,26,53,.491,10,35,.286,22,28,.786,104,34,75,.453,26,50,.520,8,25,.320,25,34,.735,101
1256,GSW,2023-11-05,104,@,CLE,L 104-115,240,34,94,.362,18,53,.340,16,41,.390,20,30,.667,104,41,83,.494,30,46,.652,11,37,.297,22,28,.786,115
1257,IND,2023-11-01,104,@,BOS,L 104-155,240,46,101,.455,41,64,.641,5,37,.135,7,12,.583,104,54,95,.568,34,60,.567,20,35,.571,27,28,.964,155
1258,UTA,2023-10-28,104,@,PHO,L 104-126,240,40,91,.440,28,54,.519,12,37,.324,12,14,.857,104,45,85,.529,35,48,.729,10,37,.270,26,28,.929,126
1259,CHI,2023-10-27,104,,TOR,W 104-103 (OT),265,37,99,.374,29,60,.483,8,39,.205,22,28,.786,104,39,84,.464,30,48,.625,9,36,.250,16,25,.640,103
1260,MEM,2023-10-27,104,,DEN,L 104-108,240,37,85,.435,27,52,.519,10,33,.303,20,24,.833,104,41,88,.466,27,51,.529,14,37,.378,12,18,.667,108
1261,CHI,2023-10-25,104,,OKC,L 104-124,240,39,94,.415,27,52,.519,12,42,.286,14,18,.778,104,45,82,.549,26,43,.605,19,39,.487,15,18,.833,124
1262,MEM,2023-10-25,104,,NOP,L 104-111,240,38,91,.418,26,48,.542,12,43,.279,16,20,.800,104,40,85,.471,26,53,.491,14,32,.438,17,22,.773,111
1263,NYK,2023-10-25,104,,BOS,L 104-108,240,36,97,.371,18,56,.321,18,41,.439,14,26,.538,104,37,77,.481,25,38,.658,12,39,.308,22,26,.846,108
1264,GSW,2023-10-24,104,,PHO,L 104-108,240,36,101,.356,26,58,.448,10,43,.233,22,28,.786,104,42,95,.442,31,62,.500,11,33,.333,13,17,.765,108
1265,LAC,2024-02-04,103,@,MIA,W 103-95,240,34,77,.442,18,38,.474,16,39,.410,19,22,.864,103,38,91,.418,30,61,.492,8,30,.267,11,12,.917,95
1266,POR,2024-02-04,103,@,DEN,L 103-112,240,39,85,.459,28,54,.519,11,31,.355,14,15,.933,103,42,86,.488,30,58,.517,12,28,.429,16,19,.842,112
1267,UTA,2024-01-30,103,@,NYK,L 103-118,240,39,86,.453,27,50,.540,12,36,.333,13,17,.765,103,44,94,.468,31,60,.517,13,34,.382,17,18,.944,118
1268,SAC,2024-01-29,103,@,MEM,W 103-94,240,43,84,.512,32,46,.696,11,38,.289,6,10,.600,103,30,80,.375,17,44,.386,13,36,.361,21,28,.750,94
1269,BRK,2024-01-23,103,,NYK,L 103-108,240,42,95,.442,27,53,.509,15,42,.357,4,5,.800,103,40,86,.465,30,57,.526,10,29,.345,18,19,.947,108
1270,MEM,2024-01-18,103,@,MIN,L 103-118,240,39,85,.459,25,51,.490,14,34,.412,11,17,.647,103,45,82,.549,33,54,.611,12,28,.429,16,21,.762,118
1271,BRK,2024-01-17,103,@,POR,L 103-105,240,35,73,.479,20,35,.571,15,38,.395,18,27,.667,103,42,86,.488,33,59,.559,9,27,.333,12,14,.857,105
1272,DAL,2024-01-09,103,,MEM,L 103-120,240,36,82,.439,27,55,.491,9,27,.333,22,27,.815,103,44,91,.484,30,54,.556,14,37,.378,18,21,.857,120
1273,LAC,2024-01-07,103,@,LAL,L 103-106,240,36,91,.396,22,54,.407,14,37,.378,17,19,.895,103,42,82,.512,31,53,.585,11,29,.379,11,16,.688,106
1274,POR,2024-01-05,103,@,DAL,L 103-139,240,39,95,.411,26,55,.473,13,40,.325,12,17,.706,103,56,96,.583,39,58,.672,17,38,.447,10,15,.667,139
1275,IND,2023-12-21,103,@,MEM,L 103-116,240,38,90,.422,20,38,.526,18,52,.346,9,11,.818,103,43,84,.512,27,49,.551,16,35,.457,14,21,.667,116
1276,HOU,2023-12-15,103,@,MEM,W 103-96,240,32,88,.364,21,59,.356,11,29,.379,28,32,.875,103,37,92,.402,26,52,.500,11,40,.275,11,15,.733,96
1277,MEM,2023-12-08,103,,MIN,L 103-127,240,37,86,.430,22,51,.431,15,35,.429,14,19,.737,103,44,88,.500,29,50,.580,15,38,.395,24,26,.923,127
1278,UTA,2023-12-08,103,,LAC,L 103-117,240,38,84,.452,29,53,.547,9,31,.290,18,24,.750,103,43,88,.489,28,54,.519,15,34,.441,16,21,.762,117
1279,TOR,2023-12-06,103,,MIA,L 103-112,240,37,86,.430,23,49,.469,14,37,.378,15,17,.882,103,41,89,.461,27,51,.529,14,38,.368,16,19,.842,112
1280,PHO,2023-12-05,103,@,LAL,L 103-106,240,37,75,.493,25,50,.500,12,25,.480,17,21,.810,103,38,102,.373,29,72,.403,9,30,.300,21,25,.840,106
1281,POR,2023-11-30,103,@,CLE,W 103-95,240,39,77,.506,25,42,.595,14,35,.400,11,11,1.000,103,38,89,.427,31,57,.544,7,32,.219,12,12,1.000,95
1282,TOR,2023-11-28,103,@,BRK,L 103-115,240,39,101,.386,26,65,.400,13,36,.361,12,19,.632,103,40,89,.449,27,51,.529,13,38,.342,22,26,.846,115
1283,OKC,2023-11-28,103,@,MIN,L 103-106,240,37,90,.411,26,60,.433,11,30,.367,18,23,.783,103,33,78,.423,19,45,.422,14,33,.424,26,32,.813,106
1284,ATL,2023-11-26,103,@,BOS,L 103-113,240,36,88,.409,17,35,.486,19,53,.358,12,19,.632,103,42,95,.442,29,48,.604,13,47,.277,16,20,.800,113
1285,DET,2023-11-20,103,,DEN,L 103-107,240,36,81,.444,29,60,.483,7,21,.333,24,26,.923,103,40,87,.460,29,59,.492,11,28,.393,16,21,.762,107
1286,ORL,2023-11-17,103,@,CHI,W 103-97,240,38,79,.481,27,45,.600,11,34,.324,16,23,.696,103,35,79,.443,25,50,.500,10,29,.345,17,22,.773,97
1287,BOS,2023-11-08,103,@,PHI,L 103-106,240,36,91,.396,21,44,.477,15,47,.319,16,19,.842,103,42,95,.442,33,61,.541,9,34,.265,13,15,.867,106
1288,ORL,2023-10-30,103,@,LAL,L 103-106,240,38,95,.400,24,60,.400,14,35,.400,13,18,.722,103,42,79,.532,34,52,.654,8,27,.296,14,18,.778,106
1289,TOR,2023-10-27,103,@,CHI,L 103-104 (OT),265,39,84,.464,30,48,.625,9,36,.250,16,25,.640,103,37,99,.374,29,60,.483,8,39,.205,22,28,.786,104
1290,MIA,2023-10-25,103,,DET,W 103-102,240,37,92,.402,29,70,.414,8,22,.364,21,26,.808,103,41,92,.446,30,60,.500,11,32,.344,9,15,.600,102
1291,PHI,2024-02-05,102,,DAL,L 102-118,240,40,93,.430,32,64,.500,8,29,.276,14,20,.700,102,42,87,.483,25,44,.568,17,43,.395,17,23,.739,118
1292,WAS,2024-02-02,102,,MIA,L 102-110,240,37,90,.411,26,48,.542,11,42,.262,17,21,.810,102,38,88,.432,31,57,.544,7,31,.226,27,35,.771,110
1293,OKC,2024-01-20,102,@,MIN,W 102-97,240,32,81,.395,24,57,.421,8,24,.333,30,35,.857,102,31,75,.413,17,38,.447,14,37,.378,21,29,.724,97
1294,DEN,2024-01-19,102,@,BOS,W 102-100,240,42,81,.519,34,50,.680,8,31,.258,10,13,.769,102,38,89,.427,24,45,.533,14,44,.318,10,14,.714,100
1295,BRK,2024-01-11,102,@,CLE,L 102-111,240,37,82,.451,29,55,.527,8,27,.296,20,28,.714,102,32,82,.390,19,38,.500,13,44,.295,34,43,.791,111
1296,BOS,2024-01-11,102,@,MIL,L 102-135,240,34,91,.374,25,56,.446,9,35,.257,25,30,.833,102,52,92,.565,34,50,.680,18,42,.429,13,16,.813,135
1297,GSW,2023-12-28,102,,MIA,L 102-114,240,37,88,.420,29,55,.527,8,33,.242,20,25,.800,102,44,91,.484,34,60,.567,10,31,.323,16,22,.727,114
1298,WAS,2023-12-27,102,,TOR,L 102-132,240,42,90,.467,34,57,.596,8,33,.242,10,15,.667,102,52,91,.571,37,53,.698,15,38,.395,13,19,.684,132
1299,DEN,2023-12-23,102,@,CHO,W 102-95,240,39,90,.433,27,60,.450,12,30,.400,12,14,.857,102,34,88,.386,26,60,.433,8,28,.286,19,23,.826,95
1300,BRK,2023-12-20,102,,NYK,L 102-121,240,37,101,.366,22,54,.407,15,47,.319,13,17,.765,102,44,95,.463,31,62,.500,13,33,.394,20,25,.800,121
1301,DET,2023-12-06,102,,MEM,L 102-116,240,41,91,.451,30,56,.536,11,35,.314,9,9,1.000,102,47,91,.516,36,65,.554,11,26,.423,11,14,.786,116
1302,MIN,2023-12-06,102,,SAS,W 102-94,240,36,87,.414,24,47,.511,12,40,.300,18,21,.857,102,38,101,.376,30,65,.462,8,36,.222,10,15,.667,94
1303,DEN,2023-12-06,102,@,LAC,L 102-111,240,41,98,.418,29,67,.433,12,31,.387,8,9,.889,102,40,87,.460,28,60,.467,12,27,.444,19,25,.760,111
1304,TOR,2023-11-26,102,@,CLE,L 102-105,240,37,89,.416,29,57,.509,8,32,.250,20,29,.690,102,45,97,.464,35,66,.530,10,31,.323,5,6,.833,105
1305,POR,2023-11-26,102,@,MIL,L 102-108,240,37,91,.407,24,59,.407,13,32,.406,15,20,.750,102,35,89,.393,21,47,.447,14,42,.333,24,32,.750,108
1306,SAS,2023-11-22,102,,LAC,L 102-109,240,35,91,.385,24,53,.453,11,38,.289,21,23,.913,102,39,85,.459,30,57,.526,9,28,.321,22,29,.759,109
1307,CHI,2023-11-22,102,@,OKC,L 102-116,240,34,88,.386,17,44,.386,17,44,.386,17,17,1.000,102,37,75,.493,26,46,.565,11,29,.379,31,38,.816,116
1308,BOS,2023-11-19,102,@,MEM,W 102-100,240,35,77,.455,23,46,.500,12,31,.387,20,25,.800,102,37,95,.389,20,51,.392,17,44,.386,9,10,.900,100
1309,CHI,2023-11-18,102,,MIA,W 102-97,240,36,81,.444,20,36,.556,16,45,.356,14,19,.737,102,33,77,.429,21,41,.512,12,36,.333,19,23,.826,97
1310,BRK,2023-11-12,102,,WAS,W 102-94,240,37,98,.378,25,49,.510,12,49,.245,16,20,.800,102,33,88,.375,23,47,.489,10,41,.244,18,25,.720,94
1311,MEM,2023-11-08,102,,MIA,L 102-108,240,35,90,.389,24,53,.453,11,37,.297,21,28,.750,102,35,77,.455,24,49,.490,11,28,.393,27,32,.844,108
1312,ORL,2023-11-06,102,,DAL,L 102-117,240,40,85,.471,32,58,.552,8,27,.296,14,18,.778,102,41,82,.500,26,42,.619,15,40,.375,20,28,.714,117
1313,GSW,2023-11-01,102,,SAC,W 102-101,240,39,81,.481,28,50,.560,11,31,.355,13,15,.867,102,36,88,.409,25,53,.472,11,35,.314,18,23,.783,101
1314,ORL,2023-10-31,102,@,LAC,L 102-118,240,38,81,.469,31,51,.608,7,30,.233,19,33,.576,102,44,89,.494,30,58,.517,14,31,.452,16,23,.696,118
1315,NOP,2023-10-30,102,,GSW,L 102-130,240,38,93,.409,28,54,.519,10,39,.256,16,26,.615,102,51,98,.520,36,57,.632,15,41,.366,13,20,.650,130
1316,UTA,2023-10-30,102,@,DEN,L 102-110,240,42,98,.429,31,61,.508,11,37,.297,7,15,.467,102,47,84,.560,38,56,.679,9,28,.321,7,17,.412,110
1317,CHI,2023-10-28,102,@,DET,L 102-118,240,39,93,.419,28,65,.431,11,28,.393,13,16,.813,102,45,86,.523,33,58,.569,12,28,.429,16,20,.800,118
1318,ORL,2023-10-27,102,@,POR,W 102-97,240,36,79,.456,27,51,.529,9,28,.321,21,32,.656,102,35,88,.398,26,56,.464,9,32,.281,18,21,.857,97
1319,DET,2023-10-25,102,@,MIA,L 102-103,240,41,92,.446,30,60,.500,11,32,.344,9,15,.600,102,37,92,.402,29,70,.414,8,22,.364,21,26,.808,103
1320,SAS,2024-02-03,101,,CLE,L 101-117,240,36,98,.367,24,58,.414,12,40,.300,17,21,.810,101,46,97,.474,33,53,.623,13,44,.295,12,13,.923,117
1321,MEM,2024-02-02,101,,GSW,L 101-121,240,35,87,.402,21,41,.512,14,46,.304,17,24,.708,101,46,83,.554,35,54,.648,11,29,.379,18,22,.818,121
1322,MEM,2024-02-01,101,,CLE,L 101-108,240,37,90,.411,25,52,.481,12,38,.316,15,17,.882,101,41,86,.477,27,51,.529,14,35,.400,12,18,.667,108
1323,OKC,2024-01-29,101,,MIN,L 101-107,240,35,79,.443,21,44,.477,14,35,.400,17,22,.773,101,40,83,.482,26,54,.481,14,29,.483,13,15,.867,107
1324,IND,2024-01-06,101,,BOS,L 101-118,240,38,92,.413,30,50,.600,8,42,.190,17,22,.773,101,46,90,.511,30,49,.612,16,41,.390,10,19,.526,118
1325,WAS,2024-01-03,101,@,CLE,L 101-140,240,42,101,.416,30,66,.455,12,35,.343,5,11,.455,101,54,101,.535,34,59,.576,20,42,.476,12,16,.750,140
1326,BRK,2024-01-03,101,@,HOU,L 101-112,240,36,93,.387,23,49,.469,13,44,.295,16,26,.615,101,37,76,.487,18,37,.486,19,39,.487,19,27,.704,112
1327,SAS,2023-12-31,101,,BOS,L 101-134,240,40,94,.426,28,49,.571,12,45,.267,9,12,.750,101,51,95,.537,36,53,.679,15,42,.357,17,22,.773,134
1328,BRK,2023-12-14,101,@,DEN,L 101-124,240,39,95,.411,31,65,.477,8,30,.267,15,20,.750,101,47,99,.475,35,63,.556,12,36,.333,18,21,.857,124
1329,DAL,2023-12-14,101,,MIN,L 101-119,240,39,83,.470,32,51,.627,7,32,.219,16,18,.889,101,44,88,.500,30,57,.526,14,31,.452,17,25,.680,119
1330,WAS,2023-12-11,101,@,PHI,L 101-146,240,36,85,.424,27,54,.500,9,31,.290,20,31,.645,101,52,95,.547,32,49,.653,20,46,.435,22,25,.880,146
1331,OKC,2023-12-06,101,@,HOU,L 101-110,240,37,87,.425,29,58,.500,8,29,.276,19,24,.792,101,40,83,.482,25,50,.500,15,33,.455,15,22,.682,110
1332,DET,2023-12-02,101,,CLE,L 101-110,240,39,83,.470,31,53,.585,8,30,.267,15,23,.652,101,44,89,.494,34,59,.576,10,30,.333,12,18,.667,110
1333,ORL,2023-12-02,101,@,BRK,L 101-129,240,35,88,.398,26,59,.441,9,29,.310,22,27,.815,101,46,91,.505,32,57,.561,14,34,.412,23,31,.742,129
1334,MIN,2023-11-30,101,,UTA,W 101-90,240,39,89,.438,26,54,.481,13,35,.371,10,13,.769,101,33,87,.379,22,53,.415,11,34,.324,13,14,.929,90
1335,LAL,2023-11-22,101,,DAL,L 101-104,240,39,84,.464,28,55,.509,11,29,.379,12,19,.632,101,38,96,.396,22,46,.478,16,50,.320,12,16,.750,104
1336,GSW,2023-11-14,101,,MIN,L 101-104,240,37,88,.420,24,49,.490,13,39,.333,14,16,.875,101,36,81,.444,22,47,.468,14,34,.412,18,21,.857,104
1337,LAC,2023-11-12,101,,MEM,L 101-105,240,37,85,.435,25,51,.490,12,34,.353,15,23,.652,101,37,88,.420,24,47,.511,13,41,.317,18,24,.750,105
1338,NOP,2023-11-10,101,@,HOU,L 101-104,240,34,75,.453,26,50,.520,8,25,.320,25,34,.735,101,36,88,.409,26,53,.491,10,35,.286,22,28,.786,104
1339,NOP,2023-11-08,101,@,MIN,L 101-122,240,36,93,.387,28,65,.431,8,28,.286,21,22,.955,101,45,82,.549,30,45,.667,15,37,.405,17,24,.708,122
1340,CHI,2023-11-04,101,@,DEN,L 101-123,240,39,86,.453,32,60,.533,7,26,.269,16,23,.696,101,42,81,.519,26,45,.578,16,36,.444,23,30,.767,123
1341,LAL,2023-11-04,101,@,ORL,L 101-120,240,37,84,.440,29,54,.537,8,30,.267,19,21,.905,101,46,101,.455,34,68,.500,12,33,.364,16,19,.842,120
1342,DET,2023-11-01,101,,POR,L 101-110,240,40,90,.444,29,61,.475,11,29,.379,10,11,.909,101,38,81,.469,31,61,.508,7,20,.350,27,33,.818,110
1343,SAC,2023-11-01,101,@,GSW,L 101-102,240,36,88,.409,25,53,.472,11,35,.314,18,23,.783,101,39,81,.481,28,50,.560,11,31,.355,13,15,.867,102
1344,TOR,2024-02-05,100,@,NOP,L 100-138,240,40,84,.476,30,53,.566,10,31,.323,10,15,.667,100,53,104,.510,34,59,.576,19,45,.422,13,13,1.000,138
1345,DEN,2024-01-31,100,@,OKC,L 100-105,240,37,93,.398,22,56,.393,15,37,.405,11,16,.688,100,37,87,.425,26,61,.426,11,26,.423,20,25,.800,105
1346,MIL,2024-01-26,100,,CLE,L 100-112,240,35,87,.402,22,53,.415,13,34,.382,17,24,.708,100,38,92,.413,24,56,.429,14,36,.389,22,31,.710,112
1347,POR,2024-01-26,100,@,SAS,L 100-116,240,38,90,.422,28,53,.528,10,37,.270,14,19,.737,100,42,92,.457,32,58,.552,10,34,.294,22,26,.846,116
1348,TOR,2024-01-22,100,,MEM,L 100-108,240,35,79,.443,27,56,.482,8,23,.348,22,23,.957,100,44,95,.463,31,61,.508,13,34,.382,7,12,.583,108
1349,TOR,2024-01-20,100,@,NYK,L 100-126,240,38,92,.413,27,58,.466,11,34,.324,13,23,.565,100,48,88,.545,34,49,.694,14,39,.359,16,20,.800,126
1350,BOS,2024-01-19,100,,DEN,L 100-102,240,38,89,.427,24,45,.533,14,44,.318,10,14,.714,100,42,81,.519,34,50,.680,8,31,.258,10,13,.769,102
1351,ORL,2024-01-13,100,@,OKC,L 100-112,240,39,84,.464,32,49,.653,7,35,.200,15,24,.625,100,43,94,.457,35,58,.603,8,36,.222,18,21,.857,112
1352,SAC,2024-01-07,100,,NOP,L 100-133,240,38,91,.418,23,46,.500,15,45,.333,9,12,.750,100,50,82,.610,31,47,.660,19,35,.543,14,16,.875,133
1353,CHI,2024-01-03,100,@,NYK,L 100-116,240,37,89,.416,24,57,.421,13,32,.406,13,16,.813,100,46,89,.517,31,51,.608,15,38,.395,9,11,.818,116
1354,CHO,2023-12-06,100,@,CHI,L 100-111,240,39,90,.433,29,53,.547,10,37,.270,12,12,1.000,100,38,90,.422,26,65,.400,12,25,.480,23,29,.793,111
1355,NOP,2023-11-25,100,@,UTA,L 100-105,240,39,93,.419,28,57,.491,11,36,.306,11,18,.611,100,38,87,.437,23,44,.523,15,43,.349,14,17,.824,105
1356,NYK,2023-11-24,100,,MIA,W 100-98,240,39,81,.481,29,52,.558,10,29,.345,12,18,.667,100,34,87,.391,24,50,.480,10,37,.270,20,21,.952,98
1357,CHI,2023-11-20,100,,MIA,L 100-118,240,37,81,.457,26,44,.591,11,37,.297,15,16,.938,100,42,84,.500,25,49,.510,17,35,.486,17,20,.850,118
1358,NYK,2023-11-20,100,@,MIN,L 100-117,240,32,92,.348,23,54,.426,9,38,.237,27,34,.794,100,41,80,.513,30,46,.652,11,34,.324,24,32,.750,117
1359,MEM,2023-11-19,100,,BOS,L 100-102,240,37,95,.389,20,51,.392,17,44,.386,9,10,.900,100,35,77,.455,23,46,.500,12,31,.387,20,25,.800,102
1360,DET,2023-11-17,100,@,CLE,L 100-108,240,39,91,.429,30,56,.536,9,35,.257,13,15,.867,100,42,82,.512,33,61,.541,9,21,.429,15,21,.714,108
1361,HOU,2023-11-17,100,@,LAC,L 100-106,240,38,88,.432,28,57,.491,10,31,.323,14,20,.700,100,36,83,.434,23,49,.469,13,34,.382,21,30,.700,106
1362,BRK,2023-11-08,100,,LAC,W 100-93,240,37,92,.402,22,51,.431,15,41,.366,11,13,.846,100,36,91,.396,28,55,.509,8,36,.222,13,13,1.000,93
1363,POR,2023-11-05,100,,MEM,L 100-112,240,37,95,.389,23,50,.460,14,45,.311,12,15,.800,100,45,89,.506,32,57,.561,13,32,.406,9,13,.692,112
1364,PHO,2023-11-04,100,@,PHI,L 100-112,240,32,89,.360,23,54,.426,9,35,.257,27,33,.818,100,43,90,.478,32,60,.533,11,30,.367,15,18,.833,112
1365,LAL,2023-10-26,100,,PHO,W 100-95,240,36,84,.429,31,55,.564,5,29,.172,23,29,.793,100,34,81,.420,25,50,.500,9,31,.290,18,23,.783,95
1366,DET,2024-02-04,99,,ORL,L 99-111,240,36,80,.450,28,49,.571,8,31,.258,19,22,.864,99,45,84,.536,35,60,.583,10,24,.417,11,15,.733,111
1367,CHO,2024-02-04,99,,IND,L 99-115,240,35,88,.398,27,59,.458,8,29,.276,21,25,.840,99,45,92,.489,34,59,.576,11,33,.333,14,18,.778,115
1368,HOU,2024-01-31,99,,NOP,L 99-110,240,35,87,.402,22,43,.512,13,44,.295,16,17,.941,99,41,82,.500,30,48,.625,11,34,.324,17,24,.708,110
1369,ORL,2024-01-22,99,,CLE,L 99-126,240,34,74,.459,23,45,.511,11,29,.379,20,30,.667,99,45,80,.563,25,42,.595,20,38,.526,16,22,.727,126
1370,SAS,2024-01-15,99,@,ATL,L 99-109,240,38,95,.400,27,53,.509,11,42,.262,12,17,.706,99,40,93,.430,27,55,.491,13,38,.342,16,21,.762,109
1371,ATL,2024-01-13,99,,WAS,L 99-127,240,32,93,.344,21,53,.396,11,40,.275,24,33,.727,99,47,97,.485,35,65,.538,12,32,.375,21,26,.808,127
1372,MIA,2024-01-12,99,,ORL,W 99-96,240,37,83,.446,29,57,.509,8,26,.308,17,20,.850,99,36,82,.439,24,42,.571,12,40,.300,12,20,.600,96
1373,CHO,2024-01-12,99,@,SAS,L 99-135,240,32,89,.360,22,55,.400,10,34,.294,25,28,.893,99,45,87,.517,27,49,.551,18,38,.474,27,34,.794,135
1374,CHO,2023-12-18,99,@,TOR,L 99-114,240,39,89,.438,31,57,.544,8,32,.250,13,13,1.000,99,44,86,.512,36,57,.632,8,29,.276,18,22,.818,114
1375,SAC,2023-12-12,99,@,LAC,L 99-119,240,36,86,.419,26,49,.531,10,37,.270,17,24,.708,99,44,84,.524,33,55,.600,11,29,.379,20,21,.952,119
1376,MIA,2023-12-08,99,,CLE,L 99-111,240,37,86,.430,22,44,.500,15,42,.357,10,15,.667,99,40,87,.460,26,49,.531,14,38,.368,17,26,.654,111
1377,PHI,2023-11-22,99,@,MIN,L 99-112,240,34,87,.391,27,55,.491,7,32,.219,24,30,.800,99,43,89,.483,33,63,.524,10,26,.385,16,24,.667,112
1378,UTA,2023-11-21,99,@,LAL,L 99-131,240,38,98,.388,27,54,.500,11,44,.250,12,16,.750,99,49,86,.570,38,57,.667,11,29,.379,22,27,.815,131
1379,SAS,2023-11-20,99,,LAC,L 99-124,240,39,90,.433,29,52,.558,10,38,.263,11,14,.786,99,45,95,.474,33,59,.559,12,36,.333,22,25,.880,124
1380,BRK,2023-11-19,99,,PHI,L 99-121,240,38,81,.469,27,53,.509,11,28,.393,12,16,.750,99,44,94,.468,28,59,.475,16,35,.457,17,18,.944,121
1381,CHO,2023-11-17,99,,MIL,L 99-130,240,37,91,.407,31,65,.477,6,26,.231,19,22,.864,99,49,89,.551,27,44,.614,22,45,.489,10,13,.769,130
1382,WAS,2023-11-17,99,,NYK,L 99-120,240,37,82,.451,27,50,.540,10,32,.313,15,16,.938,99,45,91,.495,29,53,.547,16,38,.421,14,20,.700,120
1383,POR,2023-11-14,99,@,UTA,L 99-115,240,37,88,.420,26,53,.491,11,35,.314,14,20,.700,99,44,95,.463,31,52,.596,13,43,.302,14,15,.933,115
1384,PHO,2023-11-12,99,,OKC,L 99-111,240,32,83,.386,23,54,.426,9,29,.310,26,31,.839,99,40,82,.488,30,55,.545,10,27,.370,21,25,.840,111
1385,TOR,2023-11-02,99,@,PHI,L 99-114,240,38,79,.481,28,51,.549,10,28,.357,13,19,.684,99,42,92,.457,33,67,.493,9,25,.360,21,25,.840,114
1386,POR,2023-10-30,99,@,TOR,W 99-91,240,38,85,.447,27,50,.540,11,35,.314,12,15,.800,99,38,94,.404,34,65,.523,4,29,.138,11,15,.733,91
1387,CHO,2023-10-27,99,,DET,L 99-111,240,33,88,.375,26,60,.433,7,28,.250,26,34,.765,99,40,88,.455,30,58,.517,10,30,.333,21,25,.840,111
1388,BRK,2024-02-05,98,,GSW,L 98-109,240,34,89,.382,21,47,.447,13,42,.310,17,22,.773,98,43,93,.462,39,71,.549,4,22,.182,19,23,.826,109
1389,SAS,2024-01-31,98,,ORL,L 98-108,240,36,80,.450,27,49,.551,9,31,.290,17,24,.708,98,41,86,.477,34,66,.515,7,20,.350,19,23,.826,108
1390,PHO,2024-01-28,98,@,ORL,L 98-113,240,41,73,.562,37,59,.627,4,14,.286,12,21,.571,98,41,92,.446,29,56,.518,12,36,.333,19,26,.731,113
1391,SAS,2024-01-17,98,@,BOS,L 98-117,240,39,93,.419,32,59,.542,7,34,.206,13,16,.813,98,42,90,.467,24,52,.462,18,38,.474,15,19,.789,117
1392,ORL,2024-01-15,98,@,NYK,W 98-94,240,38,85,.447,30,56,.536,8,29,.276,14,21,.667,98,33,83,.398,20,43,.465,13,40,.325,15,22,.682,94
1393,CHO,2024-01-10,98,,SAC,L 98-123,240,35,87,.402,19,49,.388,16,38,.421,12,16,.750,98,46,89,.517,33,54,.611,13,35,.371,18,23,.783,123
1394,SAS,2024-01-02,98,@,MEM,L 98-106,240,36,85,.424,26,54,.481,10,31,.323,16,23,.696,98,37,80,.463,25,42,.595,12,38,.316,20,25,.800,106
1395,SAC,2023-12-23,98,,MIN,L 98-110,240,37,85,.435,29,52,.558,8,33,.242,16,21,.762,98,44,87,.506,34,54,.630,10,33,.303,12,14,.857,110
1396,MIA,2023-11-24,98,@,NYK,L 98-100,240,34,87,.391,24,50,.480,10,37,.270,20,21,.952,98,39,81,.481,29,52,.558,10,29,.345,12,18,.667,100
1397,NYK,2023-11-13,98,@,BOS,L 98-114,240,33,79,.418,18,44,.409,15,35,.429,17,24,.708,98,40,79,.506,21,36,.583,19,43,.442,15,16,.938,114
1398,OKC,2023-11-10,98,@,SAC,L 98-105,240,39,87,.448,32,57,.561,7,30,.233,13,16,.813,98,38,91,.418,25,44,.568,13,47,.277,16,21,.762,105
1399,POR,2023-10-29,98,@,PHI,L 98-126,240,36,94,.383,29,63,.460,7,31,.226,19,22,.864,98,40,82,.488,29,54,.537,11,28,.393,35,40,.875,126
1400,MIN,2024-01-20,97,,OKC,L 97-102,240,31,75,.413,17,38,.447,14,37,.378,21,29,.724,97,32,81,.395,24,57,.421,8,24,.333,30,35,.857,102
1401,PHI,2024-01-20,97,@,CHO,W 97-89,240,36,85,.424,31,60,.517,5,25,.200,20,24,.833,97,35,85,.412,26,48,.542,9,37,.243,10,14,.714,89
1402,MIA,2024-01-17,97,@,TOR,L 97-121,240,41,90,.456,35,62,.565,6,28,.214,9,12,.750,97,45,88,.511,25,50,.500,20,38,.526,11,18,.611,121
1403,UTA,2024-01-05,97,@,BOS,L 97-126,240,34,94,.362,28,60,.467,6,34,.176,23,34,.676,97,39,90,.433,22,41,.537,17,49,.347,31,36,.861,126
1404,MIA,2024-01-05,97,@,PHO,L 97-113,240,34,83,.410,24,46,.522,10,37,.270,19,22,.864,97,44,87,.506,30,52,.577,14,35,.400,11,17,.647,113
1405,POR,2024-01-03,97,@,DAL,L 97-126,240,34,87,.391,21,47,.447,13,40,.325,16,22,.727,97,42,84,.500,29,54,.537,13,30,.433,29,41,.707,126
1406,CHI,2024-01-02,97,@,PHI,L 97-110,240,37,96,.385,30,59,.508,7,37,.189,16,23,.696,97,38,80,.475,26,50,.520,12,30,.400,22,30,.733,110
1407,MEM,2023-12-18,97,@,OKC,L 97-116,240,30,85,.353,11,31,.355,19,54,.352,18,21,.857,97,42,92,.457,31,56,.554,11,36,.306,21,23,.913,116
1408,ORL,2023-12-17,97,@,BOS,L 97-114,240,34,89,.382,23,53,.434,11,36,.306,18,24,.750,97,45,95,.474,28,59,.475,17,36,.472,7,8,.875,114
1409,WAS,2023-12-08,97,@,BRK,L 97-124,240,38,91,.418,32,58,.552,6,33,.182,15,21,.714,97,50,104,.481,40,71,.563,10,33,.303,14,18,.778,124
1410,UTA,2023-12-06,97,@,DAL,L 97-147,240,35,87,.402,23,54,.426,12,33,.364,15,18,.833,97,56,101,.554,34,52,.654,22,49,.449,13,19,.684,147
1411,HOU,2023-12-02,97,@,LAL,L 97-107,240,36,89,.404,25,58,.431,11,31,.355,14,18,.778,97,40,89,.449,32,62,.516,8,27,.296,19,27,.704,107
1412,CHI,2023-11-28,97,@,BOS,L 97-124,240,39,90,.433,30,62,.484,9,28,.321,10,18,.556,97,47,90,.522,26,41,.634,21,49,.429,9,12,.750,124
1413,MEM,2023-11-26,97,,MIN,L 97-119,240,34,88,.386,24,51,.471,10,37,.270,19,27,.704,97,43,81,.531,28,47,.596,15,34,.441,18,23,.783,119
1414,MIA,2023-11-25,97,@,BRK,L 97-112,240,38,87,.437,27,53,.509,11,34,.324,10,13,.769,97,39,78,.500,25,42,.595,14,36,.389,20,23,.870,112
1415,MIA,2023-11-18,97,@,CHI,L 97-102,240,33,77,.429,21,41,.512,12,36,.333,19,23,.826,97,36,81,.444,20,36,.556,16,45,.356,14,19,.737,102
1416,CHI,2023-11-17,97,,ORL,L 97-103,240,35,79,.443,25,50,.500,10,29,.345,17,22,.773,97,38,79,.481,27,45,.600,11,34,.324,16,23,.696,103
1417,MIL,2023-11-11,97,@,ORL,L 97-112,240,38,77,.494,29,48,.604,9,29,.310,12,25,.480,97,36,84,.429,26,58,.448,10,26,.385,30,35,.857,112
1418,SAC,2023-11-06,97,@,HOU,L 97-122,240,36,81,.444,22,41,.537,14,40,.350,11,20,.550,97,43,75,.573,28,44,.636,15,31,.484,21,27,.778,122
1419,LAC,2023-11-06,97,@,NYK,L 97-111,240,36,73,.493,25,41,.610,11,32,.344,14,16,.875,97,41,88,.466,29,57,.509,12,31,.387,17,18,.944,111
1420,POR,2023-10-27,97,,ORL,L 97-102,240,35,88,.398,26,56,.464,9,32,.281,18,21,.857,97,36,79,.456,27,51,.529,9,28,.321,21,32,.656,102
1421,TOR,2023-10-25,97,,MIN,W 97-94,240,36,90,.400,22,55,.400,14,35,.400,11,16,.688,97,34,100,.340,26,69,.377,8,31,.258,18,22,.818,94
1422,POR,2024-01-28,96,,CHI,L 96-104,240,32,79,.405,26,46,.565,6,33,.182,26,29,.897,96,42,90,.467,34,58,.586,8,32,.250,12,17,.706,104
1423,BOS,2024-01-27,96,,LAC,L 96-115,240,36,100,.360,26,60,.433,10,40,.250,14,16,.875,96,45,102,.441,35,62,.565,10,40,.250,15,18,.833,115
1424,MIN,2024-01-25,96,@,BRK,W 96-94,240,37,75,.493,27,54,.500,10,21,.476,12,16,.750,96,35,77,.455,25,44,.568,10,33,.303,14,16,.875,94
1425,MIA,2024-01-24,96,,MEM,L 96-105,240,33,82,.402,22,48,.458,11,34,.324,19,25,.760,96,36,80,.450,19,44,.432,17,36,.472,16,19,.842,105
1426,MEM,2024-01-20,96,@,CHI,L 96-125,240,32,75,.427,19,33,.576,13,42,.310,19,23,.826,96,47,91,.516,33,58,.569,14,33,.424,17,21,.810,125
1427,MIA,2024-01-15,96,@,BRK,W 96-95 (OT),265,33,87,.379,25,56,.446,8,31,.258,22,25,.880,96,34,99,.343,22,44,.500,12,55,.218,15,16,.938,95
1428,TOR,2024-01-15,96,,BOS,L 96-105,240,38,95,.400,34,63,.540,4,32,.125,16,21,.762,96,33,82,.402,17,43,.395,16,39,.410,23,25,.920,105
1429,ORL,2024-01-12,96,@,MIA,L 96-99,240,36,82,.439,24,42,.571,12,40,.300,12,20,.600,96,37,83,.446,29,57,.509,8,26,.308,17,20,.850,99
1430,LAL,2024-01-03,96,,MIA,L 96-110,240,35,83,.422,31,53,.585,4,30,.133,22,24,.917,96,41,93,.441,25,51,.490,16,42,.381,12,17,.706,110
1431,DAL,2023-12-22,96,@,HOU,L 96-122,240,35,101,.347,28,61,.459,7,40,.175,19,26,.731,96,46,95,.484,35,57,.614,11,38,.289,19,23,.826,122
1432,MEM,2023-12-15,96,,HOU,L 96-103,240,37,92,.402,26,52,.500,11,40,.275,11,15,.733,96,32,88,.364,21,59,.356,11,29,.379,28,32,.875,103
1433,BOS,2023-11-24,96,@,ORL,L 96-113,240,31,76,.408,24,47,.511,7,29,.241,27,37,.730,96,43,85,.506,32,57,.561,11,28,.393,16,22,.727,113
1434,CLE,2023-11-22,96,,MIA,L 96-129,240,36,77,.468,22,47,.468,14,30,.467,10,14,.714,96,46,88,.523,26,53,.491,20,35,.571,17,21,.810,129
1435,ORL,2023-11-15,96,@,CHI,W 96-94,240,32,82,.390,24,54,.444,8,28,.286,24,30,.800,96,33,83,.398,24,50,.480,9,33,.273,19,22,.864,94
1436,NOP,2023-10-28,96,,NYK,W 96-87,240,40,87,.460,31,54,.574,9,33,.273,7,16,.438,96,33,90,.367,26,53,.491,7,37,.189,14,18,.778,87
1437,ORL,2024-02-06,95,@,MIA,L 95-121,240,35,80,.438,25,45,.556,10,35,.286,15,21,.714,95,47,87,.540,34,51,.667,13,36,.361,14,18,.778,121
1438,MIA,2024-02-04,95,,LAC,L 95-103,240,38,91,.418,30,61,.492,8,30,.267,11,12,.917,95,34,77,.442,18,38,.474,16,39,.410,19,22,.864,103
1439,ATL,2024-01-20,95,,CLE,L 95-116,240,37,93,.398,26,55,.473,11,38,.289,10,15,.667,95,43,85,.506,27,42,.643,16,43,.372,14,16,.875,116
1440,MIL,2024-01-17,95,@,CLE,L 95-135,240,38,95,.400,26,53,.491,12,42,.286,7,10,.700,95,55,93,.591,43,65,.662,12,28,.429,13,19,.684,135
1441,BRK,2024-01-15,95,,MIA,L 95-96 (OT),265,34,99,.343,22,44,.500,12,55,.218,15,16,.938,95,33,87,.379,25,56,.446,8,31,.258,22,25,.880,96
1442,NOP,2024-01-05,95,,LAC,L 95-111,240,33,92,.359,21,63,.333,12,29,.414,17,23,.739,95,40,82,.488,25,46,.543,15,36,.417,16,20,.800,111
1443,HOU,2024-01-05,95,,MIN,L 95-122,240,36,90,.400,24,58,.414,12,32,.375,11,15,.733,95,46,88,.523,32,55,.582,14,33,.424,16,20,.800,122
1444,CHO,2023-12-23,95,,DEN,L 95-102,240,34,88,.386,26,60,.433,8,28,.286,19,23,.826,95,39,90,.433,27,60,.450,12,30,.400,12,14,.857,102
1445,CHI,2023-12-23,95,,CLE,L 95-109,240,35,80,.438,27,45,.600,8,35,.229,17,19,.895,95,39,88,.443,27,43,.628,12,45,.267,19,26,.731,109
1446,SAS,2023-12-21,95,@,CHI,L 95-114,240,37,81,.457,27,51,.529,10,30,.333,11,16,.688,95,49,90,.544,42,62,.677,7,28,.250,9,11,.818,114
1447,CLE,2023-11-30,95,,POR,L 95-103,240,38,89,.427,31,57,.544,7,32,.219,12,12,1.000,95,39,77,.506,25,42,.595,14,35,.400,11,11,1.000,103
1448,POR,2023-11-17,95,,LAL,L 95-107,240,36,89,.404,26,52,.500,10,37,.270,13,18,.722,95,40,81,.494,28,52,.538,12,29,.414,15,22,.682,107
1449,POR,2023-11-15,95,,CLE,L 95-109,240,34,91,.374,21,53,.396,13,38,.342,14,16,.875,95,42,75,.560,33,45,.733,9,30,.300,16,21,.762,109
1450,UTA,2023-11-04,95,@,MIN,L 95-123,240,35,91,.385,23,48,.479,12,43,.279,13,17,.765,95,45,81,.556,36,57,.632,9,24,.375,24,31,.774,123
1451,CLE,2023-11-01,95,@,NYK,W 95-89,240,32,74,.432,20,42,.476,12,32,.375,19,20,.950,95,32,92,.348,27,62,.435,5,30,.167,20,30,.667,89
1452,HOU,2023-10-29,95,,GSW,L 95-106,240,34,90,.378,25,57,.439,9,33,.273,18,19,.947,95,35,81,.432,17,36,.472,18,45,.400,18,23,.783,106
1453,OKC,2023-10-29,95,,DEN,L 95-128,240,37,90,.411,31,58,.534,6,32,.188,15,18,.833,95,53,88,.602,42,61,.689,11,27,.407,11,13,.846,128
1454,PHO,2023-10-26,95,@,LAL,L 95-100,240,34,81,.420,25,50,.500,9,31,.290,18,23,.783,95,36,84,.429,31,55,.564,5,29,.172,23,29,.793,100
1455,MEM,2024-01-29,94,,SAC,L 94-103,240,30,80,.375,17,44,.386,13,36,.361,21,28,.750,94,43,84,.512,32,46,.696,11,38,.289,6,10,.600,103
1456,BRK,2024-01-25,94,,MIN,L 94-96,240,35,77,.455,25,44,.568,10,33,.303,14,16,.875,94,37,75,.493,27,54,.500,10,21,.476,12,16,.750,96
1457,HOU,2024-01-17,94,@,NYK,L 94-109,240,35,84,.417,27,54,.500,8,30,.267,16,19,.842,94,39,87,.448,26,50,.520,13,37,.351,18,22,.818,109
1458,NYK,2024-01-15,94,,ORL,L 94-98,240,33,83,.398,20,43,.465,13,40,.325,15,22,.682,94,38,85,.447,30,56,.536,8,29,.276,14,21,.667,98
1459,MEM,2024-01-13,94,,NYK,L 94-106,240,36,87,.414,27,49,.551,9,38,.237,13,15,.867,94,40,83,.482,27,45,.600,13,38,.342,13,19,.684,106
1460,CLE,2023-12-11,94,@,ORL,L 94-104,240,30,85,.353,21,45,.467,9,40,.225,25,33,.758,94,39,84,.464,32,58,.552,7,26,.269,19,25,.760,104
1461,SAS,2023-12-06,94,@,MIN,L 94-102,240,38,101,.376,30,65,.462,8,36,.222,10,15,.667,94,36,87,.414,24,47,.511,12,40,.300,18,21,.857,102
1462,DAL,2023-12-01,94,,MEM,L 94-108,240,34,92,.370,22,53,.415,12,39,.308,14,21,.667,94,44,90,.489,33,56,.589,11,34,.324,9,11,.818,108
1463,LAL,2023-11-27,94,@,PHI,L 94-138,240,39,83,.470,32,55,.582,7,28,.250,9,13,.692,94,47,93,.505,25,47,.532,22,46,.478,22,26,.846,138
1464,CHI,2023-11-15,94,,ORL,L 94-96,240,33,83,.398,24,50,.480,9,33,.273,19,22,.864,94,32,82,.390,24,54,.444,8,28,.286,24,30,.800,96
1465,WAS,2023-11-12,94,@,BRK,L 94-102,240,33,88,.375,23,47,.489,10,41,.244,18,25,.720,94,37,98,.378,25,49,.510,12,49,.245,16,20,.800,102
1466,TOR,2023-11-11,94,@,BOS,L 94-117,240,35,91,.385,25,54,.463,10,37,.270,14,16,.875,94,47,86,.547,32,42,.762,15,44,.341,8,13,.615,117
1467,LAL,2023-11-08,94,@,HOU,L 94-128,240,36,85,.424,29,60,.483,7,25,.280,15,24,.625,94,51,93,.548,37,60,.617,14,33,.424,12,19,.632,128
1468,MIN,2023-10-25,94,@,TOR,L 94-97,240,34,100,.340,26,69,.377,8,31,.258,18,22,.818,94,36,90,.400,22,55,.400,14,35,.400,11,16,.688,97
1469,SAC,2024-01-12,93,@,PHI,L 93-112,240,32,95,.337,24,57,.421,8,38,.211,21,26,.808,93,40,93,.430,25,58,.431,15,35,.429,17,18,.944,112
1470,POR,2024-01-12,93,@,MIN,L 93-116,240,30,77,.390,20,49,.408,10,28,.357,23,34,.676,93,44,80,.550,33,49,.673,11,31,.355,17,24,.708,116
1471,CHO,2024-01-01,93,@,DEN,L 93-111,240,36,86,.419,26,60,.433,10,26,.385,11,16,.688,93,41,83,.494,26,45,.578,15,38,.395,14,18,.778,111
1472,DEN,2023-12-29,93,,OKC,L 93-119,240,36,85,.424,26,48,.542,10,37,.270,11,15,.733,93,46,91,.505,34,56,.607,12,35,.343,15,16,.938,119
1473,HOU,2023-12-11,93,,SAS,W 93-82,240,32,93,.344,20,54,.370,12,39,.308,17,20,.850,93,31,87,.356,26,46,.565,5,41,.122,15,22,.682,82
1474,SAC,2023-11-20,93,@,NOP,L 93-129,240,33,87,.379,22,42,.524,11,45,.244,16,24,.667,93,50,92,.543,38,64,.594,12,28,.429,17,21,.810,129
1475,LAC,2023-11-08,93,@,BRK,L 93-100,240,36,91,.396,28,55,.509,8,36,.222,13,13,1.000,93,37,92,.402,22,51,.431,15,41,.366,11,13,.846,100
1476,CHO,2024-01-29,92,,NYK,L 92-113,240,37,81,.457,26,49,.531,11,32,.344,7,14,.500,92,44,84,.524,32,47,.681,12,37,.324,13,16,.813,113
1477,ORL,2024-01-09,92,,MIN,L 92-113,240,34,94,.362,21,52,.404,13,42,.310,11,18,.611,92,43,80,.538,31,50,.620,12,30,.400,15,19,.789,113
1478,PHI,2024-01-05,92,,NYK,L 92-128,240,33,81,.407,27,58,.466,6,23,.261,20,27,.741,92,43,89,.483,25,48,.521,18,41,.439,24,25,.960,128
1479,MEM,2023-12-31,92,,SAC,L 92-123,240,30,82,.366,18,42,.429,12,40,.300,20,28,.714,92,47,92,.511,31,59,.525,16,33,.485,13,17,.765,123
1480,PHI,2023-12-30,92,@,CHI,L 92-105,240,36,92,.391,27,54,.500,9,38,.237,11,15,.733,92,40,79,.506,33,54,.611,7,25,.280,18,30,.600,105
1481,ORL,2023-12-27,92,,PHI,L 92-112,240,31,79,.392,22,46,.478,9,33,.273,21,24,.875,92,45,96,.469,35,68,.515,10,28,.357,12,17,.706,112
1482,DET,2023-12-15,92,@,PHI,L 92-124,240,35,81,.432,31,60,.517,4,21,.190,18,23,.783,92,41,98,.418,27,61,.443,14,37,.378,28,31,.903,124
1483,MEM,2024-02-04,91,@,BOS,L 91-131,240,35,92,.380,24,54,.444,11,38,.289,10,12,.833,91,48,99,.485,29,48,.604,19,51,.373,16,18,.889,131
1484,CHI,2024-01-15,91,@,CLE,L 91-109,240,35,83,.422,26,51,.510,9,32,.281,12,16,.750,91,39,95,.411,19,38,.500,20,57,.351,11,11,1.000,109
1485,CHO,2024-01-05,91,@,CHI,L 91-104,240,36,89,.404,26,55,.473,10,34,.294,9,12,.750,91,40,74,.541,30,46,.652,10,28,.357,14,17,.824,104
1486,DET,2023-12-08,91,@,ORL,L 91-123,240,34,81,.420,28,51,.549,6,30,.200,17,24,.708,91,49,89,.551,39,63,.619,10,26,.385,15,19,.789,123
1487,UTA,2023-11-29,91,@,MEM,L 91-105,240,34,90,.378,18,51,.353,16,39,.410,7,12,.583,91,43,87,.494,30,48,.625,13,39,.333,6,8,.750,105
1488,CHO,2023-11-28,91,@,NYK,L 91-115,240,37,89,.416,24,58,.414,13,31,.419,4,7,.571,91,41,88,.466,26,50,.520,15,38,.395,18,20,.900,115
1489,MEM,2023-11-22,91,@,HOU,L 91-111,240,27,82,.329,20,50,.400,7,32,.219,30,35,.857,91,40,92,.435,26,49,.531,14,43,.326,17,20,.850,111
1490,POR,2023-11-19,91,,OKC,L 91-134,240,34,85,.400,25,51,.490,9,34,.265,14,21,.667,91,49,81,.605,27,45,.600,22,36,.611,14,14,1.000,134
1491,CLE,2023-10-31,91,,NYK,L 91-109,240,36,92,.391,26,54,.481,10,38,.263,9,12,.750,91,38,86,.442,25,52,.481,13,34,.382,20,25,.800,109
1492,TOR,2023-10-30,91,,POR,L 91-99,240,38,94,.404,34,65,.523,4,29,.138,11,15,.733,91,38,85,.447,27,50,.540,11,35,.314,12,15,.800,99
1493,HOU,2024-02-04,90,@,MIN,L 90-111,240,31,88,.352,21,58,.362,10,30,.333,18,27,.667,90,40,90,.444,29,60,.483,11,30,.367,20,27,.741,111
1494,WAS,2024-01-05,90,@,CLE,L 90-114,240,35,84,.417,26,54,.481,9,30,.300,11,15,.733,90,41,77,.532,25,44,.568,16,33,.485,16,23,.696,114
1495,DAL,2024-01-01,90,@,UTA,L 90-127,240,37,93,.398,26,53,.491,11,40,.275,5,10,.500,90,49,96,.510,37,52,.712,12,44,.273,17,18,.944,127
1496,UTA,2023-11-30,90,@,MIN,L 90-101,240,33,87,.379,22,53,.415,11,34,.324,13,14,.929,90,39,89,.438,26,54,.481,13,35,.371,10,13,.769,101
1497,MIA,2023-10-28,90,@,MIN,L 90-106,240,35,87,.402,23,49,.469,12,38,.316,8,14,.571,90,44,86,.512,32,52,.615,12,34,.353,6,8,.750,106
1498,CHO,2024-01-20,89,,PHI,L 89-97,240,35,85,.412,26,48,.542,9,37,.243,10,14,.714,89,36,85,.424,31,60,.517,5,25,.200,20,24,.833,97
1499,NOP,2023-12-07,89,@,LAL,L 89-133,240,34,95,.358,27,64,.422,7,31,.226,14,20,.700,89,47,86,.547,30,51,.588,17,35,.486,22,29,.759,133
1500,MEM,2023-11-24,89,,PHO,L 89-110,240,37,80,.463,28,47,.596,9,33,.273,6,10,.600,89,39,76,.513,28,45,.622,11,31,.355,21,28,.750,110
1501,SAC,2023-11-04,89,@,HOU,L 89-107,240,32,84,.381,21,43,.488,11,41,.268,14,19,.737,89,40,87,.460,27,51,.529,13,36,.361,14,20,.700,107
1502,DEN,2023-11-01,89,@,MIN,L 89-110,240,38,96,.396,32,63,.508,6,33,.182,7,10,.700,89,38,83,.458,30,62,.484,8,21,.381,26,27,.963,110
1503,NYK,2023-11-01,89,,CLE,L 89-95,240,32,92,.348,27,62,.435,5,30,.167,20,30,.667,89,32,74,.432,20,42,.476,12,32,.375,19,20,.950,95
1504,POR,2024-01-01,88,@,PHO,L 88-109,240,33,80,.413,25,50,.500,8,30,.267,14,19,.737,88,38,80,.475,27,51,.529,11,29,.379,22,33,.667,109
1505,DAL,2023-11-25,88,@,LAC,L 88-107,240,34,91,.374,25,53,.472,9,38,.237,11,14,.786,88,38,88,.432,30,59,.508,8,29,.276,23,31,.742,107
1506,DAL,2024-01-31,87,@,MIN,L 87-121,240,31,76,.408,25,47,.532,6,29,.207,19,26,.731,87,45,80,.563,32,50,.640,13,30,.433,18,30,.600,121
1507,MIA,2024-01-21,87,@,ORL,L 87-105,240,30,80,.375,18,43,.419,12,37,.324,15,18,.833,87,37,78,.474,28,50,.560,9,28,.321,22,28,.786,105
1508,CHO,2024-01-14,87,@,MIA,L 87-104,240,33,95,.347,23,54,.426,10,41,.244,11,15,.733,87,40,81,.494,29,56,.518,11,25,.440,13,16,.813,104
1509,SAS,2023-11-14,87,@,OKC,L 87-123,240,36,93,.387,27,63,.429,9,30,.300,6,9,.667,87,46,89,.517,31,50,.620,15,39,.385,16,20,.800,123
1510,NYK,2023-10-28,87,@,NOP,L 87-96,240,33,90,.367,26,53,.491,7,37,.189,14,18,.778,87,40,87,.460,31,54,.574,9,33,.273,7,16,.438,96
1511,DEN,2023-11-24,86,@,HOU,L 86-105,240,32,94,.340,25,64,.391,7,30,.233,15,21,.714,86,40,82,.488,28,53,.528,12,29,.414,13,15,.867,105
1512,HOU,2023-10-25,86,@,ORL,L 86-116,240,32,79,.405,20,45,.444,12,34,.353,10,16,.625,86,42,87,.483,33,53,.623,9,34,.265,23,26,.885,116
1513,BRK,2024-01-02,85,@,NOP,L 85-112,240,35,98,.357,24,55,.436,11,43,.256,4,8,.500,85,41,88,.466,25,49,.510,16,39,.410,14,18,.778,112
1514,DEN,2024-01-25,84,@,NYK,L 84-122,240,34,84,.405,29,58,.500,5,26,.192,11,13,.846,84,45,85,.529,30,47,.638,15,38,.395,17,20,.850,122
1515,POR,2024-01-09,84,@,NYK,L 84-112,240,33,86,.384,27,57,.474,6,29,.207,12,18,.667,84,37,89,.416,19,41,.463,18,48,.375,20,23,.870,112
1516,NOP,2024-01-26,83,,OKC,L 83-107,240,32,82,.390,23,46,.500,9,36,.250,10,14,.714,83,42,88,.477,32,55,.582,10,33,.303,13,14,.929,107
1517,SAS,2023-10-29,83,@,LAC,L 83-123,240,30,80,.375,19,47,.404,11,33,.333,12,16,.750,83,47,91,.516,31,49,.633,16,42,.381,13,21,.619,123
1518,CHO,2023-12-16,82,,PHI,L 82-135,240,33,91,.363,26,56,.464,7,35,.200,9,11,.818,82,53,88,.602,39,57,.684,14,31,.452,15,17,.882,135
1519,SAS,2023-12-11,82,@,HOU,L 82-93,240,31,87,.356,26,46,.565,5,41,.122,15,22,.682,82,32,93,.344,20,54,.370,12,39,.308,17,20,.850,93
1520,POR,2024-01-11,77,@,OKC,L 77-139,240,28,101,.277,17,52,.327,11,49,.224,10,16,.625,77,53,93,.570,39,58,.672,14,35,.400,19,22,.864,139