Rk,Team,Date,PTS,,Opp,Result,MP,FG,FGA,FG%,2P,2PA,2P%,3P,3PA,3P%,FT,FTA,FT%,PTS,FG,FGA,FG%,2P,2PA,2P%,3P,3PA,3P%,FT,FTA,FT%,PTS
1,CHO,2022-01-26,158,@,IND,W 158-126,240,54,93,.581,30,48,.625,24,45,.533,26,33,.788,158,44,92,.478,34,58,.586,10,34,.294,28,34,.824,126
2,SAS,2022-02-25,157,@,WAS,W 157-153 (2OT),290,57,105,.543,48,76,.632,9,29,.310,34,43,.791,157,59,108,.546,43,70,.614,16,38,.421,19,24,.792,153
3,LAC,2022-04-01,153,@,MIL,W 153-119,240,56,92,.609,33,49,.673,23,43,.535,18,24,.750,153,50,94,.532,42,69,.609,8,25,.320,11,18,.611,119
4,WAS,2022-02-25,153,,SAS,L 153-157 (2OT),290,59,108,.546,43,70,.614,16,38,.421,19,24,.792,153,57,105,.543,48,76,.632,9,29,.310,34,43,.791,157
5,MEM,2021-12-02,152,,OKC,W 152-79,240,60,96,.625,41,60,.683,19,36,.528,13,18,.722,152,25,76,.329,14,38,.368,11,38,.289,18,22,.818,79
6,BRK,2022-03-15,150,@,ORL,W 150-108,240,53,88,.602,37,61,.607,16,27,.593,28,34,.824,150,36,95,.379,21,54,.389,15,41,.366,21,27,.778,108
7,MIN,2022-03-14,149,@,SAS,W 149-139,240,52,90,.578,35,57,.614,17,33,.515,28,32,.875,149,52,97,.536,39,62,.629,13,35,.371,22,26,.846,139
8,LAL,2022-04-10,146,@,DEN,W 146-141 (OT),265,44,94,.468,28,51,.549,16,43,.372,42,47,.894,146,49,100,.490,34,53,.642,15,47,.319,28,36,.778,141
9,HOU,2021-11-27,146,,CHO,W 146-143 (OT),265,51,95,.537,28,46,.609,23,49,.469,21,31,.677,146,48,103,.466,28,53,.528,20,50,.400,27,30,.900,143
10,BOS,2021-12-04,145,@,POR,W 145-117,240,49,87,.563,28,50,.560,21,37,.568,26,29,.897,145,42,89,.472,34,60,.567,8,29,.276,25,32,.781,117
11,MIA,2022-04-05,144,,CHO,W 144-115,240,48,84,.571,25,42,.595,23,42,.548,25,29,.862,144,45,85,.529,33,47,.702,12,38,.316,13,18,.722,115
12,BOS,2022-04-03,144,,WAS,W 144-102,240,56,91,.615,33,47,.702,23,44,.523,9,13,.692,144,38,82,.463,30,61,.492,8,21,.381,18,20,.900,102
13,PHI,2022-04-02,144,,CHO,W 144-114,240,53,87,.609,32,44,.727,21,43,.488,17,21,.810,144,42,87,.483,31,57,.544,11,30,.367,19,24,.792,114
14,CLE,2021-12-26,144,,TOR,W 144-99,240,56,106,.528,34,54,.630,22,52,.423,10,12,.833,144,37,89,.416,28,53,.528,9,36,.250,16,23,.696,99
15,SAS,2021-12-26,144,,DET,W 144-109,240,51,91,.560,38,64,.594,13,27,.481,29,37,.784,144,38,98,.388,30,66,.455,8,32,.250,25,34,.735,109
16,CHO,2021-11-27,143,@,HOU,L 143-146 (OT),265,48,103,.466,28,53,.528,20,50,.400,27,30,.900,143,51,95,.537,28,46,.609,23,49,.469,21,31,.677,146
17,CHO,2022-03-11,142,@,NOP,W 142-120,240,52,87,.598,30,40,.750,22,47,.468,16,20,.800,142,43,86,.500,28,47,.596,15,39,.385,19,25,.760,120
18,MIL,2022-03-08,142,@,OKC,W 142-115,240,53,100,.530,33,60,.550,20,40,.500,16,20,.800,142,42,84,.500,26,45,.578,16,39,.410,15,21,.714,115
19,LAC,2022-02-17,142,,HOU,W 142-111,240,51,92,.554,33,57,.579,18,35,.514,22,26,.846,142,42,91,.462,29,54,.537,13,37,.351,14,19,.737,111
20,SAC,2021-12-08,142,,ORL,W 142-130,240,53,97,.546,38,63,.603,15,34,.441,21,25,.840,142,48,97,.495,32,63,.508,16,34,.471,18,23,.783,130
21,DEN,2022-04-10,141,,LAL,L 141-146 (OT),265,49,100,.490,34,53,.642,15,47,.319,28,36,.778,141,44,94,.468,28,51,.549,16,43,.372,42,47,.894,146
22,MEM,2022-04-09,141,,NOP,W 141-114,240,53,90,.589,35,55,.636,18,35,.514,17,23,.739,141,41,91,.451,35,61,.574,6,30,.200,26,35,.743,114
23,CHO,2022-02-11,141,@,DET,W 141-119,240,54,97,.557,36,55,.655,18,42,.429,15,23,.652,141,48,102,.471,36,67,.537,12,35,.343,11,18,.611,119
24,MIN,2022-01-09,141,@,HOU,W 141-123,240,55,108,.509,40,66,.606,15,42,.357,16,21,.762,141,46,97,.474,32,54,.593,14,43,.326,17,28,.607,123
25,SAC,2021-11-26,141,@,LAL,W 141-137 (3OT),315,54,120,.450,40,75,.533,14,45,.311,19,29,.655,141,51,102,.500,36,58,.621,15,44,.341,20,28,.714,137
26,PHO,2022-03-24,140,@,DEN,W 140-130,240,52,86,.605,39,59,.661,13,27,.481,23,29,.793,140,48,81,.593,33,49,.673,15,32,.469,19,27,.704,130
27,PHO,2022-03-13,140,,LAL,W 140-111,240,58,102,.569,46,69,.667,12,33,.364,12,14,.857,140,36,81,.444,20,41,.488,16,40,.400,23,31,.742,111
28,DEN,2022-01-13,140,,POR,W 140-108,240,52,83,.627,31,41,.756,21,42,.500,15,20,.750,140,39,86,.453,26,46,.565,13,40,.325,17,28,.607,108
29,CHO,2022-01-05,140,,DET,W 140-111,240,48,81,.593,24,39,.615,24,42,.571,20,29,.690,140,43,92,.467,29,50,.580,14,42,.333,11,20,.550,111
30,SAC,2021-11-05,140,,CHO,W 140-110,240,48,87,.552,26,43,.605,22,44,.500,22,26,.846,140,43,92,.467,32,57,.561,11,35,.314,13,21,.619,110
31,BOS,2021-10-25,140,@,CHO,W 140-129 (OT),265,50,101,.495,31,51,.608,19,50,.380,21,25,.840,140,46,103,.447,27,59,.458,19,44,.432,18,28,.643,129
32,BOS,2022-04-10,139,@,MEM,W 139-110,240,54,99,.545,36,51,.706,18,48,.375,13,13,1.000,139,39,102,.382,24,55,.436,15,47,.319,17,27,.630,110
33,MIN,2022-04-03,139,@,HOU,W 139-132,240,51,86,.593,34,45,.756,17,41,.415,20,25,.800,139,48,85,.565,32,45,.711,16,40,.400,20,29,.690,132
34,SAS,2022-03-14,139,,MIN,L 139-149,240,52,97,.536,39,62,.629,13,35,.371,22,26,.846,139,52,90,.578,35,57,.614,17,33,.515,28,32,.875,149
35,HOU,2022-03-09,139,,LAL,W 139-130 (OT),265,52,102,.510,35,62,.565,17,40,.425,18,19,.947,139,47,101,.465,29,54,.537,18,47,.383,18,26,.692,130
36,TOR,2022-02-10,139,@,HOU,W 139-120,240,53,97,.546,38,58,.655,15,39,.385,18,22,.818,139,43,82,.524,27,44,.614,16,38,.421,18,30,.600,120
37,LAC,2022-01-17,139,,IND,W 139-133,240,45,82,.549,27,46,.587,18,36,.500,31,36,.861,139,50,97,.515,37,64,.578,13,33,.394,20,23,.870,133
38,LAL,2021-12-31,139,,POR,W 139-106,240,47,85,.553,28,44,.636,19,41,.463,26,30,.867,139,36,102,.353,24,60,.400,12,42,.286,22,27,.815,106
39,DAL,2021-12-01,139,@,NOP,W 139-107,240,57,83,.687,39,49,.796,18,34,.529,7,9,.778,139,40,89,.449,27,52,.519,13,37,.351,14,16,.875,107
40,LAC,2022-04-10,138,,OKC,W 138-88,240,54,97,.557,36,62,.581,18,35,.514,12,14,.857,138,37,98,.378,28,64,.438,9,34,.265,5,9,.556,88
41,MIN,2022-03-19,138,,MIL,W 138-119,240,47,92,.511,25,45,.556,22,47,.468,22,26,.846,138,43,97,.443,24,45,.533,19,52,.365,14,17,.824,119
42,DEN,2022-03-06,138,,NOP,W 138-130 (OT),265,47,87,.540,37,54,.685,10,33,.303,34,43,.791,138,48,101,.475,34,68,.500,14,33,.424,20,29,.690,130
43,MIN,2022-03-04,138,@,OKC,W 138-101,240,49,91,.538,27,44,.614,22,47,.468,18,23,.783,138,37,86,.430,28,51,.549,9,35,.257,18,21,.857,101
44,GSW,2022-01-14,138,@,CHI,W 138-96,240,53,94,.564,34,52,.654,19,42,.452,13,17,.765,138,37,87,.425,27,49,.551,10,38,.263,12,18,.667,96
45,BRK,2022-01-12,138,@,CHI,W 138-112,240,49,87,.563,32,55,.582,17,32,.531,23,28,.821,138,38,81,.469,27,51,.529,11,30,.367,25,31,.806,112
46,SAS,2021-12-23,138,@,LAL,W 138-110,240,46,95,.484,28,56,.500,18,39,.462,28,33,.848,138,44,94,.468,39,67,.582,5,27,.185,17,30,.567,110
47,MIN,2021-11-20,138,,MEM,W 138-95,240,49,91,.538,29,50,.580,20,41,.488,20,28,.714,138,29,83,.349,20,51,.392,9,32,.281,28,35,.800,95
48,NYK,2021-10-20,138,,BOS,W 138-134 (2OT),290,51,105,.486,34,60,.567,17,45,.378,19,27,.704,138,48,117,.410,27,60,.450,21,57,.368,17,23,.739,134
49,UTA,2022-04-06,137,,OKC,W 137-101,240,49,84,.583,34,48,.708,15,36,.417,24,32,.750,137,37,90,.411,21,53,.396,16,37,.432,11,17,.647,101
50,MIL,2022-02-06,137,@,LAC,W 137-113,240,48,88,.545,29,50,.580,19,38,.500,22,27,.815,137,40,96,.417,22,50,.440,18,46,.391,15,16,.938,113
51,MIL,2022-02-05,137,@,POR,W 137-108,240,49,92,.533,26,42,.619,23,50,.460,16,22,.727,137,41,85,.482,27,40,.675,14,45,.311,12,21,.571,108
52,PHO,2021-12-19,137,,CHO,W 137-106,240,54,95,.568,34,54,.630,20,41,.488,9,13,.692,137,36,100,.360,26,55,.473,10,45,.222,24,28,.857,106
53,UTA,2021-12-03,137,,BOS,W 137-130,240,45,81,.556,18,30,.600,27,51,.529,20,23,.870,137,47,91,.516,33,52,.635,14,39,.359,22,22,1.000,130
54,LAL,2021-11-26,137,,SAC,L 137-141 (3OT),315,51,102,.500,36,58,.621,15,44,.341,20,28,.714,137,54,120,.450,40,75,.533,14,45,.311,19,29,.655,141
55,MIA,2021-10-21,137,,MIL,W 137-95,240,51,96,.531,36,61,.590,15,35,.429,20,31,.645,137,32,84,.381,20,42,.476,12,42,.286,19,29,.655,95
56,MIN,2022-04-01,136,@,DEN,W 136-130,240,43,86,.500,24,46,.522,19,40,.475,31,36,.861,136,46,86,.535,34,51,.667,12,35,.343,26,29,.897,130
57,ATL,2022-03-30,136,@,OKC,W 136-118,240,49,91,.538,31,52,.596,18,39,.462,20,22,.909,136,41,87,.471,24,46,.522,17,41,.415,19,27,.704,118
58,SAS,2022-02-11,136,@,ATL,W 136-121,240,50,90,.556,32,58,.552,18,32,.563,18,21,.857,136,47,103,.456,33,60,.550,14,43,.326,13,15,.867,121
59,DEN,2022-01-30,136,@,MIL,W 136-100,240,53,88,.602,30,45,.667,23,43,.535,7,10,.700,136,37,78,.474,27,48,.563,10,30,.333,16,22,.727,100
60,MIN,2022-01-23,136,,BRK,W 136-125,240,48,92,.522,34,60,.567,14,32,.438,26,31,.839,136,48,95,.505,33,57,.579,15,38,.395,14,15,.933,125
61,POR,2022-01-03,136,,ATL,W 136-131,240,47,89,.528,29,48,.604,18,41,.439,24,28,.857,136,48,88,.545,34,47,.723,14,41,.341,21,24,.875,131
62,MIL,2022-01-01,136,,NOP,W 136-113,240,49,92,.533,26,44,.591,23,48,.479,15,18,.833,136,39,95,.411,23,44,.523,16,51,.314,19,30,.633,113
63,MIL,2021-12-30,136,@,ORL,W 136-118,240,45,91,.495,32,58,.552,13,33,.394,33,36,.917,136,42,87,.483,29,51,.569,13,36,.361,21,27,.778,118
64,UTA,2021-12-08,136,@,MIN,W 136-104,240,50,88,.568,25,34,.735,25,54,.463,11,15,.733,136,38,95,.400,21,48,.438,17,47,.362,11,17,.647,104
65,MEM,2021-11-15,136,,HOU,W 136-102,240,52,96,.542,36,55,.655,16,41,.390,16,20,.800,136,36,95,.379,25,57,.439,11,38,.289,19,26,.731,102
66,SAS,2021-11-10,136,,SAC,W 136-117,240,49,92,.533,31,60,.517,18,32,.563,20,31,.645,136,47,91,.516,37,55,.673,10,36,.278,13,16,.813,117
67,WAS,2022-04-01,135,,DAL,W 135-103,240,49,90,.544,32,57,.561,17,33,.515,20,22,.909,135,34,78,.436,23,40,.575,11,38,.289,24,26,.923,103
68,CHI,2022-03-31,135,,LAC,W 135-130 (OT),265,50,102,.490,40,73,.548,10,29,.345,25,32,.781,135,45,90,.500,29,54,.537,16,36,.444,24,26,.923,130
69,MIL,2022-03-16,135,@,SAC,W 135-126,240,47,89,.528,29,54,.537,18,35,.514,23,32,.719,135,46,94,.489,30,51,.588,16,43,.372,18,21,.857,126
70,MEM,2022-03-15,135,@,IND,W 135-102,240,54,105,.514,39,65,.600,15,40,.375,12,20,.600,135,41,98,.418,35,68,.515,6,30,.200,14,19,.737,102
71,MIN,2022-03-05,135,,POR,W 135-121,240,48,85,.565,33,48,.688,15,37,.405,24,29,.828,135,40,85,.471,24,47,.511,16,38,.421,25,30,.833,121
72,BOS,2022-02-15,135,@,PHI,W 135-87,240,46,82,.561,21,37,.568,25,45,.556,18,22,.818,135,23,80,.288,15,48,.313,8,32,.250,33,39,.846,87
73,UTA,2022-02-14,135,,HOU,W 135-101,240,49,89,.551,31,49,.633,18,40,.450,19,22,.864,135,35,83,.422,23,46,.500,12,37,.324,19,28,.679,101
74,MEM,2022-02-08,135,,LAC,W 135-109,240,53,103,.515,44,77,.571,9,26,.346,20,25,.800,135,40,89,.449,29,58,.500,11,31,.355,18,24,.750,109
75,MEM,2022-02-05,135,@,ORL,W 135-115,240,53,105,.505,40,66,.606,13,39,.333,16,22,.727,135,39,90,.433,22,42,.524,17,48,.354,20,29,.690,115
76,PHO,2022-01-16,135,@,DET,W 135-108,240,51,87,.586,40,60,.667,11,27,.407,22,30,.733,135,38,82,.463,29,57,.509,9,25,.360,23,34,.676,108
77,MIN,2022-01-07,135,@,OKC,W 135-105,240,50,90,.556,33,49,.673,17,41,.415,18,25,.720,135,36,89,.404,21,45,.467,15,44,.341,18,23,.783,105
78,WAS,2021-10-22,135,,IND,W 135-134 (OT),265,49,94,.521,30,56,.536,19,38,.500,18,19,.947,135,52,97,.536,37,63,.587,15,34,.441,15,20,.750,134
79,BRK,2022-04-10,134,,IND,W 134-126,240,52,81,.642,44,59,.746,8,22,.364,22,25,.880,134,47,104,.452,28,58,.483,19,46,.413,13,19,.684,126
80,OKC,2022-03-28,134,@,POR,W 134-131 (OT),265,48,90,.533,28,45,.622,20,45,.444,18,25,.720,134,51,112,.455,31,62,.500,20,50,.400,9,13,.692,131
81,BOS,2022-03-27,134,,MIN,W 134-112,240,49,87,.563,32,48,.667,17,39,.436,19,21,.905,134,45,84,.536,31,52,.596,14,32,.438,8,12,.667,112
82,DET,2022-03-17,134,@,ORL,W 134-120,240,47,94,.500,27,51,.529,20,43,.465,20,31,.645,134,47,97,.485,36,67,.537,11,30,.367,15,21,.714,120
83,CHO,2022-03-14,134,@,OKC,W 134-116,240,49,91,.538,29,56,.518,20,35,.571,16,21,.762,134,42,90,.467,26,46,.565,16,44,.364,16,19,.842,116
84,UTA,2022-03-12,134,,SAC,W 134-125,240,48,86,.558,32,45,.711,16,41,.390,22,31,.710,134,47,94,.500,34,61,.557,13,33,.394,18,21,.857,125
85,CHI,2022-02-11,134,,MIN,W 134-122,240,55,87,.632,41,56,.732,14,31,.452,10,13,.769,134,48,96,.500,35,56,.625,13,40,.325,13,16,.813,122
86,MIN,2022-02-08,134,@,SAC,W 134-114,240,50,104,.481,28,60,.467,22,44,.500,12,17,.706,134,41,83,.494,32,58,.552,9,25,.360,23,26,.885,114
87,PHO,2022-01-28,134,,MIN,W 134-124,240,43,84,.512,23,45,.511,20,39,.513,28,37,.757,134,44,90,.489,30,51,.588,14,39,.359,22,27,.815,124
88,SAS,2022-01-25,134,@,HOU,W 134-104,240,58,101,.574,46,69,.667,12,32,.375,6,6,1.000,134,39,95,.411,30,61,.492,9,34,.265,17,25,.680,104
89,ATL,2022-01-19,134,,MIN,W 134-122,240,45,86,.523,30,48,.625,15,38,.395,29,33,.879,134,42,97,.433,25,51,.490,17,46,.370,21,29,.724,122
90,LAL,2022-01-07,134,,ATL,W 134-118,240,50,101,.495,33,60,.550,17,41,.415,17,19,.895,134,43,96,.448,30,60,.500,13,36,.361,19,27,.704,118
91,POR,2021-10-23,134,,PHO,W 134-105,240,51,94,.543,30,44,.682,21,50,.420,11,17,.647,134,43,89,.483,34,61,.557,9,28,.321,10,15,.667,105
92,IND,2021-10-22,134,@,WAS,L 134-135 (OT),265,52,97,.536,37,63,.587,15,34,.441,15,20,.750,134,49,94,.521,30,56,.536,19,38,.500,18,19,.947,135
93,BOS,2021-10-20,134,@,NYK,L 134-138 (2OT),290,48,117,.410,27,60,.450,21,57,.368,17,23,.739,134,51,105,.486,34,60,.567,17,45,.378,19,27,.704,138
94,CLE,2022-04-10,133,,MIL,W 133-115,240,51,94,.543,32,56,.571,19,38,.500,12,17,.706,133,39,88,.443,27,58,.466,12,30,.400,25,32,.781,115
95,PHI,2022-04-09,133,,IND,W 133-120,240,50,90,.556,38,56,.679,12,34,.353,21,27,.778,133,41,78,.526,31,55,.564,10,23,.435,28,36,.778,120
96,CHO,2022-04-08,133,@,CHI,W 133-117,240,52,86,.605,33,46,.717,19,40,.475,10,10,1.000,133,44,82,.537,31,58,.534,13,24,.542,16,20,.800,117
97,MEM,2022-03-24,133,,IND,W 133-103,240,50,93,.538,29,51,.569,21,42,.500,12,17,.706,133,39,92,.424,30,59,.508,9,33,.273,16,23,.696,103
98,SAS,2022-03-23,133,@,POR,W 133-96,240,46,94,.489,27,50,.540,19,44,.432,22,24,.917,133,36,94,.383,29,68,.426,7,26,.269,17,18,.944,96
99,WAS,2022-03-06,133,,IND,W 133-123,240,45,86,.523,28,44,.636,17,42,.405,26,32,.813,133,44,85,.518,34,54,.630,10,31,.323,25,29,.862,123
100,TOR,2022-02-28,133,@,BRK,W 133-97,240,51,99,.515,33,61,.541,18,38,.474,13,22,.591,133,33,86,.384,21,51,.412,12,35,.343,19,24,.792,97
101,MIA,2022-02-26,133,,SAS,W 133-129,240,47,83,.566,35,55,.636,12,28,.429,27,38,.711,133,50,90,.556,36,59,.610,14,31,.452,15,19,.789,129
102,PHI,2022-02-25,133,@,MIN,W 133-102,240,42,82,.512,23,43,.535,19,39,.487,30,36,.833,133,36,86,.419,27,47,.574,9,39,.231,21,25,.840,102
103,ATL,2022-02-08,133,,IND,W 133-112,240,52,90,.578,35,57,.614,17,33,.515,12,16,.750,133,37,93,.398,27,62,.435,10,31,.323,28,33,.848,112
104,MIL,2022-01-22,133,,SAC,W 133-127,240,45,91,.495,24,49,.490,21,42,.500,22,25,.880,133,51,97,.526,36,60,.600,15,37,.405,10,16,.625,127
105,DET,2022-01-19,133,@,SAC,W 133-131,240,46,91,.505,31,55,.564,15,36,.417,26,30,.867,133,44,84,.524,32,57,.561,12,27,.444,31,44,.705,131
106,IND,2022-01-17,133,@,LAC,L 133-139,240,50,97,.515,37,64,.578,13,33,.394,20,23,.870,133,45,82,.549,27,46,.587,18,36,.500,31,36,.861,139
107,DEN,2022-01-15,133,,LAL,W 133-96,240,47,91,.516,24,51,.471,23,40,.575,16,17,.941,133,36,82,.439,26,52,.500,10,30,.333,14,19,.737,96
108,CHI,2022-01-11,133,,DET,W 133-87,240,50,92,.543,32,58,.552,18,34,.529,15,19,.789,133,30,89,.337,24,54,.444,6,35,.171,21,27,.778,87
109,PHI,2022-01-03,133,,HOU,W 133-113,240,50,96,.521,33,56,.589,17,40,.425,16,17,.941,133,37,89,.416,22,45,.489,15,44,.341,24,33,.727,113
110,PHO,2022-01-02,133,@,CHO,W 133-99,240,52,103,.505,35,62,.565,17,41,.415,12,12,1.000,133,39,85,.459,30,50,.600,9,35,.257,12,21,.571,99
111,CHI,2021-12-20,133,,HOU,W 133-118,240,47,88,.534,31,53,.585,16,35,.457,23,24,.958,133,44,78,.564,32,45,.711,12,33,.364,18,24,.750,118
112,DEN,2021-12-17,133,@,ATL,W 133-115,240,50,86,.581,33,48,.688,17,38,.447,16,18,.889,133,41,88,.466,34,64,.531,7,24,.292,26,34,.765,115
113,CHI,2021-11-29,133,,CHO,W 133-119,240,53,89,.596,39,59,.661,14,30,.467,13,19,.684,133,42,88,.477,24,49,.490,18,39,.462,17,21,.810,119
114,CHO,2021-11-26,133,,MIN,W 133-115,240,49,88,.557,26,48,.542,23,40,.575,12,15,.800,133,45,100,.450,34,65,.523,11,35,.314,14,19,.737,115
115,WAS,2022-04-05,132,@,MIN,W 132-114,240,56,101,.554,43,71,.606,13,30,.433,7,14,.500,132,41,91,.451,27,50,.540,14,41,.341,18,25,.720,114
116,HOU,2022-04-03,132,,MIN,L 132-139,240,48,85,.565,32,45,.711,16,40,.400,20,29,.690,132,51,86,.593,34,45,.756,17,41,.415,20,25,.800,139
117,ATL,2022-03-28,132,@,IND,W 132-123,240,47,86,.547,30,51,.588,17,35,.486,21,26,.808,132,45,87,.517,28,51,.549,17,36,.472,16,18,.889,123
118,MEM,2022-03-23,132,,BRK,W 132-120,240,47,101,.465,28,63,.444,19,38,.500,19,22,.864,132,43,87,.494,34,62,.548,9,25,.360,25,27,.926,120
119,BOS,2022-03-21,132,@,OKC,W 132-123,240,44,86,.512,29,46,.630,15,40,.375,29,34,.853,132,48,93,.516,31,56,.554,17,37,.459,10,14,.714,123
120,MIN,2022-03-09,132,,OKC,W 132-102,240,45,86,.523,23,34,.676,22,52,.423,20,26,.769,132,36,87,.414,22,44,.500,14,43,.326,16,24,.667,102
121,MEM,2022-03-08,132,,NOP,W 132-111,240,48,101,.475,32,57,.561,16,44,.364,20,24,.833,132,41,88,.466,30,54,.556,11,34,.324,18,27,.667,111
122,BRK,2022-03-08,132,@,CHO,W 132-121,240,46,82,.561,28,47,.596,18,35,.514,22,29,.759,132,45,92,.489,32,51,.627,13,41,.317,18,22,.818,121
123,MIL,2022-03-06,132,,PHO,W 132-122,240,47,87,.540,32,55,.582,15,32,.469,23,29,.793,132,50,93,.538,36,62,.581,14,31,.452,8,11,.727,122
124,LAC,2022-03-03,132,,LAL,W 132-111,240,51,93,.548,34,66,.515,17,27,.630,13,15,.867,132,41,84,.488,29,49,.592,12,35,.343,17,22,.773,111
125,UTA,2022-03-02,132,@,HOU,W 132-127 (OT),265,50,91,.549,35,49,.714,15,42,.357,17,24,.708,132,43,86,.500,22,35,.629,21,51,.412,20,30,.667,127
126,GSW,2022-02-24,132,@,POR,W 132-95,240,45,88,.511,30,47,.638,15,41,.366,27,32,.844,132,31,79,.392,22,44,.500,9,35,.257,24,29,.828,95
127,PHO,2022-02-12,132,,ORL,W 132-105,240,55,105,.524,40,71,.563,15,34,.441,7,10,.700,132,37,87,.425,22,46,.478,15,41,.366,16,24,.667,105
128,MEM,2022-02-10,132,@,DET,W 132-107,240,44,92,.478,29,62,.468,15,30,.500,29,42,.690,132,41,94,.436,34,59,.576,7,35,.200,18,21,.857,107
129,SAC,2022-02-09,132,,MIN,W 132-119,240,48,93,.516,36,63,.571,12,30,.400,24,27,.889,132,44,98,.449,28,52,.538,16,46,.348,15,18,.833,119
130,DEN,2022-02-08,132,,NYK,W 132-115,240,46,85,.541,30,46,.652,16,39,.410,24,31,.774,132,45,101,.446,30,58,.517,15,43,.349,10,12,.833,115
131,DAL,2022-01-29,132,,IND,W 132-105,240,51,96,.531,35,62,.565,16,34,.471,14,22,.636,132,40,91,.440,31,58,.534,9,33,.273,16,23,.696,105
132,DAL,2022-01-26,132,@,POR,W 132-112,240,48,88,.545,32,52,.615,16,36,.444,20,26,.769,132,42,82,.512,28,44,.636,14,38,.368,14,23,.609,112
133,LAL,2021-12-28,132,@,HOU,W 132-123,240,48,92,.522,34,58,.586,14,34,.412,22,29,.759,132,44,83,.530,28,48,.583,16,35,.457,19,25,.760,123
134,DAL,2021-12-27,132,@,POR,W 132-117,240,48,84,.571,36,51,.706,12,33,.364,24,33,.727,132,35,82,.427,23,42,.548,12,40,.300,35,42,.833,117
135,HOU,2021-12-13,132,@,ATL,W 132-126,240,46,96,.479,27,50,.540,19,46,.413,21,27,.778,132,42,85,.494,27,46,.587,15,39,.385,27,31,.871,126
136,ATL,2021-11-26,132,@,MEM,W 132-100,240,52,89,.584,39,62,.629,13,27,.481,15,21,.714,132,37,91,.407,25,53,.472,12,38,.316,14,19,.737,100
137,MEM,2021-10-20,132,,CLE,W 132-121,240,53,100,.530,39,67,.582,14,33,.424,12,12,1.000,132,47,93,.505,33,55,.600,14,38,.368,13,18,.722,121
138,MIL,2022-04-08,131,@,DET,W 131-101,240,50,101,.495,39,64,.609,11,37,.297,20,23,.870,131,35,90,.389,25,42,.595,10,48,.208,21,23,.913,101
139,DAL,2022-04-06,131,@,DET,W 131-113,240,45,80,.563,30,47,.638,15,33,.455,26,34,.765,131,35,82,.427,24,52,.462,11,30,.367,32,35,.914,113
140,PHI,2022-04-05,131,@,IND,W 131-122,240,47,87,.540,24,47,.511,23,40,.575,14,18,.778,131,45,95,.474,33,55,.600,12,40,.300,20,21,.952,122
141,ATL,2022-03-31,131,,CLE,W 131-107,240,45,91,.495,28,52,.538,17,39,.436,24,28,.857,131,39,90,.433,32,60,.533,7,30,.233,22,28,.786,107
142,POR,2022-03-28,131,,OKC,L 131-134 (OT),265,51,112,.455,31,62,.500,20,50,.400,9,13,.692,131,48,90,.533,28,45,.622,20,45,.444,18,25,.720,134
143,TOR,2022-03-26,131,,IND,W 131-91,240,51,84,.607,36,52,.692,15,32,.469,14,19,.737,131,33,79,.418,22,43,.512,11,36,.306,14,20,.700,91
144,LAL,2022-03-21,131,@,CLE,W 131-120,240,53,94,.564,41,62,.661,12,32,.375,13,16,.813,131,45,86,.523,31,47,.660,14,39,.359,16,19,.842,120
145,PHO,2022-03-15,131,@,NOP,W 131-115,240,49,90,.544,31,56,.554,18,34,.529,15,15,1.000,131,43,86,.500,31,52,.596,12,34,.353,17,24,.708,115
146,ATL,2022-03-13,131,,IND,W 131-128,240,46,84,.548,29,46,.630,17,38,.447,22,24,.917,131,46,89,.517,31,54,.574,15,35,.429,21,26,.808,128
147,NYK,2022-03-07,131,@,SAC,W 131-115,240,47,92,.511,29,50,.580,18,42,.429,19,23,.826,131,39,80,.488,28,48,.583,11,32,.344,26,36,.722,115
148,DEN,2022-03-07,131,,GSW,W 131-124,240,46,84,.548,36,52,.692,10,32,.313,29,41,.707,131,45,88,.511,28,48,.583,17,40,.425,17,23,.739,124
149,SAC,2022-02-28,131,@,OKC,W 131-110,240,49,87,.563,39,56,.696,10,31,.323,23,30,.767,131,40,86,.465,29,51,.569,11,35,.314,19,27,.704,110
150,PHO,2022-02-10,131,,MIL,W 131-107,240,51,90,.567,42,60,.700,9,30,.300,20,29,.690,131,40,88,.455,30,50,.600,10,38,.263,17,25,.680,107
151,MIL,2022-02-08,131,@,LAL,W 131-116,240,52,96,.542,37,60,.617,15,36,.417,12,20,.600,131,44,85,.518,34,53,.642,10,32,.313,18,30,.600,116
152,SAS,2022-02-04,131,,HOU,W 131-106,240,51,89,.573,38,61,.623,13,28,.464,16,20,.800,131,36,83,.434,25,50,.500,11,33,.333,23,29,.793,106
153,SAS,2022-01-28,131,,CHI,W 131-122,240,50,95,.526,34,58,.586,16,37,.432,15,18,.833,131,46,88,.523,38,58,.655,8,30,.267,22,26,.846,122
154,SAC,2022-01-19,131,,DET,L 131-133,240,44,84,.524,32,57,.561,12,27,.444,31,44,.705,131,46,91,.505,31,55,.564,15,36,.417,26,30,.867,133
155,ATL,2022-01-03,131,@,POR,L 131-136,240,48,88,.545,34,47,.723,14,41,.341,21,24,.875,131,47,89,.528,29,48,.604,18,41,.439,24,28,.857,136
156,CHI,2021-12-29,131,,ATL,W 131-117,240,52,84,.619,42,62,.677,10,22,.455,17,22,.773,131,44,92,.478,33,66,.500,11,26,.423,18,26,.692,117
157,CHO,2021-12-15,131,@,SAS,W 131-115,240,51,86,.593,33,52,.635,18,34,.529,11,16,.688,131,39,90,.433,27,53,.509,12,37,.324,25,25,1.000,115
158,BRK,2021-12-14,131,,TOR,W 131-129 (OT),265,50,103,.485,36,64,.563,14,39,.359,17,23,.739,131,48,105,.457,30,53,.566,18,52,.346,15,19,.789,129
159,IND,2021-11-01,131,,SAS,W 131-118,240,52,91,.571,34,53,.642,18,38,.474,9,12,.750,131,47,89,.528,33,61,.541,14,28,.500,10,14,.714,118
160,ATL,2022-04-10,130,@,HOU,W 130-114,240,45,87,.517,24,49,.490,21,38,.553,19,24,.792,130,41,89,.461,24,43,.558,17,46,.370,15,20,.750,114
161,DAL,2022-04-10,130,,SAS,W 130-120,240,46,85,.541,26,49,.531,20,36,.556,18,23,.783,130,43,89,.483,32,58,.552,11,31,.355,23,23,1.000,120
162,SAS,2022-04-01,130,,POR,W 130-111,240,46,81,.568,30,44,.682,16,37,.432,22,28,.786,130,41,92,.446,26,57,.456,15,35,.429,14,20,.700,111
163,DEN,2022-04-01,130,,MIN,L 130-136,240,46,86,.535,34,51,.667,12,35,.343,26,29,.897,130,43,86,.500,24,46,.522,19,40,.475,31,36,.861,136
164,LAC,2022-03-31,130,@,CHI,L 130-135 (OT),265,45,90,.500,29,54,.537,16,36,.444,24,26,.923,130,50,102,.490,40,73,.548,10,29,.345,25,32,.781,135
165,BRK,2022-03-29,130,,DET,W 130-123,240,42,76,.553,27,48,.563,15,28,.536,31,34,.912,130,48,99,.485,32,61,.525,16,38,.421,11,13,.846,123
166,DEN,2022-03-24,130,,PHO,L 130-140,240,48,81,.593,33,49,.673,15,32,.469,19,27,.704,130,52,86,.605,39,59,.661,13,27,.481,23,29,.793,140
167,NOP,2022-03-13,130,,HOU,W 130-105,240,48,93,.516,38,61,.623,10,32,.313,24,34,.706,130,39,77,.506,27,46,.587,12,31,.387,15,25,.600,105
168,LAL,2022-03-09,130,@,HOU,L 130-139 (OT),265,47,101,.465,29,54,.537,18,47,.383,18,26,.692,130,52,102,.510,35,62,.565,17,40,.425,18,19,.947,139
169,NOP,2022-03-06,130,@,DEN,L 130-138 (OT),265,48,101,.475,34,68,.500,14,33,.424,20,29,.690,130,47,87,.540,37,54,.685,10,33,.303,34,43,.791,138
170,ATL,2022-03-03,130,,CHI,W 130-124,240,44,84,.524,26,44,.591,18,40,.450,24,28,.857,130,52,88,.591,38,62,.613,14,26,.538,6,7,.857,124
171,MIL,2022-02-28,130,,CHO,W 130-106,240,40,91,.440,22,46,.478,18,45,.400,32,37,.865,130,36,93,.387,22,54,.407,14,39,.359,20,32,.625,106
172,ATL,2022-02-16,130,@,ORL,W 130-109,240,45,90,.500,27,57,.474,18,33,.545,22,28,.786,130,42,98,.429,29,57,.509,13,41,.317,12,13,.923,109
173,MIN,2022-02-01,130,,DEN,W 130-115,240,46,93,.495,27,48,.563,19,45,.422,19,25,.760,130,38,89,.427,24,45,.533,14,44,.318,25,28,.893,115
174,CHI,2022-01-30,130,,POR,W 130-116,240,50,90,.556,37,58,.638,13,32,.406,17,18,.944,130,43,83,.518,25,44,.568,18,39,.462,12,16,.750,116
175,GSW,2022-01-25,130,,DAL,W 130-92,240,49,92,.533,32,49,.653,17,43,.395,15,18,.833,130,32,91,.352,22,51,.431,10,40,.250,18,18,1.000,92
176,DEN,2022-01-19,130,,LAC,W 130-128 (OT),265,48,98,.490,35,60,.583,13,38,.342,21,25,.840,130,52,97,.536,37,58,.638,15,39,.385,9,12,.750,128
177,OKC,2022-01-13,130,@,BRK,W 130-109,240,47,91,.516,27,46,.587,20,45,.444,16,18,.889,130,41,98,.418,34,66,.515,7,32,.219,20,22,.909,109
178,DAL,2022-01-07,130,@,HOU,W 130-106,240,49,90,.544,32,52,.615,17,38,.447,15,28,.536,130,37,87,.425,25,44,.568,12,43,.279,20,29,.690,106
179,CHI,2022-01-07,130,,WAS,W 130-122,240,48,91,.527,33,58,.569,15,33,.455,19,21,.905,130,45,88,.511,38,64,.594,7,24,.292,25,26,.962,122
180,CHI,2021-12-27,130,@,ATL,W 130-118,240,51,94,.543,33,57,.579,18,37,.486,10,14,.714,130,40,89,.449,25,55,.455,15,34,.441,23,26,.885,118
181,ORL,2021-12-08,130,@,SAC,L 130-142,240,48,97,.495,32,63,.508,16,34,.471,18,23,.783,130,53,97,.546,38,63,.603,15,34,.441,21,25,.840,142
182,CHO,2021-12-05,130,@,ATL,W 130-127,240,46,86,.535,29,49,.592,17,37,.459,21,28,.750,130,48,93,.516,31,56,.554,17,37,.459,14,18,.778,127
183,BOS,2021-12-03,130,@,UTA,L 130-137,240,47,91,.516,33,52,.635,14,39,.359,22,22,1.000,130,45,81,.556,18,30,.600,27,51,.529,20,23,.870,137
184,BOS,2021-11-19,130,,LAL,W 130-108,240,44,88,.500,33,58,.569,11,30,.367,31,38,.816,130,39,84,.464,27,54,.500,12,30,.400,18,24,.750,108
185,DEN,2022-04-03,129,@,LAL,W 129-118,240,47,82,.573,35,51,.686,12,31,.387,23,29,.793,129,49,92,.533,43,72,.597,6,20,.300,14,21,.667,118
186,IND,2022-03-20,129,,POR,W 129-98,240,48,84,.571,33,49,.673,15,35,.429,18,21,.857,129,38,81,.469,29,48,.604,9,33,.273,13,18,.722,98
187,CHO,2022-03-19,129,,DAL,W 129-108,240,44,88,.500,24,46,.522,20,42,.476,21,27,.778,129,39,89,.438,25,51,.490,14,38,.368,16,20,.800,108
188,PHO,2022-03-18,129,,CHI,W 129-102,240,47,84,.560,36,59,.610,11,25,.440,24,26,.923,129,35,85,.412,28,58,.483,7,27,.259,25,31,.806,102
189,PHO,2022-03-16,129,@,HOU,W 129-112,240,53,95,.558,40,62,.645,13,33,.394,10,13,.769,129,42,85,.494,26,46,.565,16,39,.410,12,19,.632,112
190,BRK,2022-03-10,129,@,PHI,W 129-100,240,51,91,.560,33,51,.647,18,40,.450,9,17,.529,129,30,93,.323,16,57,.281,14,36,.389,26,30,.867,100
191,MIN,2022-03-01,129,,GSW,W 129-114,240,47,89,.528,31,49,.633,16,40,.400,19,23,.826,129,41,90,.456,28,45,.622,13,45,.289,19,22,.864,114
192,SAS,2022-02-26,129,@,MIA,L 129-133,240,50,90,.556,36,59,.610,14,31,.452,15,19,.789,129,47,83,.566,35,55,.636,12,28,.429,27,38,.711,133
193,OKC,2022-02-25,129,@,IND,W 129-125 (OT),265,50,101,.495,39,70,.557,11,31,.355,18,24,.750,129,49,101,.485,35,64,.547,14,37,.378,13,22,.591,125
194,BOS,2022-02-24,129,@,BRK,W 129-106,240,46,85,.541,29,43,.674,17,42,.405,20,27,.741,129,39,94,.415,32,65,.492,7,29,.241,21,28,.750,106
195,MIN,2022-02-13,129,@,IND,W 129-120,240,43,84,.512,25,50,.500,18,34,.529,25,28,.893,129,45,102,.441,32,57,.561,13,45,.289,17,22,.773,120
196,ATL,2022-01-30,129,,LAL,W 129-121,240,49,84,.583,39,53,.736,10,31,.323,21,32,.656,129,47,87,.540,32,52,.615,15,35,.429,12,23,.522,121
197,BRK,2022-01-05,129,@,IND,W 129-121,240,49,86,.570,44,65,.677,5,21,.238,26,29,.897,129,41,82,.500,28,43,.651,13,39,.333,26,28,.929,121
198,TOR,2022-01-04,129,,SAS,W 129-104,240,45,96,.469,27,52,.519,18,44,.409,21,29,.724,129,41,95,.432,32,60,.533,9,35,.257,13,19,.684,104
199,TOR,2021-12-14,129,@,BRK,L 129-131 (OT),265,48,105,.457,30,53,.566,18,52,.346,15,19,.789,129,50,103,.485,36,64,.563,14,39,.359,17,23,.739,131
200,UTA,2021-11-29,129,,POR,W 129-107,240,47,89,.528,28,43,.651,19,46,.413,16,23,.696,129,42,91,.462,31,60,.517,11,31,.355,12,17,.706,107
201,SAC,2021-11-15,129,@,DET,W 129-107,240,52,98,.531,36,65,.554,16,33,.485,9,11,.818,129,39,96,.406,26,49,.531,13,47,.277,16,17,.941,107
202,ATL,2021-11-15,129,,ORL,W 129-111,240,47,85,.553,33,55,.600,14,30,.467,21,32,.656,129,43,95,.453,27,52,.519,16,43,.372,9,14,.643,111
203,LAC,2021-11-13,129,,MIN,W 129-102,240,53,99,.535,37,59,.627,16,40,.400,7,9,.778,129,40,102,.392,29,66,.439,11,36,.306,11,16,.688,102
204,MIA,2021-10-30,129,@,MEM,W 129-103,240,46,88,.523,25,51,.490,21,37,.568,16,19,.842,129,34,88,.386,18,38,.474,16,50,.320,19,21,.905,103
205,CHO,2021-10-25,129,,BOS,L 129-140 (OT),265,46,103,.447,27,59,.458,19,44,.432,18,28,.643,129,50,101,.495,31,51,.608,19,50,.380,21,25,.840,140
206,GSW,2022-04-10,128,@,NOP,W 128-107,240,49,81,.605,30,48,.625,19,33,.576,11,13,.846,128,42,99,.424,28,59,.475,14,40,.350,9,12,.750,107
207,DAL,2022-04-08,128,,POR,W 128-78,240,42,79,.532,22,34,.647,20,45,.444,24,31,.774,128,31,83,.373,24,51,.471,7,32,.219,9,12,.750,78
208,CHO,2022-04-07,128,,ORL,W 128-101,240,48,92,.522,36,58,.621,12,34,.353,20,27,.741,128,38,95,.400,23,47,.489,15,48,.313,10,13,.769,101
209,GSW,2022-04-07,128,,LAL,W 128-112,240,51,97,.526,35,65,.538,16,32,.500,10,10,1.000,128,37,83,.446,28,51,.549,9,32,.281,29,38,.763,112
210,BOS,2022-04-01,128,,IND,W 128-123,240,45,83,.542,33,50,.660,12,33,.364,26,28,.929,128,42,81,.519,25,45,.556,17,36,.472,22,23,.957,123
211,DAL,2022-03-29,128,,LAL,W 128-110,240,45,87,.517,25,41,.610,20,46,.435,18,23,.783,128,40,89,.449,28,45,.622,12,44,.273,18,22,.818,110
212,BRK,2022-03-18,128,,POR,W 128-123,240,45,77,.584,35,52,.673,10,25,.400,28,33,.848,128,48,96,.500,35,61,.574,13,35,.371,14,24,.583,123
213,LAL,2022-03-18,128,@,TOR,W 128-123 (OT),265,47,96,.490,28,53,.528,19,43,.442,15,21,.714,128,49,97,.505,37,60,.617,12,37,.324,13,20,.650,123
214,NYK,2022-03-16,128,,POR,W 128-98,240,40,80,.500,24,42,.571,16,38,.421,32,39,.821,128,40,91,.440,29,57,.509,11,34,.324,7,14,.500,98
215,IND,2022-03-13,128,@,ATL,L 128-131,240,46,89,.517,31,54,.574,15,35,.429,21,26,.808,128,46,84,.548,29,46,.630,17,38,.447,22,24,.917,131
216,IND,2022-02-27,128,,BOS,W 128-107,240,47,90,.522,30,57,.526,17,33,.515,17,20,.850,128,39,91,.429,27,48,.563,12,43,.279,17,20,.850,107
217,DEN,2022-02-24,128,@,SAC,W 128-110,240,48,86,.558,33,51,.647,15,35,.429,17,20,.850,128,43,86,.500,34,57,.596,9,29,.310,15,18,.833,110
218,MIL,2022-02-15,128,,IND,W 128-119,240,48,86,.558,38,57,.667,10,29,.345,22,30,.733,128,47,93,.505,30,52,.577,17,41,.415,8,19,.421,119
219,MIN,2022-02-03,128,@,DET,W 128-117,240,44,87,.506,29,53,.547,15,34,.441,25,28,.893,128,40,91,.440,25,45,.556,15,46,.326,22,28,.786,117
220,BOS,2022-01-25,128,,SAC,W 128-75,240,51,103,.495,31,58,.534,20,45,.444,6,7,.857,128,29,95,.305,23,62,.371,6,33,.182,11,15,.733,75
221,LAC,2022-01-19,128,@,DEN,L 128-130 (OT),265,52,97,.536,37,58,.638,15,39,.385,9,12,.750,128,48,98,.490,35,60,.583,13,38,.342,21,25,.840,130
222,HOU,2022-01-12,128,@,SAS,W 128-124,240,45,82,.549,29,46,.630,16,36,.444,22,32,.688,128,43,99,.434,26,53,.491,17,46,.370,21,27,.778,124
223,NOP,2022-01-11,128,,MIN,W 128-125,240,42,76,.553,26,43,.605,16,33,.485,28,37,.757,128,42,86,.488,24,47,.511,18,39,.462,23,31,.742,125
224,UTA,2021-12-23,128,,MIN,W 128-116,240,48,90,.533,32,51,.627,16,39,.410,16,22,.727,128,45,101,.446,28,56,.500,17,45,.378,9,12,.750,116
225,SAS,2021-12-17,128,@,UTA,W 128-126,240,50,100,.500,35,59,.593,15,41,.366,13,18,.722,128,46,93,.495,33,56,.589,13,37,.351,21,26,.808,126
226,MEM,2021-11-28,128,,SAC,W 128-101,240,50,104,.481,37,65,.569,13,39,.333,15,20,.750,128,33,97,.340,24,55,.436,9,42,.214,26,37,.703,101
227,CHI,2021-11-01,128,@,BOS,W 128-114,240,49,86,.570,36,55,.655,13,31,.419,17,18,.944,128,42,96,.438,27,63,.429,15,33,.455,15,20,.750,114
228,CHI,2021-10-22,128,,NOP,W 128-112,240,47,89,.528,33,61,.541,14,28,.500,20,25,.800,128,42,87,.483,27,58,.466,15,29,.517,13,16,.813,112
229,MIN,2022-04-07,127,,SAS,W 127-121,240,41,96,.427,21,43,.488,20,53,.377,25,31,.806,127,43,89,.483,33,61,.541,10,28,.357,25,34,.735,121
230,MIL,2022-04-07,127,,BOS,W 127-121,240,49,97,.505,35,59,.593,14,38,.368,15,21,.714,127,43,87,.494,22,37,.595,21,50,.420,14,19,.737,121
231,NOP,2022-04-07,127,,POR,W 127-94,240,44,93,.473,31,56,.554,13,37,.351,26,31,.839,127,36,69,.522,25,38,.658,11,31,.355,11,13,.846,94
232,MIL,2022-04-05,127,@,CHI,W 127-106,240,46,87,.529,34,52,.654,12,35,.343,23,25,.920,127,42,98,.429,33,65,.508,9,33,.273,13,13,1.000,106
233,MIA,2022-04-02,127,@,CHI,W 127-109,240,44,82,.537,27,48,.563,17,34,.500,22,27,.815,127,37,86,.430,28,52,.538,9,34,.265,26,29,.897,109
234,WAS,2022-03-30,127,,ORL,W 127-110,240,47,92,.511,34,56,.607,13,36,.361,20,26,.769,127,40,96,.417,29,62,.468,11,34,.324,19,22,.864,110
235,MEM,2022-03-26,127,,MIL,W 127-102,240,49,102,.480,36,65,.554,13,37,.351,16,23,.696,127,37,93,.398,30,61,.492,7,32,.219,21,26,.808,102
236,DEN,2022-03-22,127,,LAC,W 127-115,240,45,83,.542,29,51,.569,16,32,.500,21,23,.913,127,42,86,.488,32,54,.593,10,32,.313,21,26,.808,115
237,PHO,2022-03-20,127,@,SAC,W 127-124 (OT),265,46,92,.500,34,64,.531,12,28,.429,23,27,.852,127,39,91,.429,23,57,.404,16,34,.471,30,36,.833,124
238,WAS,2022-03-19,127,,LAL,W 127-119,240,44,85,.518,31,54,.574,13,31,.419,26,31,.839,127,48,91,.527,35,56,.625,13,35,.371,10,11,.909,119
239,DEN,2022-03-16,127,@,WAS,W 127-109,240,46,90,.511,31,53,.585,15,37,.405,20,21,.952,127,41,87,.471,36,64,.563,5,23,.217,22,31,.710,109
240,POR,2022-03-12,127,,WAS,W 127-118,240,48,93,.516,37,63,.587,11,30,.367,20,22,.909,127,39,83,.470,25,49,.510,14,34,.412,26,27,.963,118
241,TOR,2022-03-12,127,@,DEN,W 127-115,240,48,102,.471,36,71,.507,12,31,.387,19,25,.760,127,43,78,.551,32,51,.627,11,27,.407,18,24,.750,115
242,CLE,2022-03-08,127,@,IND,W 127-124,240,47,94,.500,38,62,.613,9,32,.281,24,27,.889,127,49,91,.538,33,59,.559,16,32,.500,10,15,.667,124
243,HOU,2022-03-02,127,,UTA,L 127-132 (OT),265,43,86,.500,22,35,.629,21,51,.412,20,30,.667,127,50,91,.549,35,49,.714,15,42,.357,17,24,.708,132
244,MIN,2022-02-28,127,@,CLE,W 127-122,240,47,86,.547,29,44,.659,18,42,.429,15,19,.789,127,39,74,.527,24,37,.649,15,37,.405,29,34,.853,122
245,DET,2022-02-27,127,@,CHO,W 127-126 (OT),265,50,110,.455,36,70,.514,14,40,.350,13,18,.722,127,45,89,.506,32,58,.552,13,31,.419,23,34,.676,126
246,ATL,2022-02-26,127,,TOR,W 127-100,240,48,83,.578,35,52,.673,13,31,.419,18,22,.818,127,38,95,.400,28,63,.444,10,32,.313,14,19,.737,100
247,OKC,2022-02-14,127,@,NYK,W 127-123 (OT),265,48,96,.500,35,62,.565,13,34,.382,18,27,.667,127,45,108,.417,30,58,.517,15,50,.300,18,22,.818,123
248,PHO,2022-02-07,127,@,CHI,W 127-124,240,49,90,.544,37,58,.638,12,32,.375,17,19,.895,127,43,90,.478,33,64,.516,10,26,.385,28,31,.903,124
249,TOR,2022-02-03,127,,CHI,W 127-120 (OT),265,48,113,.425,34,77,.442,14,36,.389,17,19,.895,127,43,90,.478,31,61,.508,12,29,.414,22,24,.917,120
250,SAC,2022-01-22,127,@,MIL,L 127-133,240,51,97,.526,36,60,.600,15,37,.405,10,16,.625,127,45,91,.495,24,49,.490,21,42,.500,22,25,.880,133
251,MEM,2022-01-09,127,@,LAL,W 127-119,240,47,86,.547,36,56,.643,11,30,.367,22,32,.688,127,45,97,.464,31,64,.484,14,33,.424,15,19,.789,119
252,MIL,2021-12-28,127,@,ORL,W 127-110,240,47,85,.553,30,48,.625,17,37,.459,16,22,.727,127,38,83,.458,26,44,.591,12,39,.308,22,26,.846,110
253,MEM,2021-12-26,127,@,SAC,W 127-102,240,47,100,.470,38,70,.543,9,30,.300,24,30,.800,127,34,81,.420,24,52,.462,10,29,.345,24,27,.889,102
254,DEN,2021-12-11,127,@,SAS,W 127-112,240,47,93,.505,27,50,.540,20,43,.465,13,14,.929,127,41,89,.461,31,62,.500,10,27,.370,20,29,.690,112
255,PHI,2021-12-06,127,@,CHO,W 127-124 (OT),265,46,87,.529,31,51,.608,15,36,.417,20,27,.741,127,48,107,.449,32,61,.525,16,46,.348,12,17,.706,124
256,ATL,2021-12-05,127,,CHO,L 127-130,240,48,93,.516,31,56,.554,17,37,.459,14,18,.778,127,46,86,.535,29,49,.592,17,37,.459,21,28,.750,130
257,MIL,2021-12-01,127,,CHO,W 127-125,240,46,94,.489,32,58,.552,14,36,.389,21,26,.808,127,43,87,.494,22,36,.611,21,51,.412,18,21,.857,125
258,UTA,2021-11-27,127,,NOP,W 127-105,240,45,80,.563,25,45,.556,20,35,.571,17,22,.773,127,40,93,.430,32,58,.552,8,35,.229,17,21,.810,105
259,NOP,2021-11-24,127,,WAS,W 127-102,240,44,96,.458,32,67,.478,12,29,.414,27,32,.844,127,36,84,.429,29,53,.547,7,31,.226,23,36,.639,102
260,DET,2021-11-13,127,@,TOR,W 127-121,240,43,79,.544,28,44,.636,15,35,.429,26,30,.867,127,44,87,.506,31,53,.585,13,34,.382,20,31,.645,121
261,GSW,2021-11-08,127,,ATL,W 127-113,240,44,92,.478,26,48,.542,18,44,.409,21,22,.955,127,38,82,.463,21,39,.538,17,43,.395,20,26,.769,113
262,MIL,2021-10-19,127,,BRK,W 127-104,240,48,105,.457,31,60,.517,17,45,.378,14,18,.778,127,37,84,.440,20,52,.385,17,32,.531,13,23,.565,104
263,IND,2022-04-10,126,@,BRK,L 126-134,240,47,104,.452,28,58,.483,19,46,.413,13,19,.684,126,52,81,.642,44,59,.746,8,22,.364,22,25,.880,134
264,NOP,2022-03-24,126,,CHI,W 126-109,240,41,83,.494,29,54,.537,12,29,.414,32,34,.941,126,40,78,.513,26,44,.591,14,34,.412,15,19,.789,109
265,PHI,2022-03-23,126,@,LAL,W 126-121,240,47,91,.516,37,64,.578,10,27,.370,22,28,.786,126,50,97,.515,39,67,.582,11,30,.367,10,16,.625,121
266,MIL,2022-03-22,126,,CHI,W 126-98,240,50,82,.610,38,54,.704,12,28,.429,14,20,.700,126,39,92,.424,26,59,.441,13,33,.394,7,13,.538,98
267,BOS,2022-03-18,126,@,SAC,W 126-97,240,46,82,.561,24,42,.571,22,40,.550,12,17,.706,126,33,79,.418,20,43,.465,13,36,.361,18,24,.750,97
268,SAC,2022-03-16,126,,MIL,L 126-135,240,46,94,.489,30,51,.588,16,43,.372,18,21,.857,126,47,89,.528,29,54,.537,18,35,.514,23,32,.719,135
269,GSW,2022-03-14,126,,WAS,W 126-112,240,45,84,.536,27,39,.692,18,45,.400,18,22,.818,126,42,82,.512,32,56,.571,10,26,.385,18,23,.783,112
270,BOS,2022-03-06,126,,BRK,W 126-120,240,40,83,.482,23,47,.489,17,36,.472,29,38,.763,126,45,89,.506,33,62,.532,12,27,.444,18,20,.900,120
271,CHO,2022-02-27,126,,DET,L 126-127 (OT),265,45,89,.506,32,58,.552,13,31,.419,23,34,.676,126,50,110,.455,36,70,.514,14,40,.350,13,18,.722,127
272,BRK,2022-02-26,126,@,MIL,W 126-123,240,44,92,.478,31,58,.534,13,34,.382,25,33,.758,126,41,78,.526,25,40,.625,16,38,.421,25,38,.658,123
273,MIN,2022-02-15,126,,CHO,W 126-120 (OT),265,43,109,.394,30,54,.556,13,55,.236,27,43,.628,126,42,102,.412,34,69,.493,8,33,.242,28,37,.757,120
274,BOS,2022-02-08,126,@,BRK,W 126-91,240,50,91,.549,36,51,.706,14,40,.350,12,16,.750,126,38,99,.384,28,63,.444,10,36,.278,5,13,.385,91
275,GSW,2022-02-03,126,,SAC,W 126-114,240,47,84,.560,27,42,.643,20,42,.476,12,16,.750,126,42,80,.525,31,49,.633,11,31,.355,19,23,.826,114
276,CHI,2022-02-01,126,,ORL,W 126-115,240,46,90,.511,35,60,.583,11,30,.367,23,29,.793,126,46,93,.495,32,54,.593,14,39,.359,9,11,.818,115
277,MIN,2022-01-30,126,,UTA,W 126-106,240,49,89,.551,36,58,.621,13,31,.419,15,18,.833,126,38,81,.469,23,41,.561,15,40,.375,15,21,.714,106
278,IND,2022-01-26,126,,CHO,L 126-158,240,44,92,.478,34,58,.586,10,34,.294,28,34,.824,126,54,93,.581,30,48,.625,24,45,.533,26,33,.788,158
279,MIL,2022-01-19,126,,MEM,W 126-114,240,46,97,.474,33,60,.550,13,37,.351,21,22,.955,126,44,106,.415,35,66,.530,9,40,.225,17,25,.680,114
280,SAC,2022-01-14,126,,HOU,W 126-114,240,48,96,.500,35,59,.593,13,37,.351,17,24,.708,126,44,101,.436,31,58,.534,13,43,.302,13,16,.813,114
281,DET,2022-01-10,126,,UTA,W 126-116,240,48,93,.516,29,56,.518,19,37,.514,11,12,.917,126,44,86,.512,33,53,.623,11,33,.333,17,22,.773,116
282,MIL,2021-12-22,126,,HOU,W 126-106,240,45,103,.437,28,57,.491,17,46,.370,19,21,.905,126,36,86,.419,23,41,.561,13,45,.289,21,31,.677,106
283,UTA,2021-12-17,126,,SAS,L 126-128,240,46,93,.495,33,56,.589,13,37,.351,21,26,.808,126,50,100,.500,35,59,.593,15,41,.366,13,18,.722,128
284,ATL,2021-12-13,126,,HOU,L 126-132,240,42,85,.494,27,46,.587,15,39,.385,27,31,.871,126,46,96,.479,27,50,.540,19,46,.413,21,27,.778,132
285,MEM,2021-12-13,126,,PHI,W 126-91,240,47,89,.528,33,55,.600,14,34,.412,18,23,.783,126,37,83,.446,33,61,.541,4,22,.182,13,19,.684,91
286,GSW,2021-12-06,126,,ORL,W 126-95,240,43,87,.494,23,47,.489,20,40,.500,20,29,.690,126,33,76,.434,22,38,.579,11,38,.289,18,22,.818,95
287,TOR,2021-11-24,126,@,MEM,W 126-113,240,47,89,.528,33,59,.559,14,30,.467,18,21,.857,126,42,82,.512,33,53,.623,9,29,.310,20,26,.769,113
288,PHO,2021-11-21,126,,DEN,W 126-97,240,46,87,.529,35,51,.686,11,36,.306,23,26,.885,126,33,90,.367,22,52,.423,11,38,.289,20,28,.714,97
289,LAL,2021-11-08,126,,CHO,W 126-123 (OT),265,44,91,.484,31,59,.525,13,32,.406,25,35,.714,126,43,99,.434,29,57,.509,14,42,.333,23,28,.821,123
290,CLE,2021-11-07,126,@,NYK,W 126-109,240,49,90,.544,30,55,.545,19,35,.543,9,11,.818,126,39,85,.459,30,54,.556,9,31,.290,22,24,.917,109
291,GSW,2021-11-05,126,,NOP,W 126-85,240,47,91,.516,27,41,.659,20,50,.400,12,14,.857,126,31,88,.352,20,44,.455,11,44,.250,12,16,.750,85
292,LAC,2021-11-03,126,@,MIN,W 126-115,240,47,78,.603,26,42,.619,21,36,.583,11,12,.917,126,43,94,.457,29,54,.537,14,40,.350,15,16,.938,115
293,ORL,2022-04-10,125,,MIA,W 125-111,240,45,91,.495,22,33,.667,23,58,.397,12,14,.857,125,40,94,.426,21,44,.477,19,50,.380,12,16,.750,111
294,TOR,2022-03-30,125,,MIN,W 125-102,240,48,96,.500,30,60,.500,18,36,.500,11,15,.733,125,37,92,.402,26,55,.473,11,37,.297,17,23,.739,102
295,DEN,2022-03-30,125,@,IND,W 125-118,240,50,80,.625,38,52,.731,12,28,.429,13,14,.929,125,44,97,.454,32,57,.561,12,40,.300,18,23,.783,118
296,CHO,2022-03-30,125,@,NYK,W 125-114,240,49,90,.544,37,55,.673,12,35,.343,15,17,.882,125,40,85,.471,24,41,.585,16,44,.364,18,26,.692,114
297,HOU,2022-03-25,125,@,POR,W 125-106,240,43,83,.518,24,38,.632,19,45,.422,20,23,.870,125,43,85,.506,40,65,.615,3,20,.150,17,23,.739,106
298,BOS,2022-03-23,125,,UTA,W 125-97,240,50,84,.595,31,48,.646,19,36,.528,6,7,.857,125,35,88,.398,27,52,.519,8,36,.222,19,21,.905,97
299,PHO,2022-03-23,125,@,MIN,W 125-116,240,45,86,.523,33,53,.623,12,33,.364,23,29,.793,125,42,95,.442,29,52,.558,13,43,.302,19,22,.864,116
300,UTA,2022-03-16,125,,CHI,W 125-110,240,42,83,.506,23,44,.523,19,39,.487,22,29,.759,125,43,91,.473,31,57,.544,12,34,.353,12,17,.706,110
301,MEM,2022-03-13,125,@,OKC,W 125-118,240,48,102,.471,37,73,.507,11,29,.379,18,20,.900,125,41,97,.423,28,56,.500,13,41,.317,23,28,.821,118
302,SAC,2022-03-12,125,@,UTA,L 125-134,240,47,94,.500,34,61,.557,13,33,.394,18,21,.857,125,48,86,.558,32,45,.711,16,41,.390,22,31,.710,134
303,PHI,2022-03-04,125,,CLE,W 125-119,240,41,75,.547,27,42,.643,14,33,.424,29,32,.906,125,44,82,.537,34,54,.630,10,28,.357,21,24,.875,119
304,NOP,2022-03-02,125,,SAC,W 125-95,240,52,88,.591,41,59,.695,11,29,.379,10,12,.833,125,35,89,.393,27,54,.500,8,35,.229,17,25,.680,95
305,PHI,2022-02-27,125,@,NYK,W 125-109,240,38,78,.487,28,45,.622,10,33,.303,39,44,.886,125,38,85,.447,27,52,.519,11,33,.333,22,35,.629,109
306,CHO,2022-02-25,125,,TOR,W 125-93,240,52,94,.553,37,54,.685,15,40,.375,6,9,.667,125,37,84,.440,31,61,.508,6,23,.261,13,23,.565,93
307,IND,2022-02-25,125,,OKC,L 125-129 (OT),265,49,101,.485,35,64,.547,14,37,.378,13,22,.591,125,50,101,.495,39,70,.557,11,31,.355,18,24,.750,129
308,DAL,2022-02-17,125,@,NOP,W 125-118,240,44,82,.537,25,42,.595,19,40,.475,18,25,.720,125,46,92,.500,34,64,.531,12,28,.429,14,21,.667,118
309,CHI,2022-02-16,125,,SAC,W 125-118,240,47,94,.500,35,65,.538,12,29,.414,19,20,.950,125,43,84,.512,31,54,.574,12,30,.400,20,22,.909,118
310,MEM,2022-02-12,125,@,CHO,W 125-118,240,47,96,.490,36,63,.571,11,33,.333,20,33,.606,125,39,97,.402,25,52,.481,14,45,.311,26,33,.788,118
311,TOR,2022-02-04,125,,ATL,W 125-114,240,46,81,.568,29,54,.537,17,27,.630,16,18,.889,125,43,93,.462,34,64,.531,9,29,.310,19,21,.905,114
312,UTA,2022-02-04,125,,BRK,W 125-102,240,48,85,.565,31,47,.660,17,38,.447,12,14,.857,125,41,99,.414,29,65,.446,12,34,.353,8,11,.727,102
313,POR,2022-01-28,125,@,HOU,W 125-110,240,46,81,.568,29,42,.690,17,39,.436,16,20,.800,125,38,79,.481,28,38,.737,10,41,.244,24,31,.774,110
314,TOR,2022-01-25,125,,CHO,W 125-113,240,43,82,.524,27,48,.563,16,34,.471,23,29,.793,125,40,82,.488,30,51,.588,10,31,.323,23,32,.719,113
315,BRK,2022-01-23,125,@,MIN,L 125-136,240,48,95,.505,33,57,.579,15,38,.395,14,15,.933,125,48,92,.522,34,60,.567,14,32,.438,26,31,.839,136
316,UTA,2022-01-16,125,@,DEN,W 125-102,240,44,84,.524,29,45,.644,15,39,.385,22,29,.759,125,42,95,.442,31,52,.596,11,43,.256,7,8,.875,102
317,SAC,2022-01-12,125,,LAL,W 125-116,240,49,89,.551,38,59,.644,11,30,.367,16,19,.842,125,42,98,.429,26,51,.510,16,47,.340,16,24,.667,116
318,MIN,2022-01-11,125,@,NOP,L 125-128,240,42,86,.488,24,47,.511,18,39,.462,23,31,.742,125,42,76,.553,26,43,.605,16,33,.485,28,37,.757,128
319,IND,2022-01-08,125,,UTA,W 125-113,240,44,80,.550,30,51,.588,14,29,.483,23,32,.719,125,40,84,.476,25,49,.510,15,35,.429,18,19,.947,113
320,MIA,2021-12-21,125,,IND,W 125-96,240,47,95,.495,25,46,.543,22,49,.449,9,11,.818,125,31,87,.356,20,56,.357,11,31,.355,23,28,.821,96
321,POR,2021-12-17,125,,CHO,W 125-116,240,44,85,.518,23,38,.605,21,47,.447,16,18,.889,125,44,92,.478,31,55,.564,13,37,.351,15,18,.833,116
322,CHO,2021-12-01,125,@,MIL,L 125-127,240,43,87,.494,22,36,.611,21,51,.412,18,21,.857,125,46,94,.489,32,58,.552,14,36,.389,21,26,.808,127
323,SAC,2021-11-24,125,,POR,W 125-121,240,45,86,.523,33,53,.623,12,33,.364,23,34,.676,125,44,94,.468,32,56,.571,12,38,.316,21,25,.840,121
324,MEM,2021-11-08,125,,MIN,W 125-118 (OT),265,46,92,.500,35,64,.547,11,28,.393,22,26,.846,125,41,97,.423,24,52,.462,17,45,.378,19,23,.826,118
325,MIA,2021-11-02,125,@,DAL,W 125-110,240,43,83,.518,30,58,.517,13,25,.520,26,30,.867,125,37,84,.440,23,42,.548,14,42,.333,22,31,.710,110
326,CHO,2021-10-31,125,,POR,W 125-113,240,46,89,.517,26,47,.553,20,42,.476,13,21,.619,125,43,97,.443,26,43,.605,17,54,.315,10,11,.909,113
327,LAL,2021-10-26,125,@,SAS,W 125-121 (OT),265,50,105,.476,42,75,.560,8,30,.267,17,22,.773,125,48,108,.444,35,72,.486,13,36,.361,12,22,.545,121
328,CHI,2022-04-10,124,@,MIN,W 124-120,240,44,83,.530,34,62,.548,10,21,.476,26,33,.788,124,46,91,.505,35,60,.583,11,31,.355,17,22,.773,120
329,CHO,2022-04-10,124,,WAS,W 124-108,240,48,89,.539,30,56,.536,18,33,.545,10,14,.714,124,42,94,.447,34,71,.479,8,23,.348,16,26,.615,108
330,BOS,2022-03-20,124,@,DEN,W 124-104,240,47,82,.573,28,42,.667,19,40,.475,11,11,1.000,124,35,87,.402,21,48,.438,14,39,.359,20,25,.800,104
331,SAC,2022-03-20,124,,PHO,L 124-127 (OT),265,39,91,.429,23,57,.404,16,34,.471,30,36,.833,124,46,92,.500,34,64,.531,12,28,.429,23,27,.852,127
332,NOP,2022-03-18,124,@,SAS,W 124-91,240,48,96,.500,34,62,.548,14,34,.412,14,18,.778,124,32,89,.360,21,45,.467,11,44,.250,16,20,.800,91
333,MIN,2022-03-16,124,,LAL,W 124-104,240,40,90,.444,23,48,.479,17,42,.405,27,31,.871,124,39,93,.419,29,49,.592,10,44,.227,16,23,.696,104
334,MIL,2022-03-09,124,,ATL,W 124-115,240,47,94,.500,35,59,.593,12,35,.343,18,23,.783,124,43,86,.500,32,48,.667,11,38,.289,18,22,.818,115
335,IND,2022-03-08,124,,CLE,L 124-127,240,49,91,.538,33,59,.559,16,32,.500,10,15,.667,124,47,94,.500,38,62,.613,9,32,.281,24,27,.889,127
336,MIN,2022-03-07,124,,POR,W 124-81,240,38,92,.413,25,49,.510,13,43,.302,35,44,.795,124,23,83,.277,16,55,.291,7,28,.250,28,38,.737,81
337,GSW,2022-03-07,124,@,DEN,L 124-131,240,45,88,.511,28,48,.583,17,40,.425,17,23,.739,124,46,84,.548,36,52,.692,10,32,.313,29,41,.707,131
338,LAL,2022-03-05,124,,GSW,W 124-116,240,44,89,.494,26,48,.542,18,41,.439,18,21,.857,124,46,92,.500,31,58,.534,15,34,.441,9,19,.474,116
339,MEM,2022-03-05,124,,ORL,W 124-96,240,46,92,.500,32,58,.552,14,34,.412,18,27,.667,124,37,86,.430,26,51,.510,11,35,.314,11,16,.688,96
340,NOP,2022-03-04,124,,UTA,W 124-90,240,50,97,.515,39,61,.639,11,36,.306,13,17,.765,124,31,89,.348,20,48,.417,11,41,.268,17,26,.654,90
341,CHI,2022-03-03,124,@,ATL,L 124-130,240,52,88,.591,38,62,.613,14,26,.538,6,7,.857,124,44,84,.524,26,44,.591,18,40,.450,24,28,.857,130
342,DEN,2022-02-27,124,@,POR,W 124-92,240,44,86,.512,32,49,.653,12,37,.324,24,31,.774,124,34,91,.374,28,55,.509,6,36,.167,18,26,.692,92
343,PHO,2022-02-24,124,@,OKC,W 124-104,240,46,86,.535,33,52,.635,13,34,.382,19,21,.905,124,44,93,.473,38,62,.613,6,31,.194,10,11,.909,104
344,PHO,2022-02-16,124,,HOU,W 124-121,240,44,86,.512,37,62,.597,7,24,.292,29,36,.806,124,42,97,.433,29,53,.547,13,44,.295,24,28,.857,121
345,ATL,2022-02-15,124,,CLE,W 124-116,240,43,80,.538,29,47,.617,14,33,.424,24,27,.889,124,45,88,.511,29,47,.617,16,41,.390,10,12,.833,116
346,SAS,2022-02-12,124,@,NOP,W 124-114,240,47,93,.505,33,56,.589,14,37,.378,16,19,.842,124,43,87,.494,32,55,.582,11,32,.344,17,20,.850,114
347,CHI,2022-02-07,124,,PHO,L 124-127,240,43,90,.478,33,64,.516,10,26,.385,28,31,.903,124,49,90,.544,37,58,.638,12,32,.375,17,19,.895,127
348,DEN,2022-02-06,124,,BRK,W 124-104,240,49,94,.521,39,62,.629,10,32,.313,16,21,.762,124,36,87,.414,20,46,.435,16,41,.390,16,22,.727,104
349,ATL,2022-02-03,124,,PHO,W 124-115,240,44,84,.524,24,44,.545,20,40,.500,16,22,.727,124,46,88,.523,37,56,.661,9,32,.281,14,18,.778,115
350,GSW,2022-02-01,124,@,SAS,W 124-120,240,43,96,.448,23,50,.460,20,46,.435,18,18,1.000,124,46,83,.554,30,50,.600,16,33,.485,12,17,.706,120
351,TOR,2022-01-29,124,@,MIA,W 124-120 (3OT),315,47,107,.439,31,62,.500,16,45,.356,14,18,.778,124,45,110,.409,29,60,.483,16,50,.320,14,20,.700,120
352,MIN,2022-01-28,124,@,PHO,L 124-134,240,44,90,.489,30,51,.588,14,39,.359,22,27,.815,124,43,84,.512,23,45,.511,20,39,.513,28,37,.757,134
353,GSW,2022-01-27,124,,MIN,W 124-115,240,44,82,.537,23,46,.500,21,36,.583,15,21,.714,124,42,95,.442,32,51,.627,10,44,.227,21,27,.778,115
354,DEN,2022-01-26,124,@,BRK,W 124-118,240,42,89,.472,27,53,.509,15,36,.417,25,27,.926,124,43,88,.489,31,59,.525,12,29,.414,20,26,.769,118
355,MIA,2022-01-14,124,,ATL,W 124-118,240,41,77,.532,27,47,.574,14,30,.467,28,30,.933,124,38,79,.481,22,41,.537,16,38,.421,26,30,.867,118
356,SAS,2022-01-12,124,,HOU,L 124-128,240,43,99,.434,26,53,.491,17,46,.370,21,27,.778,124,45,82,.549,29,46,.630,16,36,.444,22,32,.688,128
357,WAS,2022-01-03,124,,CHO,W 124-121,240,40,87,.460,24,49,.490,16,38,.421,28,31,.903,124,50,104,.481,36,66,.545,14,38,.368,7,13,.538,121
358,DEN,2022-01-01,124,@,HOU,W 124-111,240,46,86,.535,36,54,.667,10,32,.313,22,27,.815,124,37,85,.435,21,43,.488,16,42,.381,21,24,.875,111
359,BRK,2021-12-27,124,@,LAC,W 124-108,240,50,88,.568,37,54,.685,13,34,.382,11,16,.688,124,37,97,.381,23,60,.383,14,37,.378,20,27,.741,108
360,WAS,2021-12-23,124,@,NYK,W 124-117,240,42,75,.560,26,38,.684,16,37,.432,24,32,.750,124,42,93,.452,29,51,.569,13,42,.310,20,23,.870,117
361,MEM,2021-12-17,124,@,SAC,W 124-105,240,45,97,.464,32,73,.438,13,24,.542,21,27,.778,124,36,88,.409,23,53,.434,13,35,.371,20,26,.769,105
362,MIN,2021-12-15,124,@,DEN,W 124-107,240,45,88,.511,22,40,.550,23,48,.479,11,16,.688,124,38,84,.452,24,45,.533,14,39,.359,17,23,.739,107
363,UTA,2021-12-15,124,,LAC,W 124-103,240,47,89,.528,32,52,.615,15,37,.405,15,20,.750,124,40,85,.471,30,55,.545,10,30,.333,13,20,.650,103
364,CLE,2021-12-15,124,,HOU,W 124-89,240,45,80,.563,27,40,.675,18,40,.450,16,24,.667,124,30,78,.385,25,49,.510,5,29,.172,24,35,.686,89
365,TOR,2021-12-13,124,,SAC,W 124-101,240,53,98,.541,42,67,.627,11,31,.355,7,10,.700,124,38,94,.404,27,60,.450,11,34,.324,14,21,.667,101
366,CHO,2021-12-10,124,,SAC,W 124-123,240,48,87,.552,34,52,.654,14,35,.400,14,20,.700,124,48,101,.475,34,60,.567,14,41,.341,13,17,.765,123
367,CHO,2021-12-06,124,,PHI,L 124-127 (OT),265,48,107,.449,32,61,.525,16,46,.348,12,17,.706,124,46,87,.529,31,51,.608,15,36,.417,20,27,.741,127
368,MIL,2021-12-04,124,,MIA,W 124-102,240,44,98,.449,26,48,.542,18,50,.360,18,20,.900,124,34,84,.405,17,41,.415,17,43,.395,17,24,.708,102
369,SAC,2021-12-01,124,@,LAC,W 124-115,240,46,88,.523,31,50,.620,15,38,.395,17,20,.850,124,47,100,.470,38,69,.551,9,31,.290,12,16,.750,115
370,ATL,2021-11-24,124,@,SAS,W 124-106,240,45,88,.511,33,62,.532,12,26,.462,22,24,.917,124,43,100,.430,31,67,.463,12,33,.364,8,10,.800,106
371,LAL,2021-11-24,124,@,IND,W 124-116 (OT),265,42,95,.442,27,58,.466,15,37,.405,25,29,.862,124,42,104,.404,29,58,.500,13,46,.283,19,24,.792,116
372,DEN,2021-11-14,124,,POR,W 124-95,240,47,90,.522,28,50,.560,19,40,.475,11,14,.786,124,35,80,.438,22,41,.537,13,39,.333,12,13,.923,95
373,HOU,2021-10-22,124,,OKC,W 124-91,240,48,95,.505,31,57,.544,17,38,.447,11,14,.786,124,34,91,.374,20,48,.417,14,43,.326,9,16,.563,91
374,MIN,2021-10-20,124,,HOU,W 124-106,240,42,87,.483,26,49,.531,16,38,.421,24,31,.774,124,40,88,.455,29,55,.527,11,33,.333,15,22,.682,106
375,SAC,2021-10-20,124,@,POR,W 124-121,240,42,92,.457,25,51,.490,17,41,.415,23,29,.793,124,45,93,.484,33,58,.569,12,35,.343,19,22,.864,121
376,NOP,2022-04-05,123,@,SAC,W 123-109,240,45,88,.511,33,63,.524,12,25,.480,21,26,.808,123,39,76,.513,28,46,.609,11,30,.367,20,22,.909,109
377,IND,2022-04-01,123,@,BOS,L 123-128,240,42,81,.519,25,45,.556,17,36,.472,22,23,.957,123,45,83,.542,33,50,.660,12,33,.364,26,28,.929,128
378,DET,2022-03-29,123,@,BRK,L 123-130,240,48,99,.485,32,61,.525,16,38,.421,11,13,.846,123,42,76,.553,27,48,.563,15,28,.536,31,34,.912,130
379,SAS,2022-03-28,123,@,HOU,W 123-120,240,47,100,.470,40,71,.563,7,29,.241,22,28,.786,123,38,92,.413,18,43,.419,20,49,.408,24,28,.857,120
380,MEM,2022-03-28,123,,GSW,W 123-95,240,43,92,.467,31,62,.500,12,30,.400,25,35,.714,123,33,81,.407,24,52,.462,9,29,.310,20,26,.769,95
381,MIA,2022-03-28,123,,SAC,W 123-100,240,49,90,.544,30,50,.600,19,40,.475,6,6,1.000,123,37,81,.457,25,46,.543,12,35,.343,14,18,.778,100
382,IND,2022-03-28,123,,ATL,L 123-132,240,45,87,.517,28,51,.549,17,36,.472,16,18,.889,123,47,86,.547,30,51,.588,17,35,.486,21,26,.808,132
383,WAS,2022-03-27,123,,GSW,W 123-115,240,44,84,.524,28,56,.500,16,28,.571,19,22,.864,123,38,89,.427,30,56,.536,8,33,.242,31,39,.795,115
384,OKC,2022-03-21,123,,BOS,L 123-132,240,48,93,.516,31,56,.554,17,37,.459,10,14,.714,123,44,86,.512,29,46,.630,15,40,.375,29,34,.853,132
385,POR,2022-03-18,123,@,BRK,L 123-128,240,48,96,.500,35,61,.574,13,35,.371,14,24,.583,123,45,77,.584,35,52,.673,10,25,.400,28,33,.848,128
386,TOR,2022-03-18,123,,LAL,L 123-128 (OT),265,49,97,.505,37,60,.617,12,37,.324,13,20,.650,123,47,96,.490,28,53,.528,19,43,.442,15,21,.714,128
387,UTA,2022-03-09,123,,POR,W 123-85,240,42,81,.519,25,35,.714,17,46,.370,22,27,.815,123,29,89,.326,20,53,.377,9,36,.250,18,22,.818,85
388,MIA,2022-03-07,123,,HOU,W 123-106,240,49,91,.538,35,60,.583,14,31,.452,11,14,.786,123,39,88,.443,26,45,.578,13,43,.302,15,22,.682,106
389,IND,2022-03-06,123,@,WAS,L 123-133,240,44,85,.518,34,54,.630,10,31,.323,25,29,.862,123,45,86,.523,28,44,.636,17,42,.405,26,32,.813,133
390,HOU,2022-03-06,123,,MEM,W 123-112,240,43,82,.524,30,48,.625,13,34,.382,24,36,.667,123,44,97,.454,39,71,.549,5,26,.192,19,27,.704,112
391,CHO,2022-03-05,123,,SAS,W 123-117,240,42,91,.462,26,49,.531,16,42,.381,23,29,.793,123,45,98,.459,34,61,.557,11,37,.297,16,20,.800,117
392,PHI,2022-03-02,123,,NYK,W 123-108,240,39,75,.520,22,39,.564,17,36,.472,28,33,.848,123,39,91,.429,31,63,.492,8,28,.286,22,32,.688,108
393,NOP,2022-02-27,123,@,LAL,W 123-95,240,47,92,.511,34,62,.548,13,30,.433,16,25,.640,123,35,84,.417,28,50,.560,7,34,.206,18,20,.900,95
394,MIL,2022-02-26,123,,BRK,L 123-126,240,41,78,.526,25,40,.625,16,38,.421,25,38,.658,123,44,92,.478,31,58,.534,13,34,.382,25,33,.758,126
395,PHI,2022-02-17,123,@,MIL,W 123-120,240,44,88,.500,32,54,.593,12,34,.353,23,27,.852,123,42,95,.442,28,51,.549,14,44,.318,22,28,.786,120
396,POR,2022-02-16,123,@,MEM,W 123-119,240,43,85,.506,30,53,.566,13,32,.406,24,32,.750,123,37,85,.435,26,55,.473,11,30,.367,34,42,.810,119
397,NYK,2022-02-14,123,,OKC,L 123-127 (OT),265,45,108,.417,30,58,.517,15,50,.300,18,22,.818,123,48,96,.500,35,62,.565,13,34,.382,18,27,.667,127
398,SAC,2022-02-12,123,@,WAS,W 123-110,240,43,76,.566,31,48,.646,12,28,.429,25,29,.862,123,41,88,.466,28,50,.560,13,38,.342,15,21,.714,110
399,MIL,2022-01-28,123,,NYK,W 123-108,240,41,89,.461,27,46,.587,14,43,.326,27,31,.871,123,39,84,.464,25,44,.568,14,40,.350,16,28,.571,108
400,PHI,2022-01-19,123,,ORL,W 123-110,240,45,83,.542,35,55,.636,10,28,.357,23,27,.852,123,40,90,.444,22,55,.400,18,35,.514,12,16,.750,110
401,HOU,2022-01-09,123,,MIN,L 123-141,240,46,97,.474,32,54,.593,14,43,.326,17,28,.607,123,55,108,.509,40,66,.606,15,42,.357,16,21,.762,141
402,MEM,2022-01-08,123,@,LAC,W 123-108,240,44,100,.440,32,62,.516,12,38,.316,23,31,.742,123,39,96,.406,29,64,.453,10,32,.313,20,24,.833,108
403,MIA,2022-01-08,123,@,PHO,W 123-100,240,44,88,.500,22,44,.500,22,44,.500,13,15,.867,123,30,79,.380,16,45,.356,14,34,.412,26,29,.897,100
404,PHO,2022-01-04,123,@,NOP,W 123-110,240,46,85,.541,29,54,.537,17,31,.548,14,20,.700,123,36,89,.404,26,56,.464,10,33,.303,28,32,.875,110
405,GSW,2022-01-01,123,@,UTA,W 123-116,240,46,86,.535,29,54,.537,17,32,.531,14,21,.667,123,40,92,.435,26,48,.542,14,44,.318,22,28,.786,116
406,BOS,2021-12-31,123,,PHO,W 123-108,240,45,83,.542,35,56,.625,10,27,.370,23,26,.885,123,41,100,.410,30,65,.462,11,35,.314,15,16,.938,108
407,HOU,2021-12-28,123,,LAL,L 123-132,240,44,83,.530,28,48,.583,16,35,.457,19,25,.760,123,48,92,.522,34,58,.586,14,34,.412,22,29,.759,132
408,CHO,2021-12-27,123,,HOU,W 123-99,240,47,88,.534,29,47,.617,18,41,.439,11,14,.786,123,36,87,.414,21,41,.512,15,46,.326,12,18,.667,99
409,UTA,2021-12-11,123,@,WAS,W 123-98,240,48,93,.516,35,54,.648,13,39,.333,14,17,.824,123,41,89,.461,33,64,.516,8,25,.320,8,14,.571,98
410,CLE,2021-12-10,123,@,MIN,W 123-106,240,46,85,.541,33,52,.635,13,33,.394,18,22,.818,123,36,92,.391,25,53,.472,11,39,.282,23,28,.821,106
411,MIL,2021-12-10,123,@,HOU,W 123-114,240,42,83,.506,27,44,.614,15,39,.385,24,32,.750,123,42,89,.472,23,43,.535,19,46,.413,11,20,.550,114
412,SAC,2021-12-10,123,@,CHO,L 123-124,240,48,101,.475,34,60,.567,14,41,.341,13,17,.765,123,48,87,.552,34,52,.654,14,35,.400,14,20,.700,124
413,SAS,2021-12-09,123,,DEN,W 123-111,240,46,88,.523,31,53,.585,15,35,.429,16,22,.727,123,42,94,.447,27,55,.491,15,39,.385,12,13,.923,111
414,NOP,2021-11-29,123,@,LAC,W 123-104,240,48,94,.511,34,59,.576,14,35,.400,13,16,.813,123,37,72,.514,23,36,.639,14,36,.389,16,21,.762,104
415,CHI,2021-11-26,123,@,ORL,W 123-88,240,48,86,.558,31,52,.596,17,34,.500,10,16,.625,123,30,80,.375,23,48,.479,7,32,.219,21,30,.700,88
416,BRK,2021-11-24,123,@,BOS,W 123-104,240,43,85,.506,29,50,.580,14,35,.400,23,30,.767,123,34,91,.374,23,43,.535,11,48,.229,25,28,.893,104
417,MIL,2021-11-22,123,,ORL,W 123-92,240,44,94,.468,26,49,.531,18,45,.400,17,24,.708,123,34,93,.366,23,52,.442,11,41,.268,13,18,.722,92
418,UTA,2021-11-20,123,@,SAC,W 123-105,240,46,91,.505,29,52,.558,17,39,.436,14,17,.824,123,41,91,.451,31,60,.517,10,31,.323,13,21,.619,105
419,DAL,2021-11-12,123,@,SAS,W 123-109,240,46,100,.460,28,55,.509,18,45,.400,13,19,.684,123,41,84,.488,28,54,.519,13,30,.433,14,20,.700,109
420,GSW,2021-11-10,123,,MIN,W 123-110,240,40,85,.471,29,45,.644,11,40,.275,32,40,.800,123,39,95,.411,22,51,.431,17,44,.386,15,20,.750,110
421,BRK,2021-11-10,123,@,ORL,W 123-90,240,46,91,.505,30,54,.556,16,37,.432,15,17,.882,123,35,92,.380,31,59,.525,4,33,.121,16,24,.667,90
422,CHO,2021-11-08,123,@,LAL,L 123-126 (OT),265,43,99,.434,29,57,.509,14,42,.333,23,28,.821,123,44,91,.484,31,59,.525,13,32,.406,25,35,.714,126
423,PHO,2021-11-04,123,,HOU,W 123-111,240,44,93,.473,30,62,.484,14,31,.452,21,23,.913,123,38,88,.432,27,56,.482,11,32,.344,24,28,.857,111
424,NYK,2021-10-30,123,@,NOP,W 123-117,240,42,81,.519,23,48,.479,19,33,.576,20,25,.800,123,42,92,.457,31,59,.525,11,33,.333,22,24,.917,117
425,OKC,2021-10-27,123,,LAL,W 123-115,240,43,86,.500,28,49,.571,15,37,.405,22,29,.759,123,46,92,.500,35,57,.614,11,35,.314,12,14,.857,115
426,CHO,2021-10-22,123,@,CLE,W 123-112,240,48,91,.527,35,59,.593,13,32,.406,14,17,.824,123,43,84,.512,34,53,.642,9,31,.290,17,20,.850,112
427,SAS,2021-10-20,123,,ORL,W 123-97,240,49,98,.500,36,68,.529,13,30,.433,12,18,.667,123,35,86,.407,26,57,.456,9,29,.310,18,23,.783,97
428,CHO,2021-10-20,123,,IND,W 123-122,240,46,107,.430,33,76,.434,13,31,.419,18,27,.667,123,42,90,.467,25,43,.581,17,47,.362,21,24,.875,122
429,DEN,2022-04-07,122,,MEM,W 122-109,240,44,80,.550,32,50,.640,12,30,.400,22,25,.880,122,42,89,.472,31,61,.508,11,28,.393,14,19,.737,109
430,IND,2022-04-05,122,,PHI,L 122-131,240,45,95,.474,33,55,.600,12,40,.300,20,21,.952,122,47,87,.540,24,47,.511,23,40,.575,14,18,.778,131
431,ATL,2022-04-02,122,,BRK,W 122-115,240,36,86,.419,23,45,.511,13,41,.317,37,49,.755,122,42,99,.424,25,62,.403,17,37,.459,14,19,.737,115
432,SAC,2022-04-01,122,@,HOU,W 122-117,240,42,81,.519,30,53,.566,12,28,.429,26,34,.765,122,41,97,.423,24,52,.462,17,45,.378,18,26,.692,117
433,MEM,2022-04-01,122,,PHO,W 122-114,240,46,102,.451,39,78,.500,7,24,.292,23,28,.821,122,47,86,.547,37,59,.627,10,27,.370,10,17,.588,114
434,UTA,2022-03-31,122,,LAL,W 122-109,240,46,90,.511,31,46,.674,15,44,.341,15,24,.625,122,41,83,.494,34,58,.586,7,25,.280,20,28,.714,109
435,PHI,2022-03-25,122,@,LAC,W 122-97,240,43,92,.467,28,57,.491,15,35,.429,21,24,.875,122,34,85,.400,26,60,.433,8,25,.320,21,25,.840,97
436,DET,2022-03-23,122,,ATL,W 122-101,240,44,88,.500,32,55,.582,12,33,.364,22,25,.880,122,37,92,.402,23,48,.479,14,44,.318,13,15,.867,101
437,MEM,2022-03-20,122,@,HOU,W 122-98,240,46,96,.479,30,62,.484,16,34,.471,14,17,.824,122,37,86,.430,27,55,.491,10,31,.323,14,24,.583,98
438,SAS,2022-03-16,122,,OKC,W 122-120,240,43,98,.439,24,57,.421,19,41,.463,17,20,.850,122,43,82,.524,30,47,.638,13,35,.371,21,29,.724,120
439,ATL,2022-03-14,122,,POR,W 122-113,240,40,109,.367,28,61,.459,12,48,.250,30,32,.938,122,44,88,.500,34,64,.531,10,24,.417,15,21,.714,113
440,GSW,2022-03-12,122,,MIL,W 122-109,240,45,93,.484,27,48,.563,18,45,.400,14,15,.933,122,38,92,.413,21,48,.438,17,44,.386,16,23,.696,109
441,LAL,2022-03-11,122,,WAS,W 122-109,240,48,91,.527,34,60,.567,14,31,.452,12,17,.706,122,39,85,.459,30,58,.517,9,27,.333,22,33,.667,109
442,PHO,2022-03-06,122,@,MIL,L 122-132,240,50,93,.538,36,62,.581,14,31,.452,8,11,.727,122,47,87,.540,32,55,.582,15,32,.469,23,29,.793,132
443,DAL,2022-03-03,122,,GSW,W 122-113,240,45,85,.529,28,48,.583,17,37,.459,15,20,.750,122,44,81,.543,29,51,.569,15,30,.500,10,13,.769,113
444,IND,2022-03-02,122,@,ORL,W 122-114 (OT),265,41,94,.436,29,57,.509,12,37,.324,28,35,.800,122,44,97,.454,34,65,.523,10,32,.313,16,20,.800,114
445,CLE,2022-02-28,122,,MIN,L 122-127,240,39,74,.527,24,37,.649,15,37,.405,29,34,.853,122,47,86,.547,29,44,.659,18,42,.429,15,19,.789,127
446,POR,2022-02-14,122,@,MIL,W 122-107,240,45,99,.455,27,56,.482,18,43,.419,14,19,.737,122,38,89,.427,25,48,.521,13,41,.317,18,24,.750,107
447,MIN,2022-02-11,122,@,CHI,L 122-134,240,48,96,.500,35,56,.625,13,40,.325,13,16,.813,122,55,87,.632,41,56,.732,14,31,.452,10,13,.769,134
448,LAL,2022-02-05,122,,NYK,W 122-115 (OT),265,48,102,.471,39,68,.574,9,34,.265,17,28,.607,122,39,98,.398,28,60,.467,11,38,.289,26,36,.722,115
449,CHI,2022-02-04,122,@,IND,W 122-115,240,49,90,.544,43,64,.672,6,26,.231,18,23,.783,122,47,95,.495,35,68,.515,12,27,.444,9,9,1.000,115
450,PHI,2022-01-31,122,,MEM,W 122-119 (OT),265,49,100,.490,38,69,.551,11,31,.355,13,15,.867,122,47,102,.461,41,72,.569,6,30,.200,19,28,.679,119
451,IND,2022-01-31,122,,LAC,W 122-116,240,50,95,.526,36,66,.545,14,29,.483,8,12,.667,122,45,96,.469,30,52,.577,15,44,.341,11,13,.846,116
452,GSW,2022-01-31,122,@,HOU,W 122-108,240,43,80,.538,26,40,.650,17,40,.425,19,23,.826,122,36,84,.429,20,41,.488,16,43,.372,20,29,.690,108
453,BOS,2022-01-31,122,,MIA,W 122-92,240,44,84,.524,28,42,.667,16,42,.381,18,27,.667,122,34,87,.391,17,43,.395,17,44,.386,7,10,.700,92
454,CHI,2022-01-28,122,@,SAS,L 122-131,240,46,88,.523,38,58,.655,8,30,.267,22,26,.846,122,50,95,.526,34,58,.586,16,37,.432,15,18,.833,131
455,MEM,2022-01-21,122,@,DEN,W 122-118,240,43,82,.524,32,57,.561,11,25,.440,25,40,.625,122,43,91,.473,30,59,.508,13,32,.406,19,23,.826,118
456,MIN,2022-01-19,122,@,ATL,L 122-134,240,42,97,.433,25,51,.490,17,46,.370,21,29,.724,122,45,86,.523,30,48,.625,15,38,.395,29,33,.879,134
457,WAS,2022-01-11,122,,OKC,W 122-118,240,47,87,.540,36,54,.667,11,33,.333,17,23,.739,122,47,98,.480,36,59,.610,11,39,.282,13,15,.867,118
458,WAS,2022-01-07,122,@,CHI,L 122-130,240,45,88,.511,38,64,.594,7,24,.292,25,26,.962,122,48,91,.527,33,58,.569,15,33,.455,19,21,.905,130
459,TOR,2022-01-07,122,,UTA,W 122-108,240,45,100,.450,33,59,.559,12,41,.293,20,25,.800,122,39,81,.481,22,43,.512,17,38,.447,13,18,.722,108
460,LAL,2022-01-04,122,,SAC,W 122-114,240,49,99,.495,38,67,.567,11,32,.344,13,20,.650,122,43,83,.518,29,49,.592,14,34,.412,14,18,.778,114
461,MIN,2022-01-03,122,@,LAC,W 122-104,240,49,93,.527,33,48,.688,16,45,.356,8,9,.889,122,39,78,.500,28,46,.609,11,32,.344,15,17,.882,104
462,BRK,2021-12-25,122,@,LAL,W 122-115,240,43,89,.483,29,57,.509,14,32,.438,22,27,.815,122,40,96,.417,30,61,.492,10,35,.286,25,28,.893,115
463,IND,2021-12-16,122,,DET,W 122-113,240,45,91,.495,38,59,.644,7,32,.219,25,28,.893,122,40,81,.494,33,56,.589,7,25,.280,26,30,.867,113
464,IND,2021-12-08,122,,NYK,W 122-102,240,46,86,.535,36,59,.610,10,27,.370,20,25,.800,122,36,86,.419,27,56,.482,9,30,.300,21,23,.913,102
465,BOS,2021-11-12,122,,MIL,W 122-113 (OT),265,47,96,.490,35,55,.636,12,41,.293,16,18,.889,122,44,98,.449,28,51,.549,16,47,.340,9,11,.818,113
466,PHI,2021-10-30,122,,ATL,W 122-94,240,46,86,.535,34,48,.708,12,38,.316,18,19,.947,122,36,95,.379,28,73,.384,8,22,.364,14,19,.737,94
467,WAS,2021-10-28,122,,ATL,W 122-111,240,46,99,.465,33,65,.508,13,34,.382,17,21,.810,122,48,88,.545,42,67,.627,6,21,.286,9,14,.643,111
468,UTA,2021-10-28,122,@,HOU,W 122-91,240,41,85,.482,25,39,.641,16,46,.348,24,30,.800,122,31,95,.326,22,51,.431,9,44,.205,20,23,.870,91
469,UTA,2021-10-26,122,,DEN,W 122-110,240,44,85,.518,32,46,.696,12,39,.308,22,29,.759,122,42,83,.506,32,55,.582,10,28,.357,16,24,.667,110
470,ATL,2021-10-25,122,,DET,W 122-104,240,46,90,.511,34,58,.586,12,32,.375,18,21,.857,122,40,91,.440,31,58,.534,9,33,.273,15,18,.833,104
471,IND,2021-10-20,122,@,CHO,L 122-123,240,42,90,.467,25,43,.581,17,47,.362,21,24,.875,122,46,107,.430,33,76,.434,13,31,.419,18,27,.667,123
472,SAS,2022-04-07,121,@,MIN,L 121-127,240,43,89,.483,33,61,.541,10,28,.357,25,34,.735,121,41,96,.427,21,43,.488,20,53,.377,25,31,.806,127
473,BOS,2022-04-07,121,@,MIL,L 121-127,240,43,87,.494,22,37,.595,21,50,.420,14,19,.737,121,49,97,.505,35,59,.593,14,38,.368,15,21,.714,127
474,PHO,2022-04-05,121,,LAL,W 121-110,240,50,102,.490,36,63,.571,14,39,.359,7,9,.778,121,39,86,.453,30,57,.526,9,29,.310,23,30,.767,110
475,UTA,2022-04-05,121,,MEM,W 121-115 (OT),265,40,96,.417,28,58,.483,12,38,.316,29,43,.674,121,39,101,.386,26,70,.371,13,31,.419,24,29,.828,115
476,DET,2022-04-03,121,@,IND,W 121-117,240,43,99,.434,22,58,.379,21,41,.512,14,18,.778,121,45,94,.479,33,56,.589,12,38,.316,15,19,.789,117
477,SAC,2022-03-30,121,@,HOU,W 121-118,240,44,95,.463,37,69,.536,7,26,.269,26,36,.722,121,43,94,.457,30,52,.577,13,42,.310,19,25,.760,118
478,LAC,2022-03-29,121,,UTA,W 121-115,240,41,83,.494,26,47,.553,15,36,.417,24,28,.857,121,43,78,.551,31,47,.660,12,31,.387,17,29,.586,115
479,ATL,2022-03-25,121,,GSW,W 121-110,240,46,89,.517,32,52,.615,14,37,.378,15,19,.789,121,43,90,.478,29,49,.592,14,41,.341,10,13,.769,110
480,LAL,2022-03-23,121,,PHI,L 121-126,240,50,97,.515,39,67,.582,11,30,.367,10,16,.625,121,47,91,.516,37,64,.578,10,27,.370,22,28,.786,126
481,NYK,2022-03-23,121,@,CHO,W 121-106,240,43,83,.518,23,38,.605,20,45,.444,15,17,.882,121,42,89,.472,29,43,.674,13,46,.283,9,17,.529,106
482,UTA,2022-03-18,121,,LAC,W 121-92,240,47,97,.485,31,53,.585,16,44,.364,11,14,.786,121,31,86,.360,20,51,.392,11,35,.314,19,21,.905,92
483,IND,2022-03-18,121,@,HOU,W 121-118,240,47,101,.465,33,58,.569,14,43,.326,13,19,.684,121,39,79,.494,27,52,.519,12,27,.444,28,32,.875,118
484,CHO,2022-03-08,121,,BRK,L 121-132,240,45,92,.489,32,51,.627,13,41,.317,18,22,.818,121,46,82,.561,28,47,.596,18,35,.514,22,29,.759,132
485,PHI,2022-03-07,121,,CHI,W 121-106,240,41,84,.488,29,54,.537,12,30,.400,27,34,.794,121,39,87,.448,31,63,.492,8,24,.333,20,26,.769,106
486,POR,2022-03-05,121,@,MIN,L 121-135,240,40,85,.471,24,47,.511,16,38,.421,25,30,.833,121,48,85,.565,33,48,.688,15,37,.405,24,29,.828,135
487,HOU,2022-02-16,121,@,PHO,L 121-124,240,42,97,.433,29,53,.547,13,44,.295,24,28,.857,121,44,86,.512,37,62,.597,7,24,.292,29,36,.806,124
488,MEM,2022-02-15,121,@,NOP,W 121-109,240,47,94,.500,37,60,.617,10,34,.294,17,27,.630,121,44,88,.500,40,62,.645,4,26,.154,17,20,.850,109
489,DEN,2022-02-14,121,,ORL,W 121-111,240,42,88,.477,26,48,.542,16,40,.400,21,23,.913,121,40,91,.440,29,52,.558,11,39,.282,20,23,.870,111
490,ATL,2022-02-11,121,,SAS,L 121-136,240,47,103,.456,33,60,.550,14,43,.326,13,15,.867,121,50,90,.556,32,58,.552,18,32,.563,18,21,.857,136
491,CHI,2022-02-09,121,@,CHO,W 121-109,240,46,82,.561,30,49,.612,16,33,.485,13,19,.684,121,40,93,.430,27,50,.540,13,43,.302,16,23,.696,109
492,MIA,2022-02-07,121,@,WAS,W 121-100,240,43,76,.566,25,44,.568,18,32,.563,17,21,.810,121,36,80,.450,29,49,.592,7,31,.226,21,23,.913,100
493,PHO,2022-02-01,121,,BRK,W 121-111,240,42,76,.553,31,45,.689,11,31,.355,26,31,.839,121,40,81,.494,24,41,.585,16,40,.400,15,21,.714,111
494,LAL,2022-01-30,121,@,ATL,L 121-129,240,47,87,.540,32,52,.615,15,35,.429,12,23,.522,121,49,84,.583,39,53,.736,10,31,.323,21,32,.656,129
495,MIA,2022-01-28,121,,LAC,W 121-114,240,40,85,.471,25,51,.490,15,34,.441,26,27,.963,121,41,92,.446,32,57,.561,9,35,.257,23,32,.719,114
496,ATL,2022-01-26,121,,SAC,W 121-104,240,48,90,.533,36,54,.667,12,36,.333,13,17,.765,121,39,93,.419,27,53,.509,12,40,.300,14,19,.737,104
497,CHO,2022-01-21,121,,OKC,W 121-98,240,45,99,.455,28,50,.560,17,49,.347,14,20,.700,121,37,98,.378,25,54,.463,12,44,.273,12,15,.800,98
498,IND,2022-01-20,121,@,GSW,W 121-117 (OT),265,41,95,.432,26,60,.433,15,35,.429,24,34,.706,121,42,94,.447,33,52,.635,9,42,.214,24,29,.828,117
499,ATL,2022-01-17,121,,MIL,W 121-114,240,38,86,.442,23,50,.460,15,36,.417,30,32,.938,121,39,88,.443,23,50,.460,16,38,.421,20,24,.833,114
500,PHO,2022-01-17,121,@,SAS,W 121-107,240,49,95,.516,40,63,.635,9,32,.281,14,20,.700,121,41,92,.446,32,62,.516,9,30,.300,16,22,.727,107
501,BRK,2022-01-09,121,,SAS,W 121-119 (OT),265,47,98,.480,39,70,.557,8,28,.286,19,22,.864,121,46,107,.430,33,75,.440,13,32,.406,14,18,.778,119
502,MIL,2022-01-07,121,@,BRK,W 121-109,240,44,96,.458,28,51,.549,16,45,.356,17,21,.810,121,42,92,.457,36,65,.554,6,27,.222,19,20,.950,109
503,DEN,2022-01-07,121,,SAC,W 121-111,240,47,85,.553,35,51,.686,12,34,.353,15,24,.625,121,40,92,.435,29,63,.460,11,29,.379,20,24,.833,111
504,IND,2022-01-05,121,,BRK,L 121-129,240,41,82,.500,28,43,.651,13,39,.333,26,28,.929,121,49,86,.570,44,65,.677,5,21,.238,26,29,.897,129
505,CHO,2022-01-03,121,@,WAS,L 121-124,240,50,104,.481,36,66,.545,14,38,.368,7,13,.538,121,40,87,.460,24,49,.490,16,38,.421,28,31,.903,124
506,ATL,2021-12-31,121,@,CLE,W 121-118,240,43,97,.443,27,59,.458,16,38,.421,19,21,.905,121,48,84,.571,40,59,.678,8,25,.320,14,24,.583,118
507,SAC,2021-12-19,121,,SAS,W 121-114,240,46,91,.505,32,66,.485,14,25,.560,15,18,.833,121,45,91,.495,33,66,.500,12,25,.480,12,13,.923,114
508,NYK,2021-12-07,121,@,SAS,W 121-109,240,43,91,.473,25,53,.472,18,38,.474,17,19,.895,121,41,92,.446,29,61,.475,12,31,.387,15,20,.750,109
509,ATL,2021-12-06,121,@,MIN,W 121-110,240,40,90,.444,15,41,.366,25,49,.510,16,19,.842,121,39,98,.398,22,58,.379,17,40,.425,15,19,.789,110
510,MIN,2021-11-27,121,@,PHI,W 121-120 (2OT),290,48,96,.500,34,60,.567,14,36,.389,11,16,.688,121,39,93,.419,27,59,.458,12,34,.353,30,39,.769,120
511,POR,2021-11-24,121,@,SAC,L 121-125,240,44,94,.468,32,56,.571,12,38,.316,21,25,.840,121,45,86,.523,33,53,.623,12,33,.364,23,34,.676,125
512,LAL,2021-11-21,121,@,DET,W 121-116,240,45,92,.489,35,61,.574,10,31,.323,21,27,.778,121,43,97,.443,29,57,.509,14,40,.350,16,21,.762,116
513,CHO,2021-11-19,121,,IND,W 121-118,240,44,81,.543,32,50,.640,12,31,.387,21,28,.750,121,41,88,.466,30,52,.577,11,36,.306,25,32,.781,118
514,CHI,2021-11-15,121,@,LAL,W 121-103,240,49,89,.551,34,55,.618,15,34,.441,8,11,.727,121,36,79,.456,30,47,.638,6,32,.188,25,31,.806,103
515,TOR,2021-11-13,121,,DET,L 121-127,240,44,87,.506,31,53,.585,13,34,.382,20,31,.645,121,43,79,.544,28,44,.636,15,35,.429,26,30,.867,127
516,PHO,2021-11-06,121,,ATL,W 121-117,240,45,88,.511,31,45,.689,14,43,.326,17,21,.810,121,42,97,.433,29,64,.453,13,33,.394,20,23,.870,117
517,SAS,2021-10-26,121,,LAL,L 121-125 (OT),265,48,108,.444,35,72,.486,13,36,.361,12,22,.545,121,50,105,.476,42,75,.560,8,30,.267,17,22,.773,125
518,LAL,2021-10-24,121,,MEM,W 121-118,240,45,84,.536,29,54,.537,16,30,.533,15,22,.682,121,45,100,.450,32,65,.492,13,35,.371,15,18,.833,118
519,MIL,2021-10-23,121,@,SAS,W 121-111,240,44,83,.530,29,48,.604,15,35,.429,18,22,.818,121,48,99,.485,38,60,.633,10,39,.256,5,6,.833,111
520,NYK,2021-10-22,121,@,ORL,W 121-96,240,44,88,.500,20,34,.588,24,54,.444,9,17,.529,121,33,83,.398,16,40,.400,17,43,.395,13,15,.867,96
521,CLE,2021-10-20,121,@,MEM,L 121-132,240,47,93,.505,33,55,.600,14,38,.368,13,18,.722,121,53,100,.530,39,67,.582,14,33,.424,12,12,1.000,132
522,POR,2021-10-20,121,,SAC,L 121-124,240,45,93,.484,33,58,.569,12,35,.343,19,22,.864,121,42,92,.457,25,51,.490,17,41,.415,23,29,.793,124
523,GSW,2021-10-19,121,@,LAL,W 121-114,240,41,93,.441,27,54,.500,14,39,.359,25,30,.833,121,45,95,.474,30,53,.566,15,42,.357,9,19,.474,114
524,SAS,2022-04-10,120,@,DAL,L 120-130,240,43,89,.483,32,58,.552,11,31,.355,23,23,1.000,120,46,85,.541,26,49,.531,20,36,.556,18,23,.783,130
525,MIN,2022-04-10,120,,CHI,L 120-124,240,46,91,.505,35,60,.583,11,31,.355,17,22,.773,120,44,83,.530,34,62,.548,10,21,.476,26,33,.788,124
526,IND,2022-04-09,120,@,PHI,L 120-133,240,41,78,.526,31,55,.564,10,23,.435,28,36,.778,120,50,90,.556,38,56,.679,12,34,.353,21,27,.778,133
527,LAL,2022-04-08,120,,OKC,W 120-101,240,41,82,.500,32,51,.627,9,31,.290,29,39,.744,120,40,88,.455,34,59,.576,6,29,.207,15,19,.789,101
528,ORL,2022-04-05,120,,CLE,W 120-115,240,47,93,.505,31,58,.534,16,35,.457,10,15,.667,120,42,86,.488,26,50,.520,16,36,.444,15,22,.682,115
529,MIL,2022-03-31,120,@,BRK,W 120-119 (OT),265,40,89,.449,28,48,.583,12,41,.293,28,34,.824,120,45,97,.464,27,60,.450,18,37,.486,11,16,.688,119
530,DAL,2022-03-30,120,@,CLE,W 120-112,240,46,88,.523,30,46,.652,16,42,.381,12,15,.800,120,42,83,.506,31,58,.534,11,25,.440,17,22,.773,112
531,HOU,2022-03-28,120,,SAS,L 120-123,240,38,92,.413,18,43,.419,20,49,.408,24,28,.857,120,47,100,.470,40,71,.563,7,29,.241,22,28,.786,123
532,BRK,2022-03-23,120,@,MEM,L 120-132,240,43,87,.494,34,62,.548,9,25,.360,25,27,.926,120,47,101,.465,28,63,.444,19,38,.500,19,22,.864,132
533,CLE,2022-03-21,120,,LAL,L 120-131,240,45,86,.523,31,47,.660,14,39,.359,16,19,.842,120,53,94,.564,41,62,.661,12,32,.375,13,16,.813,131
534,MIA,2022-03-18,120,,OKC,W 120-108,240,46,95,.484,28,44,.636,18,51,.353,10,12,.833,120,40,84,.476,30,50,.600,10,34,.294,18,23,.783,108
535,ATL,2022-03-18,120,,MEM,W 120-105,240,45,91,.495,32,63,.508,13,28,.464,17,21,.810,120,40,86,.465,32,64,.500,8,22,.364,17,23,.739,105
536,ORL,2022-03-17,120,,DET,L 120-134,240,47,97,.485,36,67,.537,11,30,.367,15,21,.714,120,47,94,.500,27,51,.529,20,43,.465,20,31,.645,134
537,OKC,2022-03-16,120,@,SAS,L 120-122,240,43,82,.524,30,47,.638,13,35,.371,21,29,.724,120,43,98,.439,24,57,.421,19,41,.463,17,20,.850,122
538,CLE,2022-03-14,120,,LAC,W 120-111 (OT),265,41,86,.477,26,56,.464,15,30,.500,23,32,.719,120,43,98,.439,31,62,.500,12,36,.333,13,17,.765,111
539,NOP,2022-03-11,120,,CHO,L 120-142,240,43,86,.500,28,47,.596,15,39,.385,19,25,.760,120,52,87,.598,30,40,.750,22,47,.468,16,20,.800,142
540,BRK,2022-03-06,120,@,BOS,L 120-126,240,45,89,.506,33,62,.532,12,27,.444,18,20,.900,120,40,83,.482,23,47,.489,17,36,.472,29,38,.763,126
541,BOS,2022-03-03,120,,MEM,W 120-107,240,46,89,.517,30,52,.577,16,37,.432,12,15,.800,120,42,99,.424,29,59,.492,13,40,.325,10,13,.769,107
542,PHO,2022-03-02,120,,POR,W 120-90,240,40,80,.500,26,44,.591,14,36,.389,26,31,.839,120,30,78,.385,19,47,.404,11,31,.355,19,25,.760,90
543,MIL,2022-03-02,120,,MIA,W 120-119,240,41,91,.451,27,55,.491,14,36,.389,24,27,.889,120,44,97,.454,23,53,.434,21,44,.477,10,12,.833,119
544,MIL,2022-02-17,120,,PHI,L 120-123,240,42,95,.442,28,51,.549,14,44,.318,22,28,.786,120,44,88,.500,32,54,.593,12,34,.353,23,27,.852,123
545,CHO,2022-02-15,120,@,MIN,L 120-126 (OT),265,42,102,.412,34,69,.493,8,33,.242,28,37,.757,120,43,109,.394,30,54,.556,13,55,.236,27,43,.628,126
546,CHI,2022-02-14,120,,SAS,W 120-109,240,46,88,.523,36,64,.563,10,24,.417,18,21,.857,120,44,92,.478,38,72,.528,6,20,.300,15,21,.714,109
547,NOP,2022-02-14,120,,TOR,W 120-90,240,45,77,.584,29,42,.690,16,35,.457,14,16,.875,120,29,95,.305,21,61,.344,8,34,.235,24,31,.774,90
548,IND,2022-02-13,120,,MIN,L 120-129,240,45,102,.441,32,57,.561,13,45,.289,17,22,.773,120,43,84,.512,25,50,.500,18,34,.529,25,28,.893,129
549,CLE,2022-02-11,120,@,IND,W 120-113,240,43,81,.531,34,57,.596,9,24,.375,25,30,.833,120,42,89,.472,24,51,.471,18,38,.474,11,16,.688,113
550,HOU,2022-02-10,120,,TOR,L 120-139,240,43,82,.524,27,44,.614,16,38,.421,18,30,.600,120,53,97,.546,38,58,.655,15,39,.385,18,22,.818,139
551,NOP,2022-02-06,120,@,HOU,W 120-107,240,41,77,.532,29,48,.604,12,29,.414,26,36,.722,120,40,84,.476,24,39,.615,16,45,.356,11,16,.688,107
552,CHI,2022-02-03,120,@,TOR,L 120-127 (OT),265,43,90,.478,31,61,.508,12,29,.414,22,24,.917,120,48,113,.425,34,77,.442,14,36,.389,17,19,.895,127
553,MEM,2022-02-02,120,@,NYK,W 120-108,240,44,102,.431,28,63,.444,16,39,.410,16,23,.696,120,38,88,.432,26,52,.500,12,36,.333,20,26,.769,108
554,OKC,2022-02-02,120,@,DAL,W 120-114 (OT),265,41,86,.477,24,49,.490,17,37,.459,21,25,.840,120,46,98,.469,32,55,.582,14,43,.326,8,10,.800,114
555,SAS,2022-02-01,120,,GSW,L 120-124,240,46,83,.554,30,50,.600,16,33,.485,12,17,.706,120,43,96,.448,23,50,.460,20,46,.435,18,18,1.000,124
556,MIA,2022-01-29,120,,TOR,L 120-124 (3OT),315,45,110,.409,29,60,.483,16,50,.320,14,20,.700,120,47,107,.439,31,62,.500,16,45,.356,14,18,.778,124
557,BRK,2022-01-15,120,,NOP,W 120-105,240,46,84,.548,34,57,.596,12,27,.444,16,17,.941,120,40,87,.460,31,56,.554,9,31,.290,16,24,.667,105
558,TOR,2022-01-02,120,,NYK,W 120-105,240,41,86,.477,28,52,.538,13,34,.382,25,30,.833,120,35,78,.449,23,42,.548,12,36,.333,23,28,.821,105
559,CHI,2022-01-01,120,@,WAS,W 120-119,240,41,84,.488,24,50,.480,17,34,.500,21,25,.840,120,46,87,.529,40,60,.667,6,27,.222,21,26,.808,119
560,LAC,2022-01-01,120,@,BRK,W 120-116,240,42,86,.488,28,50,.560,14,36,.389,22,31,.710,120,42,97,.433,31,64,.484,11,33,.333,21,25,.840,116
561,UTA,2021-12-31,120,,MIN,W 120-108,240,37,78,.474,26,49,.531,11,29,.379,35,41,.854,120,40,93,.430,26,52,.500,14,41,.341,14,22,.636,108
562,MIA,2021-12-31,120,@,HOU,W 120-110,240,40,86,.465,26,53,.491,14,33,.424,26,31,.839,120,41,93,.441,27,51,.529,14,42,.333,14,17,.824,110
563,UTA,2021-12-29,120,@,POR,W 120-105,240,46,87,.529,38,58,.655,8,29,.276,20,32,.625,120,37,88,.420,23,48,.479,14,40,.350,17,24,.708,105
564,UTA,2021-12-25,120,,DAL,W 120-116,240,40,90,.444,28,54,.519,12,36,.333,28,37,.757,120,38,89,.427,28,59,.475,10,30,.333,30,35,.857,116
565,DAL,2021-12-13,120,,CHO,W 120-96,240,43,83,.518,24,42,.571,19,41,.463,15,17,.882,120,34,86,.395,21,49,.429,13,37,.351,15,24,.625,96
566,DEN,2021-12-08,120,@,NOP,W 120-114 (OT),265,45,88,.511,36,56,.643,9,32,.281,21,27,.778,120,47,90,.522,36,60,.600,11,30,.367,9,12,.750,114
567,DEN,2021-11-29,120,@,MIA,W 120-111,240,43,74,.581,25,39,.641,18,35,.514,16,21,.762,120,43,91,.473,28,47,.596,15,44,.341,10,15,.667,111
568,PHI,2021-11-27,120,,MIN,L 120-121 (2OT),290,39,93,.419,27,59,.458,12,34,.353,30,39,.769,120,48,96,.500,34,60,.567,14,36,.389,11,16,.688,121
569,WAS,2021-11-27,120,@,DAL,W 120-114,240,45,78,.577,36,54,.667,9,24,.375,21,26,.808,120,42,89,.472,28,51,.549,14,38,.368,16,22,.727,114
570,MIL,2021-11-26,120,@,DEN,W 120-109,240,46,73,.630,30,40,.750,16,33,.485,12,20,.600,120,40,92,.435,23,45,.511,17,47,.362,12,14,.857,109
571,PHO,2021-11-24,120,@,CLE,W 120-115,240,45,86,.523,37,64,.578,8,22,.364,22,28,.786,120,43,97,.443,31,58,.534,12,39,.308,17,25,.680,115
572,MEM,2021-11-18,120,,LAC,W 120-108,240,52,96,.542,41,70,.586,11,26,.423,5,6,.833,120,42,90,.467,26,51,.510,16,39,.410,8,8,1.000,108
573,UTA,2021-11-16,120,,PHI,W 120-85,240,46,89,.517,30,51,.588,16,38,.421,12,19,.632,120,33,90,.367,27,61,.443,6,29,.207,13,17,.765,85
574,BRK,2021-11-14,120,@,OKC,W 120-96,240,41,82,.500,23,39,.590,18,43,.419,20,21,.952,120,36,90,.400,22,45,.489,14,45,.311,10,11,.909,96
575,ATL,2021-11-14,120,,MIL,W 120-100,240,47,97,.485,32,62,.516,15,35,.429,11,13,.846,120,38,84,.452,24,43,.558,14,41,.341,10,16,.625,100
576,BRK,2021-11-12,120,@,NOP,W 120-112,240,41,82,.500,23,48,.479,18,34,.529,20,27,.741,120,43,88,.489,30,56,.536,13,32,.406,13,16,.813,112
577,LAL,2021-11-10,120,,MIA,W 120-117 (OT),265,46,92,.500,28,54,.519,18,38,.474,10,16,.625,120,40,96,.417,30,59,.508,10,37,.270,27,35,.771,117
578,LAC,2021-11-07,120,,CHO,W 120-106,240,41,86,.477,23,38,.605,18,48,.375,20,21,.952,120,41,101,.406,31,68,.456,10,33,.303,14,18,.778,106
579,GSW,2021-11-07,120,,HOU,W 120-107,240,44,85,.518,29,39,.744,15,46,.326,17,20,.850,120,36,79,.456,26,46,.565,10,33,.303,25,37,.676,107
580,CHO,2021-10-27,120,@,ORL,W 120-111,240,43,83,.518,29,53,.547,14,30,.467,20,24,.833,120,43,88,.489,28,48,.583,15,40,.375,10,13,.769,111
581,MEM,2021-10-23,120,@,LAC,W 120-114,240,42,90,.467,27,54,.500,15,36,.417,21,25,.840,120,43,99,.434,30,60,.500,13,39,.333,15,17,.882,114
582,TOR,2022-04-07,119,,PHI,W 119-114,240,45,91,.495,30,58,.517,15,33,.455,14,18,.778,119,37,75,.493,18,39,.462,19,36,.528,21,25,.840,114
583,LAC,2022-04-03,119,,NOP,W 119-100,240,45,95,.474,24,51,.471,21,44,.477,8,10,.800,119,35,87,.402,26,63,.413,9,24,.375,21,27,.778,100
584,CLE,2022-04-02,119,@,NYK,W 119-101,240,44,81,.543,29,47,.617,15,34,.441,16,21,.762,119,31,77,.403,18,47,.383,13,30,.433,26,34,.765,101
585,MIL,2022-04-01,119,,LAC,L 119-153,240,50,94,.532,42,69,.609,8,25,.320,11,18,.611,119,56,92,.609,33,49,.673,23,43,.535,18,24,.750,153
586,BRK,2022-03-31,119,,MIL,L 119-120 (OT),265,45,97,.464,27,60,.450,18,37,.486,11,16,.688,119,40,89,.449,28,48,.583,12,41,.293,28,34,.824,120
587,CHO,2022-03-27,119,@,BRK,W 119-110,240,42,98,.429,25,66,.379,17,32,.531,18,23,.783,119,43,97,.443,36,63,.571,7,34,.206,17,26,.654,110
588,POR,2022-03-21,119,@,DET,W 119-115,240,37,88,.420,29,60,.483,8,28,.286,37,49,.755,119,36,85,.424,27,50,.540,9,35,.257,34,41,.829,115
589,MIL,2022-03-19,119,@,MIN,L 119-138,240,43,97,.443,24,45,.533,19,52,.365,14,17,.824,119,47,92,.511,25,45,.556,22,47,.468,22,26,.846,138
590,LAL,2022-03-19,119,@,WAS,L 119-127,240,48,91,.527,35,56,.625,13,35,.371,10,11,.909,119,44,85,.518,31,54,.574,13,31,.419,26,31,.839,127
591,CLE,2022-03-18,119,,DEN,W 119-116 (OT),265,44,98,.449,30,61,.492,14,37,.378,17,26,.654,119,46,92,.500,36,59,.610,10,33,.303,14,18,.778,116
592,IND,2022-03-12,119,@,SAS,W 119-108,240,45,92,.489,31,56,.554,14,36,.389,15,15,1.000,119,42,102,.412,31,68,.456,11,34,.324,13,16,.813,108
593,TOR,2022-03-09,119,@,SAS,W 119-104,240,41,85,.482,30,55,.545,11,30,.367,26,28,.929,119,38,84,.452,29,52,.558,9,32,.281,19,20,.950,104
594,CLE,2022-03-04,119,@,PHI,L 119-125,240,44,82,.537,34,54,.630,10,28,.357,21,24,.875,119,41,75,.547,27,42,.643,14,33,.424,29,32,.906,125
595,OKC,2022-03-02,119,@,DEN,W 119-107,240,44,87,.506,28,58,.483,16,29,.552,15,21,.714,119,40,90,.444,28,44,.636,12,46,.261,15,17,.882,107
596,MIA,2022-03-02,119,@,MIL,L 119-120,240,44,97,.454,23,53,.434,21,44,.477,10,12,.833,119,41,91,.451,27,55,.491,14,36,.389,24,27,.889,120
597,CHO,2022-03-02,119,@,CLE,W 119-98,240,43,85,.506,26,47,.553,17,38,.447,16,22,.727,119,37,79,.468,27,48,.563,10,31,.323,14,21,.667,98
598,ORL,2022-02-28,119,,IND,W 119-103,240,45,96,.469,33,59,.559,12,37,.324,17,22,.773,119,35,72,.486,20,36,.556,15,36,.417,18,25,.720,103
599,ORL,2022-02-25,119,,HOU,W 119-111,240,42,83,.506,29,47,.617,13,36,.361,22,29,.759,119,44,94,.468,30,47,.638,14,47,.298,9,20,.450,111
600,MIN,2022-02-24,119,,MEM,W 119-114,240,43,93,.462,27,51,.529,16,42,.381,17,25,.680,119,38,98,.388,29,67,.433,9,31,.290,29,40,.725,114
601,MEM,2022-02-16,119,,POR,L 119-123,240,37,85,.435,26,55,.473,11,30,.367,34,42,.810,119,43,85,.506,30,53,.566,13,32,.406,24,32,.750,123
602,IND,2022-02-15,119,@,MIL,L 119-128,240,47,93,.505,30,52,.577,17,41,.415,8,19,.421,119,48,86,.558,38,57,.667,10,29,.345,22,30,.733,128
603,LAC,2022-02-14,119,,GSW,W 119-104,240,48,85,.565,33,51,.647,15,34,.441,8,15,.533,119,39,86,.453,23,45,.511,16,41,.390,10,13,.769,104
604,DET,2022-02-11,119,,CHO,L 119-141,240,48,102,.471,36,67,.537,12,35,.343,11,18,.611,119,54,97,.557,36,55,.655,18,42,.429,15,23,.652,141
605,MIN,2022-02-09,119,@,SAC,L 119-132,240,44,98,.449,28,52,.538,16,46,.348,15,18,.833,119,48,93,.516,36,63,.571,12,30,.400,24,27,.889,132
606,PHI,2022-02-06,119,@,CHI,W 119-108,240,45,84,.536,33,60,.550,12,24,.500,17,21,.810,119,39,81,.481,32,55,.582,7,26,.269,23,26,.885,108
607,ORL,2022-02-02,119,@,IND,W 119-118,240,42,95,.442,31,60,.517,11,35,.314,24,26,.923,119,44,98,.449,30,66,.455,14,32,.438,16,23,.696,118
608,MEM,2022-01-31,119,@,PHI,L 119-122 (OT),265,47,102,.461,41,72,.569,6,30,.200,19,28,.679,119,49,100,.490,38,69,.551,11,31,.355,13,15,.867,122
609,MEM,2022-01-28,119,,UTA,W 119-109,240,46,82,.561,37,59,.627,9,23,.391,18,24,.750,119,37,85,.435,20,39,.513,17,46,.370,18,21,.857,109
610,ORL,2022-01-28,119,,DET,W 119-103,240,41,83,.494,29,58,.500,12,25,.480,25,26,.962,119,32,87,.368,22,58,.379,10,29,.345,29,37,.784,103
611,BRK,2022-01-19,119,@,WAS,W 119-118,240,47,89,.528,39,64,.609,8,25,.320,17,20,.850,119,41,86,.477,31,57,.544,10,29,.345,26,32,.813,118
612,MEM,2022-01-17,119,,CHI,W 119-106,240,47,92,.511,37,67,.552,10,25,.400,15,20,.750,119,40,92,.435,27,61,.443,13,31,.419,13,15,.867,106
613,MIN,2022-01-16,119,,GSW,W 119-99,240,45,91,.495,29,48,.604,16,43,.372,13,20,.650,119,32,82,.390,19,40,.475,13,42,.310,22,29,.759,99
614,BOS,2022-01-12,119,@,IND,W 119-100,240,40,78,.513,22,40,.550,18,38,.474,21,25,.840,119,40,86,.465,33,50,.660,7,36,.194,13,20,.650,100
615,LAL,2022-01-09,119,,MEM,L 119-127,240,45,97,.464,31,64,.484,14,33,.424,15,19,.789,119,47,86,.547,36,56,.643,11,30,.367,22,32,.688,127
616,SAS,2022-01-09,119,@,BRK,L 119-121 (OT),265,46,107,.430,33,75,.440,13,32,.406,14,18,.778,119,47,98,.480,39,70,.557,8,28,.286,19,22,.864,121
617,PHI,2022-01-07,119,,SAS,W 119-100,240,45,87,.517,37,64,.578,8,23,.348,21,27,.778,119,38,92,.413,29,62,.468,9,30,.300,15,20,.750,100
618,WAS,2022-01-01,119,,CHI,L 119-120,240,46,87,.529,40,60,.667,6,27,.222,21,26,.808,119,41,84,.488,24,50,.480,17,34,.500,21,25,.840,120
619,MIA,2021-12-28,119,,WAS,W 119-112,240,41,92,.446,25,58,.431,16,34,.471,21,23,.913,119,42,85,.494,25,43,.581,17,42,.405,11,14,.786,112
620,TOR,2021-12-18,119,,GSW,W 119-100,240,45,90,.500,31,52,.596,14,38,.368,15,23,.652,119,37,79,.468,26,43,.605,11,36,.306,15,21,.714,100
621,CLE,2021-12-18,119,@,MIL,W 119-90,240,45,90,.500,29,45,.644,16,45,.356,13,14,.929,119,35,89,.393,23,51,.451,12,38,.316,8,11,.727,90
622,SAC,2021-12-15,119,,WAS,W 119-105,240,45,82,.549,37,56,.661,8,26,.308,21,29,.724,119,42,89,.472,37,65,.569,5,24,.208,16,21,.762,105
623,WAS,2021-12-08,119,@,DET,W 119-116 (OT),265,42,88,.477,30,56,.536,12,32,.375,23,28,.821,119,37,79,.468,24,55,.436,13,24,.542,29,35,.829,116
624,LAC,2021-12-03,119,@,LAL,W 119-115,240,41,81,.506,25,46,.543,16,35,.457,21,24,.875,119,45,90,.500,33,57,.579,12,33,.364,13,21,.619,115
625,CHI,2021-12-02,119,@,NYK,W 119-115,240,44,89,.494,33,60,.550,11,29,.379,20,21,.952,119,42,82,.512,33,56,.589,9,26,.346,22,27,.815,115
626,CHO,2021-11-29,119,@,CHI,L 119-133,240,42,88,.477,24,49,.490,18,39,.462,17,21,.810,119,53,89,.596,39,59,.661,14,30,.467,13,19,.684,133
627,POR,2021-11-23,119,,DEN,W 119-100,240,45,88,.511,30,49,.612,15,39,.385,14,20,.700,119,38,78,.487,23,45,.511,15,33,.455,9,11,.818,100
628,MEM,2021-11-22,119,@,UTA,W 119-118,240,42,95,.442,29,60,.483,13,35,.371,22,27,.815,119,41,87,.471,24,44,.545,17,43,.395,19,25,.760,118
629,GSW,2021-11-21,119,,TOR,W 119-104,240,39,79,.494,17,34,.500,22,45,.489,19,24,.792,119,39,99,.394,24,62,.387,15,37,.405,11,20,.550,104
630,UTA,2021-11-18,119,,TOR,W 119-103,240,44,80,.550,25,34,.735,19,46,.413,12,13,.923,119,39,94,.415,29,56,.518,10,38,.263,15,17,.882,103
631,PHO,2021-11-12,119,@,MEM,W 119-94,240,46,94,.489,28,57,.491,18,37,.486,9,9,1.000,119,37,98,.378,30,65,.462,7,33,.212,13,23,.565,94
632,GSW,2021-11-12,119,,CHI,W 119-93,240,45,93,.484,30,47,.638,15,46,.326,14,16,.875,119,34,78,.436,26,51,.510,8,27,.296,17,22,.773,93
633,PHO,2021-11-10,119,,POR,W 119-109,240,49,94,.521,38,66,.576,11,28,.393,10,12,.833,119,44,91,.484,37,61,.607,7,30,.233,14,16,.875,109
634,LAL,2021-11-02,119,,HOU,W 119-117,240,49,93,.527,43,68,.632,6,25,.240,15,20,.750,119,48,91,.527,32,49,.653,16,42,.381,5,12,.417,117
635,UTA,2021-11-02,119,,SAC,W 119-113,240,43,98,.439,29,50,.580,14,48,.292,19,27,.704,119,42,93,.452,30,62,.484,12,31,.387,17,24,.708,113
636,MIL,2021-10-25,119,@,IND,W 119-109,240,41,85,.482,30,53,.566,11,32,.344,26,31,.839,119,40,90,.444,26,54,.481,14,36,.389,15,17,.882,109
637,GSW,2021-10-24,119,@,SAC,W 119-107,240,43,97,.443,30,60,.500,13,37,.351,20,24,.833,119,42,86,.488,27,40,.675,15,46,.326,8,13,.615,107
638,PHI,2022-04-10,118,,DET,W 118-106,240,46,88,.523,41,63,.651,5,25,.200,21,23,.913,118,38,83,.458,27,49,.551,11,34,.324,19,29,.655,106
639,BRK,2022-04-08,118,,CLE,W 118-107,240,43,92,.467,31,60,.517,12,32,.375,20,21,.952,118,40,82,.488,32,55,.582,8,27,.296,19,24,.792,107
640,ATL,2022-04-06,118,,WAS,W 118-103,240,43,92,.467,27,53,.509,16,39,.410,16,19,.842,118,42,86,.488,32,51,.627,10,35,.286,9,11,.818,103
641,TOR,2022-04-05,118,,ATL,W 118-108,240,44,101,.436,35,66,.530,9,35,.257,21,31,.677,118,43,94,.457,29,57,.509,14,37,.378,8,12,.667,108
642,BRK,2022-04-05,118,,HOU,W 118-105,240,39,86,.453,24,49,.490,15,37,.405,25,27,.926,118,40,99,.404,29,56,.518,11,43,.256,14,25,.560,105
643,DAL,2022-04-03,118,@,MIL,W 118-112,240,39,76,.513,23,38,.605,16,38,.421,24,27,.889,118,42,95,.442,27,55,.491,15,40,.375,13,18,.722,112
644,NYK,2022-04-03,118,@,ORL,W 118-88,240,45,93,.484,30,49,.612,15,44,.341,13,16,.813,118,30,85,.353,18,41,.439,12,44,.273,16,27,.593,88
645,LAL,2022-04-03,118,,DEN,L 118-129,240,49,92,.533,43,72,.597,6,20,.300,14,21,.667,118,47,82,.573,35,51,.686,12,31,.387,23,29,.793,129
646,OKC,2022-03-30,118,,ATL,L 118-136,240,41,87,.471,24,46,.522,17,41,.415,19,27,.704,118,49,91,.538,31,52,.596,18,39,.462,20,22,.909,136
647,IND,2022-03-30,118,,DEN,L 118-125,240,44,97,.454,32,57,.561,12,40,.300,18,23,.783,118,50,80,.625,38,52,.731,12,28,.429,13,14,.929,125
648,HOU,2022-03-30,118,,SAC,L 118-121,240,43,94,.457,30,52,.577,13,42,.310,19,25,.760,118,44,95,.463,37,69,.536,7,26,.269,26,36,.722,121
649,MIL,2022-03-29,118,@,PHI,W 118-116,240,44,88,.500,30,50,.600,14,38,.368,16,23,.696,118,43,89,.483,27,48,.563,16,41,.390,14,18,.778,116
650,GSW,2022-03-23,118,@,MIA,W 118-104,240,40,77,.519,25,41,.610,15,36,.417,23,27,.852,118,37,85,.435,23,49,.469,14,36,.389,16,21,.762,104
651,OKC,2022-03-23,118,,ORL,W 118-102,240,38,79,.481,21,38,.553,17,41,.415,25,30,.833,118,36,93,.387,19,42,.452,17,51,.333,13,16,.813,102
652,HOU,2022-03-18,118,,IND,L 118-121,240,39,79,.494,27,52,.519,12,27,.444,28,32,.875,118,47,101,.465,33,58,.569,14,43,.326,13,19,.684,121
653,PHI,2022-03-16,118,@,CLE,W 118-114,240,41,79,.519,29,47,.617,12,32,.375,24,28,.857,118,39,80,.488,30,52,.577,9,28,.321,27,32,.844,114
654,OKC,2022-03-13,118,,MEM,L 118-125,240,41,97,.423,28,56,.500,13,41,.317,23,28,.821,118,48,102,.471,37,73,.507,11,29,.379,18,20,.900,125
655,WAS,2022-03-12,118,@,POR,L 118-127,240,39,83,.470,25,49,.510,14,34,.412,26,27,.963,118,48,93,.516,37,63,.587,11,30,.367,20,22,.909,127
656,MEM,2022-03-11,118,,NYK,W 118-114,240,46,104,.442,37,78,.474,9,26,.346,17,29,.586,118,38,90,.422,28,65,.431,10,25,.400,28,37,.757,114
657,ORL,2022-03-11,118,,MIN,W 118-110,240,40,86,.465,24,46,.522,16,40,.400,22,25,.880,118,41,90,.456,26,45,.578,15,45,.333,13,13,1.000,110
658,MIL,2022-03-04,118,@,CHI,W 118-112,240,43,88,.489,33,57,.579,10,31,.323,22,33,.667,118,47,94,.500,37,68,.544,10,26,.385,8,11,.727,112
659,MEM,2022-02-28,118,,SAS,W 118-105,240,48,89,.539,37,63,.587,11,26,.423,11,19,.579,118,41,99,.414,32,67,.478,9,32,.281,14,19,.737,105
660,UTA,2022-02-27,118,@,PHO,W 118-114,240,44,94,.468,27,54,.500,17,40,.425,13,20,.650,118,44,86,.512,31,58,.534,13,28,.464,13,16,.813,114
661,NOP,2022-02-17,118,,DAL,L 118-125,240,46,92,.500,34,64,.531,12,28,.429,14,21,.667,118,44,82,.537,25,42,.595,19,40,.475,18,25,.720,125
662,SAC,2022-02-16,118,@,CHI,L 118-125,240,43,84,.512,31,54,.574,12,30,.400,20,22,.909,118,47,94,.500,35,65,.538,12,29,.414,19,20,.950,125
663,CHO,2022-02-12,118,,MEM,L 118-125,240,39,97,.402,25,52,.481,14,45,.311,26,33,.788,118,47,96,.490,36,63,.571,11,33,.333,20,33,.606,125
664,MIN,2022-02-06,118,,DET,W 118-105,240,42,91,.462,25,55,.455,17,36,.472,17,21,.810,118,40,95,.421,28,63,.444,12,32,.375,13,19,.684,105
665,IND,2022-02-02,118,,ORL,L 118-119,240,44,98,.449,30,66,.455,14,32,.438,16,23,.696,118,42,95,.442,31,60,.517,11,35,.314,24,26,.923,119
666,BRK,2022-01-26,118,,DEN,L 118-124,240,43,88,.489,31,59,.525,12,29,.414,20,26,.769,118,42,89,.472,27,53,.509,15,36,.417,25,27,.926,124
667,MEM,2022-01-26,118,@,SAS,W 118-110,240,46,90,.511,39,67,.582,7,23,.304,19,26,.731,118,43,94,.457,34,57,.596,9,37,.243,15,19,.789,110
668,DEN,2022-01-21,118,,MEM,L 118-122,240,43,91,.473,30,59,.508,13,32,.406,19,23,.826,118,43,82,.524,32,57,.561,11,25,.440,25,40,.625,122
669,WAS,2022-01-19,118,,BRK,L 118-119,240,41,86,.477,31,57,.544,10,29,.345,26,32,.813,118,47,89,.528,39,64,.609,8,25,.320,17,20,.850,119
670,SAS,2022-01-19,118,,OKC,W 118-96,240,47,96,.490,32,56,.571,15,40,.375,9,14,.643,118,38,98,.388,30,67,.448,8,31,.258,12,15,.800,96
671,HOU,2022-01-16,118,@,SAC,W 118-112,240,41,76,.539,25,36,.694,16,40,.400,20,24,.833,118,41,91,.451,29,53,.547,12,38,.316,18,24,.750,112
672,ATL,2022-01-14,118,@,MIA,L 118-124,240,38,79,.481,22,41,.537,16,38,.421,26,30,.867,118,41,77,.532,27,47,.574,14,30,.467,28,30,.933,124
673,MIL,2022-01-13,118,,GSW,W 118-99,240,44,86,.512,26,45,.578,18,41,.439,12,18,.667,118,33,95,.347,17,47,.362,16,48,.333,17,24,.708,99
674,OKC,2022-01-11,118,@,WAS,L 118-122,240,47,98,.480,36,59,.610,11,39,.282,13,15,.867,118,47,87,.540,36,54,.667,11,33,.333,17,23,.739,122
675,ATL,2022-01-07,118,@,LAL,L 118-134,240,43,96,.448,30,60,.500,13,36,.361,19,27,.704,118,50,101,.495,33,60,.550,17,41,.415,17,19,.895,134
676,MEM,2022-01-06,118,,DET,W 118-88,240,48,98,.490,38,66,.576,10,32,.313,12,19,.632,118,34,99,.343,24,55,.436,10,44,.227,10,13,.769,88
677,MEM,2022-01-03,118,@,BRK,W 118-104,240,48,102,.471,38,67,.567,10,35,.286,12,21,.571,118,37,82,.451,28,51,.549,9,31,.290,21,26,.808,104
678,MEM,2021-12-31,118,,SAS,W 118-105,240,49,102,.480,39,76,.513,10,26,.385,10,16,.625,118,39,90,.433,27,55,.491,12,35,.343,15,24,.625,105
679,CLE,2021-12-31,118,,ATL,L 118-121,240,48,84,.571,40,59,.678,8,25,.320,14,24,.583,118,43,97,.443,27,59,.458,16,38,.421,19,21,.905,121
680,ORL,2021-12-30,118,,MIL,L 118-136,240,42,87,.483,29,51,.569,13,36,.361,21,27,.778,118,45,91,.495,32,58,.552,13,33,.394,33,36,.917,136
681,ATL,2021-12-27,118,,CHI,L 118-130,240,40,89,.449,25,55,.455,15,34,.441,23,26,.885,118,51,94,.543,33,57,.579,18,37,.486,10,14,.714,130
682,IND,2021-12-23,118,,HOU,W 118-106,240,46,88,.523,33,50,.660,13,38,.342,13,19,.684,118,35,80,.438,20,43,.465,15,37,.405,21,26,.808,106
683,HOU,2021-12-20,118,@,CHI,L 118-133,240,44,78,.564,32,45,.711,12,33,.364,18,24,.750,118,47,88,.534,31,53,.585,16,35,.457,23,24,.958,133
684,PHO,2021-12-16,118,,WAS,W 118-98,240,42,79,.532,33,50,.660,9,29,.310,25,26,.962,118,40,82,.488,34,61,.557,6,21,.286,12,19,.632,98
685,MIA,2021-12-11,118,,CHI,W 118-92,240,46,93,.495,27,50,.540,19,43,.442,7,9,.778,118,31,83,.373,14,43,.326,17,40,.425,13,20,.650,92
686,UTA,2021-12-09,118,@,PHI,W 118-96,240,43,91,.473,28,51,.549,15,40,.375,17,24,.708,118,38,88,.432,32,55,.582,6,33,.182,14,15,.933,96
687,HOU,2021-12-05,118,,NOP,W 118-108,240,39,79,.494,22,39,.564,17,40,.425,23,29,.793,118,40,94,.426,30,56,.536,10,38,.263,18,25,.720,108
688,HOU,2021-12-03,118,,ORL,W 118-116,240,44,92,.478,27,45,.600,17,47,.362,13,15,.867,118,42,86,.488,29,49,.592,13,37,.351,19,21,.905,116
689,GSW,2021-12-03,118,,PHO,W 118-96,240,45,92,.489,26,53,.491,19,39,.487,9,12,.750,118,31,81,.383,23,59,.390,8,22,.364,26,35,.743,96
690,MIL,2021-11-28,118,@,IND,W 118-100,240,46,90,.511,38,55,.691,8,35,.229,18,22,.818,118,38,92,.413,26,47,.553,12,45,.267,12,16,.750,100
691,PHO,2021-11-26,118,@,NYK,W 118-97,240,44,79,.557,31,51,.608,13,28,.464,17,21,.810,118,34,92,.370,22,53,.415,12,39,.308,17,22,.773,97
692,GSW,2021-11-26,118,,POR,W 118-103,240,47,87,.540,35,50,.700,12,37,.324,12,16,.750,118,36,86,.419,23,48,.479,13,38,.342,18,23,.783,103
693,HOU,2021-11-24,118,,CHI,W 118-113,240,42,84,.500,25,48,.521,17,36,.472,17,22,.773,118,44,96,.458,29,61,.475,15,35,.429,10,12,.833,113
694,UTA,2021-11-22,118,,MEM,L 118-119,240,41,87,.471,24,44,.545,17,43,.395,19,25,.760,118,42,95,.442,29,60,.483,13,35,.371,22,27,.815,119
695,POR,2021-11-20,118,,PHI,W 118-111,240,40,80,.500,25,46,.543,15,34,.441,23,23,1.000,118,41,81,.506,31,53,.585,10,28,.357,19,21,.905,111
696,IND,2021-11-19,118,@,CHO,L 118-121,240,41,88,.466,30,52,.577,11,36,.306,25,32,.781,118,44,81,.543,32,50,.640,12,31,.387,21,28,.750,121
697,POR,2021-11-15,118,,TOR,W 118-113,240,46,82,.561,30,46,.652,16,36,.444,10,14,.714,118,41,89,.461,26,56,.464,15,33,.455,16,18,.889,113
698,IND,2021-11-13,118,,PHI,W 118-113,240,47,82,.573,33,54,.611,14,28,.500,10,15,.667,118,38,89,.427,26,66,.394,12,23,.522,25,29,.862,113
699,CHO,2021-11-10,118,@,MEM,W 118-108,240,41,90,.456,26,54,.481,15,36,.417,21,24,.875,118,45,107,.421,36,69,.522,9,38,.237,9,15,.600,108
700,MIL,2021-11-09,118,@,PHI,W 118-109,240,44,95,.463,29,56,.518,15,39,.385,15,21,.714,118,42,103,.408,28,60,.467,14,43,.326,11,12,.917,109
701,CHI,2021-11-08,118,,BRK,W 118-95,240,46,98,.469,37,67,.552,9,31,.290,17,20,.850,118,34,86,.395,23,53,.434,11,33,.333,16,19,.842,95
702,MIN,2021-11-08,118,@,MEM,L 118-125 (OT),265,41,97,.423,24,52,.462,17,45,.378,19,23,.826,118,46,92,.500,35,64,.547,11,28,.393,22,26,.846,125
703,MIA,2021-11-06,118,,UTA,W 118-115,240,47,78,.603,36,57,.632,11,21,.524,13,17,.765,118,43,83,.518,28,38,.737,15,45,.333,14,19,.737,115
704,SAS,2021-11-01,118,@,IND,L 118-131,240,47,89,.528,33,61,.541,14,28,.500,10,14,.714,118,52,91,.571,34,53,.642,18,38,.474,9,12,.750,131
705,ATL,2021-11-01,118,,WAS,W 118-111,240,38,83,.458,25,49,.510,13,34,.382,29,29,1.000,118,41,86,.477,28,47,.596,13,39,.333,16,16,1.000,111
706,TOR,2021-10-27,118,,IND,W 118-100,240,46,100,.460,32,70,.457,14,30,.467,12,19,.632,118,38,79,.481,28,50,.560,10,29,.345,14,17,.824,100
707,MEM,2021-10-24,118,@,LAL,L 118-121,240,45,100,.450,32,65,.492,13,35,.371,15,18,.833,118,45,84,.536,29,54,.537,16,30,.533,15,22,.682,121
708,LAC,2022-04-09,117,,SAC,W 117-98,240,42,86,.488,21,43,.488,21,43,.488,12,15,.800,117,38,86,.442,31,58,.534,7,28,.250,15,24,.625,98
709,TOR,2022-04-08,117,,HOU,W 117-115,240,44,96,.458,37,67,.552,7,29,.241,22,23,.957,117,43,81,.531,33,52,.635,10,29,.345,19,24,.792,115
710,CHI,2022-04-08,117,,CHO,L 117-133,240,44,82,.537,31,58,.534,13,24,.542,16,20,.800,117,52,86,.605,33,46,.717,19,40,.475,10,10,1.000,133
711,BOS,2022-04-06,117,@,CHI,W 117-94,240,43,88,.489,26,51,.510,17,37,.459,14,22,.636,117,35,80,.438,28,57,.491,7,23,.304,17,23,.739,94
712,OKC,2022-04-03,117,,PHO,W 117-96,240,43,87,.494,26,46,.565,17,41,.415,14,18,.778,117,37,89,.416,30,51,.588,7,38,.184,15,17,.882,96
713,IND,2022-04-03,117,,DET,L 117-121,240,45,94,.479,33,56,.589,12,38,.316,15,19,.789,117,43,99,.434,22,58,.379,21,41,.512,14,18,.778,121
714,HOU,2022-04-01,117,,SAC,L 117-122,240,41,97,.423,24,52,.462,17,45,.378,18,26,.692,117,42,81,.519,30,53,.566,12,28,.429,26,34,.765,122
715,NOP,2022-03-30,117,@,POR,W 117-107,240,40,78,.513,34,54,.630,6,24,.250,31,39,.795,117,39,85,.459,25,43,.581,14,42,.333,15,18,.833,107
716,TOR,2022-03-24,117,,CLE,W 117-104,240,42,89,.472,26,52,.500,16,37,.432,17,19,.895,117,37,79,.468,25,49,.510,12,30,.400,18,22,.818,104
717,ATL,2022-03-22,117,@,NYK,W 117-111,240,40,81,.494,25,45,.556,15,36,.417,22,27,.815,117,42,86,.488,29,52,.558,13,34,.382,14,26,.538,111
718,NOP,2022-03-20,117,@,ATL,W 117-112,240,43,96,.448,36,75,.480,7,21,.333,24,27,.889,117,41,87,.471,31,55,.564,10,32,.313,20,23,.870,112
719,MIL,2022-03-14,117,@,UTA,W 117-111,240,40,86,.465,28,55,.509,12,31,.387,25,29,.862,117,37,93,.398,20,45,.444,17,48,.354,20,24,.833,111
720,TOR,2022-03-11,117,@,PHO,W 117-112,240,42,94,.447,28,62,.452,14,32,.438,19,21,.905,117,44,88,.500,33,52,.635,11,36,.306,13,17,.765,112
721,MIA,2022-03-11,117,,CLE,W 117-105,240,41,86,.477,30,51,.588,11,35,.314,24,27,.889,117,35,79,.443,27,54,.500,8,25,.320,27,29,.931,105
722,SAS,2022-03-07,117,,LAL,W 117-110,240,46,84,.548,37,58,.638,9,26,.346,16,30,.533,117,43,91,.473,35,65,.538,8,26,.308,16,23,.696,110
723,SAS,2022-03-05,117,@,CHO,L 117-123,240,45,98,.459,34,61,.557,11,37,.297,16,20,.800,117,42,91,.462,26,49,.531,16,42,.381,23,29,.793,123
724,ATL,2022-03-04,117,@,WAS,W 117-114,240,38,91,.418,25,55,.455,13,36,.361,28,34,.824,117,46,85,.541,32,56,.571,14,29,.483,8,9,.889,114
725,NOP,2022-02-25,117,@,PHO,W 117-102,240,38,87,.437,30,58,.517,8,29,.276,33,41,.805,117,36,82,.439,24,42,.571,12,40,.300,18,24,.750,102
726,WAS,2022-02-17,117,@,BRK,W 117-103,240,46,83,.554,34,59,.576,12,24,.500,13,16,.813,117,36,89,.404,22,51,.431,14,38,.368,17,24,.708,103
727,DEN,2022-02-16,117,@,GSW,W 117-116,240,43,91,.473,29,55,.527,14,36,.389,17,21,.810,117,45,87,.517,35,53,.660,10,34,.294,16,24,.667,116
728,GSW,2022-02-12,117,,LAL,W 117-115,240,40,90,.444,28,52,.538,12,38,.316,25,34,.735,117,41,88,.466,30,61,.492,11,27,.407,22,33,.667,115
729,TOR,2022-02-09,117,@,OKC,W 117-98,240,45,88,.511,32,53,.604,13,35,.371,14,14,1.000,117,36,87,.414,22,40,.550,14,47,.298,12,14,.857,98
730,DET,2022-02-03,117,,MIN,L 117-128,240,40,91,.440,25,45,.556,15,46,.326,22,28,.786,117,44,87,.506,29,53,.547,15,34,.441,25,28,.893,128
731,CHO,2022-01-28,117,,LAL,W 117-114,240,43,83,.518,32,47,.681,11,36,.306,20,28,.714,117,38,91,.418,23,51,.451,15,40,.375,23,32,.719,114
732,PHI,2022-01-25,117,,NOP,W 117-107,240,39,84,.464,29,53,.547,10,31,.323,29,31,.935,117,40,83,.482,31,61,.508,9,22,.409,18,26,.692,107
733,NOP,2022-01-24,117,,IND,W 117-113,240,41,88,.466,35,58,.603,6,30,.200,29,31,.935,117,38,87,.437,19,41,.463,19,46,.413,18,25,.720,113
734,DEN,2022-01-23,117,,DET,W 117-111,240,44,85,.518,32,50,.640,12,35,.343,17,23,.739,117,42,75,.560,31,46,.674,11,29,.379,16,19,.842,111
735,BRK,2022-01-21,117,@,SAS,W 117-102,240,48,100,.480,39,75,.520,9,25,.360,12,12,1.000,117,37,95,.389,29,66,.439,8,29,.276,20,24,.833,102
736,GSW,2022-01-20,117,,IND,L 117-121 (OT),265,42,94,.447,33,52,.635,9,42,.214,24,29,.828,117,41,95,.432,26,60,.433,15,35,.429,24,34,.706,121
737,CHI,2022-01-19,117,,CLE,W 117-104,240,47,86,.547,37,64,.578,10,22,.455,13,18,.722,117,40,77,.519,31,50,.620,9,27,.333,15,22,.682,104
738,WAS,2022-01-17,117,,PHI,W 117-98,240,42,87,.483,33,57,.579,9,30,.300,24,32,.750,117,35,86,.407,28,60,.467,7,26,.269,21,25,.840,98
739,NYK,2022-01-15,117,@,ATL,W 117-108,240,42,83,.506,29,52,.558,13,31,.419,20,26,.769,117,40,80,.500,24,36,.667,16,44,.364,12,17,.706,108
740,TOR,2022-01-05,117,@,MIL,W 117-111,240,42,89,.472,26,53,.491,16,36,.444,17,25,.680,117,38,85,.447,21,46,.457,17,39,.436,18,26,.692,111
741,DET,2022-01-01,117,,SAS,W 117-116 (OT),265,41,101,.406,32,66,.485,9,35,.257,26,33,.788,117,42,102,.412,30,62,.484,12,40,.300,20,28,.714,116
742,ATL,2021-12-29,117,@,CHI,L 117-131,240,44,92,.478,33,66,.500,11,26,.423,18,26,.692,117,52,84,.619,42,62,.677,10,22,.455,17,22,.773,131
743,SAC,2021-12-28,117,,OKC,W 117-111,240,40,95,.421,23,56,.411,17,39,.436,20,27,.741,117,35,90,.389,24,57,.421,11,33,.333,30,36,.833,111
744,POR,2021-12-27,117,,DAL,L 117-132,240,35,82,.427,23,42,.548,12,40,.300,35,42,.833,117,48,84,.571,36,51,.706,12,33,.364,24,33,.727,132
745,OKC,2021-12-26,117,,NOP,W 117-112,240,41,86,.477,28,50,.560,13,36,.361,22,31,.710,117,39,94,.415,29,53,.547,10,41,.244,24,28,.857,112
746,PHI,2021-12-26,117,@,WAS,W 117-96,240,43,86,.500,31,55,.564,12,31,.387,19,22,.864,117,35,90,.389,27,57,.474,8,33,.242,18,28,.643,96
747,MIL,2021-12-25,117,,BOS,W 117-113,240,43,91,.473,31,58,.534,12,33,.364,19,27,.704,117,38,89,.427,21,44,.477,17,45,.378,20,24,.833,113
748,NYK,2021-12-23,117,,WAS,L 117-124,240,42,93,.452,29,51,.569,13,42,.310,20,23,.870,117,42,75,.560,26,38,.684,16,37,.432,24,32,.750,124
749,BOS,2021-12-13,117,,MIL,W 117-103,240,43,86,.500,23,39,.590,20,47,.426,11,13,.846,117,40,90,.444,29,54,.537,11,36,.306,12,15,.800,103
750,CLE,2021-12-11,117,,SAC,W 117-103,240,41,88,.466,29,57,.509,12,31,.387,23,28,.821,117,41,93,.441,34,65,.523,7,28,.250,14,22,.636,103
751,LAL,2021-12-07,117,,BOS,W 117-102,240,48,93,.516,40,66,.606,8,27,.296,13,17,.765,117,36,82,.439,26,49,.531,10,33,.303,20,29,.690,102
752,POR,2021-12-04,117,,BOS,L 117-145,240,42,89,.472,34,60,.567,8,29,.276,25,32,.781,117,49,87,.563,28,50,.560,21,37,.568,26,29,.897,145
753,LAL,2021-11-30,117,@,SAC,W 117-92,240,46,92,.500,35,64,.547,11,28,.393,14,20,.700,117,35,79,.443,29,50,.580,6,29,.207,16,22,.727,92
754,BRK,2021-11-22,117,@,CLE,W 117-112,240,45,95,.474,34,60,.567,11,35,.314,16,18,.889,117,36,93,.387,22,49,.449,14,44,.318,26,29,.897,112
755,MIL,2021-11-20,117,,ORL,W 117-108,240,37,82,.451,18,42,.429,19,40,.475,24,37,.649,117,39,98,.398,20,47,.426,19,51,.373,11,14,.786,108
756,GSW,2021-11-16,117,@,BRK,W 117-99,240,41,79,.519,28,39,.718,13,40,.325,22,28,.786,117,34,88,.386,24,52,.462,10,36,.278,21,27,.778,99
757,SAC,2021-11-10,117,@,SAS,L 117-136,240,47,91,.516,37,55,.673,10,36,.278,13,16,.813,117,49,92,.533,31,60,.517,18,32,.563,20,31,.645,136
758,MIA,2021-11-10,117,@,LAL,L 117-120 (OT),265,40,96,.417,30,59,.508,10,37,.270,27,35,.771,117,46,92,.500,28,54,.519,18,38,.474,10,16,.625,120
759,CHI,2021-11-10,117,,DAL,W 117-107,240,45,89,.506,30,58,.517,15,31,.484,12,14,.857,117,38,83,.458,26,50,.520,12,33,.364,19,24,.792,107
760,LAC,2021-11-09,117,,POR,W 117-109,240,44,85,.518,28,55,.509,16,30,.533,13,19,.684,117,43,91,.473,29,54,.537,14,37,.378,9,12,.750,109
761,ATL,2021-11-06,117,@,PHO,L 117-121,240,42,97,.433,29,64,.453,13,33,.394,20,23,.870,117,45,88,.511,31,45,.689,14,43,.326,17,21,.810,121
762,BRK,2021-11-03,117,,ATL,W 117-108,240,43,88,.489,21,40,.525,22,48,.458,9,12,.750,117,41,94,.436,28,59,.475,13,35,.371,13,15,.867,108
763,MIL,2021-11-02,117,@,DET,W 117-89,240,42,84,.500,25,47,.532,17,37,.459,16,21,.762,117,30,93,.323,22,46,.478,8,47,.170,21,30,.700,89
764,HOU,2021-11-02,117,@,LAL,L 117-119,240,48,91,.527,32,49,.653,16,42,.381,5,12,.417,117,49,93,.527,43,68,.632,6,25,.240,15,20,.750,119
765,BRK,2021-10-31,117,,DET,W 117-91,240,47,72,.653,34,47,.723,13,25,.520,10,16,.625,117,32,79,.405,20,46,.435,12,33,.364,15,22,.682,91
766,NOP,2021-10-30,117,,NYK,L 117-123,240,42,92,.457,31,59,.525,11,33,.333,22,24,.917,117,42,81,.519,23,48,.479,19,33,.576,20,25,.800,123
767,PHI,2021-10-20,117,@,NOP,W 117-97,240,44,85,.518,31,60,.517,13,25,.520,16,20,.800,117,39,93,.419,26,63,.413,13,30,.433,6,9,.667,97
768,SAC,2022-04-10,116,@,PHO,W 116-109,240,40,76,.526,26,50,.520,14,26,.538,22,30,.733,116,42,103,.408,28,56,.500,14,47,.298,11,15,.733,109
769,SAS,2022-04-05,116,@,DEN,W 116-97,240,44,89,.494,32,63,.508,12,26,.462,16,24,.667,116,41,98,.418,34,65,.523,7,33,.212,8,12,.667,97
770,PHI,2022-03-29,116,,MIL,L 116-118,240,43,89,.483,27,48,.563,16,41,.390,14,18,.778,116,44,88,.500,30,50,.600,14,38,.368,16,23,.696,118
771,NOP,2022-03-27,116,,LAL,W 116-108,240,44,91,.484,35,64,.547,9,27,.333,19,24,.792,116,42,80,.525,28,45,.622,14,35,.400,10,16,.625,108
772,MIN,2022-03-25,116,,DAL,W 116-95,240,43,84,.512,32,52,.615,11,32,.344,19,24,.792,116,35,90,.389,25,47,.532,10,43,.233,15,19,.789,95
773,MIN,2022-03-23,116,,PHO,L 116-125,240,42,95,.442,29,52,.558,13,43,.302,19,22,.864,116,45,86,.523,33,53,.623,12,33,.364,23,29,.793,125
774,DEN,2022-03-18,116,@,CLE,L 116-119 (OT),265,46,92,.500,36,59,.610,10,33,.303,14,18,.778,116,44,98,.449,30,61,.492,14,37,.378,17,26,.654,119
775,CHO,2022-03-16,116,,ATL,W 116-106,240,43,87,.494,32,52,.615,11,35,.314,19,23,.826,116,40,93,.430,27,56,.482,13,37,.351,13,14,.929,106
776,OKC,2022-03-14,116,,CHO,L 116-134,240,42,90,.467,26,46,.565,16,44,.364,16,19,.842,116,49,91,.538,29,56,.518,20,35,.571,16,21,.762,134
777,PHI,2022-03-13,116,@,ORL,W 116-114 (OT),265,35,92,.380,21,55,.382,14,37,.378,32,37,.865,116,41,91,.451,23,48,.479,18,43,.419,14,20,.700,114
778,UTA,2022-03-06,116,@,OKC,W 116-103,240,40,89,.449,17,37,.459,23,52,.442,13,17,.765,116,39,92,.424,31,52,.596,8,40,.200,17,19,.895,103
779,NYK,2022-03-06,116,@,LAC,W 116-93,240,42,89,.472,29,60,.483,13,29,.448,19,30,.633,116,33,88,.375,22,54,.407,11,34,.324,16,22,.727,93
780,GSW,2022-03-05,116,@,LAL,L 116-124,240,46,92,.500,31,58,.534,15,34,.441,9,19,.474,116,44,89,.494,26,48,.542,18,41,.439,18,21,.857,124
781,DEN,2022-03-04,116,,HOU,W 116-101,240,39,86,.453,26,53,.491,13,33,.394,25,31,.806,116,38,83,.458,28,47,.596,10,36,.278,15,22,.682,101
782,WAS,2022-03-01,116,,DET,W 116-113,240,41,82,.500,28,56,.500,13,26,.500,21,26,.808,116,43,90,.478,35,63,.556,8,27,.296,19,23,.826,113
783,MEM,2022-02-26,116,@,CHI,W 116-110,240,44,100,.440,37,77,.481,7,23,.304,21,26,.808,116,39,93,.419,30,73,.411,9,20,.450,23,30,.767,110
784,GSW,2022-02-16,116,,DEN,L 116-117,240,45,87,.517,35,53,.660,10,34,.294,16,24,.667,116,43,91,.473,29,55,.527,14,36,.389,17,21,.810,117
785,CLE,2022-02-15,116,@,ATL,L 116-124,240,45,88,.511,29,47,.617,16,41,.390,10,12,.833,116,43,80,.538,29,47,.617,14,33,.424,24,27,.889,124
786,NYK,2022-02-10,116,@,GSW,W 116-114,240,39,90,.433,25,54,.463,14,36,.389,24,33,.727,116,42,91,.462,27,46,.587,15,45,.333,15,17,.882,114
787,DAL,2022-02-08,116,,DET,W 116-86,240,40,79,.506,22,43,.512,18,36,.500,18,23,.783,116,33,87,.379,28,57,.491,5,30,.167,15,22,.682,86
788,LAL,2022-02-08,116,,MIL,L 116-131,240,44,85,.518,34,53,.642,10,32,.313,18,30,.600,116,52,96,.542,37,60,.617,15,36,.417,12,20,.600,131
789,TOR,2022-02-07,116,@,CHO,W 116-101,240,41,84,.488,26,49,.531,15,35,.429,19,29,.655,116,39,95,.411,30,55,.545,9,40,.225,14,16,.875,101
790,BOS,2022-02-06,116,@,ORL,W 116-83,240,45,99,.455,32,53,.604,13,46,.283,13,14,.929,116,29,81,.358,24,55,.436,5,26,.192,20,21,.952,83
791,LAC,2022-01-31,116,@,IND,L 116-122,240,45,96,.469,30,52,.577,15,44,.341,11,13,.846,116,50,95,.526,36,66,.545,14,29,.483,8,12,.667,122
792,NYK,2022-01-31,116,,SAC,W 116-96,240,40,80,.500,27,45,.600,13,35,.371,23,29,.793,116,37,86,.430,26,48,.542,11,38,.289,11,22,.500,96
793,POR,2022-01-30,116,@,CHI,L 116-130,240,43,83,.518,25,44,.568,18,39,.462,12,16,.750,116,50,90,.556,37,58,.638,13,32,.406,17,18,.944,130
794,DEN,2022-01-28,116,@,NOP,W 116-105,240,41,82,.500,29,49,.592,12,33,.364,22,25,.880,116,35,90,.389,30,56,.536,5,34,.147,30,33,.909,105
795,LAC,2022-01-25,116,@,WAS,W 116-115,240,39,94,.415,28,65,.431,11,29,.379,27,31,.871,116,37,80,.463,28,53,.528,9,27,.333,32,40,.800,115
796,BOS,2022-01-23,116,@,WAS,W 116-87,240,40,90,.444,21,51,.412,19,39,.487,17,21,.810,116,33,93,.355,25,59,.424,8,34,.235,13,16,.813,87
797,LAL,2022-01-21,116,@,ORL,W 116-105,240,42,85,.494,29,55,.527,13,30,.433,19,23,.826,116,36,81,.444,25,41,.610,11,40,.275,22,29,.759,105
798,HOU,2022-01-19,116,@,UTA,W 116-111,240,41,96,.427,19,51,.373,22,45,.489,12,17,.706,116,42,89,.472,32,51,.627,10,38,.263,17,20,.850,111
799,ORL,2022-01-14,116,@,CHO,W 116-109,240,45,87,.517,30,42,.714,15,45,.333,11,15,.733,116,40,97,.412,28,55,.509,12,42,.286,17,21,.810,109
800,MEM,2022-01-13,116,,MIN,W 116-108,240,42,92,.457,34,60,.567,8,32,.250,24,35,.686,116,41,96,.427,26,48,.542,15,48,.313,11,14,.786,108
801,LAL,2022-01-12,116,@,SAC,L 116-125,240,42,98,.429,26,51,.510,16,47,.340,16,24,.667,116,49,89,.551,38,59,.644,11,30,.367,16,19,.842,125
802,MEM,2022-01-11,116,,GSW,W 116-108,240,44,100,.440,30,66,.455,14,34,.412,14,18,.778,116,35,82,.427,22,46,.478,13,36,.361,25,29,.862,108
803,UTA,2022-01-10,116,@,DET,L 116-126,240,44,86,.512,33,53,.623,11,33,.333,17,22,.773,116,48,93,.516,29,56,.518,19,37,.514,11,12,.917,126
804,PHI,2022-01-05,116,@,ORL,W 116-106,240,43,85,.506,31,57,.544,12,28,.429,18,24,.750,116,40,90,.444,28,51,.549,12,39,.308,14,20,.700,106
805,BOS,2022-01-02,116,,ORL,W 116-111 (OT),265,39,86,.453,26,50,.520,13,36,.361,25,28,.893,116,40,95,.421,31,68,.456,9,27,.333,22,27,.815,111
806,SAS,2022-01-01,116,@,DET,L 116-117 (OT),265,42,102,.412,30,62,.484,12,40,.300,20,28,.714,116,41,101,.406,32,66,.485,9,35,.257,26,33,.788,117
807,UTA,2022-01-01,116,,GSW,L 116-123,240,40,92,.435,26,48,.542,14,44,.318,22,28,.786,116,46,86,.535,29,54,.537,17,32,.531,14,21,.667,123
808,BRK,2022-01-01,116,,LAC,L 116-120,240,42,97,.433,31,64,.484,11,33,.333,21,25,.840,116,42,86,.488,28,50,.560,14,36,.389,22,31,.710,120
809,TOR,2021-12-31,116,,LAC,W 116-108,240,40,96,.417,29,61,.475,11,35,.314,25,33,.758,116,38,78,.487,23,44,.523,15,34,.441,17,19,.895,108
810,CHO,2021-12-29,116,@,IND,W 116-108,240,44,85,.518,35,59,.593,9,26,.346,19,32,.594,116,36,86,.419,19,41,.463,17,45,.378,19,29,.655,108
811,GSW,2021-12-25,116,@,PHO,W 116-107,240,42,85,.494,28,48,.583,14,37,.378,18,21,.857,116,40,83,.482,29,53,.547,11,30,.367,16,16,1.000,107
812,DAL,2021-12-25,116,@,UTA,L 116-120,240,38,89,.427,28,59,.475,10,30,.333,30,35,.857,116,40,90,.444,28,54,.519,12,36,.333,28,37,.757,120
813,MIN,2021-12-23,116,@,UTA,L 116-128,240,45,101,.446,28,56,.500,17,45,.378,9,12,.750,116,48,90,.533,32,51,.627,16,39,.410,16,22,.727,128
814,SAS,2021-12-20,116,@,LAC,W 116-92,240,50,114,.439,38,77,.494,12,37,.324,4,6,.667,116,34,87,.391,25,55,.455,9,32,.281,15,20,.750,92
815,HOU,2021-12-18,116,@,DET,W 116-107,240,46,93,.495,32,55,.582,14,38,.368,10,17,.588,116,43,93,.462,33,57,.579,10,36,.278,11,16,.688,107
816,CHO,2021-12-17,116,@,POR,L 116-125,240,44,92,.478,31,55,.564,13,37,.351,15,18,.833,116,44,85,.518,23,38,.605,21,47,.447,16,18,.889,125
817,NOP,2021-12-17,116,,MIL,W 116-112 (OT),265,42,89,.472,29,52,.558,13,37,.351,19,30,.633,116,45,104,.433,31,57,.544,14,47,.298,8,10,.800,112
818,NYK,2021-12-16,116,@,HOU,W 116-103,240,39,83,.470,22,47,.468,17,36,.472,21,25,.840,116,34,68,.500,23,36,.639,11,32,.344,24,30,.800,103
819,MIN,2021-12-12,116,@,POR,W 116-111,240,38,85,.447,24,49,.490,14,36,.389,26,32,.813,116,37,81,.457,19,33,.576,18,48,.375,19,28,.679,111
820,BRK,2021-12-12,116,@,DET,W 116-104,240,41,87,.471,30,59,.508,11,28,.393,23,25,.920,116,39,92,.424,25,55,.455,14,37,.378,12,18,.667,104
821,LAL,2021-12-10,116,@,OKC,W 116-95,240,41,87,.471,22,45,.489,19,42,.452,15,20,.750,116,38,96,.396,28,52,.538,10,44,.227,9,14,.643,95
822,DET,2021-12-08,116,,WAS,L 116-119 (OT),265,37,79,.468,24,55,.436,13,24,.542,29,35,.829,116,42,88,.477,30,56,.536,12,32,.375,23,28,.821,119
823,IND,2021-12-06,116,,WAS,W 116-110,240,43,82,.524,34,59,.576,9,23,.391,21,22,.955,116,43,81,.531,36,66,.545,7,15,.467,17,21,.810,110
824,CLE,2021-12-03,116,@,WAS,W 116-101,240,42,89,.472,29,59,.492,13,30,.433,19,25,.760,116,38,82,.463,28,51,.549,10,31,.323,15,19,.789,101
825,ORL,2021-12-03,116,@,HOU,L 116-118,240,42,86,.488,29,49,.592,13,37,.351,19,21,.905,116,44,92,.478,27,45,.600,17,47,.362,13,15,.867,118
826,SAS,2021-11-29,116,,WAS,W 116-99,240,49,92,.533,41,74,.554,8,18,.444,10,16,.625,116,41,92,.446,32,61,.525,9,31,.290,8,13,.615,99
827,GSW,2021-11-24,116,,PHI,W 116-96,240,42,80,.525,27,42,.643,15,38,.395,17,24,.708,116,34,80,.425,26,52,.500,8,28,.286,20,22,.909,96
828,IND,2021-11-24,116,,LAL,L 116-124 (OT),265,42,104,.404,29,58,.500,13,46,.283,19,24,.792,116,42,95,.442,27,58,.466,15,37,.405,25,29,.862,124
829,DET,2021-11-21,116,,LAL,L 116-121,240,43,97,.443,29,57,.509,14,40,.350,16,21,.762,116,45,92,.489,35,61,.574,10,31,.323,21,27,.778,121
830,BRK,2021-11-07,116,@,TOR,W 116-103,240,41,80,.513,24,42,.571,17,38,.447,17,20,.850,116,41,87,.471,34,57,.596,7,30,.233,14,18,.778,103
831,UTA,2021-11-04,116,@,ATL,W 116-98,240,41,81,.506,24,40,.600,17,41,.415,17,23,.739,116,35,82,.427,28,54,.519,7,28,.250,21,26,.808,98
832,POR,2021-10-27,116,,MEM,W 116-96,240,39,84,.464,24,48,.500,15,36,.417,23,31,.742,116,35,96,.365,18,46,.391,17,50,.340,9,19,.474,96
833,WAS,2021-10-27,116,@,BOS,W 116-107,240,43,84,.512,34,59,.576,9,25,.360,21,29,.724,116,37,85,.435,27,56,.482,10,29,.345,23,28,.821,107
834,DAL,2021-10-26,116,,HOU,W 116-106,240,43,93,.462,31,50,.620,12,43,.279,18,25,.720,116,36,86,.419,20,47,.426,16,39,.410,18,26,.692,106
835,LAC,2021-10-25,116,,POR,W 116-86,240,44,93,.473,30,50,.600,14,43,.326,14,19,.737,116,32,85,.376,24,48,.500,8,37,.216,14,18,.778,86
836,MIL,2022-04-10,115,@,CLE,L 115-133,240,39,88,.443,27,58,.466,12,30,.400,25,32,.781,115,51,94,.543,32,56,.571,19,38,.500,12,17,.706,133
837,HOU,2022-04-08,115,@,TOR,L 115-117,240,43,81,.531,33,52,.635,10,29,.345,19,24,.792,115,44,96,.458,37,67,.552,7,29,.241,22,23,.957,117
838,CLE,2022-04-05,115,@,ORL,L 115-120,240,42,86,.488,26,50,.520,16,36,.444,15,22,.682,115,47,93,.505,31,58,.534,16,35,.457,10,15,.667,120
839,MEM,2022-04-05,115,@,UTA,L 115-121 (OT),265,39,101,.386,26,70,.371,13,31,.419,24,29,.828,115,40,96,.417,28,58,.483,12,38,.316,29,43,.674,121
840,CHO,2022-04-05,115,@,MIA,L 115-144,240,45,85,.529,33,47,.702,12,38,.316,13,18,.722,115,48,84,.571,25,42,.595,23,42,.548,25,29,.862,144
841,BRK,2022-04-02,115,@,ATL,L 115-122,240,42,99,.424,25,62,.403,17,37,.459,14,19,.737,115,36,86,.419,23,45,.511,13,41,.317,37,49,.755,122
842,UTA,2022-03-29,115,@,LAC,L 115-121,240,43,78,.551,31,47,.660,12,31,.387,17,29,.586,115,41,83,.494,26,47,.553,15,36,.417,24,28,.857,121
843,TOR,2022-03-28,115,,BOS,W 115-112 (OT),265,46,106,.434,36,67,.537,10,39,.256,13,18,.722,115,39,95,.411,27,55,.491,12,40,.300,22,28,.786,112
844,GSW,2022-03-27,115,@,WAS,L 115-123,240,38,89,.427,30,56,.536,8,33,.242,31,39,.795,115,44,84,.524,28,56,.500,16,28,.571,19,22,.864,123
845,HOU,2022-03-26,115,@,POR,W 115-98,240,44,84,.524,29,49,.592,15,35,.429,12,18,.667,115,37,93,.398,25,53,.472,12,40,.300,12,17,.706,98
846,LAC,2022-03-22,115,@,DEN,L 115-127,240,42,86,.488,32,54,.593,10,32,.313,21,26,.808,115,45,83,.542,29,51,.569,16,32,.500,21,23,.913,127
847,HOU,2022-03-21,115,,WAS,W 115-97,240,42,85,.494,22,46,.478,20,39,.513,11,13,.846,115,35,85,.412,29,56,.518,6,29,.207,21,24,.875,97
848,DET,2022-03-21,115,,POR,L 115-119,240,36,85,.424,27,50,.540,9,35,.257,34,41,.829,115,37,88,.420,29,60,.483,8,28,.286,37,49,.755,119
849,NOP,2022-03-15,115,,PHO,L 115-131,240,43,86,.500,31,52,.596,12,34,.353,17,24,.708,115,49,90,.544,31,56,.554,18,34,.529,15,15,1.000,131
850,DEN,2022-03-12,115,,TOR,L 115-127,240,43,78,.551,32,51,.627,11,27,.407,18,24,.750,115,48,102,.471,36,71,.507,12,31,.387,19,25,.760,127
851,ATL,2022-03-09,115,@,MIL,L 115-124,240,43,86,.500,32,48,.667,11,38,.289,18,22,.818,115,47,94,.500,35,59,.593,12,35,.343,18,23,.783,124
852,BOS,2022-03-09,115,@,CHO,W 115-101,240,46,93,.495,34,56,.607,12,37,.324,11,14,.786,115,36,85,.424,28,52,.538,8,33,.242,21,28,.750,101
853,LAC,2022-03-09,115,,WAS,W 115-109,240,43,86,.500,27,54,.500,16,32,.500,13,13,1.000,115,41,87,.471,31,60,.517,10,27,.370,17,20,.850,109
854,OKC,2022-03-08,115,,MIL,L 115-142,240,42,84,.500,26,45,.578,16,39,.410,15,21,.714,115,53,100,.530,33,60,.550,20,40,.500,16,20,.800,142
855,SAC,2022-03-07,115,,NYK,L 115-131,240,39,80,.488,28,48,.583,11,32,.344,26,36,.722,115,47,92,.511,29,50,.580,18,42,.429,19,23,.826,131
856,PHO,2022-03-04,115,,NYK,W 115-114,240,38,85,.447,21,51,.412,17,34,.500,22,27,.815,115,40,86,.465,27,57,.474,13,29,.448,21,30,.700,114
857,SAC,2022-03-03,115,@,SAS,W 115-112,240,39,85,.459,29,53,.547,10,32,.313,27,32,.844,115,46,93,.495,34,61,.557,12,32,.375,8,16,.500,112
858,DEN,2022-02-26,115,,SAC,W 115-110,240,38,82,.463,22,39,.564,16,43,.372,23,29,.793,115,38,89,.427,29,59,.492,9,30,.300,25,33,.758,110
859,MIA,2022-02-25,115,@,NYK,W 115-100,240,39,83,.470,28,51,.549,11,32,.344,26,35,.743,115,30,75,.400,16,35,.457,14,40,.350,26,36,.722,100
860,LAL,2022-02-12,115,@,GSW,L 115-117,240,41,88,.466,30,61,.492,11,27,.407,22,33,.667,115,40,90,.444,28,52,.538,12,38,.316,25,34,.735,117
861,MIA,2022-02-12,115,,BRK,W 115-111,240,41,82,.500,31,53,.585,10,29,.345,23,29,.793,115,42,93,.452,30,53,.566,12,40,.300,15,22,.682,111
862,NYK,2022-02-08,115,@,DEN,L 115-132,240,45,101,.446,30,58,.517,15,43,.349,10,12,.833,115,46,85,.541,30,46,.652,16,39,.410,24,31,.774,132
863,ORL,2022-02-05,115,,MEM,L 115-135,240,39,90,.433,22,42,.524,17,48,.354,20,29,.690,115,53,105,.505,40,66,.606,13,39,.333,16,22,.727,135
864,NYK,2022-02-05,115,@,LAL,L 115-122 (OT),265,39,98,.398,28,60,.467,11,38,.289,26,36,.722,115,48,102,.471,39,68,.574,9,34,.265,17,28,.607,122
865,IND,2022-02-04,115,,CHI,L 115-122,240,47,95,.495,35,68,.515,12,27,.444,9,9,1.000,115,49,90,.544,43,64,.672,6,26,.231,18,23,.783,122
866,PHO,2022-02-03,115,@,ATL,L 115-124,240,46,88,.523,37,56,.661,9,32,.281,14,18,.778,115,44,84,.524,24,44,.545,20,40,.500,16,22,.727,124
867,HOU,2022-02-02,115,,CLE,W 115-104,240,39,82,.476,25,42,.595,14,40,.350,23,33,.697,115,41,80,.513,34,59,.576,7,21,.333,15,27,.556,104
868,ORL,2022-02-01,115,@,CHI,L 115-126,240,46,93,.495,32,54,.593,14,39,.359,9,11,.818,115,46,90,.511,35,60,.583,11,30,.367,23,29,.793,126
869,DEN,2022-02-01,115,@,MIN,L 115-130,240,38,89,.427,24,45,.533,14,44,.318,25,28,.893,115,46,93,.495,27,48,.563,19,45,.422,19,25,.760,130
870,LAC,2022-01-30,115,@,CHO,W 115-90,240,44,84,.524,33,56,.589,11,28,.393,16,19,.842,115,32,98,.327,24,64,.375,8,34,.235,18,27,.667,90
871,DET,2022-01-30,115,,CLE,W 115-105,240,42,91,.462,32,65,.492,10,26,.385,21,25,.840,115,38,82,.463,25,48,.521,13,34,.382,16,25,.640,105
872,PHO,2022-01-30,115,,SAS,W 115-110,240,48,97,.495,37,65,.569,11,32,.344,8,12,.667,115,45,100,.450,32,63,.508,13,37,.351,7,8,.875,110
873,MEM,2022-01-29,115,,WAS,W 115-95,240,46,100,.460,33,69,.478,13,31,.419,10,12,.833,115,35,84,.417,25,55,.455,10,29,.345,15,21,.714,95
874,MIN,2022-01-27,115,@,GSW,L 115-124,240,42,95,.442,32,51,.627,10,44,.227,21,27,.778,115,44,82,.537,23,46,.500,21,36,.583,15,21,.714,124
875,CLE,2022-01-26,115,,MIL,W 115-99,240,41,87,.471,22,45,.489,19,42,.452,14,17,.824,115,37,80,.463,28,48,.583,9,32,.281,16,18,.889,99
876,WAS,2022-01-25,115,,LAC,L 115-116,240,37,80,.463,28,53,.528,9,27,.333,32,40,.800,115,39,94,.415,28,65,.431,11,29,.379,27,31,.871,116
877,PHO,2022-01-24,115,,UTA,W 115-109,240,47,99,.475,34,63,.540,13,36,.361,8,15,.533,115,40,81,.494,26,50,.520,14,31,.452,15,22,.682,109
878,PHI,2022-01-23,115,@,SAS,W 115-109,240,44,92,.478,37,76,.487,7,16,.438,20,23,.870,115,42,89,.472,32,59,.542,10,30,.333,15,22,.682,109
879,POR,2022-01-15,115,@,WAS,W 115-110,240,39,85,.459,26,46,.565,13,39,.333,24,35,.686,115,39,90,.433,27,53,.509,12,37,.324,20,23,.870,110
880,MIA,2022-01-12,115,@,ATL,W 115-91,240,43,90,.478,27,45,.600,16,45,.356,13,14,.929,115,31,82,.378,18,37,.486,13,45,.289,16,23,.696,91
881,UTA,2022-01-05,115,@,DEN,W 115-109,240,43,92,.467,29,51,.569,14,41,.341,15,18,.833,115,42,88,.477,31,52,.596,11,36,.306,14,15,.933,109
882,MIA,2022-01-05,115,@,POR,W 115-109,240,37,82,.451,18,41,.439,19,41,.463,22,29,.759,115,33,78,.423,18,40,.450,15,38,.395,28,36,.778,109
883,UTA,2022-01-03,115,@,NOP,W 115-104,240,41,85,.482,22,46,.478,19,39,.487,14,17,.824,115,39,97,.402,27,51,.529,12,46,.261,14,22,.636,104
884,DET,2022-01-03,115,@,MIL,W 115-106,240,44,91,.484,26,48,.542,18,43,.419,9,14,.643,115,39,92,.424,28,46,.609,11,46,.239,17,22,.773,106
885,GSW,2022-01-03,115,,MIA,W 115-108,240,45,92,.489,31,54,.574,14,38,.368,11,13,.846,115,37,90,.411,20,48,.417,17,42,.405,17,19,.895,108
886,SAC,2022-01-02,115,,MIA,W 115-113,240,40,78,.513,27,44,.614,13,34,.382,22,27,.815,115,46,105,.438,37,72,.514,9,33,.273,12,12,1.000,113
887,PHO,2021-12-29,115,,OKC,W 115-97,240,41,89,.461,29,55,.527,12,34,.353,21,28,.750,115,38,96,.396,31,61,.508,7,35,.200,14,16,.875,97
888,LAL,2021-12-25,115,,BRK,L 115-122,240,40,96,.417,30,61,.492,10,35,.286,25,28,.893,115,43,89,.483,29,57,.509,14,32,.438,22,27,.815,122
889,MIA,2021-12-23,115,,DET,W 115-112,240,43,88,.489,31,56,.554,12,32,.375,17,19,.895,115,36,80,.450,18,40,.450,18,40,.450,22,25,.880,112
890,CHO,2021-12-23,115,@,DEN,W 115-107,240,39,94,.415,23,47,.489,16,47,.340,21,24,.875,115,40,96,.417,26,56,.464,14,40,.350,13,17,.765,107
891,CHI,2021-12-19,115,,LAL,W 115-110,240,40,93,.430,30,63,.476,10,30,.333,25,31,.806,115,42,82,.512,30,48,.625,12,34,.353,14,22,.636,110
892,MIA,2021-12-17,115,@,ORL,W 115-105,240,41,82,.500,22,47,.468,19,35,.543,14,19,.737,115,43,89,.483,32,57,.561,11,32,.344,8,10,.800,105
893,ATL,2021-12-17,115,,DEN,L 115-133,240,41,88,.466,34,64,.531,7,24,.292,26,34,.765,115,50,86,.581,33,48,.688,17,38,.447,16,18,.889,133
894,SAS,2021-12-15,115,,CHO,L 115-131,240,39,90,.433,27,53,.509,12,37,.324,25,25,1.000,115,51,86,.593,33,52,.635,18,34,.529,11,16,.688,131
895,CLE,2021-12-08,115,,CHI,W 115-92,240,44,80,.550,31,52,.596,13,28,.464,14,16,.875,115,35,84,.417,28,58,.483,7,26,.269,15,21,.714,92
896,LAL,2021-12-03,115,,LAC,L 115-119,240,45,90,.500,33,57,.579,12,33,.364,13,21,.619,115,41,81,.506,25,46,.543,16,35,.457,21,24,.875,119
897,NYK,2021-12-02,115,,CHI,L 115-119,240,42,82,.512,33,56,.589,9,26,.346,22,27,.815,115,44,89,.494,33,60,.550,11,29,.379,20,21,.952,119
898,LAC,2021-12-01,115,,SAC,L 115-124,240,47,100,.470,38,69,.551,9,31,.290,12,16,.750,115,46,88,.523,31,50,.620,15,38,.395,17,20,.850,124
899,WAS,2021-12-01,115,,MIN,W 115-107,240,45,91,.495,35,59,.593,10,32,.313,15,21,.714,115,37,88,.420,26,51,.510,11,37,.297,22,26,.846,107
900,MIN,2021-11-26,115,@,CHO,L 115-133,240,45,100,.450,34,65,.523,11,35,.314,14,19,.737,115,49,88,.557,26,48,.542,23,40,.575,12,15,.800,133
901,CLE,2021-11-24,115,,PHO,L 115-120,240,43,97,.443,31,58,.534,12,39,.308,17,25,.680,115,45,86,.523,37,64,.578,8,22,.364,22,28,.786,120
902,PHO,2021-11-22,115,@,SAS,W 115-111,240,45,88,.511,33,61,.541,12,27,.444,13,16,.813,115,49,93,.527,44,73,.603,5,20,.250,8,16,.500,111
903,ATL,2021-11-20,115,,CHO,W 115-105,240,43,82,.524,31,48,.646,12,34,.353,17,21,.810,115,43,102,.422,33,62,.532,10,40,.250,9,15,.600,105
904,BRK,2021-11-19,115,,ORL,W 115-113,240,41,91,.451,31,58,.534,10,33,.303,23,25,.920,115,40,89,.449,26,51,.510,14,38,.368,19,25,.760,113
905,MIN,2021-11-18,115,,SAS,W 115-90,240,41,86,.477,20,37,.541,21,49,.429,12,15,.800,115,35,84,.417,29,52,.558,6,32,.188,14,19,.737,90
906,PHO,2021-11-14,115,@,HOU,W 115-89,240,42,97,.433,28,57,.491,14,40,.350,17,20,.850,115,35,85,.412,28,53,.528,7,32,.219,12,18,.667,89
907,TOR,2021-11-11,115,@,PHI,W 115-109,240,42,96,.438,28,63,.444,14,33,.424,17,17,1.000,115,40,88,.455,29,54,.537,11,34,.324,18,19,.947,109
908,UTA,2021-11-06,115,@,MIA,L 115-118,240,43,83,.518,28,38,.737,15,45,.333,14,19,.737,115,47,78,.603,36,57,.632,11,21,.524,13,17,.765,118
909,WAS,2021-11-05,115,,MEM,W 115-87,240,49,84,.583,39,59,.661,10,25,.400,7,13,.538,115,34,96,.354,28,65,.431,6,31,.194,13,17,.765,87
910,MIN,2021-11-03,115,,LAC,L 115-126,240,43,94,.457,29,54,.537,14,40,.350,15,16,.938,115,47,78,.603,26,42,.619,21,36,.583,11,12,.917,126
911,ORL,2021-11-01,115,@,MIN,W 115-97,240,37,82,.451,20,39,.513,17,43,.395,24,30,.800,115,36,97,.371,22,46,.478,14,51,.275,11,19,.579,97
912,WAS,2021-10-30,115,,BOS,W 115-112 (2OT),290,38,104,.365,28,68,.412,10,36,.278,29,36,.806,115,44,107,.411,42,81,.519,2,26,.077,22,25,.880,112
913,LAL,2021-10-27,115,@,OKC,L 115-123,240,46,92,.500,35,57,.614,11,35,.314,12,14,.857,115,43,86,.500,28,49,.571,15,37,.405,22,29,.759,123
914,PHI,2021-10-24,115,@,OKC,W 115-103,240,41,88,.466,24,47,.511,17,41,.415,16,20,.800,115,40,84,.476,32,53,.604,8,31,.258,15,19,.789,103
915,TOR,2021-10-22,115,@,BOS,W 115-83,240,42,100,.420,32,65,.492,10,35,.286,21,21,1.000,115,32,82,.390,21,48,.438,11,34,.324,8,11,.727,83
916,PHO,2021-10-22,115,@,LAL,W 115-105,240,42,86,.488,32,54,.593,10,32,.313,21,28,.750,115,34,86,.395,19,52,.365,15,34,.441,22,29,.759,105
917,GSW,2021-10-21,115,,LAC,W 115-113,240,43,83,.518,28,52,.538,15,31,.484,14,22,.636,115,42,96,.438,28,56,.500,14,40,.350,15,21,.714,113
918,HOU,2022-04-10,114,,ATL,L 114-130,240,41,89,.461,24,43,.558,17,46,.370,15,20,.750,114,45,87,.517,24,49,.490,21,38,.553,19,24,.792,130
919,NOP,2022-04-09,114,@,MEM,L 114-141,240,41,91,.451,35,61,.574,6,30,.200,26,35,.743,114,53,90,.589,35,55,.636,18,35,.514,17,23,.739,141
920,NYK,2022-04-08,114,@,WAS,W 114-92,240,41,88,.466,25,49,.510,16,39,.410,16,20,.800,114,35,69,.507,26,41,.634,9,28,.321,13,17,.765,92
921,PHI,2022-04-07,114,@,TOR,L 114-119,240,37,75,.493,18,39,.462,19,36,.528,21,25,.840,114,45,91,.495,30,58,.517,15,33,.455,14,18,.778,119
922,MIN,2022-04-05,114,,WAS,L 114-132,240,41,91,.451,27,50,.540,14,41,.341,18,25,.720,114,56,101,.554,43,71,.606,13,30,.433,7,14,.500,132
923,MIA,2022-04-03,114,@,TOR,W 114-109,240,41,79,.519,23,41,.561,18,38,.474,14,22,.636,114,35,83,.422,23,44,.523,12,39,.308,27,34,.794,109
924,CHO,2022-04-02,114,@,PHI,L 114-144,240,42,87,.483,31,57,.544,11,30,.367,19,24,.792,114,53,87,.609,32,44,.727,21,43,.488,17,21,.810,144
925,PHO,2022-04-01,114,@,MEM,L 114-122,240,47,86,.547,37,59,.627,10,27,.370,10,17,.588,114,46,102,.451,39,78,.500,7,24,.292,23,28,.821,122
926,NOP,2022-04-01,114,@,LAL,W 114-111,240,41,79,.519,34,53,.642,7,26,.269,25,29,.862,114,39,82,.476,28,55,.509,11,27,.407,22,31,.710,111
927,NYK,2022-03-30,114,,CHO,L 114-125,240,40,85,.471,24,41,.585,16,44,.364,18,26,.692,114,49,90,.544,37,55,.673,12,35,.343,15,17,.882,125
928,DAL,2022-03-27,114,,UTA,W 114-100,240,40,77,.519,23,43,.535,17,34,.500,17,24,.708,114,41,89,.461,29,55,.527,12,34,.353,6,10,.600,100
929,PHO,2022-03-27,114,,PHI,W 114-104,240,45,87,.517,32,60,.533,13,27,.481,11,17,.647,114,37,89,.416,27,53,.509,10,36,.278,20,26,.769,104
930,SAC,2022-03-26,114,@,ORL,W 114-110 (OT),265,42,98,.429,31,62,.500,11,36,.306,19,24,.792,114,45,106,.425,32,70,.457,13,36,.361,7,7,1.000,110
931,MIL,2022-03-24,114,,WAS,W 114-102,240,42,81,.519,26,46,.565,16,35,.457,14,16,.875,114,43,92,.467,32,54,.593,11,38,.289,5,9,.556,102
932,BRK,2022-03-21,114,,UTA,W 114-106,240,45,83,.542,34,53,.642,11,30,.367,13,15,.867,114,37,83,.446,23,44,.523,14,39,.359,18,22,.818,106
933,CLE,2022-03-16,114,,PHI,L 114-118,240,39,80,.488,30,52,.577,9,28,.321,27,32,.844,114,41,79,.519,29,47,.617,12,32,.375,24,28,.857,118
934,DEN,2022-03-14,114,@,PHI,W 114-110,240,44,82,.537,31,49,.633,13,33,.394,13,20,.650,114,36,84,.429,24,51,.471,12,33,.364,26,32,.813,110
935,TOR,2022-03-14,114,@,LAL,W 114-103,240,39,96,.406,29,59,.492,10,37,.270,26,36,.722,114,34,87,.391,21,45,.467,13,42,.310,22,29,.759,103
936,ORL,2022-03-13,114,,PHI,L 114-116 (OT),265,41,91,.451,23,48,.479,18,43,.419,14,20,.700,114,35,92,.380,21,55,.382,14,37,.378,32,37,.865,116
937,BOS,2022-03-11,114,,DET,W 114-103,240,42,90,.467,36,58,.621,6,32,.188,24,30,.800,114,35,83,.422,25,49,.510,10,34,.294,23,24,.958,103
938,NYK,2022-03-11,114,@,MEM,L 114-118,240,38,90,.422,28,65,.431,10,25,.400,28,37,.757,114,46,104,.442,37,78,.474,9,26,.346,17,29,.586,118
939,CHI,2022-03-09,114,@,DET,W 114-108,240,40,76,.526,37,61,.607,3,15,.200,31,35,.886,114,42,82,.512,31,51,.608,11,31,.355,13,17,.765,108
940,DAL,2022-03-05,114,,SAC,W 114-113,240,40,84,.476,26,48,.542,14,36,.389,20,27,.741,114,46,94,.489,37,69,.536,9,25,.360,12,18,.667,113
941,NYK,2022-03-04,114,@,PHO,L 114-115,240,40,86,.465,27,57,.474,13,29,.448,21,30,.700,114,38,85,.447,21,51,.412,17,34,.500,22,27,.815,115
942,WAS,2022-03-04,114,,ATL,L 114-117,240,46,85,.541,32,56,.571,14,29,.483,8,9,.889,114,38,91,.418,25,55,.455,13,36,.361,28,34,.824,117
943,ORL,2022-03-02,114,,IND,L 114-122 (OT),265,44,97,.454,34,65,.523,10,32,.313,16,20,.800,114,41,94,.436,29,57,.509,12,37,.324,28,35,.800,122
944,GSW,2022-03-01,114,@,MIN,L 114-129,240,41,90,.456,28,45,.622,13,45,.289,19,22,.864,114,47,89,.528,31,49,.633,16,40,.400,19,23,.826,129
945,PHO,2022-02-27,114,,UTA,L 114-118,240,44,86,.512,31,58,.534,13,28,.464,13,16,.813,114,44,94,.468,27,54,.500,17,40,.425,13,20,.650,118
946,UTA,2022-02-25,114,,DAL,W 114-109,240,40,74,.541,24,36,.667,16,38,.421,18,22,.818,114,42,88,.477,25,49,.510,17,39,.436,8,8,1.000,109
947,MEM,2022-02-24,114,@,MIN,L 114-119,240,38,98,.388,29,67,.433,9,31,.290,29,40,.725,114,43,93,.462,27,51,.529,16,42,.381,17,25,.680,119
948,SAS,2022-02-16,114,@,OKC,W 114-106,240,43,98,.439,33,64,.516,10,34,.294,18,22,.818,114,41,105,.390,30,73,.411,11,32,.344,13,19,.684,106
949,NOP,2022-02-12,114,,SAS,L 114-124,240,43,87,.494,32,55,.582,11,32,.344,17,20,.850,114,47,93,.505,33,56,.589,14,37,.378,16,19,.842,124
950,UTA,2022-02-11,114,,ORL,W 114-99,240,40,89,.449,27,48,.563,13,41,.317,21,24,.875,114,37,84,.440,24,49,.490,13,35,.371,12,16,.750,99
951,GSW,2022-02-10,114,,NYK,L 114-116,240,42,91,.462,27,46,.587,15,45,.333,15,17,.882,114,39,90,.433,25,54,.463,14,36,.389,24,33,.727,116
952,SAC,2022-02-08,114,,MIN,L 114-134,240,41,83,.494,32,58,.552,9,25,.360,23,26,.885,114,50,104,.481,28,60,.467,22,44,.500,12,17,.706,134
953,PHO,2022-02-08,114,@,PHI,W 114-109,240,43,95,.453,37,69,.536,6,26,.231,22,24,.917,114,41,89,.461,31,57,.544,10,32,.313,17,18,.944,109
954,ATL,2022-02-04,114,@,TOR,L 114-125,240,43,93,.462,34,64,.531,9,29,.310,19,21,.905,114,46,81,.568,29,54,.537,17,27,.630,16,18,.889,125
955,SAC,2022-02-03,114,@,GSW,L 114-126,240,42,80,.525,31,49,.633,11,31,.355,19,23,.826,114,47,84,.560,27,42,.643,20,42,.476,12,16,.750,126
956,DAL,2022-02-02,114,,OKC,L 114-120 (OT),265,46,98,.469,32,55,.582,14,43,.326,8,10,.800,114,41,86,.477,24,49,.490,17,37,.459,21,25,.840,120
957,LAL,2022-01-28,114,@,CHO,L 114-117,240,38,91,.418,23,51,.451,15,40,.375,23,32,.719,114,43,83,.518,32,47,.681,11,36,.306,20,28,.714,117
958,LAC,2022-01-28,114,@,MIA,L 114-121,240,41,92,.446,32,57,.561,9,35,.257,23,32,.719,114,40,85,.471,25,51,.490,15,34,.441,26,27,.963,121
959,ORL,2022-01-23,114,,CHI,W 114-95,240,42,80,.525,30,54,.556,12,26,.462,18,23,.783,114,33,76,.434,28,55,.509,5,21,.238,24,32,.750,95
960,POR,2022-01-23,114,@,TOR,W 114-105,240,45,85,.529,27,53,.509,18,32,.563,6,13,.462,114,39,98,.398,21,44,.477,18,54,.333,9,14,.643,105
961,MEM,2022-01-19,114,@,MIL,L 114-126,240,44,106,.415,35,66,.530,9,40,.225,17,25,.680,114,46,97,.474,33,60,.550,13,37,.351,21,22,.955,126
962,CLE,2022-01-17,114,,BRK,W 114-107,240,42,81,.519,31,49,.633,11,32,.344,19,21,.905,114,41,83,.494,29,53,.547,12,30,.400,13,18,.722,107
963,MIL,2022-01-17,114,@,ATL,L 114-121,240,39,88,.443,23,50,.460,16,38,.421,20,24,.833,114,38,86,.442,23,50,.460,15,36,.417,30,32,.938,121
964,BOS,2022-01-15,114,,CHI,W 114-112,240,44,90,.489,35,64,.547,9,26,.346,17,19,.895,114,44,87,.506,32,58,.552,12,29,.414,12,15,.800,112
965,HOU,2022-01-14,114,@,SAC,L 114-126,240,44,101,.436,31,58,.534,13,43,.302,13,16,.813,114,48,96,.500,35,59,.593,13,37,.351,17,24,.708,126
966,CLE,2022-01-14,114,@,SAS,W 114-109,240,46,95,.484,38,75,.507,8,20,.400,14,24,.583,114,42,92,.457,27,58,.466,15,34,.441,10,13,.769,109
967,POR,2022-01-10,114,,BRK,W 114-108,240,40,86,.465,25,48,.521,15,38,.395,19,26,.731,114,42,91,.462,30,59,.508,12,32,.375,12,15,.800,108
968,CHO,2022-01-08,114,,MIL,W 114-106,240,44,99,.444,28,51,.549,16,48,.333,10,17,.588,114,35,90,.389,23,53,.434,12,37,.324,24,26,.923,106
969,CLE,2022-01-07,114,@,POR,W 114-101,240,39,80,.488,22,41,.537,17,39,.436,19,29,.655,114,37,92,.402,21,57,.368,16,35,.457,11,19,.579,101
970,HOU,2022-01-05,114,@,WAS,W 114-111,240,40,85,.471,31,59,.525,9,26,.346,25,32,.781,114,40,91,.440,30,52,.577,10,39,.256,21,26,.808,111
971,SAC,2022-01-04,114,@,LAL,L 114-122,240,43,83,.518,29,49,.592,14,34,.412,14,18,.778,114,49,99,.495,38,67,.567,11,32,.344,13,20,.650,122
972,PHI,2021-12-28,114,@,TOR,W 114-109,240,34,77,.442,20,47,.426,14,30,.467,32,38,.842,114,38,87,.437,23,46,.500,15,41,.366,18,22,.818,109
973,MEM,2021-12-27,114,@,PHO,W 114-113,240,45,88,.511,34,59,.576,11,29,.379,13,17,.765,114,41,90,.456,30,59,.508,11,31,.355,20,23,.870,113
974,DAL,2021-12-21,114,,MIN,W 114-102,240,42,86,.488,31,52,.596,11,34,.324,19,23,.826,114,36,79,.456,23,39,.590,13,40,.325,17,20,.850,102
975,SAS,2021-12-19,114,@,SAC,L 114-121,240,45,91,.495,33,66,.500,12,25,.480,12,13,.923,114,46,91,.505,32,66,.485,14,25,.560,15,18,.833,121
976,BOS,2021-12-18,114,,NYK,W 114-107,240,42,89,.472,25,44,.568,17,45,.378,13,17,.765,114,35,80,.438,22,44,.500,13,36,.361,24,30,.800,107
977,BRK,2021-12-16,114,,PHI,W 114-105,240,44,89,.494,33,66,.500,11,23,.478,15,16,.938,114,39,89,.438,29,55,.527,10,34,.294,17,20,.850,105
978,MIL,2021-12-15,114,,IND,W 114-99,240,44,90,.489,30,61,.492,14,29,.483,12,15,.800,114,39,83,.470,28,45,.622,11,38,.289,10,11,.909,99
979,HOU,2021-12-10,114,,MIL,L 114-123,240,42,89,.472,23,43,.535,19,46,.413,11,20,.550,114,42,83,.506,27,44,.614,15,39,.385,24,32,.750,123
980,LAC,2021-12-08,114,,BOS,W 114-111,240,40,85,.471,26,53,.491,14,32,.438,20,22,.909,114,41,86,.477,31,54,.574,10,32,.313,19,21,.905,111
981,HOU,2021-12-08,114,,BRK,W 114-104,240,40,81,.494,26,40,.650,14,41,.341,20,29,.690,114,35,89,.393,27,56,.482,8,33,.242,26,31,.839,104
982,NOP,2021-12-08,114,,DEN,L 114-120 (OT),265,47,90,.522,36,60,.600,11,30,.367,9,12,.750,114,45,88,.511,36,56,.643,9,32,.281,21,27,.778,120
983,OKC,2021-12-06,114,@,DET,W 114-103,240,41,82,.500,32,57,.561,9,25,.360,23,30,.767,114,41,99,.414,25,58,.431,16,41,.390,5,6,.833,103
984,PHO,2021-12-02,114,,DET,W 114-103,240,43,79,.544,31,58,.534,12,21,.571,16,23,.696,114,36,80,.450,25,53,.472,11,27,.407,20,26,.769,103
985,SAS,2021-12-02,114,@,POR,W 114-83,240,44,91,.484,30,55,.545,14,36,.389,12,16,.750,114,29,82,.354,17,48,.354,12,34,.353,13,17,.765,83
986,HOU,2021-12-01,114,@,OKC,W 114-110,240,40,79,.506,25,42,.595,15,37,.405,19,22,.864,114,40,85,.471,32,53,.604,8,32,.250,22,29,.759,110
987,ATL,2021-12-01,114,@,IND,W 114-111,240,44,86,.512,28,53,.528,16,33,.485,10,12,.833,114,44,90,.489,34,57,.596,10,33,.303,13,16,.813,111
988,CLE,2021-11-29,114,@,DAL,W 114-96,240,45,80,.563,35,61,.574,10,19,.526,14,18,.778,114,39,89,.438,27,50,.540,12,39,.308,6,15,.400,96
989,DAL,2021-11-27,114,,WAS,L 114-120,240,42,89,.472,28,51,.549,14,38,.368,16,22,.727,114,45,78,.577,36,54,.667,9,24,.375,21,26,.808,120
990,IND,2021-11-26,114,,TOR,W 114-97,240,47,97,.485,36,58,.621,11,39,.282,9,11,.818,114,37,89,.416,30,59,.508,7,30,.233,16,22,.727,97
991,MIL,2021-11-24,114,,DET,W 114-93,240,42,87,.483,27,51,.529,15,36,.417,15,17,.882,114,34,95,.358,23,50,.460,11,45,.244,14,19,.737,93
992,CHI,2021-11-19,114,@,DEN,W 114-108,240,41,93,.441,33,62,.532,8,31,.258,24,24,1.000,114,39,82,.476,25,45,.556,14,37,.378,16,20,.800,108
993,LAL,2021-11-14,114,,SAS,W 114-106,240,43,83,.518,28,52,.538,15,31,.484,13,17,.765,114,40,90,.444,24,54,.444,16,36,.444,10,15,.667,106
994,PHI,2021-11-06,114,@,CHI,W 114-105,240,43,81,.531,30,55,.545,13,26,.500,15,19,.789,114,37,92,.402,30,63,.476,7,29,.241,24,30,.800,105
995,GSW,2021-11-03,114,,CHO,W 114-92,240,42,86,.488,24,41,.585,18,45,.400,12,18,.667,114,34,91,.374,24,55,.436,10,36,.278,14,19,.737,92
996,BOS,2021-11-01,114,,CHI,L 114-128,240,42,96,.438,27,63,.429,15,33,.455,15,20,.750,114,49,86,.570,36,55,.655,13,31,.419,17,18,.944,128
997,MIA,2021-10-29,114,,CHO,W 114-99,240,43,91,.473,34,56,.607,9,35,.257,19,19,1.000,114,35,90,.389,22,53,.415,13,37,.351,16,22,.727,99
998,LAC,2021-10-23,114,,MEM,L 114-120,240,43,99,.434,30,60,.500,13,39,.333,15,17,.882,114,42,90,.467,27,54,.500,15,36,.417,21,25,.840,120
999,BRK,2021-10-22,114,@,PHI,W 114-109,240,41,88,.466,29,50,.580,12,38,.316,20,24,.833,114,43,91,.473,29,55,.527,14,36,.389,9,11,.818,109
1000,LAL,2021-10-19,114,,GSW,L 114-121,240,45,95,.474,30,53,.566,15,42,.357,9,19,.474,114,41,93,.441,27,54,.500,14,39,.359,25,30,.833,121
1001,MIA,2022-04-08,113,,ATL,W 113-109,240,40,72,.556,29,46,.630,11,26,.423,22,28,.786,113,42,88,.477,34,54,.630,8,34,.235,17,19,.895,109
1002,LAC,2022-04-06,113,,PHO,W 113-109,240,33,75,.440,21,41,.512,12,34,.353,35,44,.795,113,42,108,.389,25,60,.417,17,48,.354,8,12,.667,109
1003,DET,2022-04-06,113,,DAL,L 113-131,240,35,82,.427,24,52,.462,11,30,.367,32,35,.914,113,45,80,.563,30,47,.638,15,33,.455,26,34,.765,131
1004,SAS,2022-04-03,113,,POR,W 113-92,240,38,84,.452,24,42,.571,14,42,.333,23,30,.767,113,33,84,.393,17,39,.436,16,45,.356,10,15,.667,92
1005,DEN,2022-03-28,113,@,CHO,W 113-109,240,40,86,.465,28,53,.528,12,33,.364,21,28,.750,113,44,93,.473,31,51,.608,13,42,.310,8,12,.667,109
1006,DEN,2022-03-26,113,,OKC,W 113-107,240,41,85,.482,33,54,.611,8,31,.258,23,24,.958,113,39,84,.464,25,48,.521,14,36,.389,15,16,.938,107
1007,PHI,2022-03-21,113,,MIA,W 113-106,240,43,86,.500,28,49,.571,15,37,.405,12,16,.750,113,38,80,.475,28,47,.596,10,33,.303,20,20,1.000,106
1008,CHI,2022-03-21,113,,TOR,W 113-99,240,44,90,.489,33,62,.532,11,28,.393,14,24,.583,113,40,91,.440,34,59,.576,6,32,.188,13,15,.867,99
1009,CLE,2022-03-19,113,,DET,W 113-109,240,45,88,.511,35,62,.565,10,26,.385,13,23,.565,113,41,85,.482,28,55,.509,13,30,.433,14,19,.737,109
1010,DAL,2022-03-16,113,@,BRK,W 113-111,240,41,83,.494,29,49,.592,12,34,.353,19,19,1.000,113,45,91,.495,36,65,.554,9,26,.346,12,15,.800,111
1011,POR,2022-03-14,113,@,ATL,L 113-122,240,44,88,.500,34,64,.531,10,24,.417,15,21,.714,113,40,109,.367,28,61,.459,12,48,.250,30,32,.938,122
1012,MIN,2022-03-12,113,@,MIA,W 113-104,240,35,83,.422,20,41,.488,15,42,.357,28,32,.875,113,35,88,.398,20,43,.465,15,45,.333,19,25,.760,104
1013,DAL,2022-03-11,113,@,HOU,W 113-100,240,40,88,.455,29,52,.558,11,36,.306,22,28,.786,113,41,86,.477,35,56,.625,6,30,.200,12,19,.632,100
1014,GSW,2022-03-10,113,@,DEN,W 113-102,240,42,88,.477,28,46,.609,14,42,.333,15,20,.750,113,35,84,.417,28,53,.528,7,31,.226,25,32,.781,102
1015,DET,2022-03-07,113,,ATL,W 113-110 (OT),265,43,93,.462,31,60,.517,12,33,.364,15,23,.652,113,42,93,.452,31,55,.564,11,38,.289,15,22,.682,110
1016,SAC,2022-03-05,113,@,DAL,L 113-114,240,46,94,.489,37,69,.536,9,25,.360,12,18,.667,113,40,84,.476,26,48,.542,14,36,.389,20,27,.741,114
1017,GSW,2022-03-03,113,@,DAL,L 113-122,240,44,81,.543,29,51,.569,15,30,.500,10,13,.769,113,45,85,.529,28,48,.583,17,37,.459,15,20,.750,122
1018,MIA,2022-03-03,113,@,BRK,W 113-107,240,40,77,.519,30,47,.638,10,30,.333,23,28,.821,113,39,83,.470,27,52,.519,12,31,.387,17,22,.773,107
1019,DET,2022-03-01,113,@,WAS,L 113-116,240,43,90,.478,35,63,.556,8,27,.296,19,23,.826,113,41,82,.500,28,56,.500,13,26,.500,21,26,.808,116
1020,LAC,2022-03-01,113,@,HOU,W 113-100,240,42,96,.438,29,65,.446,13,31,.419,16,17,.941,113,38,96,.396,25,57,.439,13,39,.333,11,17,.647,100
1021,BOS,2022-02-26,113,@,DET,W 113-104,240,42,88,.477,32,62,.516,10,26,.385,19,21,.905,113,39,87,.448,32,60,.533,7,27,.259,19,22,.864,104
1022,IND,2022-02-16,113,,WAS,W 113-108,240,45,83,.542,41,63,.651,4,20,.200,19,29,.655,113,39,91,.429,22,54,.407,17,37,.459,13,16,.813,108
1023,IND,2022-02-11,113,,CLE,L 113-120,240,42,89,.472,24,51,.471,18,38,.474,11,16,.688,113,43,81,.531,34,57,.596,9,24,.375,25,30,.833,120
1024,WAS,2022-02-10,113,,BRK,W 113-112,240,43,85,.506,32,54,.593,11,31,.355,16,18,.889,113,39,84,.464,29,55,.527,10,29,.345,24,28,.857,112
1025,ORL,2022-02-08,113,@,POR,W 113-95,240,44,90,.489,25,52,.481,19,38,.500,6,8,.750,113,32,91,.352,21,53,.396,11,38,.289,20,26,.769,95
1026,UTA,2022-02-07,113,,NYK,W 113-104,240,39,93,.419,27,45,.600,12,48,.250,23,27,.852,113,36,95,.379,28,62,.452,8,33,.242,24,35,.686,104
1027,LAC,2022-02-06,113,,MIL,L 113-137,240,40,96,.417,22,50,.440,18,46,.391,15,16,.938,113,48,88,.545,29,50,.580,19,38,.500,22,27,.815,137
1028,SAC,2022-02-05,113,,OKC,W 113-103,240,43,83,.518,31,51,.608,12,32,.375,15,22,.682,113,42,87,.483,33,57,.579,9,30,.300,10,16,.625,103
1029,NOP,2022-02-04,113,@,DEN,W 113-105,240,42,75,.560,34,50,.680,8,25,.320,21,23,.913,113,35,78,.449,16,37,.432,19,41,.463,16,17,.941,105
1030,BOS,2022-02-02,113,,CHO,W 113-107,240,42,82,.512,28,46,.609,14,36,.389,15,17,.882,113,37,87,.425,25,47,.532,12,40,.300,21,27,.778,107
1031,IND,2022-01-28,113,@,OKC,W 113-110 (OT),265,41,95,.432,28,56,.500,13,39,.333,18,29,.621,113,43,95,.453,29,52,.558,14,43,.326,10,17,.588,110
1032,CHO,2022-01-25,113,@,TOR,L 113-125,240,40,82,.488,30,51,.588,10,31,.323,23,32,.719,113,43,82,.524,27,48,.563,16,34,.471,23,29,.793,125
1033,IND,2022-01-24,113,@,NOP,L 113-117,240,38,87,.437,19,41,.463,19,46,.413,18,25,.720,113,41,88,.466,35,58,.603,6,30,.200,29,31,.935,117
1034,MIA,2022-01-23,113,,LAL,W 113-107,240,40,81,.494,25,48,.521,15,33,.455,18,20,.900,113,36,79,.456,25,39,.641,11,40,.275,24,30,.800,107
1035,ATL,2022-01-23,113,@,CHO,W 113-91,240,40,88,.455,25,49,.510,15,39,.385,18,24,.750,113,34,87,.391,30,51,.588,4,36,.111,19,27,.704,91
1036,PHO,2022-01-22,113,,IND,W 113-103,240,47,96,.490,40,71,.563,7,25,.280,12,14,.857,113,37,84,.440,27,55,.491,10,29,.345,19,27,.704,103
1037,NOP,2022-01-13,113,,LAC,W 113-89,240,43,97,.443,29,58,.500,14,39,.359,13,16,.813,113,31,81,.383,21,47,.447,10,34,.294,17,20,.850,89
1038,DAL,2022-01-09,113,,CHI,W 113-99,240,44,88,.500,28,52,.538,16,36,.444,9,9,1.000,113,39,90,.433,28,57,.491,11,33,.333,10,13,.769,99
1039,UTA,2022-01-08,113,@,IND,L 113-125,240,40,84,.476,25,49,.510,15,35,.429,18,19,.947,113,44,80,.550,30,51,.588,14,29,.483,23,32,.719,125
1040,HOU,2022-01-03,113,@,PHI,L 113-133,240,37,89,.416,22,45,.489,15,44,.341,24,33,.727,113,50,96,.521,33,56,.589,17,40,.425,16,17,.941,133
1041,MIA,2022-01-02,113,@,SAC,L 113-115,240,46,105,.438,37,72,.514,9,33,.273,12,12,1.000,113,40,78,.513,27,44,.614,13,34,.382,22,27,.815,115
1042,NOP,2022-01-01,113,@,MIL,L 113-136,240,39,95,.411,23,44,.523,16,51,.314,19,30,.633,113,49,92,.533,26,44,.591,23,48,.479,15,18,.833,136
1043,PHO,2021-12-27,113,,MEM,L 113-114,240,41,90,.456,30,59,.508,11,31,.355,20,23,.870,113,45,88,.511,34,59,.576,11,29,.379,13,17,.765,114
1044,CHI,2021-12-26,113,,IND,W 113-105,240,43,76,.566,32,53,.604,11,23,.478,16,22,.727,113,41,94,.436,33,64,.516,8,30,.267,15,21,.714,105
1045,BOS,2021-12-25,113,@,MIL,L 113-117,240,38,89,.427,21,44,.477,17,45,.378,20,24,.833,113,43,91,.473,31,58,.534,12,33,.364,19,27,.704,117
1046,PHO,2021-12-23,113,,OKC,W 113-101,240,45,93,.484,30,54,.556,15,39,.385,8,13,.615,113,37,96,.385,26,55,.473,11,41,.268,16,21,.762,101
1047,GSW,2021-12-23,113,,MEM,W 113-104,240,40,82,.488,21,42,.500,19,40,.475,14,18,.778,113,38,90,.422,30,64,.469,8,26,.308,20,24,.833,104
1048,GSW,2021-12-20,113,,SAC,W 113-98,240,46,88,.523,31,51,.608,15,37,.405,6,9,.667,113,37,83,.446,24,51,.471,13,32,.406,11,16,.688,98
1049,DET,2021-12-16,113,@,IND,L 113-122,240,40,81,.494,33,56,.589,7,25,.280,26,30,.867,113,45,91,.495,38,59,.644,7,32,.219,25,28,.893,122
1050,NOP,2021-12-15,113,@,OKC,W 113-110,240,39,80,.488,28,52,.538,11,28,.393,24,36,.667,113,39,93,.419,26,58,.448,13,35,.371,19,19,1.000,110
1051,MEM,2021-12-15,113,@,POR,W 113-103,240,39,82,.476,28,50,.560,11,32,.344,24,30,.800,113,31,82,.378,16,44,.364,15,38,.395,26,28,.929,103
1052,DEN,2021-12-13,113,,WAS,W 113-107,240,37,79,.468,27,47,.574,10,32,.313,29,33,.879,113,41,90,.456,29,56,.518,12,34,.353,13,21,.619,107
1053,MEM,2021-12-11,113,,HOU,W 113-106,240,40,80,.500,29,51,.569,11,29,.379,22,36,.611,113,38,77,.494,27,44,.614,11,33,.333,19,29,.655,106
1054,BRK,2021-12-10,113,@,ATL,W 113-105,240,46,93,.495,40,70,.571,6,23,.261,15,16,.938,113,37,94,.394,26,60,.433,11,34,.324,20,24,.833,105
1055,MIA,2021-12-08,113,,MIL,W 113-104,240,40,77,.519,18,30,.600,22,47,.468,11,12,.917,113,36,85,.424,24,46,.522,12,39,.308,20,27,.741,104
1056,DEN,2021-12-04,113,@,NYK,W 113-99,240,44,84,.524,24,41,.585,20,43,.465,5,5,1.000,113,35,88,.398,23,48,.479,12,40,.300,17,21,.810,99
1057,MIA,2021-12-03,113,@,IND,W 113-104,240,43,81,.531,27,47,.574,16,34,.471,11,13,.846,113,35,80,.438,26,44,.591,9,36,.250,25,33,.758,104
1058,PHO,2021-11-27,113,@,BRK,W 113-107,240,41,92,.446,28,54,.519,13,38,.342,18,21,.857,113,42,84,.500,35,61,.574,7,23,.304,16,21,.762,107
1059,CHI,2021-11-24,113,@,HOU,L 113-118,240,44,96,.458,29,61,.475,15,35,.429,10,12,.833,113,42,84,.500,25,48,.521,17,36,.472,17,22,.773,118
1060,MIN,2021-11-24,113,,MIA,W 113-101,240,38,93,.409,20,38,.526,18,55,.327,19,21,.905,113,33,74,.446,18,32,.563,15,42,.357,20,29,.690,101
1061,MEM,2021-11-24,113,,TOR,L 113-126,240,42,82,.512,33,53,.623,9,29,.310,20,26,.769,113,47,89,.528,33,59,.559,14,30,.467,18,21,.857,126
1062,ATL,2021-11-22,113,,OKC,W 113-101,240,42,87,.483,28,53,.528,14,34,.412,15,16,.938,113,39,97,.402,29,59,.492,10,38,.263,13,14,.929,101
1063,ORL,2021-11-19,113,@,BRK,L 113-115,240,40,89,.449,26,51,.510,14,38,.368,19,25,.760,113,41,91,.451,31,58,.534,10,33,.303,23,25,.920,115
1064,MIA,2021-11-17,113,,NOP,W 113-98,240,42,87,.483,27,47,.574,15,40,.375,14,17,.824,113,33,75,.440,23,40,.575,10,35,.286,22,28,.786,98
1065,TOR,2021-11-15,113,@,POR,L 113-118,240,41,89,.461,26,56,.464,15,33,.455,16,18,.889,113,46,82,.561,30,46,.652,16,36,.444,10,14,.714,118
1066,PHI,2021-11-13,113,@,IND,L 113-118,240,38,89,.427,26,66,.394,12,23,.522,25,29,.862,113,47,82,.573,33,54,.611,14,28,.500,10,15,.667,118
1067,MIL,2021-11-12,113,@,BOS,L 113-122 (OT),265,44,98,.449,28,51,.549,16,47,.340,9,11,.818,113,47,96,.490,35,55,.636,12,41,.293,16,18,.889,122
1068,DEN,2021-11-08,113,,MIA,W 113-96,240,42,91,.462,30,50,.600,12,41,.293,17,24,.708,113,31,78,.397,18,42,.429,13,36,.361,21,25,.840,96
1069,ATL,2021-11-08,113,@,GSW,L 113-127,240,38,82,.463,21,39,.538,17,43,.395,20,26,.769,113,44,92,.478,26,48,.542,18,44,.409,21,22,.955,127
1070,NYK,2021-11-05,113,@,MIL,W 113-98,240,41,96,.427,31,56,.554,10,40,.250,21,26,.808,113,33,82,.402,17,39,.436,16,43,.372,16,21,.762,98
1071,SAC,2021-11-02,113,@,UTA,L 113-119,240,42,93,.452,30,62,.484,12,31,.387,17,24,.708,113,43,98,.439,29,50,.580,14,48,.292,19,27,.704,119
1072,PHI,2021-11-01,113,,POR,W 113-103,240,43,83,.518,30,47,.638,13,36,.361,14,16,.875,113,40,84,.476,28,50,.560,12,34,.353,11,18,.611,103
1073,CLE,2021-11-01,113,@,CHO,W 113-110,240,39,90,.433,30,62,.484,9,28,.321,26,38,.684,113,42,101,.416,27,62,.435,15,39,.385,11,15,.733,110
1074,TOR,2021-11-01,113,@,NYK,W 113-104,240,43,99,.434,29,57,.509,14,42,.333,13,14,.929,113,35,76,.461,19,38,.500,16,38,.421,18,24,.750,104
1075,POR,2021-10-31,113,@,CHO,L 113-125,240,43,97,.443,26,43,.605,17,54,.315,10,11,.909,113,46,89,.517,26,47,.553,20,42,.476,13,21,.619,125
1076,LAL,2021-10-29,113,,CLE,W 113-101,240,46,84,.548,34,57,.596,12,27,.444,9,10,.900,113,37,87,.425,25,53,.472,12,34,.353,15,22,.682,101
1077,SAC,2021-10-29,113,@,NOP,W 113-109,240,40,80,.500,31,53,.585,9,27,.333,24,25,.960,113,42,98,.429,33,64,.516,9,34,.265,16,25,.640,109
1078,MIN,2021-10-27,113,@,MIL,W 113-108,240,43,91,.473,30,46,.652,13,45,.289,14,17,.824,113,39,95,.411,25,44,.568,14,51,.275,16,21,.762,108
1079,ATL,2021-10-21,113,,DAL,W 113-87,240,45,94,.479,30,59,.508,15,35,.429,8,9,.889,113,31,93,.333,18,50,.360,13,43,.302,12,13,.923,87
1080,LAC,2021-10-21,113,@,GSW,L 113-115,240,42,96,.438,28,56,.500,14,40,.350,15,21,.714,113,43,83,.518,28,52,.538,15,31,.484,14,22,.636,115
1081,LAL,2022-04-07,112,@,GSW,L 112-128,240,37,83,.446,28,51,.549,9,32,.281,29,38,.763,112,51,97,.526,35,65,.538,16,32,.500,10,10,1.000,128
1082,MIL,2022-04-03,112,,DAL,L 112-118,240,42,95,.442,27,55,.491,15,40,.375,13,18,.722,112,39,76,.513,23,38,.605,16,38,.421,24,27,.889,118
1083,PHI,2022-04-03,112,@,CLE,W 112-108,240,33,80,.413,22,49,.449,11,31,.355,35,42,.833,112,35,78,.449,20,45,.444,15,33,.455,23,31,.742,108
1084,CLE,2022-03-30,112,,DAL,L 112-120,240,42,83,.506,31,58,.534,11,25,.440,17,22,.773,112,46,88,.523,30,46,.652,16,42,.381,12,15,.800,120
1085,MEM,2022-03-30,112,@,SAS,W 112-111,240,44,91,.484,28,52,.538,16,39,.410,8,11,.727,112,42,83,.506,28,48,.583,14,35,.400,13,16,.813,111
1086,BOS,2022-03-28,112,@,TOR,L 112-115 (OT),265,39,95,.411,27,55,.491,12,40,.300,22,28,.786,112,46,106,.434,36,67,.537,10,39,.256,13,18,.722,115
1087,MIN,2022-03-27,112,@,BOS,L 112-134,240,45,84,.536,31,52,.596,14,32,.438,8,12,.667,112,49,87,.563,32,48,.667,17,39,.436,19,21,.905,134
1088,ATL,2022-03-20,112,,NOP,L 112-117,240,41,87,.471,31,55,.564,10,32,.313,20,23,.870,112,43,96,.448,36,75,.480,7,21,.333,24,27,.889,117
1089,HOU,2022-03-16,112,,PHO,L 112-129,240,42,85,.494,26,46,.565,16,39,.410,12,19,.632,112,53,95,.558,40,62,.645,13,33,.394,10,13,.769,129
1090,SAC,2022-03-14,112,,CHI,W 112-103,240,39,82,.476,29,57,.509,10,25,.400,24,26,.923,112,36,88,.409,26,54,.481,10,34,.294,21,22,.955,103
1091,WAS,2022-03-14,112,@,GSW,L 112-126,240,42,82,.512,32,56,.571,10,26,.385,18,23,.783,112,45,84,.536,27,39,.692,18,45,.400,18,22,.818,126
1092,PHO,2022-03-11,112,,TOR,L 112-117,240,44,88,.500,33,52,.635,11,36,.306,13,17,.765,112,42,94,.447,28,62,.452,14,32,.438,19,21,.905,117
1093,ATL,2022-03-11,112,,LAC,W 112-106,240,43,90,.478,34,59,.576,9,31,.290,17,19,.895,112,40,82,.488,28,50,.560,12,32,.375,14,17,.824,106
1094,GSW,2022-03-08,112,,LAC,W 112-97,240,44,92,.478,31,58,.534,13,34,.382,11,13,.846,112,33,93,.355,21,54,.389,12,39,.308,19,23,.826,97
1095,MEM,2022-03-06,112,@,HOU,L 112-123,240,44,97,.454,39,71,.549,5,26,.192,19,27,.704,112,43,82,.524,30,48,.625,13,34,.382,24,36,.667,123
1096,CHI,2022-03-04,112,,MIL,L 112-118,240,47,94,.500,37,68,.544,10,26,.385,8,11,.727,112,43,88,.489,33,57,.579,10,31,.323,22,33,.667,118
1097,SAS,2022-03-03,112,,SAC,L 112-115,240,46,93,.495,34,61,.557,12,32,.375,8,16,.500,112,39,85,.459,29,53,.547,10,32,.313,27,32,.844,115
1098,MIA,2022-02-28,112,,CHI,W 112-99,240,40,81,.494,28,50,.560,12,31,.387,20,26,.769,112,41,84,.488,34,55,.618,7,29,.241,10,15,.667,99
1099,CHI,2022-02-24,112,,ATL,W 112-108,240,41,84,.488,33,57,.579,8,27,.296,22,27,.815,112,41,97,.423,33,69,.478,8,28,.286,18,27,.667,108
1100,DET,2022-02-16,112,@,BOS,W 112-111,240,43,93,.462,27,63,.429,16,30,.533,10,13,.769,112,42,77,.545,29,45,.644,13,32,.406,14,18,.778,111
1101,POR,2022-02-12,112,,NYK,W 112-103,240,40,84,.476,25,44,.568,15,40,.375,17,20,.850,112,31,81,.383,19,42,.452,12,39,.308,29,34,.853,103
1102,BRK,2022-02-10,112,@,WAS,L 112-113,240,39,84,.464,29,55,.527,10,29,.345,24,28,.857,112,43,85,.506,32,54,.593,11,31,.355,16,18,.889,113
1103,DAL,2022-02-10,112,,LAC,W 112-105,240,38,78,.487,25,39,.641,13,39,.333,23,27,.852,112,39,81,.481,30,58,.517,9,23,.391,18,25,.720,105
1104,MIA,2022-02-10,112,@,NOP,W 112-97,240,39,81,.481,29,49,.592,10,32,.313,24,28,.857,112,36,85,.424,25,44,.568,11,41,.268,14,16,.875,97
1105,IND,2022-02-08,112,@,ATL,L 112-133,240,37,93,.398,27,62,.435,10,31,.323,28,33,.848,112,52,90,.578,35,57,.614,17,33,.515,12,16,.750,133
1106,MIA,2022-02-03,112,@,SAS,W 112-95,240,42,83,.506,30,53,.566,12,30,.400,16,18,.889,112,30,80,.375,22,47,.468,8,33,.242,27,38,.711,95
1107,SAC,2022-02-02,112,,BRK,W 112-101,240,41,93,.441,27,51,.529,14,42,.333,16,18,.889,112,41,84,.488,33,59,.559,8,25,.320,11,14,.786,101
1108,MIL,2022-02-01,112,,WAS,W 112-98,240,46,92,.500,34,54,.630,12,38,.316,8,9,.889,112,36,82,.439,24,47,.511,12,35,.343,14,20,.700,98
1109,POR,2022-01-26,112,,DAL,L 112-132,240,42,82,.512,28,44,.636,14,38,.368,14,23,.609,112,48,88,.545,32,52,.615,16,36,.444,20,26,.769,132
1110,MIN,2022-01-18,112,@,NYK,W 112-110,240,35,81,.432,22,40,.550,13,41,.317,29,38,.763,112,37,80,.463,25,42,.595,12,38,.316,24,33,.727,110
1111,SAC,2022-01-16,112,,HOU,L 112-118,240,41,91,.451,29,53,.547,12,38,.316,18,24,.750,112,41,76,.539,25,36,.694,16,40,.400,20,24,.833,118
1112,CHI,2022-01-15,112,@,BOS,L 112-114,240,44,87,.506,32,58,.552,12,29,.414,12,15,.800,112,44,90,.489,35,64,.547,9,26,.346,17,19,.895,114
1113,PHO,2022-01-14,112,@,IND,W 112-94,240,40,88,.455,29,60,.483,11,28,.393,21,23,.913,112,34,88,.386,21,45,.467,13,43,.302,13,18,.722,94
1114,DAL,2022-01-14,112,@,MEM,W 112-85,240,47,91,.516,39,59,.661,8,32,.250,10,16,.625,112,34,89,.382,27,58,.466,7,31,.226,10,13,.769,85
1115,WAS,2022-01-12,112,,ORL,W 112-106,240,43,82,.524,33,51,.647,10,31,.323,16,21,.762,112,41,99,.414,30,64,.469,11,35,.314,13,16,.813,106
1116,CHI,2022-01-12,112,,BRK,L 112-138,240,38,81,.469,27,51,.529,11,30,.367,25,31,.806,112,49,87,.563,32,55,.582,17,32,.531,23,28,.821,138
1117,DAL,2021-12-31,112,@,SAC,W 112-96,240,42,81,.519,33,59,.559,9,22,.409,19,22,.864,112,38,91,.418,28,62,.452,10,29,.345,10,12,.833,96
1118,WAS,2021-12-28,112,@,MIA,L 112-119,240,42,85,.494,25,43,.581,17,42,.405,11,14,.786,112,41,92,.446,25,58,.431,16,34,.471,21,23,.913,119
1119,NOP,2021-12-26,112,@,OKC,L 112-117,240,39,94,.415,29,53,.547,10,41,.244,24,28,.857,112,41,86,.477,28,50,.560,13,36,.361,22,31,.710,117
1120,DET,2021-12-23,112,@,MIA,L 112-115,240,36,80,.450,18,40,.450,18,40,.450,22,25,.880,112,43,88,.489,31,56,.554,12,32,.375,17,19,.895,115
1121,UTA,2021-12-20,112,,CHO,W 112-102,240,34,96,.354,18,43,.419,16,53,.302,28,37,.757,112,39,101,.386,24,58,.414,15,43,.349,9,9,1.000,102
1122,MIL,2021-12-17,112,@,NOP,L 112-116 (OT),265,45,104,.433,31,57,.544,14,47,.298,8,10,.800,112,42,89,.472,29,52,.558,13,37,.351,19,30,.633,116
1123,SAS,2021-12-12,112,,NOP,W 112-97,240,45,91,.495,38,66,.576,7,25,.280,15,20,.750,112,40,94,.426,32,65,.492,8,29,.276,9,15,.600,97
1124,MIL,2021-12-12,112,@,NYK,W 112-97,240,42,88,.477,28,47,.596,14,41,.341,14,17,.824,112,35,82,.427,18,33,.545,17,49,.347,10,13,.769,97
1125,SAS,2021-12-11,112,,DEN,L 112-127,240,41,89,.461,31,62,.500,10,27,.370,20,29,.690,112,47,93,.505,27,50,.540,20,43,.465,13,14,.929,127
1126,MIL,2021-12-06,112,,CLE,W 112-104,240,40,86,.465,27,54,.500,13,32,.406,19,24,.792,112,35,90,.389,20,44,.455,15,46,.326,19,20,.950,104
1127,SAS,2021-12-04,112,@,GSW,W 112-107,240,42,88,.477,30,53,.566,12,35,.343,16,19,.842,112,40,90,.444,27,51,.529,13,39,.333,14,21,.667,107
1128,BRK,2021-11-30,112,,NYK,W 112-110,240,41,85,.482,33,57,.579,8,28,.286,22,25,.880,112,44,91,.484,33,59,.559,11,32,.344,11,12,.917,110
1129,DAL,2021-11-23,112,@,LAC,W 112-104 (OT),265,39,89,.438,27,50,.540,12,39,.308,22,27,.815,112,35,85,.412,25,53,.472,10,32,.313,24,29,.828,104
1130,CLE,2021-11-22,112,,BRK,L 112-117,240,36,93,.387,22,49,.449,14,44,.318,26,29,.897,112,45,95,.474,34,60,.567,11,35,.314,16,18,.889,117
1131,PHO,2021-11-19,112,,DAL,W 112-104,240,44,85,.518,30,56,.536,14,29,.483,10,14,.714,112,37,90,.411,25,50,.500,12,40,.300,18,23,.783,104
1132,MIA,2021-11-18,112,,WAS,W 112-97,240,41,82,.500,31,56,.554,10,26,.385,20,24,.833,112,38,77,.494,23,41,.561,15,36,.417,6,10,.600,97
1133,POR,2021-11-17,112,,CHI,W 112-107,240,37,84,.440,26,53,.491,11,31,.355,27,28,.964,112,39,83,.470,26,54,.481,13,29,.448,16,20,.800,107
1134,NOP,2021-11-13,112,,MEM,W 112-101,240,38,79,.481,24,50,.480,14,29,.483,22,25,.880,112,38,88,.432,30,64,.469,8,24,.333,17,21,.810,101
1135,NOP,2021-11-12,112,,BRK,L 112-120,240,43,88,.489,30,56,.536,13,32,.406,13,16,.813,112,41,82,.500,23,48,.479,18,34,.529,20,27,.741,120
1136,LAC,2021-11-11,112,,MIA,W 112-109,240,43,91,.473,32,54,.593,11,37,.297,15,17,.882,112,43,97,.443,34,56,.607,9,41,.220,14,17,.824,109
1137,DET,2021-11-10,112,@,HOU,W 112-104,240,42,97,.433,26,49,.531,16,48,.333,12,18,.667,112,35,82,.427,23,48,.479,12,34,.353,22,34,.647,104
1138,MIL,2021-11-10,112,@,NYK,W 112-100,240,40,90,.444,14,40,.350,26,50,.520,6,9,.667,112,36,83,.434,20,46,.435,16,37,.432,12,17,.706,100
1139,SAC,2021-11-03,112,,NOP,W 112-99,240,42,80,.525,32,50,.640,10,30,.333,18,22,.818,112,37,86,.430,25,52,.481,12,34,.353,13,15,.867,99
1140,PHO,2021-11-02,112,,NOP,W 112-100,240,43,82,.524,34,56,.607,9,26,.346,17,18,.944,112,36,91,.396,23,52,.442,13,39,.333,15,16,.938,100
1141,BOS,2021-10-30,112,@,WAS,L 112-115 (2OT),290,44,107,.411,42,81,.519,2,26,.077,22,25,.880,112,38,104,.365,28,68,.412,10,36,.278,29,36,.806,115
1142,NYK,2021-10-26,112,,PHI,W 112-99,240,41,87,.471,25,50,.500,16,37,.432,14,15,.933,112,36,82,.439,24,41,.585,12,41,.293,15,17,.882,99
1143,NOP,2021-10-22,112,@,CHI,L 112-128,240,42,87,.483,27,58,.466,15,29,.517,13,16,.813,112,47,89,.528,33,61,.541,14,28,.500,20,25,.800,128
1144,CLE,2021-10-22,112,,CHO,L 112-123,240,43,84,.512,34,53,.642,9,31,.290,17,20,.850,112,48,91,.527,35,59,.593,13,32,.406,14,17,.824,123
1145,MIA,2022-04-10,111,@,ORL,L 111-125,240,40,94,.426,21,44,.477,19,50,.380,12,16,.750,111,45,91,.495,22,33,.667,23,58,.397,12,14,.857,125
1146,UTA,2022-04-10,111,@,POR,W 111-80,240,37,82,.451,28,46,.609,9,36,.250,28,38,.737,111,31,83,.373,22,49,.449,9,34,.265,9,12,.750,80
1147,PHO,2022-04-08,111,@,UTA,W 111-105,240,46,92,.500,40,73,.548,6,19,.316,13,15,.867,111,35,88,.398,24,50,.480,11,38,.289,24,33,.727,105
1148,GSW,2022-04-02,111,,UTA,W 111-107,240,40,84,.476,20,36,.556,20,48,.417,11,12,.917,111,38,89,.427,23,43,.535,15,46,.326,16,22,.727,107
1149,LAL,2022-04-01,111,,NOP,L 111-114,240,39,82,.476,28,55,.509,11,27,.407,22,31,.710,111,41,79,.519,34,53,.642,7,26,.269,25,29,.862,114
1150,POR,2022-04-01,111,@,SAS,L 111-130,240,41,92,.446,26,57,.456,15,35,.429,14,20,.700,111,46,81,.568,30,44,.682,16,37,.432,22,28,.786,130
1151,SAS,2022-03-30,111,,MEM,L 111-112,240,42,83,.506,28,48,.583,14,35,.400,13,16,.813,111,44,91,.484,28,52,.538,16,39,.410,8,11,.727,112
1152,NYK,2022-03-25,111,@,MIA,W 111-103,240,36,82,.439,19,32,.594,17,50,.340,22,28,.786,111,35,70,.500,23,37,.622,12,33,.364,21,25,.840,103
1153,NYK,2022-03-22,111,,ATL,L 111-117,240,42,86,.488,29,52,.558,13,34,.382,14,26,.538,111,40,81,.494,25,45,.556,15,36,.417,22,27,.815,117
1154,PHI,2022-03-18,111,,DAL,W 111-101,240,37,75,.493,21,37,.568,16,38,.421,21,23,.913,111,37,80,.463,25,48,.521,12,32,.375,15,21,.714,101
1155,BRK,2022-03-16,111,,DAL,L 111-113,240,45,91,.495,36,65,.554,9,26,.346,12,15,.800,111,41,83,.494,29,49,.592,12,34,.353,19,19,1.000,113
1156,UTA,2022-03-14,111,,MIL,L 111-117,240,37,93,.398,20,45,.444,17,48,.354,20,24,.833,111,40,86,.465,28,55,.509,12,31,.387,25,29,.862,117
1157,LAC,2022-03-14,111,@,CLE,L 111-120 (OT),265,43,98,.439,31,62,.500,12,36,.333,13,17,.765,111,41,86,.477,26,56,.464,15,30,.500,23,32,.719,120
1158,LAL,2022-03-13,111,@,PHO,L 111-140,240,36,81,.444,20,41,.488,16,40,.400,23,31,.742,111,58,102,.569,46,69,.667,12,33,.364,12,14,.857,140
1159,PHO,2022-03-09,111,@,MIA,W 111-90,240,45,99,.455,34,62,.548,11,37,.297,10,10,1.000,111,35,88,.398,25,55,.455,10,33,.303,10,13,.769,90
1160,NOP,2022-03-08,111,@,MEM,L 111-132,240,41,88,.466,30,54,.556,11,34,.324,18,27,.667,111,48,101,.475,32,57,.561,16,44,.364,20,24,.833,132
1161,DAL,2022-03-07,111,,UTA,W 111-103,240,39,88,.443,22,42,.524,17,46,.370,16,20,.800,111,36,83,.434,24,52,.462,12,31,.387,19,24,.792,103
1162,DET,2022-03-04,111,,IND,W 111-106,240,42,94,.447,27,64,.422,15,30,.500,12,18,.667,111,39,100,.390,29,60,.483,10,40,.250,18,28,.643,106
1163,LAL,2022-03-03,111,@,LAC,L 111-132,240,41,84,.488,29,49,.592,12,35,.343,17,22,.773,111,51,93,.548,34,66,.515,17,27,.630,13,15,.867,132
1164,HOU,2022-02-25,111,@,ORL,L 111-119,240,44,94,.468,30,47,.638,14,47,.298,9,20,.450,111,42,83,.506,29,47,.617,13,36,.361,22,29,.759,119
1165,MIA,2022-02-17,111,@,CHO,W 111-107 (2OT),290,41,102,.402,27,54,.500,14,48,.292,15,23,.652,111,38,95,.400,28,53,.528,10,42,.238,21,30,.700,107
1166,HOU,2022-02-17,111,@,LAC,L 111-142,240,42,91,.462,29,54,.537,13,37,.351,14,19,.737,111,51,92,.554,33,57,.579,18,35,.514,22,26,.846,142
1167,BRK,2022-02-16,111,@,NYK,W 111-106,240,43,98,.439,32,64,.500,11,34,.324,14,23,.609,111,37,85,.435,21,42,.500,16,43,.372,16,18,.889,106
1168,BOS,2022-02-16,111,,DET,L 111-112,240,42,77,.545,29,45,.644,13,32,.406,14,18,.778,111,43,93,.462,27,63,.429,16,30,.533,10,13,.769,112
1169,ORL,2022-02-14,111,@,DEN,L 111-121,240,40,91,.440,29,52,.558,11,39,.282,20,23,.870,111,42,88,.477,26,48,.542,16,40,.400,21,23,.913,121
1170,BRK,2022-02-12,111,@,MIA,L 111-115,240,42,93,.452,30,53,.566,12,40,.300,15,22,.682,111,41,82,.500,31,53,.585,10,29,.345,23,29,.793,115
1171,UTA,2022-02-09,111,,GSW,W 111-85,240,41,89,.461,24,38,.632,17,51,.333,12,17,.706,111,28,78,.359,12,35,.343,16,43,.372,13,17,.765,85
1172,LAC,2022-02-03,111,,LAL,W 111-110,240,46,89,.517,33,59,.559,13,30,.433,6,11,.545,111,41,88,.466,30,59,.508,11,29,.379,17,25,.680,110
1173,BRK,2022-02-01,111,@,PHO,L 111-121,240,40,81,.494,24,41,.585,16,40,.400,15,21,.714,111,42,76,.553,31,45,.689,11,31,.355,26,31,.839,121
1174,NOP,2022-02-01,111,@,DET,W 111-101,240,39,89,.438,31,61,.508,8,28,.286,25,28,.893,111,41,84,.488,33,52,.635,8,32,.250,11,14,.786,101
1175,CHI,2022-01-26,111,,TOR,W 111-105,240,46,84,.548,39,58,.672,7,26,.269,12,16,.750,111,38,79,.481,26,48,.542,12,31,.387,17,28,.607,105
1176,LAC,2022-01-26,111,@,ORL,W 111-102,240,36,81,.444,21,52,.404,15,29,.517,24,27,.889,111,38,84,.452,29,49,.592,9,35,.257,17,22,.773,102
1177,CHI,2022-01-24,111,@,OKC,W 111-110,240,41,89,.461,26,50,.520,15,39,.385,14,19,.737,111,38,92,.413,22,47,.468,16,45,.356,18,24,.750,110
1178,DET,2022-01-23,111,@,DEN,L 111-117,240,42,75,.560,31,46,.674,11,29,.379,16,19,.842,111,44,85,.518,32,50,.640,12,35,.343,17,23,.739,117
1179,UTA,2022-01-21,111,,DET,W 111-101,240,36,79,.456,26,48,.542,10,31,.323,29,34,.853,111,38,87,.437,25,55,.455,13,32,.406,12,16,.750,101
1180,CHO,2022-01-19,111,@,BOS,W 111-102,240,42,86,.488,26,47,.553,16,39,.410,11,15,.733,111,39,90,.433,25,44,.568,14,46,.304,10,13,.769,102
1181,IND,2022-01-19,111,@,LAL,W 111-104,240,44,90,.489,33,60,.550,11,30,.367,12,15,.800,111,40,90,.444,29,56,.518,11,34,.324,13,18,.722,104
1182,UTA,2022-01-19,111,,HOU,L 111-116,240,42,89,.472,32,51,.627,10,38,.263,17,20,.850,111,41,96,.427,19,51,.373,22,45,.489,12,17,.706,116
1183,PHI,2022-01-14,111,,BOS,W 111-99,240,38,85,.447,24,44,.545,14,41,.341,21,25,.840,111,37,78,.474,26,47,.553,11,31,.355,14,18,.778,99
1184,CLE,2022-01-12,111,@,UTA,W 111-91,240,43,81,.531,32,51,.627,11,30,.367,14,17,.824,111,34,85,.400,18,38,.474,16,47,.340,7,11,.636,91
1185,NYK,2022-01-10,111,,SAS,W 111-96,240,40,82,.488,27,50,.540,13,32,.406,18,24,.750,111,39,95,.411,31,66,.470,8,29,.276,10,15,.667,96
1186,PHI,2022-01-10,111,@,HOU,W 111-91,240,43,94,.457,33,59,.559,10,35,.286,15,18,.833,111,30,77,.390,17,35,.486,13,42,.310,18,27,.667,91
1187,SAC,2022-01-07,111,@,DEN,L 111-121,240,40,92,.435,29,63,.460,11,29,.379,20,24,.833,111,47,85,.553,35,51,.686,12,34,.353,15,24,.625,121
1188,MIL,2022-01-05,111,,TOR,L 111-117,240,38,85,.447,21,46,.457,17,39,.436,18,26,.692,111,42,89,.472,26,53,.491,16,36,.444,17,25,.680,117
1189,DET,2022-01-05,111,@,CHO,L 111-140,240,43,92,.467,29,50,.580,14,42,.333,11,20,.550,111,48,81,.593,24,39,.615,24,42,.571,20,29,.690,140
1190,WAS,2022-01-05,111,,HOU,L 111-114,240,40,91,.440,30,52,.577,10,39,.256,21,26,.808,111,40,85,.471,31,59,.525,9,26,.346,25,32,.781,114
1191,ORL,2022-01-02,111,@,BOS,L 111-116 (OT),265,40,95,.421,31,68,.456,9,27,.333,22,27,.815,111,39,86,.453,26,50,.520,13,36,.361,25,28,.893,116
1192,HOU,2022-01-01,111,,DEN,L 111-124,240,37,85,.435,21,43,.488,16,42,.381,21,24,.875,111,46,86,.535,36,54,.667,10,32,.313,22,27,.815,124
1193,OKC,2021-12-28,111,@,SAC,L 111-117,240,35,90,.389,24,57,.421,11,33,.333,30,36,.833,111,40,95,.421,23,56,.411,17,39,.436,20,27,.741,117
1194,BOS,2021-12-22,111,,CLE,W 111-101,240,43,92,.467,32,62,.516,11,30,.367,14,18,.778,111,36,92,.391,27,54,.500,9,38,.237,20,24,.833,101
1195,NOP,2021-12-21,111,,POR,W 111-97,240,42,80,.525,30,47,.638,12,33,.364,15,18,.833,111,35,78,.449,22,44,.500,13,34,.382,14,19,.737,97
1196,MIN,2021-12-19,111,,DAL,W 111-105,240,36,77,.468,21,43,.488,15,34,.441,24,31,.774,111,36,82,.439,24,41,.585,12,41,.293,21,22,.955,105
1197,GSW,2021-12-17,111,@,BOS,W 111-107,240,39,90,.433,23,44,.523,16,46,.348,17,21,.810,111,36,82,.439,21,41,.512,15,41,.366,20,29,.690,107
1198,ATL,2021-12-15,111,@,ORL,W 111-99,240,42,85,.494,31,54,.574,11,31,.355,16,16,1.000,111,35,90,.389,25,55,.455,10,35,.286,19,21,.905,99
1199,PHO,2021-12-14,111,@,POR,W 111-107 (OT),265,44,93,.473,33,62,.532,11,31,.355,12,15,.800,111,40,96,.417,27,55,.491,13,41,.317,14,22,.636,107
1200,LAC,2021-12-13,111,,PHO,W 111-95,240,43,78,.551,34,57,.596,9,21,.429,16,23,.696,111,36,96,.375,29,67,.433,7,29,.241,16,19,.842,95
1201,POR,2021-12-12,111,,MIN,L 111-116,240,37,81,.457,19,33,.576,18,48,.375,19,28,.679,111,38,85,.447,24,49,.490,14,36,.389,26,32,.813,116
1202,PHO,2021-12-10,111,,BOS,W 111-90,240,43,96,.448,29,58,.500,14,38,.368,11,11,1.000,111,35,93,.376,31,67,.463,4,26,.154,16,24,.667,90
1203,DEN,2021-12-09,111,@,SAS,L 111-123,240,42,94,.447,27,55,.491,15,39,.385,12,13,.923,111,46,88,.523,31,53,.585,15,35,.429,16,22,.727,123
1204,BOS,2021-12-08,111,@,LAC,L 111-114,240,41,86,.477,31,54,.574,10,32,.313,19,21,.905,111,40,85,.471,26,53,.491,14,32,.438,20,22,.909,114
1205,CHI,2021-12-04,111,@,BRK,W 111-107,240,41,86,.477,31,55,.564,10,31,.323,19,27,.704,111,46,111,.414,38,86,.442,8,25,.320,7,9,.778,107
1206,CLE,2021-12-01,111,@,MIA,W 111-85,240,37,68,.544,21,37,.568,16,31,.516,21,23,.913,111,32,85,.376,20,48,.417,12,37,.324,9,13,.692,85
1207,IND,2021-12-01,111,,ATL,L 111-114,240,44,90,.489,34,57,.596,10,33,.303,13,16,.813,111,44,86,.512,28,53,.528,16,33,.485,10,12,.833,114
1208,MIA,2021-11-29,111,,DEN,L 111-120,240,43,91,.473,28,47,.596,15,44,.341,10,15,.667,111,43,74,.581,25,39,.641,18,35,.514,16,21,.762,120
1209,SAS,2021-11-22,111,,PHO,L 111-115,240,49,93,.527,44,73,.603,5,20,.250,8,16,.500,111,45,88,.511,33,61,.541,12,27,.444,13,16,.813,115
1210,IND,2021-11-20,111,,NOP,W 111-94,240,42,91,.462,28,53,.528,14,38,.368,13,18,.722,111,35,88,.398,29,70,.414,6,18,.333,18,19,.947,94
1211,PHI,2021-11-20,111,@,POR,L 111-118,240,41,81,.506,31,53,.585,10,28,.357,19,21,.905,111,40,80,.500,25,46,.543,15,34,.441,23,23,1.000,118
1212,BOS,2021-11-20,111,,OKC,W 111-105,240,41,88,.466,24,49,.490,17,39,.436,12,14,.857,111,39,96,.406,21,54,.389,18,42,.429,9,16,.563,105
1213,ORL,2021-11-15,111,@,ATL,L 111-129,240,43,95,.453,27,52,.519,16,43,.372,9,14,.643,111,47,85,.553,33,55,.600,14,30,.467,21,32,.656,129
1214,DAL,2021-11-15,111,,DEN,W 111-101,240,45,90,.500,31,54,.574,14,36,.389,7,10,.700,111,40,84,.476,31,52,.596,9,32,.281,12,17,.706,101
1215,MIA,2021-11-13,111,@,UTA,W 111-105,240,42,85,.494,29,52,.558,13,33,.394,14,16,.875,111,35,85,.412,18,32,.563,17,53,.321,18,25,.720,105
1216,IND,2021-11-11,111,@,UTA,W 111-100,240,43,96,.448,32,65,.492,11,31,.355,14,19,.737,111,39,83,.470,30,51,.588,9,32,.281,13,23,.565,100
1217,HOU,2021-11-04,111,@,PHO,L 111-123,240,38,88,.432,27,56,.482,11,32,.344,24,28,.857,111,44,93,.473,30,62,.484,14,31,.452,21,23,.913,123
1218,IND,2021-11-03,111,,NYK,W 111-98,240,42,91,.462,26,50,.520,16,41,.390,11,14,.786,111,36,87,.414,31,63,.492,5,24,.208,21,27,.778,98
1219,WAS,2021-11-01,111,@,ATL,L 111-118,240,41,86,.477,28,47,.596,13,39,.333,16,16,1.000,111,38,83,.458,25,49,.510,13,34,.382,29,29,1.000,118
1220,POR,2021-10-29,111,,LAC,W 111-92,240,41,98,.418,22,57,.386,19,41,.463,10,16,.625,111,34,87,.391,19,45,.422,15,42,.357,9,16,.563,92
1221,ATL,2021-10-28,111,@,WAS,L 111-122,240,48,88,.545,42,67,.627,6,21,.286,9,14,.643,111,46,99,.465,33,65,.508,13,34,.382,17,21,.810,122
1222,ORL,2021-10-27,111,,CHO,L 111-120,240,43,88,.489,28,48,.583,15,40,.375,10,13,.769,111,43,83,.518,29,53,.547,14,30,.467,20,24,.833,120
1223,CHI,2021-10-25,111,@,TOR,W 111-108,240,39,81,.481,27,54,.500,12,27,.444,21,22,.955,111,40,83,.482,28,53,.528,12,30,.400,16,20,.800,108
1224,CHO,2021-10-24,111,@,BRK,W 111-95,240,43,94,.457,33,64,.516,10,30,.333,15,19,.789,111,38,87,.437,29,52,.558,9,35,.257,10,12,.833,95
1225,SAS,2021-10-23,111,,MIL,L 111-121,240,48,99,.485,38,60,.633,10,39,.256,5,6,.833,111,44,83,.530,29,48,.604,15,35,.429,18,22,.818,121
1226,MEM,2022-04-10,110,,BOS,L 110-139,240,39,102,.382,24,55,.436,15,47,.319,17,27,.630,110,54,99,.545,36,51,.706,18,48,.375,13,13,1.000,139
1227,BRK,2022-04-06,110,@,NYK,W 110-98,240,41,93,.441,27,52,.519,14,41,.341,14,18,.778,110,32,83,.386,19,45,.422,13,38,.342,21,36,.583,98
1228,LAL,2022-04-05,110,@,PHO,L 110-121,240,39,86,.453,30,57,.526,9,29,.310,23,30,.767,110,50,102,.490,36,63,.571,14,39,.359,7,9,.778,121
1229,DET,2022-04-01,110,@,OKC,W 110-101,240,40,94,.426,25,46,.543,15,48,.313,15,18,.833,110,36,84,.429,25,50,.500,11,34,.324,18,29,.621,101
1230,ORL,2022-03-30,110,@,WAS,L 110-127,240,40,96,.417,29,62,.468,11,34,.324,19,22,.864,110,47,92,.511,34,56,.607,13,36,.361,20,26,.769,127
1231,LAL,2022-03-29,110,@,DAL,L 110-128,240,40,89,.449,28,45,.622,12,44,.273,18,22,.818,110,45,87,.517,25,41,.610,20,46,.435,18,23,.783,128
1232,BRK,2022-03-27,110,,CHO,L 110-119,240,43,97,.443,36,63,.571,7,34,.206,17,26,.654,110,42,98,.429,25,66,.379,17,32,.531,18,23,.783,119
1233,ORL,2022-03-26,110,,SAC,L 110-114 (OT),265,45,106,.425,32,70,.457,13,36,.361,7,7,1.000,110,42,98,.429,31,62,.500,11,36,.306,19,24,.792,114
1234,BRK,2022-03-26,110,@,MIA,W 110-95,240,39,83,.470,28,50,.560,11,33,.333,21,26,.808,110,33,75,.440,23,41,.561,10,34,.294,19,26,.731,95
1235,GSW,2022-03-25,110,@,ATL,L 110-121,240,43,90,.478,29,49,.592,14,41,.341,10,13,.769,110,46,89,.517,32,52,.615,14,37,.378,15,19,.789,121
1236,SAC,2022-03-23,110,@,IND,W 110-109,240,43,82,.524,31,45,.689,12,37,.324,12,17,.706,110,42,91,.462,28,55,.509,14,36,.389,11,11,1.000,109
1237,DAL,2022-03-23,110,,HOU,W 110-91,240,42,86,.488,34,53,.642,8,33,.242,18,22,.818,110,33,82,.402,29,54,.537,4,28,.143,21,28,.750,91
1238,DAL,2022-03-21,110,,MIN,W 110-108,240,40,83,.482,26,37,.703,14,46,.304,16,21,.762,110,36,91,.396,23,55,.418,13,36,.361,23,29,.793,108
1239,SAS,2022-03-20,110,@,GSW,W 110-108,240,38,98,.388,23,58,.397,15,40,.375,19,25,.760,110,41,90,.456,30,57,.526,11,33,.333,15,21,.714,108
1240,BOS,2022-03-16,110,@,GSW,W 110-88,240,38,81,.469,23,41,.561,15,40,.375,19,22,.864,110,32,86,.372,21,38,.553,11,48,.229,13,16,.813,88
1241,CHI,2022-03-16,110,@,UTA,L 110-125,240,43,91,.473,31,57,.544,12,34,.353,12,17,.706,110,42,83,.506,23,44,.523,19,39,.487,22,29,.759,125
1242,PHI,2022-03-14,110,,DEN,L 110-114,240,36,84,.429,24,51,.471,12,33,.364,26,32,.813,110,44,82,.537,31,49,.633,13,33,.394,13,20,.650,114
1243,BRK,2022-03-13,110,,NYK,W 110-107,240,44,89,.494,38,60,.633,6,29,.207,16,22,.727,110,39,83,.470,28,54,.519,11,29,.379,18,21,.857,107
1244,MIN,2022-03-11,110,@,ORL,L 110-118,240,41,90,.456,26,45,.578,15,45,.333,13,13,1.000,110,40,86,.465,24,46,.522,16,40,.400,22,25,.880,118
1245,ATL,2022-03-07,110,@,DET,L 110-113 (OT),265,42,93,.452,31,55,.564,11,38,.289,15,22,.682,110,43,93,.462,31,60,.517,12,33,.364,15,23,.652,113
1246,LAL,2022-03-07,110,@,SAS,L 110-117,240,43,91,.473,35,65,.538,8,26,.308,16,23,.696,110,46,84,.548,37,58,.638,9,26,.346,16,30,.533,117
1247,OKC,2022-02-28,110,,SAC,L 110-131,240,40,86,.465,29,51,.569,11,35,.314,19,27,.704,110,49,87,.563,39,56,.696,10,31,.323,23,30,.767,131
1248,SAC,2022-02-26,110,@,DEN,L 110-115,240,38,89,.427,29,59,.492,9,30,.300,25,33,.758,110,38,82,.463,22,39,.564,16,43,.372,23,29,.793,115
1249,CHI,2022-02-26,110,,MEM,L 110-116,240,39,93,.419,30,73,.411,9,20,.450,23,30,.767,110,44,100,.440,37,77,.481,7,23,.304,21,26,.808,116
1250,SAC,2022-02-24,110,,DEN,L 110-128,240,43,86,.500,34,57,.596,9,29,.310,15,18,.833,110,48,86,.558,33,51,.647,15,35,.429,17,20,.850,128
1251,WAS,2022-02-12,110,,SAC,L 110-123,240,41,88,.466,28,50,.560,13,38,.342,15,21,.714,110,43,76,.566,31,48,.646,12,28,.429,25,29,.862,123
1252,DEN,2022-02-12,110,@,TOR,W 110-109,240,39,84,.464,25,47,.532,14,37,.378,18,21,.857,110,43,88,.489,31,54,.574,12,34,.353,11,17,.647,109
1253,NOP,2022-02-08,110,,HOU,W 110-97,240,42,80,.525,34,48,.708,8,32,.250,18,20,.900,110,32,86,.372,19,44,.432,13,42,.310,20,31,.645,97
1254,GSW,2022-02-07,110,@,OKC,W 110-98,240,41,82,.500,26,39,.667,15,43,.349,13,17,.765,110,37,90,.411,26,54,.481,11,36,.306,13,17,.765,98
1255,LAL,2022-02-03,110,@,LAC,L 110-111,240,41,88,.466,30,59,.508,11,29,.379,17,25,.680,110,46,89,.517,33,59,.559,13,30,.433,6,11,.545,111
1256,TOR,2022-02-01,110,,MIA,W 110-106,240,39,81,.481,27,55,.491,12,26,.462,20,29,.690,110,38,78,.487,30,48,.625,8,30,.267,22,25,.880,106
1257,ORL,2022-01-30,110,,DAL,W 110-108,240,43,84,.512,32,50,.640,11,34,.324,13,16,.813,110,39,81,.481,23,43,.535,16,38,.421,14,18,.778,108
1258,SAS,2022-01-30,110,@,PHO,L 110-115,240,45,100,.450,32,63,.508,13,37,.351,7,8,.875,110,48,97,.495,37,65,.569,11,32,.344,8,12,.667,115
1259,GSW,2022-01-29,110,,BRK,W 110-106,240,40,98,.408,26,53,.491,14,45,.311,16,18,.889,110,39,98,.398,28,70,.400,11,28,.393,17,21,.810,106
1260,HOU,2022-01-28,110,,POR,L 110-125,240,38,79,.481,28,38,.737,10,41,.244,24,31,.774,110,46,81,.568,29,42,.690,17,39,.436,16,20,.800,125
1261,OKC,2022-01-28,110,,IND,L 110-113 (OT),265,43,95,.453,29,52,.558,14,43,.326,10,17,.588,110,41,95,.432,28,56,.500,13,39,.333,18,29,.621,113
1262,SAS,2022-01-26,110,,MEM,L 110-118,240,43,94,.457,34,57,.596,9,37,.243,15,19,.789,110,46,90,.511,39,67,.582,7,23,.304,19,26,.731,118
1263,MIA,2022-01-26,110,,NYK,W 110-96,240,37,74,.500,21,37,.568,16,37,.432,20,22,.909,110,35,83,.422,20,39,.513,15,44,.341,11,17,.647,96
1264,DEN,2022-01-25,110,@,DET,W 110-105,240,36,84,.429,25,52,.481,11,32,.344,27,31,.871,110,41,97,.423,29,61,.475,12,36,.333,11,14,.786,105
1265,OKC,2022-01-24,110,,CHI,L 110-111,240,38,92,.413,22,47,.468,16,45,.356,18,24,.750,110,41,89,.461,26,50,.520,15,39,.385,14,19,.737,111
1266,NYK,2022-01-23,110,,LAC,W 110-102,240,39,91,.429,23,55,.418,16,36,.444,16,19,.842,110,34,79,.430,20,38,.526,14,41,.341,20,30,.667,102
1267,ATL,2022-01-21,110,,MIA,W 110-108,240,38,68,.559,24,35,.686,14,33,.424,20,24,.833,110,41,85,.482,26,45,.578,15,40,.375,11,12,.917,108
1268,ORL,2022-01-19,110,@,PHI,L 110-123,240,40,90,.444,22,55,.400,18,35,.514,12,16,.750,110,45,83,.542,35,55,.636,10,28,.357,23,27,.852,123
1269,NYK,2022-01-18,110,,MIN,L 110-112,240,37,80,.463,25,42,.595,12,38,.316,24,33,.727,110,35,81,.432,22,40,.550,13,41,.317,29,38,.763,112
1270,WAS,2022-01-15,110,,POR,L 110-115,240,39,90,.433,27,53,.509,12,37,.324,20,23,.870,110,39,85,.459,26,46,.565,13,39,.333,24,35,.686,115
1271,NOP,2022-01-04,110,,PHO,L 110-123,240,36,89,.404,26,56,.464,10,33,.303,28,32,.875,110,46,85,.541,29,54,.537,17,31,.548,14,20,.700,123
1272,MEM,2022-01-04,110,@,CLE,W 110-106,240,42,90,.467,33,63,.524,9,27,.333,17,22,.773,110,40,92,.435,30,58,.517,10,34,.294,16,21,.762,106
1273,HOU,2021-12-31,110,,MIA,L 110-120,240,41,93,.441,27,51,.529,14,42,.333,14,17,.824,110,40,86,.465,26,53,.491,14,33,.424,26,31,.839,120
1274,PHI,2021-12-30,110,@,BRK,W 110-102,240,42,100,.420,29,68,.426,13,32,.406,13,20,.650,110,37,81,.457,30,54,.556,7,27,.259,21,27,.778,102
1275,WAS,2021-12-30,110,,CLE,W 110-93,240,45,90,.500,36,61,.590,9,29,.310,11,17,.647,110,35,83,.422,27,55,.491,8,28,.286,15,23,.652,93
1276,ORL,2021-12-28,110,,MIL,L 110-127,240,38,83,.458,26,44,.591,12,39,.308,22,26,.846,110,47,85,.553,30,48,.625,17,37,.459,16,22,.727,127
1277,UTA,2021-12-27,110,@,SAS,W 110-104,240,39,86,.453,30,55,.545,9,31,.290,23,30,.767,110,45,100,.450,35,70,.500,10,30,.333,4,9,.444,104
1278,LAL,2021-12-23,110,,SAS,L 110-138,240,44,94,.468,39,67,.582,5,27,.185,17,30,.567,110,46,95,.484,28,56,.500,18,39,.462,28,33,.848,138
1279,NOP,2021-12-23,110,@,ORL,W 110-104,240,37,86,.430,24,56,.429,13,30,.433,23,26,.885,110,38,88,.432,29,56,.518,9,32,.281,19,21,.905,104
1280,LAL,2021-12-19,110,@,CHI,L 110-115,240,42,82,.512,30,48,.625,12,34,.353,14,22,.636,110,40,93,.430,30,63,.476,10,30,.333,25,31,.806,115
1281,MIN,2021-12-17,110,,LAL,W 110-92,240,41,98,.418,29,54,.537,12,44,.273,16,24,.667,110,30,78,.385,18,35,.514,12,43,.279,20,29,.690,92
1282,OKC,2021-12-15,110,,NOP,L 110-113,240,39,93,.419,26,58,.448,13,35,.371,19,19,1.000,110,39,80,.488,28,52,.538,11,28,.393,24,36,.667,113
1283,OKC,2021-12-08,110,@,TOR,W 110-109,240,38,84,.452,21,44,.477,17,40,.425,17,20,.850,110,42,93,.452,27,52,.519,15,41,.366,10,15,.667,109
1284,PHI,2021-12-08,110,@,CHO,W 110-106,240,36,75,.480,23,41,.561,13,34,.382,25,30,.833,110,39,80,.488,29,51,.569,10,29,.345,18,21,.857,106
1285,WAS,2021-12-06,110,@,IND,L 110-116,240,43,81,.531,36,66,.545,7,15,.467,17,21,.810,110,43,82,.524,34,59,.576,9,23,.391,21,22,.955,116
1286,MIN,2021-12-06,110,,ATL,L 110-121,240,39,98,.398,22,58,.379,17,40,.425,15,19,.789,110,40,90,.444,15,41,.366,25,49,.510,16,19,.842,121
1287,BRK,2021-12-03,110,,MIN,W 110-105,240,36,76,.474,30,53,.566,6,23,.261,32,41,.780,110,36,93,.387,23,51,.451,13,42,.310,20,24,.833,105
1288,OKC,2021-12-01,110,,HOU,L 110-114,240,40,85,.471,32,53,.604,8,32,.250,22,29,.759,110,40,79,.506,25,42,.595,15,37,.405,19,22,.864,114
1289,NYK,2021-11-30,110,@,BRK,L 110-112,240,44,91,.484,33,59,.559,11,32,.344,11,12,.917,110,41,85,.482,33,57,.579,8,28,.286,22,25,.880,112
1290,POR,2021-11-30,110,,DET,W 110-92,240,41,96,.427,27,54,.500,14,42,.333,14,18,.778,110,29,76,.382,20,41,.488,9,35,.257,25,30,.833,92
1291,LAL,2021-11-28,110,,DET,W 110-106,240,43,86,.500,34,54,.630,9,32,.281,15,25,.600,110,38,89,.427,25,56,.446,13,33,.394,17,19,.895,106
1292,UTA,2021-11-24,110,@,OKC,W 110-104,240,39,86,.453,24,39,.615,15,47,.319,17,20,.850,110,37,82,.451,22,46,.478,15,36,.417,15,22,.682,104
1293,MIN,2021-11-22,110,@,NOP,W 110-96,240,40,100,.400,30,56,.536,10,44,.227,20,28,.714,110,37,88,.420,31,56,.554,6,32,.188,16,18,.889,96
1294,ATL,2021-11-17,110,,BOS,W 110-99,240,41,81,.506,28,44,.636,13,37,.351,15,18,.833,110,37,84,.440,26,43,.605,11,41,.268,14,17,.824,99
1295,MIN,2021-11-10,110,@,GSW,L 110-123,240,39,95,.411,22,51,.431,17,44,.386,15,20,.750,110,40,85,.471,29,45,.644,11,40,.275,32,40,.800,123
1296,UTA,2021-11-09,110,,ATL,W 110-98,240,41,81,.506,26,43,.605,15,38,.395,13,16,.813,110,37,85,.435,19,50,.380,18,35,.514,6,10,.600,98
1297,CHO,2021-11-05,110,@,SAC,L 110-140,240,43,92,.467,32,57,.561,11,35,.314,13,21,.619,110,48,87,.552,26,43,.605,22,44,.500,22,26,.846,140
1298,POR,2021-11-05,110,,IND,W 110-106,240,40,82,.488,23,43,.535,17,39,.436,13,15,.867,110,43,88,.489,29,46,.630,14,42,.333,6,10,.600,106
1299,DAL,2021-11-02,110,,MIA,L 110-125,240,37,84,.440,23,42,.548,14,42,.333,22,31,.710,110,43,83,.518,30,58,.517,13,25,.520,26,30,.867,125
1300,CHO,2021-11-01,110,,CLE,L 110-113,240,42,101,.416,27,62,.435,15,39,.385,11,15,.733,110,39,90,.433,30,62,.484,9,28,.321,26,38,.684,113
1301,DET,2021-10-30,110,,ORL,W 110-103,240,36,89,.404,22,46,.478,14,43,.326,24,30,.800,110,38,87,.437,22,55,.400,16,32,.500,11,15,.733,103
1302,TOR,2021-10-29,110,,ORL,W 110-109,240,43,86,.500,34,56,.607,9,30,.300,15,22,.682,110,41,87,.471,25,53,.472,16,34,.471,11,16,.688,109
1303,PHI,2021-10-28,110,,DET,W 110-102,240,38,76,.500,26,49,.531,12,27,.444,22,24,.917,110,35,86,.407,22,47,.468,13,39,.333,19,27,.704,102
1304,SAC,2021-10-27,110,@,PHO,W 110-107,240,42,95,.442,27,57,.474,15,38,.395,11,15,.733,110,42,93,.452,36,71,.507,6,22,.273,17,24,.708,107
1305,DEN,2021-10-26,110,@,UTA,L 110-122,240,42,83,.506,32,55,.582,10,28,.357,16,24,.667,110,44,85,.518,32,46,.696,12,39,.308,22,29,.759,122
1306,ORL,2021-10-24,110,@,NYK,W 110-104,240,36,88,.409,24,45,.533,12,43,.279,26,34,.765,110,37,100,.370,24,52,.462,13,48,.271,17,25,.680,104
1307,UTA,2021-10-22,110,@,SAC,W 110-101,240,37,90,.411,21,48,.438,16,42,.381,20,23,.870,110,39,99,.394,31,63,.492,8,36,.222,15,21,.714,101
1308,DEN,2021-10-20,110,@,PHO,W 110-98,240,44,83,.530,27,44,.614,17,39,.436,5,9,.556,110,36,87,.414,22,50,.440,14,37,.378,12,17,.706,98
1309,PHO,2022-04-10,109,,SAC,L 109-116,240,42,103,.408,28,56,.500,14,47,.298,11,15,.733,109,40,76,.526,26,50,.520,14,26,.538,22,30,.733,116
1310,ATL,2022-04-08,109,@,MIA,L 109-113,240,42,88,.477,34,54,.630,8,34,.235,17,19,.895,109,40,72,.556,29,46,.630,11,26,.423,22,28,.786,113
1311,MEM,2022-04-07,109,@,DEN,L 109-122,240,42,89,.472,31,61,.508,11,28,.393,14,19,.737,109,44,80,.550,32,50,.640,12,30,.400,22,25,.880,122
1312,PHO,2022-04-06,109,@,LAC,L 109-113,240,42,108,.389,25,60,.417,17,48,.354,8,12,.667,109,33,75,.440,21,41,.512,12,34,.353,35,44,.795,113
1313,SAC,2022-04-05,109,,NOP,L 109-123,240,39,76,.513,28,46,.609,11,30,.367,20,22,.909,109,45,88,.511,33,63,.524,12,25,.480,21,26,.808,123
1314,TOR,2022-04-03,109,,MIA,L 109-114,240,35,83,.422,23,44,.523,12,39,.308,27,34,.794,109,41,79,.519,23,41,.561,18,38,.474,14,22,.636,114
1315,GSW,2022-04-03,109,@,SAC,W 109-90,240,41,79,.519,25,45,.556,16,34,.471,11,15,.733,109,31,81,.383,24,48,.500,7,33,.212,21,24,.875,90
1316,CHI,2022-04-02,109,,MIA,L 109-127,240,37,86,.430,28,52,.538,9,34,.265,26,29,.897,109,44,82,.537,27,48,.563,17,34,.500,22,27,.815,127
1317,LAL,2022-03-31,109,@,UTA,L 109-122,240,41,83,.494,34,58,.586,7,25,.280,20,28,.714,109,46,90,.511,31,46,.674,15,44,.341,15,24,.625,122
1318,CHO,2022-03-28,109,,DEN,L 109-113,240,44,93,.473,31,51,.608,13,42,.310,8,12,.667,109,40,86,.465,28,53,.528,12,33,.364,21,28,.750,113
1319,NYK,2022-03-28,109,,CHI,W 109-104,240,38,89,.427,26,54,.481,12,35,.343,21,35,.600,109,34,79,.430,28,56,.500,6,23,.261,30,33,.909,104
1320,CHI,2022-03-24,109,@,NOP,L 109-126,240,40,78,.513,26,44,.591,14,34,.412,15,19,.789,109,41,83,.494,29,54,.537,12,29,.414,32,34,.941,126
1321,IND,2022-03-23,109,,SAC,L 109-110,240,42,91,.462,28,55,.509,14,36,.389,11,11,1.000,109,43,82,.524,31,45,.689,12,37,.324,12,17,.706,110
1322,DET,2022-03-19,109,@,CLE,L 109-113,240,41,85,.482,28,55,.509,13,30,.433,14,19,.737,109,45,88,.511,35,62,.565,10,26,.385,13,23,.565,113
1323,WAS,2022-03-16,109,,DEN,L 109-127,240,41,87,.471,36,64,.563,5,23,.217,22,31,.710,109,46,90,.511,31,53,.585,15,37,.405,20,21,.952,127
1324,MIL,2022-03-12,109,@,GSW,L 109-122,240,38,92,.413,21,48,.438,17,44,.386,16,23,.696,109,45,93,.484,27,48,.563,18,45,.400,14,15,.933,122
1325,WAS,2022-03-11,109,@,LAL,L 109-122,240,39,85,.459,30,58,.517,9,27,.333,22,33,.667,109,48,91,.527,34,60,.567,14,31,.452,12,17,.706,122
1326,WAS,2022-03-09,109,@,LAC,L 109-115,240,41,87,.471,31,60,.517,10,27,.370,17,20,.850,109,43,86,.500,27,54,.500,16,32,.500,13,13,1.000,115
1327,TOR,2022-03-01,109,,BRK,W 109-108,240,41,90,.456,34,67,.507,7,23,.304,20,23,.870,109,42,84,.500,32,59,.542,10,25,.400,14,19,.737,108
1328,DAL,2022-03-01,109,@,LAL,W 109-104,240,41,82,.500,31,47,.660,10,35,.286,17,27,.630,109,37,82,.451,23,48,.479,14,34,.412,16,20,.800,104
1329,NYK,2022-02-27,109,,PHI,L 109-125,240,38,85,.447,27,52,.519,11,33,.333,22,35,.629,109,38,78,.487,28,45,.622,10,33,.303,39,44,.886,125
1330,DAL,2022-02-25,109,@,UTA,L 109-114,240,42,88,.477,25,49,.510,17,39,.436,8,8,1.000,109,40,74,.541,24,36,.667,16,38,.421,18,22,.818,114
1331,ORL,2022-02-16,109,,ATL,L 109-130,240,42,98,.429,29,57,.509,13,41,.317,12,13,.923,109,45,90,.500,27,57,.474,18,33,.545,22,28,.786,130
1332,NOP,2022-02-15,109,,MEM,L 109-121,240,44,88,.500,40,62,.645,4,26,.154,17,20,.850,109,47,94,.500,37,60,.617,10,34,.294,17,27,.630,121
1333,BRK,2022-02-14,109,,SAC,W 109-85,240,43,84,.512,34,58,.586,9,26,.346,14,15,.933,109,31,90,.344,22,55,.400,9,35,.257,14,18,.778,85
1334,SAS,2022-02-14,109,@,CHI,L 109-120,240,44,92,.478,38,72,.528,6,20,.300,15,21,.714,109,46,88,.523,36,64,.563,10,24,.417,18,21,.857,120
1335,TOR,2022-02-12,109,,DEN,L 109-110,240,43,88,.489,31,54,.574,12,34,.353,11,17,.647,109,39,84,.464,25,47,.532,14,37,.378,18,21,.857,110
1336,CHO,2022-02-09,109,,CHI,L 109-121,240,40,93,.430,27,50,.540,13,43,.302,16,23,.696,109,46,82,.561,30,49,.612,16,33,.485,13,19,.684,121
1337,PHI,2022-02-08,109,,PHO,L 109-114,240,41,89,.461,31,57,.544,10,32,.313,17,18,.944,109,43,95,.453,37,69,.536,6,26,.231,22,24,.917,114
1338,LAC,2022-02-08,109,@,MEM,L 109-135,240,40,89,.449,29,58,.500,11,31,.355,18,24,.750,109,53,103,.515,44,77,.571,9,26,.346,20,25,.800,135
1339,UTA,2022-01-28,109,@,MEM,L 109-119,240,37,85,.435,20,39,.513,17,46,.370,18,21,.857,109,46,82,.561,37,59,.627,9,23,.391,18,24,.750,119
1340,MIN,2022-01-25,109,@,POR,W 109-107,240,36,82,.439,22,39,.564,14,43,.326,23,31,.742,109,37,94,.394,21,53,.396,16,41,.390,17,20,.850,107
1341,UTA,2022-01-24,109,@,PHO,L 109-115,240,40,81,.494,26,50,.520,14,31,.452,15,22,.682,109,47,99,.475,34,63,.540,13,36,.361,8,15,.533,115
1342,SAS,2022-01-23,109,,PHI,L 109-115,240,42,89,.472,32,59,.542,10,30,.333,15,22,.682,109,44,92,.478,37,76,.487,7,16,.438,20,23,.870,115
1343,POR,2022-01-21,109,@,BOS,W 109-105,240,36,76,.474,20,43,.465,16,33,.485,21,30,.700,109,37,82,.451,26,45,.578,11,37,.297,20,23,.870,105
1344,TOR,2022-01-21,109,@,WAS,W 109-105,240,42,90,.467,31,60,.517,11,30,.367,14,17,.824,109,43,85,.506,32,52,.615,11,33,.333,8,10,.800,105
1345,PHO,2022-01-20,109,@,DAL,W 109-101,240,39,86,.453,31,50,.620,8,36,.222,23,25,.920,109,37,85,.435,26,48,.542,11,37,.297,16,20,.800,101
1346,PHI,2022-01-15,109,@,MIA,W 109-98,240,40,79,.506,27,47,.574,13,32,.406,16,21,.762,109,33,86,.384,24,51,.471,9,35,.257,23,30,.767,98
1347,CHO,2022-01-14,109,,ORL,L 109-116,240,40,97,.412,28,55,.509,12,42,.286,17,21,.810,109,45,87,.517,30,42,.714,15,45,.333,11,15,.733,116
1348,SAS,2022-01-14,109,,CLE,L 109-114,240,42,92,.457,27,58,.466,15,34,.441,10,13,.769,109,46,95,.484,38,75,.507,8,20,.400,14,24,.583,114
1349,BRK,2022-01-13,109,,OKC,L 109-130,240,41,98,.418,34,66,.515,7,32,.219,20,22,.909,109,47,91,.516,27,46,.587,20,45,.444,16,18,.889,130
1350,CHO,2022-01-12,109,@,PHI,W 109-98,240,46,89,.517,36,55,.655,10,34,.294,7,8,.875,109,34,73,.466,22,43,.512,12,30,.400,18,28,.643,98
1351,CLE,2022-01-10,109,@,SAC,W 109-108,240,43,87,.494,33,53,.623,10,34,.294,13,15,.867,109,39,91,.429,25,61,.410,14,30,.467,16,22,.727,108
1352,BRK,2022-01-07,109,,MIL,L 109-121,240,42,92,.457,36,65,.554,6,27,.222,19,20,.950,109,44,96,.458,28,51,.549,16,45,.356,17,21,.810,121
1353,POR,2022-01-05,109,,MIA,L 109-115,240,33,78,.423,18,40,.450,15,38,.395,28,36,.778,109,37,82,.451,18,41,.439,19,41,.463,22,29,.759,115
1354,DEN,2022-01-05,109,,UTA,L 109-115,240,42,88,.477,31,52,.596,11,36,.306,14,15,.933,109,43,92,.467,29,51,.569,14,41,.341,15,18,.833,115
1355,TOR,2021-12-28,109,,PHI,L 109-114,240,38,87,.437,23,46,.500,15,41,.366,18,22,.818,109,34,77,.442,20,47,.426,14,30,.467,32,38,.842,114
1356,DET,2021-12-26,109,@,SAS,L 109-144,240,38,98,.388,30,66,.455,8,32,.250,25,34,.735,109,51,91,.560,38,64,.594,13,27,.481,29,37,.784,144
1357,WAS,2021-12-18,109,@,UTA,W 109-103,240,42,94,.447,33,63,.524,9,31,.290,16,20,.800,109,35,81,.432,21,37,.568,14,44,.318,19,30,.633,103
1358,NOP,2021-12-10,109,,DET,W 109-93,240,41,95,.432,28,58,.483,13,37,.351,14,16,.875,109,35,90,.389,23,53,.434,12,37,.324,11,12,.917,93
1359,TOR,2021-12-08,109,,OKC,L 109-110,240,42,93,.452,27,52,.519,15,41,.366,10,15,.667,109,38,84,.452,21,44,.477,17,40,.425,17,20,.850,110
1360,SAS,2021-12-07,109,,NYK,L 109-121,240,41,92,.446,29,61,.475,12,31,.387,15,20,.750,109,43,91,.473,25,53,.472,18,38,.474,17,19,.895,121
1361,CHI,2021-12-06,109,,DEN,W 109-97,240,41,91,.451,28,56,.500,13,35,.371,14,20,.700,109,38,96,.396,27,64,.422,11,32,.344,10,15,.667,97
1362,UTA,2021-12-05,109,@,CLE,W 109-108,240,40,90,.444,20,42,.476,20,48,.417,9,10,.900,109,42,91,.462,28,53,.528,14,38,.368,10,13,.769,108
1363,BOS,2021-11-28,109,@,TOR,W 109-97,240,34,82,.415,22,48,.458,12,34,.353,29,31,.935,109,35,93,.376,22,51,.431,13,42,.310,14,16,.875,97
1364,DEN,2021-11-26,109,,MIL,L 109-120,240,40,92,.435,23,45,.511,17,47,.362,12,14,.857,109,46,73,.630,30,40,.750,16,33,.485,12,20,.600,120
1365,IND,2021-11-22,109,@,CHI,W 109-77,240,40,90,.444,27,59,.458,13,31,.419,16,18,.889,109,31,85,.365,25,57,.439,6,28,.214,9,15,.600,77
1366,CHO,2021-11-22,109,@,WAS,W 109-103,240,40,91,.440,25,60,.417,15,31,.484,14,24,.583,109,36,94,.383,27,57,.474,9,37,.243,22,27,.815,103
1367,CHI,2021-11-21,109,,NYK,W 109-103,240,37,88,.420,26,59,.441,11,29,.379,24,27,.889,109,35,84,.417,28,57,.491,7,27,.259,26,31,.839,103
1368,BRK,2021-11-17,109,,CLE,W 109-99,240,38,83,.458,26,51,.510,12,32,.375,21,25,.840,109,35,89,.393,24,45,.533,11,44,.250,18,21,.857,99
1369,MIL,2021-11-17,109,,LAL,W 109-102,240,40,87,.460,28,50,.560,12,37,.324,17,24,.708,109,40,96,.417,28,53,.528,12,43,.279,10,12,.833,102
1370,SAS,2021-11-12,109,,DAL,L 109-123,240,41,84,.488,28,54,.519,13,30,.433,14,20,.700,109,46,100,.460,28,55,.509,18,45,.400,13,19,.684,123
1371,MIA,2021-11-11,109,@,LAC,L 109-112,240,43,97,.443,34,56,.607,9,41,.220,14,17,.824,109,43,91,.473,32,54,.593,11,37,.297,15,17,.882,112
1372,PHI,2021-11-11,109,,TOR,L 109-115,240,40,88,.455,29,54,.537,11,34,.324,18,19,.947,109,42,96,.438,28,63,.444,14,33,.424,17,17,1.000,115
1373,POR,2021-11-10,109,@,PHO,L 109-119,240,44,91,.484,37,61,.607,7,30,.233,14,16,.875,109,49,94,.521,38,66,.576,11,28,.393,10,12,.833,119
1374,PHI,2021-11-09,109,,MIL,L 109-118,240,42,103,.408,28,60,.467,14,43,.326,11,12,.917,109,44,95,.463,29,56,.518,15,39,.385,15,21,.714,118
1375,POR,2021-11-09,109,@,LAC,L 109-117,240,43,91,.473,29,54,.537,14,37,.378,9,12,.750,109,44,85,.518,28,55,.509,16,30,.533,13,19,.684,117
1376,PHO,2021-11-08,109,@,SAC,W 109-104,240,44,93,.473,32,63,.508,12,30,.400,9,11,.818,109,37,82,.451,27,58,.466,10,24,.417,20,26,.769,104
1377,NYK,2021-11-07,109,,CLE,L 109-126,240,39,85,.459,30,54,.556,9,31,.290,22,24,.917,109,49,90,.544,30,55,.545,19,35,.543,9,11,.818,126
1378,PHI,2021-11-04,109,@,DET,W 109-98,240,41,83,.494,29,51,.569,12,32,.375,15,22,.682,109,35,87,.402,24,51,.471,11,36,.306,17,19,.895,98
1379,DAL,2021-11-03,109,@,SAS,W 109-108,240,40,93,.430,32,59,.542,8,34,.235,21,29,.724,109,43,88,.489,36,67,.537,7,21,.333,15,20,.750,108
1380,TOR,2021-11-03,109,@,WAS,W 109-100,240,41,88,.466,31,63,.492,10,25,.400,17,20,.850,109,34,78,.436,26,46,.565,8,32,.250,24,30,.800,100
1381,NOP,2021-10-29,109,,SAC,L 109-113,240,42,98,.429,33,64,.516,9,34,.265,16,25,.640,109,40,80,.500,31,53,.585,9,27,.333,24,25,.960,113
1382,ORL,2021-10-29,109,@,TOR,L 109-110,240,41,87,.471,25,53,.472,16,34,.471,11,16,.688,109,43,86,.500,34,56,.607,9,30,.300,15,22,.682,110
1383,IND,2021-10-25,109,,MIL,L 109-119,240,40,90,.444,26,54,.481,14,36,.389,15,17,.882,109,41,85,.482,30,53,.566,11,32,.344,26,31,.839,119
1384,PHI,2021-10-22,109,,BRK,L 109-114,240,43,91,.473,29,55,.527,14,36,.389,9,11,.818,109,41,88,.466,29,50,.580,12,38,.316,20,24,.833,114
1385,WAS,2022-04-10,108,@,CHO,L 108-124,240,42,94,.447,34,71,.479,8,23,.348,16,26,.615,108,48,89,.539,30,56,.536,18,33,.545,10,14,.714,124
1386,ATL,2022-04-05,108,@,TOR,L 108-118,240,43,94,.457,29,57,.509,14,37,.378,8,12,.667,108,44,101,.436,35,66,.530,9,35,.257,21,31,.677,118
1387,CLE,2022-04-03,108,,PHI,L 108-112,240,35,78,.449,20,45,.444,15,33,.455,23,31,.742,108,33,80,.413,22,49,.449,11,31,.355,35,42,.833,112
1388,LAL,2022-03-27,108,@,NOP,L 108-116,240,42,80,.525,28,45,.622,14,35,.400,10,16,.625,108,44,91,.484,35,64,.547,9,27,.333,19,24,.792,116
1389,MIN,2022-03-21,108,@,DAL,L 108-110,240,36,91,.396,23,55,.418,13,36,.361,23,29,.793,108,40,83,.482,26,37,.703,14,46,.304,16,21,.762,110
1390,GSW,2022-03-20,108,,SAS,L 108-110,240,41,90,.456,30,57,.526,11,33,.333,15,21,.714,108,38,98,.388,23,58,.397,15,40,.375,19,25,.760,110
1391,UTA,2022-03-20,108,@,NYK,W 108-93,240,34,74,.459,17,28,.607,17,46,.370,23,29,.793,108,31,83,.373,15,43,.349,16,40,.400,15,21,.714,93
1392,DAL,2022-03-19,108,@,CHO,L 108-129,240,39,89,.438,25,51,.490,14,38,.368,16,20,.800,108,44,88,.500,24,46,.522,20,42,.476,21,27,.778,129
1393,OKC,2022-03-18,108,@,MIA,L 108-120,240,40,84,.476,30,50,.600,10,34,.294,18,23,.783,108,46,95,.484,28,44,.636,18,51,.353,10,12,.833,120
1394,ORL,2022-03-15,108,,BRK,L 108-150,240,36,95,.379,21,54,.389,15,41,.366,21,27,.778,108,53,88,.602,37,61,.607,16,27,.593,28,34,.824,150
1395,SAS,2022-03-12,108,,IND,L 108-119,240,42,102,.412,31,68,.456,11,34,.324,13,16,.813,108,45,92,.489,31,56,.554,14,36,.389,15,15,1.000,119
1396,ORL,2022-03-09,108,@,NOP,W 108-102,240,36,76,.474,22,39,.564,14,37,.378,22,26,.846,108,41,93,.441,34,62,.548,7,31,.226,13,18,.722,102
1397,DET,2022-03-09,108,,CHI,L 108-114,240,42,82,.512,31,51,.608,11,31,.355,13,17,.765,108,40,76,.526,37,61,.607,3,15,.200,31,35,.886,114
1398,DET,2022-03-03,108,@,TOR,W 108-106,240,38,84,.452,27,47,.574,11,37,.297,21,28,.750,108,36,83,.434,29,57,.509,7,26,.269,27,36,.750,106
1399,NYK,2022-03-02,108,@,PHI,L 108-123,240,39,91,.429,31,63,.492,8,28,.286,22,32,.688,108,39,75,.520,22,39,.564,17,36,.472,28,33,.848,123
1400,BRK,2022-03-01,108,@,TOR,L 108-109,240,42,84,.500,32,59,.542,10,25,.400,14,19,.737,108,41,90,.456,34,67,.507,7,23,.304,20,23,.870,109
1401,ATL,2022-02-24,108,@,CHI,L 108-112,240,41,97,.423,33,69,.478,8,28,.286,18,27,.667,108,41,84,.488,33,57,.579,8,27,.296,22,27,.815,112
1402,WAS,2022-02-16,108,@,IND,L 108-113,240,39,91,.429,22,54,.407,17,37,.459,13,16,.813,108,45,83,.542,41,63,.651,4,20,.200,19,29,.655,113
1403,BOS,2022-02-11,108,,DEN,W 108-102,240,38,96,.396,28,59,.475,10,37,.270,22,30,.733,108,39,90,.433,28,46,.609,11,44,.250,13,18,.722,102
1404,CHI,2022-02-06,108,,PHI,L 108-119,240,39,81,.481,32,55,.582,7,26,.269,23,26,.885,108,45,84,.536,33,60,.550,12,24,.500,17,21,.810,119
1405,POR,2022-02-05,108,,MIL,L 108-137,240,41,85,.482,27,40,.675,14,45,.311,12,21,.571,108,49,92,.533,26,42,.619,23,50,.460,16,22,.727,137
1406,UTA,2022-02-02,108,,DEN,W 108-104,240,42,86,.488,35,57,.614,7,29,.241,17,22,.773,108,42,79,.532,31,51,.608,11,28,.393,9,12,.750,104
1407,NYK,2022-02-02,108,,MEM,L 108-120,240,38,88,.432,26,52,.500,12,36,.333,20,26,.769,108,44,102,.431,28,63,.444,16,39,.410,16,23,.696,120
1408,HOU,2022-01-31,108,,GSW,L 108-122,240,36,84,.429,20,41,.488,16,43,.372,20,29,.690,108,43,80,.538,26,40,.650,17,40,.425,19,23,.826,122
1409,DAL,2022-01-30,108,@,ORL,L 108-110,240,39,81,.481,23,43,.535,16,38,.421,14,18,.778,108,43,84,.512,32,50,.640,11,34,.324,13,16,.813,110
1410,NYK,2022-01-28,108,@,MIL,L 108-123,240,39,84,.464,25,44,.568,14,40,.350,16,28,.571,108,41,89,.461,27,46,.587,14,43,.326,27,31,.871,123
1411,ATL,2022-01-28,108,,BOS,W 108-92,240,41,89,.461,29,58,.500,12,31,.387,14,20,.700,108,30,86,.349,23,50,.460,7,36,.194,25,27,.926,92
1412,MIA,2022-01-21,108,@,ATL,L 108-110,240,41,85,.482,26,45,.578,15,40,.375,11,12,.917,108,38,68,.559,24,35,.686,14,33,.424,20,24,.833,110
1413,DET,2022-01-16,108,,PHO,L 108-135,240,38,82,.463,29,57,.509,9,25,.360,23,34,.676,108,51,87,.586,40,60,.667,11,27,.407,22,30,.733,135
1414,DAL,2022-01-15,108,,ORL,W 108-92,240,32,78,.410,20,44,.455,12,34,.353,32,38,.842,108,37,77,.481,30,51,.588,7,26,.269,11,16,.688,92
1415,ATL,2022-01-15,108,,NYK,L 108-117,240,40,80,.500,24,36,.667,16,44,.364,12,17,.706,108,42,83,.506,29,52,.558,13,31,.419,20,26,.769,117
1416,POR,2022-01-13,108,@,DEN,L 108-140,240,39,86,.453,26,46,.565,13,40,.325,17,28,.607,108,52,83,.627,31,41,.756,21,42,.500,15,20,.750,140
1417,MIN,2022-01-13,108,@,MEM,L 108-116,240,41,96,.427,26,48,.542,15,48,.313,11,14,.786,108,42,92,.457,34,60,.567,8,32,.250,24,35,.686,116
1418,NYK,2022-01-12,108,,DAL,W 108-85,240,42,90,.467,30,63,.476,12,27,.444,12,15,.800,108,32,78,.410,24,41,.585,8,37,.216,13,19,.684,85
1419,GSW,2022-01-11,108,@,MEM,L 108-116,240,35,82,.427,22,46,.478,13,36,.361,25,29,.862,108,44,100,.440,30,66,.455,14,34,.412,14,18,.778,116
1420,SAC,2022-01-10,108,,CLE,L 108-109,240,39,91,.429,25,61,.410,14,30,.467,16,22,.727,108,43,87,.494,33,53,.623,10,34,.294,13,15,.867,109
1421,BRK,2022-01-10,108,@,POR,L 108-114,240,42,91,.462,30,59,.508,12,32,.375,12,15,.800,108,40,86,.465,25,48,.521,15,38,.395,19,26,.731,114
1422,LAC,2022-01-08,108,,MEM,L 108-123,240,39,96,.406,29,64,.453,10,32,.313,20,24,.833,108,44,100,.440,32,62,.516,12,38,.316,23,31,.742,123
1423,UTA,2022-01-07,108,@,TOR,L 108-122,240,39,81,.481,22,43,.512,17,38,.447,13,18,.722,108,45,100,.450,33,59,.559,12,41,.293,20,25,.800,122
1424,NYK,2022-01-06,108,,BOS,W 108-105,240,40,90,.444,22,54,.407,18,36,.500,10,15,.667,108,38,80,.475,21,35,.600,17,45,.378,12,13,.923,105
1425,ATL,2022-01-05,108,@,SAC,W 108-102,240,39,86,.453,31,56,.554,8,30,.267,22,30,.733,108,38,90,.422,27,63,.429,11,27,.407,15,20,.750,102
1426,MIA,2022-01-03,108,@,GSW,L 108-115,240,37,90,.411,20,48,.417,17,42,.405,17,19,.895,108,45,92,.489,31,54,.574,14,38,.368,11,13,.846,115
1427,LAL,2022-01-02,108,,MIN,W 108-103,240,36,75,.480,23,34,.676,13,41,.317,23,29,.793,108,41,92,.446,32,54,.593,9,38,.237,12,16,.750,103
1428,CLE,2022-01-02,108,,IND,W 108-104,240,41,88,.466,35,62,.565,6,26,.231,20,28,.714,108,37,83,.446,18,37,.486,19,46,.413,11,14,.786,104
1429,CHI,2021-12-31,108,@,IND,W 108-106,240,35,86,.407,23,59,.390,12,27,.444,26,30,.867,108,38,91,.418,30,60,.500,8,31,.258,22,29,.759,106
1430,PHO,2021-12-31,108,@,BOS,L 108-123,240,41,100,.410,30,65,.462,11,35,.314,15,16,.938,108,45,83,.542,35,56,.625,10,27,.370,23,26,.885,123
1431,LAC,2021-12-31,108,@,TOR,L 108-116,240,38,78,.487,23,44,.523,15,34,.441,17,19,.895,108,40,96,.417,29,61,.475,11,35,.314,25,33,.758,116
1432,MIN,2021-12-31,108,@,UTA,L 108-120,240,40,93,.430,26,52,.500,14,41,.341,14,22,.636,108,37,78,.474,26,49,.531,11,29,.379,35,41,.854,120
1433,IND,2021-12-29,108,,CHO,L 108-116,240,36,86,.419,19,41,.463,17,45,.378,19,29,.655,108,44,85,.518,35,59,.593,9,26,.346,19,32,.594,116
1434,NOP,2021-12-28,108,,CLE,W 108-104,240,36,80,.450,20,44,.455,16,36,.444,20,26,.769,108,37,88,.420,23,47,.489,14,41,.341,16,19,.842,104
1435,MIN,2021-12-27,108,,BOS,W 108-103,240,40,90,.444,26,56,.464,14,34,.412,14,19,.737,108,33,89,.371,17,42,.405,16,47,.340,21,28,.750,103
1436,LAC,2021-12-27,108,,BRK,L 108-124,240,37,97,.381,23,60,.383,14,37,.378,20,27,.741,108,50,88,.568,37,54,.685,13,34,.382,11,16,.688,124
1437,OKC,2021-12-22,108,,DEN,W 108-94,240,42,94,.447,34,60,.567,8,34,.235,16,19,.842,108,33,84,.393,20,40,.500,13,44,.295,15,26,.577,94
1438,PHO,2021-12-21,108,@,LAL,W 108-90,240,41,93,.441,29,52,.558,12,41,.293,14,15,.933,108,34,87,.391,27,52,.519,7,35,.200,15,23,.652,90
1439,PHI,2021-12-20,108,@,BOS,W 108-103,240,36,72,.500,26,47,.553,10,25,.400,26,31,.839,108,38,82,.463,31,55,.564,7,27,.259,20,25,.800,103
1440,MEM,2021-12-09,108,,LAL,W 108-95,240,41,94,.436,27,52,.519,14,42,.333,12,18,.667,108,36,78,.462,24,48,.500,12,30,.400,11,17,.647,95
1441,PHO,2021-12-06,108,,SAS,W 108-104,240,43,94,.457,33,65,.508,10,29,.345,12,18,.667,108,40,93,.430,29,64,.453,11,29,.379,13,19,.684,104
1442,NOP,2021-12-05,108,@,HOU,L 108-118,240,40,94,.426,30,56,.536,10,38,.263,18,25,.720,108,39,79,.494,22,39,.564,17,40,.425,23,29,.793,118
1443,CLE,2021-12-05,108,,UTA,L 108-109,240,42,91,.462,28,53,.528,14,38,.368,10,13,.769,108,40,90,.444,20,42,.476,20,48,.417,9,10,.900,109
1444,ORL,2021-12-01,108,,DEN,W 108-103,240,44,81,.543,38,54,.704,6,27,.222,14,19,.737,108,39,80,.488,29,46,.630,10,34,.294,15,21,.714,103
1445,BOS,2021-11-22,108,,HOU,W 108-90,240,39,92,.424,27,57,.474,12,35,.343,18,19,.947,108,31,83,.373,20,41,.488,11,42,.262,17,24,.708,90
1446,ORL,2021-11-20,108,@,MIL,L 108-117,240,39,98,.398,20,47,.426,19,51,.373,11,14,.786,108,37,82,.451,18,42,.429,19,40,.475,24,37,.649,117
1447,DEN,2021-11-19,108,,CHI,L 108-114,240,39,82,.476,25,45,.556,14,37,.378,16,20,.800,108,41,93,.441,33,62,.532,8,31,.258,24,24,1.000,114
1448,TOR,2021-11-19,108,@,SAC,W 108-89,240,38,84,.452,26,53,.491,12,31,.387,20,24,.833,108,32,84,.381,23,47,.489,9,37,.243,16,25,.640,89
1449,LAL,2021-11-19,108,@,BOS,L 108-130,240,39,84,.464,27,54,.500,12,30,.400,18,24,.750,108,44,88,.500,33,58,.569,11,30,.367,31,38,.816,130
1450,LAC,2021-11-18,108,@,MEM,L 108-120,240,42,90,.467,26,51,.510,16,39,.410,8,8,1.000,108,52,96,.542,41,70,.586,11,26,.423,5,6,.833,120
1451,MEM,2021-11-10,108,,CHO,L 108-118,240,45,107,.421,36,69,.522,9,38,.237,9,15,.600,108,41,90,.456,26,54,.481,15,36,.417,21,24,.875,118
1452,OKC,2021-11-10,108,@,NOP,W 108-100,240,37,87,.425,27,53,.509,10,34,.294,24,30,.800,108,34,97,.351,25,62,.403,9,35,.257,23,32,.719,100
1453,DAL,2021-11-08,108,,NOP,W 108-92,240,43,85,.506,29,50,.580,14,35,.400,8,13,.615,108,37,87,.425,28,53,.528,9,34,.265,9,11,.818,92
1454,ATL,2021-11-03,108,@,BRK,L 108-117,240,41,94,.436,28,59,.475,13,35,.371,13,15,.867,108,43,88,.489,21,40,.525,22,48,.458,9,12,.750,117
1455,MEM,2021-11-03,108,,DEN,W 108-106,240,42,81,.519,26,47,.553,16,34,.471,8,14,.571,108,43,91,.473,35,64,.547,8,27,.296,12,13,.923,106
1456,SAS,2021-11-03,108,,DAL,L 108-109,240,43,88,.489,36,67,.537,7,21,.333,15,20,.750,108,40,93,.430,32,59,.542,8,34,.235,21,29,.724,109
1457,MIL,2021-10-27,108,,MIN,L 108-113,240,39,95,.411,25,44,.568,14,51,.275,16,21,.762,108,43,91,.473,30,46,.652,13,45,.289,14,17,.824,113
1458,TOR,2021-10-25,108,,CHI,L 108-111,240,40,83,.482,28,53,.528,12,30,.400,16,20,.800,108,39,81,.481,27,54,.500,12,27,.444,21,22,.955,111
1459,NOP,2022-04-10,107,,GSW,L 107-128,240,42,99,.424,28,59,.475,14,40,.350,9,12,.750,107,49,81,.605,30,48,.625,19,33,.576,11,13,.846,128
1460,CLE,2022-04-08,107,@,BRK,L 107-118,240,40,82,.488,32,55,.582,8,27,.296,19,24,.792,107,43,92,.467,31,60,.517,12,32,.375,20,21,.952,118
1461,UTA,2022-04-02,107,@,GSW,L 107-111,240,38,89,.427,23,43,.535,15,46,.326,16,22,.727,107,40,84,.476,20,36,.556,20,48,.417,11,12,.917,111
1462,CLE,2022-03-31,107,@,ATL,L 107-131,240,39,90,.433,32,60,.533,7,30,.233,22,28,.786,107,45,91,.495,28,52,.538,17,39,.436,24,28,.857,131
1463,PHO,2022-03-30,107,@,GSW,W 107-103,240,38,92,.413,31,64,.484,7,28,.250,24,30,.800,107,35,83,.422,22,45,.489,13,38,.342,20,25,.800,103
1464,POR,2022-03-30,107,,NOP,L 107-117,240,39,85,.459,25,43,.581,14,42,.333,15,18,.833,107,40,78,.513,34,54,.630,6,24,.250,31,39,.795,117
1465,CHI,2022-03-29,107,@,WAS,W 107-94,240,43,85,.506,37,67,.552,6,18,.333,15,18,.833,107,38,79,.481,32,53,.604,6,26,.231,12,17,.706,94
1466,CLE,2022-03-28,107,,ORL,W 107-101,240,37,83,.446,24,42,.571,13,41,.317,20,23,.870,107,42,87,.483,32,50,.640,10,37,.270,7,13,.538,101
1467,OKC,2022-03-26,107,@,DEN,L 107-113,240,39,84,.464,25,48,.521,14,36,.389,15,16,.938,107,41,85,.482,33,54,.611,8,31,.258,23,24,.958,113
1468,SAS,2022-03-26,107,@,NOP,W 107-103,240,39,92,.424,32,66,.485,7,26,.269,22,25,.880,107,40,90,.444,30,58,.517,10,32,.313,13,19,.684,103
1469,CHO,2022-03-25,107,,UTA,W 107-101,240,41,88,.466,28,54,.519,13,34,.382,12,17,.706,107,38,84,.452,21,37,.568,17,47,.362,8,11,.727,101
1470,NYK,2022-03-13,107,@,BRK,L 107-110,240,39,83,.470,28,54,.519,11,29,.379,18,21,.857,107,44,89,.494,38,60,.633,6,29,.207,16,22,.727,110
1471,NYK,2022-03-09,107,@,DAL,W 107-77,240,36,84,.429,27,50,.540,9,34,.265,26,33,.788,107,27,86,.314,21,42,.500,6,44,.136,17,25,.680,77
1472,BRK,2022-03-03,107,,MIA,L 107-113,240,39,83,.470,27,52,.519,12,31,.387,17,22,.773,107,40,77,.519,30,47,.638,10,30,.333,23,28,.821,113
1473,MEM,2022-03-03,107,@,BOS,L 107-120,240,42,99,.424,29,59,.492,13,40,.325,10,13,.769,107,46,89,.517,30,52,.577,16,37,.432,12,15,.800,120
1474,DEN,2022-03-02,107,,OKC,L 107-119,240,40,90,.444,28,44,.636,12,46,.261,15,17,.882,107,44,87,.506,28,58,.483,16,29,.552,15,21,.714,119
1475,BOS,2022-03-01,107,,ATL,W 107-98,240,39,83,.470,28,48,.583,11,35,.314,18,19,.947,107,36,83,.434,29,52,.558,7,31,.226,19,24,.792,98
1476,DAL,2022-02-27,107,@,GSW,W 107-101,240,39,78,.500,26,44,.591,13,34,.382,16,20,.800,107,39,91,.429,28,52,.538,11,39,.282,12,20,.600,101
1477,BOS,2022-02-27,107,@,IND,L 107-128,240,39,91,.429,27,48,.563,12,43,.279,17,20,.850,107,47,90,.522,30,57,.526,17,33,.515,17,20,.850,128
1478,CHO,2022-02-17,107,,MIA,L 107-111 (2OT),290,38,95,.400,28,53,.528,10,42,.238,21,30,.700,107,41,102,.402,27,54,.500,14,48,.292,15,23,.652,111
1479,DAL,2022-02-15,107,@,MIA,W 107-99,240,34,76,.447,16,35,.457,18,41,.439,21,33,.636,107,35,84,.417,28,57,.491,7,27,.259,22,27,.815,99
1480,MIL,2022-02-14,107,,POR,L 107-122,240,38,89,.427,25,48,.521,13,41,.317,18,24,.750,107,45,99,.455,27,56,.482,18,43,.419,14,19,.737,122
1481,MIL,2022-02-10,107,@,PHO,L 107-131,240,40,88,.455,30,50,.600,10,38,.263,17,25,.680,107,51,90,.567,42,60,.700,9,30,.300,20,29,.690,131
1482,DET,2022-02-10,107,,MEM,L 107-132,240,41,94,.436,34,59,.576,7,35,.200,18,21,.857,107,44,92,.478,29,62,.468,15,30,.500,29,42,.690,132
1483,POR,2022-02-09,107,,LAL,W 107-105,240,42,89,.472,32,57,.561,10,32,.313,13,16,.813,107,41,74,.554,24,37,.649,17,37,.459,6,13,.462,105
1484,HOU,2022-02-06,107,,NOP,L 107-120,240,40,84,.476,24,39,.615,16,45,.356,11,16,.688,107,41,77,.532,29,48,.604,12,29,.414,26,36,.722,120
1485,DAL,2022-02-04,107,,PHI,W 107-98,240,39,85,.459,29,51,.569,10,34,.294,19,23,.826,107,36,70,.514,27,43,.628,9,27,.333,17,23,.739,98
1486,CHO,2022-02-02,107,@,BOS,L 107-113,240,37,87,.425,25,47,.532,12,40,.300,21,27,.778,107,42,82,.512,28,46,.609,14,36,.389,15,17,.882,113
1487,BOS,2022-01-29,107,@,NOP,W 107-97,240,43,81,.531,29,40,.725,14,41,.341,7,11,.636,107,36,82,.439,28,50,.560,8,32,.250,17,23,.739,97
1488,POR,2022-01-25,107,,MIN,L 107-109,240,37,94,.394,21,53,.396,16,41,.390,17,20,.850,107,36,82,.439,22,39,.564,14,43,.326,23,31,.742,109
1489,NOP,2022-01-25,107,@,PHI,L 107-117,240,40,83,.482,31,61,.508,9,22,.409,18,26,.692,107,39,84,.464,29,53,.547,10,31,.323,29,31,.935,117
1490,LAL,2022-01-23,107,@,MIA,L 107-113,240,36,79,.456,25,39,.641,11,40,.275,24,30,.800,107,40,81,.494,25,48,.521,15,33,.455,18,20,.900,113
1491,SAS,2022-01-17,107,,PHO,L 107-121,240,41,92,.446,32,62,.516,9,30,.300,16,22,.727,107,49,95,.516,40,63,.635,9,32,.281,14,20,.700,121
1492,BRK,2022-01-17,107,@,CLE,L 107-114,240,41,83,.494,29,53,.547,12,30,.400,13,18,.722,107,42,81,.519,31,49,.633,11,32,.344,19,21,.905,114
1493,CLE,2022-01-15,107,@,OKC,W 107-102,240,40,87,.460,31,52,.596,9,35,.257,18,25,.720,107,36,83,.434,26,56,.464,10,27,.370,20,22,.909,102
1494,PHO,2021-12-25,107,,GSW,L 107-116,240,40,83,.482,29,53,.547,11,30,.367,16,16,1.000,107,42,85,.494,28,48,.583,14,37,.378,18,21,.857,116
1495,DEN,2021-12-23,107,,CHO,L 107-115,240,40,96,.417,26,56,.464,14,40,.350,13,17,.765,107,39,94,.415,23,47,.489,16,47,.340,21,24,.875,115
1496,NYK,2021-12-18,107,@,BOS,L 107-114,240,35,80,.438,22,44,.500,13,36,.361,24,30,.800,107,42,89,.472,25,44,.568,17,45,.378,13,17,.765,114
1497,DET,2021-12-18,107,,HOU,L 107-116,240,43,93,.462,33,57,.579,10,36,.278,11,16,.688,107,46,93,.495,32,55,.582,14,38,.368,10,17,.588,116
1498,BOS,2021-12-17,107,,GSW,L 107-111,240,36,82,.439,21,41,.512,15,41,.366,20,29,.690,107,39,90,.433,23,44,.523,16,46,.348,17,21,.810,111
1499,DEN,2021-12-15,107,,MIN,L 107-124,240,38,84,.452,24,45,.533,14,39,.359,17,23,.739,107,45,88,.511,22,40,.550,23,48,.479,11,16,.688,124
1500,LAL,2021-12-15,107,@,DAL,W 107-104 (OT),265,39,90,.433,24,51,.471,15,39,.385,14,18,.778,107,39,98,.398,27,54,.500,12,44,.273,14,17,.824,104
1501,POR,2021-12-14,107,,PHO,L 107-111 (OT),265,40,96,.417,27,55,.491,13,41,.317,14,22,.636,107,44,93,.473,33,62,.532,11,31,.355,12,15,.800,111
1502,WAS,2021-12-13,107,@,DEN,L 107-113,240,41,90,.456,29,56,.518,12,34,.353,13,21,.619,107,37,79,.468,27,47,.574,10,32,.313,29,33,.879,113
1503,BRK,2021-12-04,107,,CHI,L 107-111,240,46,111,.414,38,86,.442,8,25,.320,7,9,.778,107,41,86,.477,31,55,.564,10,31,.323,19,27,.704,111
1504,GSW,2021-12-04,107,,SAS,L 107-112,240,40,90,.444,27,51,.529,13,39,.333,14,21,.667,107,42,88,.477,30,53,.566,12,35,.343,16,19,.842,112
1505,NOP,2021-12-03,107,@,DAL,W 107-91,240,37,90,.411,25,60,.417,12,30,.400,21,28,.750,107,32,79,.405,22,45,.489,10,34,.294,17,26,.654,91
1506,NOP,2021-12-01,107,,DAL,L 107-139,240,40,89,.449,27,52,.519,13,37,.351,14,16,.875,107,57,83,.687,39,49,.796,18,34,.529,7,9,.778,139
1507,MIN,2021-12-01,107,@,WAS,L 107-115,240,37,88,.420,26,51,.510,11,37,.297,22,26,.846,107,45,91,.495,35,59,.593,10,32,.313,15,21,.714,115
1508,POR,2021-11-29,107,@,UTA,L 107-129,240,42,91,.462,31,60,.517,11,31,.355,12,17,.706,107,47,89,.528,28,43,.651,19,46,.413,16,23,.696,129
1509,BRK,2021-11-27,107,,PHO,L 107-113,240,42,84,.500,35,61,.574,7,23,.304,16,21,.762,107,41,92,.446,28,54,.519,13,38,.342,18,21,.857,113
1510,MIA,2021-11-27,107,@,CHI,W 107-104,240,37,86,.430,23,46,.500,14,40,.350,19,22,.864,107,38,81,.469,27,42,.643,11,39,.282,17,21,.810,104
1511,LAC,2021-11-26,107,,DET,W 107-96,240,39,91,.429,28,53,.528,11,38,.289,18,19,.947,107,33,90,.367,25,57,.439,8,33,.242,22,26,.846,96
1512,CHI,2021-11-17,107,@,POR,L 107-112,240,39,83,.470,26,54,.481,13,29,.448,16,20,.800,107,37,84,.440,26,53,.491,11,31,.355,27,28,.964,112
1513,MIN,2021-11-17,107,,SAC,W 107-97,240,41,82,.500,31,46,.674,10,36,.278,15,18,.833,107,34,93,.366,24,55,.436,10,38,.263,19,25,.760,97
1514,DET,2021-11-15,107,,SAC,L 107-129,240,39,96,.406,26,49,.531,13,47,.277,16,17,.941,107,52,98,.531,36,65,.554,16,33,.485,9,11,.818,129
1515,MIN,2021-11-12,107,@,LAL,W 107-83,240,43,94,.457,31,57,.544,12,37,.324,9,12,.750,107,29,82,.354,20,41,.488,9,41,.220,16,20,.800,83
1516,DAL,2021-11-10,107,@,CHI,L 107-117,240,38,83,.458,26,50,.520,12,33,.364,19,24,.792,107,45,89,.506,30,58,.517,15,31,.484,12,14,.857,117
1517,ORL,2021-11-07,107,,UTA,W 107-100,240,43,87,.494,31,55,.564,12,32,.375,9,11,.818,107,34,89,.382,26,47,.553,8,42,.190,24,29,.828,100
1518,HOU,2021-11-07,107,@,GSW,L 107-120,240,36,79,.456,26,46,.565,10,33,.303,25,37,.676,107,44,85,.518,29,39,.744,15,46,.326,17,20,.850,120
1519,DAL,2021-11-06,107,,BOS,W 107-104,240,41,78,.526,28,39,.718,13,39,.333,12,14,.857,107,42,86,.488,33,55,.600,9,31,.290,11,16,.688,104
1520,OKC,2021-11-04,107,@,LAL,W 107-104,240,37,87,.425,22,46,.478,15,41,.366,18,26,.692,107,39,94,.415,27,61,.443,12,33,.364,14,17,.824,104
1521,CLE,2021-11-03,107,,POR,W 107-104,240,39,74,.527,24,44,.545,15,30,.500,14,18,.778,107,40,90,.444,27,53,.509,13,37,.351,11,17,.647,104
1522,UTA,2021-10-31,107,@,MIL,W 107-95,240,35,75,.467,23,38,.605,12,37,.324,25,27,.926,107,39,96,.406,27,55,.491,12,41,.293,5,6,.833,95
1523,CHI,2021-10-30,107,,UTA,W 107-99,240,39,91,.429,34,70,.486,5,21,.238,24,30,.800,107,35,92,.380,24,54,.444,11,38,.289,18,19,.947,99
1524,PHO,2021-10-27,107,,SAC,L 107-110,240,42,93,.452,36,71,.507,6,22,.273,17,24,.708,107,42,95,.442,27,57,.474,15,38,.395,11,15,.733,110
1525,BOS,2021-10-27,107,,WAS,L 107-116,240,37,85,.435,27,56,.482,10,29,.345,23,28,.821,107,43,84,.512,34,59,.576,9,25,.360,21,29,.724,116
1526,NOP,2021-10-25,107,@,MIN,W 107-98,240,39,87,.448,29,57,.509,10,30,.333,19,23,.826,107,31,90,.344,16,40,.400,15,50,.300,21,27,.778,98
1527,MIA,2021-10-25,107,,ORL,W 107-90,240,41,87,.471,35,60,.583,6,27,.222,19,19,1.000,107,33,81,.407,21,37,.568,12,44,.273,12,19,.632,90
1528,SAC,2021-10-24,107,,GSW,L 107-119,240,42,86,.488,27,40,.675,15,46,.326,8,13,.615,107,43,97,.443,30,60,.500,13,37,.351,20,24,.833,119
1529,BOS,2021-10-24,107,@,HOU,W 107-97,240,38,86,.442,23,39,.590,15,47,.319,16,20,.800,107,32,75,.427,18,43,.419,14,32,.438,19,24,.792,97
1530,UTA,2021-10-20,107,,OKC,W 107-86,240,40,91,.440,26,44,.591,14,47,.298,13,15,.867,107,34,91,.374,27,56,.482,7,35,.200,11,18,.611,86
1531,DET,2022-04-10,106,@,PHI,L 106-118,240,38,83,.458,27,49,.551,11,34,.324,19,29,.655,106,46,88,.523,41,63,.651,5,25,.200,21,23,.913,118
1532,CHI,2022-04-05,106,,MIL,L 106-127,240,42,98,.429,33,65,.508,9,33,.273,13,13,1.000,106,46,87,.529,34,52,.654,12,35,.343,23,25,.920,127
1533,MIA,2022-03-30,106,@,BOS,W 106-98,240,38,79,.481,25,45,.556,13,34,.382,17,25,.680,106,35,85,.412,24,48,.500,11,37,.297,17,23,.739,98
1534,POR,2022-03-25,106,,HOU,L 106-125,240,43,85,.506,40,65,.615,3,20,.150,17,23,.739,106,43,83,.518,24,38,.632,19,45,.422,20,23,.870,125
1535,CHO,2022-03-23,106,,NYK,L 106-121,240,42,89,.472,29,43,.674,13,46,.283,9,17,.529,106,43,83,.518,23,38,.605,20,45,.444,15,17,.882,121
1536,MIA,2022-03-21,106,@,PHI,L 106-113,240,38,80,.475,28,47,.596,10,33,.303,20,20,1.000,106,43,86,.500,28,49,.571,15,37,.405,12,16,.750,113
1537,CHO,2022-03-21,106,,NOP,W 106-103,240,40,79,.506,27,42,.643,13,37,.351,13,15,.867,106,40,90,.444,31,66,.470,9,24,.375,14,16,.875,103
1538,UTA,2022-03-21,106,@,BRK,L 106-114,240,37,83,.446,23,44,.523,14,39,.359,18,22,.818,106,45,83,.542,34,53,.642,11,30,.367,13,15,.867,114
1539,ATL,2022-03-16,106,@,CHO,L 106-116,240,40,93,.430,27,56,.482,13,37,.351,13,14,.929,106,43,87,.494,32,52,.615,11,35,.314,19,23,.826,116
1540,LAC,2022-03-13,106,@,DET,W 106-102,240,40,89,.449,30,59,.508,10,30,.333,16,20,.800,106,36,80,.450,24,51,.471,12,29,.414,18,20,.900,102
1541,LAC,2022-03-11,106,@,ATL,L 106-112,240,40,82,.488,28,50,.560,12,32,.375,14,17,.824,106,43,90,.478,34,59,.576,9,31,.290,17,19,.895,112
1542,DEN,2022-03-09,106,@,SAC,W 106-100,240,40,82,.488,31,47,.660,9,35,.257,17,19,.895,106,38,85,.447,26,51,.510,12,34,.353,12,18,.667,100
1543,HOU,2022-03-07,106,@,MIA,L 106-123,240,39,88,.443,26,45,.578,13,43,.302,15,22,.682,106,49,91,.538,35,60,.583,14,31,.452,11,14,.786,123
1544,CHI,2022-03-07,106,@,PHI,L 106-121,240,39,87,.448,31,63,.492,8,24,.333,20,26,.769,106,41,84,.488,29,54,.537,12,30,.400,27,34,.794,121
1545,IND,2022-03-04,106,@,DET,L 106-111,240,39,100,.390,29,60,.483,10,40,.250,18,28,.643,106,42,94,.447,27,64,.422,15,30,.500,12,18,.667,111
1546,TOR,2022-03-03,106,,DET,L 106-108,240,36,83,.434,29,57,.509,7,26,.269,27,36,.750,106,38,84,.452,27,47,.574,11,37,.297,21,28,.750,108
1547,CHO,2022-02-28,106,@,MIL,L 106-130,240,36,93,.387,22,54,.407,14,39,.359,20,32,.625,106,40,91,.440,22,46,.478,18,45,.400,32,37,.865,130
1548,BRK,2022-02-24,106,,BOS,L 106-129,240,39,94,.415,32,65,.492,7,29,.241,21,28,.750,106,46,85,.541,29,43,.674,17,42,.405,20,27,.741,129
1549,DET,2022-02-24,106,,CLE,W 106-103,240,35,86,.407,24,52,.462,11,34,.324,25,28,.893,106,34,77,.442,22,42,.524,12,35,.343,23,34,.676,103
1550,NYK,2022-02-16,106,,BRK,L 106-111,240,37,85,.435,21,42,.500,16,43,.372,16,18,.889,106,43,98,.439,32,64,.500,11,34,.324,14,23,.609,111
1551,OKC,2022-02-16,106,,SAS,L 106-114,240,41,105,.390,30,73,.411,11,32,.344,13,19,.684,106,43,98,.439,33,64,.516,10,34,.294,18,22,.818,114
1552,LAL,2022-02-16,106,,UTA,W 106-101,240,41,86,.477,31,50,.620,10,36,.278,14,22,.636,106,37,79,.468,26,46,.565,11,33,.333,16,19,.842,101
1553,CHI,2022-02-12,106,,OKC,W 106-101,240,40,89,.449,33,64,.516,7,25,.280,19,23,.826,106,34,88,.386,23,52,.442,11,36,.306,22,30,.733,101
1554,HOU,2022-02-04,106,@,SAS,L 106-131,240,36,83,.434,25,50,.500,11,33,.333,23,29,.793,106,51,89,.573,38,61,.623,13,28,.464,16,20,.800,131
1555,WAS,2022-02-02,106,@,PHI,W 106-103,240,41,90,.456,32,68,.471,9,22,.409,15,19,.789,106,41,91,.451,30,64,.469,11,27,.407,10,13,.769,103
1556,MIA,2022-02-01,106,@,TOR,L 106-110,240,38,78,.487,30,48,.625,8,30,.267,22,25,.880,106,39,81,.481,27,55,.491,12,26,.462,20,29,.690,110
1557,TOR,2022-01-31,106,@,ATL,W 106-100,240,38,89,.427,20,53,.377,18,36,.500,12,17,.706,106,37,81,.457,25,49,.510,12,32,.375,14,16,.875,100
1558,UTA,2022-01-30,106,@,MIN,L 106-126,240,38,81,.469,23,41,.561,15,40,.375,15,21,.714,106,49,89,.551,36,58,.621,13,31,.419,15,18,.833,126
1559,BRK,2022-01-29,106,@,GSW,L 106-110,240,39,98,.398,28,70,.400,11,28,.393,17,21,.810,106,40,98,.408,26,53,.491,14,45,.311,16,18,.889,110
1560,LAL,2022-01-25,106,@,BRK,W 106-96,240,42,89,.472,30,51,.588,12,38,.316,10,10,1.000,106,37,88,.420,30,61,.492,7,27,.259,15,22,.682,96
1561,CHI,2022-01-17,106,@,MEM,L 106-119,240,40,92,.435,27,61,.443,13,31,.419,13,15,.867,106,47,92,.511,37,67,.552,10,25,.400,15,20,.750,119
1562,ORL,2022-01-12,106,@,WAS,L 106-112,240,41,99,.414,30,64,.469,11,35,.314,13,16,.813,106,43,82,.524,33,51,.647,10,31,.323,16,21,.762,112
1563,LAC,2022-01-09,106,,ATL,W 106-93,240,44,92,.478,32,59,.542,12,33,.364,6,7,.857,106,35,78,.449,28,52,.538,7,26,.269,16,19,.842,93
1564,MIL,2022-01-08,106,@,CHO,L 106-114,240,35,90,.389,23,53,.434,12,37,.324,24,26,.923,106,44,99,.444,28,51,.549,16,48,.333,10,17,.588,114
1565,HOU,2022-01-07,106,,DAL,L 106-130,240,37,87,.425,25,44,.568,12,43,.279,20,29,.690,106,49,90,.544,32,52,.615,17,38,.447,15,28,.536,130
1566,PHO,2022-01-06,106,,LAC,W 106-89,240,44,107,.411,34,76,.447,10,31,.323,8,10,.800,106,31,86,.360,25,58,.431,6,28,.214,21,25,.840,89
1567,ORL,2022-01-05,106,,PHI,L 106-116,240,40,90,.444,28,51,.549,12,39,.308,14,20,.700,106,43,85,.506,31,57,.544,12,28,.429,18,24,.750,116
1568,CLE,2022-01-04,106,,MEM,L 106-110,240,40,92,.435,30,58,.517,10,34,.294,16,21,.762,106,42,90,.467,33,63,.524,9,27,.333,17,22,.773,110
1569,MIL,2022-01-03,106,,DET,L 106-115,240,39,92,.424,28,46,.609,11,46,.239,17,22,.773,106,44,91,.484,26,48,.542,18,43,.419,9,14,.643,115
1570,POR,2021-12-31,106,@,LAL,L 106-139,240,36,102,.353,24,60,.400,12,42,.286,22,27,.815,106,47,85,.553,28,44,.636,19,41,.463,26,30,.867,139
1571,IND,2021-12-31,106,,CHI,L 106-108,240,38,91,.418,30,60,.500,8,31,.258,22,29,.759,106,35,86,.407,23,59,.390,12,27,.444,26,30,.867,108
1572,HOU,2021-12-23,106,@,IND,L 106-118,240,35,80,.438,20,43,.465,15,37,.405,21,26,.808,106,46,88,.523,33,50,.660,13,38,.342,13,19,.684,118
1573,HOU,2021-12-22,106,@,MIL,L 106-126,240,36,86,.419,23,41,.561,13,45,.289,21,31,.677,106,45,103,.437,28,57,.491,17,46,.370,19,21,.905,126
1574,CHO,2021-12-19,106,@,PHO,L 106-137,240,36,100,.360,26,55,.473,10,45,.222,24,28,.857,106,54,95,.568,34,54,.630,20,41,.488,9,13,.692,137
1575,LAL,2021-12-12,106,,ORL,W 106-94,240,41,84,.488,28,56,.500,13,28,.464,11,17,.647,106,33,88,.375,20,50,.400,13,38,.342,15,19,.789,94
1576,LAC,2021-12-11,106,,ORL,W 106-104,240,42,92,.457,24,56,.429,18,36,.500,4,6,.667,106,35,80,.438,23,47,.489,12,33,.364,22,24,.917,104
1577,HOU,2021-12-11,106,@,MEM,L 106-113,240,38,77,.494,27,44,.614,11,33,.333,19,29,.655,106,40,80,.500,29,51,.569,11,29,.379,22,36,.611,113
1578,MIN,2021-12-10,106,,CLE,L 106-123,240,36,92,.391,25,53,.472,11,39,.282,23,28,.821,106,46,85,.541,33,52,.635,13,33,.394,18,22,.818,123
1579,IND,2021-12-10,106,,DAL,W 106-93,240,41,87,.471,28,51,.549,13,36,.361,11,12,.917,106,39,84,.464,35,55,.636,4,29,.138,11,12,.917,93
1580,CHO,2021-12-08,106,,PHI,L 106-110,240,39,80,.488,29,51,.569,10,29,.345,18,21,.857,106,36,75,.480,23,41,.561,13,34,.382,25,30,.833,110
1581,DET,2021-11-28,106,@,LAL,L 106-110,240,38,89,.427,25,56,.446,13,33,.394,17,19,.895,106,43,86,.500,34,54,.630,9,32,.281,15,25,.600,110
1582,CHO,2021-11-24,106,@,ORL,W 106-99,240,39,93,.419,27,53,.509,12,40,.300,16,21,.762,106,38,93,.409,23,51,.451,15,42,.357,8,10,.800,99
1583,SAS,2021-11-24,106,,ATL,L 106-124,240,43,100,.430,31,67,.463,12,33,.364,8,10,.800,106,45,88,.511,33,62,.532,12,26,.462,22,24,.917,124
1584,NYK,2021-11-23,106,,LAL,W 106-100,240,37,82,.451,22,48,.458,15,34,.441,17,21,.810,106,34,91,.374,23,55,.418,11,36,.306,21,30,.700,100
1585,NYK,2021-11-20,106,,HOU,W 106-99,240,33,78,.423,15,37,.405,18,41,.439,22,26,.846,106,38,84,.452,28,45,.622,10,39,.256,13,22,.591,99
1586,LAC,2021-11-16,106,,SAS,W 106-92,240,37,85,.435,25,47,.532,12,38,.316,20,22,.909,106,41,95,.432,36,73,.493,5,22,.227,5,7,.714,92
1587,SAS,2021-11-14,106,@,LAL,L 106-114,240,40,90,.444,24,54,.444,16,36,.444,10,15,.667,106,43,83,.518,28,52,.538,15,31,.484,13,17,.765,114
1588,CHO,2021-11-14,106,,GSW,W 106-102,240,42,88,.477,28,52,.538,14,36,.389,8,12,.667,106,38,90,.422,29,51,.569,9,39,.231,17,25,.680,102
1589,CHO,2021-11-07,106,@,LAC,L 106-120,240,41,101,.406,31,68,.456,10,33,.303,14,18,.778,106,41,86,.477,23,38,.605,18,48,.375,20,21,.952,120
1590,IND,2021-11-05,106,@,POR,L 106-110,240,43,88,.489,29,46,.630,14,42,.333,6,10,.600,106,40,82,.488,23,43,.535,17,39,.436,13,15,.867,110
1591,DEN,2021-11-03,106,@,MEM,L 106-108,240,43,91,.473,35,64,.547,8,27,.296,12,13,.923,106,42,81,.519,26,47,.553,16,34,.471,8,14,.571,108
1592,MEM,2021-11-01,106,,DEN,W 106-97,240,44,97,.454,31,63,.492,13,34,.382,5,7,.714,106,39,88,.443,30,50,.600,9,38,.237,10,15,.667,97
1593,DEN,2021-10-29,106,,DAL,W 106-75,240,43,83,.518,32,47,.681,11,36,.306,9,13,.692,106,23,78,.295,15,41,.366,8,37,.216,21,27,.778,75
1594,MIA,2021-10-27,106,@,BRK,W 106-93,240,38,96,.396,30,67,.448,8,29,.276,22,26,.846,106,33,85,.388,19,42,.452,14,43,.326,13,14,.929,93
1595,GSW,2021-10-26,106,@,OKC,W 106-98,240,39,83,.470,25,43,.581,14,40,.350,14,18,.778,106,36,86,.419,24,52,.462,12,34,.353,14,17,.824,98
1596,HOU,2021-10-26,106,@,DAL,L 106-116,240,36,86,.419,20,47,.426,16,39,.410,18,26,.692,106,43,93,.462,31,50,.620,12,43,.279,18,25,.720,116
1597,HOU,2021-10-20,106,@,MIN,L 106-124,240,40,88,.455,29,55,.527,11,33,.333,15,22,.682,106,42,87,.483,26,49,.531,16,38,.421,24,31,.774,124
1598,NYK,2022-04-10,105,,TOR,W 105-94,240,40,87,.460,25,44,.568,15,43,.349,10,12,.833,105,36,92,.391,24,50,.480,12,42,.286,10,11,.909,94
1599,UTA,2022-04-08,105,,PHO,L 105-111,240,35,88,.398,24,50,.480,11,38,.289,24,33,.727,105,46,92,.500,40,73,.548,6,19,.316,13,15,.867,111
1600,HOU,2022-04-05,105,@,BRK,L 105-118,240,40,99,.404,29,56,.518,11,43,.256,14,25,.560,105,39,86,.453,24,49,.490,15,37,.405,25,27,.926,118
1601,MEM,2022-03-18,105,@,ATL,L 105-120,240,40,86,.465,32,64,.500,8,22,.364,17,23,.739,105,45,91,.495,32,63,.508,13,28,.464,17,21,.810,120
1602,MIA,2022-03-15,105,,DET,W 105-98,240,29,72,.403,17,39,.436,12,33,.364,35,39,.897,105,37,80,.463,27,46,.587,10,34,.294,14,22,.636,98
1603,HOU,2022-03-13,105,@,NOP,L 105-130,240,39,77,.506,27,46,.587,12,31,.387,15,25,.600,105,48,93,.516,38,61,.623,10,32,.313,24,34,.706,130
1604,CLE,2022-03-11,105,@,MIA,L 105-117,240,35,79,.443,27,54,.500,8,25,.320,27,29,.931,105,41,86,.477,30,51,.588,11,35,.314,24,27,.889,117
1605,SAS,2022-02-28,105,@,MEM,L 105-118,240,41,99,.414,32,67,.478,9,32,.281,14,19,.737,105,48,89,.539,37,63,.587,11,26,.423,11,19,.579,118
1606,LAC,2022-02-25,105,@,LAL,W 105-102,240,41,83,.494,31,57,.544,10,26,.385,13,19,.684,105,39,93,.419,31,62,.500,8,31,.258,16,21,.762,102
1607,BOS,2022-02-13,105,,ATL,W 105-95,240,36,85,.424,25,47,.532,11,38,.289,22,27,.815,105,34,93,.366,22,55,.400,12,38,.316,15,15,1.000,95
1608,ORL,2022-02-12,105,@,PHO,L 105-132,240,37,87,.425,22,46,.478,15,41,.366,16,24,.667,105,55,105,.524,40,71,.563,15,34,.441,7,10,.700,132
1609,LAC,2022-02-10,105,@,DAL,L 105-112,240,39,81,.481,30,58,.517,9,23,.391,18,25,.720,105,38,78,.487,25,39,.641,13,39,.333,23,27,.852,112
1610,CLE,2022-02-09,105,,SAS,W 105-92,240,39,82,.476,30,61,.492,9,21,.429,18,24,.750,105,38,99,.384,30,66,.455,8,33,.242,8,11,.727,92
1611,LAL,2022-02-09,105,@,POR,L 105-107,240,41,74,.554,24,37,.649,17,37,.459,6,13,.462,105,42,89,.472,32,57,.561,10,32,.313,13,16,.813,107
1612,DET,2022-02-06,105,@,MIN,L 105-118,240,40,95,.421,28,63,.444,12,32,.375,13,19,.684,105,42,91,.462,25,55,.455,17,36,.472,17,21,.810,118
1613,DEN,2022-02-04,105,,NOP,L 105-113,240,35,78,.449,16,37,.432,19,41,.463,16,17,.941,105,42,75,.560,34,50,.680,8,25,.320,21,23,.913,113
1614,CLE,2022-01-30,105,@,DET,L 105-115,240,38,82,.463,25,48,.521,13,34,.382,16,25,.640,105,42,91,.462,32,65,.492,10,26,.385,21,25,.840,115
1615,IND,2022-01-29,105,@,DAL,L 105-132,240,40,91,.440,31,58,.534,9,33,.273,16,23,.696,105,51,96,.531,35,62,.565,16,34,.471,14,22,.636,132
1616,NOP,2022-01-28,105,,DEN,L 105-116,240,35,90,.389,30,56,.536,5,34,.147,30,33,.909,105,41,82,.500,29,49,.592,12,33,.364,22,25,.880,116
1617,PHI,2022-01-27,105,,LAL,W 105-87,240,41,82,.500,28,47,.596,13,35,.371,10,17,.588,105,36,88,.409,30,59,.508,6,29,.207,9,9,1.000,87
1618,TOR,2022-01-26,105,@,CHI,L 105-111,240,38,79,.481,26,48,.542,12,31,.387,17,28,.607,105,46,84,.548,39,58,.672,7,26,.269,12,16,.750,111
1619,PHO,2022-01-26,105,@,UTA,W 105-97,240,40,82,.488,33,64,.516,7,18,.389,18,27,.667,105,34,79,.430,22,49,.449,12,30,.400,17,23,.739,97
1620,DET,2022-01-25,105,,DEN,L 105-110,240,41,97,.423,29,61,.475,12,36,.333,11,14,.786,105,36,84,.429,25,52,.481,11,32,.344,27,31,.871,110
1621,TOR,2022-01-23,105,,POR,L 105-114,240,39,98,.398,21,44,.477,18,54,.333,9,14,.643,105,45,85,.529,27,53,.509,18,32,.563,6,13,.462,114
1622,GSW,2022-01-21,105,,HOU,W 105-103,240,39,81,.481,29,51,.569,10,30,.333,17,22,.773,105,38,89,.427,28,54,.519,10,35,.286,17,20,.850,103
1623,BOS,2022-01-21,105,,POR,L 105-109,240,37,82,.451,26,45,.578,11,37,.297,20,23,.870,105,36,76,.474,20,43,.465,16,33,.485,21,30,.700,109
1624,WAS,2022-01-21,105,,TOR,L 105-109,240,43,85,.506,32,52,.615,11,33,.333,8,10,.800,105,42,90,.467,31,60,.517,11,30,.367,14,17,.824,109
1625,ORL,2022-01-21,105,,LAL,L 105-116,240,36,81,.444,25,41,.610,11,40,.275,22,29,.759,105,42,85,.494,29,55,.527,13,30,.433,19,23,.826,116
1626,NOP,2022-01-15,105,@,BRK,L 105-120,240,40,87,.460,31,56,.554,9,31,.290,16,24,.667,105,46,84,.548,34,57,.596,12,27,.444,16,17,.941,120
1627,TOR,2022-01-09,105,,NOP,W 105-101,240,36,85,.424,22,51,.431,14,34,.412,19,20,.950,105,34,75,.453,22,42,.524,12,33,.364,21,25,.840,101
1628,OKC,2022-01-07,105,,MIN,L 105-135,240,36,89,.404,21,45,.467,15,44,.341,18,23,.783,105,50,90,.556,33,49,.673,17,41,.415,18,25,.720,135
1629,BOS,2022-01-06,105,@,NYK,L 105-108,240,38,80,.475,21,35,.600,17,45,.378,12,13,.923,105,40,90,.444,22,54,.407,18,36,.500,10,15,.667,108
1630,NYK,2022-01-02,105,@,TOR,L 105-120,240,35,78,.449,23,42,.548,12,36,.333,23,28,.821,105,41,86,.477,28,52,.538,13,34,.382,25,30,.833,120
1631,SAS,2021-12-31,105,@,MEM,L 105-118,240,39,90,.433,27,55,.491,12,35,.343,15,24,.625,105,49,102,.480,39,76,.513,10,26,.385,10,16,.625,118
1632,POR,2021-12-29,105,,UTA,L 105-120,240,37,88,.420,23,48,.479,14,40,.350,17,24,.708,105,46,87,.529,38,58,.655,8,29,.276,20,32,.625,120
1633,IND,2021-12-26,105,@,CHI,L 105-113,240,41,94,.436,33,64,.516,8,30,.267,15,21,.714,105,43,76,.566,32,53,.604,11,23,.478,16,22,.727,113
1634,LAC,2021-12-22,105,@,SAC,W 105-89,240,42,82,.512,35,58,.603,7,24,.292,14,16,.875,105,34,85,.400,22,47,.468,12,38,.316,9,12,.750,89
1635,NYK,2021-12-21,105,,DET,W 105-91,240,40,90,.444,29,57,.509,11,33,.333,14,19,.737,105,34,94,.362,26,61,.426,8,33,.242,15,19,.789,91
1636,POR,2021-12-19,105,@,MEM,W 105-100,240,35,74,.473,24,42,.571,11,32,.344,24,28,.857,105,35,91,.385,26,57,.456,9,34,.265,21,25,.840,100
1637,DAL,2021-12-19,105,@,MIN,L 105-111,240,36,82,.439,24,41,.585,12,41,.293,21,22,.955,105,36,77,.468,21,43,.488,15,34,.441,24,31,.774,111
1638,SAC,2021-12-17,105,,MEM,L 105-124,240,36,88,.409,23,53,.434,13,35,.371,20,26,.769,105,45,97,.464,32,73,.438,13,24,.542,21,27,.778,124
1639,ORL,2021-12-17,105,,MIA,L 105-115,240,43,89,.483,32,57,.561,11,32,.344,8,10,.800,105,41,82,.500,22,47,.468,19,35,.543,14,19,.737,115
1640,PHI,2021-12-16,105,@,BRK,L 105-114,240,39,89,.438,29,55,.527,10,34,.294,17,20,.850,105,44,89,.494,33,66,.500,11,23,.478,15,16,.938,114
1641,WAS,2021-12-15,105,@,SAC,L 105-119,240,42,89,.472,37,65,.569,5,24,.208,16,21,.762,105,45,82,.549,37,56,.661,8,26,.308,21,29,.724,119
1642,GSW,2021-12-14,105,@,NYK,W 105-96,240,35,77,.455,20,37,.541,15,40,.375,20,27,.741,105,30,83,.361,14,41,.341,16,42,.381,20,22,.909,96
1643,CLE,2021-12-13,105,,MIA,W 105-94,240,36,81,.444,20,45,.444,16,36,.444,17,18,.944,105,38,85,.447,25,45,.556,13,40,.325,5,9,.556,94
1644,ATL,2021-12-10,105,,BRK,L 105-113,240,37,94,.394,26,60,.433,11,34,.324,20,24,.833,105,46,93,.495,40,70,.571,6,23,.261,15,16,.938,113
1645,MEM,2021-12-06,105,@,MIA,W 105-90,240,38,89,.427,25,56,.446,13,33,.394,16,21,.762,105,35,76,.461,29,54,.537,6,22,.273,14,17,.824,90
1646,MIN,2021-12-03,105,@,BRK,L 105-110,240,36,93,.387,23,51,.451,13,42,.310,20,24,.833,105,36,76,.474,30,53,.566,6,23,.261,32,41,.780,110
1647,GSW,2021-11-28,105,@,LAC,W 105-90,240,38,86,.442,21,46,.457,17,40,.425,12,22,.545,105,32,80,.400,23,52,.442,9,28,.321,17,25,.680,90
1648,NOP,2021-11-27,105,@,UTA,L 105-127,240,40,93,.430,32,58,.552,8,35,.229,17,21,.810,105,45,80,.563,25,45,.556,20,35,.571,17,22,.773,127
1649,CLE,2021-11-27,105,,ORL,W 105-92,240,41,90,.456,27,51,.529,14,39,.359,9,12,.750,105,35,88,.398,27,56,.482,8,32,.250,14,23,.609,92
1650,OKC,2021-11-20,105,@,BOS,L 105-111,240,39,96,.406,21,54,.389,18,42,.429,9,16,.563,105,41,88,.466,24,49,.490,17,39,.436,12,14,.857,111
1651,CHO,2021-11-20,105,@,ATL,L 105-115,240,43,102,.422,33,62,.532,10,40,.250,9,15,.600,105,43,82,.524,31,48,.646,12,34,.353,17,21,.810,115
1652,SAC,2021-11-20,105,,UTA,L 105-123,240,41,91,.451,31,60,.517,10,31,.323,13,21,.619,105,46,91,.505,29,52,.558,17,39,.436,14,17,.824,123
1653,GSW,2021-11-19,105,@,DET,W 105-102,240,38,80,.475,26,50,.520,12,30,.400,17,21,.810,105,32,80,.400,18,38,.474,14,42,.333,24,30,.800,102
1654,PHO,2021-11-17,105,,DAL,W 105-98,240,41,93,.441,28,54,.519,13,39,.333,10,14,.714,105,38,91,.418,22,59,.373,16,32,.500,6,6,1.000,98
1655,WAS,2021-11-15,105,,NOP,W 105-100,240,39,84,.464,29,56,.518,10,28,.357,17,25,.680,105,30,74,.405,19,53,.358,11,21,.524,29,34,.853,100
1656,UTA,2021-11-13,105,,MIA,L 105-111,240,35,85,.412,18,32,.563,17,53,.321,18,25,.720,105,42,85,.494,29,52,.558,13,33,.394,14,16,.875,111
1657,DEN,2021-11-12,105,,ATL,W 105-96,240,40,90,.444,30,55,.545,10,35,.286,15,20,.750,105,38,93,.409,33,65,.508,5,28,.179,15,21,.714,96
1658,OKC,2021-11-12,105,,SAC,W 105-103,240,42,99,.424,32,69,.464,10,30,.333,11,15,.733,105,38,95,.400,24,54,.444,14,41,.341,13,17,.765,103
1659,CHI,2021-11-06,105,,PHI,L 105-114,240,37,92,.402,30,63,.476,7,29,.241,24,30,.800,105,43,81,.531,30,55,.545,13,26,.500,15,19,.789,114
1660,POR,2021-11-06,105,,LAL,W 105-90,240,36,95,.379,21,40,.525,15,55,.273,18,24,.750,105,31,90,.344,22,58,.379,9,32,.281,19,24,.792,90
1661,DAL,2021-10-31,105,,SAC,W 105-99,240,40,90,.444,28,53,.528,12,37,.324,13,20,.650,105,38,96,.396,31,60,.517,7,36,.194,16,20,.800,99
1662,BRK,2021-10-29,105,,IND,W 105-98,240,34,76,.447,28,50,.560,6,26,.231,31,41,.756,105,37,93,.398,29,64,.453,8,29,.276,16,23,.696,98
1663,PHO,2021-10-23,105,@,POR,L 105-134,240,43,89,.483,34,61,.557,9,28,.321,10,15,.667,105,51,94,.543,30,44,.682,21,50,.420,11,17,.647,134
1664,LAL,2021-10-22,105,,PHO,L 105-115,240,34,86,.395,19,52,.365,15,34,.441,22,29,.759,105,42,86,.488,32,54,.593,10,32,.313,21,28,.750,115
1665,CHI,2022-03-28,104,@,NYK,L 104-109,240,34,79,.430,28,56,.500,6,23,.261,30,33,.909,104,38,89,.427,26,54,.481,12,35,.343,21,35,.600,109
1666,PHI,2022-03-27,104,@,PHO,L 104-114,240,37,89,.416,27,53,.509,10,36,.278,20,26,.769,104,45,87,.517,32,60,.533,13,27,.481,11,17,.647,114
1667,NYK,2022-03-27,104,@,DET,W 104-102,240,34,85,.400,21,44,.477,13,41,.317,23,29,.793,104,39,85,.459,31,56,.554,8,29,.276,16,18,.889,102
1668,CLE,2022-03-24,104,@,TOR,L 104-117,240,37,79,.468,25,49,.510,12,30,.400,18,22,.818,104,42,89,.472,26,52,.500,16,37,.432,17,19,.895,117
1669,MIA,2022-03-23,104,,GSW,L 104-118,240,37,85,.435,23,49,.469,14,36,.389,16,21,.762,104,40,77,.519,25,41,.610,15,36,.417,23,27,.852,118
1670,DEN,2022-03-20,104,,BOS,L 104-124,240,35,87,.402,21,48,.438,14,39,.359,20,25,.800,104,47,82,.573,28,42,.667,19,40,.475,11,11,1.000,124
1671,LAL,2022-03-16,104,@,MIN,L 104-124,240,39,93,.419,29,49,.592,10,44,.227,16,23,.696,104,40,90,.444,23,48,.479,17,42,.405,27,31,.871,124
1672,MIA,2022-03-12,104,,MIN,L 104-113,240,35,88,.398,20,43,.465,15,45,.333,19,25,.760,104,35,83,.422,20,41,.488,15,42,.357,28,32,.875,113
1673,SAS,2022-03-11,104,,UTA,W 104-102,240,34,85,.400,28,56,.500,6,29,.207,30,43,.698,104,37,92,.402,24,52,.462,13,40,.325,15,23,.652,102
1674,SAS,2022-03-09,104,,TOR,L 104-119,240,38,84,.452,29,52,.558,9,32,.281,19,20,.950,104,41,85,.482,30,55,.545,11,30,.367,26,28,.929,119
1675,CLE,2022-03-06,104,,TOR,W 104-96,240,39,85,.459,28,49,.571,11,36,.306,15,23,.652,104,37,94,.394,31,70,.443,6,24,.250,16,26,.615,96
1676,LAL,2022-03-01,104,,DAL,L 104-109,240,37,82,.451,23,48,.479,14,34,.412,16,20,.800,104,41,82,.500,31,47,.660,10,35,.286,17,27,.630,109
1677,DET,2022-02-26,104,,BOS,L 104-113,240,39,87,.448,32,60,.533,7,27,.259,19,22,.864,104,42,88,.477,32,62,.516,10,26,.385,19,21,.905,113
1678,OKC,2022-02-24,104,,PHO,L 104-124,240,44,93,.473,38,62,.613,6,31,.194,10,11,.909,104,46,86,.535,33,52,.635,13,34,.382,19,21,.905,124
1679,GSW,2022-02-14,104,@,LAC,L 104-119,240,39,86,.453,23,45,.511,16,41,.390,10,13,.769,104,48,85,.565,33,51,.647,15,34,.441,8,15,.533,119
1680,NYK,2022-02-07,104,@,UTA,L 104-113,240,36,95,.379,28,62,.452,8,33,.242,24,35,.686,104,39,93,.419,27,45,.600,12,48,.250,23,27,.852,113
1681,BRK,2022-02-06,104,@,DEN,L 104-124,240,36,87,.414,20,46,.435,16,41,.390,16,22,.727,104,49,94,.521,39,62,.629,10,32,.313,16,21,.762,124
1682,MIA,2022-02-05,104,@,CHO,W 104-86,240,38,91,.418,27,59,.458,11,32,.344,17,18,.944,104,33,86,.384,23,50,.460,10,36,.278,10,16,.625,86
1683,DEN,2022-02-02,104,@,UTA,L 104-108,240,42,79,.532,31,51,.608,11,28,.393,9,12,.750,104,42,86,.488,35,57,.614,7,29,.241,17,22,.773,108
1684,CLE,2022-02-02,104,@,HOU,L 104-115,240,41,80,.513,34,59,.576,7,21,.333,15,27,.556,104,39,82,.476,25,42,.595,14,40,.350,23,33,.697,115
1685,SAC,2022-01-26,104,@,ATL,L 104-121,240,39,93,.419,27,53,.509,12,40,.300,14,19,.737,104,48,90,.533,36,54,.667,12,36,.333,13,17,.765,121
1686,HOU,2022-01-25,104,,SAS,L 104-134,240,39,95,.411,30,61,.492,9,34,.265,17,25,.680,104,58,101,.574,46,69,.667,12,32,.375,6,6,1.000,134
1687,DAL,2022-01-23,104,,MEM,W 104-91,240,36,74,.486,27,44,.614,9,30,.300,23,31,.742,104,37,99,.374,33,75,.440,4,24,.167,13,19,.684,91
1688,LAL,2022-01-19,104,,IND,L 104-111,240,40,90,.444,29,56,.518,11,34,.324,13,18,.722,104,44,90,.489,33,60,.550,11,30,.367,12,15,.800,111
1689,MIA,2022-01-19,104,,POR,W 104-92,240,37,80,.463,25,45,.556,12,35,.343,18,25,.720,104,33,81,.407,19,35,.543,14,46,.304,12,16,.750,92
1690,CLE,2022-01-19,104,@,CHI,L 104-117,240,40,77,.519,31,50,.620,9,27,.333,15,22,.682,104,47,86,.547,37,64,.578,10,22,.455,13,18,.722,117
1691,BOS,2022-01-17,104,,NOP,W 104-92,240,38,80,.475,28,48,.583,10,32,.313,18,20,.900,104,36,87,.414,27,57,.474,9,30,.300,11,18,.611,92
1692,MIA,2022-01-17,104,,TOR,W 104-99,240,38,83,.458,29,59,.492,9,24,.375,19,22,.864,104,37,90,.411,24,54,.444,13,36,.361,12,17,.706,99
1693,DAL,2022-01-17,104,,OKC,W 104-102,240,35,88,.398,23,51,.451,12,37,.324,22,28,.786,104,36,83,.434,25,48,.521,11,35,.314,19,24,.792,102
1694,NYK,2022-01-04,104,,IND,W 104-94,240,39,80,.488,33,52,.635,6,28,.214,20,28,.714,104,32,76,.421,23,38,.605,9,38,.237,21,32,.656,94
1695,SAS,2022-01-04,104,@,TOR,L 104-129,240,41,95,.432,32,60,.533,9,35,.257,13,19,.684,104,45,96,.469,27,52,.519,18,44,.409,21,29,.724,129
1696,BRK,2022-01-03,104,,MEM,L 104-118,240,37,82,.451,28,51,.549,9,31,.290,21,26,.808,104,48,102,.471,38,67,.567,10,35,.286,12,21,.571,118
1697,LAC,2022-01-03,104,,MIN,L 104-122,240,39,78,.500,28,46,.609,11,32,.344,15,17,.882,104,49,93,.527,33,48,.688,16,45,.356,8,9,.889,122
1698,NOP,2022-01-03,104,,UTA,L 104-115,240,39,97,.402,27,51,.529,12,46,.261,14,22,.636,104,41,85,.482,22,46,.478,19,39,.487,14,17,.824,115
1699,IND,2022-01-02,104,@,CLE,L 104-108,240,37,83,.446,18,37,.486,19,46,.413,11,14,.786,104,41,88,.466,35,62,.565,6,26,.231,20,28,.714,108
1700,MEM,2021-12-29,104,,LAL,W 104-99,240,35,85,.412,25,55,.455,10,30,.333,24,29,.828,104,39,86,.453,24,45,.533,15,41,.366,6,8,.750,99
1701,CLE,2021-12-28,104,@,NOP,L 104-108,240,37,88,.420,23,47,.489,14,41,.341,16,19,.842,104,36,80,.450,20,44,.455,16,36,.444,20,26,.769,108
1702,SAS,2021-12-27,104,,UTA,L 104-110,240,45,100,.450,35,70,.500,10,30,.333,4,9,.444,104,39,86,.453,30,55,.545,9,31,.290,23,30,.767,110
1703,MEM,2021-12-23,104,@,GSW,L 104-113,240,38,90,.422,30,64,.469,8,26,.308,20,24,.833,104,40,82,.488,21,42,.500,19,40,.475,14,18,.778,113
1704,ORL,2021-12-23,104,,NOP,L 104-110,240,38,88,.432,29,56,.518,9,32,.281,19,21,.905,104,37,86,.430,24,56,.429,13,30,.433,23,26,.885,110
1705,ORL,2021-12-22,104,@,ATL,W 104-98,240,38,85,.447,27,48,.563,11,37,.297,17,23,.739,104,32,80,.400,20,49,.408,12,31,.387,22,29,.759,98
1706,OKC,2021-12-18,104,,LAC,W 104-103,240,43,92,.467,31,61,.508,12,31,.387,6,10,.600,104,37,83,.446,21,44,.477,16,39,.410,13,19,.684,103
1707,DAL,2021-12-15,104,,LAL,L 104-107 (OT),265,39,98,.398,27,54,.500,12,44,.273,14,17,.824,104,39,90,.433,24,51,.471,15,39,.385,14,18,.778,107
1708,DET,2021-12-12,104,,BRK,L 104-116,240,39,92,.424,25,55,.455,14,37,.378,12,18,.667,104,41,87,.471,30,59,.508,11,28,.393,23,25,.920,116
1709,ORL,2021-12-11,104,@,LAC,L 104-106,240,35,80,.438,23,47,.489,12,33,.364,22,24,.917,104,42,92,.457,24,56,.429,18,36,.500,4,6,.667,106
1710,BRK,2021-12-08,104,@,HOU,L 104-114,240,35,89,.393,27,56,.482,8,33,.242,26,31,.839,104,40,81,.494,26,40,.650,14,41,.341,20,29,.690,114
1711,GSW,2021-12-08,104,,POR,W 104-94,240,33,83,.398,19,37,.514,14,46,.304,24,31,.774,104,33,80,.413,25,50,.500,8,30,.267,20,28,.714,94
1712,MIL,2021-12-08,104,@,MIA,L 104-113,240,36,85,.424,24,46,.522,12,39,.308,20,27,.741,104,40,77,.519,18,30,.600,22,47,.468,11,12,.917,113
1713,DAL,2021-12-08,104,@,MEM,W 104-96,240,37,77,.481,25,44,.568,12,33,.364,18,23,.783,104,36,90,.400,27,59,.458,9,31,.290,15,25,.600,96
1714,MIN,2021-12-08,104,,UTA,L 104-136,240,38,95,.400,21,48,.438,17,47,.362,11,17,.647,104,50,88,.568,25,34,.735,25,54,.463,11,15,.733,136
1715,CLE,2021-12-06,104,@,MIL,L 104-112,240,35,90,.389,20,44,.455,15,46,.326,19,20,.950,104,40,86,.465,27,54,.500,13,32,.406,19,24,.792,112
1716,SAS,2021-12-06,104,@,PHO,L 104-108,240,40,93,.430,29,64,.453,11,29,.379,13,19,.684,104,43,94,.457,33,65,.508,10,29,.345,12,18,.667,108
1717,SAC,2021-12-04,104,,LAC,W 104-99,240,36,86,.419,24,52,.462,12,34,.353,20,25,.800,104,34,89,.382,21,55,.382,13,34,.382,18,27,.667,99
1718,IND,2021-12-03,104,,MIA,L 104-113,240,35,80,.438,26,44,.591,9,36,.250,25,33,.758,104,43,81,.531,27,47,.574,16,34,.471,11,13,.846,113
1719,PHO,2021-11-30,104,,GSW,W 104-96,240,43,87,.494,31,57,.544,12,30,.400,6,11,.545,104,36,86,.419,22,46,.478,14,40,.350,10,14,.714,96
1720,LAC,2021-11-29,104,,NOP,L 104-123,240,37,72,.514,23,36,.639,14,36,.389,16,21,.762,104,48,94,.511,34,59,.576,14,35,.400,13,16,.813,123
1721,CHI,2021-11-27,104,,MIA,L 104-107,240,38,81,.469,27,42,.643,11,39,.282,17,21,.810,104,37,86,.430,23,46,.500,14,40,.350,19,22,.864,107
1722,BOS,2021-11-24,104,,BRK,L 104-123,240,34,91,.374,23,43,.535,11,48,.229,25,28,.893,104,43,85,.506,29,50,.580,14,35,.400,23,30,.767,123
1723,OKC,2021-11-24,104,,UTA,L 104-110,240,37,82,.451,22,46,.478,15,36,.417,15,22,.682,104,39,86,.453,24,39,.615,15,47,.319,17,20,.850,110
1724,LAC,2021-11-23,104,,DAL,L 104-112 (OT),265,35,85,.412,25,53,.472,10,32,.313,24,29,.828,104,39,89,.438,27,50,.540,12,39,.308,22,27,.815,112
1725,TOR,2021-11-21,104,@,GSW,L 104-119,240,39,99,.394,24,62,.387,15,37,.405,11,20,.550,104,39,79,.494,17,34,.500,22,45,.489,19,24,.792,119
1726,DAL,2021-11-19,104,@,PHO,L 104-112,240,37,90,.411,25,50,.500,12,40,.300,18,23,.783,104,44,85,.518,30,56,.536,14,29,.483,10,14,.714,112
1727,GSW,2021-11-18,104,@,CLE,W 104-89,240,41,83,.494,26,40,.650,15,43,.349,7,8,.875,104,34,80,.425,22,41,.537,12,39,.308,9,16,.563,89
1728,ORL,2021-11-17,104,@,NYK,W 104-98,240,39,96,.406,28,58,.483,11,38,.289,15,18,.833,104,37,88,.420,21,39,.538,16,49,.327,8,12,.667,98
1729,WAS,2021-11-13,104,@,ORL,W 104-92,240,42,84,.500,30,49,.612,12,35,.343,8,10,.800,104,31,92,.337,18,52,.346,13,40,.325,17,20,.850,92
1730,CHO,2021-11-12,104,,NYK,W 104-96,240,39,90,.433,29,54,.537,10,36,.278,16,24,.667,104,36,93,.387,23,58,.397,13,35,.371,11,18,.611,96
1731,POR,2021-11-12,104,@,HOU,W 104-92,240,34,87,.391,23,51,.451,11,36,.306,25,31,.806,104,34,85,.400,27,53,.509,7,32,.219,17,27,.630,92
1732,BOS,2021-11-10,104,,TOR,W 104-88,240,42,94,.447,32,65,.492,10,29,.345,10,15,.667,104,33,77,.429,27,52,.519,6,25,.240,16,19,.842,88
1733,HOU,2021-11-10,104,,DET,L 104-112,240,35,82,.427,23,48,.479,12,34,.353,22,34,.647,104,42,97,.433,26,49,.531,16,48,.333,12,18,.667,112
1734,SAC,2021-11-08,104,,PHO,L 104-109,240,37,82,.451,27,58,.466,10,24,.417,20,26,.769,104,44,93,.473,32,63,.508,12,30,.400,9,11,.818,109
1735,BOS,2021-11-06,104,@,DAL,L 104-107,240,42,86,.488,33,55,.600,9,31,.290,11,16,.688,104,41,78,.526,28,39,.718,13,39,.333,12,14,.857,107
1736,LAC,2021-11-05,104,@,MIN,W 104-84,240,36,88,.409,30,60,.500,6,28,.214,26,32,.813,104,31,89,.348,14,37,.378,17,52,.327,5,7,.714,84
1737,LAL,2021-11-04,104,,OKC,L 104-107,240,39,94,.415,27,61,.443,12,33,.364,14,17,.824,104,37,87,.425,22,46,.478,15,41,.366,18,26,.692,107
1738,POR,2021-11-03,104,@,CLE,L 104-107,240,40,90,.444,27,53,.509,13,37,.351,11,17,.647,104,39,74,.527,24,44,.545,15,30,.500,14,18,.778,107
1739,NYK,2021-11-01,104,,TOR,L 104-113,240,35,76,.461,19,38,.500,16,38,.421,18,24,.750,104,43,99,.434,29,57,.509,14,42,.333,13,14,.929,113
1740,DAL,2021-10-28,104,,SAS,W 104-99,240,41,89,.461,23,44,.523,18,45,.400,4,13,.308,104,39,88,.443,27,58,.466,12,30,.400,9,15,.600,99
1741,NYK,2021-10-28,104,@,CHI,W 104-103,240,39,85,.459,28,56,.500,11,29,.379,15,20,.750,104,36,84,.429,25,52,.481,11,32,.344,20,22,.909,103
1742,MEM,2021-10-28,104,@,GSW,W 104-101 (OT),265,39,97,.402,27,49,.551,12,48,.250,14,14,1.000,104,39,90,.433,25,50,.500,14,40,.350,9,12,.750,101
1743,DET,2021-10-25,104,@,ATL,L 104-122,240,40,91,.440,31,58,.534,9,33,.273,15,18,.833,104,46,90,.511,34,58,.586,12,32,.375,18,21,.857,122
1744,BRK,2021-10-25,104,,WAS,W 104-90,240,40,94,.426,30,59,.508,10,35,.286,14,17,.824,104,33,95,.347,24,56,.429,9,39,.231,15,20,.750,90
1745,NYK,2021-10-24,104,,ORL,L 104-110,240,37,100,.370,24,52,.462,13,48,.271,17,25,.680,104,36,88,.409,24,45,.533,12,43,.279,26,34,.765,110
1746,BRK,2021-10-19,104,@,MIL,L 104-127,240,37,84,.440,20,52,.385,17,32,.531,13,23,.565,104,48,105,.457,31,60,.517,17,45,.378,14,18,.778,127
1747,WAS,2022-04-06,103,@,ATL,L 103-118,240,42,86,.488,32,51,.627,10,35,.286,9,11,.818,103,43,92,.467,27,53,.509,16,39,.410,16,19,.842,118
1748,DAL,2022-04-01,103,@,WAS,L 103-135,240,34,78,.436,23,40,.575,11,38,.289,24,26,.923,103,49,90,.544,32,57,.561,17,33,.515,20,22,.909,135
1749,GSW,2022-03-30,103,,PHO,L 103-107,240,35,83,.422,22,45,.489,13,38,.342,20,25,.800,103,38,92,.413,31,64,.484,7,28,.250,24,30,.800,107
1750,NOP,2022-03-26,103,,SAS,L 103-107,240,40,90,.444,30,58,.517,10,32,.313,13,19,.684,103,39,92,.424,32,66,.485,7,26,.269,22,25,.880,107
1751,MIA,2022-03-25,103,,NYK,L 103-111,240,35,70,.500,23,37,.622,12,33,.364,21,25,.840,103,36,82,.439,19,32,.594,17,50,.340,22,28,.786,111
1752,IND,2022-03-24,103,@,MEM,L 103-133,240,39,92,.424,30,59,.508,9,33,.273,16,23,.696,103,50,93,.538,29,51,.569,21,42,.500,12,17,.706,133
1753,NOP,2022-03-21,103,@,CHO,L 103-106,240,40,90,.444,31,66,.470,9,24,.375,14,16,.875,103,40,79,.506,27,42,.643,13,37,.351,13,15,.867,106
1754,TOR,2022-03-16,103,@,LAC,W 103-100,240,38,83,.458,27,51,.529,11,32,.344,16,21,.762,103,38,78,.487,27,48,.563,11,30,.367,13,15,.867,100
1755,LAL,2022-03-14,103,,TOR,L 103-114,240,34,87,.391,21,45,.467,13,42,.310,22,29,.759,103,39,96,.406,29,59,.492,10,37,.270,26,36,.722,114
1756,CHI,2022-03-14,103,@,SAC,L 103-112,240,36,88,.409,26,54,.481,10,34,.294,21,22,.955,103,39,82,.476,29,57,.509,10,25,.400,24,26,.923,112
1757,DET,2022-03-11,103,@,BOS,L 103-114,240,35,83,.422,25,49,.510,10,34,.294,23,24,.958,103,42,90,.467,36,58,.621,6,32,.188,24,30,.800,114
1758,UTA,2022-03-07,103,@,DAL,L 103-111,240,36,83,.434,24,52,.462,12,31,.387,19,24,.792,103,39,88,.443,22,42,.524,17,46,.370,16,20,.800,111
1759,OKC,2022-03-06,103,,UTA,L 103-116,240,39,92,.424,31,52,.596,8,40,.200,17,19,.895,103,40,89,.449,17,37,.459,23,52,.442,13,17,.765,116
1760,ORL,2022-03-04,103,@,TOR,W 103-97,240,36,95,.379,25,58,.431,11,37,.297,20,21,.952,103,37,93,.398,25,56,.446,12,37,.324,11,17,.647,97
1761,IND,2022-02-28,103,@,ORL,L 103-119,240,35,72,.486,20,36,.556,15,36,.417,18,25,.720,103,45,96,.469,33,59,.559,12,37,.324,17,22,.773,119
1762,CLE,2022-02-24,103,@,DET,L 103-106,240,34,77,.442,22,42,.524,12,35,.343,23,34,.676,103,35,86,.407,24,52,.462,11,34,.324,25,28,.893,106
1763,BRK,2022-02-17,103,,WAS,L 103-117,240,36,89,.404,22,51,.431,14,38,.368,17,24,.708,103,46,83,.554,34,59,.576,12,24,.500,13,16,.813,117
1764,TOR,2022-02-16,103,@,MIN,W 103-91,240,40,88,.455,32,63,.508,8,25,.320,15,19,.789,103,30,77,.390,20,35,.571,10,42,.238,21,29,.724,91
1765,PHO,2022-02-15,103,,LAC,W 103-96,240,44,90,.489,36,65,.554,8,25,.320,7,10,.700,103,40,97,.412,30,62,.484,10,35,.286,6,9,.667,96
1766,WAS,2022-02-14,103,,DET,W 103-94,240,40,85,.471,31,56,.554,9,29,.310,14,18,.778,103,32,85,.376,24,62,.387,8,23,.348,22,27,.815,94
1767,NYK,2022-02-12,103,@,POR,L 103-112,240,31,81,.383,19,42,.452,12,39,.308,29,34,.853,103,40,84,.476,25,44,.568,15,40,.375,17,20,.850,112
1768,PHI,2022-02-12,103,,CLE,W 103-93,240,38,79,.481,28,57,.491,10,22,.455,17,21,.810,103,36,77,.468,28,53,.528,8,24,.333,13,15,.867,93
1769,DAL,2022-02-06,103,,ATL,W 103-94,240,38,88,.432,22,52,.423,16,36,.444,11,13,.846,103,37,95,.389,32,70,.457,5,25,.200,15,16,.938,94
1770,OKC,2022-02-05,103,@,SAC,L 103-113,240,42,87,.483,33,57,.579,9,30,.300,10,16,.625,103,43,83,.518,31,51,.608,12,32,.375,15,22,.682,113
1771,PHI,2022-02-02,103,,WAS,L 103-106,240,41,91,.451,30,64,.469,11,27,.407,10,13,.769,103,41,90,.456,32,68,.471,9,22,.409,15,19,.789,106
1772,PHI,2022-01-29,103,,SAC,W 103-101,240,36,70,.514,24,40,.600,12,30,.400,19,26,.731,103,36,82,.439,24,47,.511,12,35,.343,17,20,.850,101
1773,DET,2022-01-28,103,@,ORL,L 103-119,240,32,87,.368,22,58,.379,10,29,.345,29,37,.784,103,41,83,.494,29,58,.500,12,25,.480,25,26,.962,119
1774,IND,2022-01-22,103,@,PHO,L 103-113,240,37,84,.440,27,55,.491,10,29,.345,19,27,.704,103,47,96,.490,40,71,.563,7,25,.280,12,14,.857,113
1775,HOU,2022-01-21,103,@,GSW,L 103-105,240,38,89,.427,28,54,.519,10,35,.286,17,20,.850,103,39,81,.481,29,51,.569,10,30,.333,17,22,.773,105
1776,TOR,2022-01-15,103,@,MIL,W 103-96,240,40,91,.440,28,56,.500,12,35,.343,11,20,.550,103,26,77,.338,14,38,.368,12,39,.308,32,35,.914,96
1777,DET,2022-01-14,103,,TOR,W 103-87,240,38,81,.469,30,54,.556,8,27,.296,19,23,.826,103,28,87,.322,17,49,.347,11,38,.289,20,26,.769,87
1778,CHO,2022-01-10,103,,MIL,W 103-99,240,38,96,.396,25,52,.481,13,44,.295,14,16,.875,103,37,84,.440,24,41,.585,13,43,.302,12,16,.750,99
1779,POR,2022-01-09,103,,SAC,W 103-88,240,37,88,.420,20,48,.417,17,40,.425,12,15,.800,103,33,85,.388,26,54,.481,7,31,.226,15,21,.714,88
1780,DAL,2022-01-03,103,,DEN,W 103-89,240,35,78,.449,21,41,.512,14,37,.378,19,21,.905,103,31,67,.463,25,42,.595,6,25,.240,21,29,.724,89
1781,MIN,2022-01-02,103,@,LAL,L 103-108,240,41,92,.446,32,54,.593,9,38,.237,12,16,.750,103,36,75,.480,23,34,.676,13,41,.317,23,29,.793,108
1782,BOS,2021-12-27,103,@,MIN,L 103-108,240,33,89,.371,17,42,.405,16,47,.340,21,28,.750,103,40,90,.444,26,56,.464,14,34,.412,14,19,.737,108
1783,DEN,2021-12-26,103,@,LAC,W 103-100,240,39,95,.411,24,54,.444,15,41,.366,10,11,.909,103,40,86,.465,32,60,.533,8,26,.308,12,18,.667,100
1784,BOS,2021-12-20,103,,PHI,L 103-108,240,38,82,.463,31,55,.564,7,27,.259,20,25,.800,103,36,72,.500,26,47,.553,10,25,.400,26,31,.839,108
1785,LAC,2021-12-18,103,@,OKC,L 103-104,240,37,83,.446,21,44,.477,16,39,.410,13,19,.684,103,43,92,.467,31,61,.508,12,31,.387,6,10,.600,104
1786,UTA,2021-12-18,103,,WAS,L 103-109,240,35,81,.432,21,37,.568,14,44,.318,19,30,.633,103,42,94,.447,33,63,.524,9,31,.290,16,20,.800,109
1787,HOU,2021-12-16,103,,NYK,L 103-116,240,34,68,.500,23,36,.639,11,32,.344,24,30,.800,103,39,83,.470,22,47,.468,17,36,.472,21,25,.840,116
1788,POR,2021-12-15,103,,MEM,L 103-113,240,31,82,.378,16,44,.364,15,38,.395,26,28,.929,103,39,82,.476,28,50,.560,11,32,.344,24,30,.800,113
1789,LAC,2021-12-15,103,@,UTA,L 103-124,240,40,85,.471,30,55,.545,10,30,.333,13,20,.650,103,47,89,.528,32,52,.615,15,37,.405,15,20,.750,124
1790,MIL,2021-12-13,103,@,BOS,L 103-117,240,40,90,.444,29,54,.537,11,36,.306,12,15,.800,103,43,86,.500,23,39,.590,20,47,.426,11,13,.846,117
1791,DAL,2021-12-12,103,@,OKC,W 103-84,240,38,90,.422,29,57,.509,9,33,.273,18,23,.783,103,30,80,.375,17,43,.395,13,37,.351,11,16,.688,84
1792,SAC,2021-12-11,103,@,CLE,L 103-117,240,41,93,.441,34,65,.523,7,28,.250,14,22,.636,103,41,88,.466,29,57,.509,12,31,.387,23,28,.821,117
1793,DET,2021-12-06,103,,OKC,L 103-114,240,41,99,.414,25,58,.431,16,41,.390,5,6,.833,103,41,82,.500,32,57,.561,9,25,.360,23,30,.767,114
1794,DET,2021-12-02,103,@,PHO,L 103-114,240,36,80,.450,25,53,.472,11,27,.407,20,26,.769,103,43,79,.544,31,58,.534,12,21,.571,16,23,.696,114
1795,DEN,2021-12-01,103,@,ORL,L 103-108,240,39,80,.488,29,46,.630,10,34,.294,15,21,.714,103,44,81,.543,38,54,.704,6,27,.222,14,19,.737,108
1796,POR,2021-11-26,103,@,GSW,L 103-118,240,36,86,.419,23,48,.479,13,38,.342,18,23,.783,103,47,87,.540,35,50,.700,12,37,.324,12,16,.750,118
1797,WAS,2021-11-22,103,,CHO,L 103-109,240,36,94,.383,27,57,.474,9,37,.243,22,27,.815,103,40,91,.440,25,60,.417,15,31,.484,14,24,.583,109
1798,NYK,2021-11-21,103,@,CHI,L 103-109,240,35,84,.417,28,57,.491,7,27,.259,26,31,.839,103,37,88,.420,26,59,.441,11,29,.379,24,27,.889,109
1799,WAS,2021-11-20,103,,MIA,W 103-100,240,36,74,.486,25,44,.568,11,30,.367,20,23,.870,103,38,81,.469,31,54,.574,7,27,.259,17,20,.850,100
1800,TOR,2021-11-18,103,@,UTA,L 103-119,240,39,94,.415,29,56,.518,10,38,.263,15,17,.882,103,44,80,.550,25,34,.735,19,46,.413,12,13,.923,119
1801,PHI,2021-11-18,103,@,DEN,W 103-89,240,43,85,.506,32,56,.571,11,29,.379,6,12,.500,103,32,89,.360,20,53,.377,12,36,.333,13,16,.813,89
1802,MIA,2021-11-15,103,@,OKC,W 103-90,240,37,82,.451,19,42,.452,18,40,.450,11,13,.846,103,34,83,.410,19,42,.452,15,41,.366,7,10,.700,90
1803,LAL,2021-11-15,103,,CHI,L 103-121,240,36,79,.456,30,47,.638,6,32,.188,25,31,.806,103,49,89,.551,34,55,.618,15,34,.441,8,11,.727,121
1804,SAC,2021-11-12,103,@,OKC,L 103-105,240,38,95,.400,24,54,.444,14,41,.341,13,17,.765,103,42,99,.424,32,69,.464,10,30,.333,11,15,.733,105
1805,NYK,2021-11-08,103,@,PHI,W 103-96,240,40,91,.440,27,51,.529,13,40,.325,10,13,.769,103,35,91,.385,22,51,.431,13,40,.325,13,16,.813,96
1806,TOR,2021-11-07,103,,BRK,L 103-116,240,41,87,.471,34,57,.596,7,30,.233,14,18,.778,103,41,80,.513,24,42,.571,17,38,.447,17,20,.850,116
1807,PHI,2021-11-03,103,,CHI,W 103-98,240,38,77,.494,26,49,.531,12,28,.429,15,21,.714,103,38,82,.463,32,61,.525,6,21,.286,16,18,.889,98
1808,POR,2021-11-01,103,@,PHI,L 103-113,240,40,84,.476,28,50,.560,12,34,.353,11,18,.611,103,43,83,.518,30,47,.638,13,36,.361,14,16,.875,113
1809,MEM,2021-10-30,103,,MIA,L 103-129,240,34,88,.386,18,38,.474,16,50,.320,19,21,.905,103,46,88,.523,25,51,.490,21,37,.568,16,19,.842,129
1810,ORL,2021-10-30,103,@,DET,L 103-110,240,38,87,.437,22,55,.400,16,32,.500,11,15,.733,103,36,89,.404,22,46,.478,14,43,.326,24,30,.800,110
1811,GSW,2021-10-30,103,,OKC,W 103-82,240,39,92,.424,18,38,.474,21,54,.389,4,8,.500,103,29,83,.349,21,44,.477,8,39,.205,16,21,.762,82
1812,CHI,2021-10-28,103,,NYK,L 103-104,240,36,84,.429,25,52,.481,11,32,.344,20,22,.909,103,39,85,.459,28,56,.500,11,29,.379,15,20,.750,104
1813,OKC,2021-10-24,103,,PHI,L 103-115,240,40,84,.476,32,53,.604,8,31,.258,15,19,.789,103,41,88,.466,24,47,.511,17,41,.415,16,20,.800,115
1814,DAL,2021-10-23,103,@,TOR,W 103-95,240,38,91,.418,24,49,.490,14,42,.333,13,18,.722,103,34,85,.400,23,48,.479,11,37,.297,16,23,.696,95
1815,WAS,2022-04-03,102,@,BOS,L 102-144,240,38,82,.463,30,61,.492,8,21,.381,18,20,.900,102,56,91,.615,33,47,.702,23,44,.523,9,13,.692,144
1816,TOR,2022-04-01,102,@,ORL,W 102-89,240,36,86,.419,23,44,.523,13,42,.310,17,20,.850,102,34,79,.430,23,44,.523,11,35,.314,10,11,.909,89
1817,DET,2022-03-31,102,,PHI,W 102-94,240,41,82,.500,31,47,.660,10,35,.286,10,15,.667,102,31,69,.449,24,43,.558,7,26,.269,25,28,.893,94
1818,MIN,2022-03-30,102,@,TOR,L 102-125,240,37,92,.402,26,55,.473,11,37,.297,17,23,.739,102,48,96,.500,30,60,.500,18,36,.500,11,15,.733,125
1819,DET,2022-03-27,102,,NYK,L 102-104,240,39,85,.459,31,56,.554,8,29,.276,16,18,.889,102,34,85,.400,21,44,.477,13,41,.317,23,29,.793,104
1820,MIL,2022-03-26,102,@,MEM,L 102-127,240,37,93,.398,30,61,.492,7,32,.219,21,26,.808,102,49,102,.480,36,65,.554,13,37,.351,16,23,.696,127
1821,WAS,2022-03-24,102,@,MIL,L 102-114,240,43,92,.467,32,54,.593,11,38,.289,5,9,.556,102,42,81,.519,26,46,.565,16,35,.457,14,16,.875,114
1822,ORL,2022-03-23,102,@,OKC,L 102-118,240,36,93,.387,19,42,.452,17,51,.333,13,16,.813,102,38,79,.481,21,38,.553,17,41,.415,25,30,.833,118
1823,CHI,2022-03-18,102,@,PHO,L 102-129,240,35,85,.412,28,58,.483,7,27,.259,25,31,.806,102,47,84,.560,36,59,.610,11,25,.440,24,26,.923,129
1824,IND,2022-03-15,102,,MEM,L 102-135,240,41,98,.418,35,68,.515,6,30,.200,14,19,.737,102,54,105,.514,39,65,.600,15,40,.375,12,20,.600,135
1825,DET,2022-03-13,102,,LAC,L 102-106,240,36,80,.450,24,51,.471,12,29,.414,18,20,.900,102,40,89,.449,30,59,.508,10,30,.333,16,20,.800,106
1826,UTA,2022-03-11,102,@,SAS,L 102-104,240,37,92,.402,24,52,.462,13,40,.325,15,23,.652,102,34,85,.400,28,56,.500,6,29,.207,30,43,.698,104
1827,DEN,2022-03-10,102,,GSW,L 102-113,240,35,84,.417,28,53,.528,7,31,.226,25,32,.781,102,42,88,.477,28,46,.609,14,42,.333,15,20,.750,113
1828,NOP,2022-03-09,102,,ORL,L 102-108,240,41,93,.441,34,62,.548,7,31,.226,13,18,.722,102,36,76,.474,22,39,.564,14,37,.378,22,26,.846,108
1829,OKC,2022-03-09,102,@,MIN,L 102-132,240,36,87,.414,22,44,.500,14,43,.326,16,24,.667,102,45,86,.523,23,34,.676,22,52,.423,20,26,.769,132
1830,PHO,2022-03-08,102,@,ORL,W 102-99,240,35,92,.380,22,55,.400,13,37,.351,19,23,.826,102,35,92,.380,28,53,.528,7,39,.179,22,25,.880,99
1831,PHO,2022-02-25,102,,NOP,L 102-117,240,36,82,.439,24,42,.571,12,40,.300,18,24,.750,102,38,87,.437,30,58,.517,8,29,.276,33,41,.805,117
1832,LAL,2022-02-25,102,,LAC,L 102-105,240,39,93,.419,31,62,.500,8,31,.258,16,21,.762,102,41,83,.494,31,57,.544,10,26,.385,13,19,.684,105
1833,MIN,2022-02-25,102,,PHI,L 102-133,240,36,86,.419,27,47,.574,9,39,.231,21,25,.840,102,42,82,.512,23,43,.535,19,39,.487,30,36,.833,133
1834,DEN,2022-02-11,102,@,BOS,L 102-108,240,39,90,.433,28,46,.609,11,44,.250,13,18,.722,102,38,96,.396,28,59,.475,10,37,.270,22,30,.733,108
1835,BOS,2022-02-04,102,@,DET,W 102-93,240,37,82,.451,28,54,.519,9,28,.321,19,25,.760,102,34,104,.327,24,78,.308,10,26,.385,15,20,.750,93
1836,CLE,2022-02-04,102,@,CHO,W 102-101,240,36,90,.400,22,55,.400,14,35,.400,16,20,.800,102,38,92,.413,24,49,.490,14,43,.326,11,12,.917,101
1837,BRK,2022-02-04,102,@,UTA,L 102-125,240,41,99,.414,29,65,.446,12,34,.353,8,11,.727,102,48,85,.565,31,47,.660,17,38,.447,12,14,.857,125
1838,ORL,2022-01-26,102,,LAC,L 102-111,240,38,84,.452,29,49,.592,9,35,.257,17,22,.773,102,36,81,.444,21,52,.404,15,29,.517,24,27,.889,111
1839,LAC,2022-01-23,102,@,NYK,L 102-110,240,34,79,.430,20,38,.526,14,41,.341,20,30,.667,102,39,91,.429,23,55,.418,16,36,.444,16,19,.842,110
1840,LAC,2022-01-21,102,@,PHI,W 102-101,240,40,87,.460,29,55,.527,11,32,.344,11,15,.733,102,38,91,.418,28,63,.444,10,28,.357,15,21,.714,101
1841,SAS,2022-01-21,102,,BRK,L 102-117,240,37,95,.389,29,66,.439,8,29,.276,20,24,.833,102,48,100,.480,39,75,.520,9,25,.360,12,12,1.000,117
1842,NOP,2022-01-20,102,@,NYK,W 102-91,240,38,76,.500,27,48,.563,11,28,.393,15,22,.682,102,29,77,.377,20,39,.513,9,38,.237,24,36,.667,91
1843,BOS,2022-01-19,102,,CHO,L 102-111,240,39,90,.433,25,44,.568,14,46,.304,10,13,.769,102,42,86,.488,26,47,.553,16,39,.410,11,15,.733,111
1844,DAL,2022-01-19,102,,TOR,W 102-98,240,37,76,.487,28,43,.651,9,33,.273,19,20,.950,102,35,91,.385,27,59,.458,8,32,.250,20,25,.800,98
1845,GSW,2022-01-18,102,,DET,W 102-86,240,34,83,.410,20,41,.488,14,42,.333,20,27,.741,102,30,85,.353,21,51,.412,9,34,.265,17,24,.708,86
1846,OKC,2022-01-17,102,@,DAL,L 102-104,240,36,83,.434,25,48,.521,11,35,.314,19,24,.792,102,35,88,.398,23,51,.451,12,37,.324,22,28,.786,104
1847,DEN,2022-01-16,102,,UTA,L 102-125,240,42,95,.442,31,52,.596,11,43,.256,7,8,.875,102,44,84,.524,29,45,.644,15,39,.385,22,29,.759,125
1848,OKC,2022-01-15,102,,CLE,L 102-107,240,36,83,.434,26,56,.464,10,27,.370,20,22,.909,102,40,87,.460,31,52,.596,9,35,.257,18,25,.720,107
1849,WAS,2022-01-09,102,@,ORL,W 102-100,240,36,88,.409,25,59,.424,11,29,.379,19,24,.792,102,38,95,.400,29,67,.433,9,28,.321,15,16,.938,100
1850,SAC,2022-01-05,102,,ATL,L 102-108,240,38,90,.422,27,63,.429,11,27,.407,15,20,.750,102,39,86,.453,31,56,.554,8,30,.267,22,30,.733,108
1851,CHI,2022-01-03,102,,ORL,W 102-98,240,37,86,.430,26,55,.473,11,31,.355,17,23,.739,102,36,85,.424,26,58,.448,10,27,.370,16,18,.889,98
1852,BRK,2021-12-30,102,,PHI,L 102-110,240,37,81,.457,30,54,.556,7,27,.259,21,27,.778,102,42,100,.420,29,68,.426,13,32,.406,13,20,.650,110
1853,SAC,2021-12-26,102,,MEM,L 102-127,240,34,81,.420,24,52,.462,10,29,.345,24,27,.889,102,47,100,.470,38,70,.543,9,30,.300,24,30,.800,127
1854,MIL,2021-12-23,102,@,DAL,W 102-95,240,37,82,.451,27,46,.587,10,36,.278,18,22,.818,102,35,86,.407,23,41,.561,12,45,.267,13,17,.765,95
1855,MIN,2021-12-21,102,@,DAL,L 102-114,240,36,79,.456,23,39,.590,13,40,.325,17,20,.850,102,42,86,.488,31,52,.596,11,34,.324,19,23,.826,114
1856,OKC,2021-12-20,102,@,MEM,W 102-99,240,36,84,.429,25,46,.543,11,38,.289,19,28,.679,102,39,101,.386,28,69,.406,11,32,.344,10,13,.769,99
1857,CHO,2021-12-20,102,@,UTA,L 102-112,240,39,101,.386,24,58,.414,15,43,.349,9,9,1.000,102,34,96,.354,18,43,.419,16,53,.302,28,37,.757,112
1858,GSW,2021-12-13,102,@,IND,W 102-100,240,42,84,.500,34,54,.630,8,30,.267,10,14,.714,102,35,87,.402,28,57,.491,7,30,.233,23,31,.742,100
1859,PHI,2021-12-11,102,,GSW,W 102-93,240,35,76,.461,26,49,.531,9,27,.333,23,26,.885,102,34,85,.400,22,37,.595,12,48,.250,13,18,.722,93
1860,NYK,2021-12-08,102,@,IND,L 102-122,240,36,86,.419,27,56,.482,9,30,.300,21,23,.913,102,46,86,.535,36,59,.610,10,27,.370,20,25,.800,122
1861,BOS,2021-12-07,102,@,LAL,L 102-117,240,36,82,.439,26,49,.531,10,33,.303,20,29,.690,102,48,93,.516,40,66,.606,8,27,.296,13,17,.765,117
1862,BRK,2021-12-07,102,@,DAL,W 102-99,240,42,83,.506,34,57,.596,8,26,.308,10,13,.769,102,36,90,.400,27,44,.614,9,46,.196,18,22,.818,99
1863,LAC,2021-12-06,102,@,POR,W 102-90,240,41,92,.446,30,56,.536,11,36,.306,9,14,.643,102,35,79,.443,30,57,.526,5,22,.227,15,20,.750,90
1864,TOR,2021-12-05,102,,WAS,W 102-90,240,38,85,.447,30,62,.484,8,23,.348,18,24,.750,102,30,73,.411,22,48,.458,8,25,.320,22,29,.759,90
1865,MIA,2021-12-04,102,@,MIL,L 102-124,240,34,84,.405,17,41,.415,17,43,.395,17,24,.708,102,44,98,.449,26,48,.542,18,50,.360,18,20,.900,124
1866,HOU,2021-11-29,102,,OKC,W 102-89,240,40,96,.417,25,50,.500,15,46,.326,7,11,.636,102,31,87,.356,24,44,.545,7,43,.163,20,26,.769,89
1867,WAS,2021-11-24,102,@,NOP,L 102-127,240,36,84,.429,29,53,.547,7,31,.226,23,36,.639,102,44,96,.458,32,67,.478,12,29,.414,27,32,.844,127
1868,PHI,2021-11-22,102,@,SAC,W 102-94,240,36,85,.424,27,53,.509,9,32,.281,21,27,.778,102,33,80,.413,26,49,.531,7,31,.226,21,29,.724,94
1869,DET,2021-11-19,102,,GSW,L 102-105,240,32,80,.400,18,38,.474,14,42,.333,24,30,.800,102,38,80,.475,26,50,.520,12,30,.400,17,21,.810,105
1870,LAL,2021-11-17,102,@,MIL,L 102-109,240,40,96,.417,28,53,.528,12,43,.279,10,12,.833,102,40,87,.460,28,50,.560,12,37,.324,17,24,.708,109
1871,HOU,2021-11-15,102,@,MEM,L 102-136,240,36,95,.379,25,57,.439,11,38,.289,19,26,.731,102,52,96,.542,36,55,.655,16,41,.390,16,20,.800,136
1872,GSW,2021-11-14,102,@,CHO,L 102-106,240,38,90,.422,29,51,.569,9,39,.231,17,25,.680,102,42,88,.477,28,52,.538,14,36,.389,8,12,.667,106
1873,MIN,2021-11-13,102,@,LAC,L 102-129,240,40,102,.392,29,66,.439,11,36,.306,11,16,.688,102,53,99,.535,37,59,.627,16,40,.400,7,9,.778,129
1874,CLE,2021-11-05,102,@,TOR,W 102-101,240,38,83,.458,28,53,.528,10,30,.333,16,19,.842,102,42,99,.424,30,72,.417,12,27,.444,5,9,.556,101
1875,SAS,2021-11-05,102,@,ORL,W 102-89,240,40,90,.444,34,71,.479,6,19,.316,16,18,.889,102,35,89,.393,23,48,.479,12,41,.293,7,10,.700,89
1876,SAS,2021-10-30,102,@,MIL,W 102-93,240,39,95,.411,32,64,.500,7,31,.226,17,24,.708,102,36,89,.404,26,50,.520,10,39,.256,11,16,.688,93
1877,DET,2021-10-28,102,@,PHI,L 102-110,240,35,86,.407,22,47,.468,13,39,.333,19,27,.704,102,38,76,.500,26,49,.531,12,27,.444,22,24,.917,110
1878,ATL,2021-10-27,102,@,NOP,W 102-99,240,40,96,.417,32,66,.485,8,30,.267,14,17,.824,102,40,93,.430,29,57,.509,11,36,.306,8,9,.889,99
1879,IND,2021-10-23,102,,MIA,W 102-91 (OT),265,38,97,.392,28,58,.483,10,39,.256,16,21,.762,102,35,91,.385,26,58,.448,9,33,.273,12,14,.857,91
1880,DEN,2021-10-22,102,,SAS,W 102-96,240,44,86,.512,35,56,.625,9,30,.300,5,8,.625,102,40,84,.476,34,60,.567,6,24,.250,10,14,.714,96
1881,OKC,2022-04-08,101,@,LAL,L 101-120,240,40,88,.455,34,59,.576,6,29,.207,15,19,.789,101,41,82,.500,32,51,.627,9,31,.290,29,39,.744,120
1882,DET,2022-04-08,101,,MIL,L 101-131,240,35,90,.389,25,42,.595,10,48,.208,21,23,.913,101,50,101,.495,39,64,.609,11,37,.297,20,23,.870,131
1883,ORL,2022-04-07,101,@,CHO,L 101-128,240,38,95,.400,23,47,.489,15,48,.313,10,13,.769,101,48,92,.522,36,58,.621,12,34,.353,20,27,.741,128
1884,OKC,2022-04-06,101,@,UTA,L 101-137,240,37,90,.411,21,53,.396,16,37,.432,11,17,.647,101,49,84,.583,34,48,.708,15,36,.417,24,32,.750,137
1885,NYK,2022-04-02,101,,CLE,L 101-119,240,31,77,.403,18,47,.383,13,30,.433,26,34,.765,101,44,81,.543,29,47,.617,15,34,.441,16,21,.762,119
1886,OKC,2022-04-01,101,,DET,L 101-110,240,36,84,.429,25,50,.500,11,34,.324,18,29,.621,101,40,94,.426,25,46,.543,15,48,.313,15,18,.833,110
1887,ORL,2022-03-28,101,@,CLE,L 101-107,240,42,87,.483,32,50,.640,10,37,.270,7,13,.538,101,37,83,.446,24,42,.571,13,41,.317,20,23,.870,107
1888,UTA,2022-03-25,101,@,CHO,L 101-107,240,38,84,.452,21,37,.568,17,47,.362,8,11,.727,101,41,88,.466,28,54,.519,13,34,.382,12,17,.706,107
1889,ATL,2022-03-23,101,@,DET,L 101-122,240,37,92,.402,23,48,.479,14,44,.318,13,15,.867,101,44,88,.500,32,55,.582,12,33,.364,22,25,.880,122
1890,DAL,2022-03-18,101,@,PHI,L 101-111,240,37,80,.463,25,48,.521,12,32,.375,15,21,.714,101,37,75,.493,21,37,.568,16,38,.421,21,23,.913,111
1891,CHI,2022-03-12,101,,CLE,W 101-91,240,39,88,.443,30,67,.448,9,21,.429,14,15,.933,101,36,86,.419,31,62,.500,5,24,.208,14,17,.824,91
1892,CHO,2022-03-09,101,,BOS,L 101-115,240,36,85,.424,28,52,.538,8,33,.242,21,28,.750,101,46,93,.495,34,56,.607,12,37,.324,11,14,.786,115
1893,HOU,2022-03-04,101,@,DEN,L 101-116,240,38,83,.458,28,47,.596,10,36,.278,15,22,.682,101,39,86,.453,26,53,.491,13,33,.394,25,31,.806,116
1894,OKC,2022-03-04,101,,MIN,L 101-138,240,37,86,.430,28,51,.549,9,35,.257,18,21,.857,101,49,91,.538,27,44,.614,22,47,.468,18,23,.783,138
1895,GSW,2022-02-27,101,,DAL,L 101-107,240,39,91,.429,28,52,.538,11,39,.282,12,20,.600,101,39,78,.500,26,44,.591,13,34,.382,16,20,.800,107
1896,UTA,2022-02-16,101,@,LAL,L 101-106,240,37,79,.468,26,46,.565,11,33,.333,16,19,.842,101,41,86,.477,31,50,.620,10,36,.278,14,22,.636,106
1897,HOU,2022-02-14,101,@,UTA,L 101-135,240,35,83,.422,23,46,.500,12,37,.324,19,28,.679,101,49,89,.551,31,49,.633,18,40,.450,19,22,.864,135
1898,OKC,2022-02-12,101,@,CHI,L 101-106,240,34,88,.386,23,52,.442,11,36,.306,22,30,.733,101,40,89,.449,33,64,.516,7,25,.280,19,23,.826,106
1899,CHO,2022-02-07,101,,TOR,L 101-116,240,39,95,.411,30,55,.545,9,40,.225,14,16,.875,101,41,84,.488,26,49,.531,15,35,.429,19,29,.655,116
1900,CHO,2022-02-04,101,,CLE,L 101-102,240,38,92,.413,24,49,.490,14,43,.326,11,12,.917,101,36,90,.400,22,55,.400,14,35,.400,16,20,.800,102
1901,BRK,2022-02-02,101,@,SAC,L 101-112,240,41,84,.488,33,59,.559,8,25,.320,11,14,.786,101,41,93,.441,27,51,.529,14,42,.333,16,18,.889,112
1902,DET,2022-02-01,101,,NOP,L 101-111,240,41,84,.488,33,52,.635,8,32,.250,11,14,.786,101,39,89,.438,31,61,.508,8,28,.286,25,28,.893,111
1903,SAC,2022-01-29,101,@,PHI,L 101-103,240,36,82,.439,24,47,.511,12,35,.343,17,20,.850,101,36,70,.514,24,40,.600,12,30,.400,19,26,.731,103
1904,DET,2022-01-21,101,@,UTA,L 101-111,240,38,87,.437,25,55,.455,13,32,.406,12,16,.750,101,36,79,.456,26,48,.542,10,31,.323,29,34,.853,111
1905,PHI,2022-01-21,101,,LAC,L 101-102,240,38,91,.418,28,63,.444,10,28,.357,15,21,.714,101,40,87,.460,29,55,.527,11,32,.344,11,15,.733,102
1906,DAL,2022-01-20,101,,PHO,L 101-109,240,37,85,.435,26,48,.542,11,37,.297,16,20,.800,101,39,86,.453,31,50,.620,8,36,.222,23,25,.920,109
1907,LAL,2022-01-17,101,,UTA,W 101-95,240,38,86,.442,27,49,.551,11,37,.297,14,23,.609,101,31,83,.373,19,37,.514,12,46,.261,21,24,.875,95
1908,SAS,2022-01-15,101,,LAC,W 101-94,240,34,83,.410,23,46,.500,11,37,.297,22,27,.815,101,38,100,.380,26,62,.419,12,38,.316,6,8,.750,94
1909,BOS,2022-01-10,101,,IND,W 101-98 (OT),265,35,88,.398,27,60,.450,8,28,.286,23,28,.821,101,36,94,.383,25,57,.439,11,37,.297,15,17,.882,98
1910,NOP,2022-01-09,101,@,TOR,L 101-105,240,34,75,.453,22,42,.524,12,33,.364,21,25,.840,101,36,85,.424,22,51,.431,14,34,.412,19,20,.950,105
1911,POR,2022-01-07,101,,CLE,L 101-114,240,37,92,.402,21,57,.368,16,35,.457,11,19,.579,101,39,80,.488,22,41,.537,17,39,.436,19,29,.655,114
1912,NOP,2022-01-06,101,,GSW,W 101-96,240,35,83,.422,27,49,.551,8,34,.235,23,29,.793,101,37,87,.425,30,54,.556,7,33,.212,15,18,.833,96
1913,NYK,2021-12-25,101,,ATL,W 101-87,240,38,85,.447,18,35,.514,20,50,.400,5,12,.417,101,33,87,.379,20,49,.408,13,38,.342,8,14,.571,87
1914,OKC,2021-12-23,101,@,PHO,L 101-113,240,37,96,.385,26,55,.473,11,41,.268,16,21,.762,101,45,93,.484,30,54,.556,15,39,.385,8,13,.615,113
1915,CLE,2021-12-22,101,@,BOS,L 101-111,240,36,92,.391,27,54,.500,9,38,.237,20,24,.833,101,43,92,.467,32,62,.516,11,30,.367,14,18,.778,111
1916,MIA,2021-12-15,101,@,PHI,W 101-96,240,35,78,.449,17,34,.500,18,44,.409,13,17,.765,101,35,79,.443,23,42,.548,12,37,.324,14,17,.824,96
1917,SAC,2021-12-13,101,@,TOR,L 101-124,240,38,94,.404,27,60,.450,11,34,.324,14,21,.667,101,53,98,.541,42,67,.627,11,31,.355,7,10,.700,124
1918,WAS,2021-12-03,101,,CLE,L 101-116,240,38,82,.463,28,51,.549,10,31,.323,15,19,.789,101,42,89,.472,29,59,.492,13,30,.433,19,25,.760,116
1919,PHI,2021-11-29,101,,ORL,W 101-96,240,39,97,.402,29,64,.453,10,33,.303,13,18,.722,101,37,90,.411,29,57,.509,8,33,.242,14,18,.778,96
1920,SAC,2021-11-28,101,@,MEM,L 101-128,240,33,97,.340,24,55,.436,9,42,.214,26,37,.703,101,50,104,.481,37,65,.569,13,39,.333,15,20,.750,128
1921,WAS,2021-11-26,101,@,OKC,W 101-99,240,38,79,.481,28,50,.560,10,29,.345,15,15,1.000,101,38,94,.404,27,61,.443,11,33,.333,12,14,.857,99
1922,MIA,2021-11-24,101,@,MIN,L 101-113,240,33,74,.446,18,32,.563,15,42,.357,20,29,.690,101,38,93,.409,20,38,.526,18,55,.327,19,21,.905,113
1923,OKC,2021-11-22,101,@,ATL,L 101-113,240,39,97,.402,29,59,.492,10,38,.263,13,14,.929,101,42,87,.483,28,53,.528,14,34,.412,15,16,.938,113
1924,OKC,2021-11-17,101,,HOU,W 101-89,240,41,92,.446,31,53,.585,10,39,.256,9,16,.563,101,32,90,.356,20,48,.417,12,42,.286,13,19,.684,89
1925,DEN,2021-11-15,101,@,DAL,L 101-111,240,40,84,.476,31,52,.596,9,32,.281,12,17,.706,101,45,90,.500,31,54,.574,14,36,.389,7,10,.700,111
1926,MEM,2021-11-13,101,@,NOP,L 101-112,240,38,88,.432,30,64,.469,8,24,.333,17,21,.810,101,38,79,.481,24,50,.480,14,29,.483,22,25,.880,112
1927,DEN,2021-11-10,101,,IND,W 101-98,240,36,84,.429,24,54,.444,12,30,.400,17,20,.850,101,40,84,.476,29,53,.547,11,31,.355,7,11,.636,98
1928,WAS,2021-11-07,101,,MIL,W 101-94,240,41,81,.506,30,54,.556,11,27,.407,8,13,.615,101,37,94,.394,27,58,.466,10,36,.278,10,18,.556,94
1929,TOR,2021-11-05,101,,CLE,L 101-102,240,42,99,.424,30,72,.417,12,27,.444,5,9,.556,101,38,83,.458,28,53,.528,10,30,.333,16,19,.842,102
1930,PHO,2021-10-30,101,,CLE,W 101-92,240,39,84,.464,33,58,.569,6,26,.231,17,27,.630,101,36,91,.396,22,47,.468,14,44,.318,6,7,.857,92
1931,CLE,2021-10-29,101,@,LAL,L 101-113,240,37,87,.425,25,53,.472,12,34,.353,15,22,.682,101,46,84,.548,34,57,.596,12,27,.444,9,10,.900,113
1932,GSW,2021-10-28,101,,MEM,L 101-104 (OT),265,39,90,.433,25,50,.500,14,40,.350,9,12,.750,101,39,97,.402,27,49,.551,12,48,.250,14,14,1.000,104
1933,CLE,2021-10-23,101,,ATL,W 101-95,240,37,89,.416,30,61,.492,7,28,.250,20,27,.741,101,38,99,.384,28,65,.431,10,34,.294,9,15,.600,95
1934,SAC,2021-10-22,101,,UTA,L 101-110,240,39,99,.394,31,63,.492,8,36,.222,15,21,.714,101,37,90,.411,21,48,.438,16,42,.381,20,23,.870,110
1935,GSW,2022-04-09,100,@,SAS,W 100-94,240,33,81,.407,25,49,.510,8,32,.250,26,33,.788,100,32,80,.400,22,49,.449,10,31,.323,20,27,.741,94
1936,NOP,2022-04-03,100,@,LAC,L 100-119,240,35,87,.402,26,63,.413,9,24,.375,21,27,.778,100,45,95,.474,24,51,.471,21,44,.477,8,10,.800,119
1937,SAC,2022-03-28,100,@,MIA,L 100-123,240,37,81,.457,25,46,.543,12,35,.343,14,18,.778,100,49,90,.544,30,50,.600,19,40,.475,6,6,1.000,123
1938,UTA,2022-03-27,100,@,DAL,L 100-114,240,41,89,.461,29,55,.527,12,34,.353,6,10,.600,100,40,77,.519,23,43,.535,17,34,.500,17,24,.708,114
1939,WAS,2022-03-25,100,@,DET,W 100-97,240,36,83,.434,27,53,.509,9,30,.300,19,21,.905,100,39,95,.411,33,63,.524,6,32,.188,13,14,.929,97
1940,NYK,2022-03-18,100,,WAS,W 100-97,240,31,90,.344,21,57,.368,10,33,.303,28,36,.778,100,34,79,.430,21,45,.467,13,34,.382,16,21,.762,97
1941,LAC,2022-03-16,100,,TOR,L 100-103,240,38,78,.487,27,48,.563,11,30,.367,13,15,.867,100,38,83,.458,27,51,.529,11,32,.344,16,21,.762,103
1942,HOU,2022-03-11,100,,DAL,L 100-113,240,41,86,.477,35,56,.625,6,30,.200,12,19,.632,100,40,88,.455,29,52,.558,11,36,.306,22,28,.786,113
1943,PHI,2022-03-10,100,,BRK,L 100-129,240,30,93,.323,16,57,.281,14,36,.389,26,30,.867,100,51,91,.560,33,51,.647,18,40,.450,9,17,.529,129
1944,SAC,2022-03-09,100,,DEN,L 100-106,240,38,85,.447,26,51,.510,12,34,.353,12,18,.667,100,40,82,.488,31,47,.660,9,35,.257,17,19,.895,106
1945,HOU,2022-03-01,100,,LAC,L 100-113,240,38,96,.396,25,57,.439,13,39,.333,11,17,.647,100,42,96,.438,29,65,.446,13,31,.419,16,17,.941,113
1946,TOR,2022-02-26,100,@,ATL,L 100-127,240,38,95,.400,28,63,.444,10,32,.313,14,19,.737,100,48,83,.578,35,52,.673,13,31,.419,18,22,.818,127
1947,NYK,2022-02-25,100,,MIA,L 100-115,240,30,75,.400,16,35,.457,14,40,.350,26,36,.722,100,39,83,.470,28,51,.549,11,32,.344,26,35,.743,115
1948,PHI,2022-02-11,100,,OKC,W 100-87,240,36,93,.387,29,67,.433,7,26,.269,21,26,.808,100,35,90,.389,29,55,.527,6,35,.171,11,12,.917,87
1949,WAS,2022-02-07,100,,MIA,L 100-121,240,36,80,.450,29,49,.592,7,31,.226,21,23,.913,100,43,76,.566,25,44,.568,18,32,.563,17,21,.810,121
1950,ATL,2022-01-31,100,,TOR,L 100-106,240,37,81,.457,25,49,.510,12,32,.375,14,16,.875,100,38,89,.427,20,53,.377,18,36,.500,12,17,.706,106
1951,MIL,2022-01-30,100,,DEN,L 100-136,240,37,78,.474,27,48,.563,10,30,.333,16,22,.727,100,53,88,.602,30,45,.667,23,43,.535,7,10,.700,136
1952,IND,2022-01-12,100,,BOS,L 100-119,240,40,86,.465,33,50,.660,7,36,.194,13,20,.650,100,40,78,.513,22,40,.550,18,38,.474,21,25,.840,119
1953,ORL,2022-01-09,100,,WAS,L 100-102,240,38,95,.400,29,67,.433,9,28,.321,15,16,.938,100,36,88,.409,25,59,.424,11,29,.379,19,24,.792,102
1954,PHO,2022-01-08,100,,MIA,L 100-123,240,30,79,.380,16,45,.356,14,34,.412,26,29,.897,100,44,88,.500,22,44,.500,22,44,.500,13,15,.867,123
1955,SAS,2022-01-07,100,@,PHI,L 100-119,240,38,92,.413,29,62,.468,9,30,.300,15,20,.750,100,45,87,.517,37,64,.578,8,23,.348,21,27,.778,119
1956,LAC,2021-12-26,100,,DEN,L 100-103,240,40,86,.465,32,60,.533,8,26,.308,12,18,.667,100,39,95,.411,24,54,.444,15,41,.366,10,11,.909,103
1957,MEM,2021-12-19,100,,POR,L 100-105,240,35,91,.385,26,57,.456,9,34,.265,21,25,.840,100,35,74,.473,24,42,.571,11,32,.344,24,28,.857,105
1958,DET,2021-12-19,100,,MIA,W 100-90,240,35,75,.467,27,43,.628,8,32,.250,22,30,.733,100,28,74,.378,15,31,.484,13,43,.302,21,33,.636,90
1959,ORL,2021-12-18,100,@,BRK,W 100-93,240,39,94,.415,29,63,.460,10,31,.323,12,13,.923,100,39,102,.382,30,56,.536,9,46,.196,6,8,.750,93
1960,GSW,2021-12-18,100,@,TOR,L 100-119,240,37,79,.468,26,43,.605,11,36,.306,15,21,.714,100,45,90,.500,31,52,.596,14,38,.368,15,23,.652,119
1961,IND,2021-12-13,100,,GSW,L 100-102,240,35,87,.402,28,57,.491,7,30,.233,23,31,.742,100,42,84,.500,34,54,.630,8,30,.267,10,14,.714,102
1962,MIN,2021-11-29,100,,IND,W 100-98,240,36,82,.439,27,47,.574,9,35,.257,19,26,.731,100,36,91,.396,27,54,.500,9,37,.243,17,21,.810,98
1963,IND,2021-11-28,100,,MIL,L 100-118,240,38,92,.413,26,47,.553,12,45,.267,12,16,.750,100,46,90,.511,38,55,.691,8,35,.229,18,22,.818,118
1964,MEM,2021-11-26,100,,ATL,L 100-132,240,37,91,.407,25,53,.472,12,38,.316,14,19,.737,100,52,89,.584,39,62,.629,13,27,.481,15,21,.714,132
1965,MIA,2021-11-23,100,@,DET,W 100-92,240,35,76,.461,26,47,.553,9,29,.310,21,29,.724,100,35,84,.417,25,46,.543,10,38,.263,12,14,.857,92
1966,LAL,2021-11-23,100,@,NYK,L 100-106,240,34,91,.374,23,55,.418,11,36,.306,21,30,.700,100,37,82,.451,22,48,.458,15,34,.441,17,21,.810,106
1967,DEN,2021-11-23,100,@,POR,L 100-119,240,38,78,.487,23,45,.511,15,33,.455,9,11,.818,100,45,88,.511,30,49,.612,15,39,.385,14,20,.700,119
1968,MIA,2021-11-20,100,@,WAS,L 100-103,240,38,81,.469,31,54,.574,7,27,.259,17,20,.850,100,36,74,.486,25,44,.568,11,30,.367,20,23,.870,103
1969,NOP,2021-11-15,100,@,WAS,L 100-105,240,30,74,.405,19,53,.358,11,21,.524,29,34,.853,100,39,84,.464,29,56,.518,10,28,.357,17,25,.680,105
1970,MIL,2021-11-14,100,@,ATL,L 100-120,240,38,84,.452,24,43,.558,14,41,.341,10,16,.625,100,47,97,.485,32,62,.516,15,35,.429,11,13,.846,120
1971,CHI,2021-11-14,100,@,LAC,W 100-90,240,38,86,.442,27,57,.474,11,29,.379,13,14,.929,100,29,81,.358,18,47,.383,11,34,.324,21,21,1.000,90
1972,UTA,2021-11-11,100,,IND,L 100-111,240,39,83,.470,30,51,.588,9,32,.281,13,23,.565,100,43,96,.448,32,65,.492,11,31,.355,14,19,.737,111
1973,NOP,2021-11-10,100,,OKC,L 100-108,240,34,97,.351,25,62,.403,9,35,.257,23,32,.719,100,37,87,.425,27,53,.509,10,34,.294,24,30,.800,108
1974,NYK,2021-11-10,100,,MIL,L 100-112,240,36,83,.434,20,46,.435,16,37,.432,12,17,.706,100,40,90,.444,14,40,.350,26,50,.520,6,9,.667,112
1975,UTA,2021-11-07,100,@,ORL,L 100-107,240,34,89,.382,26,47,.553,8,42,.190,24,29,.828,100,43,87,.494,31,55,.564,12,32,.375,9,11,.818,107
1976,WAS,2021-11-03,100,,TOR,L 100-109,240,34,78,.436,26,46,.565,8,32,.250,24,30,.800,100,41,88,.466,31,63,.492,10,25,.400,17,20,.850,109
1977,NOP,2021-11-02,100,@,PHO,L 100-112,240,36,91,.396,23,52,.442,13,39,.333,15,16,.938,100,43,82,.524,34,56,.607,9,26,.346,17,18,.944,112
1978,IND,2021-10-27,100,@,TOR,L 100-118,240,38,79,.481,28,50,.560,10,29,.345,14,17,.824,100,46,100,.460,32,70,.457,14,30,.467,12,19,.632,118
1979,TOR,2022-03-21,99,@,CHI,L 99-113,240,40,91,.440,34,59,.576,6,32,.188,13,15,.867,99,44,90,.489,33,62,.532,11,28,.393,14,24,.583,113
1980,ORL,2022-03-08,99,,PHO,L 99-102,240,35,92,.380,28,53,.528,7,39,.179,22,25,.880,99,35,92,.380,22,55,.400,13,37,.351,19,23,.826,102
1981,MIA,2022-03-05,99,,PHI,W 99-82,240,35,72,.486,22,44,.500,13,28,.464,16,19,.842,99,28,82,.341,21,41,.512,7,41,.171,19,23,.826,82
1982,CHI,2022-02-28,99,@,MIA,L 99-112,240,41,84,.488,34,55,.618,7,29,.241,10,15,.667,99,40,81,.494,28,50,.560,12,31,.387,20,26,.769,112
1983,LAC,2022-02-27,99,@,HOU,W 99-98,240,34,77,.442,23,43,.535,11,34,.324,20,28,.714,99,35,92,.380,18,50,.360,17,42,.405,11,18,.611,98
1984,MIA,2022-02-15,99,,DAL,L 99-107,240,35,84,.417,28,57,.491,7,27,.259,22,27,.815,99,34,76,.447,16,35,.457,18,41,.439,21,33,.636,107
1985,LAC,2022-02-12,99,@,DAL,W 99-97,240,43,82,.524,36,60,.600,7,22,.318,6,11,.545,99,35,85,.412,20,46,.435,15,39,.385,12,19,.632,97
1986,ORL,2022-02-11,99,@,UTA,L 99-114,240,37,84,.440,24,49,.490,13,35,.371,12,16,.750,99,40,89,.449,27,48,.563,13,41,.317,21,24,.875,114
1987,LAL,2022-02-02,99,,POR,W 99-94,240,33,78,.423,22,48,.458,11,30,.367,22,33,.667,99,35,98,.357,21,56,.375,14,42,.333,10,19,.526,94
1988,MIL,2022-01-26,99,@,CLE,L 99-115,240,37,80,.463,28,48,.583,9,32,.281,16,18,.889,99,41,87,.471,22,45,.489,19,42,.452,14,17,.824,115
1989,TOR,2022-01-17,99,@,MIA,L 99-104,240,37,90,.411,24,54,.444,13,36,.361,12,17,.706,99,38,83,.458,29,59,.492,9,24,.375,19,22,.864,104
1990,GSW,2022-01-16,99,@,MIN,L 99-119,240,32,82,.390,19,40,.475,13,42,.310,22,29,.759,99,45,91,.495,29,48,.604,16,43,.372,13,20,.650,119
1991,BOS,2022-01-14,99,@,PHI,L 99-111,240,37,78,.474,26,47,.553,11,31,.355,14,18,.778,99,38,85,.447,24,44,.545,14,41,.341,21,25,.840,111
1992,GSW,2022-01-13,99,@,MIL,L 99-118,240,33,95,.347,17,47,.362,16,48,.333,17,24,.708,99,44,86,.512,26,45,.578,18,41,.439,12,18,.667,118
1993,PHO,2022-01-11,99,@,TOR,W 99-95,240,35,74,.473,24,42,.571,11,32,.344,18,22,.818,99,36,89,.404,28,52,.538,8,37,.216,15,25,.600,95
1994,MIL,2022-01-10,99,@,CHO,L 99-103,240,37,84,.440,24,41,.585,13,43,.302,12,16,.750,99,38,96,.396,25,52,.481,13,44,.295,14,16,.875,103
1995,DEN,2022-01-09,99,@,OKC,W 99-95,240,37,89,.416,24,53,.453,13,36,.361,12,16,.750,99,38,88,.432,29,50,.580,9,38,.237,10,12,.833,95
1996,CHI,2022-01-09,99,@,DAL,L 99-113,240,39,90,.433,28,57,.491,11,33,.333,10,13,.769,99,44,88,.500,28,52,.538,16,36,.444,9,9,1.000,113
1997,BOS,2022-01-08,99,,NYK,W 99-75,240,36,76,.474,24,47,.511,12,29,.414,15,17,.882,99,29,79,.367,18,48,.375,11,31,.355,6,15,.400,75
1998,DAL,2022-01-05,99,,GSW,W 99-82,240,33,87,.379,21,47,.447,12,40,.300,21,26,.808,99,33,81,.407,28,53,.528,5,28,.179,11,16,.688,82
1999,SAS,2022-01-05,99,@,BOS,W 99-97,240,42,88,.477,32,62,.516,10,26,.385,5,5,1.000,99,40,90,.444,31,62,.500,9,28,.321,8,9,.889,97
2000,CHO,2022-01-02,99,,PHO,L 99-133,240,39,85,.459,30,50,.600,9,35,.257,12,21,.571,99,52,103,.505,35,62,.565,17,41,.415,12,12,1.000,133
2001,LAL,2021-12-29,99,@,MEM,L 99-104,240,39,86,.453,24,45,.533,15,41,.366,6,8,.750,99,35,85,.412,25,55,.455,10,30,.333,24,29,.828,104
2002,HOU,2021-12-27,99,@,CHO,L 99-123,240,36,87,.414,21,41,.512,15,46,.326,12,18,.667,99,47,88,.534,29,47,.617,18,41,.439,11,14,.786,123
2003,TOR,2021-12-26,99,@,CLE,L 99-144,240,37,89,.416,28,53,.528,9,36,.250,16,23,.696,99,56,106,.528,34,54,.630,22,52,.423,10,12,.833,144
2004,MEM,2021-12-20,99,,OKC,L 99-102,240,39,101,.386,28,69,.406,11,32,.344,10,13,.769,99,36,84,.429,25,46,.543,11,38,.289,19,28,.679,102
2005,IND,2021-12-15,99,@,MIL,L 99-114,240,39,83,.470,28,45,.622,11,38,.289,10,11,.909,99,44,90,.489,30,61,.492,14,29,.483,12,15,.800,114
2006,ORL,2021-12-15,99,,ATL,L 99-111,240,35,90,.389,25,55,.455,10,35,.286,19,21,.905,99,42,85,.494,31,54,.574,11,31,.355,16,16,1.000,111
2007,DAL,2021-12-07,99,,BRK,L 99-102,240,36,90,.400,27,44,.614,9,46,.196,18,22,.818,99,42,83,.506,34,57,.596,8,26,.308,10,13,.769,102
2008,LAC,2021-12-04,99,@,SAC,L 99-104,240,34,89,.382,21,55,.382,13,34,.382,18,27,.667,99,36,86,.419,24,52,.462,12,34,.353,20,25,.800,104
2009,NYK,2021-12-04,99,,DEN,L 99-113,240,35,88,.398,23,48,.479,12,40,.300,17,21,.810,99,44,84,.524,24,41,.585,20,43,.465,5,5,1.000,113
2010,WAS,2021-11-29,99,@,SAS,L 99-116,240,41,92,.446,32,61,.525,9,31,.290,8,13,.615,99,49,92,.533,41,74,.554,8,18,.444,10,16,.625,116
2011,NYK,2021-11-27,99,@,ATL,W 99-90,240,36,82,.439,25,53,.472,11,29,.379,16,22,.727,99,33,93,.355,24,56,.429,9,37,.243,15,20,.750,90
2012,OKC,2021-11-26,99,,WAS,L 99-101,240,38,94,.404,27,61,.443,11,33,.333,12,14,.857,99,38,79,.481,28,50,.560,10,29,.345,15,15,1.000,101
2013,ORL,2021-11-24,99,,CHO,L 99-106,240,38,93,.409,23,51,.451,15,42,.357,8,10,.800,99,39,93,.419,27,53,.509,12,40,.300,16,21,.762,106
2014,HOU,2021-11-20,99,@,NYK,L 99-106,240,38,84,.452,28,45,.622,10,39,.256,13,22,.591,99,33,78,.423,15,37,.405,18,41,.439,22,26,.846,106
2015,CLE,2021-11-17,99,@,BRK,L 99-109,240,35,89,.393,24,45,.533,11,44,.250,18,21,.857,99,38,83,.458,26,51,.510,12,32,.375,21,25,.840,109
2016,BOS,2021-11-17,99,@,ATL,L 99-110,240,37,84,.440,26,43,.605,11,41,.268,14,17,.824,99,41,81,.506,28,44,.636,13,37,.351,15,18,.833,110
2017,BRK,2021-11-16,99,,GSW,L 99-117,240,34,88,.386,24,52,.462,10,36,.278,21,27,.778,99,41,79,.519,28,39,.718,13,40,.325,22,28,.786,117
2018,PHO,2021-11-15,99,@,MIN,W 99-96,240,32,85,.376,25,54,.463,7,31,.226,28,36,.778,99,31,85,.365,18,41,.439,13,44,.295,21,27,.778,96
2019,OKC,2021-11-07,99,,SAS,W 99-94,240,35,94,.372,23,52,.442,12,42,.286,17,20,.850,99,41,100,.410,35,70,.500,6,30,.200,6,9,.667,94
2020,NOP,2021-11-03,99,@,SAC,L 99-112,240,37,86,.430,25,52,.481,12,34,.353,13,15,.867,99,42,80,.525,32,50,.640,10,30,.333,18,22,.818,112
2021,LAC,2021-11-01,99,,OKC,W 99-94,240,35,92,.380,20,50,.400,15,42,.357,14,19,.737,99,35,90,.389,24,53,.453,11,37,.297,13,16,.813,94
2022,SAC,2021-10-31,99,@,DAL,L 99-105,240,38,96,.396,31,60,.517,7,36,.194,16,20,.800,99,40,90,.444,28,53,.528,12,37,.324,13,20,.650,105
2023,UTA,2021-10-30,99,@,CHI,L 99-107,240,35,92,.380,24,54,.444,11,38,.289,18,19,.947,99,39,91,.429,34,70,.486,5,21,.238,24,30,.800,107
2024,CHO,2021-10-29,99,@,MIA,L 99-114,240,35,90,.389,22,53,.415,13,37,.351,16,22,.727,99,43,91,.473,34,56,.607,9,35,.257,19,19,1.000,114
2025,SAS,2021-10-28,99,@,DAL,L 99-104,240,39,88,.443,27,58,.466,12,30,.400,9,15,.600,99,41,89,.461,23,44,.523,18,45,.400,4,13,.308,104
2026,NOP,2021-10-27,99,,ATL,L 99-102,240,40,93,.430,29,57,.509,11,36,.306,8,9,.889,99,40,96,.417,32,66,.485,8,30,.267,14,17,.824,102
2027,PHI,2021-10-26,99,@,NYK,L 99-112,240,36,82,.439,24,41,.585,12,41,.293,15,17,.882,99,41,87,.471,25,50,.500,16,37,.432,14,15,.933,112
2028,CLE,2021-10-25,99,@,DEN,W 99-87,240,38,82,.463,31,57,.544,7,25,.280,16,20,.800,99,35,86,.407,26,48,.542,9,38,.237,8,12,.667,87
2029,SAC,2022-04-09,98,@,LAC,L 98-117,240,38,86,.442,31,58,.534,7,28,.250,15,24,.625,98,42,86,.488,21,43,.488,21,43,.488,12,15,.800,117
2030,NYK,2022-04-06,98,,BRK,L 98-110,240,32,83,.386,19,45,.422,13,38,.342,21,36,.583,98,41,93,.441,27,52,.519,14,41,.341,14,18,.778,110
2031,OKC,2022-04-05,98,,POR,W 98-94,240,39,81,.481,30,52,.577,9,29,.310,11,22,.500,98,35,83,.422,24,51,.471,11,32,.344,13,16,.813,94
2032,BOS,2022-03-30,98,,MIA,L 98-106,240,35,85,.412,24,48,.500,11,37,.297,17,23,.739,98,38,79,.481,25,45,.556,13,34,.382,17,25,.680,106
2033,POR,2022-03-26,98,,HOU,L 98-115,240,37,93,.398,25,53,.472,12,40,.300,12,17,.706,98,44,84,.524,29,49,.592,15,35,.429,12,18,.667,115
2034,CHI,2022-03-26,98,@,CLE,W 98-94,240,36,75,.480,31,54,.574,5,21,.238,21,25,.840,98,34,82,.415,27,51,.529,7,31,.226,19,27,.704,94
2035,CHI,2022-03-22,98,@,MIL,L 98-126,240,39,92,.424,26,59,.441,13,33,.394,7,13,.538,98,50,82,.610,38,54,.704,12,28,.429,14,20,.700,126
2036,POR,2022-03-20,98,@,IND,L 98-129,240,38,81,.469,29,48,.604,9,33,.273,13,18,.722,98,48,84,.571,33,49,.673,15,35,.429,18,21,.857,129
2037,HOU,2022-03-20,98,,MEM,L 98-122,240,37,86,.430,27,55,.491,10,31,.323,14,24,.583,98,46,96,.479,30,62,.484,16,34,.471,14,17,.824,122
2038,POR,2022-03-16,98,@,NYK,L 98-128,240,40,91,.440,29,57,.509,11,34,.324,7,14,.500,98,40,80,.500,24,42,.571,16,38,.421,32,39,.821,128
2039,DET,2022-03-15,98,@,MIA,L 98-105,240,37,80,.463,27,46,.587,10,34,.294,14,22,.636,98,29,72,.403,17,39,.436,12,33,.364,35,39,.897,105
2040,CLE,2022-03-02,98,,CHO,L 98-119,240,37,79,.468,27,48,.563,10,31,.323,14,21,.667,98,43,85,.506,26,47,.553,17,38,.447,16,22,.727,119
2041,ATL,2022-03-01,98,@,BOS,L 98-107,240,36,83,.434,29,52,.558,7,31,.226,19,24,.792,98,39,83,.470,28,48,.583,11,35,.314,18,19,.947,107
2042,HOU,2022-02-27,98,,LAC,L 98-99,240,35,92,.380,18,50,.360,17,42,.405,11,18,.611,98,34,77,.442,23,43,.535,11,34,.324,20,28,.714,99
2043,OKC,2022-02-09,98,,TOR,L 98-117,240,36,87,.414,22,40,.550,14,47,.298,12,14,.857,98,45,88,.511,32,53,.604,13,35,.371,14,14,1.000,117
2044,OKC,2022-02-07,98,,GSW,L 98-110,240,37,90,.411,26,54,.481,11,36,.306,13,17,.765,98,41,82,.500,26,39,.667,15,43,.349,13,17,.765,110
2045,CLE,2022-02-06,98,,IND,W 98-85,240,34,84,.405,23,52,.442,11,32,.344,19,28,.679,98,31,83,.373,23,52,.442,8,31,.258,15,17,.882,85
2046,PHI,2022-02-04,98,@,DAL,L 98-107,240,36,70,.514,27,43,.628,9,27,.333,17,23,.739,98,39,85,.459,29,51,.569,10,34,.294,19,23,.826,107
2047,WAS,2022-02-01,98,@,MIL,L 98-112,240,36,82,.439,24,47,.511,12,35,.343,14,20,.700,98,46,92,.500,34,54,.630,12,38,.316,8,9,.889,112
2048,OKC,2022-01-31,98,,POR,W 98-81,240,35,86,.407,23,45,.511,12,41,.293,16,17,.941,98,34,81,.420,27,43,.628,7,38,.184,6,8,.750,81
2049,OKC,2022-01-21,98,@,CHO,L 98-121,240,37,98,.378,25,54,.463,12,44,.273,12,15,.800,98,45,99,.455,28,50,.560,17,49,.347,14,20,.700,121
2050,TOR,2022-01-19,98,@,DAL,L 98-102,240,35,91,.385,27,59,.458,8,32,.250,20,25,.800,98,37,76,.487,28,43,.651,9,33,.273,19,20,.950,102
2051,PHI,2022-01-17,98,@,WAS,L 98-117,240,35,86,.407,28,60,.467,7,26,.269,21,25,.840,98,42,87,.483,33,57,.579,9,30,.300,24,32,.750,117
2052,POR,2022-01-17,98,@,ORL,W 98-88,240,37,90,.411,30,56,.536,7,34,.206,17,18,.944,98,34,90,.378,26,58,.448,8,32,.250,12,20,.600,88
2053,MIA,2022-01-15,98,,PHI,L 98-109,240,33,86,.384,24,51,.471,9,35,.257,23,30,.767,98,40,79,.506,27,47,.574,13,32,.406,16,21,.762,109
2054,PHI,2022-01-12,98,,CHO,L 98-109,240,34,73,.466,22,43,.512,12,30,.400,18,28,.643,98,46,89,.517,36,55,.655,10,34,.294,7,8,.875,109
2055,IND,2022-01-10,98,@,BOS,L 98-101 (OT),265,36,94,.383,25,57,.439,11,37,.297,15,17,.882,98,35,88,.398,27,60,.450,8,28,.286,23,28,.821,101
2056,MIN,2022-01-05,98,,OKC,W 98-90,240,36,90,.400,24,46,.522,12,44,.273,14,20,.700,98,33,90,.367,24,55,.436,9,35,.257,15,18,.833,90
2057,ORL,2022-01-03,98,@,CHI,L 98-102,240,36,85,.424,26,58,.448,10,27,.370,16,18,.889,98,37,86,.430,26,55,.473,11,31,.355,17,23,.739,102
2058,ATL,2021-12-23,98,@,PHI,W 98-96,240,37,82,.451,30,58,.517,7,24,.292,17,19,.895,98,33,80,.413,27,53,.509,6,27,.222,24,26,.923,96
2059,ATL,2021-12-22,98,,ORL,L 98-104,240,32,80,.400,20,49,.408,12,31,.387,22,29,.759,98,38,85,.447,27,48,.563,11,37,.297,17,23,.739,104
2060,SAC,2021-12-20,98,@,GSW,L 98-113,240,37,83,.446,24,51,.471,13,32,.406,11,16,.688,98,46,88,.523,31,51,.608,15,37,.405,6,9,.667,113
2061,WAS,2021-12-16,98,@,PHO,L 98-118,240,40,82,.488,34,61,.557,6,21,.286,12,19,.632,98,42,79,.532,33,50,.660,9,29,.310,25,26,.962,118
2062,WAS,2021-12-11,98,,UTA,L 98-123,240,41,89,.461,33,64,.516,8,25,.320,8,14,.571,98,48,93,.516,35,54,.648,13,39,.333,14,17,.824,123
2063,PHI,2021-12-03,98,@,ATL,W 98-96,240,38,81,.469,29,59,.492,9,22,.409,13,17,.765,98,31,76,.408,21,48,.438,10,28,.357,24,30,.800,96
2064,MEM,2021-11-30,98,@,TOR,W 98-91,240,36,93,.387,26,59,.441,10,34,.294,16,19,.842,98,36,91,.396,26,52,.500,10,39,.256,9,12,.750,91
2065,IND,2021-11-29,98,@,MIN,L 98-100,240,36,91,.396,27,54,.500,9,37,.243,17,21,.810,98,36,82,.439,27,47,.574,9,35,.257,19,26,.731,100
2066,NOP,2021-11-26,98,@,UTA,W 98-97,240,38,89,.427,27,62,.435,11,27,.407,11,13,.846,98,36,80,.450,23,47,.489,13,33,.394,12,18,.667,97
2067,NYK,2021-11-17,98,,ORL,L 98-104,240,37,88,.420,21,39,.538,16,49,.327,8,12,.667,98,39,96,.406,28,58,.483,11,38,.289,15,18,.833,104
2068,NOP,2021-11-17,98,@,MIA,L 98-113,240,33,75,.440,23,40,.575,10,35,.286,22,28,.786,98,42,87,.483,27,47,.574,15,40,.375,14,17,.824,113
2069,DAL,2021-11-17,98,@,PHO,L 98-105,240,38,91,.418,22,59,.373,16,32,.500,6,6,1.000,98,41,93,.441,28,54,.519,13,39,.333,10,14,.714,105
2070,BOS,2021-11-15,98,@,CLE,W 98-92,240,36,78,.462,26,49,.531,10,29,.345,16,20,.800,98,32,83,.386,16,43,.372,16,40,.400,12,16,.750,92
2071,CLE,2021-11-12,98,,DET,W 98-78,240,39,82,.476,25,41,.610,14,41,.341,6,9,.667,98,29,79,.367,20,49,.408,9,30,.300,11,13,.846,78
2072,IND,2021-11-10,98,@,DEN,L 98-101,240,40,84,.476,29,53,.547,11,31,.355,7,11,.636,98,36,84,.429,24,54,.444,12,30,.400,17,20,.850,101
2073,ATL,2021-11-09,98,@,UTA,L 98-110,240,37,85,.435,19,50,.380,18,35,.514,6,10,.600,98,41,81,.506,26,43,.605,15,38,.395,13,16,.813,110
2074,MIL,2021-11-05,98,,NYK,L 98-113,240,33,82,.402,17,39,.436,16,43,.372,16,21,.762,98,41,96,.427,31,56,.554,10,40,.250,21,26,.808,113
2075,ATL,2021-11-04,98,,UTA,L 98-116,240,35,82,.427,28,54,.519,7,28,.250,21,26,.808,98,41,81,.506,24,40,.600,17,41,.415,17,23,.739,116
2076,DET,2021-11-04,98,,PHI,L 98-109,240,35,87,.402,24,51,.471,11,36,.306,17,19,.895,98,41,83,.494,29,51,.569,12,32,.375,15,22,.682,109
2077,CHI,2021-11-03,98,@,PHI,L 98-103,240,38,82,.463,32,61,.525,6,21,.286,16,18,.889,98,38,77,.494,26,49,.531,12,28,.429,15,21,.714,103
2078,NYK,2021-11-03,98,@,IND,L 98-111,240,36,87,.414,31,63,.492,5,24,.208,21,27,.778,98,42,91,.462,26,50,.520,16,41,.390,11,14,.786,111
2079,IND,2021-10-29,98,@,BRK,L 98-105,240,37,93,.398,29,64,.453,8,29,.276,16,23,.696,98,34,76,.447,28,50,.560,6,26,.231,31,41,.756,105
2080,OKC,2021-10-26,98,,GSW,L 98-106,240,36,86,.419,24,52,.462,12,34,.353,14,17,.824,98,39,83,.470,25,43,.581,14,40,.350,14,18,.778,106
2081,MIN,2021-10-25,98,,NOP,L 98-107,240,31,90,.344,16,40,.400,15,50,.300,21,27,.778,98,39,87,.448,29,57,.509,10,30,.333,19,23,.826,107
2082,WAS,2021-10-20,98,@,TOR,W 98-83,240,36,81,.444,31,54,.574,5,27,.185,21,26,.808,98,30,97,.309,23,63,.365,7,34,.206,16,22,.727,83
2083,PHO,2021-10-20,98,,DEN,L 98-110,240,36,87,.414,22,50,.440,14,37,.378,12,17,.706,98,44,83,.530,27,44,.614,17,39,.436,5,9,.556,110
2084,DEN,2022-04-05,97,,SAS,L 97-116,240,41,98,.418,34,65,.523,7,33,.212,8,12,.667,97,44,89,.494,32,63,.508,12,26,.462,16,24,.667,116
2085,DET,2022-03-25,97,,WAS,L 97-100,240,39,95,.411,33,63,.524,6,32,.188,13,14,.929,97,36,83,.434,27,53,.509,9,30,.300,19,21,.905,100
2086,LAC,2022-03-25,97,,PHI,L 97-122,240,34,85,.400,26,60,.433,8,25,.320,21,25,.840,97,43,92,.467,28,57,.491,15,35,.429,21,24,.875,122
2087,UTA,2022-03-23,97,@,BOS,L 97-125,240,35,88,.398,27,52,.519,8,36,.222,19,21,.905,97,50,84,.595,31,48,.646,19,36,.528,6,7,.857,125
2088,WAS,2022-03-21,97,@,HOU,L 97-115,240,35,85,.412,29,56,.518,6,29,.207,21,24,.875,97,42,85,.494,22,46,.478,20,39,.513,11,13,.846,115
2089,WAS,2022-03-18,97,@,NYK,L 97-100,240,34,79,.430,21,45,.467,13,34,.382,16,21,.762,97,31,90,.344,21,57,.368,10,33,.303,28,36,.778,100
2090,SAC,2022-03-18,97,,BOS,L 97-126,240,33,79,.418,20,43,.465,13,36,.361,18,24,.750,97,46,82,.561,24,42,.571,22,40,.550,12,17,.706,126
2091,LAC,2022-03-08,97,@,GSW,L 97-112,240,33,93,.355,21,54,.389,12,39,.308,19,23,.826,97,44,92,.478,31,58,.534,13,34,.382,11,13,.846,112
2092,TOR,2022-03-04,97,,ORL,L 97-103,240,37,93,.398,25,56,.446,12,37,.324,11,17,.647,97,36,95,.379,25,58,.431,11,37,.297,20,21,.952,103
2093,BRK,2022-02-28,97,,TOR,L 97-133,240,33,86,.384,21,51,.412,12,35,.343,19,24,.792,97,51,99,.515,33,61,.541,18,38,.474,13,22,.591,133
2094,DAL,2022-02-12,97,,LAC,L 97-99,240,35,85,.412,20,46,.435,15,39,.385,12,19,.632,97,43,82,.524,36,60,.600,7,22,.318,6,11,.545,99
2095,NOP,2022-02-10,97,,MIA,L 97-112,240,36,85,.424,25,44,.568,11,41,.268,14,16,.875,97,39,81,.481,29,49,.592,10,32,.313,24,28,.857,112
2096,HOU,2022-02-08,97,@,NOP,L 97-110,240,32,86,.372,19,44,.432,13,42,.310,20,31,.645,97,42,80,.525,34,48,.708,8,32,.250,18,20,.900,110
2097,NOP,2022-01-29,97,,BOS,L 97-107,240,36,82,.439,28,50,.560,8,32,.250,17,23,.739,97,43,81,.531,29,40,.725,14,41,.341,7,11,.636,107
2098,UTA,2022-01-26,97,,PHO,L 97-105,240,34,79,.430,22,49,.449,12,30,.400,17,23,.739,97,40,82,.488,33,64,.516,7,18,.389,18,27,.667,105
2099,CHO,2022-01-17,97,@,NYK,W 97-87,240,36,86,.419,22,47,.468,14,39,.359,11,17,.647,97,32,80,.400,20,46,.435,12,34,.353,11,21,.524,87
2100,DET,2022-01-08,97,,ORL,W 97-92,240,38,87,.437,28,54,.519,10,33,.303,11,16,.688,97,29,86,.337,15,40,.375,14,46,.304,20,23,.870,92
2101,BOS,2022-01-05,97,,SAS,L 97-99,240,40,90,.444,31,62,.500,9,28,.321,8,9,.889,97,42,88,.477,32,62,.516,10,26,.385,5,5,1.000,99
2102,OKC,2021-12-29,97,@,PHO,L 97-115,240,38,96,.396,31,61,.508,7,35,.200,14,16,.875,97,41,89,.461,29,55,.527,12,34,.353,21,28,.750,115
2103,POR,2021-12-21,97,@,NOP,L 97-111,240,35,78,.449,22,44,.500,13,34,.382,14,19,.737,97,42,80,.525,30,47,.638,12,33,.364,15,18,.833,111
2104,NYK,2021-12-12,97,,MIL,L 97-112,240,35,82,.427,18,33,.545,17,49,.347,10,13,.769,97,42,88,.477,28,47,.596,14,41,.341,14,17,.824,112
2105,NOP,2021-12-12,97,@,SAS,L 97-112,240,40,94,.426,32,65,.492,8,29,.276,9,15,.600,97,45,91,.495,38,66,.576,7,25,.280,15,20,.750,112
2106,DEN,2021-12-06,97,@,CHI,L 97-109,240,38,96,.396,27,64,.422,11,32,.344,10,15,.667,97,41,91,.451,28,56,.500,13,35,.371,14,20,.700,109
2107,MEM,2021-12-04,97,@,DAL,W 97-90,240,37,76,.487,28,50,.560,9,26,.346,14,24,.583,97,31,92,.337,16,49,.327,15,43,.349,13,19,.684,90
2108,TOR,2021-12-02,97,,MIL,W 97-93,240,37,88,.420,23,48,.479,14,40,.350,9,14,.643,97,32,85,.376,21,54,.389,11,31,.355,18,25,.720,93
2109,TOR,2021-11-28,97,,BOS,L 97-109,240,35,93,.376,22,51,.431,13,42,.310,14,16,.875,97,34,82,.415,22,48,.458,12,34,.353,29,31,.935,109
2110,TOR,2021-11-26,97,@,IND,L 97-114,240,37,89,.416,30,59,.508,7,30,.233,16,22,.727,97,47,97,.485,36,58,.621,11,39,.282,9,11,.818,114
2111,NYK,2021-11-26,97,,PHO,L 97-118,240,34,92,.370,22,53,.415,12,39,.308,17,22,.773,97,44,79,.557,31,51,.608,13,28,.464,17,21,.810,118
2112,UTA,2021-11-26,97,,NOP,L 97-98,240,36,80,.450,23,47,.489,13,33,.394,12,18,.667,97,38,89,.427,27,62,.435,11,27,.407,11,13,.846,98
2113,LAC,2021-11-21,97,,DAL,W 97-91,240,36,75,.480,24,46,.522,12,29,.414,13,18,.722,97,34,83,.410,28,53,.528,6,30,.200,17,18,.944,91
2114,DEN,2021-11-21,97,@,PHO,L 97-126,240,33,90,.367,22,52,.423,11,38,.289,20,28,.714,97,46,87,.529,35,51,.686,11,36,.306,23,26,.885,126
2115,WAS,2021-11-18,97,@,MIA,L 97-112,240,38,77,.494,23,41,.561,15,36,.417,6,10,.600,97,41,82,.500,31,56,.554,10,26,.385,20,24,.833,112
2116,DET,2021-11-17,97,,IND,W 97-89,240,34,80,.425,26,52,.500,8,28,.286,21,28,.750,97,33,79,.418,24,42,.571,9,37,.243,14,19,.737,89
2117,SAC,2021-11-17,97,@,MIN,L 97-107,240,34,93,.366,24,55,.436,10,38,.263,19,25,.760,97,41,82,.500,31,46,.674,10,36,.278,15,18,.833,107
2118,CHO,2021-11-17,97,,WAS,W 97-87,240,42,96,.438,32,64,.500,10,32,.313,3,6,.500,97,33,90,.367,25,48,.521,8,42,.190,13,16,.813,87
2119,WAS,2021-11-10,97,@,CLE,W 97-94,240,35,84,.417,25,56,.446,10,28,.357,17,17,1.000,97,35,76,.461,26,45,.578,9,31,.290,15,21,.714,94
2120,MIN,2021-11-01,97,,ORL,L 97-115,240,36,97,.371,22,46,.478,14,51,.275,11,19,.579,97,37,82,.451,20,39,.513,17,43,.395,24,30,.800,115
2121,DEN,2021-11-01,97,@,MEM,L 97-106,240,39,88,.443,30,50,.600,9,38,.237,10,15,.667,97,44,97,.454,31,63,.492,13,34,.382,5,7,.714,106
2122,TOR,2021-10-30,97,@,IND,W 97-94,240,39,92,.424,28,60,.467,11,32,.344,8,12,.667,97,35,81,.432,22,38,.579,13,43,.302,11,16,.688,94
2123,HOU,2021-10-24,97,,BOS,L 97-107,240,32,75,.427,18,43,.419,14,32,.438,19,24,.792,97,38,86,.442,23,39,.590,15,47,.319,16,20,.800,107
2124,CHI,2021-10-23,97,,DET,W 97-82,240,35,84,.417,24,58,.414,11,26,.423,16,19,.842,97,34,88,.386,29,60,.483,5,28,.179,9,15,.600,82
2125,ORL,2021-10-20,97,@,SAS,L 97-123,240,35,86,.407,26,57,.456,9,29,.310,18,23,.783,97,49,98,.500,36,68,.529,13,30,.433,12,18,.667,123
2126,NOP,2021-10-20,97,,PHI,L 97-117,240,39,93,.419,26,63,.413,13,30,.433,6,9,.667,97,44,85,.518,31,60,.517,13,25,.520,16,20,.800,117
2127,PHO,2022-04-03,96,@,OKC,L 96-117,240,37,89,.416,30,51,.588,7,38,.184,15,17,.882,96,43,87,.494,26,46,.565,17,41,.415,14,18,.778,117
2128,POR,2022-03-23,96,,SAS,L 96-133,240,36,94,.383,29,68,.426,7,26,.269,17,18,.944,96,46,94,.489,27,50,.540,19,44,.432,22,24,.917,133
2129,TOR,2022-03-06,96,@,CLE,L 96-104,240,37,94,.394,31,70,.443,6,24,.250,16,26,.615,96,39,85,.459,28,49,.571,11,36,.306,15,23,.652,104
2130,ORL,2022-03-05,96,@,MEM,L 96-124,240,37,86,.430,26,51,.510,11,35,.314,11,16,.688,96,46,92,.500,32,58,.552,14,34,.412,18,27,.667,124
2131,LAC,2022-02-15,96,@,PHO,L 96-103,240,40,97,.412,30,62,.484,10,35,.286,6,9,.667,96,44,90,.489,36,65,.554,8,25,.320,7,10,.700,103
2132,OKC,2022-02-04,96,@,POR,W 96-93,240,33,87,.379,18,45,.400,15,42,.357,15,21,.714,96,40,101,.396,34,68,.500,6,33,.182,7,10,.700,93
2133,SAC,2022-01-31,96,@,NYK,L 96-116,240,37,86,.430,26,48,.542,11,38,.289,11,22,.500,96,40,80,.500,27,45,.600,13,35,.371,23,29,.793,116
2134,NYK,2022-01-26,96,@,MIA,L 96-110,240,35,83,.422,20,39,.513,15,44,.341,11,17,.647,96,37,74,.500,21,37,.568,16,37,.432,20,22,.909,110
2135,BRK,2022-01-25,96,,LAL,L 96-106,240,37,88,.420,30,61,.492,7,27,.259,15,22,.682,96,42,89,.472,30,51,.588,12,38,.316,10,10,1.000,106
2136,OKC,2022-01-19,96,@,SAS,L 96-118,240,38,98,.388,30,67,.448,8,31,.258,12,15,.800,96,47,96,.490,32,56,.571,15,40,.375,9,14,.643,118
2137,MIL,2022-01-15,96,,TOR,L 96-103,240,26,77,.338,14,38,.368,12,39,.308,32,35,.914,96,40,91,.440,28,56,.500,12,35,.343,11,20,.550,103
2138,LAL,2022-01-15,96,@,DEN,L 96-133,240,36,82,.439,26,52,.500,10,30,.333,14,19,.737,96,47,91,.516,24,51,.471,23,40,.575,16,17,.941,133
2139,CHI,2022-01-14,96,,GSW,L 96-138,240,37,87,.425,27,49,.551,10,38,.263,12,18,.667,96,53,94,.564,34,52,.654,19,42,.452,13,17,.765,138
2140,SAS,2022-01-10,96,@,NYK,L 96-111,240,39,95,.411,31,66,.470,8,29,.276,10,15,.667,96,40,82,.488,27,50,.540,13,32,.406,18,24,.750,111
2141,GSW,2022-01-09,96,,CLE,W 96-82,240,39,97,.402,29,55,.527,10,42,.238,8,10,.800,96,32,75,.427,25,51,.490,7,24,.292,11,18,.611,82
2142,GSW,2022-01-06,96,@,NOP,L 96-101,240,37,87,.425,30,54,.556,7,33,.212,15,18,.833,96,35,83,.422,27,49,.551,8,34,.235,23,29,.793,101
2143,SAC,2021-12-31,96,,DAL,L 96-112,240,38,91,.418,28,62,.452,10,29,.345,10,12,.833,96,42,81,.519,33,59,.559,9,22,.409,19,22,.864,112
2144,NYK,2021-12-28,96,@,MIN,W 96-88,240,37,90,.411,21,50,.420,16,40,.400,6,16,.375,96,34,85,.400,27,47,.574,7,38,.184,13,20,.650,88
2145,WAS,2021-12-26,96,,PHI,L 96-117,240,35,90,.389,27,57,.474,8,33,.242,18,28,.643,96,43,86,.500,31,55,.564,12,31,.387,19,22,.864,117
2146,PHI,2021-12-23,96,,ATL,L 96-98,240,33,80,.413,27,53,.509,6,27,.222,24,26,.923,96,37,82,.451,30,58,.517,7,24,.292,17,19,.895,98
2147,IND,2021-12-21,96,@,MIA,L 96-125,240,31,87,.356,20,56,.357,11,31,.355,23,28,.821,96,47,95,.495,25,46,.543,22,49,.449,9,11,.818,125
2148,PHI,2021-12-15,96,,MIA,L 96-101,240,35,79,.443,23,42,.548,12,37,.324,14,17,.824,96,35,78,.449,17,34,.500,18,44,.409,13,17,.765,101
2149,NYK,2021-12-14,96,,GSW,L 96-105,240,30,83,.361,14,41,.341,16,42,.381,20,22,.909,96,35,77,.455,20,37,.541,15,40,.375,20,27,.741,105
2150,CHO,2021-12-13,96,@,DAL,L 96-120,240,34,86,.395,21,49,.429,13,37,.351,15,24,.625,96,43,83,.518,24,42,.571,19,41,.463,15,17,.882,120
2151,PHI,2021-12-09,96,,UTA,L 96-118,240,38,88,.432,32,55,.582,6,33,.182,14,15,.933,96,43,91,.473,28,51,.549,15,40,.375,17,24,.708,118
2152,MEM,2021-12-08,96,,DAL,L 96-104,240,36,90,.400,27,59,.458,9,31,.290,15,25,.600,96,37,77,.481,25,44,.568,12,33,.364,18,23,.783,104
2153,PHO,2021-12-03,96,@,GSW,L 96-118,240,31,81,.383,23,59,.390,8,22,.364,26,35,.743,96,45,92,.489,26,53,.491,19,39,.487,9,12,.750,118
2154,ATL,2021-12-03,96,,PHI,L 96-98,240,31,76,.408,21,48,.438,10,28,.357,24,30,.800,96,38,81,.469,29,59,.492,9,22,.409,13,17,.765,98
2155,GSW,2021-11-30,96,@,PHO,L 96-104,240,36,86,.419,22,46,.478,14,40,.350,10,14,.714,96,43,87,.494,31,57,.544,12,30,.400,6,11,.545,104
2156,ORL,2021-11-29,96,@,PHI,L 96-101,240,37,90,.411,29,57,.509,8,33,.242,14,18,.778,96,39,97,.402,29,64,.453,10,33,.303,13,18,.722,101
2157,DAL,2021-11-29,96,,CLE,L 96-114,240,39,89,.438,27,50,.540,12,39,.308,6,15,.400,96,45,80,.563,35,61,.574,10,19,.526,14,18,.778,114
2158,SAS,2021-11-26,96,,BOS,W 96-88,240,38,87,.437,32,63,.508,6,24,.250,14,19,.737,96,34,92,.370,24,58,.414,10,34,.294,10,15,.667,88
2159,DET,2021-11-26,96,@,LAC,L 96-107,240,33,90,.367,25,57,.439,8,33,.242,22,26,.846,96,39,91,.429,28,53,.528,11,38,.289,18,19,.947,107
2160,PHI,2021-11-24,96,@,GSW,L 96-116,240,34,80,.425,26,52,.500,8,28,.286,20,22,.909,96,42,80,.525,27,42,.643,15,38,.395,17,24,.708,116
2161,NOP,2021-11-22,96,,MIN,L 96-110,240,37,88,.420,31,56,.554,6,32,.188,16,18,.889,96,40,100,.400,30,56,.536,10,44,.227,20,28,.714,110
2162,MIL,2021-11-19,96,,OKC,W 96-89,240,31,83,.373,19,42,.452,12,41,.293,22,26,.846,96,32,91,.352,20,43,.465,12,48,.250,13,21,.619,89
2163,MIN,2021-11-15,96,,PHO,L 96-99,240,31,85,.365,18,41,.439,13,44,.295,21,27,.778,96,32,85,.376,25,54,.463,7,31,.226,28,36,.778,99
2164,OKC,2021-11-14,96,,BRK,L 96-120,240,36,90,.400,22,45,.489,14,45,.311,10,11,.909,96,41,82,.500,23,39,.590,18,43,.419,20,21,.952,120
2165,ATL,2021-11-12,96,@,DEN,L 96-105,240,38,93,.409,33,65,.508,5,28,.179,15,21,.714,96,40,90,.444,30,55,.545,10,35,.286,15,20,.750,105
2166,NYK,2021-11-12,96,@,CHO,L 96-104,240,36,93,.387,23,58,.397,13,35,.371,11,18,.611,96,39,90,.433,29,54,.537,10,36,.278,16,24,.667,104
2167,MIA,2021-11-08,96,@,DEN,L 96-113,240,31,78,.397,18,42,.429,13,36,.361,21,25,.840,96,42,91,.462,30,50,.600,12,41,.293,17,24,.708,113
2168,PHI,2021-11-08,96,,NYK,L 96-103,240,35,91,.385,22,51,.431,13,40,.325,13,16,.813,96,40,91,.440,27,51,.529,13,40,.325,10,13,.769,103
2169,BRK,2021-11-05,96,@,DET,W 96-90,240,36,80,.450,25,53,.472,11,27,.407,13,14,.929,96,33,87,.379,22,53,.415,11,34,.324,13,18,.722,90
2170,MEM,2021-10-27,96,@,POR,L 96-116,240,35,96,.365,18,46,.391,17,50,.340,9,19,.474,96,39,84,.464,24,48,.500,15,36,.417,23,31,.742,116
2171,MIN,2021-10-23,96,,NOP,W 96-89,240,39,96,.406,27,58,.466,12,38,.316,6,10,.600,96,31,89,.348,22,49,.449,9,40,.225,18,23,.783,89
2172,SAS,2021-10-22,96,@,DEN,L 96-102,240,40,84,.476,34,60,.567,6,24,.250,10,14,.714,96,44,86,.512,35,56,.625,9,30,.300,5,8,.625,102
2173,ORL,2021-10-22,96,,NYK,L 96-121,240,33,83,.398,16,40,.400,17,43,.395,13,15,.867,96,44,88,.500,20,34,.588,24,54,.444,9,17,.529,121
2174,GSW,2022-03-28,95,@,MEM,L 95-123,240,33,81,.407,24,52,.462,9,29,.310,20,26,.769,95,43,92,.467,31,62,.500,12,30,.400,25,35,.714,123
2175,MIA,2022-03-26,95,,BRK,L 95-110,240,33,75,.440,23,41,.561,10,34,.294,19,26,.731,95,39,83,.470,28,50,.560,11,33,.333,21,26,.808,110
2176,DAL,2022-03-25,95,@,MIN,L 95-116,240,35,90,.389,25,47,.532,10,43,.233,15,19,.789,95,43,84,.512,32,52,.615,11,32,.344,19,24,.792,116
2177,DAL,2022-03-13,95,@,BOS,W 95-92,240,33,74,.446,18,37,.486,15,37,.405,14,19,.737,95,33,88,.375,24,51,.471,9,37,.243,17,19,.895,92
2178,SAC,2022-03-02,95,@,NOP,L 95-125,240,35,89,.393,27,54,.500,8,35,.229,17,25,.680,95,52,88,.591,41,59,.695,11,29,.379,10,12,.833,125
2179,LAL,2022-02-27,95,,NOP,L 95-123,240,35,84,.417,28,50,.560,7,34,.206,18,20,.900,95,47,92,.511,34,62,.548,13,30,.433,16,25,.640,123
2180,POR,2022-02-24,95,,GSW,L 95-132,240,31,79,.392,22,44,.500,9,35,.257,24,29,.828,95,45,88,.511,30,47,.638,15,41,.366,27,32,.844,132
2181,ATL,2022-02-13,95,@,BOS,L 95-105,240,34,93,.366,22,55,.400,12,38,.316,15,15,1.000,95,36,85,.424,25,47,.532,11,38,.289,22,27,.815,105
2182,POR,2022-02-08,95,,ORL,L 95-113,240,32,91,.352,21,53,.396,11,38,.289,20,26,.769,95,44,90,.489,25,52,.481,19,38,.500,6,8,.750,113
2183,PHO,2022-02-05,95,@,WAS,W 95-80,240,40,99,.404,32,68,.471,8,31,.258,7,14,.500,95,30,85,.353,25,61,.410,5,24,.208,15,19,.789,80
2184,SAS,2022-02-03,95,,MIA,L 95-112,240,30,80,.375,22,47,.468,8,33,.242,27,38,.711,95,42,83,.506,30,53,.566,12,30,.400,16,18,.889,112
2185,WAS,2022-01-29,95,@,MEM,L 95-115,240,35,84,.417,25,55,.455,10,29,.345,15,21,.714,95,46,100,.460,33,69,.478,13,31,.419,10,12,.833,115
2186,CLE,2022-01-24,95,,NYK,W 95-93,240,35,81,.432,22,45,.489,13,36,.361,12,20,.600,95,35,84,.417,23,46,.500,12,38,.316,11,21,.524,93
2187,CHI,2022-01-23,95,@,ORL,L 95-114,240,33,76,.434,28,55,.509,5,21,.238,24,32,.750,95,42,80,.525,30,54,.556,12,26,.462,18,23,.783,114
2188,UTA,2022-01-17,95,@,LAL,L 95-101,240,31,83,.373,19,37,.514,12,46,.261,21,24,.875,95,38,86,.442,27,49,.551,11,37,.297,14,23,.609,101
2189,TOR,2022-01-11,95,,PHO,L 95-99,240,36,89,.404,28,52,.538,8,37,.216,15,25,.600,95,35,74,.473,24,42,.571,11,32,.344,18,22,.818,99
2190,OKC,2022-01-09,95,,DEN,L 95-99,240,38,88,.432,29,50,.580,9,38,.237,10,12,.833,95,37,89,.416,24,53,.453,13,36,.361,12,16,.750,99
2191,DAL,2022-01-02,95,@,OKC,W 95-86,240,38,85,.447,24,46,.522,14,39,.359,5,7,.714,95,35,85,.412,25,55,.455,10,30,.333,6,9,.667,86
2192,OKC,2021-12-31,95,,NYK,W 95-80,240,36,87,.414,18,44,.409,18,43,.419,5,7,.714,95,30,81,.370,22,40,.550,8,41,.195,12,22,.545,80
2193,SAC,2021-12-29,95,,DAL,W 95-94,240,36,75,.480,26,49,.531,10,26,.385,13,15,.867,95,38,81,.469,29,57,.509,9,24,.375,9,13,.692,94
2194,DAL,2021-12-23,95,,MIL,L 95-102,240,35,86,.407,23,41,.561,12,45,.267,13,17,.765,95,37,82,.451,27,46,.587,10,36,.278,18,22,.818,102
2195,PHO,2021-12-13,95,@,LAC,L 95-111,240,36,96,.375,29,67,.433,7,29,.241,16,19,.842,95,43,78,.551,34,57,.596,9,21,.429,16,23,.696,111
2196,OKC,2021-12-10,95,,LAL,L 95-116,240,38,96,.396,28,52,.538,10,44,.227,9,14,.643,95,41,87,.471,22,45,.489,19,42,.452,15,20,.750,116
2197,LAL,2021-12-09,95,@,MEM,L 95-108,240,36,78,.462,24,48,.500,12,30,.400,11,17,.647,95,41,94,.436,27,52,.519,14,42,.333,12,18,.667,108
2198,ORL,2021-12-06,95,@,GSW,L 95-126,240,33,76,.434,22,38,.579,11,38,.289,18,22,.818,95,43,87,.494,23,47,.489,20,40,.500,20,29,.690,126
2199,MEM,2021-11-20,95,@,MIN,L 95-138,240,29,83,.349,20,51,.392,9,32,.281,28,35,.800,95,49,91,.538,29,50,.580,20,41,.488,20,28,.714,138
2200,POR,2021-11-14,95,@,DEN,L 95-124,240,35,80,.438,22,41,.537,13,39,.333,12,13,.923,95,47,90,.522,28,50,.560,19,40,.475,11,14,.786,124
2201,BRK,2021-11-08,95,@,CHI,L 95-118,240,34,86,.395,23,53,.434,11,33,.333,16,19,.842,95,46,98,.469,37,67,.552,9,31,.290,17,20,.850,118
2202,DEN,2021-11-06,95,,HOU,W 95-94,240,36,89,.404,27,49,.551,9,40,.225,14,17,.824,95,35,75,.467,27,47,.574,8,28,.286,16,24,.667,94
2203,BOS,2021-11-04,95,@,MIA,W 95-78,240,31,78,.397,15,37,.405,16,41,.390,17,20,.850,95,28,81,.346,19,40,.475,9,41,.220,13,19,.684,78
2204,LAL,2021-10-31,95,,HOU,W 95-85,240,39,96,.406,30,65,.462,9,31,.290,8,13,.615,95,32,76,.421,26,48,.542,6,28,.214,15,29,.517,85
2205,MIL,2021-10-31,95,,UTA,L 95-107,240,39,96,.406,27,55,.491,12,41,.293,5,6,.833,95,35,75,.467,23,38,.605,12,37,.324,25,27,.926,107
2206,BRK,2021-10-24,95,,CHO,L 95-111,240,38,87,.437,29,52,.558,9,35,.257,10,12,.833,95,43,94,.457,33,64,.516,10,30,.333,15,19,.789,111
2207,ATL,2021-10-23,95,@,CLE,L 95-101,240,38,99,.384,28,65,.431,10,34,.294,9,15,.600,95,37,89,.416,30,61,.492,7,28,.250,20,27,.741,101
2208,TOR,2021-10-23,95,,DAL,L 95-103,240,34,85,.400,23,48,.479,11,37,.297,16,23,.696,95,38,91,.418,24,49,.490,14,42,.333,13,18,.722,103
2209,MIL,2021-10-21,95,@,MIA,L 95-137,240,32,84,.381,20,42,.476,12,42,.286,19,29,.655,95,51,96,.531,36,61,.590,15,35,.429,20,31,.645,137
2210,TOR,2022-04-10,94,@,NYK,L 94-105,240,36,92,.391,24,50,.480,12,42,.286,10,11,.909,94,40,87,.460,25,44,.568,15,43,.349,10,12,.833,105
2211,SAS,2022-04-09,94,,GSW,L 94-100,240,32,80,.400,22,49,.449,10,31,.323,20,27,.741,94,33,81,.407,25,49,.510,8,32,.250,26,33,.788,100
2212,POR,2022-04-07,94,@,NOP,L 94-127,240,36,69,.522,25,38,.658,11,31,.355,11,13,.846,94,44,93,.473,31,56,.554,13,37,.351,26,31,.839,127
2213,CHI,2022-04-06,94,,BOS,L 94-117,240,35,80,.438,28,57,.491,7,23,.304,17,23,.739,94,43,88,.489,26,51,.510,17,37,.459,14,22,.636,117
2214,POR,2022-04-05,94,@,OKC,L 94-98,240,35,83,.422,24,51,.471,11,32,.344,13,16,.813,94,39,81,.481,30,52,.577,9,29,.310,11,22,.500,98
2215,PHI,2022-03-31,94,@,DET,L 94-102,240,31,69,.449,24,43,.558,7,26,.269,25,28,.893,94,41,82,.500,31,47,.660,10,35,.286,10,15,.667,102
2216,WAS,2022-03-29,94,,CHI,L 94-107,240,38,79,.481,32,53,.604,6,26,.231,12,17,.706,94,43,85,.506,37,67,.552,6,18,.333,15,18,.833,107
2217,CLE,2022-03-26,94,,CHI,L 94-98,240,34,82,.415,27,51,.529,7,31,.226,19,27,.704,94,36,75,.480,31,54,.574,5,21,.238,21,25,.840,98
2218,ORL,2022-03-22,94,,GSW,W 94-90,240,34,79,.430,24,43,.558,10,36,.278,16,20,.800,94,34,85,.400,23,53,.434,11,32,.344,11,16,.688,90
2219,DET,2022-02-14,94,@,WAS,L 94-103,240,32,85,.376,24,62,.387,8,23,.348,22,27,.815,94,40,85,.471,31,56,.554,9,29,.310,14,18,.778,103
2220,ATL,2022-02-06,94,@,DAL,L 94-103,240,37,95,.389,32,70,.457,5,25,.200,15,16,.938,94,38,88,.432,22,52,.423,16,36,.444,11,13,.846,103
2221,POR,2022-02-02,94,@,LAL,L 94-99,240,35,98,.357,21,56,.375,14,42,.333,10,19,.526,94,33,78,.423,22,48,.458,11,30,.367,22,33,.667,99
2222,GSW,2022-01-23,94,,UTA,W 94-92,240,36,83,.434,23,41,.561,13,42,.310,9,10,.900,94,31,81,.383,20,46,.435,11,35,.314,19,23,.826,92
2223,CLE,2022-01-22,94,,OKC,W 94-87,240,35,76,.461,29,49,.592,6,27,.222,18,35,.514,94,33,85,.388,21,44,.477,12,41,.293,9,16,.563,87
2224,MIL,2022-01-21,94,,CHI,W 94-90,240,34,88,.386,28,57,.491,6,31,.194,20,28,.714,94,31,85,.365,24,47,.511,7,38,.184,21,24,.875,90
2225,LAC,2022-01-15,94,@,SAS,L 94-101,240,38,100,.380,26,62,.419,12,38,.316,6,8,.750,94,34,83,.410,23,46,.500,11,37,.297,22,27,.815,101
2226,IND,2022-01-14,94,,PHO,L 94-112,240,34,88,.386,21,45,.467,13,43,.302,13,18,.722,94,40,88,.455,29,60,.483,11,28,.393,21,23,.913,112
2227,IND,2022-01-04,94,@,NYK,L 94-104,240,32,76,.421,23,38,.605,9,38,.237,21,32,.656,94,39,80,.488,33,52,.635,6,28,.214,20,28,.714,104
2228,DAL,2021-12-29,94,@,SAC,L 94-95,240,38,81,.469,29,57,.509,9,24,.375,9,13,.692,94,36,75,.480,26,49,.531,10,26,.385,13,15,.867,95
2229,NYK,2021-12-29,94,@,DET,W 94-85,240,31,81,.383,23,50,.460,8,31,.258,24,27,.889,94,30,81,.370,18,46,.391,12,35,.343,13,17,.765,85
2230,DEN,2021-12-22,94,@,OKC,L 94-108,240,33,84,.393,20,40,.500,13,44,.295,15,26,.577,94,42,94,.447,34,60,.567,8,34,.235,16,19,.842,108
2231,MIA,2021-12-13,94,@,CLE,L 94-105,240,38,85,.447,25,45,.556,13,40,.325,5,9,.556,94,36,81,.444,20,45,.444,16,36,.444,17,18,.944,105
2232,ORL,2021-12-12,94,@,LAL,L 94-106,240,33,88,.375,20,50,.400,13,38,.342,15,19,.789,94,41,84,.488,28,56,.500,13,28,.464,11,17,.647,106
2233,POR,2021-12-08,94,@,GSW,L 94-104,240,33,80,.413,25,50,.500,8,30,.267,20,28,.714,94,33,83,.398,19,37,.514,14,46,.304,24,31,.774,104
2234,SAC,2021-11-22,94,,PHI,L 94-102,240,33,80,.413,26,49,.531,7,31,.226,21,29,.724,94,36,85,.424,27,53,.509,9,32,.281,21,27,.778,102
2235,NOP,2021-11-20,94,@,IND,L 94-111,240,35,88,.398,29,70,.414,6,18,.333,18,19,.947,94,42,91,.462,28,53,.528,14,38,.368,13,18,.722,111
2236,NOP,2021-11-19,94,,LAC,W 94-81,240,38,87,.437,25,57,.439,13,30,.433,5,8,.625,94,34,90,.378,25,53,.472,9,37,.243,4,5,.800,81
2237,MEM,2021-11-12,94,,PHO,L 94-119,240,37,98,.378,30,65,.462,7,33,.212,13,23,.565,94,46,94,.489,28,57,.491,18,37,.486,9,9,1.000,119
2238,CLE,2021-11-10,94,,WAS,L 94-97,240,35,76,.461,26,45,.578,9,31,.290,15,21,.714,94,35,84,.417,25,56,.446,10,28,.357,17,17,1.000,97
2239,SAS,2021-11-07,94,@,OKC,L 94-99,240,41,100,.410,35,70,.500,6,30,.200,6,9,.667,94,35,94,.372,23,52,.442,12,42,.286,17,20,.850,99
2240,MIL,2021-11-07,94,@,WAS,L 94-101,240,37,94,.394,27,58,.466,10,36,.278,10,18,.556,94,41,81,.506,30,54,.556,11,27,.407,8,13,.615,101
2241,IND,2021-11-07,94,@,SAC,W 94-91,240,37,83,.446,31,58,.534,6,25,.240,14,18,.778,94,31,84,.369,21,50,.420,10,34,.294,19,22,.864,91
2242,HOU,2021-11-06,94,@,DEN,L 94-95,240,35,75,.467,27,47,.574,8,28,.286,16,24,.667,94,36,89,.404,27,49,.551,9,40,.225,14,17,.824,95
2243,OKC,2021-11-01,94,@,LAC,L 94-99,240,35,90,.389,24,53,.453,11,37,.297,13,16,.813,94,35,92,.380,20,50,.400,15,42,.357,14,19,.737,99
2244,IND,2021-10-30,94,,TOR,L 94-97,240,35,81,.432,22,38,.579,13,43,.302,11,16,.688,94,39,92,.424,28,60,.467,11,32,.344,8,12,.667,97
2245,ATL,2021-10-30,94,@,PHI,L 94-122,240,36,95,.379,28,73,.384,8,22,.364,14,19,.737,94,46,86,.535,34,48,.708,12,38,.316,18,19,.947,122
2246,CHI,2021-10-20,94,@,DET,W 94-88,240,37,86,.430,30,63,.476,7,23,.304,13,15,.867,94,36,90,.400,30,62,.484,6,28,.214,10,13,.769,88
2247,NYK,2022-03-20,93,,UTA,L 93-108,240,31,83,.373,15,43,.349,16,40,.400,15,21,.714,93,34,74,.459,17,28,.607,17,46,.370,23,29,.793,108
2248,TOR,2022-03-20,93,@,PHI,W 93-88,240,35,93,.376,28,67,.418,7,26,.269,16,23,.696,93,30,73,.411,23,46,.500,7,27,.259,21,28,.750,88
2249,LAC,2022-03-06,93,,NYK,L 93-116,240,33,88,.375,22,54,.407,11,34,.324,16,22,.727,93,42,89,.472,29,60,.483,13,29,.448,19,30,.633,116
2250,TOR,2022-02-25,93,@,CHO,L 93-125,240,37,84,.440,31,61,.508,6,23,.261,13,23,.565,93,52,94,.553,37,54,.685,15,40,.375,6,9,.667,125
2251,CLE,2022-02-12,93,@,PHI,L 93-103,240,36,77,.468,28,53,.528,8,24,.333,13,15,.867,93,38,79,.481,28,57,.491,10,22,.455,17,21,.810,103
2252,POR,2022-02-04,93,,OKC,L 93-96,240,40,101,.396,34,68,.500,6,33,.182,7,10,.700,93,33,87,.379,18,45,.400,15,42,.357,15,21,.714,96
2253,DET,2022-02-04,93,,BOS,L 93-102,240,34,104,.327,24,78,.308,10,26,.385,15,20,.750,93,37,82,.451,28,54,.519,9,28,.321,19,25,.760,102
2254,CLE,2022-01-31,93,,NOP,W 93-90,240,36,84,.429,27,53,.509,9,31,.290,12,14,.857,93,33,85,.388,27,55,.491,6,30,.200,18,21,.857,90
2255,NYK,2022-01-24,93,@,CLE,L 93-95,240,35,84,.417,23,46,.500,12,38,.316,11,21,.524,93,35,81,.432,22,45,.489,13,36,.361,12,20,.600,95
2256,ATL,2022-01-09,93,@,LAC,L 93-106,240,35,78,.449,28,52,.538,7,26,.269,16,19,.842,93,44,92,.478,32,59,.542,12,33,.364,6,7,.857,106
2257,CLE,2021-12-30,93,@,WAS,L 93-110,240,35,83,.422,27,55,.491,8,28,.286,15,23,.652,93,45,90,.500,36,61,.590,9,29,.310,11,17,.647,110
2258,MIA,2021-12-26,93,,ORL,W 93-83,240,36,89,.404,26,55,.473,10,34,.294,11,18,.611,93,31,72,.431,21,40,.525,10,32,.313,11,17,.647,83
2259,BRK,2021-12-18,93,,ORL,L 93-100,240,39,102,.382,30,56,.536,9,46,.196,6,8,.750,93,39,94,.415,29,63,.460,10,31,.323,12,13,.923,100
2260,GSW,2021-12-11,93,@,PHI,L 93-102,240,34,85,.400,22,37,.595,12,48,.250,13,18,.722,93,35,76,.461,26,49,.531,9,27,.333,23,26,.885,102
2261,DAL,2021-12-10,93,@,IND,L 93-106,240,39,84,.464,35,55,.636,4,29,.138,11,12,.917,93,41,87,.471,28,51,.549,13,36,.361,11,12,.917,106
2262,DET,2021-12-10,93,@,NOP,L 93-109,240,35,90,.389,23,53,.434,12,37,.324,11,12,.917,93,41,95,.432,28,58,.483,13,37,.351,14,16,.875,109
2263,MIL,2021-12-02,93,@,TOR,L 93-97,240,32,85,.376,21,54,.389,11,31,.355,18,25,.720,93,37,88,.420,23,48,.479,14,40,.350,9,14,.643,97
2264,DET,2021-11-24,93,@,MIL,L 93-114,240,34,95,.358,23,50,.460,11,45,.244,14,19,.737,93,42,87,.483,27,51,.529,15,36,.417,15,17,.882,114
2265,CHI,2021-11-12,93,@,GSW,L 93-119,240,34,78,.436,26,51,.510,8,27,.296,17,22,.773,93,45,93,.484,30,47,.638,15,46,.326,14,16,.875,119
2266,DEN,2021-10-30,93,@,MIN,W 93-91,240,36,88,.409,27,51,.529,9,37,.243,12,16,.750,93,35,89,.393,22,48,.458,13,41,.317,8,9,.889,91
2267,MIL,2021-10-30,93,,SAS,L 93-102,240,36,89,.404,26,50,.520,10,39,.256,11,16,.688,93,39,95,.411,32,64,.500,7,31,.226,17,24,.708,102
2268,BRK,2021-10-27,93,,MIA,L 93-106,240,33,85,.388,19,42,.452,14,43,.326,13,14,.929,93,38,96,.396,30,67,.448,8,29,.276,22,26,.846,106
2269,WAS,2022-04-08,92,,NYK,L 92-114,240,35,69,.507,26,41,.634,9,28,.321,13,17,.765,92,41,88,.466,25,49,.510,16,39,.410,16,20,.800,114
2270,POR,2022-04-03,92,@,SAS,L 92-113,240,33,84,.393,17,39,.436,16,45,.356,10,15,.667,92,38,84,.452,24,42,.571,14,42,.333,23,30,.767,113
2271,LAC,2022-03-18,92,@,UTA,L 92-121,240,31,86,.360,20,51,.392,11,35,.314,19,21,.905,92,47,97,.485,31,53,.585,16,44,.364,11,14,.786,121
2272,BOS,2022-03-13,92,,DAL,L 92-95,240,33,88,.375,24,51,.471,9,37,.243,17,19,.895,92,33,74,.446,18,37,.486,15,37,.405,14,19,.737,95
2273,POR,2022-02-27,92,,DEN,L 92-124,240,34,91,.374,28,55,.509,6,36,.167,18,26,.692,92,44,86,.512,32,49,.653,12,37,.324,24,31,.774,124
2274,CLE,2022-02-26,92,,WAS,W 92-86,240,32,83,.386,24,58,.414,8,25,.320,20,24,.833,92,35,81,.432,24,58,.414,11,23,.478,5,6,.833,86
2275,SAS,2022-02-09,92,@,CLE,L 92-105,240,38,99,.384,30,66,.455,8,33,.242,8,11,.727,92,39,82,.476,30,61,.492,9,21,.429,18,24,.750,105
2276,MIA,2022-01-31,92,@,BOS,L 92-122,240,34,87,.391,17,43,.395,17,44,.386,7,10,.700,92,44,84,.524,28,42,.667,16,42,.381,18,27,.667,122
2277,BOS,2022-01-28,92,@,ATL,L 92-108,240,30,86,.349,23,50,.460,7,36,.194,25,27,.926,92,41,89,.461,29,58,.500,12,31,.387,14,20,.700,108
2278,DAL,2022-01-25,92,@,GSW,L 92-130,240,32,91,.352,22,51,.431,10,40,.250,18,18,1.000,92,49,92,.533,32,49,.653,17,43,.395,15,18,.833,130
2279,UTA,2022-01-23,92,@,GSW,L 92-94,240,31,81,.383,20,46,.435,11,35,.314,19,23,.826,92,36,83,.434,23,41,.561,13,42,.310,9,10,.900,94
2280,POR,2022-01-19,92,@,MIA,L 92-104,240,33,81,.407,19,35,.543,14,46,.304,12,16,.750,92,37,80,.463,25,45,.556,12,35,.343,18,25,.720,104
2281,NOP,2022-01-17,92,@,BOS,L 92-104,240,36,87,.414,27,57,.474,9,30,.300,11,18,.611,92,38,80,.475,28,48,.583,10,32,.313,18,20,.900,104
2282,ORL,2022-01-15,92,@,DAL,L 92-108,240,37,77,.481,30,51,.588,7,26,.269,11,16,.688,92,32,78,.410,20,44,.455,12,34,.353,32,38,.842,108
2283,ORL,2022-01-08,92,@,DET,L 92-97,240,29,86,.337,15,40,.375,14,46,.304,20,23,.870,92,38,87,.437,28,54,.519,10,33,.303,11,16,.688,97
2284,LAC,2021-12-20,92,,SAS,L 92-116,240,34,87,.391,25,55,.455,9,32,.281,15,20,.750,92,50,114,.439,38,77,.494,12,37,.324,4,6,.667,116
2285,LAL,2021-12-17,92,@,MIN,L 92-110,240,30,78,.385,18,35,.514,12,43,.279,20,29,.690,92,41,98,.418,29,54,.537,12,44,.273,16,24,.667,110
2286,CHI,2021-12-11,92,@,MIA,L 92-118,240,31,83,.373,14,43,.326,17,40,.425,13,20,.650,92,46,93,.495,27,50,.540,19,43,.442,7,9,.778,118
2287,CHI,2021-12-08,92,@,CLE,L 92-115,240,35,84,.417,28,58,.483,7,26,.269,15,21,.714,92,44,80,.550,31,52,.596,13,28,.464,14,16,.875,115
2288,SAC,2021-11-30,92,,LAL,L 92-117,240,35,79,.443,29,50,.580,6,29,.207,16,22,.727,92,46,92,.500,35,64,.547,11,28,.393,14,20,.700,117
2289,DET,2021-11-30,92,@,POR,L 92-110,240,29,76,.382,20,41,.488,9,35,.257,25,30,.833,92,41,96,.427,27,54,.500,14,42,.333,14,18,.778,110
2290,ORL,2021-11-27,92,@,CLE,L 92-105,240,35,88,.398,27,56,.482,8,32,.250,14,23,.609,92,41,90,.456,27,51,.529,14,39,.359,9,12,.750,105
2291,DET,2021-11-23,92,,MIA,L 92-100,240,35,84,.417,25,46,.543,10,38,.263,12,14,.857,92,35,76,.461,26,47,.553,9,29,.310,21,29,.724,100
2292,ORL,2021-11-22,92,@,MIL,L 92-123,240,34,93,.366,23,52,.442,11,41,.268,13,18,.722,92,44,94,.468,26,49,.531,18,45,.400,17,24,.708,123
2293,SAS,2021-11-16,92,@,LAC,L 92-106,240,41,95,.432,36,73,.493,5,22,.227,5,7,.714,92,37,85,.435,25,47,.532,12,38,.316,20,22,.909,106
2294,NYK,2021-11-15,92,,IND,W 92-84,240,37,86,.430,26,52,.500,11,34,.324,7,10,.700,92,32,86,.372,24,49,.490,8,37,.216,12,16,.750,84
2295,CLE,2021-11-15,92,,BOS,L 92-98,240,32,83,.386,16,43,.372,16,40,.400,12,16,.750,92,36,78,.462,26,49,.531,10,29,.345,16,20,.800,98
2296,ORL,2021-11-13,92,,WAS,L 92-104,240,31,92,.337,18,52,.346,13,40,.325,17,20,.850,92,42,84,.500,30,49,.612,12,35,.343,8,10,.800,104
2297,HOU,2021-11-12,92,,POR,L 92-104,240,34,85,.400,27,53,.509,7,32,.219,17,27,.630,92,34,87,.391,23,51,.451,11,36,.306,25,31,.806,104
2298,NOP,2021-11-08,92,@,DAL,L 92-108,240,37,87,.425,28,53,.528,9,34,.265,9,11,.818,92,43,85,.506,29,50,.580,14,35,.400,8,13,.615,108
2299,BOS,2021-11-03,92,@,ORL,W 92-79,240,33,79,.418,23,42,.548,10,37,.270,16,25,.640,92,27,84,.321,18,41,.439,9,43,.209,16,20,.800,79
2300,CHO,2021-11-03,92,@,GSW,L 92-114,240,34,91,.374,24,55,.436,10,36,.278,14,19,.737,92,42,86,.488,24,41,.585,18,45,.400,12,18,.667,114
2301,CLE,2021-10-30,92,@,PHO,L 92-101,240,36,91,.396,22,47,.468,14,44,.318,6,7,.857,92,39,84,.464,33,58,.569,6,26,.231,17,27,.630,101
2302,LAC,2021-10-29,92,@,POR,L 92-111,240,34,87,.391,19,45,.422,15,42,.357,9,16,.563,92,41,98,.418,22,57,.386,19,41,.463,10,16,.625,111
2303,CLE,2021-10-27,92,@,LAC,W 92-79,240,33,81,.407,30,61,.492,3,20,.150,23,27,.852,92,31,87,.356,22,46,.478,9,41,.220,8,13,.615,79
2304,IND,2022-03-26,91,@,TOR,L 91-131,240,33,79,.418,22,43,.512,11,36,.306,14,20,.700,91,51,84,.607,36,52,.692,15,32,.469,14,19,.737,131
2305,HOU,2022-03-23,91,@,DAL,L 91-110,240,33,82,.402,29,54,.537,4,28,.143,21,28,.750,91,42,86,.488,34,53,.642,8,33,.242,18,22,.818,110
2306,SAS,2022-03-18,91,,NOP,L 91-124,240,32,89,.360,21,45,.467,11,44,.250,16,20,.800,91,48,96,.500,34,62,.548,14,34,.412,14,18,.778,124
2307,CLE,2022-03-12,91,@,CHI,L 91-101,240,36,86,.419,31,62,.500,5,24,.208,14,17,.824,91,39,88,.443,30,67,.448,9,21,.429,14,15,.933,101
2308,MIN,2022-02-16,91,,TOR,L 91-103,240,30,77,.390,20,35,.571,10,42,.238,21,29,.724,91,40,88,.455,32,63,.508,8,25,.320,15,19,.789,103
2309,BRK,2022-02-08,91,,BOS,L 91-126,240,38,99,.384,28,63,.444,10,36,.278,5,13,.385,91,50,91,.549,36,51,.706,14,40,.350,12,16,.750,126
2310,CHO,2022-01-23,91,,ATL,L 91-113,240,34,87,.391,30,51,.588,4,36,.111,19,27,.704,91,40,88,.455,25,49,.510,15,39,.385,18,24,.750,113
2311,MEM,2022-01-23,91,@,DAL,L 91-104,240,37,99,.374,33,75,.440,4,24,.167,13,19,.684,91,36,74,.486,27,44,.614,9,30,.300,23,31,.742,104
2312,NYK,2022-01-20,91,,NOP,L 91-102,240,29,77,.377,20,39,.513,9,38,.237,24,36,.667,91,38,76,.500,27,48,.563,11,28,.393,15,22,.682,102
2313,UTA,2022-01-12,91,,CLE,L 91-111,240,34,85,.400,18,38,.474,16,47,.340,7,11,.636,91,43,81,.531,32,51,.627,11,30,.367,14,17,.824,111
2314,ATL,2022-01-12,91,,MIA,L 91-115,240,31,82,.378,18,37,.486,13,45,.289,16,23,.696,91,43,90,.478,27,45,.600,16,45,.356,13,14,.929,115
2315,HOU,2022-01-10,91,,PHI,L 91-111,240,30,77,.390,17,35,.486,13,42,.310,18,27,.667,91,43,94,.457,33,59,.559,10,35,.286,15,18,.833,111
2316,LAC,2021-12-29,91,@,BOS,W 91-82,240,33,81,.407,22,53,.415,11,28,.393,14,17,.824,91,35,101,.347,31,59,.525,4,42,.095,8,11,.727,82
2317,DET,2021-12-21,91,@,NYK,L 91-105,240,34,94,.362,26,61,.426,8,33,.242,15,19,.789,91,40,90,.444,29,57,.509,11,33,.333,14,19,.737,105
2318,PHI,2021-12-13,91,@,MEM,L 91-126,240,37,83,.446,33,61,.541,4,22,.182,13,19,.684,91,47,89,.528,33,55,.600,14,34,.412,18,23,.783,126
2319,DAL,2021-12-03,91,,NOP,L 91-107,240,32,79,.405,22,45,.489,10,34,.294,17,26,.654,91,37,90,.411,25,60,.417,12,30,.400,21,28,.750,107
2320,TOR,2021-11-30,91,,MEM,L 91-98,240,36,91,.396,26,52,.500,10,39,.256,9,12,.750,91,36,93,.387,26,59,.441,10,34,.294,16,19,.842,98
2321,DAL,2021-11-21,91,@,LAC,L 91-97,240,34,83,.410,28,53,.528,6,30,.200,17,18,.944,91,36,75,.480,24,46,.522,12,29,.414,13,18,.722,97
2322,CLE,2021-11-13,91,,BOS,W 91-89,240,31,81,.383,21,43,.488,10,38,.263,19,22,.864,91,33,78,.423,27,55,.491,6,23,.261,17,18,.944,89
2323,SAC,2021-11-07,91,,IND,L 91-94,240,31,84,.369,21,50,.420,10,34,.294,19,22,.864,91,37,83,.446,31,58,.534,6,25,.240,14,18,.778,94
2324,DET,2021-10-31,91,@,BRK,L 91-117,240,32,79,.405,20,46,.435,12,33,.364,15,22,.682,91,47,72,.653,34,47,.723,13,25,.520,10,16,.625,117
2325,MIN,2021-10-30,91,,DEN,L 91-93,240,35,89,.393,22,48,.458,13,41,.317,8,9,.889,91,36,88,.409,27,51,.529,9,37,.243,12,16,.750,93
2326,HOU,2021-10-28,91,,UTA,L 91-122,240,31,95,.326,22,51,.431,9,44,.205,20,23,.870,91,41,85,.482,25,39,.641,16,46,.348,24,30,.800,122
2327,MIA,2021-10-23,91,@,IND,L 91-102 (OT),265,35,91,.385,26,58,.448,9,33,.273,12,14,.857,91,38,97,.392,28,58,.483,10,39,.256,16,21,.762,102
2328,OKC,2021-10-22,91,@,HOU,L 91-124,240,34,91,.374,20,48,.417,14,43,.326,9,16,.563,91,48,95,.505,31,57,.544,17,38,.447,11,14,.786,124
2329,SAC,2022-04-03,90,,GSW,L 90-109,240,31,81,.383,24,48,.500,7,33,.212,21,24,.875,90,41,79,.519,25,45,.556,16,34,.471,11,15,.733,109
2330,GSW,2022-03-22,90,@,ORL,L 90-94,240,34,85,.400,23,53,.434,11,32,.344,11,16,.688,90,34,79,.430,24,43,.558,10,36,.278,16,20,.800,94
2331,ORL,2022-03-20,90,,OKC,W 90-85,240,32,83,.386,25,52,.481,7,31,.226,19,24,.792,90,30,92,.326,17,44,.386,13,48,.271,12,18,.667,85
2332,MIA,2022-03-09,90,,PHO,L 90-111,240,35,88,.398,25,55,.455,10,33,.303,10,13,.769,90,45,99,.455,34,62,.548,11,37,.297,10,10,1.000,111
2333,UTA,2022-03-04,90,@,NOP,L 90-124,240,31,89,.348,20,48,.417,11,41,.268,17,26,.654,90,50,97,.515,39,61,.639,11,36,.306,13,17,.765,124
2334,POR,2022-03-02,90,@,PHO,L 90-120,240,30,78,.385,19,47,.404,11,31,.355,19,25,.760,90,40,80,.500,26,44,.591,14,36,.389,26,31,.839,120
2335,TOR,2022-02-14,90,@,NOP,L 90-120,240,29,95,.305,21,61,.344,8,34,.235,24,31,.774,90,45,77,.584,29,42,.690,16,35,.457,14,16,.875,120
2336,NOP,2022-01-31,90,@,CLE,L 90-93,240,33,85,.388,27,55,.491,6,30,.200,18,21,.857,90,36,84,.429,27,53,.509,9,31,.290,12,14,.857,93
2337,CHO,2022-01-30,90,,LAC,L 90-115,240,32,98,.327,24,64,.375,8,34,.235,18,27,.667,90,44,84,.524,33,56,.589,11,28,.393,16,19,.842,115
2338,CHI,2022-01-21,90,@,MIL,L 90-94,240,31,85,.365,24,47,.511,7,38,.184,21,24,.875,90,34,88,.386,28,57,.491,6,31,.194,20,28,.714,94
2339,OKC,2022-01-05,90,@,MIN,L 90-98,240,33,90,.367,24,55,.436,9,35,.257,15,18,.833,90,36,90,.400,24,46,.522,12,44,.273,14,20,.700,98
2340,LAL,2021-12-21,90,,PHO,L 90-108,240,34,87,.391,27,52,.519,7,35,.200,15,23,.652,90,41,93,.441,29,52,.558,12,41,.293,14,15,.933,108
2341,MIA,2021-12-19,90,@,DET,L 90-100,240,28,74,.378,15,31,.484,13,43,.302,21,33,.636,90,35,75,.467,27,43,.628,8,32,.250,22,30,.733,100
2342,MIL,2021-12-18,90,,CLE,L 90-119,240,35,89,.393,23,51,.451,12,38,.316,8,11,.727,90,45,90,.500,29,45,.644,16,45,.356,13,14,.929,119
2343,TOR,2021-12-10,90,,NYK,W 90-87,240,30,87,.345,18,52,.346,12,35,.343,18,23,.783,90,29,81,.358,20,47,.426,9,34,.265,20,24,.833,87
2344,BOS,2021-12-10,90,@,PHO,L 90-111,240,35,93,.376,31,67,.463,4,26,.154,16,24,.667,90,43,96,.448,29,58,.500,14,38,.368,11,11,1.000,111
2345,POR,2021-12-06,90,,LAC,L 90-102,240,35,79,.443,30,57,.526,5,22,.227,15,20,.750,90,41,92,.446,30,56,.536,11,36,.306,9,14,.643,102
2346,MIA,2021-12-06,90,,MEM,L 90-105,240,35,76,.461,29,54,.537,6,22,.273,14,17,.824,90,38,89,.427,25,56,.446,13,33,.394,16,21,.762,105
2347,WAS,2021-12-05,90,@,TOR,L 90-102,240,30,73,.411,22,48,.458,8,25,.320,22,29,.759,90,38,85,.447,30,62,.484,8,23,.348,18,24,.750,102
2348,DAL,2021-12-04,90,,MEM,L 90-97,240,31,92,.337,16,49,.327,15,43,.349,13,19,.684,90,37,76,.487,28,50,.560,9,26,.346,14,24,.583,97
2349,LAC,2021-11-28,90,,GSW,L 90-105,240,32,80,.400,23,52,.442,9,28,.321,17,25,.680,90,38,86,.442,21,46,.457,17,40,.425,12,22,.545,105
2350,ATL,2021-11-27,90,,NYK,L 90-99,240,33,93,.355,24,56,.429,9,37,.243,15,20,.750,90,36,82,.439,25,53,.472,11,29,.379,16,22,.727,99
2351,HOU,2021-11-22,90,@,BOS,L 90-108,240,31,83,.373,20,41,.488,11,42,.262,17,24,.708,90,39,92,.424,27,57,.474,12,35,.343,18,19,.947,108
2352,SAS,2021-11-18,90,@,MIN,L 90-115,240,35,84,.417,29,52,.558,6,32,.188,14,19,.737,90,41,86,.477,20,37,.541,21,49,.429,12,15,.800,115
2353,OKC,2021-11-15,90,,MIA,L 90-103,240,34,83,.410,19,42,.452,15,41,.366,7,10,.700,90,37,82,.451,19,42,.452,18,40,.450,11,13,.846,103
2354,LAC,2021-11-14,90,,CHI,L 90-100,240,29,81,.358,18,47,.383,11,34,.324,21,21,1.000,90,38,86,.442,27,57,.474,11,29,.379,13,14,.929,100
2355,ORL,2021-11-10,90,,BRK,L 90-123,240,35,92,.380,31,59,.525,4,33,.121,16,24,.667,90,46,91,.505,30,54,.556,16,37,.432,15,17,.882,123
2356,LAL,2021-11-06,90,@,POR,L 90-105,240,31,90,.344,22,58,.379,9,32,.281,19,24,.792,90,36,95,.379,21,40,.525,15,55,.273,18,24,.750,105
2357,DET,2021-11-05,90,,BRK,L 90-96,240,33,87,.379,22,53,.415,11,34,.324,13,18,.722,90,36,80,.450,25,53,.472,11,27,.407,13,14,.929,96
2358,WAS,2021-10-25,90,@,BRK,L 90-104,240,33,95,.347,24,56,.429,9,39,.231,15,20,.750,90,40,94,.426,30,59,.508,10,35,.286,14,17,.824,104
2359,ORL,2021-10-25,90,@,MIA,L 90-107,240,33,81,.407,21,37,.568,12,44,.273,12,19,.632,90,41,87,.471,35,60,.583,6,27,.222,19,19,1.000,107
2360,ORL,2022-04-01,89,,TOR,L 89-102,240,34,79,.430,23,44,.523,11,35,.314,10,11,.909,89,36,86,.419,23,44,.523,13,42,.310,17,20,.850,102
2361,LAC,2022-01-13,89,@,NOP,L 89-113,240,31,81,.383,21,47,.447,10,34,.294,17,20,.850,89,43,97,.443,29,58,.500,14,39,.359,13,16,.813,113
2362,LAC,2022-01-06,89,@,PHO,L 89-106,240,31,86,.360,25,58,.431,6,28,.214,21,25,.840,89,44,107,.411,34,76,.447,10,31,.323,8,10,.800,106
2363,DEN,2022-01-03,89,@,DAL,L 89-103,240,31,67,.463,25,42,.595,6,25,.240,21,29,.724,89,35,78,.449,21,41,.512,14,37,.378,19,21,.905,103
2364,DEN,2021-12-28,89,@,GSW,W 89-86,240,34,83,.410,26,50,.520,8,33,.242,13,20,.650,89,30,72,.417,20,40,.500,10,32,.313,16,31,.516,86
2365,SAC,2021-12-22,89,,LAC,L 89-105,240,34,85,.400,22,47,.468,12,38,.316,9,12,.750,89,42,82,.512,35,58,.603,7,24,.292,14,16,.875,105
2366,HOU,2021-12-15,89,@,CLE,L 89-124,240,30,78,.385,25,49,.510,5,29,.172,24,35,.686,89,45,80,.563,27,40,.675,18,40,.450,16,24,.667,124
2367,OKC,2021-11-29,89,@,HOU,L 89-102,240,31,87,.356,24,44,.545,7,43,.163,20,26,.769,89,40,96,.417,25,50,.500,15,46,.326,7,11,.636,102
2368,OKC,2021-11-19,89,@,MIL,L 89-96,240,32,91,.352,20,43,.465,12,48,.250,13,21,.619,89,31,83,.373,19,42,.452,12,41,.293,22,26,.846,96
2369,SAC,2021-11-19,89,,TOR,L 89-108,240,32,84,.381,23,47,.489,9,37,.243,16,25,.640,89,38,84,.452,26,53,.491,12,31,.387,20,24,.833,108
2370,DEN,2021-11-18,89,,PHI,L 89-103,240,32,89,.360,20,53,.377,12,36,.333,13,16,.813,89,43,85,.506,32,56,.571,11,29,.379,6,12,.500,103
2371,CLE,2021-11-18,89,,GSW,L 89-104,240,34,80,.425,22,41,.537,12,39,.308,9,16,.563,89,41,83,.494,26,40,.650,15,43,.349,7,8,.875,104
2372,IND,2021-11-17,89,@,DET,L 89-97,240,33,79,.418,24,42,.571,9,37,.243,14,19,.737,89,34,80,.425,26,52,.500,8,28,.286,21,28,.750,97
2373,HOU,2021-11-17,89,@,OKC,L 89-101,240,32,90,.356,20,48,.417,12,42,.286,13,19,.684,89,41,92,.446,31,53,.585,10,39,.256,9,16,.563,101
2374,HOU,2021-11-14,89,,PHO,L 89-115,240,35,85,.412,28,53,.528,7,32,.219,12,18,.667,89,42,97,.433,28,57,.491,14,40,.350,17,20,.850,115
2375,BOS,2021-11-13,89,@,CLE,L 89-91,240,33,78,.423,27,55,.491,6,23,.261,17,18,.944,89,31,81,.383,21,43,.488,10,38,.263,19,22,.864,91
2376,ORL,2021-11-05,89,,SAS,L 89-102,240,35,89,.393,23,48,.479,12,41,.293,7,10,.700,89,40,90,.444,34,71,.479,6,19,.316,16,18,.889,102
2377,DET,2021-11-02,89,,MIL,L 89-117,240,30,93,.323,22,46,.478,8,47,.170,21,30,.700,89,42,84,.500,25,47,.532,17,37,.459,16,21,.762,117
2378,NOP,2021-10-23,89,@,MIN,L 89-96,240,31,89,.348,22,49,.449,9,40,.225,18,23,.783,89,39,96,.406,27,58,.466,12,38,.316,6,10,.600,96
2379,OKC,2022-04-10,88,@,LAC,L 88-138,240,37,98,.378,28,64,.438,9,34,.265,5,9,.556,88,54,97,.557,36,62,.581,18,35,.514,12,14,.857,138
2380,ORL,2022-04-03,88,,NYK,L 88-118,240,30,85,.353,18,41,.439,12,44,.273,16,27,.593,88,45,93,.484,30,49,.612,15,44,.341,13,16,.813,118
2381,PHI,2022-03-20,88,,TOR,L 88-93,240,30,73,.411,23,46,.500,7,27,.259,21,28,.750,88,35,93,.376,28,67,.418,7,26,.269,16,23,.696,93
2382,GSW,2022-03-16,88,,BOS,L 88-110,240,32,86,.372,21,38,.553,11,48,.229,13,16,.813,88,38,81,.469,23,41,.561,15,40,.375,19,22,.864,110
2383,ORL,2022-01-17,88,,POR,L 88-98,240,34,90,.378,26,58,.448,8,32,.250,12,20,.600,88,37,90,.411,30,56,.536,7,34,.206,17,18,.944,98
2384,SAC,2022-01-09,88,@,POR,L 88-103,240,33,85,.388,26,54,.481,7,31,.226,15,21,.714,88,37,88,.420,20,48,.417,17,40,.425,12,15,.800,103
2385,DET,2022-01-06,88,@,MEM,L 88-118,240,34,99,.343,24,55,.436,10,44,.227,10,13,.769,88,48,98,.490,38,66,.576,10,32,.313,12,19,.632,118
2386,MIN,2021-12-28,88,,NYK,L 88-96,240,34,85,.400,27,47,.574,7,38,.184,13,20,.650,88,37,90,.411,21,50,.420,16,40,.400,6,16,.375,96
2387,BOS,2021-12-01,88,,PHI,W 88-87,240,33,79,.418,22,51,.431,11,28,.393,11,15,.733,88,33,89,.371,25,58,.431,8,31,.258,13,17,.765,87
2388,ORL,2021-11-26,88,,CHI,L 88-123,240,30,80,.375,23,48,.479,7,32,.219,21,30,.700,88,48,86,.558,31,52,.596,17,34,.500,10,16,.625,123
2389,BOS,2021-11-26,88,@,SAS,L 88-96,240,34,92,.370,24,58,.414,10,34,.294,10,15,.667,88,38,87,.437,32,63,.508,6,24,.250,14,19,.737,96
2390,TOR,2021-11-10,88,@,BOS,L 88-104,240,33,77,.429,27,52,.519,6,25,.240,16,19,.842,88,42,94,.447,32,65,.492,10,29,.345,10,15,.667,104
2391,DET,2021-10-20,88,,CHI,L 88-94,240,36,90,.400,30,62,.484,6,28,.214,10,13,.769,88,37,86,.430,30,63,.476,7,23,.304,13,15,.867,94
2392,PHI,2022-02-15,87,,BOS,L 87-135,240,23,80,.288,15,48,.313,8,32,.250,33,39,.846,87,46,82,.561,21,37,.568,25,45,.556,18,22,.818,135
2393,OKC,2022-02-11,87,@,PHI,L 87-100,240,35,90,.389,29,55,.527,6,35,.171,11,12,.917,87,36,93,.387,29,67,.433,7,26,.269,21,26,.808,100
2394,LAL,2022-01-27,87,@,PHI,L 87-105,240,36,88,.409,30,59,.508,6,29,.207,9,9,1.000,87,41,82,.500,28,47,.596,13,35,.371,10,17,.588,105
2395,WAS,2022-01-23,87,,BOS,L 87-116,240,33,93,.355,25,59,.424,8,34,.235,13,16,.813,87,40,90,.444,21,51,.412,19,39,.487,17,21,.810,116
2396,OKC,2022-01-22,87,@,CLE,L 87-94,240,33,85,.388,21,44,.477,12,41,.293,9,16,.563,87,35,76,.461,29,49,.592,6,27,.222,18,35,.514,94
2397,NYK,2022-01-17,87,,CHO,L 87-97,240,32,80,.400,20,46,.435,12,34,.353,11,21,.524,87,36,86,.419,22,47,.468,14,39,.359,11,17,.647,97
2398,TOR,2022-01-14,87,@,DET,L 87-103,240,28,87,.322,17,49,.347,11,38,.289,20,26,.769,87,38,81,.469,30,54,.556,8,27,.296,19,23,.826,103
2399,DET,2022-01-11,87,@,CHI,L 87-133,240,30,89,.337,24,54,.444,6,35,.171,21,27,.778,87,50,92,.543,32,58,.552,18,34,.529,15,19,.789,133
2400,LAC,2022-01-11,87,,DEN,W 87-85,240,34,84,.405,24,50,.480,10,34,.294,9,12,.750,87,32,80,.400,28,47,.596,4,33,.121,17,20,.850,85
2401,ATL,2021-12-25,87,@,NYK,L 87-101,240,33,87,.379,20,49,.408,13,38,.342,8,14,.571,87,38,85,.447,18,35,.514,20,50,.400,5,12,.417,101
2402,NYK,2021-12-10,87,@,TOR,L 87-90,240,29,81,.358,20,47,.426,9,34,.265,20,24,.833,87,30,87,.345,18,52,.346,12,35,.343,18,23,.783,90
2403,PHI,2021-12-01,87,@,BOS,L 87-88,240,33,89,.371,25,58,.431,8,31,.258,13,17,.765,87,33,79,.418,22,51,.431,11,28,.393,11,15,.733,88
2404,WAS,2021-11-17,87,@,CHO,L 87-97,240,33,90,.367,25,48,.521,8,42,.190,13,16,.813,87,42,96,.438,32,64,.500,10,32,.313,3,6,.500,97
2405,MEM,2021-11-05,87,@,WAS,L 87-115,240,34,96,.354,28,65,.431,6,31,.194,13,17,.765,87,49,84,.583,39,59,.661,10,25,.400,7,13,.538,115
2406,DEN,2021-10-25,87,,CLE,L 87-99,240,35,86,.407,26,48,.542,9,38,.237,8,12,.667,87,38,82,.463,31,57,.544,7,25,.280,16,20,.800,99
2407,DAL,2021-10-21,87,@,ATL,L 87-113,240,31,93,.333,18,50,.360,13,43,.302,12,13,.923,87,45,94,.479,30,59,.508,15,35,.429,8,9,.889,113
2408,WAS,2022-02-26,86,@,CLE,L 86-92,240,35,81,.432,24,58,.414,11,23,.478,5,6,.833,86,32,83,.386,24,58,.414,8,25,.320,20,24,.833,92
2409,DET,2022-02-08,86,@,DAL,L 86-116,240,33,87,.379,28,57,.491,5,30,.167,15,22,.682,86,40,79,.506,22,43,.512,18,36,.500,18,23,.783,116
2410,CHO,2022-02-05,86,,MIA,L 86-104,240,33,86,.384,23,50,.460,10,36,.278,10,16,.625,86,38,91,.418,27,59,.458,11,32,.344,17,18,.944,104
2411,DET,2022-01-18,86,@,GSW,L 86-102,240,30,85,.353,21,51,.412,9,34,.265,17,24,.708,86,34,83,.410,20,41,.488,14,42,.333,20,27,.741,102
2412,OKC,2022-01-02,86,,DAL,L 86-95,240,35,85,.412,25,55,.455,10,30,.333,6,9,.667,86,38,85,.447,24,46,.522,14,39,.359,5,7,.714,95
2413,GSW,2021-12-28,86,,DEN,L 86-89,240,30,72,.417,20,40,.500,10,32,.313,16,31,.516,86,34,83,.410,26,50,.520,8,33,.242,13,20,.650,89
2414,POR,2021-10-25,86,@,LAC,L 86-116,240,32,85,.376,24,48,.500,8,37,.216,14,18,.778,86,44,93,.473,30,50,.600,14,43,.326,14,19,.737,116
2415,OKC,2021-10-20,86,@,UTA,L 86-107,240,34,91,.374,27,56,.482,7,35,.200,11,18,.611,86,40,91,.440,26,44,.591,14,47,.298,13,15,.867,107
2416,OKC,2022-03-20,85,@,ORL,L 85-90,240,30,92,.326,17,44,.386,13,48,.271,12,18,.667,85,32,83,.386,25,52,.481,7,31,.226,19,24,.792,90
2417,POR,2022-03-09,85,@,UTA,L 85-123,240,29,89,.326,20,53,.377,9,36,.250,18,22,.818,85,42,81,.519,25,35,.714,17,46,.370,22,27,.815,123
2418,SAC,2022-02-14,85,@,BRK,L 85-109,240,31,90,.344,22,55,.400,9,35,.257,14,18,.778,85,43,84,.512,34,58,.586,9,26,.346,14,15,.933,109
2419,GSW,2022-02-09,85,@,UTA,L 85-111,240,28,78,.359,12,35,.343,16,43,.372,13,17,.765,85,41,89,.461,24,38,.632,17,51,.333,12,17,.706,111
2420,IND,2022-02-06,85,@,CLE,L 85-98,240,31,83,.373,23,52,.442,8,31,.258,15,17,.882,85,34,84,.405,23,52,.442,11,32,.344,19,28,.679,98
2421,MEM,2022-01-14,85,,DAL,L 85-112,240,34,89,.382,27,58,.466,7,31,.226,10,13,.769,85,47,91,.516,39,59,.661,8,32,.250,10,16,.625,112
2422,DAL,2022-01-12,85,@,NYK,L 85-108,240,32,78,.410,24,41,.585,8,37,.216,13,19,.684,85,42,90,.467,30,63,.476,12,27,.444,12,15,.800,108
2423,DEN,2022-01-11,85,@,LAC,L 85-87,240,32,80,.400,28,47,.596,4,33,.121,17,20,.850,85,34,84,.405,24,50,.480,10,34,.294,9,12,.750,87
2424,DET,2021-12-29,85,,NYK,L 85-94,240,30,81,.370,18,46,.391,12,35,.343,13,17,.765,85,31,81,.383,23,50,.460,8,31,.258,24,27,.889,94
2425,MIA,2021-12-01,85,,CLE,L 85-111,240,32,85,.376,20,48,.417,12,37,.324,9,13,.692,85,37,68,.544,21,37,.568,16,31,.516,21,23,.913,111
2426,PHI,2021-11-16,85,@,UTA,L 85-120,240,33,90,.367,27,61,.443,6,29,.207,13,17,.765,85,46,89,.517,30,51,.588,16,38,.421,12,19,.632,120
2427,NOP,2021-11-05,85,@,GSW,L 85-126,240,31,88,.352,20,44,.455,11,44,.250,12,16,.750,85,47,91,.516,27,41,.659,20,50,.400,12,14,.857,126
2428,HOU,2021-10-31,85,@,LAL,L 85-95,240,32,76,.421,26,48,.542,6,28,.214,15,29,.517,85,39,96,.406,30,65,.462,9,31,.290,8,13,.615,95
2429,OKC,2021-12-12,84,,DAL,L 84-103,240,30,80,.375,17,43,.395,13,37,.351,11,16,.688,84,38,90,.422,29,57,.509,9,33,.273,18,23,.783,103
2430,IND,2021-11-15,84,@,NYK,L 84-92,240,32,86,.372,24,49,.490,8,37,.216,12,16,.750,84,37,86,.430,26,52,.500,11,34,.324,7,10,.700,92
2431,MIN,2021-11-05,84,,LAC,L 84-104,240,31,89,.348,14,37,.378,17,52,.327,5,7,.714,84,36,88,.409,30,60,.500,6,28,.214,26,32,.813,104
2432,ORL,2022-02-06,83,,BOS,L 83-116,240,29,81,.358,24,55,.436,5,26,.192,20,21,.952,83,45,99,.455,32,53,.604,13,46,.283,13,14,.929,116
2433,ORL,2021-12-26,83,@,MIA,L 83-93,240,31,72,.431,21,40,.525,10,32,.313,11,17,.647,83,36,89,.404,26,55,.473,10,34,.294,11,18,.611,93
2434,POR,2021-12-02,83,,SAS,L 83-114,240,29,82,.354,17,48,.354,12,34,.353,13,17,.765,83,44,91,.484,30,55,.545,14,36,.389,12,16,.750,114
2435,LAL,2021-11-12,83,,MIN,L 83-107,240,29,82,.354,20,41,.488,9,41,.220,16,20,.800,83,43,94,.457,31,57,.544,12,37,.324,9,12,.750,107
2436,BOS,2021-10-22,83,,TOR,L 83-115,240,32,82,.390,21,48,.438,11,34,.324,8,11,.727,83,42,100,.420,32,65,.492,10,35,.286,21,21,1.000,115
2437,TOR,2021-10-20,83,,WAS,L 83-98,240,30,97,.309,23,63,.365,7,34,.206,16,22,.727,83,36,81,.444,31,54,.574,5,27,.185,21,26,.808,98
2438,PHI,2022-03-05,82,@,MIA,L 82-99,240,28,82,.341,21,41,.512,7,41,.171,19,23,.826,82,35,72,.486,22,44,.500,13,28,.464,16,19,.842,99
2439,CLE,2022-01-09,82,@,GSW,L 82-96,240,32,75,.427,25,51,.490,7,24,.292,11,18,.611,82,39,97,.402,29,55,.527,10,42,.238,8,10,.800,96
2440,GSW,2022-01-05,82,@,DAL,L 82-99,240,33,81,.407,28,53,.528,5,28,.179,11,16,.688,82,33,87,.379,21,47,.447,12,40,.300,21,26,.808,99
2441,BOS,2021-12-29,82,,LAC,L 82-91,240,35,101,.347,31,59,.525,4,42,.095,8,11,.727,82,33,81,.407,22,53,.415,11,28,.393,14,17,.824,91
2442,OKC,2021-10-30,82,@,GSW,L 82-103,240,29,83,.349,21,44,.477,8,39,.205,16,21,.762,82,39,92,.424,18,38,.474,21,54,.389,4,8,.500,103
2443,DET,2021-10-23,82,@,CHI,L 82-97,240,34,88,.386,29,60,.483,5,28,.179,9,15,.600,82,35,84,.417,24,58,.414,11,26,.423,16,19,.842,97
2444,POR,2022-03-07,81,@,MIN,L 81-124,240,23,83,.277,16,55,.291,7,28,.250,28,38,.737,81,38,92,.413,25,49,.510,13,43,.302,35,44,.795,124
2445,POR,2022-01-31,81,@,OKC,L 81-98,240,34,81,.420,27,43,.628,7,38,.184,6,8,.750,81,35,86,.407,23,45,.511,12,41,.293,16,17,.941,98
2446,LAC,2021-11-19,81,@,NOP,L 81-94,240,34,90,.378,25,53,.472,9,37,.243,4,5,.800,81,38,87,.437,25,57,.439,13,30,.433,5,8,.625,94
2447,POR,2022-04-10,80,,UTA,L 80-111,240,31,83,.373,22,49,.449,9,34,.265,9,12,.750,80,37,82,.451,28,46,.609,9,36,.250,28,38,.737,111
2448,WAS,2022-02-05,80,,PHO,L 80-95,240,30,85,.353,25,61,.410,5,24,.208,15,19,.789,80,40,99,.404,32,68,.471,8,31,.258,7,14,.500,95
2449,NYK,2021-12-31,80,@,OKC,L 80-95,240,30,81,.370,22,40,.550,8,41,.195,12,22,.545,80,36,87,.414,18,44,.409,18,43,.419,5,7,.714,95
2450,OKC,2021-12-02,79,@,MEM,L 79-152,240,25,76,.329,14,38,.368,11,38,.289,18,22,.818,79,60,96,.625,41,60,.683,19,36,.528,13,18,.722,152
2451,ORL,2021-11-03,79,,BOS,L 79-92,240,27,84,.321,18,41,.439,9,43,.209,16,20,.800,79,33,79,.418,23,42,.548,10,37,.270,16,25,.640,92
2452,LAC,2021-10-27,79,,CLE,L 79-92,240,31,87,.356,22,46,.478,9,41,.220,8,13,.615,79,33,81,.407,30,61,.492,3,20,.150,23,27,.852,92
2453,POR,2022-04-08,78,@,DAL,L 78-128,240,31,83,.373,24,51,.471,7,32,.219,9,12,.750,78,42,79,.532,22,34,.647,20,45,.444,24,31,.774,128
2454,DET,2021-11-12,78,@,CLE,L 78-98,240,29,79,.367,20,49,.408,9,30,.300,11,13,.846,78,39,82,.476,25,41,.610,14,41,.341,6,9,.667,98
2455,MIA,2021-11-04,78,,BOS,L 78-95,240,28,81,.346,19,40,.475,9,41,.220,13,19,.684,78,31,78,.397,15,37,.405,16,41,.390,17,20,.850,95
2456,DAL,2022-03-09,77,,NYK,L 77-107,240,27,86,.314,21,42,.500,6,44,.136,17,25,.680,77,36,84,.429,27,50,.540,9,34,.265,26,33,.788,107
2457,CHI,2021-11-22,77,,IND,L 77-109,240,31,85,.365,25,57,.439,6,28,.214,9,15,.600,77,40,90,.444,27,59,.458,13,31,.419,16,18,.889,109
2458,SAC,2022-01-25,75,@,BOS,L 75-128,240,29,95,.305,23,62,.371,6,33,.182,11,15,.733,75,51,103,.495,31,58,.534,20,45,.444,6,7,.857,128
2459,NYK,2022-01-08,75,@,BOS,L 75-99,240,29,79,.367,18,48,.375,11,31,.355,6,15,.400,75,36,76,.474,24,47,.511,12,29,.414,15,17,.882,99
2460,DAL,2021-10-29,75,@,DEN,L 75-106,240,23,78,.295,15,41,.366,8,37,.216,21,27,.778,75,43,83,.518,32,47,.681,11,36,.306,9,13,.692,106