Rk,Team,Date,PTS,,Opp,Result,MP,FG,FGA,FG%,2P,2PA,2P%,3P,3PA,3P%,FT,FTA,FT%,PTS,FG,FGA,FG%,2P,2PA,2P%,3P,3PA,3P%,FT,FTA,FT%,PTS
1,DET,2015-12-18,147,@,CHI,W 147-144 (4OT),340,56,124,.452,48,95,.505,8,29,.276,27,46,.587,147,50,120,.417,45,98,.459,5,22,.227,39,44,.886,144
2,MIN,2016-04-13,144,,NOP,W 144-109,240,56,86,.651,43,58,.741,13,28,.464,19,23,.826,144,40,92,.435,29,62,.468,11,30,.367,18,22,.818,109
3,CHI,2015-12-18,144,,DET,L 144-147 (4OT),340,50,120,.417,45,98,.459,5,22,.227,39,44,.886,144,56,124,.452,48,95,.505,8,29,.276,27,46,.587,147
4,SAC,2016-01-02,142,,PHO,W 142-119,240,53,87,.609,44,64,.688,9,23,.391,27,34,.794,142,43,83,.518,33,54,.611,10,29,.345,23,28,.821,119
5,LAC,2016-01-18,140,,HOU,W 140-132 (OT),265,47,91,.516,25,54,.463,22,37,.595,24,33,.727,140,44,88,.500,33,56,.589,11,32,.344,33,52,.635,132
6,ORL,2016-03-29,139,,BRK,W 139-105,240,56,91,.615,42,64,.656,14,27,.519,13,19,.684,139,37,79,.468,32,65,.492,5,14,.357,26,39,.667,105
7,BOS,2016-02-10,139,,LAC,W 139-134 (OT),265,47,95,.495,34,62,.548,13,33,.394,32,37,.865,139,44,85,.518,32,55,.582,12,30,.400,34,50,.680,134
8,OKC,2015-10-30,139,@,ORL,W 139-136 (2OT),290,50,110,.455,42,83,.506,8,27,.296,31,38,.816,139,47,106,.443,35,73,.479,12,33,.364,30,38,.789,136
9,POR,2016-02-19,137,,GSW,W 137-105,240,52,97,.536,35,67,.522,17,30,.567,16,23,.696,137,36,92,.391,24,58,.414,12,34,.353,21,28,.750,105
10,GSW,2016-04-03,136,,POR,W 136-111,240,50,88,.568,32,58,.552,18,30,.600,18,22,.818,136,38,85,.447,29,61,.475,9,24,.375,26,33,.788,111
11,ORL,2015-10-30,136,,OKC,L 136-139 (2OT),290,47,106,.443,35,73,.479,12,33,.364,30,38,.789,136,50,110,.455,42,83,.506,8,27,.296,31,38,.816,139
12,GSW,2015-11-27,135,@,PHO,W 135-116,240,46,81,.568,24,43,.558,22,38,.579,21,31,.677,135,45,92,.489,35,66,.530,10,26,.385,16,23,.696,116
13,LAC,2016-02-10,134,@,BOS,L 134-139 (OT),265,44,85,.518,32,55,.582,12,30,.400,34,50,.680,134,47,95,.495,34,62,.548,13,33,.394,32,37,.865,139
14,GSW,2016-02-03,134,@,WAS,W 134-121,240,49,93,.527,29,52,.558,20,41,.488,16,29,.552,134,46,91,.505,38,68,.559,8,23,.348,21,30,.700,121
15,GSW,2015-10-31,134,@,NOP,W 134-120,240,46,84,.548,29,54,.537,17,30,.567,25,35,.714,134,46,100,.460,38,78,.487,8,22,.364,20,23,.870,120
16,SAC,2016-03-27,133,,DAL,W 133-111,240,51,82,.622,42,62,.677,9,20,.450,22,30,.733,133,42,88,.477,34,64,.531,8,24,.333,19,24,.792,111
17,MIN,2016-03-25,132,@,WAS,W 132-129 (2OT),290,51,96,.531,43,70,.614,8,26,.308,22,22,1.000,132,50,100,.500,37,71,.521,13,29,.448,16,23,.696,129
18,DAL,2016-03-20,132,,POR,W 132-120 (OT),265,49,89,.551,34,64,.531,15,25,.600,19,23,.826,132,42,104,.404,24,58,.414,18,46,.391,18,28,.643,120
19,MIN,2016-03-05,132,,BRK,W 132-118,240,52,76,.684,42,58,.724,10,18,.556,18,22,.818,132,45,92,.489,36,66,.545,9,26,.346,19,26,.731,118
20,GSW,2016-01-18,132,@,CLE,W 132-98,240,46,85,.541,27,45,.600,19,40,.475,21,27,.778,132,37,77,.481,30,58,.517,7,19,.368,17,25,.680,98
21,HOU,2016-01-18,132,@,LAC,L 132-140 (OT),265,44,88,.500,33,56,.589,11,32,.344,33,52,.635,132,47,91,.516,25,54,.463,22,37,.595,24,33,.727,140
22,SAC,2015-10-30,132,,LAL,W 132-114,240,52,101,.515,46,79,.582,6,22,.273,22,30,.733,132,41,89,.461,30,55,.545,11,34,.324,21,27,.778,114
23,BRK,2016-03-15,131,,PHI,W 131-114,240,47,90,.522,37,66,.561,10,24,.417,27,31,.871,131,41,88,.466,30,58,.517,11,30,.367,21,26,.808,114
24,OKC,2016-02-29,131,@,SAC,W 131-116,240,47,82,.573,33,48,.688,14,34,.412,23,26,.885,131,48,107,.449,41,82,.500,7,25,.280,13,19,.684,116
25,OKC,2015-12-29,131,,MIL,W 131-123,240,43,86,.500,35,64,.547,8,22,.364,37,40,.925,131,49,100,.490,39,84,.464,10,16,.625,15,22,.682,123
26,GSW,2015-12-08,131,@,IND,W 131-123,240,52,95,.547,36,60,.600,16,35,.457,11,15,.733,131,44,100,.440,30,67,.448,14,33,.424,21,26,.808,123
27,HOU,2016-04-10,130,,LAL,W 130-110,240,50,98,.510,33,57,.579,17,41,.415,13,18,.722,130,41,83,.494,29,55,.527,12,28,.429,16,19,.842,110
28,GSW,2016-03-18,130,@,DAL,W 130-112,240,48,95,.505,26,57,.456,22,38,.579,12,14,.857,130,41,93,.441,32,64,.500,9,29,.310,21,22,.955,112
29,OKC,2016-03-16,130,@,BOS,W 130-109,240,47,96,.490,35,67,.522,12,29,.414,24,30,.800,130,40,93,.430,35,74,.473,5,19,.263,24,27,.889,109
30,HOU,2016-03-14,130,,MEM,W 130-81,240,46,85,.541,30,52,.577,16,33,.485,22,34,.647,130,30,101,.297,26,84,.310,4,17,.235,17,28,.607,81
31,ORL,2016-02-28,130,,PHI,W 130-116,240,49,86,.570,39,70,.557,10,16,.625,22,25,.880,130,41,77,.532,36,55,.655,5,22,.227,29,37,.784,116
32,GSW,2016-02-25,130,@,ORL,W 130-114,240,53,88,.602,40,63,.635,13,25,.520,11,16,.688,130,41,90,.456,31,64,.484,10,26,.385,22,28,.786,114
33,SAS,2016-01-27,130,,HOU,W 130-99,240,50,90,.556,38,67,.567,12,23,.522,18,21,.857,130,28,73,.384,20,43,.465,8,30,.267,35,52,.673,99
34,LAC,2016-01-02,130,,PHI,W 130-99,240,49,81,.605,37,58,.638,12,23,.522,20,25,.800,130,41,89,.461,32,66,.485,9,23,.391,8,17,.471,99
35,NOP,2015-12-20,130,@,DEN,W 130-125,240,44,78,.564,33,54,.611,11,24,.458,31,39,.795,130,45,96,.469,28,61,.459,17,35,.486,18,22,.818,125
36,CHO,2015-11-03,130,,CHI,W 130-105,240,47,91,.516,33,68,.485,14,23,.609,22,23,.957,130,44,90,.489,30,60,.500,14,30,.467,3,8,.375,105
37,HOU,2016-04-11,129,@,MIN,W 129-105,240,48,86,.558,33,56,.589,15,30,.500,18,26,.692,129,38,83,.458,33,62,.532,5,21,.238,24,33,.727,105
38,IND,2016-04-10,129,,BRK,W 129-105,240,48,86,.558,37,59,.627,11,27,.407,22,27,.815,129,35,91,.385,21,54,.389,14,37,.378,21,26,.808,105
39,WAS,2016-03-25,129,,MIN,L 129-132 (2OT),290,50,100,.500,37,71,.521,13,29,.448,16,23,.696,129,51,96,.531,43,70,.614,8,26,.308,22,22,1.000,132
40,MIA,2016-03-01,129,,CHI,W 129-111,240,52,77,.675,46,65,.708,6,12,.500,19,25,.760,129,41,90,.456,30,67,.448,11,23,.478,18,26,.692,111
41,DAL,2016-02-21,129,,PHI,W 129-103,240,41,85,.482,28,51,.549,13,34,.382,34,36,.944,129,37,77,.481,25,49,.510,12,28,.429,17,27,.630,103
42,CHO,2016-01-25,129,@,SAC,W 129-128 (2OT),290,44,110,.400,24,66,.364,20,44,.455,21,26,.808,129,48,91,.527,41,68,.603,7,23,.304,25,32,.781,128
43,DEN,2016-01-17,129,,IND,W 129-126,240,46,91,.505,36,65,.554,10,26,.385,27,38,.711,129,48,82,.585,39,62,.629,9,20,.450,21,30,.700,126
44,SAC,2015-11-25,129,@,MIL,W 129-118,240,44,77,.571,34,54,.630,10,23,.435,31,37,.838,129,42,88,.477,29,57,.509,13,31,.419,21,27,.778,118
45,GSW,2015-11-12,129,@,MIN,W 129-116,240,48,89,.539,30,51,.588,18,38,.474,15,16,.938,129,43,87,.494,40,78,.513,3,9,.333,27,36,.750,116
46,GSW,2016-03-25,128,,DAL,W 128-120,240,43,88,.489,22,43,.512,21,45,.467,21,23,.913,128,43,96,.448,25,61,.410,18,35,.514,16,21,.762,120
47,OKC,2016-03-14,128,,POR,W 128-94,240,49,83,.590,40,66,.606,9,17,.529,21,26,.808,128,31,91,.341,24,64,.375,7,27,.259,25,27,.926,94
48,GSW,2016-03-11,128,,POR,W 128-112,240,40,89,.449,22,49,.449,18,40,.450,30,39,.769,128,37,86,.430,18,50,.360,19,36,.528,19,23,.826,112
49,NYK,2016-03-09,128,@,PHO,W 128-97,240,46,82,.561,30,58,.517,16,24,.667,20,24,.833,128,39,89,.438,30,60,.500,9,29,.310,10,15,.667,97
50,MIL,2016-02-29,128,,HOU,W 128-121,240,48,81,.593,40,66,.606,8,15,.533,24,33,.727,128,41,87,.471,26,51,.510,15,36,.417,24,35,.686,121
51,DAL,2016-02-28,128,,MIN,W 128-101,240,47,89,.528,34,53,.642,13,36,.361,21,21,1.000,128,34,90,.378,27,67,.403,7,23,.304,26,37,.703,101
52,MEM,2016-02-24,128,,LAL,W 128-119,240,48,85,.565,35,58,.603,13,27,.481,19,29,.655,128,39,88,.443,22,49,.449,17,39,.436,24,33,.727,119
53,BOS,2016-02-07,128,,SAC,W 128-119,240,51,91,.560,38,67,.567,13,24,.542,13,15,.867,128,47,95,.495,37,69,.536,10,26,.385,15,19,.789,119
54,BRK,2016-02-05,128,,SAC,W 128-119,240,48,86,.558,30,58,.517,18,28,.643,14,15,.933,128,45,89,.506,37,63,.587,8,26,.308,21,22,.955,119
55,OKC,2016-01-26,128,@,NYK,W 128-122 (OT),265,46,99,.465,35,79,.443,11,20,.550,25,29,.862,128,44,95,.463,33,72,.458,11,23,.478,23,30,.767,122
56,SAC,2016-01-25,128,,CHO,L 128-129 (2OT),290,48,91,.527,41,68,.603,7,23,.304,25,32,.781,128,44,110,.400,24,66,.364,20,44,.455,21,26,.808,129
57,GSW,2016-01-09,128,@,SAC,W 128-116,240,49,87,.563,30,50,.600,19,37,.514,11,15,.733,128,43,92,.467,35,69,.507,8,23,.348,22,29,.759,116
58,GSW,2016-01-08,128,@,POR,W 128-108,240,46,87,.529,28,55,.509,18,32,.563,18,21,.857,128,38,96,.396,26,63,.413,12,33,.364,20,28,.714,108
59,GSW,2015-12-16,128,,PHO,W 128-103,240,46,88,.523,31,56,.554,15,32,.469,21,27,.778,128,41,91,.451,36,69,.522,5,22,.227,16,18,.889,103
60,GSW,2016-01-27,127,,DAL,W 127-107,240,47,81,.580,33,52,.635,14,29,.483,19,21,.905,127,44,87,.506,33,56,.589,11,31,.355,8,12,.667,107
61,ATL,2015-12-16,127,,PHI,W 127-106,240,48,78,.615,38,57,.667,10,21,.476,21,24,.875,127,39,75,.520,27,49,.551,12,26,.462,16,24,.667,106
62,DET,2015-12-02,127,,PHO,W 127-122 (OT),265,44,87,.506,32,60,.533,12,27,.444,27,44,.614,127,47,97,.485,33,64,.516,14,33,.424,14,15,.933,122
63,CHO,2015-11-23,127,,SAC,W 127-122 (OT),265,49,98,.500,40,69,.580,9,29,.310,20,26,.769,127,52,104,.500,44,73,.603,8,31,.258,10,16,.625,122
64,CHO,2016-03-01,126,,PHO,W 126-92,240,45,93,.484,32,66,.485,13,27,.481,23,27,.852,126,33,91,.363,27,64,.422,6,27,.222,20,27,.741,92
65,CHI,2016-02-21,126,,LAL,W 126-115,240,44,79,.557,31,60,.517,13,19,.684,25,26,.962,126,43,93,.462,36,72,.500,7,21,.333,22,33,.667,115
66,OKC,2016-01-27,126,@,MIN,W 126-123,240,48,91,.527,38,71,.535,10,20,.500,20,21,.952,126,50,90,.556,45,76,.592,5,14,.357,18,28,.643,123
67,IND,2016-01-17,126,@,DEN,L 126-129,240,48,82,.585,39,62,.629,9,20,.450,21,30,.700,126,46,91,.505,36,65,.554,10,26,.385,27,38,.711,129
68,ATL,2016-01-07,126,@,PHI,W 126-98,240,49,92,.533,36,60,.600,13,32,.406,15,19,.789,126,39,86,.453,34,68,.500,5,18,.278,15,25,.600,98
69,HOU,2015-12-12,126,,LAL,W 126-97,240,47,90,.522,32,57,.561,15,33,.455,17,28,.607,126,35,88,.398,25,56,.446,10,32,.313,17,20,.850,97
70,GSW,2016-04-13,125,,MEM,W 125-104,240,46,87,.529,26,40,.650,20,47,.426,13,16,.813,125,42,98,.429,34,74,.459,8,24,.333,12,16,.750,104
71,GSW,2016-03-14,125,,NOP,W 125-107,240,47,81,.580,35,56,.625,12,25,.480,19,23,.826,125,35,93,.376,28,68,.412,7,25,.280,30,34,.882,107
72,CHO,2016-03-12,125,,HOU,W 125-109,240,48,88,.545,33,57,.579,15,31,.484,14,16,.875,125,43,93,.462,38,67,.567,5,26,.192,18,28,.643,109
73,DET,2016-03-12,125,@,PHI,W 125-111,240,49,91,.538,40,73,.548,9,18,.500,18,22,.818,125,39,84,.464,29,59,.492,10,25,.400,23,27,.852,111
74,GSW,2016-01-20,125,@,CHI,W 125-94,240,50,95,.526,38,63,.603,12,32,.375,13,20,.650,125,37,100,.370,36,80,.450,1,20,.050,19,24,.792,94
75,CLE,2016-01-08,125,@,MIN,W 125-99,240,43,81,.531,30,54,.556,13,27,.481,26,29,.897,125,36,79,.456,29,63,.460,7,16,.438,20,26,.769,99
76,DEN,2015-12-20,125,,NOP,L 125-130,240,45,96,.469,28,61,.459,17,35,.486,18,22,.818,125,44,78,.564,33,54,.611,11,24,.458,31,39,.795,130
77,OKC,2015-12-08,125,@,MEM,W 125-88,240,47,84,.560,34,58,.586,13,26,.500,18,23,.783,125,33,81,.407,30,67,.448,3,14,.214,19,22,.864,88
78,OKC,2015-11-10,125,@,WAS,W 125-101,240,44,86,.512,29,63,.460,15,23,.652,22,29,.759,125,38,97,.392,33,73,.452,5,24,.208,20,26,.769,101
79,BOS,2016-04-08,124,,MIL,W 124-109,240,44,78,.564,38,64,.594,6,14,.429,30,38,.789,124,41,84,.488,34,67,.507,7,17,.412,20,29,.690,109
80,PHO,2016-04-07,124,@,HOU,W 124-115,240,44,94,.468,32,63,.508,12,31,.387,24,29,.828,124,42,74,.568,28,41,.683,14,33,.424,17,28,.607,115
81,OKC,2016-04-05,124,@,DEN,W 124-102,240,46,87,.529,31,54,.574,15,33,.455,17,24,.708,124,37,88,.420,27,58,.466,10,30,.333,18,27,.667,102
82,MIN,2016-04-05,124,@,GSW,W 124-117 (OT),265,44,86,.512,36,69,.522,8,17,.471,28,36,.778,124,49,98,.500,37,63,.587,12,35,.343,7,8,.875,117
83,CLE,2016-03-21,124,,DEN,W 124-91,240,48,86,.558,33,55,.600,15,31,.484,13,17,.765,124,32,81,.395,24,59,.407,8,22,.364,19,25,.760,91
84,WAS,2016-03-14,124,,DET,W 124-81,240,51,90,.567,43,72,.597,8,18,.444,14,18,.778,124,32,79,.405,29,56,.518,3,23,.130,14,22,.636,81
85,MIA,2016-03-14,124,,DEN,W 124-119,240,47,79,.595,39,62,.629,8,17,.471,22,28,.786,124,49,93,.527,42,73,.575,7,20,.350,14,20,.700,119
86,ORL,2016-02-23,124,@,PHI,W 124-115,240,41,85,.482,34,71,.479,7,14,.500,35,41,.854,124,43,79,.544,33,58,.569,10,21,.476,19,26,.731,115
87,MIN,2016-02-22,124,,BOS,W 124-122,240,43,83,.518,35,68,.515,8,15,.533,30,40,.750,124,49,101,.485,39,73,.534,10,28,.357,14,17,.824,122
88,LAC,2016-02-22,124,,PHO,W 124-84,240,44,80,.550,31,56,.554,13,24,.542,23,35,.657,124,31,88,.352,24,64,.375,7,24,.292,15,20,.750,84
89,ATL,2016-02-03,124,@,PHI,W 124-86,240,48,92,.522,38,72,.528,10,20,.500,18,25,.720,124,35,84,.417,29,57,.509,6,27,.222,10,14,.714,86
90,CHO,2016-01-18,124,,UTA,W 124-119 (2OT),290,41,88,.466,27,61,.443,14,27,.519,28,32,.875,124,44,104,.423,29,59,.492,15,45,.333,16,20,.800,119
91,GSW,2015-12-11,124,@,BOS,W 124-119 (2OT),290,42,107,.393,33,76,.434,9,31,.290,31,39,.795,124,49,114,.430,37,81,.457,12,33,.364,9,16,.563,119
92,GSW,2015-11-19,124,@,LAC,W 124-117,240,38,73,.521,21,43,.488,17,30,.567,31,36,.861,124,44,88,.500,31,59,.525,13,29,.448,16,24,.667,117
93,OKC,2015-11-08,124,,PHO,W 124-103,240,49,94,.521,45,74,.608,4,20,.200,22,30,.733,124,38,84,.452,31,68,.456,7,16,.438,20,26,.769,103
94,IND,2016-04-06,123,,CLE,W 123-109,240,45,80,.563,29,49,.592,16,31,.516,17,22,.773,123,35,74,.473,27,45,.600,8,29,.276,31,34,.912,109
95,UTA,2016-03-28,123,,LAL,W 123-75,240,46,89,.517,29,57,.509,17,32,.531,14,19,.737,123,26,85,.306,19,65,.292,7,20,.350,16,22,.727,75
96,NOP,2016-03-16,123,@,SAC,W 123-108,240,49,90,.544,37,69,.536,12,21,.571,13,16,.813,123,42,90,.467,33,72,.458,9,18,.500,15,17,.882,108
97,GSW,2016-03-12,123,,PHO,W 123-116,240,42,84,.500,31,51,.608,11,33,.333,28,33,.848,123,45,92,.489,34,63,.540,11,29,.379,15,20,.750,116
98,DET,2016-03-06,123,,POR,W 123-103,240,44,84,.524,32,62,.516,12,22,.545,23,28,.821,123,35,78,.449,24,47,.511,11,31,.355,22,23,.957,103
99,NOP,2016-02-25,123,,OKC,W 123-119,240,47,90,.522,35,70,.500,12,20,.600,17,18,.944,123,47,86,.547,39,67,.582,8,19,.421,17,22,.773,119
100,GSW,2016-02-09,123,,HOU,W 123-110,240,44,94,.468,32,60,.533,12,34,.353,23,26,.885,123,37,87,.425,24,54,.444,13,33,.394,23,35,.657,110
101,WAS,2016-01-30,123,@,HOU,W 123-122,240,45,86,.523,34,54,.630,11,32,.344,22,30,.733,123,41,86,.477,24,51,.471,17,35,.486,23,33,.697,122
102,MIN,2016-01-27,123,,OKC,L 123-126,240,50,90,.556,45,76,.592,5,14,.357,18,28,.643,123,48,91,.527,38,71,.535,10,20,.500,20,21,.952,126
103,DET,2016-01-20,123,@,HOU,W 123-114,240,38,80,.475,26,50,.520,12,30,.400,35,59,.593,123,43,95,.453,31,71,.437,12,24,.500,16,18,.889,114
104,SAS,2016-01-06,123,,UTA,W 123-98,240,52,86,.605,43,65,.662,9,21,.429,10,13,.769,123,37,79,.468,30,61,.492,7,18,.389,17,18,.944,98
105,SAS,2016-01-04,123,@,MIL,W 123-98,240,49,90,.544,40,70,.571,9,20,.450,16,20,.800,123,37,77,.481,34,65,.523,3,12,.250,21,30,.700,98
106,MIL,2015-12-29,123,@,OKC,L 123-131,240,49,100,.490,39,84,.464,10,16,.625,15,22,.682,123,43,86,.500,35,64,.547,8,22,.364,37,40,.925,131
107,CHO,2015-12-11,123,@,MEM,W 123-99,240,39,78,.500,21,41,.512,18,37,.486,27,30,.900,123,32,80,.400,25,60,.417,7,20,.350,28,37,.757,99
108,MIN,2015-12-09,123,,LAL,W 123-122 (OT),265,46,93,.495,39,74,.527,7,19,.368,24,31,.774,123,48,93,.516,39,70,.557,9,23,.391,17,27,.630,122
109,IND,2015-12-08,123,,GSW,L 123-131,240,44,100,.440,30,67,.448,14,33,.424,21,26,.808,123,52,95,.547,36,60,.600,16,35,.457,11,15,.733,131
110,POR,2015-12-03,123,,IND,W 123-111,240,44,85,.518,26,49,.531,18,36,.500,17,20,.850,123,38,88,.432,25,58,.431,13,30,.433,22,24,.917,111
111,IND,2015-11-24,123,@,WAS,W 123-106,240,44,80,.550,25,54,.463,19,26,.731,16,23,.696,123,38,83,.458,25,50,.500,13,33,.394,17,24,.708,106
112,IND,2015-11-21,123,,MIL,W 123-86,240,47,91,.516,32,61,.525,15,30,.500,14,23,.609,123,34,79,.430,29,62,.468,5,17,.294,13,19,.684,86
113,TOR,2016-04-12,122,,PHI,W 122-98,240,48,95,.505,38,70,.543,10,25,.400,16,19,.842,122,35,77,.455,20,42,.476,15,35,.429,13,25,.520,98
114,ATL,2016-03-23,122,@,WAS,W 122-101,240,45,84,.536,28,42,.667,17,42,.405,15,22,.682,122,39,92,.424,27,62,.435,12,30,.400,11,12,.917,101
115,MIA,2016-03-19,122,,CLE,W 122-101,240,46,84,.548,35,65,.538,11,19,.579,19,23,.826,122,40,76,.526,30,52,.577,10,24,.417,11,13,.846,101
116,LAC,2016-03-16,122,@,HOU,W 122-106,240,43,76,.566,31,46,.674,12,30,.400,24,32,.750,122,40,82,.488,31,57,.544,9,25,.360,17,24,.708,106
117,CHO,2016-03-09,122,,NOP,W 122-113,240,38,82,.463,23,47,.489,15,35,.429,31,38,.816,122,40,85,.471,30,52,.577,10,33,.303,23,28,.821,113
118,DAL,2016-02-26,122,,DEN,W 122-116 (OT),265,45,88,.511,34,59,.576,11,29,.379,21,27,.778,122,43,93,.462,34,64,.531,9,29,.310,21,31,.677,116
119,TOR,2016-02-22,122,@,NYK,W 122-95,240,46,87,.529,35,62,.565,11,25,.440,19,25,.760,122,37,84,.440,31,64,.484,6,20,.300,15,23,.652,95
120,BOS,2016-02-22,122,@,MIN,L 122-124,240,49,101,.485,39,73,.534,10,28,.357,14,17,.824,122,43,83,.518,35,68,.515,8,15,.533,30,40,.750,124
121,OKC,2016-02-08,122,@,PHO,W 122-106,240,42,85,.494,27,52,.519,15,33,.455,23,30,.767,122,37,73,.507,36,62,.581,1,11,.091,31,39,.795,106
122,HOU,2016-01-30,122,,WAS,L 122-123,240,41,86,.477,24,51,.471,17,35,.486,23,33,.697,122,45,86,.523,34,54,.630,11,32,.344,22,30,.733,123
123,NYK,2016-01-26,122,,OKC,L 122-128 (OT),265,44,95,.463,33,72,.458,11,23,.478,23,30,.767,122,46,99,.465,35,79,.443,11,20,.550,25,29,.862,128
124,GSW,2016-01-22,122,,IND,W 122-110,240,43,90,.478,29,57,.509,14,33,.424,22,25,.880,122,44,95,.463,41,78,.526,3,17,.176,19,27,.704,110
125,CLE,2016-01-04,122,,TOR,W 122-100,240,41,74,.554,24,41,.585,17,33,.515,23,26,.885,122,36,73,.493,28,54,.519,8,19,.421,20,29,.690,100
126,LAC,2015-12-30,122,@,CHO,W 122-117,240,37,71,.521,22,41,.537,15,30,.500,33,41,.805,122,38,88,.432,29,58,.500,9,30,.300,32,36,.889,117
127,GSW,2015-12-28,122,,SAC,W 122-103,240,43,89,.483,23,47,.489,20,42,.476,16,24,.667,122,37,95,.389,24,64,.375,13,31,.419,16,28,.571,103
128,OKC,2015-12-27,122,,DEN,W 122-112,240,48,83,.578,40,68,.588,8,15,.533,18,21,.857,122,46,94,.489,37,69,.536,9,25,.360,11,15,.733,112
129,LAL,2015-12-09,122,@,MIN,L 122-123 (OT),265,48,93,.516,39,70,.557,9,23,.391,17,27,.630,122,46,93,.495,39,74,.527,7,19,.368,24,31,.774,123
130,UTA,2015-12-05,122,,IND,W 122-119 (OT),265,43,92,.467,35,69,.507,8,23,.348,28,37,.757,122,40,93,.430,28,64,.438,12,29,.414,27,34,.794,119
131,PHO,2015-12-02,122,@,DET,L 122-127 (OT),265,47,97,.485,33,64,.516,14,33,.424,14,15,.933,122,44,87,.506,32,60,.533,12,27,.444,27,44,.614,127
132,SAC,2015-11-23,122,@,CHO,L 122-127 (OT),265,52,104,.500,44,73,.603,8,31,.258,10,16,.625,122,49,98,.500,40,69,.580,9,29,.310,20,26,.769,127
133,NOP,2015-11-22,122,,PHO,W 122-116,240,39,85,.459,28,55,.509,11,30,.367,33,40,.825,122,35,90,.389,18,54,.333,17,36,.472,29,33,.879,116
134,MEM,2015-11-16,122,,OKC,W 122-114,240,37,84,.440,25,67,.373,12,17,.706,36,39,.923,122,41,81,.506,31,57,.544,10,24,.417,22,31,.710,114
135,NYK,2015-10-28,122,@,MIL,W 122-97,240,42,93,.452,33,70,.471,9,23,.391,29,35,.829,122,30,86,.349,21,68,.309,9,18,.500,28,31,.903,97
136,CHI,2016-04-11,121,@,NOP,W 121-116,240,44,77,.571,34,54,.630,10,23,.435,23,26,.885,121,41,80,.513,29,54,.537,12,26,.462,22,28,.786,116
137,PHO,2016-04-09,121,@,NOP,W 121-100,240,43,83,.518,33,58,.569,10,25,.400,25,31,.806,121,39,95,.411,32,74,.432,7,21,.333,15,20,.750,100
138,WAS,2016-04-06,121,,BRK,W 121-103,240,48,95,.505,40,67,.597,8,28,.286,17,20,.850,121,39,92,.424,32,75,.427,7,17,.412,18,24,.750,103
139,MIN,2016-03-28,121,,PHO,W 121-116,240,41,81,.506,34,55,.618,7,26,.269,32,40,.800,121,41,84,.488,26,51,.510,15,33,.455,19,23,.826,116
140,GSW,2016-03-16,121,,NYK,W 121-85,240,46,91,.505,28,54,.519,18,37,.486,11,12,.917,121,36,91,.396,29,72,.403,7,19,.368,6,10,.600,85
141,POR,2016-03-12,121,,ORL,W 121-84,240,47,84,.560,30,49,.612,17,35,.486,10,11,.909,121,34,91,.374,27,65,.415,7,26,.269,9,18,.500,84
142,MEM,2016-03-11,121,,NOP,W 121-114 (OT),265,47,96,.490,41,82,.500,6,14,.429,21,32,.656,121,42,96,.438,35,72,.486,7,24,.292,23,34,.676,114
143,BRK,2016-03-04,121,@,DEN,W 121-120 (OT),265,46,91,.505,33,69,.478,13,22,.591,16,21,.762,121,46,96,.479,40,70,.571,6,26,.231,22,25,.880,120
144,GSW,2016-03-03,121,,OKC,W 121-106,240,47,87,.540,36,53,.679,11,34,.324,16,21,.762,121,40,86,.465,36,66,.545,4,20,.200,22,27,.815,106
145,DAL,2016-03-01,121,,ORL,W 121-108,240,43,77,.558,34,58,.586,9,19,.474,26,31,.839,121,41,91,.451,32,61,.525,9,30,.300,17,20,.850,108
146,HOU,2016-02-29,121,@,MIL,L 121-128,240,41,87,.471,26,51,.510,15,36,.417,24,35,.686,121,48,81,.593,40,66,.606,8,15,.533,24,33,.727,128
147,GSW,2016-02-27,121,@,OKC,W 121-118 (OT),265,45,95,.474,31,63,.492,14,32,.438,17,25,.680,121,46,96,.479,37,70,.529,9,26,.346,17,26,.654,118
148,BOS,2016-02-21,121,@,DEN,W 121-101,240,47,97,.485,37,65,.569,10,32,.313,17,20,.850,121,34,73,.466,28,52,.538,6,21,.286,27,34,.794,101
149,NOP,2016-02-19,121,,PHI,W 121-114,240,41,81,.506,34,64,.531,7,17,.412,32,40,.800,121,40,76,.526,28,49,.571,12,27,.444,22,26,.846,114
150,OKC,2016-02-11,121,,NOP,W 121-95,240,45,86,.523,33,54,.611,12,32,.375,19,23,.826,121,38,88,.432,35,72,.486,3,16,.188,16,24,.667,95
151,UTA,2016-02-09,121,@,DAL,W 121-119 (OT),265,48,92,.522,42,66,.636,6,26,.231,19,27,.704,121,36,75,.480,25,46,.543,11,29,.379,36,41,.878,119
152,WAS,2016-02-03,121,,GSW,L 121-134,240,46,91,.505,38,68,.559,8,23,.348,21,30,.700,121,49,93,.527,29,52,.558,20,41,.488,16,29,.552,134
153,MEM,2016-01-30,121,,SAC,W 121-117,240,41,79,.519,33,61,.541,8,18,.444,31,37,.838,121,38,92,.413,29,68,.426,9,24,.375,32,38,.842,117
154,POR,2016-01-23,121,,LAL,W 121-103,240,47,93,.505,37,62,.597,10,31,.323,17,22,.773,121,34,69,.493,27,52,.519,7,17,.412,28,32,.875,103
155,CLE,2016-01-06,121,@,WAS,W 121-115,240,48,89,.539,36,60,.600,12,29,.414,13,19,.684,121,42,76,.553,28,52,.538,14,24,.583,17,27,.630,115
156,SAS,2016-01-02,121,,HOU,W 121-103,240,45,86,.523,32,62,.516,13,24,.542,18,19,.947,121,37,74,.500,28,52,.538,9,22,.409,20,33,.606,103
157,ATL,2015-12-29,121,@,HOU,W 121-115,240,43,99,.434,29,58,.500,14,41,.341,21,25,.840,121,39,72,.542,28,52,.538,11,20,.550,26,39,.667,115
158,GSW,2015-12-18,121,,MIL,W 121-112,240,42,87,.483,33,61,.541,9,26,.346,28,37,.757,121,42,91,.462,38,73,.521,4,18,.222,24,28,.857,112
159,ATL,2015-11-24,121,,BOS,W 121-97,240,45,80,.563,33,56,.589,12,24,.500,19,22,.864,121,34,82,.415,25,61,.410,9,21,.429,20,26,.769,97
160,ATL,2015-11-06,121,@,NOP,W 121-115,240,41,77,.532,32,56,.571,9,21,.429,30,35,.857,121,42,84,.500,32,54,.593,10,30,.333,21,24,.875,115
161,WAS,2016-04-11,120,@,BRK,W 120-111,240,46,89,.517,37,64,.578,9,25,.360,19,24,.792,120,44,98,.449,34,67,.507,10,31,.323,13,21,.619,111
162,POR,2016-04-06,120,,OKC,W 120-115,240,43,84,.512,28,51,.549,15,33,.455,19,24,.792,120,43,91,.473,34,69,.493,9,22,.409,20,31,.645,115
163,SAC,2016-03-30,120,,WAS,W 120-111,240,47,84,.560,39,66,.591,8,18,.444,18,25,.720,120,43,89,.483,34,63,.540,9,26,.346,16,20,.800,111
164,BRK,2016-03-26,120,,IND,W 120-110,240,42,77,.545,37,66,.561,5,11,.455,31,36,.861,120,37,77,.481,26,53,.491,11,24,.458,25,30,.833,110
165,DAL,2016-03-25,120,@,GSW,L 120-128,240,43,96,.448,25,61,.410,18,35,.514,16,21,.762,120,43,88,.489,22,43,.512,21,45,.467,21,23,.913,128
166,BOS,2016-03-20,120,@,PHI,W 120-105,240,46,94,.489,36,69,.522,10,25,.400,18,21,.857,120,39,92,.424,31,71,.437,8,21,.381,19,27,.704,105
167,POR,2016-03-20,120,@,DAL,L 120-132 (OT),265,42,104,.404,24,58,.414,18,46,.391,18,28,.643,120,49,89,.551,34,64,.531,15,25,.600,19,23,.826,132
168,CLE,2016-03-10,120,@,LAL,W 120-108,240,45,85,.529,29,50,.580,16,35,.457,14,20,.700,120,42,80,.525,35,58,.603,7,22,.318,17,21,.810,108
169,CLE,2016-03-09,120,@,SAC,W 120-111,240,39,90,.433,26,46,.565,13,44,.295,29,35,.829,120,40,84,.476,32,62,.516,8,22,.364,23,32,.719,111
170,OKC,2016-03-09,120,,LAC,W 120-108,240,48,91,.527,39,67,.582,9,24,.375,15,18,.833,120,41,81,.506,29,47,.617,12,34,.353,14,23,.609,108
171,CLE,2016-03-05,120,,BOS,W 120-103,240,42,82,.512,32,52,.615,10,30,.333,26,34,.765,120,37,80,.463,27,57,.474,10,23,.435,19,27,.704,103
172,DEN,2016-03-04,120,,BRK,L 120-121 (OT),265,46,96,.479,40,70,.571,6,26,.231,22,25,.880,120,46,91,.505,33,69,.478,13,22,.591,16,21,.762,121
173,CLE,2016-02-10,120,,LAL,W 120-111,240,48,94,.511,35,63,.556,13,31,.419,11,18,.611,120,38,86,.442,25,58,.431,13,28,.464,22,27,.815,111
174,CLE,2016-02-08,120,,SAC,W 120-100,240,45,94,.479,29,59,.492,16,35,.457,14,19,.737,120,36,82,.439,27,59,.458,9,23,.391,19,29,.655,100
175,LAC,2016-01-31,120,,CHI,W 120-93,240,45,84,.536,28,52,.538,17,32,.531,13,19,.684,120,40,93,.430,35,78,.449,5,15,.333,8,11,.727,93
176,GSW,2016-01-25,120,,SAS,W 120-90,240,44,85,.518,33,59,.559,11,26,.423,21,25,.840,120,31,74,.419,26,60,.433,5,14,.357,23,31,.742,90
177,CHO,2016-01-22,120,@,ORL,W 120-116 (OT),265,45,101,.446,35,74,.473,10,27,.370,20,22,.909,120,45,91,.495,34,68,.500,11,23,.478,15,19,.789,116
178,NYK,2016-01-12,120,,BOS,W 120-114,240,43,81,.531,36,61,.590,7,20,.350,27,30,.900,120,42,86,.488,33,57,.579,9,29,.310,21,26,.808,114
179,ATL,2016-01-09,120,,CHI,W 120-105,240,49,94,.521,39,70,.557,10,24,.417,12,15,.800,120,36,83,.434,29,65,.446,7,18,.389,26,31,.839,105
180,MIL,2015-12-31,120,@,IND,W 120-116,240,45,77,.584,39,63,.619,6,14,.429,24,35,.686,120,41,82,.500,28,52,.538,13,30,.433,21,26,.808,116
181,OKC,2015-12-23,120,@,LAL,W 120-85,240,51,95,.537,46,76,.605,5,19,.263,13,17,.765,120,32,89,.360,25,64,.391,7,25,.280,14,22,.636,85
182,HOU,2015-12-05,120,,SAC,W 120-113,240,36,78,.462,20,44,.455,16,34,.471,32,43,.744,120,46,98,.469,36,72,.500,10,26,.385,11,13,.846,113
183,GSW,2015-11-28,120,,SAC,W 120-101,240,39,80,.488,23,50,.460,16,30,.533,26,31,.839,120,39,100,.390,29,75,.387,10,25,.400,13,15,.867,101
184,NOP,2015-11-25,120,@,PHO,W 120-114,240,42,81,.519,32,59,.542,10,22,.455,26,34,.765,120,44,96,.458,34,70,.486,10,26,.385,16,20,.800,114
185,BOS,2015-11-20,120,,BRK,W 120-95,240,51,87,.586,41,58,.707,10,29,.345,8,10,.800,120,35,89,.393,27,70,.386,8,19,.421,17,24,.708,95
186,PHO,2015-11-16,120,,LAL,W 120-101,240,45,93,.484,34,63,.540,11,30,.367,19,25,.760,120,37,77,.481,28,57,.491,9,20,.450,18,20,.900,101
187,NOP,2015-11-10,120,,DAL,W 120-105,240,46,92,.500,32,59,.542,14,33,.424,14,18,.778,120,39,88,.443,34,68,.500,5,20,.250,22,26,.846,105
188,DET,2015-11-08,120,@,POR,W 120-103,240,47,96,.490,36,66,.545,11,30,.367,15,22,.682,120,41,76,.539,32,51,.627,9,25,.360,12,18,.667,103
189,DEN,2015-11-03,120,@,LAL,W 120-109,240,43,85,.506,36,65,.554,7,20,.350,27,31,.871,120,36,86,.419,30,60,.500,6,26,.231,31,38,.816,109
190,NOP,2015-10-31,120,,GSW,L 120-134,240,46,100,.460,38,78,.487,8,22,.364,20,23,.870,120,46,84,.548,29,54,.537,17,30,.567,25,35,.714,134
191,ORL,2016-04-03,119,,MEM,W 119-107,240,43,90,.478,33,64,.516,10,26,.385,23,29,.793,119,41,89,.461,33,68,.485,8,21,.381,17,26,.654,107
192,OKC,2016-03-31,119,,LAC,W 119-117,240,45,87,.517,35,55,.636,10,32,.313,19,24,.792,119,42,76,.553,26,47,.553,16,29,.552,17,22,.773,117
193,OKC,2016-03-28,119,@,TOR,W 119-100,240,41,86,.477,30,60,.500,11,26,.423,26,32,.813,119,38,93,.409,30,69,.435,8,24,.333,16,23,.696,100
194,PHO,2016-03-23,119,,LAL,W 119-107,240,47,93,.505,34,65,.523,13,28,.464,12,20,.600,119,39,93,.419,32,66,.485,7,27,.259,22,26,.846,107
195,DEN,2016-03-14,119,@,MIA,L 119-124,240,49,93,.527,42,73,.575,7,20,.350,14,20,.700,119,47,79,.595,39,62,.629,8,17,.471,22,28,.786,124
196,GSW,2016-03-07,119,,ORL,W 119-113,240,42,84,.500,26,49,.531,16,35,.457,19,27,.704,119,40,90,.444,35,69,.507,5,21,.238,28,34,.824,113
197,CHO,2016-03-02,119,@,PHI,W 119-99,240,40,81,.494,30,56,.536,10,25,.400,29,35,.829,119,34,85,.400,21,52,.404,13,33,.394,18,26,.692,99
198,HOU,2016-02-25,119,@,POR,W 119-105,240,44,82,.537,34,53,.642,10,29,.345,21,35,.600,119,37,80,.463,24,45,.533,13,35,.371,18,22,.818,105
199,OKC,2016-02-25,119,@,NOP,L 119-123,240,47,86,.547,39,67,.582,8,19,.421,17,22,.773,119,47,90,.522,35,70,.500,12,20,.600,17,18,.944,123
200,LAL,2016-02-24,119,@,MEM,L 119-128,240,39,88,.443,22,49,.449,17,39,.436,24,33,.727,119,48,85,.565,35,58,.603,13,27,.481,19,29,.655,128
201,SAS,2016-02-19,119,@,LAL,W 119-113,240,48,88,.545,42,76,.553,6,12,.500,17,18,.944,119,40,81,.494,30,59,.508,10,22,.455,23,26,.885,113
202,SAS,2016-02-09,119,@,MIA,W 119-101,240,47,89,.528,41,75,.547,6,14,.429,19,26,.731,119,40,70,.571,36,58,.621,4,12,.333,17,24,.708,101
203,DAL,2016-02-09,119,,UTA,L 119-121 (OT),265,36,75,.480,25,46,.543,11,29,.379,36,41,.878,119,48,92,.522,42,66,.636,6,26,.231,19,27,.704,121
204,SAC,2016-02-07,119,@,BOS,L 119-128,240,47,95,.495,37,69,.536,10,26,.385,15,19,.789,119,51,91,.560,38,67,.567,13,24,.542,13,15,.867,128
205,SAC,2016-02-05,119,@,BRK,L 119-128,240,45,89,.506,37,63,.587,8,26,.308,21,22,.955,119,48,86,.558,30,58,.517,18,28,.643,14,15,.933,128
206,LAL,2016-02-02,119,,MIN,W 119-115,240,40,80,.500,28,54,.519,12,26,.462,27,35,.771,119,46,80,.575,42,63,.667,4,17,.235,19,25,.760,115
207,ORL,2016-01-31,119,,BOS,W 119-114,240,44,82,.537,34,58,.586,10,24,.417,21,35,.600,119,39,93,.419,23,47,.489,16,46,.348,20,25,.800,114
208,ATL,2016-01-25,119,@,DEN,W 119-105,240,43,86,.500,34,59,.576,9,27,.333,24,26,.923,119,33,84,.393,27,64,.422,6,20,.300,33,37,.892,105
209,NYK,2016-01-18,119,,PHI,W 119-113 (2OT),290,43,97,.443,35,77,.455,8,20,.400,25,30,.833,119,45,102,.441,35,74,.473,10,28,.357,13,25,.520,113
210,UTA,2016-01-18,119,@,CHO,L 119-124 (2OT),290,44,104,.423,29,59,.492,15,45,.333,16,20,.800,119,41,88,.466,27,61,.443,14,27,.519,28,32,.875,124
211,BOS,2016-01-16,119,@,WAS,W 119-117,240,39,88,.443,30,59,.508,9,29,.310,32,36,.889,119,40,89,.449,34,67,.507,6,22,.273,31,36,.861,117
212,PHO,2016-01-02,119,@,SAC,L 119-142,240,43,83,.518,33,54,.611,10,29,.345,23,28,.821,119,53,87,.609,44,64,.688,9,23,.391,27,34,.794,142
213,DAL,2015-12-23,119,@,BRK,W 119-118 (OT),265,45,82,.549,29,48,.604,16,34,.471,13,15,.867,119,51,101,.505,41,82,.500,10,19,.526,6,14,.429,118
214,DET,2015-12-16,119,,BOS,W 119-116,240,38,78,.487,27,57,.474,11,21,.524,32,43,.744,119,43,89,.483,33,64,.516,10,25,.400,20,24,.833,116
215,BOS,2015-12-11,119,,GSW,L 119-124 (2OT),290,49,114,.430,37,81,.457,12,33,.364,9,16,.563,119,42,107,.393,33,76,.434,9,31,.290,31,39,.795,124
216,SAS,2015-12-07,119,@,PHI,W 119-68,240,47,76,.618,43,65,.662,4,11,.364,21,25,.840,119,26,75,.347,22,51,.431,4,24,.167,12,21,.571,68
217,IND,2015-12-05,119,@,UTA,L 119-122 (OT),265,40,93,.430,28,64,.438,12,29,.414,27,34,.794,119,43,92,.467,35,69,.507,8,23,.348,28,37,.757,122
218,TOR,2015-11-11,119,@,PHI,W 119-103,240,43,89,.483,38,71,.535,5,18,.278,28,31,.903,119,40,87,.460,28,58,.483,12,29,.414,11,17,.647,103
219,GSW,2015-11-06,119,,DEN,W 119-104,240,46,93,.495,29,56,.518,17,37,.459,10,18,.556,119,39,92,.424,31,68,.456,8,24,.333,18,22,.818,104
220,HOU,2015-11-04,119,,ORL,W 119-114 (OT),265,42,88,.477,31,54,.574,11,34,.324,24,34,.706,119,46,91,.505,39,71,.549,7,20,.350,15,19,.789,114
221,GSW,2015-11-02,119,,MEM,W 119-69,240,43,84,.512,32,59,.542,11,25,.440,22,30,.733,119,26,96,.271,23,73,.315,3,23,.130,14,20,.700,69
222,MIA,2016-04-10,118,,ORL,W 118-96,240,43,77,.558,37,57,.649,6,20,.300,26,30,.867,118,37,83,.446,30,65,.462,7,18,.389,15,19,.789,96
223,ATL,2016-04-09,118,,BOS,W 118-107,240,46,88,.523,29,55,.527,17,33,.515,9,11,.818,118,40,90,.444,29,62,.468,11,28,.393,16,24,.667,107
224,HOU,2016-04-03,118,,OKC,W 118-110,240,41,102,.402,28,60,.467,13,42,.310,23,26,.885,118,38,82,.463,31,55,.564,7,27,.259,27,32,.844,110
225,DET,2016-03-23,118,,ORL,W 118-102,240,43,80,.538,32,56,.571,11,24,.458,21,25,.840,118,39,98,.398,31,73,.425,8,25,.320,16,19,.842,102
226,CHI,2016-03-17,118,,BRK,W 118-102,240,46,94,.489,35,70,.500,11,24,.458,15,15,1.000,118,40,86,.465,34,65,.523,6,21,.286,16,20,.800,102
227,SAS,2016-03-17,118,,POR,W 118-110,240,45,86,.523,37,70,.529,8,16,.500,20,22,.909,118,39,89,.438,29,67,.433,10,22,.455,22,30,.733,110
228,ATL,2016-03-16,118,@,DET,W 118-114,240,39,89,.438,27,55,.491,12,34,.353,28,34,.824,118,39,84,.464,31,59,.525,8,25,.320,28,39,.718,114
229,CHO,2016-03-11,118,,DET,W 118-103,240,42,83,.506,32,58,.552,10,25,.400,24,29,.828,118,36,76,.474,27,46,.587,9,30,.300,22,27,.815,103
230,MIA,2016-03-11,118,@,CHI,W 118-96,240,47,91,.516,37,73,.507,10,18,.556,14,20,.700,118,38,81,.469,30,60,.500,8,21,.381,12,15,.800,96
231,HOU,2016-03-09,118,@,PHI,W 118-104,240,38,86,.442,27,53,.509,11,33,.333,31,41,.756,118,35,86,.407,23,53,.434,12,33,.364,22,32,.688,104
232,BRK,2016-03-05,118,@,MIN,L 118-132,240,45,92,.489,36,66,.545,9,26,.346,19,26,.731,118,52,76,.684,42,58,.724,10,18,.556,18,22,.818,132
233,OKC,2016-02-27,118,,GSW,L 118-121 (OT),265,46,96,.479,37,70,.529,9,26,.346,17,26,.654,118,45,95,.474,31,63,.492,14,32,.438,17,25,.680,121
234,GSW,2016-02-24,118,@,MIA,W 118-112,240,42,90,.467,29,62,.468,13,28,.464,21,25,.840,118,40,86,.465,34,72,.472,6,14,.429,26,31,.839,112
235,SAS,2016-02-21,118,@,PHO,W 118-111,240,43,82,.524,33,66,.500,10,16,.625,22,34,.647,118,43,93,.462,34,69,.493,9,24,.375,16,22,.727,111
236,NYK,2016-01-20,118,,UTA,W 118-111 (OT),265,47,90,.522,40,73,.548,7,17,.412,17,18,.944,118,37,86,.430,25,59,.424,12,27,.444,25,31,.806,111
237,DAL,2016-01-18,118,,BOS,W 118-113 (OT),265,40,93,.430,24,59,.407,16,34,.471,22,24,.917,118,40,94,.426,28,64,.438,12,30,.400,21,26,.808,113
238,WAS,2016-01-15,118,@,IND,W 118-104,240,51,98,.520,40,73,.548,11,25,.440,5,10,.500,118,38,80,.475,35,63,.556,3,17,.176,25,32,.781,104
239,SAC,2016-01-07,118,,LAL,W 118-115,240,47,85,.553,41,64,.641,6,21,.286,18,27,.667,118,41,76,.539,33,52,.635,8,24,.333,25,29,.862,115
240,DAL,2015-12-26,118,,CHI,W 118-111,240,40,87,.460,24,54,.444,16,33,.485,22,28,.786,118,42,78,.538,34,57,.596,8,21,.381,19,26,.731,111
241,BRK,2015-12-23,118,,DAL,L 118-119 (OT),265,51,101,.505,41,82,.500,10,19,.526,6,14,.429,118,45,82,.549,29,48,.604,16,34,.471,13,15,.867,119
242,OKC,2015-12-19,118,,LAL,W 118-78,240,46,84,.548,37,65,.569,9,19,.474,17,25,.680,118,30,86,.349,22,58,.379,8,28,.286,10,17,.588,78
243,SAS,2015-12-14,118,,UTA,W 118-81,240,42,75,.560,33,54,.611,9,21,.429,25,27,.926,118,32,79,.405,29,68,.426,3,11,.273,14,17,.824,81
244,DET,2015-12-12,118,,IND,W 118-96,240,45,90,.500,32,61,.525,13,29,.448,15,19,.789,118,41,82,.500,38,66,.576,3,16,.188,11,18,.611,96
245,MIL,2015-11-25,118,,SAC,L 118-129,240,42,88,.477,29,57,.509,13,31,.419,21,27,.778,118,44,77,.571,34,54,.630,10,23,.435,31,37,.838,129
246,GSW,2015-11-22,118,@,DEN,W 118-105,240,47,89,.528,32,60,.533,15,29,.517,9,13,.692,118,37,86,.430,33,71,.465,4,15,.267,27,35,.771,105
247,PHO,2015-11-12,118,,LAC,W 118-104,240,44,83,.530,30,53,.566,14,30,.467,16,21,.762,118,40,90,.444,31,64,.484,9,26,.346,15,28,.536,104
248,DAL,2015-11-11,118,,LAC,W 118-108,240,42,76,.553,31,52,.596,11,24,.458,23,30,.767,118,37,86,.430,25,59,.424,12,27,.444,22,33,.667,108
249,CLE,2015-11-10,118,,UTA,W 118-114,240,37,74,.500,26,50,.520,11,24,.458,33,43,.767,118,40,82,.488,30,60,.500,10,22,.455,24,28,.857,114
250,BOS,2015-11-06,118,,WAS,W 118-98,240,44,97,.454,32,67,.478,12,30,.400,18,23,.783,118,36,88,.409,28,63,.444,8,25,.320,18,23,.783,98
251,PHO,2015-11-04,118,,SAC,W 118-97,240,45,83,.542,31,60,.517,14,23,.609,14,22,.636,118,40,84,.476,29,60,.483,11,24,.458,6,12,.500,97
252,WAS,2015-10-30,118,@,MIL,W 118-113,240,35,68,.515,23,47,.489,12,21,.571,36,44,.818,118,42,82,.512,35,58,.603,7,24,.292,22,28,.786,113
253,CHO,2016-04-13,117,,ORL,W 117-103,240,47,86,.547,36,57,.632,11,29,.379,12,19,.632,117,42,91,.462,34,64,.531,8,27,.296,11,18,.611,103
254,GSW,2016-04-05,117,,MIN,L 117-124 (OT),265,49,98,.500,37,63,.587,12,35,.343,7,8,.875,117,44,86,.512,36,69,.522,8,17,.471,28,36,.778,124
255,LAC,2016-03-31,117,@,OKC,L 117-119,240,42,76,.553,26,47,.553,16,29,.552,17,22,.773,117,45,87,.517,35,55,.636,10,32,.313,19,24,.792,119
256,GSW,2016-03-27,117,,PHI,W 117-105,240,44,83,.530,30,50,.600,14,33,.424,15,20,.750,117,42,90,.467,32,60,.533,10,30,.333,11,12,.917,105
257,WAS,2016-03-21,117,@,ATL,W 117-102,240,46,91,.505,33,66,.500,13,25,.520,12,20,.600,117,38,78,.487,25,45,.556,13,33,.394,13,17,.765,102
258,POR,2016-03-18,117,@,NOP,W 117-112,240,36,78,.462,27,51,.529,9,27,.333,36,40,.900,117,40,83,.482,30,62,.484,10,21,.476,22,28,.786,112
259,WAS,2016-03-16,117,,CHI,W 117-96,240,43,88,.489,30,67,.448,13,21,.619,18,24,.750,117,35,87,.402,29,67,.433,6,20,.300,20,23,.870,96
260,TOR,2016-03-04,117,,POR,W 117-115,240,34,67,.507,28,55,.509,6,12,.500,43,54,.796,117,39,83,.470,28,56,.500,11,27,.407,26,35,.743,115
261,DEN,2016-03-02,117,,LAL,W 117-107,240,38,78,.487,26,55,.473,12,23,.522,29,38,.763,117,35,79,.443,24,48,.500,11,31,.355,26,32,.813,107
262,LAC,2016-02-26,117,@,SAC,W 117-107,240,43,89,.483,34,60,.567,9,29,.310,22,26,.846,117,34,78,.436,22,54,.407,12,24,.500,27,37,.730,107
263,UTA,2016-02-23,117,,HOU,W 117-114 (OT),265,38,74,.514,28,50,.560,10,24,.417,31,38,.816,117,36,87,.414,25,53,.472,11,34,.324,31,41,.756,114
264,MIL,2016-02-20,117,@,ATL,W 117-109 (2OT),290,46,104,.442,43,87,.494,3,17,.176,22,32,.688,117,44,106,.415,35,65,.538,9,41,.220,12,18,.667,109
265,MIN,2016-02-10,117,,TOR,W 117-112,240,35,76,.461,31,62,.500,4,14,.286,43,53,.811,117,39,86,.453,29,55,.527,10,31,.323,24,32,.750,112
266,CHO,2016-02-10,117,@,IND,W 117-95,240,45,87,.517,33,59,.559,12,28,.429,15,19,.789,117,40,92,.435,36,74,.486,4,18,.222,11,15,.733,95
267,ORL,2016-02-08,117,@,ATL,W 117-110 (OT),265,46,93,.495,37,64,.578,9,29,.310,16,22,.727,117,43,92,.467,31,63,.492,12,29,.414,12,20,.600,110
268,OKC,2016-02-03,117,,ORL,W 117-114,240,44,93,.473,35,66,.530,9,27,.333,20,25,.800,117,47,95,.495,37,72,.514,10,23,.435,10,12,.833,114
269,SAC,2016-01-30,117,@,MEM,L 117-121,240,38,92,.413,29,68,.426,9,24,.375,32,38,.842,117,41,79,.519,33,61,.541,8,18,.444,31,37,.838,121
270,CLE,2016-01-30,117,,SAS,W 117-103,240,45,82,.549,36,59,.610,9,23,.391,18,21,.857,117,40,81,.494,34,63,.540,6,18,.333,17,21,.810,103
271,DEN,2016-01-28,117,@,WAS,W 117-113,240,41,81,.506,32,63,.508,9,18,.500,26,33,.788,117,39,88,.443,28,60,.467,11,28,.393,24,30,.800,113
272,SAS,2016-01-21,117,@,PHO,W 117-89,240,42,86,.488,33,72,.458,9,14,.643,24,28,.857,117,32,81,.395,26,63,.413,6,18,.333,19,23,.826,89
273,MIN,2016-01-17,117,,PHO,W 117-87,240,39,69,.565,32,51,.627,7,18,.389,32,40,.800,117,35,81,.432,32,66,.485,3,15,.200,14,25,.560,87
274,WAS,2016-01-16,117,,BOS,L 117-119,240,40,89,.449,34,67,.507,6,22,.273,31,36,.861,117,39,88,.443,30,59,.508,9,29,.310,32,36,.889,119
275,BOS,2016-01-15,117,,PHO,W 117-103,240,42,96,.438,28,66,.424,14,30,.467,19,29,.655,117,35,89,.393,25,62,.403,10,27,.370,23,28,.821,103
276,OKC,2016-01-08,117,@,LAL,W 117-113,240,45,89,.506,40,72,.556,5,17,.294,22,26,.846,117,40,84,.476,31,58,.534,9,26,.346,24,25,.960,113
277,CHI,2016-01-05,117,,MIL,W 117-106,240,46,83,.554,41,64,.641,5,19,.263,20,20,1.000,117,46,102,.451,40,86,.465,6,16,.375,8,14,.571,106
278,DAL,2016-01-05,117,,SAC,W 117-116 (2OT),290,45,98,.459,33,69,.478,12,29,.414,15,23,.652,117,47,99,.475,35,67,.522,12,32,.375,10,14,.714,116
279,CHO,2015-12-30,117,,LAC,L 117-122,240,38,88,.432,29,58,.500,9,30,.300,32,36,.889,117,37,71,.521,22,41,.537,15,30,.500,33,41,.805,122
280,ATL,2015-12-26,117,,NYK,W 117-98,240,47,88,.534,39,63,.619,8,25,.320,15,18,.833,117,39,81,.481,32,57,.561,7,24,.292,13,17,.765,98
281,CLE,2015-11-23,117,,ORL,W 117-103,240,43,81,.531,25,46,.543,18,35,.514,13,22,.591,117,40,81,.494,30,59,.508,10,22,.455,13,21,.619,103
282,OKC,2015-11-22,117,,DAL,W 117-114,240,47,90,.522,38,68,.559,9,22,.409,14,18,.778,117,44,83,.530,34,64,.531,10,19,.526,16,28,.571,114
283,LAC,2015-11-19,117,,GSW,L 117-124,240,44,88,.500,31,59,.525,13,29,.448,16,24,.667,117,38,73,.521,21,43,.488,17,30,.567,31,36,.861,124
284,MIN,2015-11-09,117,@,ATL,W 117-107,240,46,80,.575,39,65,.600,7,15,.467,18,22,.818,117,44,86,.512,31,55,.564,13,31,.419,6,7,.857,107
285,OKC,2015-11-01,117,,DEN,W 117-93,240,45,86,.523,32,61,.525,13,25,.520,14,18,.778,117,35,92,.380,26,66,.394,9,26,.346,14,19,.737,93
286,NYK,2015-10-31,117,@,WAS,W 117-110,240,41,86,.477,32,67,.478,9,19,.474,26,32,.813,117,38,90,.422,32,68,.471,6,22,.273,28,33,.848,110
287,HOU,2016-04-13,116,,SAC,W 116-81,240,47,97,.485,37,62,.597,10,35,.286,12,19,.632,116,32,96,.333,21,59,.356,11,37,.297,6,13,.462,81
288,NOP,2016-04-11,116,,CHI,L 116-121,240,41,80,.513,29,54,.537,12,26,.462,22,28,.786,116,44,77,.571,34,54,.630,10,23,.435,23,26,.885,121
289,POR,2016-03-31,116,,BOS,W 116-109,240,41,90,.456,27,56,.482,14,34,.412,20,27,.741,116,37,88,.420,28,64,.438,9,24,.375,26,34,.765,109
290,PHO,2016-03-28,116,@,MIN,L 116-121,240,41,84,.488,26,51,.510,15,33,.455,19,23,.826,116,41,81,.506,34,55,.618,7,26,.269,32,40,.800,121
291,DEN,2016-03-25,116,@,LAL,W 116-105,240,45,94,.479,35,68,.515,10,26,.385,16,24,.667,116,37,85,.435,27,62,.435,10,23,.435,21,26,.808,105
292,SAC,2016-03-25,116,,PHO,W 116-94,240,40,90,.444,33,68,.485,7,22,.318,29,39,.744,116,35,94,.372,26,62,.419,9,32,.281,15,23,.652,94
293,HOU,2016-03-18,116,,MIN,W 116-111,240,48,85,.565,37,56,.661,11,29,.379,9,14,.643,116,43,85,.506,37,69,.536,6,16,.375,19,24,.792,111
294,ATL,2016-03-17,116,,DEN,W 116-98,240,40,80,.500,28,54,.519,12,26,.462,24,28,.857,116,39,87,.448,33,65,.508,6,22,.273,14,17,.824,98
295,ORL,2016-03-15,116,,DEN,W 116-110,240,44,81,.543,36,56,.643,8,25,.320,20,25,.800,116,40,80,.500,31,56,.554,9,24,.375,21,24,.875,110
296,DEN,2016-03-12,116,,WAS,W 116-100,240,42,80,.525,34,56,.607,8,24,.333,24,29,.828,116,36,86,.419,29,65,.446,7,21,.333,21,29,.724,100
297,PHO,2016-03-12,116,@,GSW,L 116-123,240,45,92,.489,34,63,.540,11,29,.379,15,20,.750,116,42,84,.500,31,51,.608,11,33,.333,28,33,.848,123
298,DEN,2016-03-10,116,,PHO,W 116-98,240,44,91,.484,31,63,.492,13,28,.464,15,19,.789,116,33,89,.371,27,61,.443,6,28,.214,26,33,.788,98
299,BOS,2016-03-09,116,,MEM,W 116-96,240,41,87,.471,26,55,.473,15,32,.469,19,24,.792,116,32,84,.381,25,58,.431,7,26,.269,25,31,.806,96
300,SAS,2016-03-08,116,@,MIN,W 116-91,240,47,85,.553,43,66,.652,4,19,.211,18,19,.947,116,36,79,.456,32,64,.500,4,15,.267,15,19,.789,91
301,POR,2016-03-08,116,,WAS,W 116-109 (OT),265,41,89,.461,31,65,.477,10,24,.417,24,31,.774,116,45,99,.455,37,79,.468,8,20,.400,11,23,.478,109
302,DEN,2016-03-06,116,,DAL,W 116-114 (OT),265,44,107,.411,35,81,.432,9,26,.346,19,25,.760,116,41,93,.441,25,52,.481,16,41,.390,16,20,.800,114
303,MIL,2016-03-04,116,,MIN,W 116-101,240,43,83,.518,29,59,.492,14,24,.583,16,20,.800,116,42,87,.483,35,65,.538,7,22,.318,10,14,.714,101
304,BOS,2016-03-02,116,,POR,W 116-93,240,43,107,.402,36,81,.444,7,26,.269,23,24,.958,116,34,84,.405,23,55,.418,11,29,.379,14,20,.700,93
305,SAC,2016-02-29,116,,OKC,L 116-131,240,48,107,.449,41,82,.500,7,25,.280,13,19,.684,116,47,82,.573,33,48,.688,14,34,.412,23,26,.885,131
306,WAS,2016-02-29,116,,PHI,W 116-108,240,43,89,.483,37,69,.536,6,20,.300,24,31,.774,116,43,89,.483,33,57,.579,10,32,.313,12,21,.571,108
307,PHI,2016-02-28,116,@,ORL,L 116-130,240,41,77,.532,36,55,.655,5,22,.227,29,37,.784,116,49,86,.570,39,70,.557,10,16,.625,22,25,.880,130
308,DEN,2016-02-26,116,@,DAL,L 116-122 (OT),265,43,93,.462,34,64,.531,9,29,.310,21,31,.677,116,45,88,.511,34,59,.576,11,29,.379,21,27,.778,122
309,BRK,2016-02-25,116,@,PHO,W 116-106,240,37,75,.493,29,57,.509,8,18,.444,34,42,.810,116,42,98,.429,33,71,.465,9,27,.333,13,23,.565,106
310,OKC,2016-02-24,116,@,DAL,W 116-103,240,43,89,.483,31,56,.554,12,33,.364,18,22,.818,116,35,86,.407,26,58,.448,9,28,.321,24,30,.800,103
311,CHI,2016-02-19,116,,TOR,W 116-106,240,48,93,.516,41,77,.532,7,16,.438,13,20,.650,116,38,88,.432,33,70,.471,5,18,.278,25,34,.735,106
312,HOU,2016-02-19,116,@,PHO,W 116-100,240,37,78,.474,30,54,.556,7,24,.292,35,56,.625,116,30,82,.366,19,47,.404,11,35,.314,29,35,.829,100
313,SAC,2016-02-19,116,,DEN,W 116-110,240,41,83,.494,31,62,.500,10,21,.476,24,31,.774,116,42,90,.467,34,66,.515,8,24,.333,18,26,.692,110
314,POR,2016-02-10,116,,HOU,W 116-103,240,41,89,.461,33,61,.541,8,28,.286,26,34,.765,116,37,77,.481,26,43,.605,11,34,.324,18,34,.529,103
315,NOP,2016-02-08,116,@,MIN,W 116-102,240,47,97,.485,37,73,.507,10,24,.417,12,20,.600,116,36,81,.444,34,69,.493,2,12,.167,28,35,.800,102
316,GSW,2016-02-06,116,,OKC,W 116-108,240,48,97,.495,41,71,.577,7,26,.269,13,20,.650,116,36,85,.424,29,63,.460,7,22,.318,29,37,.784,108
317,SAS,2016-02-05,116,@,DAL,W 116-90,240,41,80,.513,29,58,.500,12,22,.545,22,25,.880,116,33,73,.452,30,58,.517,3,15,.200,21,27,.778,90
318,GSW,2016-01-31,116,@,NYK,W 116-95,240,42,73,.575,26,44,.591,16,29,.552,16,23,.696,116,33,90,.367,27,72,.375,6,18,.333,23,26,.885,95
319,OKC,2016-01-29,116,,HOU,W 116-108,240,41,86,.477,33,67,.493,8,19,.421,26,30,.867,116,36,95,.379,27,56,.482,9,39,.231,27,43,.628,108
320,BOS,2016-01-25,116,@,WAS,W 116-91,240,44,90,.489,35,68,.515,9,22,.409,19,23,.826,116,32,75,.427,25,51,.490,7,24,.292,20,30,.667,91
321,BRK,2016-01-24,116,,OKC,W 116-106,240,45,94,.479,37,77,.481,8,17,.471,18,25,.720,116,43,93,.462,35,67,.522,8,26,.308,12,19,.632,106
322,NOP,2016-01-23,116,,MIL,W 116-99,240,43,94,.457,26,63,.413,17,31,.548,13,17,.765,116,39,74,.527,33,59,.559,6,15,.400,15,18,.833,99
323,LAC,2016-01-22,116,@,NYK,W 116-88,240,43,76,.566,30,53,.566,13,23,.565,17,24,.708,116,33,85,.388,29,67,.433,4,18,.222,18,20,.900,88
324,ORL,2016-01-22,116,,CHO,L 116-120 (OT),265,45,91,.495,34,68,.500,11,23,.478,15,19,.789,116,45,101,.446,35,74,.473,10,27,.370,20,22,.909,120
325,POR,2016-01-15,116,@,BRK,W 116-104,240,47,93,.505,32,58,.552,15,35,.429,7,11,.636,116,38,85,.447,30,66,.455,8,19,.421,20,28,.714,104
326,GSW,2016-01-14,116,,LAL,W 116-98,240,43,86,.500,30,53,.566,13,33,.394,17,20,.850,116,40,90,.444,36,67,.537,4,23,.174,14,24,.583,98
327,IND,2016-01-12,116,,PHO,W 116-97,240,41,79,.519,31,55,.564,10,24,.417,24,31,.774,116,36,89,.404,28,64,.438,8,25,.320,17,27,.630,97
328,SAC,2016-01-09,116,,GSW,L 116-128,240,43,92,.467,35,69,.507,8,23,.348,22,29,.759,116,49,87,.563,30,50,.600,19,37,.514,11,15,.733,128
329,SAC,2016-01-05,116,@,DAL,L 116-117 (2OT),290,47,99,.475,35,67,.522,12,32,.375,10,14,.714,116,45,98,.459,33,69,.478,12,29,.414,15,23,.652,117
330,SAC,2016-01-04,116,@,OKC,W 116-104,240,40,89,.449,33,72,.458,7,17,.412,29,39,.744,116,39,89,.438,29,60,.483,10,29,.345,16,23,.696,104
331,IND,2015-12-31,116,,MIL,L 116-120,240,41,82,.500,28,52,.538,13,30,.433,21,26,.808,116,45,77,.584,39,63,.619,6,14,.429,24,35,.686,120
332,MIA,2015-12-20,116,,POR,W 116-109,240,43,75,.573,31,52,.596,12,23,.522,18,26,.692,116,39,80,.488,26,46,.565,13,34,.382,18,22,.818,109
333,BOS,2015-12-16,116,@,DET,L 116-119,240,43,89,.483,33,64,.516,10,25,.400,20,24,.833,116,38,78,.487,27,57,.474,11,21,.524,32,43,.744,119
334,DAL,2015-12-06,116,@,WAS,W 116-104,240,38,76,.500,22,45,.489,16,31,.516,24,27,.889,116,42,89,.472,34,62,.548,8,27,.296,12,21,.571,104
335,GSW,2015-12-02,116,@,CHO,W 116-99,240,46,88,.523,30,54,.556,16,34,.471,8,11,.727,116,35,94,.372,26,63,.413,9,31,.290,20,30,.667,99
336,DET,2015-11-30,116,,HOU,W 116-105,240,45,85,.529,37,62,.597,8,23,.348,18,37,.486,116,35,88,.398,24,61,.393,11,27,.407,24,28,.857,105
337,HOU,2015-11-29,116,@,NYK,W 116-111 (OT),265,43,95,.453,36,70,.514,7,25,.280,23,36,.639,116,45,78,.577,39,60,.650,6,18,.333,15,17,.882,111
338,PHO,2015-11-27,116,,GSW,L 116-135,240,45,92,.489,35,66,.530,10,26,.385,16,23,.696,116,46,81,.568,24,43,.558,22,38,.579,21,31,.677,135
339,HOU,2015-11-27,116,,PHI,W 116-114,240,38,73,.521,27,53,.509,11,20,.550,29,37,.784,116,40,83,.482,24,48,.500,16,35,.457,18,26,.692,114
340,ATL,2015-11-27,116,@,MEM,W 116-101,240,35,75,.467,21,36,.583,14,39,.359,32,36,.889,116,35,80,.438,23,50,.460,12,30,.400,19,21,.905,101
341,PHO,2015-11-22,116,@,NOP,L 116-122,240,35,90,.389,18,54,.333,17,36,.472,29,33,.879,116,39,85,.459,28,55,.509,11,30,.367,33,40,.825,122
342,MIA,2015-11-19,116,,SAC,W 116-109,240,42,89,.472,35,65,.538,7,24,.292,25,33,.758,116,43,84,.512,31,61,.508,12,23,.522,11,20,.550,109
343,CHO,2015-11-18,116,,BRK,W 116-111,240,39,80,.488,28,55,.509,11,25,.440,27,36,.750,116,44,91,.484,39,76,.513,5,15,.333,18,22,.818,111
344,MIN,2015-11-12,116,,GSW,L 116-129,240,43,87,.494,40,78,.513,3,9,.333,27,36,.750,116,48,89,.539,30,51,.588,18,38,.474,15,16,.938,129
345,HOU,2015-11-06,116,@,SAC,W 116-110,240,40,82,.488,25,46,.543,15,36,.417,21,27,.778,116,40,93,.430,31,65,.477,9,28,.321,21,29,.724,110
346,CHI,2016-04-13,115,,PHI,W 115-105,240,39,83,.470,24,59,.407,15,24,.625,22,27,.815,115,37,81,.457,20,46,.435,17,35,.486,14,18,.778,105
347,HOU,2016-04-07,115,,PHO,L 115-124,240,42,74,.568,28,41,.683,14,33,.424,17,28,.607,115,44,94,.468,32,63,.508,12,31,.387,24,29,.828,124
348,OKC,2016-04-06,115,@,POR,L 115-120,240,43,91,.473,34,69,.493,9,22,.409,20,31,.645,115,43,84,.512,28,51,.549,15,33,.455,19,24,.792,120
349,POR,2016-04-05,115,@,SAC,W 115-107,240,40,93,.430,28,62,.452,12,31,.387,23,27,.852,115,41,78,.526,30,56,.536,11,22,.500,14,21,.667,107
350,IND,2016-04-02,115,@,PHI,W 115-102,240,44,84,.524,36,61,.590,8,23,.348,19,23,.826,115,34,83,.410,18,46,.391,16,37,.432,18,26,.692,102
351,SAC,2016-04-02,115,@,DEN,W 115-106,240,41,88,.466,33,67,.493,8,21,.381,25,31,.806,115,40,92,.435,31,63,.492,9,29,.310,17,24,.708,106
352,CHO,2016-03-26,115,@,MIL,W 115-91,240,41,74,.554,25,45,.556,16,29,.552,17,21,.810,115,37,84,.440,33,69,.478,4,15,.267,13,15,.867,91
353,TOR,2016-03-26,115,@,NOP,W 115-91,240,39,73,.534,27,44,.614,12,29,.414,25,28,.893,115,37,85,.435,33,70,.471,4,15,.267,13,20,.650,91
354,NYK,2016-03-23,115,@,CHI,W 115-107,240,45,87,.517,31,62,.500,14,25,.560,11,15,.733,115,38,82,.463,23,50,.460,15,32,.469,16,21,.762,107
355,OKC,2016-03-19,115,@,IND,W 115-111,240,42,80,.525,32,52,.615,10,28,.357,21,26,.808,115,40,83,.482,31,61,.508,9,22,.409,22,30,.733,111
356,DET,2016-03-19,115,,BRK,W 115-103,240,46,94,.489,36,70,.514,10,24,.417,13,21,.619,115,42,80,.525,37,66,.561,5,14,.357,14,21,.667,103
357,DET,2016-03-18,115,,SAC,W 115-108,240,44,92,.478,32,66,.485,12,26,.462,15,18,.833,115,40,79,.506,36,64,.563,4,15,.267,24,29,.828,108
358,GSW,2016-03-09,115,,UTA,W 115-94,240,48,84,.571,35,54,.648,13,30,.433,6,10,.600,115,32,79,.405,24,59,.407,8,20,.400,22,31,.710,94
359,NOP,2016-03-07,115,,SAC,W 115-112,240,45,94,.479,38,69,.551,7,25,.280,18,26,.692,115,41,83,.494,34,58,.586,7,25,.280,23,27,.852,112
360,POR,2016-03-04,115,@,TOR,L 115-117,240,39,83,.470,28,56,.500,11,27,.407,26,35,.743,115,34,67,.507,28,55,.509,6,12,.500,43,54,.796,117
361,PHI,2016-02-23,115,,ORL,L 115-124,240,43,79,.544,33,58,.569,10,21,.476,19,26,.731,115,41,85,.482,34,71,.479,7,14,.500,35,41,.854,124
362,LAL,2016-02-21,115,@,CHI,L 115-126,240,43,93,.462,36,72,.500,7,21,.333,22,33,.667,115,44,79,.557,31,60,.517,13,19,.684,25,26,.962,126
363,CLE,2016-02-21,115,@,OKC,W 115-92,240,41,80,.513,31,57,.544,10,23,.435,23,27,.852,115,37,90,.411,32,69,.464,5,21,.238,13,19,.684,92
364,POR,2016-02-21,115,,UTA,W 115-111,240,39,90,.433,27,58,.466,12,32,.375,25,38,.658,115,43,86,.500,35,70,.500,8,16,.500,17,23,.739,111
365,GSW,2016-02-20,115,@,LAC,W 115-112,240,42,82,.512,31,51,.608,11,31,.355,20,26,.769,115,42,94,.447,29,58,.500,13,36,.361,15,18,.833,112
366,MIA,2016-02-19,115,@,ATL,W 115-111,240,44,88,.500,36,68,.529,8,20,.400,19,28,.679,115,41,87,.471,25,51,.490,16,36,.444,13,13,1.000,111
367,DEN,2016-02-05,115,,CHI,W 115-110,240,39,87,.448,33,69,.478,6,18,.333,31,44,.705,115,43,93,.462,38,81,.469,5,12,.417,19,27,.704,110
368,HOU,2016-02-02,115,,MIA,W 115-102,240,44,84,.524,28,49,.571,16,35,.457,11,16,.688,115,38,85,.447,32,68,.471,6,17,.353,20,27,.741,102
369,MIN,2016-02-02,115,@,LAL,L 115-119,240,46,80,.575,42,63,.667,4,17,.235,19,25,.760,115,40,80,.500,28,54,.519,12,26,.462,27,35,.771,119
370,CLE,2016-01-27,115,,PHO,W 115-93,240,45,81,.556,34,53,.642,11,28,.393,14,16,.875,115,33,70,.471,25,50,.500,8,20,.400,19,25,.760,93
371,HOU,2016-01-24,115,,DAL,W 115-104,240,43,89,.483,28,45,.622,15,44,.341,14,21,.667,115,36,79,.456,21,49,.429,15,30,.500,17,22,.773,104
372,CLE,2016-01-21,115,,LAC,W 115-102,240,42,83,.506,29,55,.527,13,28,.464,18,24,.750,115,36,80,.450,30,55,.545,6,25,.240,24,36,.667,102
373,NOP,2016-01-21,115,,DET,W 115-99,240,46,86,.535,41,74,.554,5,12,.417,18,18,1.000,115,38,91,.418,31,61,.508,7,30,.233,16,20,.800,99
374,TOR,2016-01-20,115,,BOS,W 115-109,240,46,83,.554,35,54,.648,11,29,.379,12,17,.706,115,43,85,.506,31,59,.525,12,26,.462,11,15,.733,109
375,CHI,2016-01-14,115,@,PHI,W 115-111 (OT),265,41,88,.466,34,71,.479,7,17,.412,26,31,.839,115,42,93,.452,30,66,.455,12,27,.444,15,20,.750,111
376,POR,2016-01-10,115,,OKC,W 115-110,240,42,100,.420,23,56,.411,19,44,.432,12,14,.857,115,37,76,.487,27,55,.491,10,21,.476,26,36,.722,110
377,LAL,2016-01-07,115,@,SAC,L 115-118,240,41,76,.539,33,52,.635,8,24,.333,25,29,.862,115,47,85,.553,41,64,.641,6,21,.286,18,27,.667,118
378,WAS,2016-01-06,115,,CLE,L 115-121,240,42,76,.553,28,52,.538,14,24,.583,17,27,.630,115,48,89,.539,36,60,.600,12,29,.414,13,19,.684,121
379,DET,2016-01-04,115,,ORL,W 115-89,240,43,88,.489,29,58,.500,14,30,.467,15,21,.714,115,36,81,.444,30,61,.492,6,20,.300,11,11,1.000,89
380,CHI,2016-01-03,115,@,TOR,W 115-113,240,42,82,.512,33,61,.541,9,21,.429,22,25,.880,115,42,92,.457,29,61,.475,13,31,.419,16,19,.842,113
381,DET,2015-12-31,115,,MIN,W 115-90,240,41,86,.477,27,51,.529,14,35,.400,19,28,.679,115,35,86,.407,30,72,.417,5,14,.357,15,19,.789,90
382,HOU,2015-12-29,115,,ATL,L 115-121,240,39,72,.542,28,52,.538,11,20,.550,26,39,.667,115,43,99,.434,29,58,.500,14,41,.341,21,25,.840,121
383,NOP,2015-12-23,115,,POR,W 115-89,240,41,85,.482,28,54,.519,13,31,.419,20,23,.870,115,33,95,.347,26,67,.388,7,28,.250,16,24,.667,89
384,SAS,2015-12-18,115,,LAC,W 115-107,240,43,87,.494,33,68,.485,10,19,.526,19,24,.792,115,36,72,.500,26,48,.542,10,24,.417,25,40,.625,107
385,CHI,2015-12-14,115,,PHI,W 115-96,240,43,85,.506,35,63,.556,8,22,.364,21,26,.808,115,38,92,.413,27,61,.443,11,31,.355,9,13,.692,96
386,DAL,2015-12-01,115,@,POR,W 115-112 (OT),265,43,94,.457,34,65,.523,9,29,.310,20,24,.833,115,41,100,.410,26,60,.433,15,40,.375,15,17,.882,112
387,CLE,2015-11-19,115,,MIL,W 115-100,240,40,71,.563,29,47,.617,11,24,.458,24,30,.800,115,38,73,.521,35,65,.538,3,8,.375,21,26,.808,100
388,WAS,2015-11-17,115,,MIL,W 115-86,240,37,70,.529,25,48,.521,12,22,.545,29,41,.707,115,31,72,.431,21,51,.412,10,21,.476,14,24,.583,86
389,GSW,2015-11-17,115,,TOR,W 115-110,240,43,80,.538,32,51,.627,11,29,.379,18,27,.667,115,37,79,.468,31,61,.508,6,18,.333,30,39,.769,110
390,DEN,2015-11-17,115,@,NOP,W 115-98,240,45,85,.529,30,55,.545,15,30,.500,10,13,.769,115,41,83,.494,34,60,.567,7,23,.304,9,11,.818,98
391,NOP,2015-11-06,115,,ATL,L 115-121,240,42,84,.500,32,54,.593,10,30,.333,21,24,.875,115,41,77,.532,32,56,.571,9,21,.429,30,35,.857,121
392,POR,2015-11-05,115,,MEM,W 115-96,240,44,87,.506,29,57,.509,15,30,.500,12,20,.600,115,37,77,.481,30,57,.526,7,20,.350,15,21,.714,96
393,CHI,2015-10-28,115,@,BRK,W 115-100,240,42,78,.538,28,50,.560,14,28,.500,17,20,.850,115,39,93,.419,39,84,.464,0,9,.000,22,28,.786,100
394,PHO,2016-04-13,114,,LAC,W 114-105,240,45,99,.455,38,73,.521,7,26,.269,17,22,.773,114,43,96,.448,34,65,.523,9,31,.290,10,12,.833,105
395,CHO,2016-04-11,114,@,BOS,W 114-100,240,41,81,.506,27,49,.551,14,32,.438,18,22,.818,114,34,89,.382,26,65,.400,8,24,.333,24,29,.828,100
396,SAC,2016-04-09,114,,OKC,W 114-112,240,45,94,.479,32,62,.516,13,32,.406,11,20,.550,114,39,81,.481,26,49,.531,13,32,.406,21,28,.750,112
397,LAC,2016-04-03,114,,WAS,W 114-109,240,43,85,.506,35,66,.530,8,19,.421,20,33,.606,114,43,94,.457,32,64,.500,11,30,.367,12,21,.571,109
398,ORL,2016-03-31,114,@,IND,W 114-94,240,48,90,.533,43,74,.581,5,16,.313,13,18,.722,114,36,86,.419,29,67,.433,7,19,.368,15,21,.714,94
399,LAC,2016-03-28,114,,BOS,W 114-90,240,44,84,.524,33,59,.559,11,25,.440,15,18,.833,114,31,89,.348,24,70,.343,7,19,.368,21,27,.778,90
400,GSW,2016-03-23,114,,LAC,W 114-98,240,39,87,.448,24,53,.453,15,34,.441,21,28,.750,114,36,85,.424,28,57,.491,8,28,.286,18,27,.667,98
401,DET,2016-03-16,114,,ATL,L 114-118,240,39,84,.464,31,59,.525,8,25,.320,28,39,.718,114,39,89,.438,27,55,.491,12,34,.353,28,34,.824,118
402,MIN,2016-03-16,114,@,MEM,W 114-108,240,40,71,.563,30,50,.600,10,21,.476,24,31,.774,114,44,100,.440,40,80,.500,4,20,.200,16,21,.762,108
403,PHI,2016-03-15,114,@,BRK,L 114-131,240,41,88,.466,30,58,.517,11,30,.367,21,26,.808,114,47,90,.522,37,66,.561,10,24,.417,27,31,.871,131
404,CLE,2016-03-13,114,@,LAC,W 114-90,240,41,84,.488,23,47,.489,18,37,.486,14,20,.700,114,32,79,.405,22,47,.468,10,32,.313,16,19,.842,90
405,NOP,2016-03-11,114,@,MEM,L 114-121 (OT),265,42,96,.438,35,72,.486,7,24,.292,23,34,.676,114,47,96,.490,41,82,.500,6,14,.429,21,32,.656,121
406,UTA,2016-03-11,114,,WAS,W 114-93,240,38,67,.567,29,51,.569,9,16,.563,29,38,.763,114,35,80,.438,28,56,.500,7,24,.292,16,22,.727,93
407,MIL,2016-03-09,114,,MIA,W 114-108,240,42,80,.525,38,72,.528,4,8,.500,26,37,.703,114,42,80,.525,36,65,.554,6,15,.400,18,19,.947,108
408,DAL,2016-03-06,114,@,DEN,L 114-116 (OT),265,41,93,.441,25,52,.481,16,41,.390,16,20,.800,114,44,107,.411,35,81,.432,9,26,.346,19,25,.760,116
409,DET,2016-02-28,114,,TOR,W 114-101,240,41,71,.577,29,48,.604,12,23,.522,20,27,.741,114,39,80,.488,29,59,.492,10,21,.476,13,18,.722,101
410,ORL,2016-02-25,114,,GSW,L 114-130,240,41,90,.456,31,64,.484,10,26,.385,22,28,.786,114,53,88,.602,40,63,.635,13,25,.520,11,16,.688,130
411,TOR,2016-02-24,114,,MIN,W 114-105,240,41,85,.482,31,59,.525,10,26,.385,22,26,.846,114,37,74,.500,31,64,.484,6,10,.600,25,33,.758,105
412,CLE,2016-02-24,114,,CHO,W 114-103,240,45,91,.495,32,59,.542,13,32,.406,11,17,.647,114,37,76,.487,27,47,.574,10,29,.345,19,27,.704,103
413,SAC,2016-02-23,114,@,DEN,W 114-110,240,43,83,.518,36,66,.545,7,17,.412,21,28,.750,114,41,100,.410,31,73,.425,10,27,.370,18,22,.818,110
414,HOU,2016-02-23,114,@,UTA,L 114-117 (OT),265,36,87,.414,25,53,.472,11,34,.324,31,41,.756,114,38,74,.514,28,50,.560,10,24,.417,31,38,.816,117
415,MIA,2016-02-20,114,,WAS,W 114-94,240,47,96,.490,45,83,.542,2,13,.154,18,28,.643,114,40,99,.404,37,77,.481,3,22,.136,11,21,.524,94
416,PHI,2016-02-19,114,@,NOP,L 114-121,240,40,76,.526,28,49,.571,12,27,.444,22,26,.846,114,41,81,.506,34,64,.531,7,17,.412,32,40,.800,121
417,SAC,2016-02-10,114,@,PHI,W 114-110,240,44,87,.506,40,71,.563,4,16,.250,22,29,.759,114,42,91,.462,27,56,.482,15,35,.429,11,17,.647,110
418,DAL,2016-02-06,114,@,MEM,W 114-110 (OT),265,38,88,.432,23,50,.460,15,38,.395,23,33,.697,114,44,88,.500,35,65,.538,9,23,.391,13,23,.565,110
419,IND,2016-02-03,114,@,BRK,W 114-100,240,44,88,.500,32,64,.500,12,24,.500,14,17,.824,114,36,81,.444,29,58,.500,7,23,.304,21,31,.677,100
420,ORL,2016-02-03,114,@,OKC,L 114-117,240,47,95,.495,37,72,.514,10,23,.435,10,12,.833,114,44,93,.473,35,66,.530,9,27,.333,20,25,.800,117
421,OKC,2016-02-01,114,,WAS,W 114-98,240,43,83,.518,36,61,.590,7,22,.318,21,27,.778,114,40,86,.465,33,60,.550,7,26,.269,11,15,.733,98
422,BOS,2016-01-31,114,@,ORL,L 114-119,240,39,93,.419,23,47,.489,16,46,.348,20,25,.800,114,44,82,.537,34,58,.586,10,24,.417,21,35,.600,119
423,CLE,2016-01-29,114,@,DET,W 114-106,240,39,83,.470,30,60,.500,9,23,.391,27,29,.931,114,40,84,.476,33,61,.541,7,23,.304,19,26,.731,106
424,CHI,2016-01-28,114,@,LAL,W 114-91,240,47,95,.495,41,78,.526,6,17,.353,14,16,.875,114,32,85,.376,23,60,.383,9,25,.360,18,23,.783,91
425,NOP,2016-01-28,114,,SAC,W 114-105,240,43,98,.439,33,72,.458,10,26,.385,18,24,.750,114,40,89,.449,30,61,.492,10,28,.357,15,20,.750,105
426,CLE,2016-01-25,114,,MIN,W 114-107,240,45,89,.506,34,58,.586,11,31,.355,13,20,.650,114,41,84,.488,37,68,.544,4,16,.250,21,23,.913,107
427,HOU,2016-01-20,114,,DET,L 114-123,240,43,95,.453,31,71,.437,12,24,.500,16,18,.889,114,38,80,.475,26,50,.520,12,30,.400,35,59,.593,123
428,NOP,2016-01-19,114,,MIN,W 114-99,240,42,83,.506,32,60,.533,10,23,.435,20,23,.870,114,36,76,.474,33,62,.532,3,14,.214,24,31,.774,99
429,ATL,2016-01-16,114,,BRK,W 114-86,240,44,79,.557,36,50,.720,8,29,.276,18,24,.750,114,34,78,.436,28,58,.483,6,20,.300,12,19,.632,86
430,PHI,2016-01-16,114,,POR,W 114-89,240,42,76,.553,32,53,.604,10,23,.435,20,30,.667,114,34,87,.391,29,58,.500,5,29,.172,16,24,.667,89
431,BOS,2016-01-12,114,@,NYK,L 114-120,240,42,86,.488,33,57,.579,9,29,.310,21,26,.808,114,43,81,.531,36,61,.590,7,20,.350,27,30,.900,120
432,WAS,2016-01-11,114,@,CHI,W 114-100,240,48,99,.485,39,75,.520,9,24,.375,9,10,.900,114,34,81,.420,25,59,.424,9,22,.409,23,27,.852,100
433,LAC,2016-01-10,114,,NOP,W 114-111 (OT),265,42,89,.472,30,53,.566,12,36,.333,18,34,.529,114,40,100,.400,32,70,.457,8,30,.267,23,29,.793,111
434,GSW,2015-12-31,114,@,HOU,W 114-110,240,43,84,.512,32,61,.525,11,23,.478,17,27,.630,114,36,78,.462,24,48,.500,12,30,.400,26,29,.897,110
435,DAL,2015-12-30,114,,GSW,W 114-91,240,42,82,.512,28,55,.509,14,27,.519,16,20,.800,114,33,81,.407,26,62,.419,7,19,.368,18,24,.750,91
436,SAS,2015-12-16,114,,WAS,W 114-95,240,44,83,.530,36,61,.590,8,22,.364,18,23,.783,114,35,84,.417,32,69,.464,3,15,.200,22,25,.880,95
437,DEN,2015-12-14,114,,HOU,W 114-108,240,42,82,.512,34,57,.596,8,25,.320,22,25,.880,114,41,87,.471,23,47,.489,18,40,.450,8,11,.727,108
438,WAS,2015-12-12,114,@,DAL,W 114-111,240,44,85,.518,30,56,.536,14,29,.483,12,15,.800,114,38,89,.427,24,56,.429,14,33,.424,21,24,.875,111
439,SAC,2015-12-08,114,,UTA,W 114-106,240,43,77,.558,33,49,.673,10,28,.357,18,24,.750,114,38,92,.413,23,56,.411,15,36,.417,15,22,.682,106
440,WAS,2015-12-07,114,@,MIA,W 114-103,240,46,92,.500,37,74,.500,9,18,.500,13,17,.765,114,41,69,.594,36,53,.679,5,16,.313,16,22,.727,103
441,GSW,2015-12-06,114,@,BRK,W 114-98,240,44,86,.512,30,53,.566,14,33,.424,12,23,.522,114,39,89,.438,34,72,.472,5,17,.294,15,23,.652,98
442,NOP,2015-12-04,114,,CLE,W 114-108 (OT),265,42,85,.494,33,60,.550,9,25,.360,21,31,.677,114,39,89,.438,29,56,.518,10,33,.303,20,24,.833,108
443,BOS,2015-12-03,114,@,SAC,W 114-97,240,40,84,.476,26,51,.510,14,33,.424,20,24,.833,114,29,77,.377,22,56,.393,7,21,.333,32,41,.780,97
444,ORL,2015-11-27,114,,MIL,W 114-90,240,43,82,.524,31,55,.564,12,27,.444,16,22,.727,114,31,74,.419,23,48,.479,8,26,.308,20,22,.909,90
445,PHI,2015-11-27,114,@,HOU,L 114-116,240,40,83,.482,24,48,.500,16,35,.457,18,26,.692,114,38,73,.521,27,53,.509,11,20,.550,29,37,.784,116
446,PHO,2015-11-25,114,,NOP,L 114-120,240,44,96,.458,34,70,.486,10,26,.385,16,20,.800,114,42,81,.519,32,59,.542,10,22,.455,26,34,.765,120
447,DAL,2015-11-22,114,@,OKC,L 114-117,240,44,83,.530,34,64,.531,10,19,.526,16,28,.571,114,47,90,.522,38,68,.559,9,22,.409,14,18,.778,117
448,PHO,2015-11-20,114,@,DEN,W 114-107,240,40,79,.506,25,52,.481,15,27,.556,19,25,.760,114,41,90,.456,36,66,.545,5,24,.208,20,26,.769,107
449,OKC,2015-11-16,114,@,MEM,L 114-122,240,41,81,.506,31,57,.544,10,24,.417,22,31,.710,114,37,84,.440,25,67,.373,12,17,.706,36,39,.923,122
450,MEM,2015-11-15,114,@,MIN,W 114-106,240,40,71,.563,31,54,.574,9,17,.529,25,27,.926,114,41,82,.500,36,66,.545,5,16,.313,19,21,.905,106
451,UTA,2015-11-10,114,@,CLE,L 114-118,240,40,82,.488,30,60,.500,10,22,.455,24,28,.857,114,37,74,.500,26,50,.520,11,24,.458,33,43,.767,118
452,ATL,2015-11-07,114,,WAS,W 114-99,240,43,92,.467,30,59,.508,13,33,.394,15,15,1.000,114,38,78,.487,30,54,.556,8,24,.333,15,17,.882,99
453,SAS,2015-11-07,114,,CHO,W 114-94,240,45,81,.556,36,60,.600,9,21,.429,15,23,.652,114,34,73,.466,28,54,.519,6,19,.316,20,31,.645,94
454,ORL,2015-11-04,114,@,HOU,L 114-119 (OT),265,46,91,.505,39,71,.549,7,20,.350,15,19,.789,114,42,88,.477,31,54,.574,11,34,.324,24,34,.706,119
455,LAC,2015-10-31,114,,SAC,W 114-109,240,39,76,.513,35,59,.593,4,17,.235,32,46,.696,114,43,101,.426,37,83,.446,6,18,.333,17,25,.680,109
456,LAL,2015-10-30,114,@,SAC,L 114-132,240,41,89,.461,30,55,.545,11,34,.324,21,27,.778,114,52,101,.515,46,79,.582,6,22,.273,22,30,.733,132
457,WAS,2016-04-10,113,,CHO,W 113-98,240,42,80,.525,33,59,.559,9,21,.429,20,28,.714,113,28,81,.346,16,48,.333,12,33,.364,30,35,.857,98
458,CHO,2016-04-08,113,,BRK,W 113-99,240,41,83,.494,27,46,.587,14,37,.378,17,20,.850,113,39,92,.424,29,67,.433,10,25,.400,11,20,.550,99
459,MIL,2016-04-01,113,,ORL,W 113-110,240,47,86,.547,43,69,.623,4,17,.235,15,25,.600,113,46,86,.535,38,62,.613,8,24,.333,10,12,.833,110
460,OKC,2016-03-24,113,,UTA,W 113-91,240,45,83,.542,36,61,.590,9,22,.409,14,22,.636,113,35,73,.479,30,51,.588,5,22,.227,16,23,.696,91
461,MIN,2016-03-23,113,,SAC,W 113-104,240,45,80,.563,40,67,.597,5,13,.385,18,32,.563,113,42,91,.462,34,71,.479,8,20,.400,12,23,.522,104
462,CLE,2016-03-23,113,,MIL,W 113-104,240,40,83,.482,30,49,.612,10,34,.294,23,27,.852,113,43,80,.538,36,64,.563,7,16,.438,11,15,.733,104
463,MIA,2016-03-22,113,@,NOP,W 113-99,240,44,88,.500,41,69,.594,3,19,.158,22,27,.815,113,34,87,.391,27,71,.380,7,16,.438,24,30,.800,99
464,MEM,2016-03-19,113,,LAC,W 113-102,240,40,82,.488,36,67,.537,4,15,.267,29,36,.806,113,31,66,.470,19,36,.528,12,30,.400,28,39,.718,102
465,NOP,2016-03-09,113,@,CHO,L 113-122,240,40,85,.471,30,52,.577,10,33,.303,23,28,.821,113,38,82,.463,23,47,.489,15,35,.429,31,38,.816,122
466,ORL,2016-03-07,113,@,GSW,L 113-119,240,40,90,.444,35,69,.507,5,21,.238,28,34,.824,113,42,84,.500,26,49,.531,16,35,.457,19,27,.704,119
467,HOU,2016-03-06,113,@,TOR,W 113-107,240,38,78,.487,25,49,.510,13,29,.448,24,37,.649,113,37,77,.481,25,44,.568,12,33,.364,21,27,.778,107
468,WAS,2016-02-28,113,,CLE,W 113-99,240,39,79,.494,28,48,.583,11,31,.355,24,34,.706,113,32,80,.400,23,51,.451,9,29,.310,26,30,.867,99
469,LAL,2016-02-19,113,,SAS,L 113-119,240,40,81,.494,30,59,.508,10,22,.455,23,26,.885,113,48,88,.545,42,76,.553,6,12,.500,17,18,.944,119
470,ATL,2016-02-10,113,@,CHI,W 113-90,240,43,90,.478,30,57,.526,13,33,.394,14,15,.933,113,38,86,.442,33,72,.458,5,14,.357,9,12,.750,90
471,BOS,2016-01-29,113,,ORL,W 113-94,240,43,86,.500,33,62,.532,10,24,.417,17,21,.810,113,32,79,.405,25,59,.424,7,20,.350,23,29,.793,94
472,WAS,2016-01-28,113,,DEN,L 113-117,240,39,88,.443,28,60,.467,11,28,.393,24,30,.800,113,41,81,.506,32,63,.508,9,18,.500,26,33,.788,117
473,PHI,2016-01-26,113,,PHO,W 113-103,240,39,81,.481,28,53,.528,11,28,.393,24,36,.667,113,39,83,.470,33,64,.516,6,19,.316,19,28,.679,103
474,BOS,2016-01-18,113,@,DAL,L 113-118 (OT),265,40,94,.426,28,64,.438,12,30,.400,21,26,.808,113,40,93,.430,24,59,.407,16,34,.471,22,24,.917,118
475,PHI,2016-01-18,113,@,NYK,L 113-119 (2OT),290,45,102,.441,35,74,.473,10,28,.357,13,25,.520,113,43,97,.443,35,77,.455,8,20,.400,25,30,.833,119
476,DET,2016-01-16,113,,GSW,W 113-95,240,47,101,.465,39,78,.500,8,23,.348,11,20,.550,113,34,94,.362,24,69,.348,10,25,.400,17,23,.739,95
477,OKC,2016-01-15,113,,MIN,W 113-93,240,47,89,.528,42,66,.636,5,23,.217,14,22,.636,113,34,85,.400,29,73,.397,5,12,.417,20,23,.870,93
478,LAL,2016-01-08,113,,OKC,L 113-117,240,40,84,.476,31,58,.534,9,26,.346,24,25,.960,113,45,89,.506,40,72,.556,5,17,.294,22,26,.846,117
479,TOR,2016-01-03,113,,CHI,L 113-115,240,42,92,.457,29,61,.475,13,31,.419,16,19,.842,113,42,82,.512,33,61,.541,9,21,.429,22,25,.880,115
480,MIL,2015-12-23,113,,PHI,W 113-100,240,51,85,.600,46,73,.630,5,12,.417,6,8,.750,113,37,81,.457,30,61,.492,7,20,.350,19,29,.655,100
481,WAS,2015-12-21,113,,SAC,W 113-99,240,42,83,.506,28,59,.475,14,24,.583,15,17,.882,113,37,91,.407,30,69,.435,7,22,.318,18,22,.818,99
482,BOS,2015-12-21,113,,MIN,W 113-99,240,46,89,.517,34,64,.531,12,25,.480,9,16,.563,113,36,79,.456,34,66,.515,2,13,.154,25,32,.781,99
483,ORL,2015-12-16,113,,CHO,W 113-98,240,43,77,.558,29,53,.547,14,24,.583,13,15,.867,113,36,79,.456,22,45,.489,14,34,.412,12,15,.800,98
484,LAL,2015-12-15,113,,MIL,W 113-95,240,41,89,.461,31,62,.500,10,27,.370,21,25,.840,113,40,85,.471,36,72,.500,4,13,.308,11,20,.550,95
485,SAC,2015-12-05,113,@,HOU,L 113-120,240,46,98,.469,36,72,.500,10,26,.385,11,13,.846,113,36,78,.462,20,44,.455,16,34,.471,32,43,.744,120
486,MEM,2015-12-01,113,@,NOP,W 113-104,240,43,90,.478,41,80,.513,2,10,.200,25,26,.962,113,35,81,.432,26,54,.481,9,27,.333,25,33,.758,104
487,CHO,2015-11-20,113,,PHI,W 113-88,240,40,81,.494,28,56,.500,12,25,.480,21,22,.955,113,32,79,.405,24,53,.453,8,26,.308,16,22,.727,88
488,SAS,2015-11-11,113,@,POR,W 113-101,240,46,82,.561,39,67,.582,7,15,.467,14,18,.778,113,39,88,.443,30,66,.455,9,22,.409,14,23,.609,101
489,TOR,2015-10-30,113,@,BOS,W 113-103,240,36,82,.439,25,56,.446,11,26,.423,30,35,.857,113,32,85,.376,25,59,.424,7,26,.269,32,41,.780,103
490,MIL,2015-10-30,113,,WAS,L 113-118,240,42,82,.512,35,58,.603,7,24,.292,22,28,.786,113,35,68,.515,23,47,.489,12,21,.571,36,44,.818,118
491,DET,2016-04-13,112,@,CLE,W 112-110 (OT),265,37,85,.435,21,52,.404,16,33,.485,22,28,.786,112,46,97,.474,39,79,.494,7,18,.389,11,15,.733,110
492,OKC,2016-04-11,112,,LAL,W 112-79,240,42,96,.438,30,59,.508,12,37,.324,16,27,.593,112,23,81,.284,16,50,.320,7,31,.226,26,30,.867,79
493,OKC,2016-04-09,112,@,SAC,L 112-114,240,39,81,.481,26,49,.531,13,32,.406,21,28,.750,112,45,94,.479,32,62,.516,13,32,.406,11,20,.550,114
494,ORL,2016-04-08,112,,MIA,W 112-109,240,43,82,.524,38,71,.535,5,11,.455,21,28,.750,112,45,100,.450,37,78,.474,8,22,.364,11,21,.524,109
495,DET,2016-04-08,112,,WAS,W 112-99,240,36,77,.468,22,45,.489,14,32,.438,26,29,.897,112,38,86,.442,32,67,.478,6,19,.316,17,23,.739,99
496,GSW,2016-04-07,112,,SAS,W 112-101,240,45,83,.542,33,58,.569,12,25,.480,10,11,.909,112,39,80,.488,32,64,.500,7,16,.438,16,23,.696,101
497,CLE,2016-04-03,112,,CHO,W 112-103,240,45,83,.542,29,54,.537,16,29,.552,6,13,.462,112,34,76,.447,25,50,.500,9,26,.346,26,27,.963,103
498,MIA,2016-04-01,112,@,SAC,W 112-106,240,42,82,.512,30,60,.500,12,22,.545,16,17,.941,112,38,87,.437,31,66,.470,7,21,.333,23,29,.793,106
499,ATL,2016-03-26,112,@,DET,W 112-95,240,43,95,.453,30,61,.492,13,34,.382,13,14,.929,112,34,88,.386,27,59,.458,7,29,.241,20,28,.714,95
500,HOU,2016-03-25,112,,TOR,W 112-109,240,42,81,.519,30,59,.508,12,22,.545,16,35,.457,112,39,94,.415,26,63,.413,13,31,.419,18,26,.692,109
501,DET,2016-03-25,112,,CHO,W 112-105,240,42,91,.462,34,61,.557,8,30,.267,20,26,.769,112,37,93,.398,23,63,.365,14,30,.467,17,22,.773,105
502,SAS,2016-03-23,112,,MIA,W 112-88,240,42,81,.519,34,67,.507,8,14,.571,20,24,.833,112,37,77,.481,30,63,.476,7,14,.500,7,12,.583,88
503,DAL,2016-03-18,112,,GSW,L 112-130,240,41,93,.441,32,64,.500,9,29,.310,21,22,.955,112,48,95,.505,26,57,.456,22,38,.579,12,14,.857,130
504,NOP,2016-03-18,112,,POR,L 112-117,240,40,83,.482,30,62,.484,10,21,.476,22,28,.786,112,36,78,.462,27,51,.529,9,27,.333,36,40,.900,117
505,TOR,2016-03-12,112,,MIA,W 112-104 (OT),265,37,84,.440,31,66,.470,6,18,.333,32,38,.842,112,37,98,.378,28,73,.384,9,25,.360,21,26,.808,104
506,IND,2016-03-12,112,@,DAL,W 112-105,240,38,81,.469,29,53,.547,9,28,.321,27,29,.931,112,41,85,.482,33,63,.524,8,22,.364,15,18,.833,105
507,POR,2016-03-11,112,@,GSW,L 112-128,240,37,86,.430,18,50,.360,19,36,.528,19,23,.826,112,40,89,.449,22,49,.449,18,40,.450,30,39,.769,128
508,SAC,2016-03-07,112,@,NOP,L 112-115,240,41,83,.494,34,58,.586,7,25,.280,23,27,.852,112,45,94,.479,38,69,.551,7,25,.280,18,26,.692,115
509,LAL,2016-03-06,112,,GSW,W 112-95,240,41,87,.471,32,62,.516,9,25,.360,21,22,.955,112,37,92,.402,33,62,.532,4,30,.133,17,21,.810,95
510,MIA,2016-03-04,112,@,PHI,W 112-102,240,39,88,.443,34,72,.472,5,16,.313,29,36,.806,112,36,95,.379,27,64,.422,9,31,.290,21,27,.778,102
511,MIN,2016-02-27,112,@,NOP,W 112-110,240,42,84,.500,37,69,.536,5,15,.333,23,30,.767,112,39,84,.464,29,57,.509,10,27,.370,22,26,.846,110
512,MEM,2016-02-26,112,@,LAL,W 112-95,240,43,85,.506,30,53,.566,13,32,.406,13,15,.867,112,32,78,.410,27,55,.491,5,23,.217,26,39,.667,95
513,BOS,2016-02-25,112,,MIL,W 112-107,240,41,84,.488,36,61,.590,5,23,.217,25,33,.758,112,42,87,.483,38,72,.528,4,15,.267,19,25,.760,107
514,MIA,2016-02-24,112,,GSW,L 112-118,240,40,86,.465,34,72,.472,6,14,.429,26,31,.839,112,42,90,.467,29,62,.468,13,28,.464,21,25,.840,118
515,POR,2016-02-23,112,,BRK,W 112-104,240,40,80,.500,30,57,.526,10,23,.435,22,25,.880,112,43,90,.478,40,78,.513,3,12,.250,15,19,.789,104
516,LAC,2016-02-20,112,,GSW,L 112-115,240,42,94,.447,29,58,.500,13,36,.361,15,18,.833,112,42,82,.512,31,51,.608,11,31,.355,20,26,.769,115
517,TOR,2016-02-10,112,@,MIN,L 112-117,240,39,86,.453,29,55,.527,10,31,.323,24,32,.750,112,35,76,.461,31,62,.500,4,14,.286,43,53,.811,117
518,GSW,2016-02-10,112,@,PHO,W 112-104,240,37,89,.416,23,49,.469,14,40,.350,24,29,.828,112,41,93,.441,35,72,.486,6,21,.286,16,22,.727,104
519,MIL,2016-02-09,112,,BOS,W 112-111,240,45,88,.511,38,69,.551,7,19,.368,15,23,.652,112,39,84,.464,29,55,.527,10,29,.345,23,24,.958,111
520,POR,2016-02-08,112,@,MEM,W 112-106 (OT),265,44,89,.494,34,60,.567,10,29,.345,14,20,.700,112,43,86,.500,36,67,.537,7,19,.368,13,19,.684,106
521,MIN,2016-02-06,112,,CHI,W 112-105,240,45,87,.517,44,75,.587,1,12,.083,21,22,.955,112,40,85,.471,32,65,.492,8,20,.400,17,19,.895,105
522,IND,2016-02-06,112,,DET,W 112-104,240,41,76,.539,35,65,.538,6,11,.545,24,29,.828,112,38,79,.481,26,46,.565,12,33,.364,16,31,.516,104
523,DEN,2016-02-01,112,,TOR,W 112-93,240,45,83,.542,35,61,.574,10,22,.455,12,15,.800,112,29,78,.372,21,53,.396,8,25,.320,27,39,.692,93
524,ATL,2016-02-01,112,,DAL,W 112-97,240,42,80,.525,28,45,.622,14,35,.400,14,19,.737,112,31,85,.365,24,59,.407,7,26,.269,28,38,.737,97
525,POR,2016-01-26,112,,SAC,W 112-97,240,44,90,.489,35,60,.583,9,30,.300,15,19,.789,112,36,86,.419,29,67,.433,7,19,.368,18,32,.563,97
526,HOU,2016-01-25,112,@,NOP,W 112-111,240,38,80,.475,19,40,.475,19,40,.475,17,21,.810,112,42,91,.462,29,62,.468,13,29,.448,14,25,.560,111
527,TOR,2016-01-24,112,,LAC,W 112-94,240,41,83,.494,29,61,.475,12,22,.545,18,26,.692,112,34,76,.447,26,50,.520,8,26,.308,18,30,.600,94
528,BOS,2016-01-24,112,@,PHI,W 112-92,240,43,97,.443,32,72,.444,11,25,.440,15,19,.789,112,35,89,.393,27,63,.429,8,26,.308,14,20,.700,92
529,SAC,2016-01-20,112,@,LAL,W 112-93,240,43,89,.483,37,69,.536,6,20,.300,20,28,.714,112,32,90,.356,28,65,.431,4,25,.160,25,31,.806,93
530,TOR,2016-01-18,112,,BRK,W 112-100,240,43,85,.506,30,61,.492,13,24,.542,13,18,.722,112,39,76,.513,34,62,.548,5,14,.357,17,19,.895,100
531,HOU,2016-01-17,112,@,LAL,W 112-95,240,44,91,.484,38,70,.543,6,21,.286,18,24,.750,112,37,82,.451,31,63,.492,6,19,.316,15,19,.789,95
532,SAS,2016-01-17,112,,DAL,W 112-83,240,42,90,.467,37,70,.529,5,20,.250,23,28,.821,112,29,81,.358,23,58,.397,6,23,.261,19,25,.760,83
533,DEN,2016-01-13,112,,GSW,W 112-110,240,37,87,.425,32,65,.492,5,22,.227,33,37,.892,112,42,88,.477,32,62,.516,10,26,.385,16,20,.800,110
534,OKC,2016-01-06,112,,MEM,W 112-94,240,38,83,.458,30,66,.455,8,17,.471,28,33,.848,112,35,90,.389,28,69,.406,7,21,.333,17,24,.708,94
535,POR,2016-01-03,112,@,DEN,W 112-106,240,40,78,.513,30,55,.545,10,23,.435,22,32,.688,112,34,80,.425,27,58,.466,7,22,.318,31,48,.646,106
536,LAL,2015-12-30,112,@,BOS,W 112-104,240,43,94,.457,34,75,.453,9,19,.474,17,23,.739,112,38,88,.432,31,61,.508,7,27,.259,21,25,.840,104
537,SAS,2015-12-30,112,,PHO,W 112-79,240,43,76,.566,37,62,.597,6,14,.429,20,33,.606,112,32,81,.395,27,63,.429,5,18,.278,10,18,.556,79
538,MEM,2015-12-27,112,,LAL,W 112-96,240,45,80,.563,39,64,.609,6,16,.375,16,22,.727,112,32,84,.381,24,55,.436,8,29,.276,24,32,.750,96
539,DEN,2015-12-27,112,@,OKC,L 112-122,240,46,94,.489,37,69,.536,9,25,.360,11,15,.733,112,48,83,.578,40,68,.588,8,15,.533,18,21,.857,122
540,MIL,2015-12-18,112,@,GSW,L 112-121,240,42,91,.462,38,73,.521,4,18,.222,24,28,.857,112,42,87,.483,33,61,.541,9,26,.346,28,37,.757,121
541,DEN,2015-12-15,112,@,MIN,W 112-100,240,41,73,.562,31,55,.564,10,18,.556,20,27,.741,112,36,77,.468,32,67,.478,4,10,.400,24,31,.774,100
542,MEM,2015-12-14,112,,WAS,W 112-95,240,44,78,.564,34,63,.540,10,15,.667,14,15,.933,112,37,86,.430,28,62,.452,9,24,.375,12,20,.600,95
543,NYK,2015-12-12,112,@,POR,W 112-110,240,39,75,.520,30,54,.556,9,21,.429,25,28,.893,112,41,89,.461,35,68,.515,6,21,.286,22,29,.759,110
544,GSW,2015-12-05,112,@,TOR,W 112-109,240,35,73,.479,19,43,.442,16,30,.533,26,36,.722,112,40,91,.440,32,71,.451,8,20,.400,21,26,.808,109
545,POR,2015-12-01,112,,DAL,L 112-115 (OT),265,41,100,.410,26,60,.433,15,40,.375,15,17,.882,112,43,94,.457,34,65,.523,9,29,.310,20,24,.833,115
546,SAC,2015-11-30,112,,DAL,W 112-98,240,36,79,.456,27,48,.563,9,31,.290,31,44,.705,112,36,84,.429,27,47,.574,9,37,.243,17,22,.773,98
547,IND,2015-11-18,112,@,PHI,W 112-85,240,42,92,.457,30,65,.462,12,27,.444,16,20,.800,112,35,76,.461,30,51,.588,5,25,.200,10,16,.625,85
548,GSW,2015-11-04,112,,LAC,W 112-108,240,39,85,.459,29,59,.492,10,26,.385,24,31,.774,112,43,88,.489,35,66,.530,8,22,.364,14,22,.636,108
549,GSW,2015-10-30,112,@,HOU,W 112-92,240,43,93,.462,34,67,.507,9,26,.346,17,25,.680,112,30,82,.366,25,59,.424,5,23,.217,27,36,.750,92
550,ATL,2015-10-29,112,@,NYK,W 112-101,240,42,83,.506,32,59,.542,10,24,.417,18,26,.692,112,38,93,.409,32,64,.500,6,29,.207,19,21,.905,101
551,MEM,2015-10-29,112,@,IND,W 112-103,240,41,82,.500,34,66,.515,7,16,.438,23,29,.793,112,37,78,.474,25,48,.521,12,30,.400,17,24,.708,103
552,OKC,2015-10-28,112,,SAS,W 112-106,240,42,86,.488,35,67,.522,7,19,.368,21,22,.955,112,45,93,.484,40,78,.513,5,15,.333,11,13,.846,106
553,MIN,2015-10-28,112,@,LAL,W 112-111,240,38,83,.458,33,63,.524,5,20,.250,31,37,.838,112,35,90,.389,26,56,.464,9,34,.265,32,35,.914,111
554,BOS,2015-10-28,112,,PHI,W 112-95,240,39,85,.459,31,61,.508,8,24,.333,26,27,.963,112,34,83,.410,27,61,.443,7,22,.318,20,23,.870,95
555,POR,2015-10-28,112,,NOP,W 112-94,240,44,88,.500,32,56,.571,12,32,.375,12,14,.857,112,36,91,.396,25,58,.431,11,33,.333,11,18,.611,94
556,BRK,2016-04-11,111,,WAS,L 111-120,240,44,98,.449,34,67,.507,10,31,.323,13,21,.619,111,46,89,.517,37,64,.578,9,25,.360,19,24,.792,120
557,TOR,2016-04-08,111,,IND,W 111-98,240,37,68,.544,27,46,.587,10,22,.455,27,38,.711,111,37,83,.446,29,56,.518,8,27,.296,16,20,.800,98
558,CHO,2016-04-06,111,@,NYK,W 111-97,240,42,90,.467,30,64,.469,12,26,.462,15,17,.882,111,37,78,.474,27,52,.519,10,26,.385,13,15,.867,97
559,POR,2016-04-03,111,@,GSW,L 111-136,240,38,85,.447,29,61,.475,9,24,.375,26,33,.788,111,50,88,.568,32,58,.552,18,30,.600,18,22,.818,136
560,WAS,2016-03-30,111,@,SAC,L 111-120,240,43,89,.483,34,63,.540,9,26,.346,16,20,.800,111,47,84,.560,39,66,.591,8,18,.444,18,25,.720,120
561,DAL,2016-03-27,111,@,SAC,L 111-133,240,42,88,.477,34,64,.531,8,24,.333,19,24,.792,111,51,82,.622,42,62,.677,9,20,.450,22,30,.733,133
562,OKC,2016-03-26,111,,SAS,W 111-92,240,44,85,.518,37,65,.569,7,20,.350,16,18,.889,111,37,86,.430,33,71,.465,4,15,.267,14,17,.824,92
563,ORL,2016-03-26,111,,CHI,W 111-89,240,48,89,.539,41,70,.586,7,19,.368,8,12,.667,111,36,88,.409,30,64,.469,6,24,.250,11,17,.647,89
564,OKC,2016-03-22,111,,HOU,W 111-107,240,41,91,.451,33,56,.589,8,35,.229,21,29,.724,111,40,92,.435,27,55,.491,13,37,.351,14,17,.824,107
565,IND,2016-03-19,111,,OKC,L 111-115,240,40,83,.482,31,61,.508,9,22,.409,22,30,.733,111,42,80,.525,32,52,.615,10,28,.357,21,26,.808,115
566,MIN,2016-03-18,111,@,HOU,L 111-116,240,43,85,.506,37,69,.536,6,16,.375,19,24,.792,111,48,85,.565,37,56,.661,11,29,.379,9,14,.643,116
567,OKC,2016-03-18,111,@,PHI,W 111-97,240,45,89,.506,38,67,.567,7,22,.318,14,18,.778,111,35,89,.393,25,60,.417,10,29,.345,17,27,.630,97
568,PHI,2016-03-12,111,,DET,L 111-125,240,39,84,.464,29,59,.492,10,25,.400,23,27,.852,111,49,91,.538,40,73,.548,9,18,.500,18,22,.818,125
569,SAC,2016-03-09,111,,CLE,L 111-120,240,40,84,.476,32,62,.516,8,22,.364,23,32,.719,111,39,90,.433,26,46,.565,13,44,.295,29,35,.829,120
570,CHI,2016-03-01,111,@,MIA,L 111-129,240,41,90,.456,30,67,.448,11,23,.478,18,26,.692,111,52,77,.675,46,65,.708,6,12,.500,19,25,.760,129
571,POR,2016-02-28,111,@,IND,W 111-102,240,41,81,.506,27,57,.474,14,24,.583,15,21,.714,111,40,93,.430,37,79,.468,3,14,.214,19,25,.760,102
572,PHO,2016-02-27,111,,MEM,W 111-106,240,37,80,.463,25,48,.521,12,32,.375,25,35,.714,111,32,80,.400,26,60,.433,6,20,.300,36,42,.857,106
573,DET,2016-02-24,111,,PHI,W 111-91,240,39,83,.470,28,55,.509,11,28,.393,22,34,.647,111,33,83,.398,26,60,.433,7,23,.304,18,26,.692,91
574,PHO,2016-02-21,111,,SAS,L 111-118,240,43,93,.462,34,69,.493,9,24,.375,16,22,.727,111,43,82,.524,33,66,.500,10,16,.625,22,34,.647,118
575,UTA,2016-02-21,111,@,POR,L 111-115,240,43,86,.500,35,70,.500,8,16,.500,17,23,.739,111,39,90,.433,27,58,.466,12,32,.375,25,38,.658,115
576,NOP,2016-02-21,111,@,DET,W 111-106,240,41,86,.477,37,66,.561,4,20,.200,25,29,.862,111,37,89,.416,25,56,.446,12,33,.364,20,32,.625,106
577,ATL,2016-02-19,111,,MIA,L 111-115,240,41,87,.471,25,51,.490,16,36,.444,13,13,1.000,111,44,88,.500,36,68,.529,8,20,.400,19,28,.679,115
578,UTA,2016-02-19,111,,BOS,W 111-93,240,37,68,.544,27,45,.600,10,23,.435,27,44,.614,111,30,81,.370,23,56,.411,7,25,.280,26,36,.722,93
579,LAL,2016-02-10,111,@,CLE,L 111-120,240,38,86,.442,25,58,.431,13,28,.464,22,27,.815,111,48,94,.511,35,63,.556,13,31,.419,11,18,.611,120
580,BOS,2016-02-09,111,@,MIL,L 111-112,240,39,84,.464,29,55,.527,10,29,.345,23,24,.958,111,45,88,.511,38,69,.551,7,19,.368,15,23,.652,112
581,WAS,2016-02-09,111,@,NYK,W 111-108,240,39,78,.500,23,52,.442,16,26,.615,17,25,.680,111,44,83,.530,36,57,.632,8,26,.308,12,14,.857,108
582,DET,2016-02-04,111,,NYK,W 111-105,240,40,79,.506,31,62,.500,9,17,.529,22,33,.667,111,36,84,.429,30,62,.484,6,22,.273,27,34,.794,105
583,HOU,2016-02-04,111,@,PHO,W 111-105,240,37,86,.430,22,44,.500,15,42,.357,22,32,.688,111,32,83,.386,21,54,.389,11,29,.379,30,32,.938,105
584,SAC,2016-02-01,111,,MIL,W 111-104,240,39,86,.453,30,60,.500,9,26,.346,24,30,.800,111,42,84,.500,34,64,.531,8,20,.400,12,17,.706,104
585,CLE,2016-02-01,111,@,IND,W 111-106 (OT),265,44,88,.500,37,66,.561,7,22,.318,16,23,.696,111,43,101,.426,35,74,.473,8,27,.296,12,14,.857,106
586,TOR,2016-01-30,111,,DET,W 111-107,240,36,78,.462,32,64,.500,4,14,.286,35,47,.745,111,39,87,.448,30,58,.517,9,29,.310,20,34,.588,107
587,IND,2016-01-28,111,,ATL,W 111-92,240,38,78,.487,29,63,.460,9,15,.600,26,30,.867,111,33,83,.398,26,55,.473,7,28,.250,19,21,.905,92
588,BOS,2016-01-27,111,,DEN,W 111-103,240,41,96,.427,32,68,.471,9,28,.321,20,24,.833,111,36,84,.429,29,63,.460,7,21,.333,24,32,.750,103
589,NOP,2016-01-25,111,,HOU,L 111-112,240,42,91,.462,29,62,.468,13,29,.448,14,25,.560,111,38,80,.475,19,40,.475,19,40,.475,17,21,.810,112
590,UTA,2016-01-20,111,@,NYK,L 111-118 (OT),265,37,86,.430,25,59,.424,12,27,.444,25,31,.806,111,47,90,.522,40,73,.548,7,17,.412,17,18,.944,118
591,CHI,2016-01-18,111,@,DET,W 111-101,240,44,84,.524,35,63,.556,9,21,.429,14,20,.700,111,42,95,.442,37,69,.536,5,26,.192,12,20,.600,101
592,PHI,2016-01-14,111,,CHI,L 111-115 (OT),265,42,93,.452,30,66,.455,12,27,.444,15,20,.750,111,41,88,.466,34,71,.479,7,17,.412,26,31,.839,115
593,GSW,2016-01-11,111,,MIA,W 111-103,240,41,86,.477,34,63,.540,7,23,.304,22,30,.733,111,41,91,.451,34,72,.472,7,19,.368,14,16,.875,103
594,NOP,2016-01-10,111,@,LAC,L 111-114 (OT),265,40,100,.400,32,70,.457,8,30,.267,23,29,.793,111,42,89,.472,30,53,.566,12,36,.333,18,34,.529,114
595,PHO,2016-01-06,111,,CHO,W 111-102,240,41,84,.488,22,51,.431,19,33,.576,10,13,.769,111,38,87,.437,27,59,.458,11,28,.393,15,22,.682,102
596,GSW,2016-01-04,111,,CHO,W 111-101,240,45,87,.517,30,53,.566,15,34,.441,6,6,1.000,111,38,86,.442,31,65,.477,7,21,.333,18,19,.947,101
597,NYK,2016-01-03,111,,ATL,W 111-97,240,44,88,.500,33,62,.532,11,26,.423,12,14,.857,111,37,84,.440,29,58,.500,8,26,.308,15,20,.750,97
598,GSW,2016-01-02,111,,DEN,W 111-108 (OT),265,43,86,.500,33,58,.569,10,28,.357,15,23,.652,111,44,105,.419,39,75,.520,5,30,.167,15,23,.652,108
599,BRK,2015-12-28,111,@,MIA,W 111-105,240,36,82,.439,24,59,.407,12,23,.522,27,36,.750,111,36,78,.462,26,54,.481,10,24,.417,23,30,.767,105
600,PHI,2015-12-26,111,@,PHO,W 111-104,240,38,79,.481,26,52,.500,12,27,.444,23,27,.852,111,34,88,.386,24,61,.393,10,27,.370,26,34,.765,104
601,WAS,2015-12-26,111,@,BRK,W 111-96,240,42,84,.500,30,57,.526,12,27,.444,15,22,.682,111,43,89,.483,38,72,.528,5,17,.294,5,16,.313,96
602,CHI,2015-12-26,111,@,DAL,L 111-118,240,42,78,.538,34,57,.596,8,21,.381,19,26,.731,111,40,87,.460,24,54,.444,16,33,.485,22,28,.786,118
603,TOR,2015-12-26,111,@,MIL,W 111-90,240,42,81,.519,29,52,.558,13,29,.448,14,19,.737,111,34,81,.420,28,67,.418,6,14,.429,16,18,.889,90
604,LAL,2015-12-22,111,@,DEN,W 111-107,240,40,84,.476,33,58,.569,7,26,.269,24,32,.750,111,41,90,.456,32,65,.492,9,25,.360,16,19,.842,107
605,DAL,2015-12-12,111,,WAS,L 111-114,240,38,89,.427,24,56,.429,14,33,.424,21,24,.875,111,44,85,.518,30,56,.536,14,29,.483,12,15,.800,114
606,DEN,2015-12-11,111,,MIN,W 111-108 (OT),265,38,86,.442,27,58,.466,11,28,.393,24,33,.727,111,38,87,.437,31,68,.456,7,19,.368,25,29,.862,108
607,CLE,2015-12-11,111,@,ORL,W 111-76,240,41,72,.569,30,51,.588,11,21,.524,18,27,.667,111,28,72,.389,22,50,.440,6,22,.273,14,20,.700,76
608,BOS,2015-12-07,111,@,NOP,W 111-93,240,40,81,.494,28,53,.528,12,28,.429,19,24,.792,111,37,90,.411,33,77,.429,4,13,.308,15,18,.833,93
609,DET,2015-12-06,111,,LAL,W 111-91,240,41,93,.441,32,69,.464,9,24,.375,20,26,.769,111,32,80,.400,27,62,.435,5,18,.278,22,29,.759,91
610,IND,2015-12-03,111,@,POR,L 111-123,240,38,88,.432,25,58,.431,13,30,.433,22,24,.917,111,44,85,.518,26,49,.531,18,36,.500,17,20,.850,123
611,NYK,2015-11-29,111,,HOU,L 111-116 (OT),265,45,78,.577,39,60,.650,6,18,.333,15,17,.882,111,43,95,.453,36,70,.514,7,25,.280,23,36,.639,116
612,LAC,2015-11-27,111,,NOP,W 111-90,240,40,83,.482,33,64,.516,7,19,.368,24,30,.800,111,34,94,.362,29,74,.392,5,20,.250,17,23,.739,90
613,BOS,2015-11-27,111,,WAS,W 111-78,240,42,97,.433,30,64,.469,12,33,.364,15,19,.789,111,27,84,.321,22,66,.333,5,18,.278,19,22,.864,78
614,GSW,2015-11-24,111,,LAL,W 111-77,240,45,92,.489,33,57,.579,12,35,.343,9,15,.600,111,31,83,.373,28,62,.452,3,21,.143,12,16,.750,77
615,LAC,2015-11-24,111,@,DEN,W 111-94,240,37,79,.468,29,59,.492,8,20,.400,29,47,.617,111,31,78,.397,23,53,.434,8,25,.320,24,29,.828,94
616,OKC,2015-11-23,111,@,UTA,W 111-89,240,42,77,.545,31,50,.620,11,27,.407,16,18,.889,111,28,73,.384,23,54,.426,5,19,.263,28,40,.700,89
617,BRK,2015-11-22,111,,BOS,W 111-101,240,40,79,.506,35,64,.547,5,15,.333,26,33,.788,111,35,82,.427,21,45,.467,14,37,.378,17,21,.810,101
618,BRK,2015-11-18,111,@,CHO,L 111-116,240,44,91,.484,39,76,.513,5,15,.333,18,22,.818,111,39,80,.488,28,55,.509,11,25,.440,27,36,.750,116
619,BOS,2015-11-16,111,@,HOU,W 111-95,240,44,93,.473,33,57,.579,11,36,.306,12,17,.706,111,36,85,.424,25,53,.472,11,32,.344,12,23,.522,95
620,SAC,2015-11-13,111,,BRK,W 111-109,240,40,94,.426,29,67,.433,11,27,.407,20,26,.769,111,42,89,.472,34,68,.500,8,21,.381,17,21,.810,109
621,NYK,2015-11-10,111,@,TOR,W 111-109,240,42,95,.442,31,72,.431,11,23,.478,16,18,.889,111,37,84,.440,33,67,.493,4,17,.235,31,39,.795,109
622,CHI,2015-11-09,111,@,PHI,W 111-88,240,41,96,.427,31,71,.437,10,25,.400,19,23,.826,111,35,100,.350,30,75,.400,5,25,.200,13,23,.565,88
623,DAL,2015-10-28,111,@,PHO,W 111-95,240,40,85,.471,30,64,.469,10,21,.476,21,31,.677,111,34,87,.391,28,63,.444,6,24,.250,21,33,.636,95
624,LAC,2015-10-28,111,@,SAC,W 111-104,240,42,80,.525,36,61,.590,6,19,.316,21,31,.677,111,41,94,.436,30,70,.429,11,24,.458,11,18,.611,104
625,LAL,2015-10-28,111,,MIN,L 111-112,240,35,90,.389,26,56,.464,9,34,.265,32,35,.914,111,38,83,.458,33,63,.524,5,20,.250,31,37,.838,112
626,GSW,2015-10-27,111,,NOP,W 111-95,240,41,96,.427,32,66,.485,9,30,.300,20,22,.909,111,35,83,.422,29,65,.446,6,18,.333,19,27,.704,95
627,CLE,2016-04-13,110,,DET,L 110-112 (OT),265,46,97,.474,39,79,.494,7,18,.389,11,15,.733,110,37,85,.435,21,52,.404,16,33,.485,22,28,.786,112
628,LAC,2016-04-12,110,,MEM,W 110-84,240,41,75,.547,29,50,.580,12,25,.480,16,21,.762,110,35,86,.407,30,66,.455,5,20,.250,9,14,.643,84
629,LAL,2016-04-10,110,@,HOU,L 110-130,240,41,83,.494,29,55,.527,12,28,.429,16,19,.842,110,50,98,.510,33,57,.579,17,41,.415,13,18,.722,130
630,NOP,2016-04-08,110,,LAL,W 110-102,240,42,79,.532,32,57,.561,10,22,.455,16,21,.762,110,34,81,.420,23,57,.404,11,24,.458,23,27,.852,102
631,OKC,2016-04-03,110,@,HOU,L 110-118,240,38,82,.463,31,55,.564,7,27,.259,27,32,.844,110,41,102,.402,28,60,.467,13,42,.310,23,26,.885,118
632,POR,2016-04-02,110,,MIA,W 110-93,240,41,79,.519,31,64,.484,10,15,.667,18,23,.783,110,34,88,.386,28,69,.406,6,19,.316,19,27,.704,93
633,CLE,2016-04-01,110,@,ATL,W 110-108 (OT),265,39,98,.398,27,60,.450,12,38,.316,20,31,.645,110,38,95,.400,29,65,.446,9,30,.300,23,26,.885,108
634,ORL,2016-04-01,110,@,MIL,L 110-113,240,46,86,.535,38,62,.613,8,24,.333,10,12,.833,110,47,86,.547,43,69,.623,4,17,.235,15,25,.600,113
635,MIA,2016-03-28,110,,BRK,W 110-99,240,48,84,.571,43,68,.632,5,16,.313,9,12,.750,110,41,77,.532,38,66,.576,3,11,.273,14,18,.778,99
636,IND,2016-03-26,110,@,BRK,L 110-120,240,37,77,.481,26,53,.491,11,24,.458,25,30,.833,110,42,77,.545,37,66,.561,5,11,.455,31,36,.861,120
637,SAS,2016-03-25,110,,MEM,W 110-104,240,44,77,.571,37,59,.627,7,18,.389,15,18,.833,110,44,83,.530,37,65,.569,7,18,.389,9,13,.692,104
638,POR,2016-03-17,110,@,SAS,L 110-118,240,39,89,.438,29,67,.433,10,22,.455,22,30,.733,110,45,86,.523,37,70,.529,8,16,.500,20,22,.909,118
639,DEN,2016-03-15,110,@,ORL,L 110-116,240,40,80,.500,31,56,.554,9,24,.375,21,24,.875,110,44,81,.543,36,56,.643,8,25,.320,20,25,.800,116
640,DEN,2016-03-08,110,,NYK,W 110-94,240,45,99,.455,39,78,.500,6,21,.286,14,19,.737,110,33,75,.440,27,57,.474,6,18,.333,22,26,.846,94
641,NOP,2016-02-27,110,,MIN,L 110-112,240,39,84,.464,29,57,.509,10,27,.370,22,26,.846,110,42,84,.500,37,69,.536,5,15,.333,23,30,.767,112
642,DEN,2016-02-23,110,,SAC,L 110-114,240,41,100,.410,31,73,.425,10,27,.370,18,22,.818,110,43,83,.518,36,66,.545,7,17,.412,21,28,.750,114
643,DEN,2016-02-19,110,@,SAC,L 110-116,240,42,90,.467,34,66,.515,8,24,.333,18,26,.692,110,41,83,.494,31,62,.500,10,21,.476,24,31,.774,116
644,ORL,2016-02-19,110,,DAL,W 110-104 (OT),265,41,102,.402,28,67,.418,13,35,.371,15,17,.882,110,37,89,.416,18,48,.375,19,41,.463,11,18,.611,104
645,PHI,2016-02-10,110,,SAC,L 110-114,240,42,91,.462,27,56,.482,15,35,.429,11,17,.647,110,44,87,.506,40,71,.563,4,16,.250,22,29,.759,114
646,HOU,2016-02-09,110,@,GSW,L 110-123,240,37,87,.425,24,54,.444,13,33,.394,23,35,.657,110,44,94,.468,32,60,.533,12,34,.353,23,26,.885,123
647,ATL,2016-02-08,110,,ORL,L 110-117 (OT),265,43,92,.467,31,63,.492,12,29,.414,12,20,.600,110,46,93,.495,37,64,.578,9,29,.310,16,22,.727,117
648,MEM,2016-02-06,110,,DAL,L 110-114 (OT),265,44,88,.500,35,65,.538,9,23,.391,13,23,.565,110,38,88,.432,23,50,.460,15,38,.395,23,33,.697,114
649,CHI,2016-02-05,110,@,DEN,L 110-115,240,43,93,.462,38,81,.469,5,12,.417,19,27,.704,110,39,87,.448,33,69,.478,6,18,.333,31,44,.705,115
650,TOR,2016-02-04,110,@,POR,W 110-103,240,40,85,.471,28,66,.424,12,19,.632,18,25,.720,110,38,81,.469,28,56,.500,10,25,.400,17,23,.739,103
651,SAS,2016-02-03,110,,NOP,W 110-97,240,42,81,.519,33,66,.500,9,15,.600,17,18,.944,110,41,90,.456,38,71,.535,3,19,.158,12,14,.857,97
652,MEM,2016-02-01,110,@,NOP,W 110-95,240,43,71,.606,34,55,.618,9,16,.563,15,18,.833,110,36,88,.409,26,62,.419,10,26,.385,13,21,.619,95
653,DET,2016-01-27,110,,PHI,W 110-97,240,39,91,.429,34,70,.486,5,21,.238,27,38,.711,110,39,82,.476,32,63,.508,7,19,.368,12,17,.706,97
654,IND,2016-01-22,110,@,GSW,L 110-122,240,44,95,.463,41,78,.526,3,17,.176,19,27,.704,110,43,90,.478,29,57,.509,14,33,.424,22,25,.880,122
655,BOS,2016-01-22,110,,CHI,W 110-101,240,43,96,.448,35,73,.479,8,23,.348,16,21,.762,110,38,89,.427,35,76,.461,3,13,.231,22,26,.846,101
656,OKC,2016-01-19,110,@,DEN,W 110-104,240,41,97,.423,35,69,.507,6,28,.214,22,30,.733,110,35,83,.422,28,63,.444,7,20,.350,27,36,.750,104
657,SAC,2016-01-16,110,@,LAC,W 110-103,240,36,76,.474,23,51,.451,13,25,.520,25,33,.758,110,38,96,.396,25,57,.439,13,39,.333,14,19,.737,103
658,GSW,2016-01-13,110,@,DEN,L 110-112,240,42,88,.477,32,62,.516,10,26,.385,16,20,.800,110,37,87,.425,32,65,.492,5,22,.227,33,37,.892,112
659,BRK,2016-01-13,110,,NYK,W 110-104,240,45,86,.523,36,69,.522,9,17,.529,11,14,.786,110,41,91,.451,34,69,.493,7,22,.318,15,23,.652,104
660,CLE,2016-01-12,110,@,DAL,W 110-107 (OT),265,40,97,.412,23,53,.434,17,44,.386,13,16,.813,110,39,79,.494,28,51,.549,11,28,.393,18,22,.818,107
661,OKC,2016-01-10,110,@,POR,L 110-115,240,37,76,.487,27,55,.491,10,21,.476,26,36,.722,110,42,100,.420,23,56,.411,19,44,.432,12,14,.857,115
662,OKC,2015-12-31,110,,PHO,W 110-106,240,42,80,.525,35,59,.593,7,21,.333,19,24,.792,110,43,82,.524,35,62,.565,8,20,.400,12,13,.923,106
663,HOU,2015-12-31,110,,GSW,L 110-114,240,36,78,.462,24,48,.500,12,30,.400,26,29,.897,110,43,84,.512,32,61,.525,11,23,.478,17,27,.630,114
664,PHI,2015-12-30,110,@,SAC,W 110-105,240,40,94,.426,31,63,.492,9,31,.290,21,34,.618,110,36,74,.486,28,49,.571,8,25,.320,25,41,.610,105
665,POR,2015-12-30,110,,DEN,W 110-103,240,41,87,.471,29,55,.527,12,32,.375,16,20,.800,110,37,87,.425,25,60,.417,12,27,.444,17,19,.895,103
666,NOP,2015-12-26,110,,HOU,W 110-108,240,38,75,.507,25,51,.490,13,24,.542,21,26,.808,110,38,84,.452,23,51,.451,15,33,.455,17,20,.850,108
667,UTA,2015-12-21,110,,PHO,W 110-89,240,36,79,.456,27,54,.500,9,25,.360,29,37,.784,110,31,79,.392,24,55,.436,7,24,.292,20,22,.909,89
668,POR,2015-12-12,110,,NYK,L 110-112,240,41,89,.461,35,68,.515,6,21,.286,22,29,.759,110,39,75,.520,30,54,.556,9,21,.429,25,28,.893,112
669,BRK,2015-12-08,110,,HOU,W 110-105,240,45,81,.556,38,63,.603,7,18,.389,13,16,.813,110,39,82,.476,24,47,.511,15,35,.429,12,17,.706,105
670,LAC,2015-12-07,110,@,MIN,W 110-106,240,38,86,.442,30,61,.492,8,25,.320,26,29,.897,110,36,82,.439,29,64,.453,7,18,.389,27,35,.771,106
671,ORL,2015-11-29,110,,BOS,W 110-91,240,45,93,.484,36,68,.529,9,25,.360,11,16,.688,110,36,88,.409,31,61,.508,5,27,.185,14,20,.700,91
672,OKC,2015-11-25,110,,BRK,W 110-99,240,41,78,.526,31,54,.574,10,24,.417,18,21,.857,110,43,94,.457,40,81,.494,3,13,.231,10,12,.833,99
673,MEM,2015-11-24,110,,DAL,W 110-96,240,37,86,.430,30,65,.462,7,21,.333,29,37,.784,110,30,77,.390,19,43,.442,11,34,.324,25,28,.893,96
674,OKC,2015-11-18,110,,NOP,W 110-103,240,38,85,.447,31,68,.456,7,17,.412,27,40,.675,110,43,95,.453,35,63,.556,8,32,.250,9,9,1.000,103
675,TOR,2015-11-17,110,@,GSW,L 110-115,240,37,79,.468,31,61,.508,6,18,.333,30,39,.769,110,43,80,.538,32,51,.627,11,29,.379,18,27,.667,115
676,DAL,2015-11-14,110,@,HOU,W 110-98,240,43,89,.483,35,61,.574,8,28,.286,16,21,.762,110,32,84,.381,23,50,.460,9,34,.265,25,32,.781,98
677,SAC,2015-11-06,110,,HOU,L 110-116,240,40,93,.430,31,65,.477,9,28,.321,21,29,.724,110,40,82,.488,25,46,.543,15,36,.417,21,27,.778,116
678,HOU,2015-11-02,110,,OKC,W 110-105,240,41,89,.461,32,60,.533,9,29,.310,19,29,.655,110,40,84,.476,30,61,.492,10,23,.435,15,22,.682,105
679,WAS,2015-10-31,110,,NYK,L 110-117,240,38,90,.422,32,68,.471,6,22,.273,28,33,.848,110,41,86,.477,32,67,.478,9,19,.474,26,32,.813,117
680,PHO,2015-10-30,110,,POR,W 110-92,240,37,83,.446,33,65,.508,4,18,.222,32,42,.762,110,34,86,.395,25,62,.403,9,24,.375,15,19,.789,92
681,WAS,2016-04-13,109,,ATL,W 109-98,240,42,88,.477,33,60,.550,9,28,.321,16,30,.533,109,32,81,.395,21,52,.404,11,29,.379,23,31,.742,98
682,NOP,2016-04-13,109,@,MIN,L 109-144,240,40,92,.435,29,62,.468,11,30,.367,18,22,.818,109,56,86,.651,43,58,.741,13,28,.464,19,23,.826,144
683,CLE,2016-04-11,109,,ATL,W 109-94,240,40,83,.482,29,54,.537,11,29,.379,18,20,.900,109,39,87,.448,31,57,.544,8,30,.267,8,15,.533,94
684,MIL,2016-04-10,109,@,PHI,W 109-108 (OT),265,40,87,.460,33,64,.516,7,23,.304,22,24,.917,109,39,96,.406,26,50,.520,13,46,.283,17,25,.680,108
685,NYK,2016-04-08,109,@,PHI,W 109-102,240,43,91,.473,39,75,.520,4,16,.250,19,30,.633,109,32,91,.352,18,54,.333,14,37,.378,24,36,.667,102
686,MIA,2016-04-08,109,@,ORL,L 109-112,240,45,100,.450,37,78,.474,8,22,.364,11,21,.524,109,43,82,.524,38,71,.535,5,11,.455,21,28,.750,112
687,MIL,2016-04-08,109,@,BOS,L 109-124,240,41,84,.488,34,67,.507,7,17,.412,20,29,.690,109,44,78,.564,38,64,.594,6,14,.429,30,38,.789,124
688,CLE,2016-04-06,109,@,IND,L 109-123,240,35,74,.473,27,45,.600,8,29,.276,31,34,.912,109,45,80,.563,29,49,.592,16,31,.516,17,22,.773,123
689,CLE,2016-04-05,109,@,MIL,W 109-80,240,41,75,.547,23,39,.590,18,36,.500,9,10,.900,109,35,88,.398,31,72,.431,4,16,.250,6,12,.500,80
690,WAS,2016-04-03,109,@,LAC,L 109-114,240,43,94,.457,32,64,.500,11,30,.367,12,21,.571,109,43,85,.506,35,66,.530,8,19,.421,20,33,.606,114
691,BOS,2016-04-01,109,@,GSW,W 109-106,240,41,87,.471,33,64,.516,8,23,.348,19,30,.633,109,38,83,.458,18,40,.450,20,43,.465,10,13,.769,106
692,BOS,2016-03-31,109,@,POR,L 109-116,240,37,88,.420,28,64,.438,9,24,.375,26,34,.765,109,41,90,.456,27,56,.482,14,34,.412,20,27,.741,116
693,DEN,2016-03-30,109,@,MEM,W 109-105,240,38,78,.487,25,49,.510,13,29,.448,20,24,.833,109,41,95,.432,35,76,.461,6,19,.316,17,27,.630,105
694,TOR,2016-03-25,109,@,HOU,L 109-112,240,39,94,.415,26,63,.413,13,31,.419,18,26,.692,109,42,81,.519,30,59,.508,12,22,.545,16,35,.457,112
695,POR,2016-03-23,109,,DAL,W 109-103,240,40,89,.449,33,62,.532,7,27,.259,22,25,.880,109,42,96,.438,33,66,.500,9,30,.300,10,11,.909,103
696,GSW,2016-03-21,109,@,MIN,W 109-104,240,43,87,.494,35,63,.556,8,24,.333,15,24,.625,109,36,82,.439,29,63,.460,7,19,.368,25,30,.833,104
697,CHI,2016-03-21,109,,SAC,W 109-102,240,41,91,.451,29,67,.433,12,24,.500,15,23,.652,109,40,88,.455,31,59,.525,9,29,.310,13,16,.813,102
698,NOP,2016-03-20,109,,LAC,W 109-105,240,35,71,.493,28,50,.560,7,21,.333,32,40,.800,109,33,82,.402,23,43,.535,10,39,.256,29,42,.690,105
699,ATL,2016-03-19,109,,HOU,W 109-97,240,44,88,.500,30,50,.600,14,38,.368,7,12,.583,109,33,84,.393,28,61,.459,5,23,.217,26,31,.839,97
700,CLE,2016-03-18,109,@,ORL,W 109-103,240,38,76,.500,25,48,.521,13,28,.464,20,27,.741,109,37,82,.451,26,60,.433,11,22,.500,18,22,.818,103
701,CHO,2016-03-17,109,@,MIA,W 109-106,240,40,86,.465,27,60,.450,13,26,.500,16,21,.762,109,40,75,.533,33,58,.569,7,17,.412,19,24,.792,106
702,BOS,2016-03-16,109,,OKC,L 109-130,240,40,93,.430,35,74,.473,5,19,.263,24,27,.889,109,47,96,.490,35,67,.522,12,29,.414,24,30,.800,130
703,CHI,2016-03-14,109,@,TOR,W 109-107,240,41,83,.494,32,58,.552,9,25,.360,18,20,.900,109,37,83,.446,31,63,.492,6,20,.300,27,31,.871,107
704,MIL,2016-03-13,109,@,BRK,W 109-100,240,45,89,.506,39,75,.520,6,14,.429,13,21,.619,109,39,70,.557,27,43,.628,12,27,.444,10,13,.769,100
705,HOU,2016-03-12,109,@,CHO,L 109-125,240,43,93,.462,38,67,.567,5,26,.192,18,28,.643,109,48,88,.545,33,57,.579,15,31,.484,14,16,.875,125
706,SAS,2016-03-10,109,,CHI,W 109-101,240,44,93,.473,38,76,.500,6,17,.353,15,19,.789,109,39,86,.453,28,64,.438,11,22,.500,12,13,.923,101
707,WAS,2016-03-08,109,@,POR,L 109-116 (OT),265,45,99,.455,37,79,.468,8,20,.400,11,23,.478,109,41,89,.461,31,65,.477,10,24,.417,24,31,.774,116
708,LAC,2016-03-07,109,@,DAL,W 109-90,240,39,83,.470,27,51,.529,12,32,.375,19,29,.655,109,30,81,.370,26,56,.464,4,25,.160,26,32,.813,90
709,PHO,2016-03-06,109,@,MEM,W 109-100,240,37,71,.521,25,43,.581,12,28,.429,23,30,.767,109,32,80,.400,22,58,.379,10,22,.455,26,33,.788,100
710,GSW,2016-03-01,109,,ATL,W 109-105 (OT),265,41,103,.398,29,67,.433,12,36,.333,15,17,.882,109,37,80,.463,25,47,.532,12,33,.364,19,24,.792,105
711,CHI,2016-02-24,109,,WAS,W 109-104,240,44,88,.500,36,65,.554,8,23,.348,13,16,.813,109,38,90,.422,29,62,.468,9,28,.321,19,26,.731,104
712,WAS,2016-02-23,109,,NOP,W 109-89,240,43,94,.457,31,68,.456,12,26,.462,11,17,.647,109,29,83,.349,23,60,.383,6,23,.261,25,33,.758,89
713,ATL,2016-02-20,109,,MIL,L 109-117 (2OT),290,44,106,.415,35,65,.538,9,41,.220,12,18,.667,109,46,104,.442,43,87,.494,3,17,.176,22,32,.688,117
714,BRK,2016-02-19,109,,NYK,W 109-98,240,42,86,.488,34,69,.493,8,17,.471,17,20,.850,109,36,82,.439,26,56,.464,10,26,.385,16,18,.889,98
715,MEM,2016-02-19,109,,MIN,W 109-104,240,40,82,.488,33,61,.541,7,21,.333,22,28,.786,109,31,75,.413,20,49,.408,11,26,.423,31,31,1.000,104
716,MEM,2016-02-10,109,@,BRK,W 109-90,240,45,86,.523,36,66,.545,9,20,.450,10,12,.833,109,33,71,.465,22,49,.449,11,22,.500,13,19,.684,90
717,IND,2016-01-30,109,,DEN,W 109-105 (OT),265,44,100,.440,35,73,.479,9,27,.333,12,16,.750,109,40,87,.460,36,69,.522,4,18,.222,21,25,.840,105
718,POR,2016-01-29,109,,CHO,W 109-91,240,45,92,.489,38,72,.528,7,20,.350,12,16,.750,109,31,80,.388,21,51,.412,10,29,.345,19,28,.679,91
719,OKC,2016-01-22,109,@,DAL,W 109-106,240,45,91,.495,37,61,.607,8,30,.267,11,15,.733,109,40,87,.460,30,54,.556,10,33,.303,16,18,.889,106
720,OKC,2016-01-20,109,,CHO,W 109-95,240,39,83,.470,30,59,.508,9,24,.375,22,30,.733,109,34,81,.420,25,54,.463,9,27,.333,18,21,.857,95
721,BOS,2016-01-20,109,@,TOR,L 109-115,240,43,85,.506,31,59,.525,12,26,.462,11,15,.733,109,46,83,.554,35,54,.648,11,29,.379,12,17,.706,115
722,UTA,2016-01-16,109,,LAL,W 109-82,240,41,83,.494,29,59,.492,12,24,.500,15,18,.833,109,31,90,.344,22,67,.328,9,23,.391,11,18,.611,82
723,NOP,2016-01-15,109,,CHO,W 109-107,240,43,87,.494,31,60,.517,12,27,.444,11,13,.846,109,42,86,.488,28,51,.549,14,35,.400,9,12,.750,107
724,NOP,2016-01-13,109,@,SAC,W 109-97,240,42,100,.420,26,67,.388,16,33,.485,9,11,.818,109,41,84,.488,35,61,.574,6,23,.261,9,14,.643,97
725,SAS,2016-01-12,109,@,DET,W 109-99,240,41,85,.482,36,71,.507,5,14,.357,22,27,.815,109,38,91,.418,32,68,.471,6,23,.261,17,26,.654,99
726,LAC,2016-01-06,109,@,POR,W 109-98,240,42,83,.506,31,60,.517,11,23,.478,14,17,.824,109,38,86,.442,29,60,.483,9,26,.346,13,23,.565,98
727,GSW,2016-01-05,109,@,LAL,W 109-88,240,40,86,.465,27,55,.491,13,31,.419,16,21,.762,109,29,91,.319,24,70,.343,5,21,.238,25,30,.833,88
728,PHI,2016-01-04,109,,MIN,W 109-99,240,48,87,.552,44,67,.657,4,20,.200,9,14,.643,109,39,73,.534,37,68,.544,2,5,.400,19,24,.792,99
729,OKC,2016-01-02,109,@,CHO,W 109-90,240,35,79,.443,26,56,.464,9,23,.391,30,37,.811,109,29,84,.345,23,62,.371,6,22,.273,26,34,.765,90
730,UTA,2015-12-31,109,,POR,W 109-96,240,43,86,.500,28,53,.528,15,33,.455,8,11,.727,109,35,78,.449,19,42,.452,16,36,.444,10,14,.714,96
731,LAC,2015-12-26,109,@,UTA,W 109-104,240,38,79,.481,25,53,.472,13,26,.500,20,24,.833,109,36,74,.486,26,47,.553,10,27,.370,22,27,.815,104
732,POR,2015-12-20,109,@,MIA,L 109-116,240,39,80,.488,26,46,.565,13,34,.382,18,22,.818,109,43,75,.573,31,52,.596,12,23,.522,18,26,.692,116
733,WAS,2015-12-19,109,,CHO,W 109-101,240,40,79,.506,31,59,.525,9,20,.450,20,23,.870,109,39,93,.419,29,60,.483,10,33,.303,13,16,.813,101
734,ATL,2015-12-18,109,@,BOS,W 109-101,240,41,88,.466,37,68,.544,4,20,.200,23,29,.793,109,34,77,.442,24,54,.444,10,23,.435,23,31,.742,101
735,CHO,2015-12-17,109,,TOR,W 109-99 (OT),265,37,85,.435,27,56,.482,10,29,.345,25,31,.806,109,35,97,.361,26,58,.448,9,39,.231,20,28,.714,99
736,SAS,2015-12-11,109,,LAL,W 109-87,240,44,82,.537,38,68,.559,6,14,.429,15,25,.600,109,36,88,.409,27,63,.429,9,25,.360,6,10,.600,87
737,HOU,2015-12-09,109,@,WAS,W 109-103,240,40,83,.482,28,50,.560,12,33,.364,17,25,.680,109,39,89,.438,34,64,.531,5,25,.200,20,24,.833,103
738,LAC,2015-12-09,109,@,MIL,W 109-95,240,38,81,.469,26,53,.491,12,28,.429,21,36,.583,109,42,90,.467,40,80,.500,2,10,.200,9,12,.750,95
739,POR,2015-12-05,109,@,MIN,W 109-103,240,39,77,.506,29,57,.509,10,20,.500,21,30,.700,109,38,83,.458,33,68,.485,5,15,.333,22,26,.846,103
740,TOR,2015-12-05,109,,GSW,L 109-112,240,40,91,.440,32,71,.451,8,20,.400,21,26,.808,109,35,73,.479,19,43,.442,16,30,.533,26,36,.722,112
741,WAS,2015-12-04,109,,PHO,W 109-106,240,40,82,.488,30,56,.536,10,26,.385,19,25,.760,109,43,84,.512,33,61,.541,10,23,.435,10,16,.625,106
742,MIL,2015-11-23,109,,DET,W 109-88,240,43,83,.518,34,70,.486,9,13,.692,14,17,.824,109,31,91,.341,25,63,.397,6,28,.214,20,24,.833,88
743,CLE,2015-11-21,109,,ATL,W 109-97,240,41,85,.482,30,56,.536,11,29,.379,16,19,.842,109,32,86,.372,21,58,.362,11,28,.393,22,25,.880,97
744,SAC,2015-11-19,109,@,MIA,L 109-116,240,43,84,.512,31,61,.508,12,23,.522,11,20,.550,109,42,89,.472,35,65,.538,7,24,.292,25,33,.758,116
745,SAS,2015-11-18,109,,DEN,W 109-98,240,42,86,.488,33,68,.485,9,18,.500,16,20,.800,109,38,98,.388,33,83,.398,5,15,.333,17,18,.944,98
746,BRK,2015-11-13,109,@,SAC,L 109-111,240,42,89,.472,34,68,.500,8,21,.381,17,21,.810,109,40,94,.426,29,67,.433,11,27,.407,20,26,.769,111
747,TOR,2015-11-10,109,,NYK,L 109-111,240,37,84,.440,33,67,.493,4,17,.235,31,39,.795,109,42,95,.442,31,72,.431,11,23,.478,16,18,.889,111
748,GSW,2015-11-09,109,,DET,W 109-95,240,43,91,.473,31,70,.443,12,21,.571,11,13,.846,109,40,85,.471,34,66,.515,6,19,.316,9,15,.600,95
749,HOU,2015-11-07,109,@,LAC,W 109-105,240,38,86,.442,31,56,.554,7,30,.233,26,29,.897,109,42,88,.477,38,66,.576,4,22,.182,17,25,.680,105
750,LAL,2015-11-03,109,,DEN,L 109-120,240,36,86,.419,30,60,.500,6,26,.231,31,38,.816,109,43,85,.506,36,65,.554,7,20,.350,27,31,.871,120
751,MIA,2015-11-01,109,,HOU,W 109-89,240,42,86,.488,33,64,.516,9,22,.409,16,21,.762,109,32,79,.405,22,43,.512,10,36,.278,15,18,.833,89
752,SAC,2015-10-31,109,@,LAC,L 109-114,240,43,101,.426,37,83,.446,6,18,.333,17,25,.680,109,39,76,.513,35,59,.593,4,17,.235,32,46,.696,114
753,PHI,2016-04-10,108,,MIL,L 108-109 (OT),265,39,96,.406,26,50,.520,13,46,.283,17,25,.680,108,40,87,.460,33,64,.516,7,23,.304,22,24,.917,109
754,DET,2016-04-06,108,@,ORL,W 108-104,240,39,86,.453,28,59,.475,11,27,.407,19,31,.613,108,43,90,.478,39,75,.520,4,15,.267,14,19,.737,104
755,MEM,2016-04-05,108,,CHI,W 108-92,240,39,87,.448,32,68,.471,7,19,.368,23,26,.885,108,34,77,.442,23,48,.479,11,29,.379,13,19,.684,92
756,ATL,2016-04-01,108,,CLE,L 108-110 (OT),265,38,95,.400,29,65,.446,9,30,.300,23,26,.885,108,39,98,.398,27,60,.450,12,38,.316,20,31,.645,110
757,POR,2016-03-26,108,,PHI,W 108-105,240,38,91,.418,30,66,.455,8,25,.320,24,30,.800,108,39,93,.419,29,55,.527,10,38,.263,17,24,.708,105
758,MIA,2016-03-25,108,,ORL,W 108-97,240,40,80,.500,35,65,.538,5,15,.333,23,33,.697,108,36,84,.429,30,66,.455,6,18,.333,19,28,.679,97
759,SAC,2016-03-18,108,@,DET,L 108-115,240,40,79,.506,36,64,.563,4,15,.267,24,29,.828,108,44,92,.478,32,66,.485,12,26,.462,15,18,.833,115
760,SAC,2016-03-16,108,,NOP,L 108-123,240,42,90,.467,33,72,.458,9,18,.500,15,17,.882,108,49,90,.544,37,69,.536,12,21,.571,13,16,.813,123
761,MEM,2016-03-16,108,,MIN,L 108-114,240,44,100,.440,40,80,.500,4,20,.200,16,21,.762,108,40,71,.563,30,50,.600,10,21,.476,24,31,.774,114
762,SAS,2016-03-15,108,,LAC,W 108-87,240,44,82,.537,36,62,.581,8,20,.400,12,16,.750,108,32,69,.464,24,50,.480,8,19,.421,15,22,.682,87
763,UTA,2016-03-13,108,@,SAC,W 108-99,240,39,82,.476,27,54,.500,12,28,.429,18,22,.818,108,38,81,.469,29,60,.483,9,21,.429,14,21,.667,99
764,LAL,2016-03-10,108,,CLE,L 108-120,240,42,80,.525,35,58,.603,7,22,.318,17,21,.810,108,45,85,.529,29,50,.580,16,35,.457,14,20,.700,120
765,LAC,2016-03-09,108,@,OKC,L 108-120,240,41,81,.506,29,47,.617,12,34,.353,14,23,.609,108,48,91,.527,39,67,.582,9,24,.375,15,18,.833,120
766,MIA,2016-03-09,108,@,MIL,L 108-114,240,42,80,.525,36,65,.554,6,15,.400,18,19,.947,108,42,80,.525,38,72,.528,4,8,.500,26,37,.703,114
767,CHO,2016-03-07,108,,MIN,W 108-103,240,41,90,.456,29,60,.483,12,30,.400,14,17,.824,108,39,80,.488,35,65,.538,4,15,.267,21,24,.875,103
768,CHI,2016-03-05,108,,HOU,W 108-100,240,36,79,.456,27,58,.466,9,21,.429,27,34,.794,108,35,87,.402,26,52,.500,9,35,.257,21,30,.700,100
769,CHO,2016-03-04,108,,IND,W 108-101,240,38,79,.481,25,48,.521,13,31,.419,19,23,.826,108,37,90,.411,28,62,.452,9,28,.321,18,21,.857,101
770,CLE,2016-03-04,108,,WAS,W 108-83,240,42,90,.467,30,63,.476,12,27,.444,12,16,.750,108,32,81,.395,29,61,.475,3,20,.150,16,24,.667,83
771,MIA,2016-03-03,108,,PHO,W 108-92,240,40,83,.482,31,66,.470,9,17,.529,19,25,.760,108,33,82,.402,28,60,.467,5,22,.227,21,27,.778,92
772,ORL,2016-03-01,108,@,DAL,L 108-121,240,41,91,.451,32,61,.525,9,30,.300,17,20,.850,108,43,77,.558,34,58,.586,9,19,.474,26,31,.839,121
773,PHI,2016-02-29,108,@,WAS,L 108-116,240,43,89,.483,33,57,.579,10,32,.313,12,21,.571,108,43,89,.483,37,69,.536,6,20,.300,24,31,.774,116
774,NYK,2016-02-26,108,,ORL,W 108-95,240,37,80,.463,33,64,.516,4,16,.250,30,36,.833,108,39,93,.419,33,66,.500,6,27,.222,11,16,.688,95
775,SAS,2016-02-24,108,@,SAC,W 108-92,240,44,85,.518,36,66,.545,8,19,.421,12,15,.800,108,39,96,.406,33,78,.423,6,18,.333,8,15,.533,92
776,IND,2016-02-24,108,,NYK,W 108-105,240,46,91,.505,43,76,.566,3,15,.200,13,16,.813,108,35,77,.455,22,51,.431,13,26,.500,22,25,.880,105
777,MIL,2016-02-22,108,,LAL,W 108-101,240,44,86,.512,39,70,.557,5,16,.313,15,25,.600,108,28,76,.368,16,47,.340,12,29,.414,33,43,.767,101
778,NYK,2016-02-09,108,,WAS,L 108-111,240,44,83,.530,36,57,.632,8,26,.308,12,14,.857,108,39,78,.500,23,52,.442,16,26,.615,17,25,.680,111
779,CHO,2016-02-08,108,,CHI,W 108-91,240,35,80,.438,21,44,.477,14,36,.389,24,31,.774,108,35,90,.389,25,65,.385,10,25,.400,11,14,.786,91
780,CHO,2016-02-06,108,,WAS,W 108-104,240,38,81,.469,26,54,.481,12,27,.444,20,25,.800,108,38,86,.442,29,61,.475,9,25,.360,19,24,.792,104
781,OKC,2016-02-06,108,@,GSW,L 108-116,240,36,85,.424,29,63,.460,7,22,.318,29,37,.784,108,48,97,.495,41,71,.577,7,26,.269,13,20,.650,116
782,MIN,2016-02-03,108,@,LAC,W 108-102,240,39,77,.506,31,60,.517,8,17,.471,22,26,.846,108,33,75,.440,22,43,.512,11,32,.344,25,34,.735,102
783,GSW,2016-01-30,108,@,PHI,W 108-105,240,47,95,.495,34,65,.523,13,30,.433,1,2,.500,108,42,92,.457,32,63,.508,10,29,.345,11,21,.524,105
784,HOU,2016-01-29,108,@,OKC,L 108-116,240,36,95,.379,27,56,.482,9,39,.231,27,43,.628,108,41,86,.477,33,67,.493,8,19,.421,26,30,.867,116
785,MEM,2016-01-25,108,,ORL,W 108-102 (OT),265,43,100,.430,37,82,.451,6,18,.333,16,25,.640,108,40,86,.465,30,58,.517,10,28,.357,12,14,.857,102
786,SAC,2016-01-23,108,,IND,W 108-97,240,38,85,.447,33,69,.478,5,16,.313,27,36,.750,108,36,86,.419,29,67,.433,7,19,.368,18,25,.720,97
787,SAS,2016-01-22,108,@,LAL,W 108-95,240,43,85,.506,32,64,.500,11,21,.524,11,13,.846,108,38,84,.452,32,68,.471,6,16,.375,13,18,.722,95
788,UTA,2016-01-22,108,@,BRK,W 108-86,240,43,75,.573,34,59,.576,9,16,.563,13,15,.867,108,33,75,.440,27,59,.458,6,16,.375,14,18,.778,86
789,POR,2016-01-18,108,@,WAS,W 108-98,240,43,84,.512,26,53,.491,17,31,.548,5,11,.455,108,37,77,.481,28,56,.500,9,21,.429,15,20,.750,98
790,MIL,2016-01-15,108,,ATL,W 108-101 (OT),265,40,96,.417,37,86,.430,3,10,.300,25,37,.676,108,43,100,.430,34,70,.486,9,30,.300,6,6,1.000,101
791,OKC,2016-01-13,108,,DAL,W 108-89,240,38,82,.463,23,49,.469,15,33,.455,17,29,.586,108,32,82,.390,26,51,.510,6,31,.194,19,25,.760,89
792,TOR,2016-01-09,108,@,PHI,W 108-95,240,41,75,.547,36,58,.621,5,17,.294,21,27,.778,108,39,80,.488,28,63,.444,11,17,.647,6,14,.429,95
793,POR,2016-01-08,108,,GSW,L 108-128,240,38,96,.396,26,63,.413,12,33,.364,20,28,.714,108,46,87,.529,28,55,.509,18,32,.563,18,21,.857,128
794,DEN,2016-01-02,108,@,GSW,L 108-111 (OT),265,44,105,.419,39,75,.520,5,30,.167,15,23,.652,108,43,86,.500,33,58,.569,10,28,.357,15,23,.652,111
795,CHI,2016-01-01,108,,NYK,W 108-81,240,39,85,.459,29,69,.420,10,16,.625,20,25,.800,108,31,84,.369,25,65,.385,6,19,.316,13,17,.765,81
796,NYK,2015-12-29,108,,DET,W 108-96,240,43,79,.544,35,63,.556,8,16,.500,14,17,.824,108,37,89,.416,27,62,.435,10,27,.370,12,17,.706,96
797,CHO,2015-12-28,108,,LAL,W 108-98,240,43,89,.483,37,64,.578,6,25,.240,16,22,.727,108,35,85,.412,26,56,.464,9,29,.310,19,23,.826,98
798,LAC,2015-12-28,108,@,WAS,W 108-91,240,41,78,.526,34,55,.618,7,23,.304,19,25,.760,108,34,87,.391,27,63,.429,7,24,.292,16,24,.667,91
799,HOU,2015-12-26,108,@,NOP,L 108-110,240,38,84,.452,23,51,.451,15,33,.455,17,20,.850,108,38,75,.507,25,51,.490,13,24,.542,21,26,.808,110
800,MIA,2015-12-26,108,@,ORL,W 108-101,240,38,77,.494,28,57,.491,10,20,.500,22,23,.957,108,43,79,.544,34,60,.567,9,19,.474,6,13,.462,101
801,SAS,2015-12-23,108,@,MIN,W 108-83,240,44,82,.537,34,58,.586,10,24,.417,10,14,.714,108,30,72,.417,27,62,.435,3,10,.300,20,25,.800,83
802,SAC,2015-12-23,108,@,IND,W 108-106,240,46,89,.517,42,66,.636,4,23,.174,12,16,.750,108,41,89,.461,29,57,.509,12,32,.375,12,20,.600,106
803,CLE,2015-12-20,108,,PHI,W 108-86,240,40,85,.471,29,60,.483,11,25,.440,17,21,.810,108,30,86,.349,25,62,.403,5,24,.208,21,30,.700,86
804,TOR,2015-12-18,108,@,MIA,W 108-94,240,41,80,.513,33,59,.559,8,21,.381,18,22,.818,108,35,74,.473,26,49,.531,9,25,.360,15,17,.882,94
805,HOU,2015-12-14,108,@,DEN,L 108-114,240,41,87,.471,23,47,.489,18,40,.450,8,11,.727,108,42,82,.512,34,57,.596,8,25,.320,22,25,.880,114
806,PHO,2015-12-13,108,,MIN,W 108-101,240,39,87,.448,29,57,.509,10,30,.333,20,24,.833,108,33,73,.452,25,54,.463,8,19,.421,27,34,.794,101
807,MIL,2015-12-12,108,,GSW,W 108-95,240,44,90,.489,38,76,.500,6,14,.429,14,18,.778,108,36,89,.404,30,62,.484,6,27,.222,17,25,.680,95
808,MIN,2015-12-11,108,@,DEN,L 108-111 (OT),265,38,87,.437,31,68,.456,7,19,.368,25,29,.862,108,38,86,.442,27,58,.466,11,28,.393,24,33,.727,111
809,DEN,2015-12-05,108,@,PHI,W 108-105,240,37,81,.457,26,50,.520,11,31,.355,23,38,.605,108,37,74,.500,22,43,.512,15,31,.484,16,26,.615,105
810,SAS,2015-12-05,108,,BOS,W 108-105,240,44,83,.530,39,66,.591,5,17,.294,15,22,.682,108,39,86,.453,27,57,.474,12,29,.414,15,22,.682,105
811,CLE,2015-12-04,108,@,NOP,L 108-114 (OT),265,39,89,.438,29,56,.518,10,33,.303,20,24,.833,108,42,85,.494,33,60,.550,9,25,.360,21,31,.677,114
812,NYK,2015-12-04,108,,BRK,W 108-91,240,39,87,.448,27,60,.450,12,27,.444,18,21,.857,108,39,91,.429,36,80,.450,3,11,.273,10,15,.667,91
813,HOU,2015-12-02,108,,NOP,W 108-101,240,36,87,.414,28,60,.467,8,27,.296,28,39,.718,108,36,88,.409,29,63,.460,7,25,.280,22,25,.880,101
814,LAL,2015-12-02,108,@,WAS,W 108-104,240,41,96,.427,33,71,.465,8,25,.320,18,20,.900,108,37,79,.468,30,58,.517,7,21,.333,23,31,.742,104
815,POR,2015-11-28,108,,LAL,W 108-96,240,38,78,.487,26,48,.542,12,30,.400,20,26,.769,108,36,82,.439,29,59,.492,7,23,.304,17,23,.739,96
816,SAS,2015-11-28,108,,ATL,W 108-88,240,40,85,.471,31,68,.456,9,17,.529,19,20,.950,108,37,87,.425,31,61,.508,6,26,.231,8,13,.615,88
817,HOU,2015-11-18,108,,POR,W 108-103 (OT),265,32,92,.348,18,48,.375,14,44,.318,30,35,.857,108,35,88,.398,26,58,.448,9,30,.300,24,29,.828,103
818,MIL,2015-11-14,108,,CLE,W 108-105 (2OT),290,43,102,.422,37,86,.430,6,16,.375,16,22,.727,108,37,91,.407,23,53,.434,14,38,.368,17,27,.630,105
819,WAS,2015-11-14,108,,ORL,W 108-99,240,39,83,.470,27,54,.500,12,29,.414,18,26,.692,108,38,87,.437,34,69,.493,4,18,.222,19,24,.792,99
820,LAC,2015-11-11,108,@,DAL,L 108-118,240,37,86,.430,25,59,.424,12,27,.444,22,33,.667,108,42,76,.553,31,52,.596,11,24,.458,23,30,.767,118
821,DEN,2015-11-09,108,,POR,W 108-104,240,40,77,.519,33,58,.569,7,19,.368,21,32,.656,108,36,91,.396,26,62,.419,10,29,.345,22,27,.815,104
822,CLE,2015-11-06,108,,PHI,W 108-102,240,45,88,.511,35,62,.565,10,26,.385,8,12,.667,108,41,79,.519,31,56,.554,10,23,.435,10,15,.667,102
823,CHO,2015-11-05,108,@,DAL,W 108-94,240,44,89,.494,38,62,.613,6,27,.222,14,17,.824,108,32,82,.390,26,53,.491,6,29,.207,24,27,.889,94
824,LAC,2015-11-04,108,@,GSW,L 108-112,240,43,88,.489,35,66,.530,8,22,.364,14,22,.636,108,39,85,.459,29,59,.492,10,26,.385,24,31,.774,112
825,POR,2015-11-04,108,@,UTA,W 108-92,240,41,77,.532,30,52,.577,11,25,.440,15,32,.469,108,33,88,.375,28,64,.438,5,24,.208,21,33,.636,92
826,POR,2016-04-13,107,,DEN,W 107-99,240,39,89,.438,28,53,.528,11,36,.306,18,22,.818,107,40,94,.426,33,69,.478,7,25,.280,12,18,.667,99
827,ORL,2016-04-11,107,,MIL,W 107-98,240,41,84,.488,34,61,.557,7,23,.304,18,28,.643,107,41,78,.526,38,63,.603,3,15,.200,13,19,.684,98
828,BOS,2016-04-09,107,@,ATL,L 107-118,240,40,90,.444,29,62,.468,11,28,.393,16,24,.667,107,46,88,.523,29,55,.527,17,33,.515,9,11,.818,118
829,MIA,2016-04-05,107,,DET,W 107-89,240,44,84,.524,35,70,.500,9,14,.643,10,14,.714,107,32,80,.400,27,58,.466,5,22,.227,20,25,.800,89
830,PHI,2016-04-05,107,,NOP,W 107-93,240,40,88,.455,27,54,.500,13,34,.382,14,17,.824,107,37,82,.451,30,64,.469,7,18,.389,12,16,.750,93
831,SAC,2016-04-05,107,,POR,L 107-115,240,41,78,.526,30,56,.536,11,22,.500,14,21,.667,107,40,93,.430,28,62,.452,12,31,.387,23,27,.852,115
832,BOS,2016-04-03,107,@,LAL,W 107-100,240,41,91,.451,33,61,.541,8,30,.267,17,22,.773,107,37,90,.411,31,69,.449,6,21,.286,20,29,.690,100
833,MEM,2016-04-03,107,@,ORL,L 107-119,240,41,89,.461,33,68,.485,8,21,.381,17,26,.654,107,43,90,.478,33,64,.516,10,26,.385,23,29,.793,119
834,CLE,2016-03-31,107,,BRK,W 107-87,240,38,87,.437,26,49,.531,12,38,.316,19,24,.792,107,35,94,.372,31,73,.425,4,21,.190,13,21,.619,87
835,CLE,2016-03-26,107,@,NYK,W 107-93,240,37,83,.446,23,49,.469,14,34,.412,19,25,.760,107,33,79,.418,25,56,.446,8,23,.348,19,28,.679,93
836,CHI,2016-03-23,107,,NYK,L 107-115,240,38,82,.463,23,50,.460,15,32,.469,16,21,.762,107,45,87,.517,31,62,.500,14,25,.560,11,15,.733,115
837,LAL,2016-03-23,107,@,PHO,L 107-119,240,39,93,.419,32,66,.485,7,27,.259,22,26,.846,107,47,93,.505,34,65,.523,13,28,.464,12,20,.600,119
838,LAL,2016-03-22,107,,MEM,W 107-100,240,39,77,.506,33,58,.569,6,19,.316,23,24,.958,107,40,80,.500,36,65,.554,4,15,.267,16,23,.696,100
839,HOU,2016-03-22,107,@,OKC,L 107-111,240,40,92,.435,27,55,.491,13,37,.351,14,17,.824,107,41,91,.451,33,56,.589,8,35,.229,21,29,.724,111
840,BOS,2016-03-21,107,,ORL,W 107-96,240,40,85,.471,33,63,.524,7,22,.318,20,24,.833,107,39,93,.419,34,74,.459,5,19,.263,13,19,.684,96
841,CHO,2016-03-16,107,,ORL,W 107-99,240,40,100,.400,29,63,.460,11,37,.297,16,21,.762,107,35,83,.422,24,58,.414,11,25,.440,18,21,.857,99
842,TOR,2016-03-15,107,@,MIL,W 107-89,240,39,83,.470,25,53,.472,14,30,.467,15,17,.882,107,34,77,.442,32,64,.500,2,13,.154,19,26,.731,89
843,TOR,2016-03-14,107,,CHI,L 107-109,240,37,83,.446,31,63,.492,6,20,.300,27,31,.871,107,41,83,.494,32,58,.552,9,25,.360,18,20,.900,109
844,NOP,2016-03-14,107,@,GSW,L 107-125,240,35,93,.376,28,68,.412,7,25,.280,30,34,.882,107,47,81,.580,35,56,.625,12,25,.480,19,23,.826,125
845,DAL,2016-03-14,107,@,CHO,W 107-96,240,42,87,.483,33,57,.579,9,30,.300,14,18,.778,107,32,76,.421,22,46,.478,10,30,.333,22,34,.647,96
846,PHO,2016-03-14,107,,MIN,W 107-104,240,40,95,.421,29,60,.483,11,35,.314,16,20,.800,107,37,84,.440,33,68,.485,4,16,.250,26,30,.867,104
847,ORL,2016-03-11,107,@,SAC,W 107-100,240,41,79,.519,37,64,.578,4,15,.267,21,34,.618,107,35,88,.398,27,63,.429,8,25,.320,22,25,.880,100
848,LAL,2016-03-08,107,,ORL,W 107-98,240,40,81,.494,31,54,.574,9,27,.333,18,23,.783,107,37,76,.487,32,57,.561,5,19,.263,19,27,.704,98
849,TOR,2016-03-06,107,,HOU,L 107-113,240,37,77,.481,25,44,.568,12,33,.364,21,27,.778,107,38,78,.487,25,49,.510,13,29,.448,24,37,.649,113
850,ATL,2016-03-05,107,@,LAC,W 107-97,240,40,89,.449,30,62,.484,10,27,.370,17,20,.850,107,34,79,.430,22,47,.468,12,32,.375,17,28,.607,97
851,LAL,2016-03-02,107,@,DEN,L 107-117,240,35,79,.443,24,48,.500,11,31,.355,26,32,.813,107,38,78,.487,26,55,.473,12,23,.522,29,38,.763,117
852,LAL,2016-03-01,107,,BRK,W 107-101,240,41,83,.494,30,57,.526,11,26,.423,14,21,.667,107,39,89,.438,34,71,.479,5,18,.278,18,27,.667,101
853,SAC,2016-02-26,107,,LAC,L 107-117,240,34,78,.436,22,54,.407,12,24,.500,27,37,.730,107,43,89,.483,34,60,.567,9,29,.310,22,26,.846,117
854,MIL,2016-02-25,107,@,BOS,L 107-112,240,42,87,.483,38,72,.528,4,15,.267,19,25,.760,107,41,84,.488,36,61,.590,5,23,.217,25,33,.758,112
855,LAC,2016-02-05,107,@,ORL,W 107-93,240,40,74,.541,32,47,.681,8,27,.296,19,23,.826,107,34,81,.420,30,61,.492,4,20,.200,21,28,.750,93
856,CHI,2016-02-03,107,@,SAC,W 107-102,240,40,88,.455,29,67,.433,11,21,.524,16,21,.762,107,42,88,.477,36,68,.529,6,20,.300,12,19,.632,102
857,POR,2016-02-02,107,,MIL,W 107-95,240,39,85,.459,28,54,.519,11,31,.355,18,25,.720,107,38,86,.442,33,72,.458,5,14,.357,14,24,.583,95
858,SAS,2016-02-01,107,,ORL,W 107-92,240,40,78,.513,31,54,.574,9,24,.375,18,21,.857,107,39,96,.406,34,79,.430,5,17,.294,9,11,.818,92
859,DET,2016-01-30,107,@,TOR,L 107-111,240,39,87,.448,30,58,.517,9,29,.310,20,34,.588,107,36,78,.462,32,64,.500,4,14,.286,35,47,.745,111
860,MIA,2016-01-29,107,@,MIL,W 107-103,240,37,74,.500,30,56,.536,7,18,.389,26,32,.813,107,38,80,.475,36,68,.529,2,12,.167,25,28,.893,103
861,DAL,2016-01-27,107,@,GSW,L 107-127,240,44,87,.506,33,56,.589,11,31,.355,8,12,.667,107,47,81,.580,33,52,.635,14,29,.483,19,21,.905,127
862,MIL,2016-01-26,107,,ORL,W 107-100,240,38,77,.494,33,64,.516,5,13,.385,26,31,.839,107,33,80,.413,20,56,.357,13,24,.542,21,29,.724,100
863,MIN,2016-01-25,107,@,CLE,L 107-114,240,41,84,.488,37,68,.544,4,16,.250,21,23,.913,107,45,89,.506,34,58,.586,11,31,.355,13,20,.650,114
864,CHO,2016-01-15,107,@,NOP,L 107-109,240,42,86,.488,28,51,.549,14,35,.400,9,12,.750,107,43,87,.494,31,60,.517,12,27,.444,11,13,.846,109
865,CHO,2016-01-13,107,,ATL,W 107-84,240,36,82,.439,23,43,.535,13,39,.333,22,26,.846,107,30,81,.370,23,56,.411,7,25,.280,17,21,.810,84
866,HOU,2016-01-13,107,,MIN,W 107-104,240,37,75,.493,30,45,.667,7,30,.233,26,38,.684,107,36,78,.462,28,61,.459,8,17,.471,24,30,.800,104
867,DAL,2016-01-12,107,,CLE,L 107-110 (OT),265,39,79,.494,28,51,.549,11,28,.393,18,22,.818,107,40,97,.412,23,53,.434,17,44,.386,13,16,.813,110
868,HOU,2016-01-12,107,@,MEM,W 107-91,240,33,77,.429,15,42,.357,18,35,.514,23,27,.852,107,33,72,.458,26,54,.481,7,18,.389,18,24,.750,91
869,HOU,2016-01-10,107,,IND,W 107-103 (OT),265,39,89,.438,25,51,.490,14,38,.368,15,23,.652,107,43,90,.478,34,59,.576,9,31,.290,8,10,.800,103
870,NYK,2016-01-05,107,@,ATL,W 107-101,240,40,84,.476,35,66,.530,5,18,.278,22,24,.917,107,37,87,.425,22,48,.458,15,39,.385,12,19,.632,101
871,ATL,2015-12-23,107,,DET,W 107-100,240,43,89,.483,37,69,.536,6,20,.300,15,20,.750,107,38,89,.427,31,68,.456,7,21,.333,17,33,.515,100
872,DEN,2015-12-22,107,,LAL,L 107-111,240,41,90,.456,32,65,.492,9,25,.360,16,19,.842,107,40,84,.476,33,58,.569,7,26,.269,24,32,.750,111
873,ORL,2015-12-21,107,@,NYK,W 107-99,240,44,86,.512,34,64,.531,10,22,.455,9,11,.818,107,39,76,.513,32,52,.615,7,24,.292,14,16,.875,99
874,HOU,2015-12-19,107,,LAC,W 107-97,240,34,76,.447,26,51,.510,8,25,.320,31,49,.633,107,34,86,.395,23,48,.479,11,38,.289,18,29,.621,97
875,NYK,2015-12-19,107,,CHI,W 107-91,240,41,82,.500,36,62,.581,5,20,.250,20,24,.833,107,37,94,.394,32,73,.438,5,21,.238,12,17,.706,91
876,LAC,2015-12-18,107,@,SAS,L 107-115,240,36,72,.500,26,48,.542,10,24,.417,25,40,.625,107,43,87,.494,33,68,.485,10,19,.526,19,24,.792,115
877,NYK,2015-12-18,107,@,PHI,W 107-97,240,40,85,.471,34,66,.515,6,19,.316,21,28,.750,107,37,77,.481,31,53,.585,6,24,.250,17,30,.567,97
878,HOU,2015-12-17,107,@,LAL,W 107-87,240,34,88,.386,22,57,.386,12,31,.387,27,42,.643,107,36,84,.429,31,60,.517,5,24,.208,10,18,.556,87
879,NYK,2015-12-16,107,,MIN,W 107-102,240,37,85,.435,29,64,.453,8,21,.381,25,30,.833,107,42,101,.416,38,80,.475,4,21,.190,14,14,1.000,102
880,IND,2015-12-16,107,,DAL,W 107-81,240,43,89,.483,32,60,.533,11,29,.379,10,17,.588,107,33,90,.367,25,57,.439,8,33,.242,7,10,.700,81
881,SAC,2015-12-15,107,,HOU,W 107-97,240,38,75,.507,27,51,.529,11,24,.458,20,29,.690,107,34,82,.415,22,43,.512,12,39,.308,17,23,.739,97
882,NOP,2015-12-11,107,,WAS,W 107-105,240,39,79,.494,23,52,.442,16,27,.593,13,18,.722,107,40,80,.500,28,53,.528,12,27,.444,13,21,.619,105
883,DET,2015-12-11,107,@,PHI,W 107-95,240,43,93,.462,33,66,.500,10,27,.370,11,16,.688,107,36,80,.450,30,62,.484,6,18,.333,17,24,.708,95
884,OKC,2015-12-10,107,,ATL,W 107-94,240,39,80,.488,30,63,.476,9,17,.529,20,26,.769,107,35,78,.449,25,50,.500,10,28,.357,14,23,.609,94
885,PHO,2015-12-09,107,,ORL,W 107-104,240,41,80,.513,35,56,.625,6,24,.250,19,27,.704,107,40,85,.471,28,60,.467,12,25,.480,12,16,.750,104
886,PHO,2015-11-29,107,@,TOR,W 107-102,240,40,94,.426,29,67,.433,11,27,.407,16,20,.800,107,38,86,.442,26,57,.456,12,29,.414,14,17,.824,102
887,LAC,2015-11-29,107,,MIN,W 107-99,240,39,75,.520,31,53,.585,8,22,.364,21,33,.636,107,37,82,.451,29,66,.439,8,16,.500,17,21,.810,99
888,IND,2015-11-29,107,@,LAL,W 107-103,240,34,83,.410,25,56,.446,9,27,.333,30,37,.811,107,38,99,.384,27,66,.409,11,33,.333,16,22,.727,103
889,POR,2015-11-22,107,@,LAL,W 107-93,240,43,87,.494,35,62,.565,8,25,.320,13,17,.765,107,32,88,.364,26,70,.371,6,18,.333,23,27,.852,93
890,NYK,2015-11-21,107,@,HOU,W 107-102,240,34,80,.425,22,55,.400,12,25,.480,27,34,.794,107,35,81,.432,23,53,.434,12,28,.429,20,28,.714,102
891,DEN,2015-11-20,107,,PHO,L 107-114,240,41,90,.456,36,66,.545,5,24,.208,20,26,.769,107,40,79,.506,25,52,.481,15,27,.556,19,25,.760,114
892,SAC,2015-11-15,107,,TOR,W 107-101,240,39,76,.513,29,51,.569,10,25,.400,19,24,.792,107,38,87,.437,23,56,.411,15,31,.484,10,14,.714,101
893,GSW,2015-11-14,107,,BRK,W 107-99 (OT),265,43,97,.443,31,63,.492,12,34,.353,9,10,.900,107,41,98,.418,39,80,.488,2,18,.111,15,16,.938,99
894,DEN,2015-11-13,107,,HOU,W 107-98,240,37,81,.457,28,61,.459,9,20,.450,24,32,.750,107,33,77,.429,24,48,.500,9,29,.310,23,31,.742,98
895,IND,2015-11-13,107,,MIN,W 107-103,240,41,86,.477,31,61,.508,10,25,.400,15,23,.652,107,42,83,.506,35,63,.556,7,20,.350,12,13,.923,103
896,ATL,2015-11-09,107,,MIN,L 107-117,240,44,86,.512,31,55,.564,13,31,.419,6,7,.857,107,46,80,.575,39,65,.600,7,15,.467,18,22,.818,117
897,DAL,2015-11-07,107,,NOP,W 107-98,240,40,84,.476,31,60,.517,9,24,.375,18,22,.818,107,39,86,.453,30,58,.517,9,28,.321,11,13,.846,98
898,CLE,2015-11-02,107,@,PHI,W 107-100,240,42,81,.519,34,59,.576,8,22,.364,15,20,.750,107,38,85,.447,31,61,.508,7,24,.292,17,23,.739,100
899,MIN,2016-04-09,106,@,POR,W 106-105,240,41,84,.488,36,71,.507,5,13,.385,19,25,.760,106,40,80,.500,31,56,.554,9,24,.375,16,18,.889,105
900,MIA,2016-04-07,106,,CHI,W 106-98,240,44,92,.478,40,78,.513,4,14,.286,14,17,.824,106,35,78,.449,32,64,.500,3,14,.214,25,28,.893,98
901,NOP,2016-04-03,106,@,BRK,W 106-87,240,42,76,.553,34,54,.630,8,22,.364,14,23,.609,106,33,85,.388,25,62,.403,8,23,.348,13,21,.619,87
902,DEN,2016-04-02,106,,SAC,L 106-115,240,40,92,.435,31,63,.492,9,29,.310,17,24,.708,106,41,88,.466,33,67,.493,8,21,.381,25,31,.806,115
903,SAC,2016-04-01,106,,MIA,L 106-112,240,38,87,.437,31,66,.470,7,21,.333,23,29,.793,106,42,82,.512,30,60,.500,12,22,.545,16,17,.941,112
904,WAS,2016-04-01,106,@,PHO,W 106-99,240,38,86,.442,28,60,.467,10,26,.385,20,25,.800,106,36,93,.387,29,70,.414,7,23,.304,20,26,.769,99
905,GSW,2016-04-01,106,,BOS,L 106-109,240,38,83,.458,18,40,.450,20,43,.465,10,13,.769,106,41,87,.471,33,64,.516,8,23,.348,19,30,.633,109
906,HOU,2016-03-29,106,@,CLE,W 106-100,240,38,79,.481,29,54,.537,9,25,.360,21,42,.500,106,31,86,.360,17,46,.370,14,40,.350,24,28,.857,100
907,NYK,2016-03-24,106,,CHI,W 106-94,240,39,76,.513,26,46,.565,13,30,.433,15,16,.938,106,37,89,.416,31,64,.484,6,25,.240,14,18,.778,94
908,MIA,2016-03-17,106,,CHO,L 106-109,240,40,75,.533,33,58,.569,7,17,.412,19,24,.792,106,40,86,.465,27,60,.450,13,26,.500,16,21,.762,109
909,HOU,2016-03-16,106,,LAC,L 106-122,240,40,82,.488,31,57,.544,9,25,.360,17,24,.708,106,43,76,.566,31,46,.674,12,30,.400,24,32,.750,122
910,SAC,2016-03-15,106,@,LAL,W 106-98,240,38,79,.481,34,61,.557,4,18,.222,26,33,.788,106,37,84,.440,32,58,.552,5,26,.192,19,26,.731,98
911,MEM,2016-03-07,106,@,CLE,W 106-103,240,41,86,.477,35,66,.530,6,20,.300,18,22,.818,106,36,80,.450,29,51,.569,7,29,.241,24,29,.828,103
912,UTA,2016-03-05,106,@,NOP,W 106-94,240,37,78,.474,31,58,.534,6,20,.300,26,27,.963,106,38,92,.413,29,73,.397,9,19,.474,9,11,.818,94
913,ATL,2016-03-04,106,@,LAL,W 106-77,240,37,68,.544,24,40,.600,13,28,.464,19,26,.731,106,29,85,.341,24,58,.414,5,27,.185,14,20,.700,77
914,OKC,2016-03-03,106,@,GSW,L 106-121,240,40,86,.465,36,66,.545,4,20,.200,22,27,.815,106,47,87,.540,36,53,.679,11,34,.324,16,21,.762,121
915,MEM,2016-02-27,106,@,PHO,L 106-111,240,32,80,.400,26,60,.433,6,20,.300,36,42,.857,106,37,80,.463,25,48,.521,12,32,.375,25,35,.714,111
916,PHO,2016-02-25,106,,BRK,L 106-116,240,42,98,.429,33,71,.465,9,27,.333,13,23,.565,106,37,75,.493,29,57,.509,8,18,.444,34,42,.810,116
917,DET,2016-02-21,106,,NOP,L 106-111,240,37,89,.416,25,56,.446,12,33,.364,20,32,.625,106,41,86,.477,37,66,.561,4,20,.200,25,29,.862,111
918,TOR,2016-02-19,106,@,CHI,L 106-116,240,38,88,.432,33,70,.471,5,18,.278,25,34,.735,106,48,93,.516,41,77,.532,7,16,.438,13,20,.650,116
919,CLE,2016-02-18,106,,CHI,W 106-95,240,42,91,.462,35,67,.522,7,24,.292,15,17,.882,106,37,93,.398,29,72,.403,8,21,.381,13,22,.591,95
920,MEM,2016-02-08,106,,POR,L 106-112 (OT),265,43,86,.500,36,67,.537,7,19,.368,13,19,.684,106,44,89,.494,34,60,.567,10,29,.345,14,20,.700,112
921,PHO,2016-02-08,106,,OKC,L 106-122,240,37,73,.507,36,62,.581,1,11,.091,31,39,.795,106,42,85,.494,27,52,.519,15,33,.455,23,30,.767,122
922,SAS,2016-02-06,106,,LAL,W 106-102,240,39,88,.443,31,64,.484,8,24,.333,20,25,.800,106,34,86,.395,24,56,.429,10,30,.333,24,27,.889,102
923,WAS,2016-02-05,106,,PHI,W 106-94,240,44,84,.524,38,62,.613,6,22,.273,12,20,.600,106,37,87,.425,28,61,.459,9,26,.346,11,14,.786,94
924,CHO,2016-02-03,106,,CLE,W 106-97,240,39,79,.494,30,52,.577,9,27,.333,19,23,.826,106,38,83,.458,28,55,.509,10,28,.357,11,14,.786,97
925,IND,2016-02-01,106,,CLE,L 106-111 (OT),265,43,101,.426,35,74,.473,8,27,.296,12,14,.857,106,44,88,.500,37,66,.561,7,22,.318,16,23,.696,111
926,DET,2016-01-29,106,,CLE,L 106-114,240,40,84,.476,33,61,.541,7,23,.304,19,26,.731,106,39,83,.470,30,60,.500,9,23,.391,27,29,.931,114
927,TOR,2016-01-26,106,,WAS,W 106-89,240,35,79,.443,24,50,.480,11,29,.379,25,32,.781,106,32,78,.410,28,63,.444,4,15,.267,21,28,.750,89
928,OKC,2016-01-24,106,@,BRK,L 106-116,240,43,93,.462,35,67,.522,8,26,.308,12,19,.632,106,45,94,.479,37,77,.481,8,17,.471,18,25,.720,116
929,MIN,2016-01-23,106,,MEM,W 106-101,240,34,68,.500,29,51,.569,5,17,.294,33,36,.917,106,37,79,.468,28,60,.467,9,19,.474,18,22,.818,101
930,DAL,2016-01-22,106,,OKC,L 106-109,240,40,87,.460,30,54,.556,10,33,.303,16,18,.889,106,45,91,.495,37,61,.607,8,30,.267,11,15,.733,109
931,DAL,2016-01-20,106,,MIN,W 106-94 (OT),265,42,97,.433,37,72,.514,5,25,.200,17,22,.773,106,40,91,.440,35,68,.515,5,23,.217,9,11,.818,94
932,WAS,2016-01-20,106,,MIA,W 106-87,240,45,86,.523,40,70,.571,5,16,.313,11,13,.846,106,33,68,.485,26,53,.491,7,15,.467,14,18,.778,87
933,TOR,2016-01-14,106,@,ORL,W 106-103 (OT),265,37,90,.411,29,66,.439,8,24,.333,24,31,.774,106,44,97,.454,35,74,.473,9,23,.391,6,8,.750,103
934,WAS,2016-01-13,106,,MIL,W 106-101,240,38,84,.452,26,57,.456,12,27,.444,18,24,.750,106,38,72,.528,37,64,.578,1,8,.125,24,34,.706,101
935,MIL,2016-01-12,106,,CHI,W 106-101,240,43,93,.462,40,80,.500,3,13,.231,17,28,.607,106,35,85,.412,23,56,.411,12,29,.414,19,24,.792,101
936,SAS,2016-01-11,106,@,BRK,W 106-79,240,44,82,.537,40,69,.580,4,13,.308,14,19,.737,106,33,73,.452,31,61,.508,2,12,.167,11,13,.846,79
937,MIL,2016-01-05,106,@,CHI,L 106-117,240,46,102,.451,40,86,.465,6,16,.375,8,14,.571,106,46,83,.554,41,64,.641,5,19,.263,20,20,1.000,117
938,DEN,2016-01-03,106,,POR,L 106-112,240,34,80,.425,27,58,.466,7,22,.318,31,48,.646,106,40,78,.513,30,55,.545,10,23,.435,22,32,.688,112
939,MIA,2016-01-01,106,,DAL,W 106-82,240,46,82,.561,38,64,.594,8,18,.444,6,9,.667,106,32,88,.364,25,57,.439,7,31,.226,11,14,.786,82
940,PHO,2015-12-31,106,@,OKC,L 106-110,240,43,82,.524,35,62,.565,8,20,.400,12,13,.923,106,42,80,.525,35,59,.593,7,21,.333,19,24,.792,110
941,IND,2015-12-23,106,,SAC,L 106-108,240,41,89,.461,29,57,.509,12,32,.375,12,20,.600,106,46,89,.517,42,66,.636,4,23,.174,12,16,.750,108
942,SAS,2015-12-21,106,,IND,W 106-92,240,46,89,.517,40,69,.580,6,20,.300,8,9,.889,106,38,90,.422,31,71,.437,7,19,.368,9,15,.600,92
943,ATL,2015-12-21,106,,POR,W 106-97,240,37,77,.481,28,48,.583,9,29,.310,23,28,.821,106,38,81,.469,33,57,.579,5,24,.208,16,22,.727,97
944,OKC,2015-12-16,106,,POR,W 106-90,240,38,79,.481,36,65,.554,2,14,.143,28,37,.757,106,32,92,.348,21,66,.318,11,26,.423,15,18,.833,90
945,PHI,2015-12-16,106,@,ATL,L 106-127,240,39,75,.520,27,49,.551,12,26,.462,16,24,.667,106,48,78,.615,38,57,.667,10,21,.476,21,24,.875,127
946,IND,2015-12-14,106,,TOR,W 106-90,240,41,86,.477,31,64,.484,10,22,.455,14,16,.875,106,29,79,.367,19,51,.373,10,28,.357,22,26,.846,90
947,POR,2015-12-11,106,@,PHO,W 106-96,240,45,96,.469,33,62,.532,12,34,.353,4,7,.571,106,36,83,.434,23,48,.479,13,35,.371,11,18,.611,96
948,UTA,2015-12-09,106,,NYK,W 106-85,240,39,80,.488,30,59,.508,9,21,.429,19,23,.826,106,31,78,.397,23,57,.404,8,21,.381,15,27,.556,85
949,UTA,2015-12-08,106,@,SAC,L 106-114,240,38,92,.413,23,56,.411,15,36,.417,15,22,.682,106,43,77,.558,33,49,.673,10,28,.357,18,24,.750,114
950,MIN,2015-12-07,106,,LAC,L 106-110,240,36,82,.439,29,64,.453,7,18,.389,27,35,.771,106,38,86,.442,30,61,.492,8,25,.320,26,29,.897,110
951,MIL,2015-12-05,106,,NYK,W 106-91,240,44,89,.494,42,85,.494,2,4,.500,16,24,.667,106,32,76,.421,26,51,.510,6,25,.240,21,28,.750,91
952,PHO,2015-12-04,106,@,WAS,L 106-109,240,43,84,.512,33,61,.541,10,23,.435,10,16,.625,106,40,82,.488,30,56,.536,10,26,.385,19,25,.760,109
953,DEN,2015-12-03,106,@,TOR,W 106-105,240,38,81,.469,26,54,.481,12,27,.444,18,18,1.000,106,39,92,.424,31,65,.477,8,27,.296,19,22,.864,105
954,GSW,2015-11-30,106,@,UTA,W 106-103,240,40,82,.488,26,53,.491,14,29,.483,12,15,.800,106,40,89,.449,34,70,.486,6,19,.316,17,22,.773,103
955,ATL,2015-11-30,106,,OKC,W 106-100,240,39,90,.433,29,62,.468,10,28,.357,18,20,.900,106,37,93,.398,30,74,.405,7,19,.368,19,22,.864,100
956,WAS,2015-11-24,106,,IND,L 106-123,240,38,83,.458,25,50,.500,13,33,.394,17,24,.708,106,44,80,.550,25,54,.463,19,26,.731,16,23,.696,123
957,GSW,2015-11-20,106,,CHI,W 106-94,240,39,79,.494,29,50,.580,10,29,.345,18,24,.750,106,35,88,.398,28,66,.424,7,22,.318,17,23,.739,94
958,DAL,2015-11-18,106,@,BOS,W 106-102,240,37,72,.514,30,52,.577,7,20,.350,25,35,.714,106,38,92,.413,30,66,.455,8,26,.308,18,24,.750,102
959,MIN,2015-11-15,106,,MEM,L 106-114,240,41,82,.500,36,66,.545,5,16,.313,19,21,.905,106,40,71,.563,31,54,.574,9,17,.529,25,27,.926,114
960,CHO,2015-11-15,106,,POR,W 106-94,240,41,83,.494,32,52,.615,9,31,.290,15,19,.789,106,35,89,.393,30,68,.441,5,21,.238,19,21,.905,94
961,BOS,2015-11-13,106,,ATL,W 106-93,240,42,103,.408,31,70,.443,11,33,.333,11,12,.917,106,36,76,.474,30,56,.536,6,20,.300,15,20,.750,93
962,ATL,2015-11-11,106,,NOP,W 106-98,240,42,86,.488,32,60,.533,10,26,.385,12,16,.750,106,37,83,.446,23,54,.426,14,29,.483,10,15,.667,98
963,BRK,2015-11-11,106,@,HOU,W 106-98,240,42,98,.429,34,81,.420,8,17,.471,14,17,.824,106,42,98,.429,34,64,.531,8,34,.235,6,12,.500,98
964,SAS,2015-11-09,106,@,SAC,W 106-88,240,46,87,.529,40,64,.625,6,23,.261,8,11,.727,106,34,84,.405,27,65,.415,7,19,.368,13,19,.684,88
965,POR,2015-11-02,106,@,MIN,W 106-101,240,41,89,.461,32,59,.542,9,30,.300,15,20,.750,106,34,79,.430,31,66,.470,3,13,.231,30,39,.769,101
966,TOR,2015-11-01,106,,MIL,W 106-87,240,41,90,.456,30,65,.462,11,25,.440,13,20,.650,106,29,69,.420,24,50,.480,5,19,.263,24,24,1.000,87
967,CLE,2015-10-28,106,@,MEM,W 106-76,240,41,84,.488,28,55,.509,13,29,.448,11,17,.647,106,29,82,.354,27,66,.409,2,16,.125,16,22,.727,76
968,TOR,2015-10-28,106,,IND,W 106-99,240,36,80,.450,29,62,.468,7,18,.389,27,39,.692,106,32,86,.372,23,63,.365,9,23,.391,26,31,.839,99
969,SAS,2015-10-28,106,@,OKC,L 106-112,240,45,93,.484,40,78,.513,5,15,.333,11,13,.846,106,42,86,.488,35,67,.522,7,19,.368,21,22,.955,112
970,DET,2015-10-27,106,@,ATL,W 106-94,240,37,96,.385,25,67,.373,12,29,.414,20,26,.769,106,37,82,.451,29,55,.527,8,27,.296,12,15,.800,94
971,PHI,2016-04-13,105,@,CHI,L 105-115,240,37,81,.457,20,46,.435,17,35,.486,14,18,.778,105,39,83,.470,24,59,.407,15,24,.625,22,27,.815,115
972,LAC,2016-04-13,105,@,PHO,L 105-114,240,43,96,.448,34,65,.523,9,31,.290,10,12,.833,105,45,99,.455,38,73,.521,7,26,.269,17,22,.773,114
973,MIN,2016-04-11,105,,HOU,L 105-129,240,38,83,.458,33,62,.532,5,21,.238,24,33,.727,105,48,86,.558,33,56,.589,15,30,.500,18,26,.692,129
974,SAC,2016-04-11,105,@,PHO,W 105-101,240,41,83,.494,35,66,.530,6,17,.353,17,28,.607,105,41,100,.410,36,78,.462,5,22,.227,14,17,.824,101
975,BRK,2016-04-10,105,@,IND,L 105-129,240,35,91,.385,21,54,.389,14,37,.378,21,26,.808,105,48,86,.558,37,59,.627,11,27,.407,22,27,.815,129
976,CHI,2016-04-09,105,,CLE,W 105-102,240,40,89,.449,32,65,.492,8,24,.333,17,21,.810,105,36,83,.434,17,43,.395,19,40,.475,11,18,.611,102
977,POR,2016-04-09,105,,MIN,L 105-106,240,40,80,.500,31,56,.554,9,24,.375,16,18,.889,105,41,84,.488,36,71,.507,5,13,.385,19,25,.760,106
978,MIN,2016-04-07,105,@,SAC,W 105-97,240,36,80,.450,25,59,.424,11,21,.524,22,31,.710,105,36,85,.424,30,68,.441,6,17,.353,19,21,.905,97
979,NYK,2016-04-01,105,,BRK,W 105-91,240,42,84,.500,28,61,.459,14,23,.609,7,7,1.000,105,36,101,.356,32,77,.416,4,24,.167,15,20,.750,91
980,MIL,2016-03-30,105,,PHO,W 105-94,240,37,77,.481,31,62,.500,6,15,.400,25,34,.735,105,38,84,.452,33,60,.550,5,24,.208,13,17,.765,94
981,TOR,2016-03-30,105,,ATL,W 105-97,240,36,80,.450,25,57,.439,11,23,.478,22,28,.786,105,37,83,.446,23,50,.460,14,33,.424,9,13,.692,97
982,MEM,2016-03-30,105,,DEN,L 105-109,240,41,95,.432,35,76,.461,6,19,.316,17,27,.630,105,38,78,.487,25,49,.510,13,29,.448,20,24,.833,109
983,BRK,2016-03-29,105,@,ORL,L 105-139,240,37,79,.468,32,65,.492,5,14,.357,26,39,.667,105,56,91,.615,42,64,.656,14,27,.519,13,19,.684,139
984,POR,2016-03-28,105,,SAC,W 105-93,240,38,80,.475,24,51,.471,14,29,.483,15,18,.833,105,37,89,.416,30,74,.405,7,15,.467,12,19,.632,93
985,PHI,2016-03-27,105,@,GSW,L 105-117,240,42,90,.467,32,60,.533,10,30,.333,11,12,.917,105,44,83,.530,30,50,.600,14,33,.424,15,20,.750,117
986,LAC,2016-03-27,105,,DEN,W 105-90,240,38,80,.475,28,52,.538,10,28,.357,19,26,.731,105,37,94,.394,30,65,.462,7,29,.241,9,13,.692,90
987,PHI,2016-03-26,105,@,POR,L 105-108,240,39,93,.419,29,55,.527,10,38,.263,17,24,.708,105,38,91,.418,30,66,.455,8,25,.320,24,30,.800,108
988,CHO,2016-03-25,105,@,DET,L 105-112,240,37,93,.398,23,63,.365,14,30,.467,17,22,.773,105,42,91,.462,34,61,.557,8,30,.267,20,26,.769,112
989,LAL,2016-03-25,105,,DEN,L 105-116,240,37,85,.435,27,62,.435,10,23,.435,21,26,.808,105,45,94,.479,35,68,.515,10,26,.385,16,24,.667,116
990,CHO,2016-03-22,105,@,BRK,W 105-100,240,39,82,.476,29,54,.537,10,28,.357,17,21,.810,105,34,74,.459,26,56,.464,8,18,.444,24,27,.889,100
991,LAC,2016-03-20,105,@,NOP,L 105-109,240,33,82,.402,23,43,.535,10,39,.256,29,42,.690,105,35,71,.493,28,50,.560,7,21,.333,32,40,.800,109
992,PHI,2016-03-20,105,,BOS,L 105-120,240,39,92,.424,31,71,.437,8,21,.381,19,27,.704,105,46,94,.489,36,69,.522,10,25,.400,18,21,.857,120
993,TOR,2016-03-20,105,,ORL,W 105-100,240,35,81,.432,29,61,.475,6,20,.300,29,45,.644,105,40,83,.482,32,61,.525,8,22,.364,12,18,.667,100
994,TOR,2016-03-18,105,,BOS,W 105-91,240,37,77,.481,24,49,.490,13,28,.464,18,25,.720,105,36,82,.439,27,61,.443,9,21,.429,10,12,.833,91
995,DAL,2016-03-12,105,,IND,L 105-112,240,41,85,.482,33,63,.524,8,22,.364,15,18,.833,105,38,81,.469,29,53,.547,9,28,.321,27,29,.931,112
996,BOS,2016-03-04,105,,NYK,W 105-104,240,41,90,.456,37,70,.529,4,20,.200,19,25,.760,105,42,92,.457,33,69,.478,9,23,.391,11,14,.786,104
997,ATL,2016-03-01,105,@,GSW,L 105-109 (OT),265,37,80,.463,25,47,.532,12,33,.364,19,24,.792,105,41,103,.398,29,67,.433,12,36,.333,15,17,.882,109
998,LAC,2016-02-29,105,,BRK,W 105-95,240,41,83,.494,32,60,.533,9,23,.391,14,16,.875,105,32,77,.416,24,58,.414,8,19,.421,23,33,.697,95
999,POR,2016-02-25,105,,HOU,L 105-119,240,37,80,.463,24,45,.533,13,35,.371,18,22,.818,105,44,82,.537,34,53,.642,10,29,.345,21,35,.600,119
1000,MIN,2016-02-24,105,@,TOR,L 105-114,240,37,74,.500,31,64,.484,6,10,.600,25,33,.758,105,41,85,.482,31,59,.525,10,26,.385,22,26,.846,114
1001,NYK,2016-02-24,105,@,IND,L 105-108,240,35,77,.455,22,51,.431,13,26,.500,22,25,.880,105,46,91,.505,43,76,.566,3,15,.200,13,16,.813,108
1002,IND,2016-02-21,105,@,ORL,W 105-102,240,41,82,.500,32,58,.552,9,24,.375,14,21,.667,105,38,91,.418,31,66,.470,7,25,.280,19,29,.655,102
1003,GSW,2016-02-19,105,@,POR,L 105-137,240,36,92,.391,24,58,.414,12,34,.353,21,28,.750,105,52,97,.536,35,67,.522,17,30,.567,16,23,.696,137
1004,LAC,2016-02-18,105,,SAS,W 105-86,240,39,78,.500,27,53,.509,12,25,.480,15,20,.750,105,35,83,.422,31,66,.470,4,17,.235,12,15,.800,86
1005,BRK,2016-02-08,105,,DEN,W 105-104,240,42,81,.519,33,62,.532,9,19,.474,12,15,.800,105,42,90,.467,33,65,.508,9,25,.360,11,13,.846,104
1006,CHI,2016-02-06,105,@,MIN,L 105-112,240,40,85,.471,32,65,.492,8,20,.400,17,19,.895,105,45,87,.517,44,75,.587,1,12,.083,21,22,.955,112
1007,PHO,2016-02-04,105,,HOU,L 105-111,240,32,83,.386,21,54,.389,11,29,.379,30,32,.938,105,37,86,.430,22,44,.500,15,42,.357,22,32,.688,111
1008,NYK,2016-02-04,105,@,DET,L 105-111,240,36,84,.429,30,62,.484,6,22,.273,27,34,.794,105,40,79,.506,31,62,.500,9,17,.529,22,33,.667,111
1009,DET,2016-02-01,105,@,BRK,W 105-100,240,42,98,.429,32,68,.471,10,30,.333,11,16,.688,105,40,82,.488,33,66,.500,7,16,.438,13,15,.867,100
1010,UTA,2016-02-01,105,,CHI,W 105-96 (OT),265,38,85,.447,31,67,.463,7,18,.389,22,33,.667,105,39,90,.433,34,69,.493,5,21,.238,13,20,.650,96
1011,MIA,2016-01-31,105,,ATL,W 105-87,240,39,81,.481,34,61,.557,5,20,.250,22,26,.846,105,27,70,.386,22,48,.458,5,22,.227,28,32,.875,87
1012,NOP,2016-01-30,105,,BRK,W 105-103,240,43,93,.462,32,66,.485,11,27,.407,8,10,.800,105,40,84,.476,31,64,.484,9,20,.450,14,23,.609,103
1013,PHI,2016-01-30,105,,GSW,L 105-108,240,42,92,.457,32,63,.508,10,29,.345,11,21,.524,105,47,95,.495,34,65,.523,13,30,.433,1,2,.500,108
1014,DEN,2016-01-30,105,@,IND,L 105-109 (OT),265,40,87,.460,36,69,.522,4,18,.222,21,25,.840,105,44,100,.440,35,73,.479,9,27,.333,12,16,.750,109
1015,LAC,2016-01-29,105,,LAL,W 105-93,240,40,81,.494,32,55,.582,8,26,.308,17,24,.708,105,34,78,.436,29,65,.446,5,13,.385,20,25,.800,93
1016,SAC,2016-01-28,105,@,NOP,L 105-114,240,40,89,.449,30,61,.492,10,28,.357,15,20,.750,105,43,98,.439,33,72,.458,10,26,.385,18,24,.750,114
1017,DEN,2016-01-25,105,,ATL,L 105-119,240,33,84,.393,27,64,.422,6,20,.300,33,37,.892,105,43,86,.500,34,59,.576,9,27,.333,24,26,.923,119
1018,MIL,2016-01-16,105,@,CHO,W 105-92,240,39,72,.542,34,60,.567,5,12,.417,22,26,.846,105,33,87,.379,24,51,.471,9,36,.250,17,22,.773,92
1019,WAS,2016-01-09,105,@,ORL,W 105-99,240,42,76,.553,29,53,.547,13,23,.565,8,10,.800,105,38,74,.514,33,60,.550,5,14,.357,18,24,.750,99
1020,CHI,2016-01-09,105,@,ATL,L 105-120,240,36,83,.434,29,65,.446,7,18,.389,26,31,.839,105,49,94,.521,39,70,.557,10,24,.417,12,15,.800,120
1021,NOP,2016-01-02,105,@,DAL,W 105-98,240,40,83,.482,34,63,.540,6,20,.300,19,24,.792,105,36,83,.434,26,57,.456,10,26,.385,16,19,.842,98
1022,SAC,2015-12-30,105,,PHI,L 105-110,240,36,74,.486,28,49,.571,8,25,.320,25,41,.610,105,40,94,.426,31,63,.492,9,31,.290,21,34,.618,110
1023,MIA,2015-12-28,105,,BRK,L 105-111,240,36,78,.462,26,54,.481,10,24,.417,23,30,.767,105,36,82,.439,24,59,.407,12,23,.522,27,36,.750,111
1024,POR,2015-12-26,105,,CLE,W 105-76,240,41,89,.461,32,67,.478,9,22,.409,14,19,.737,105,28,77,.364,17,46,.370,11,31,.355,9,15,.600,76
1025,CHI,2015-12-25,105,@,OKC,W 105-96,240,40,92,.435,33,74,.446,7,18,.389,18,20,.900,105,37,96,.385,31,72,.431,6,24,.250,16,23,.696,96
1026,BRK,2015-12-21,105,@,CHI,W 105-102,240,43,94,.457,36,74,.486,7,20,.350,12,14,.857,105,43,95,.453,34,69,.493,9,26,.346,7,13,.538,102
1027,POR,2015-12-14,105,,NOP,W 105-101,240,35,81,.432,22,49,.449,13,32,.406,22,29,.759,105,36,82,.439,28,57,.491,8,25,.320,21,27,.778,101
1028,ORL,2015-12-14,105,@,BRK,W 105-82,240,41,76,.539,32,55,.582,9,21,.429,14,20,.700,105,31,80,.388,24,61,.393,7,19,.368,13,16,.813,82
1029,LAC,2015-12-14,105,@,DET,W 105-103 (OT),265,44,97,.454,38,78,.487,6,19,.316,11,15,.733,105,37,89,.416,31,70,.443,6,19,.316,23,31,.742,103
1030,LAC,2015-12-12,105,@,BRK,W 105-100,240,43,86,.500,35,62,.565,8,24,.333,11,18,.611,105,35,79,.443,30,60,.500,5,19,.263,25,30,.833,100
1031,WAS,2015-12-11,105,@,NOP,L 105-107,240,40,80,.500,28,53,.528,12,27,.444,13,21,.619,105,39,79,.494,23,52,.442,16,27,.593,13,18,.722,107
1032,BOS,2015-12-09,105,,CHI,W 105-100,240,38,92,.413,33,69,.478,5,23,.217,24,28,.857,105,39,91,.429,33,70,.471,6,21,.286,16,23,.696,100
1033,HOU,2015-12-08,105,@,BRK,L 105-110,240,39,82,.476,24,47,.511,15,35,.429,12,17,.706,105,45,81,.556,38,63,.603,7,18,.389,13,16,.813,110
1034,CLE,2015-12-08,105,,POR,W 105-100,240,40,79,.506,31,58,.534,9,21,.429,16,20,.800,105,40,79,.506,29,53,.547,11,26,.423,9,16,.563,100
1035,BOS,2015-12-05,105,@,SAS,L 105-108,240,39,86,.453,27,57,.474,12,29,.414,15,22,.682,105,44,83,.530,39,66,.591,5,17,.294,15,22,.682,108
1036,PHI,2015-12-05,105,,DEN,L 105-108,240,37,74,.500,22,43,.512,15,31,.484,16,26,.615,105,37,81,.457,26,50,.520,11,31,.355,23,38,.605,108
1037,TOR,2015-12-03,105,,DEN,L 105-106,240,39,92,.424,31,65,.477,8,27,.296,19,22,.864,105,38,81,.469,26,54,.481,12,27,.444,18,18,1.000,106
1038,HOU,2015-11-30,105,@,DET,L 105-116,240,35,88,.398,24,61,.393,11,27,.407,24,28,.857,105,45,85,.529,37,62,.597,8,23,.348,18,37,.486,116
1039,BOS,2015-11-30,105,@,MIA,W 105-95,240,38,80,.475,30,60,.500,8,20,.400,21,25,.840,105,36,75,.480,31,58,.534,5,17,.294,18,24,.750,95
1040,DEN,2015-11-22,105,,GSW,L 105-118,240,37,86,.430,33,71,.465,4,15,.267,27,35,.771,105,47,89,.528,32,60,.533,15,29,.517,9,13,.692,118
1041,PHO,2015-11-14,105,,DEN,W 105-81,240,37,84,.440,26,60,.433,11,24,.458,20,26,.769,105,34,98,.347,28,63,.444,6,35,.171,7,8,.875,81
1042,CLE,2015-11-14,105,@,MIL,L 105-108 (2OT),290,37,91,.407,23,53,.434,14,38,.368,17,27,.630,105,43,102,.422,37,86,.430,6,16,.375,16,22,.727,108
1043,DAL,2015-11-10,105,@,NOP,L 105-120,240,39,88,.443,34,68,.500,5,20,.250,22,26,.846,105,46,92,.500,32,59,.542,14,33,.424,14,18,.778,120
1044,LAC,2015-11-07,105,,HOU,L 105-109,240,42,88,.477,38,66,.576,4,22,.182,17,25,.680,105,38,86,.442,31,56,.554,7,30,.233,26,29,.897,109
1045,ORL,2015-11-07,105,@,PHI,W 105-97,240,39,83,.470,33,70,.471,6,13,.462,21,24,.875,105,36,80,.450,25,47,.532,11,33,.333,14,26,.538,97
1046,CHI,2015-11-03,105,@,CHO,L 105-130,240,44,90,.489,30,60,.500,14,30,.467,3,8,.375,105,47,91,.516,33,68,.485,14,23,.609,22,23,.957,130
1047,OKC,2015-11-02,105,@,HOU,L 105-110,240,40,84,.476,30,61,.492,10,23,.435,15,22,.682,105,41,89,.461,32,60,.533,9,29,.310,19,29,.655,110
1048,DEN,2015-10-28,105,@,HOU,W 105-85,240,40,79,.506,27,52,.519,13,27,.481,12,18,.667,105,30,87,.345,22,52,.423,8,35,.229,17,26,.654,85
1049,MEM,2016-04-13,104,@,GSW,L 104-125,240,42,98,.429,34,74,.459,8,24,.333,12,16,.750,104,46,87,.529,26,40,.650,20,47,.426,13,16,.813,125
1050,BOS,2016-04-06,104,,NOP,W 104-97,240,36,87,.414,26,53,.491,10,34,.294,22,27,.815,104,34,78,.436,25,54,.463,9,24,.375,20,23,.870,97
1051,ORL,2016-04-06,104,,DET,L 104-108,240,43,90,.478,39,75,.520,4,15,.267,14,19,.737,104,39,86,.453,28,59,.475,11,27,.407,19,31,.613,108
1052,IND,2016-03-27,104,,HOU,W 104-101,240,41,87,.471,32,61,.525,9,26,.346,13,20,.650,104,38,85,.447,31,52,.596,7,33,.212,18,27,.667,101
1053,MEM,2016-03-25,104,@,SAS,L 104-110,240,44,83,.530,37,65,.569,7,18,.389,9,13,.692,104,44,77,.571,37,59,.627,7,18,.389,15,18,.833,110
1054,BRK,2016-03-24,104,,CLE,W 104-95,240,41,89,.461,33,67,.493,8,22,.364,14,19,.737,104,39,89,.438,29,51,.569,10,38,.263,7,9,.778,95
1055,DEN,2016-03-23,104,,PHI,W 104-103,240,33,76,.434,27,59,.458,6,17,.353,32,40,.800,104,37,94,.394,22,57,.386,15,37,.405,14,15,.933,103
1056,MIL,2016-03-23,104,@,CLE,L 104-113,240,43,80,.538,36,64,.563,7,16,.438,11,15,.733,104,40,83,.482,30,49,.612,10,34,.294,23,27,.852,113
1057,SAC,2016-03-23,104,@,MIN,L 104-113,240,42,91,.462,34,71,.479,8,20,.400,12,23,.522,104,45,80,.563,40,67,.597,5,13,.385,18,32,.563,113
1058,MIN,2016-03-21,104,,GSW,L 104-109,240,36,82,.439,29,63,.460,7,19,.368,25,30,.833,104,43,87,.494,35,63,.556,8,24,.333,15,24,.625,109
1059,MIN,2016-03-14,104,@,PHO,L 104-107,240,37,84,.440,33,68,.485,4,16,.250,26,30,.867,104,40,95,.421,29,60,.483,11,35,.314,16,20,.800,107
1060,ATL,2016-03-13,104,,IND,W 104-75,240,40,85,.471,25,55,.455,15,30,.500,9,10,.900,104,33,87,.379,28,63,.444,5,24,.208,4,7,.571,75
1061,MIA,2016-03-12,104,@,TOR,L 104-112 (OT),265,37,98,.378,28,73,.384,9,25,.360,21,26,.808,104,37,84,.440,31,66,.470,6,18,.333,32,38,.842,112
1062,TOR,2016-03-10,104,,ATL,W 104-96,240,38,82,.463,31,58,.534,7,24,.292,21,29,.724,104,35,82,.427,28,59,.475,7,23,.304,19,27,.704,96
1063,PHI,2016-03-09,104,,HOU,L 104-118,240,35,86,.407,23,53,.434,12,33,.364,22,32,.688,104,38,86,.442,27,53,.509,11,33,.333,31,41,.756,118
1064,TOR,2016-03-08,104,,BRK,W 104-99,240,37,78,.474,27,55,.491,10,23,.435,20,25,.800,104,42,82,.512,36,70,.514,6,12,.500,9,9,1.000,99
1065,OKC,2016-03-06,104,@,MIL,W 104-96,240,32,76,.421,25,51,.490,7,25,.280,33,43,.767,104,34,90,.378,31,71,.437,3,19,.158,25,30,.833,96
1066,SAS,2016-03-05,104,,SAC,W 104-94,240,40,81,.494,32,58,.552,8,23,.348,16,19,.842,104,37,81,.457,31,65,.477,6,16,.375,14,21,.667,94
1067,NYK,2016-03-04,104,@,BOS,L 104-105,240,42,92,.457,33,69,.478,9,23,.391,11,14,.786,104,41,90,.456,37,70,.529,4,20,.200,19,25,.760,105
1068,SAC,2016-03-03,104,@,DAL,W 104-101,240,42,80,.525,35,55,.636,7,25,.280,13,24,.542,104,45,94,.479,38,65,.585,7,29,.241,4,6,.667,101
1069,IND,2016-03-02,104,@,MIL,W 104-99,240,38,80,.475,28,60,.467,10,20,.500,18,26,.692,104,34,76,.447,31,62,.500,3,14,.214,28,32,.875,99
1070,WAS,2016-03-02,104,@,MIN,W 104-98,240,42,84,.500,31,55,.564,11,29,.379,9,13,.692,104,32,75,.427,27,61,.443,5,14,.357,29,34,.853,98
1071,MEM,2016-03-02,104,,SAC,W 104-98,240,35,79,.443,30,61,.492,5,18,.278,29,33,.879,104,39,82,.476,30,56,.536,9,26,.346,11,20,.550,98
1072,TOR,2016-03-02,104,,UTA,W 104-94,240,40,80,.500,34,58,.586,6,22,.273,18,21,.857,104,37,83,.446,27,57,.474,10,26,.385,10,16,.625,94
1073,POR,2016-03-01,104,@,NYK,W 104-85,240,37,88,.420,25,58,.431,12,30,.400,18,20,.900,104,33,88,.375,27,67,.403,6,21,.286,13,18,.722,85
1074,SAS,2016-02-27,104,@,HOU,W 104-94,240,37,76,.487,29,57,.509,8,19,.421,22,28,.786,104,35,84,.417,27,59,.458,8,25,.320,16,22,.727,94
1075,WAS,2016-02-24,104,@,CHI,L 104-109,240,38,90,.422,29,62,.468,9,28,.321,19,26,.731,104,44,88,.500,36,65,.554,8,23,.348,13,16,.813,109
1076,BRK,2016-02-23,104,@,POR,L 104-112,240,43,90,.478,40,78,.513,3,12,.250,15,19,.789,104,40,80,.500,30,57,.526,10,23,.435,22,25,.880,112
1077,CHO,2016-02-21,104,@,BRK,W 104-96,240,40,79,.506,30,52,.577,10,27,.370,14,15,.933,104,35,81,.432,30,59,.508,5,22,.227,21,24,.875,96
1078,MIN,2016-02-19,104,@,MEM,L 104-109,240,31,75,.413,20,49,.408,11,26,.423,31,31,1.000,104,40,82,.488,33,61,.541,7,21,.333,22,28,.786,109
1079,DAL,2016-02-19,104,@,ORL,L 104-110 (OT),265,37,89,.416,18,48,.375,19,41,.463,11,18,.611,104,41,102,.402,28,67,.418,13,35,.371,15,17,.882,110
1080,PHO,2016-02-10,104,,GSW,L 104-112,240,41,93,.441,35,72,.486,6,21,.286,16,22,.727,104,37,89,.416,23,49,.469,14,40,.350,24,29,.828,112
1081,DEN,2016-02-08,104,@,BRK,L 104-105,240,42,90,.467,33,65,.508,9,25,.360,11,13,.846,104,42,81,.519,33,62,.532,9,19,.474,12,15,.800,105
1082,WAS,2016-02-06,104,@,CHO,L 104-108,240,38,86,.442,29,61,.475,9,25,.360,19,24,.792,104,38,81,.469,26,54,.481,12,27,.444,20,25,.800,108
1083,DET,2016-02-06,104,@,IND,L 104-112,240,38,79,.481,26,46,.565,12,33,.364,16,31,.516,104,41,76,.539,35,65,.538,6,11,.545,24,29,.828,112
1084,BOS,2016-02-05,104,@,CLE,W 104-103,240,38,88,.432,31,68,.456,7,20,.350,21,25,.840,104,37,87,.425,29,57,.509,8,30,.267,21,35,.600,103
1085,TOR,2016-02-02,104,@,PHO,W 104-97,240,35,74,.473,26,47,.553,9,27,.333,25,32,.781,104,37,79,.468,25,48,.521,12,31,.387,11,15,.733,97
1086,MIL,2016-02-01,104,@,SAC,L 104-111,240,42,84,.500,34,64,.531,8,20,.400,12,17,.706,104,39,86,.453,30,60,.500,9,26,.346,24,30,.800,111
1087,DAL,2016-01-24,104,@,HOU,L 104-115,240,36,79,.456,21,49,.429,15,30,.500,17,22,.773,104,43,89,.483,28,45,.622,15,44,.341,14,21,.667,115
1088,DEN,2016-01-23,104,,DET,W 104-101,240,36,78,.462,28,56,.500,8,22,.364,24,29,.828,104,40,84,.476,29,55,.527,11,29,.379,10,19,.526,101
1089,ATL,2016-01-20,104,@,POR,W 104-98,240,39,87,.448,29,63,.460,10,24,.417,16,23,.696,104,41,94,.436,32,63,.508,9,31,.290,7,11,.636,98
1090,DEN,2016-01-19,104,,OKC,L 104-110,240,35,83,.422,28,63,.444,7,20,.350,27,36,.750,104,41,97,.423,35,69,.507,6,28,.214,22,30,.733,110
1091,IND,2016-01-15,104,,WAS,L 104-118,240,38,80,.475,35,63,.556,3,17,.176,25,32,.781,104,51,98,.520,40,73,.548,11,25,.440,5,10,.500,118
1092,BRK,2016-01-15,104,,POR,L 104-116,240,38,85,.447,30,66,.455,8,19,.421,20,28,.714,104,47,93,.505,32,58,.552,15,35,.429,7,11,.636,116
1093,NYK,2016-01-13,104,@,BRK,L 104-110,240,41,91,.451,34,69,.493,7,22,.318,15,23,.652,104,45,86,.523,36,69,.522,9,17,.529,11,14,.786,110
1094,MIN,2016-01-13,104,@,HOU,L 104-107,240,36,78,.462,28,61,.459,8,17,.471,24,30,.800,104,37,75,.493,30,45,.667,7,30,.233,26,38,.684,107
1095,LAC,2016-01-13,104,,MIA,W 104-90,240,40,94,.426,29,69,.420,11,25,.440,13,16,.813,104,31,70,.443,22,46,.478,9,24,.375,19,29,.655,90
1096,OKC,2016-01-04,104,,SAC,L 104-116,240,39,89,.438,29,60,.483,10,29,.345,16,23,.696,104,40,89,.449,33,72,.458,7,17,.412,29,39,.744,116
1097,CLE,2016-01-02,104,,ORL,W 104-79,240,34,82,.415,22,45,.489,12,37,.324,24,39,.615,104,29,76,.382,23,51,.451,6,25,.240,15,17,.882,79
1098,TOR,2016-01-01,104,,CHO,W 104-94,240,36,91,.396,21,58,.362,15,33,.455,17,18,.944,104,34,85,.400,24,53,.453,10,32,.313,16,18,.889,94
1099,BOS,2015-12-30,104,,LAL,L 104-112,240,38,88,.432,31,61,.508,7,27,.259,21,25,.840,104,43,94,.457,34,75,.453,9,19,.474,17,23,.739,112
1100,CHI,2015-12-28,104,,TOR,W 104-97,240,40,87,.460,32,66,.485,8,21,.381,16,24,.667,104,38,88,.432,32,68,.471,6,20,.300,15,24,.625,97
1101,ORL,2015-12-28,104,,NOP,W 104-89,240,45,82,.549,38,65,.585,7,17,.412,7,11,.636,104,37,83,.446,32,63,.508,5,20,.250,10,15,.667,89
1102,UTA,2015-12-26,104,,LAC,L 104-109,240,36,74,.486,26,47,.553,10,27,.370,22,27,.815,104,38,79,.481,25,53,.472,13,26,.500,20,24,.833,109
1103,PHO,2015-12-26,104,,PHI,L 104-111,240,34,88,.386,24,61,.393,10,27,.370,26,34,.765,104,38,79,.481,26,52,.500,12,27,.444,23,27,.852,111
1104,DEN,2015-12-23,104,@,PHO,W 104-96,240,42,91,.462,28,56,.500,14,35,.400,6,13,.462,104,36,87,.414,23,62,.371,13,25,.520,11,17,.647,96
1105,ORL,2015-12-23,104,,HOU,W 104-101,240,44,84,.524,37,68,.544,7,16,.438,9,13,.692,104,41,83,.494,34,54,.630,7,29,.241,12,17,.706,101
1106,MEM,2015-12-22,104,@,PHI,W 104-90,240,40,85,.471,35,70,.500,5,15,.333,19,24,.792,104,31,66,.470,24,43,.558,7,23,.304,21,32,.656,90
1107,SAC,2015-12-20,104,@,TOR,W 104-94,240,40,76,.526,31,55,.564,9,21,.429,15,24,.625,104,35,94,.372,27,65,.415,8,29,.276,16,17,.941,94
1108,PHO,2015-12-18,104,,NOP,W 104-88,240,44,84,.524,38,68,.559,6,16,.375,10,17,.588,104,26,71,.366,22,49,.449,4,22,.182,32,38,.842,88
1109,IND,2015-12-18,104,,BRK,W 104-97,240,37,89,.416,30,61,.492,7,28,.250,23,26,.885,104,36,86,.419,28,70,.400,8,16,.500,17,17,1.000,97
1110,CLE,2015-12-17,104,,OKC,W 104-100,240,41,88,.466,29,59,.492,12,29,.414,10,13,.769,104,35,74,.473,29,54,.537,6,20,.300,24,28,.857,100
1111,NOP,2015-12-16,104,@,UTA,W 104-94,240,34,73,.466,24,52,.462,10,21,.476,26,28,.929,104,32,67,.478,25,47,.532,7,20,.350,23,29,.793,94
1112,MIA,2015-12-16,104,@,BRK,W 104-98,240,40,75,.533,33,54,.611,7,21,.333,17,24,.708,104,42,89,.472,38,73,.521,4,16,.250,10,14,.714,98
1113,DAL,2015-12-14,104,,PHO,W 104-94,240,38,77,.494,26,45,.578,12,32,.375,16,21,.762,104,33,80,.413,24,55,.436,9,25,.360,19,27,.704,94
1114,OKC,2015-12-13,104,,UTA,W 104-98 (OT),265,35,79,.443,28,58,.483,7,21,.333,27,30,.900,104,39,94,.415,31,72,.431,8,22,.364,12,20,.600,98
1115,ORL,2015-12-09,104,@,PHO,L 104-107,240,40,85,.471,28,60,.467,12,25,.480,12,16,.750,104,41,80,.513,35,56,.625,6,24,.250,19,27,.704,107
1116,DAL,2015-12-07,104,@,NYK,W 104-97,240,37,82,.451,24,51,.471,13,31,.419,17,20,.850,104,40,84,.476,31,59,.525,9,25,.360,8,9,.889,97
1117,CHO,2015-12-07,104,,DET,W 104-84,240,36,84,.429,28,58,.483,8,26,.308,24,35,.686,104,32,87,.368,22,53,.415,10,34,.294,10,22,.455,84
1118,WAS,2015-12-06,104,,DAL,L 104-116,240,42,89,.472,34,62,.548,8,27,.296,12,21,.571,104,38,76,.500,22,45,.489,16,31,.516,24,27,.889,116
1119,WAS,2015-12-02,104,,LAL,L 104-108,240,37,79,.468,30,58,.517,7,21,.333,23,31,.742,104,41,96,.427,33,71,.465,8,25,.320,18,20,.900,108
1120,NOP,2015-12-01,104,,MEM,L 104-113,240,35,81,.432,26,54,.481,9,27,.333,25,33,.758,104,43,90,.478,41,80,.513,2,10,.200,25,26,.962,113
1121,IND,2015-11-27,104,,CHI,W 104-92,240,37,87,.425,29,59,.492,8,28,.286,22,29,.759,104,32,92,.348,21,66,.318,11,26,.423,17,20,.850,92
1122,DET,2015-11-25,104,,MIA,W 104-81,240,41,98,.418,25,67,.373,16,31,.516,6,7,.857,104,32,79,.405,26,59,.441,6,20,.300,11,16,.688,81
1123,NOP,2015-11-20,104,,SAS,W 104-90,240,40,88,.455,32,66,.485,8,22,.364,16,17,.941,104,34,84,.405,25,67,.373,9,17,.529,13,16,.813,90
1124,ORL,2015-11-18,104,,MIN,W 104-101 (OT),265,41,110,.373,32,89,.360,9,21,.429,13,21,.619,104,36,85,.424,32,67,.478,4,18,.222,25,30,.833,101
1125,DET,2015-11-17,104,,CLE,W 104-99,240,36,84,.429,29,63,.460,7,21,.333,25,31,.806,104,38,80,.475,27,47,.574,11,33,.333,12,20,.600,99
1126,LAC,2015-11-12,104,@,PHO,L 104-118,240,40,90,.444,31,64,.484,9,26,.346,15,28,.536,104,44,83,.530,30,53,.566,14,30,.467,16,21,.762,118
1127,CHO,2015-11-10,104,@,MIN,W 104-95,240,38,78,.487,30,52,.577,8,26,.308,20,27,.741,104,36,80,.450,27,61,.443,9,19,.474,14,19,.737,95
1128,POR,2015-11-09,104,@,DEN,L 104-108,240,36,91,.396,26,62,.419,10,29,.345,22,27,.815,104,40,77,.519,33,58,.569,7,19,.368,21,32,.656,108
1129,LAL,2015-11-06,104,@,BRK,W 104-98,240,33,78,.423,26,55,.473,7,23,.304,31,40,.775,104,40,93,.430,37,74,.500,3,19,.158,15,20,.750,98
1130,DEN,2015-11-06,104,@,GSW,L 104-119,240,39,92,.424,31,68,.456,8,24,.333,18,22,.818,104,46,93,.495,29,56,.518,17,37,.459,10,18,.556,119
1131,CHI,2015-11-05,104,,OKC,W 104-98,240,40,90,.444,33,72,.458,7,18,.389,17,21,.810,104,38,84,.452,33,71,.465,5,13,.385,17,20,.850,98
1132,LAC,2015-10-29,104,,DAL,W 104-88,240,38,87,.437,30,56,.536,8,31,.258,20,33,.606,104,35,97,.361,29,67,.433,6,30,.200,12,15,.800,88
1133,SAC,2015-10-28,104,,LAC,L 104-111,240,41,94,.436,30,70,.429,11,24,.458,11,18,.611,104,42,80,.525,36,61,.590,6,19,.316,21,31,.677,111
1134,MIA,2015-10-28,104,,CHO,W 104-94,240,36,73,.493,24,53,.453,12,20,.600,20,21,.952,104,33,84,.393,27,60,.450,6,24,.250,22,29,.759,94
1135,ORL,2016-04-13,103,@,CHO,L 103-117,240,42,91,.462,34,64,.531,8,27,.296,11,18,.611,103,47,86,.547,36,57,.632,11,29,.379,12,19,.632,117
1136,TOR,2016-04-13,103,@,BRK,W 103-96,240,41,93,.441,28,56,.500,13,37,.351,8,15,.533,103,39,89,.438,29,63,.460,10,26,.385,8,12,.667,96
1137,DAL,2016-04-08,103,,MEM,W 103-93,240,30,60,.500,18,29,.621,12,31,.387,31,39,.795,103,35,87,.402,28,65,.431,7,22,.318,16,22,.727,93
1138,BRK,2016-04-06,103,@,WAS,L 103-121,240,39,92,.424,32,75,.427,7,17,.412,18,24,.750,103,48,95,.505,40,67,.597,8,28,.286,17,20,.850,121
1139,LAC,2016-04-05,103,,LAL,W 103-81,240,40,78,.513,33,58,.569,7,20,.350,16,26,.615,103,26,83,.313,20,63,.317,6,20,.300,23,25,.920,81
1140,ATL,2016-04-05,103,,PHO,W 103-90,240,39,95,.411,28,61,.459,11,34,.324,14,19,.737,103,30,81,.370,18,50,.360,12,31,.387,18,30,.600,90
1141,CHO,2016-04-03,103,@,CLE,L 103-112,240,34,76,.447,25,50,.500,9,26,.346,26,27,.963,103,45,83,.542,29,54,.537,16,29,.552,6,13,.462,112
1142,CHI,2016-03-31,103,@,HOU,W 103-100,240,37,77,.481,26,53,.491,11,24,.458,18,22,.818,103,36,90,.400,27,65,.415,9,25,.360,19,22,.864,100
1143,GSW,2016-03-30,103,@,UTA,W 103-96 (OT),265,39,89,.438,27,54,.500,12,35,.343,13,18,.722,103,37,92,.402,28,60,.467,9,32,.281,13,29,.448,96
1144,PHI,2016-03-23,103,@,DEN,L 103-104,240,37,94,.394,22,57,.386,15,37,.405,14,15,.933,103,33,76,.434,27,59,.458,6,17,.353,32,40,.800,104
1145,DAL,2016-03-23,103,@,POR,L 103-109,240,42,96,.438,33,66,.500,9,30,.300,10,11,.909,103,40,89,.449,33,62,.532,7,27,.259,22,25,.880,109
1146,MEM,2016-03-21,103,@,PHO,W 103-97,240,39,90,.433,31,70,.443,8,20,.400,17,19,.895,103,30,76,.395,19,48,.396,11,28,.393,26,34,.765,97
1147,BRK,2016-03-19,103,@,DET,L 103-115,240,42,80,.525,37,66,.561,5,14,.357,14,21,.667,103,46,94,.489,36,70,.514,10,24,.417,13,21,.619,115
1148,ORL,2016-03-18,103,,CLE,L 103-109,240,37,82,.451,26,60,.433,11,22,.500,18,22,.818,103,38,76,.500,25,48,.521,13,28,.464,20,27,.741,109
1149,UTA,2016-03-17,103,,PHO,W 103-69,240,43,88,.489,32,63,.508,11,25,.440,6,9,.667,103,28,82,.341,22,56,.393,6,26,.231,7,14,.500,69
1150,IND,2016-03-15,103,,BOS,W 103-98,240,39,84,.464,34,72,.472,5,12,.417,20,28,.714,103,36,94,.383,28,63,.444,8,31,.258,18,22,.818,98
1151,MIL,2016-03-12,103,,NOP,W 103-92,240,40,81,.494,36,68,.529,4,13,.308,19,24,.792,103,35,89,.393,29,60,.483,6,29,.207,16,21,.762,92
1152,DET,2016-03-11,103,@,CHO,L 103-118,240,36,76,.474,27,46,.587,9,30,.300,22,27,.815,103,42,83,.506,32,58,.552,10,25,.400,24,29,.828,118
1153,MIN,2016-03-07,103,@,CHO,L 103-108,240,39,80,.488,35,65,.538,4,15,.267,21,24,.875,103,41,90,.456,29,60,.483,12,30,.400,14,17,.824,108
1154,CLE,2016-03-07,103,,MEM,L 103-106,240,36,80,.450,29,51,.569,7,29,.241,24,29,.828,103,41,86,.477,35,66,.530,6,20,.300,18,22,.818,106
1155,MIA,2016-03-06,103,,PHI,W 103-98,240,36,81,.444,28,67,.418,8,14,.571,23,30,.767,103,37,85,.435,26,54,.481,11,31,.355,13,22,.591,98
1156,POR,2016-03-06,103,@,DET,L 103-123,240,35,78,.449,24,47,.511,11,31,.355,22,23,.957,103,44,84,.524,32,62,.516,12,22,.545,23,28,.821,123
1157,BOS,2016-03-05,103,@,CLE,L 103-120,240,37,80,.463,27,57,.474,10,23,.435,19,27,.704,103,42,82,.512,32,52,.615,10,30,.333,26,34,.765,120
1158,LAC,2016-03-02,103,,OKC,W 103-98,240,40,98,.408,31,66,.470,9,32,.281,14,21,.667,103,39,98,.398,29,63,.460,10,35,.286,10,11,.909,98
1159,MEM,2016-02-29,103,@,DEN,W 103-96,240,36,75,.480,33,55,.600,3,20,.150,28,36,.778,103,40,75,.533,32,50,.640,8,25,.320,8,10,.800,96
1160,POR,2016-02-27,103,@,CHI,W 103-95,240,38,87,.437,33,66,.500,5,21,.238,22,27,.815,103,39,94,.415,32,72,.444,7,22,.318,10,12,.833,95
1161,ATL,2016-02-26,103,,CHI,W 103-88,240,37,89,.416,30,55,.545,7,34,.206,22,24,.917,103,32,88,.364,27,68,.397,5,20,.250,19,22,.864,88
1162,WAS,2016-02-26,103,@,PHI,W 103-94,240,40,94,.426,33,71,.465,7,23,.304,16,17,.941,103,35,82,.427,27,57,.474,8,25,.320,16,21,.762,94
1163,CHO,2016-02-24,103,@,CLE,L 103-114,240,37,76,.487,27,47,.574,10,29,.345,19,27,.704,103,45,91,.495,32,59,.542,13,32,.406,11,17,.647,114
1164,DAL,2016-02-24,103,,OKC,L 103-116,240,35,86,.407,26,58,.448,9,28,.321,24,30,.800,103,43,89,.483,31,56,.554,12,33,.364,18,22,.818,116
1165,PHI,2016-02-21,103,@,DAL,L 103-129,240,37,77,.481,25,49,.510,12,28,.429,17,27,.630,103,41,85,.482,28,51,.549,13,34,.382,34,36,.944,129
1166,NYK,2016-02-20,103,@,MIN,W 103-95,240,42,83,.506,37,66,.561,5,17,.294,14,16,.875,103,36,84,.429,31,72,.431,5,12,.417,18,25,.720,95
1167,WAS,2016-02-18,103,,UTA,W 103-89,240,42,86,.488,35,68,.515,7,18,.389,12,21,.571,103,31,77,.403,27,62,.435,4,15,.267,23,29,.793,89
1168,HOU,2016-02-10,103,@,POR,L 103-116,240,37,77,.481,26,43,.605,11,34,.324,18,34,.529,103,41,89,.461,33,61,.541,8,28,.286,26,34,.765,116
1169,DEN,2016-02-10,103,@,DET,W 103-92,240,39,83,.470,33,64,.516,6,19,.316,19,24,.792,103,38,88,.432,28,61,.459,10,27,.370,6,7,.857,92
1170,TOR,2016-02-08,103,@,DET,W 103-89,240,39,70,.557,28,50,.560,11,20,.550,14,17,.824,103,36,80,.450,28,52,.538,8,28,.286,9,17,.529,89
1171,PHI,2016-02-06,103,,BRK,W 103-98,240,38,81,.469,28,52,.538,10,29,.345,17,22,.773,103,35,76,.461,30,61,.492,5,15,.333,23,26,.885,98
1172,CLE,2016-02-05,103,,BOS,L 103-104,240,37,87,.425,29,57,.509,8,30,.267,21,35,.600,103,38,88,.432,31,68,.456,7,20,.350,21,25,.840,104
1173,POR,2016-02-04,103,,TOR,L 103-110,240,38,81,.469,28,56,.500,10,25,.400,17,23,.739,103,40,85,.471,28,66,.424,12,19,.632,18,25,.720,110
1174,SAS,2016-01-30,103,@,CLE,L 103-117,240,40,81,.494,34,63,.540,6,18,.333,17,21,.810,103,45,82,.549,36,59,.610,9,23,.391,18,21,.857,117
1175,BRK,2016-01-30,103,@,NOP,L 103-105,240,40,84,.476,31,64,.484,9,20,.450,14,23,.609,103,43,93,.462,32,66,.485,11,27,.407,8,10,.800,105
1176,UTA,2016-01-29,103,,MIN,W 103-90,240,40,76,.526,30,51,.588,10,25,.400,13,16,.813,103,35,75,.467,33,65,.508,2,10,.200,18,26,.692,90
1177,MIL,2016-01-29,103,,MIA,L 103-107,240,38,80,.475,36,68,.529,2,12,.167,25,28,.893,103,37,74,.500,30,56,.536,7,18,.389,26,32,.813,107
1178,TOR,2016-01-28,103,,NYK,W 103-93,240,37,85,.435,29,65,.446,8,20,.400,21,29,.724,103,38,87,.437,31,69,.449,7,18,.389,10,20,.500,93
1179,MEM,2016-01-28,103,,MIL,W 103-83,240,38,80,.475,28,52,.538,10,28,.357,17,20,.850,103,29,79,.367,28,63,.444,1,16,.063,24,27,.889,83
1180,DEN,2016-01-27,103,@,BOS,L 103-111,240,36,84,.429,29,63,.460,7,21,.333,24,32,.750,103,41,96,.427,32,68,.471,9,28,.321,20,24,.833,111
1181,PHO,2016-01-26,103,@,PHI,L 103-113,240,39,83,.470,33,64,.516,6,19,.316,19,28,.679,103,39,81,.481,28,53,.528,11,28,.393,24,36,.667,113
1182,LAL,2016-01-23,103,@,POR,L 103-121,240,34,69,.493,27,52,.519,7,17,.412,28,32,.875,103,47,93,.505,37,62,.597,10,31,.323,17,22,.773,121
1183,MEM,2016-01-16,103,,NYK,W 103-95,240,39,82,.476,34,72,.472,5,10,.500,20,26,.769,103,35,77,.455,30,57,.526,5,20,.250,20,24,.833,95
1184,LAC,2016-01-16,103,,SAC,L 103-110,240,38,96,.396,25,57,.439,13,39,.333,14,19,.737,103,36,76,.474,23,51,.451,13,25,.520,25,33,.758,110
1185,PHO,2016-01-15,103,@,BOS,L 103-117,240,35,89,.393,25,62,.403,10,27,.370,23,28,.821,103,42,96,.438,28,66,.424,14,30,.467,19,29,.655,117
1186,ORL,2016-01-14,103,,TOR,L 103-106 (OT),265,44,97,.454,35,74,.473,9,23,.391,6,8,.750,103,37,90,.411,29,66,.439,8,24,.333,24,31,.774,106
1187,SAC,2016-01-14,103,@,UTA,W 103-101,240,34,74,.459,29,63,.460,5,11,.455,30,42,.714,103,35,83,.422,29,49,.592,6,34,.176,25,34,.735,101
1188,MEM,2016-01-14,103,,DET,W 103-101,240,37,76,.487,28,60,.467,9,16,.563,20,25,.800,103,37,72,.514,22,40,.550,15,32,.469,12,17,.706,101
1189,BOS,2016-01-13,103,,IND,W 103-94,240,40,90,.444,31,64,.484,9,26,.346,14,20,.700,103,37,91,.407,32,61,.525,5,30,.167,15,20,.750,94
1190,MIA,2016-01-11,103,@,GSW,L 103-111,240,41,91,.451,34,72,.472,7,19,.368,14,16,.875,103,41,86,.477,34,63,.540,7,23,.304,22,30,.733,111
1191,IND,2016-01-10,103,@,HOU,L 103-107 (OT),265,43,90,.478,34,59,.576,9,31,.290,8,10,.800,103,39,89,.438,25,51,.490,14,38,.368,15,23,.652,107
1192,DET,2016-01-09,103,,BRK,W 103-89,240,43,92,.467,35,65,.538,8,27,.296,9,14,.643,103,38,82,.463,33,73,.452,5,9,.556,8,10,.800,89
1193,MIA,2016-01-08,103,@,PHO,W 103-95,240,36,73,.493,29,55,.527,7,18,.389,24,30,.800,103,40,92,.435,34,68,.500,6,24,.250,9,13,.692,95
1194,HOU,2016-01-07,103,,UTA,W 103-94,240,39,75,.520,32,52,.615,7,23,.304,18,26,.692,103,38,78,.487,31,50,.620,7,28,.250,11,17,.647,94
1195,MIA,2016-01-04,103,,IND,W 103-100 (OT),265,34,90,.378,29,68,.426,5,22,.227,30,39,.769,103,37,94,.394,29,66,.439,8,28,.286,18,25,.720,100
1196,BOS,2016-01-04,103,@,BRK,W 103-94,240,41,92,.446,35,71,.493,6,21,.286,15,19,.789,103,32,85,.376,26,57,.456,6,28,.214,24,27,.889,94
1197,HOU,2016-01-02,103,@,SAS,L 103-121,240,37,74,.500,28,52,.538,9,22,.409,20,33,.606,103,45,86,.523,32,62,.516,13,24,.542,18,19,.947,121
1198,WAS,2016-01-01,103,,ORL,W 103-91,240,43,92,.467,35,66,.530,8,26,.308,9,10,.900,103,40,85,.471,35,65,.538,5,20,.250,6,8,.750,91
1199,DEN,2015-12-30,103,@,POR,L 103-110,240,37,87,.425,25,60,.417,12,27,.444,17,19,.895,103,41,87,.471,29,55,.527,12,32,.375,16,20,.800,110
1200,SAC,2015-12-28,103,@,GSW,L 103-122,240,37,95,.389,24,64,.375,13,31,.419,16,28,.571,103,43,89,.483,23,47,.489,20,42,.476,16,24,.667,122
1201,DAL,2015-12-28,103,,MIL,W 103-93,240,38,84,.452,28,62,.452,10,22,.455,17,26,.654,103,38,79,.481,34,65,.523,4,14,.286,13,15,.867,93
1202,GSW,2015-12-23,103,,UTA,W 103-85,240,39,83,.470,30,60,.500,9,23,.391,16,16,1.000,103,33,80,.413,26,60,.433,7,20,.350,12,14,.857,85
1203,TOR,2015-12-22,103,,DAL,W 103-99,240,35,74,.473,23,48,.479,12,26,.462,21,27,.778,103,40,92,.435,29,63,.460,11,29,.379,8,11,.727,99
1204,ATL,2015-12-20,103,@,ORL,W 103-100,240,39,78,.500,28,56,.500,11,22,.500,14,20,.700,103,38,81,.469,34,69,.493,4,12,.333,20,24,.833,100
1205,LAC,2015-12-16,103,,MIL,W 103-90,240,36,75,.480,25,54,.463,11,21,.524,20,24,.833,103,38,88,.432,33,72,.458,5,16,.313,9,11,.818,90
1206,PHO,2015-12-16,103,@,GSW,L 103-128,240,41,91,.451,36,69,.522,5,22,.227,16,18,.889,103,46,88,.523,31,56,.554,15,32,.469,21,27,.778,128
1207,DET,2015-12-14,103,,LAC,L 103-105 (OT),265,37,89,.416,31,70,.443,6,19,.316,23,31,.742,103,44,97,.454,38,78,.487,6,19,.316,11,15,.733,105
1208,SAS,2015-12-12,103,@,ATL,W 103-78,240,36,74,.486,26,54,.481,10,20,.500,21,22,.955,103,30,80,.375,25,56,.446,5,24,.208,13,16,.813,78
1209,WAS,2015-12-09,103,,HOU,L 103-109,240,39,89,.438,34,64,.531,5,25,.200,20,24,.833,103,40,83,.482,28,50,.560,12,33,.364,17,25,.680,109
1210,PHO,2015-12-07,103,@,CHI,W 103-101,240,41,92,.446,34,75,.453,7,17,.412,14,17,.824,103,41,90,.456,35,69,.507,6,21,.286,13,18,.722,101
1211,MIA,2015-12-07,103,,WAS,L 103-114,240,41,69,.594,36,53,.679,5,16,.313,16,22,.727,103,46,92,.500,37,74,.500,9,18,.500,13,17,.765,114
1212,LAC,2015-12-05,103,,ORL,W 103-101,240,37,82,.451,25,51,.490,12,31,.387,17,25,.680,103,40,90,.444,34,70,.486,6,20,.300,15,18,.833,101
1213,MIN,2015-12-05,103,,POR,L 103-109,240,38,83,.458,33,68,.485,5,15,.333,22,26,.846,103,39,77,.506,29,57,.509,10,20,.500,21,30,.700,109
1214,SAS,2015-12-03,103,@,MEM,W 103-83,240,40,80,.500,30,62,.484,10,18,.556,13,18,.722,103,30,80,.375,28,64,.438,2,16,.125,21,25,.840,83
1215,ORL,2015-12-03,103,@,UTA,W 103-94,240,40,89,.449,32,66,.485,8,23,.348,15,15,1.000,103,31,72,.431,17,39,.436,14,33,.424,18,24,.750,94
1216,IND,2015-12-02,103,@,LAC,W 103-91,240,32,76,.421,25,56,.446,7,20,.350,32,39,.821,103,30,79,.380,24,52,.462,6,27,.222,25,39,.641,91
1217,PHI,2015-12-01,103,,LAL,W 103-91,240,37,79,.468,23,47,.489,14,32,.438,15,23,.652,103,33,89,.371,25,55,.455,8,34,.235,17,24,.708,91
1218,UTA,2015-11-30,103,,GSW,L 103-106,240,40,89,.449,34,70,.486,6,19,.316,17,22,.773,103,40,82,.488,26,53,.491,14,29,.483,12,15,.800,106
1219,LAL,2015-11-29,103,,IND,L 103-107,240,38,99,.384,27,66,.409,11,33,.333,16,22,.727,103,34,83,.410,25,56,.446,9,27,.333,30,37,.811,107
1220,OKC,2015-11-27,103,,DET,W 103-87,240,37,79,.468,30,55,.545,7,24,.292,22,26,.846,103,31,90,.344,22,61,.361,9,29,.310,16,20,.800,87
1221,TOR,2015-11-25,103,,CLE,W 103-99,240,40,79,.506,29,54,.537,11,25,.440,12,22,.545,103,36,82,.439,22,53,.415,14,29,.483,13,16,.813,99
1222,ORL,2015-11-23,103,@,CLE,L 103-117,240,40,81,.494,30,59,.508,10,22,.455,13,21,.619,103,43,81,.531,25,46,.543,18,35,.514,13,22,.591,117
1223,CHI,2015-11-18,103,@,PHO,W 103-97,240,41,83,.494,32,64,.500,9,19,.474,12,14,.857,103,37,91,.407,29,64,.453,8,27,.296,15,21,.714,97
1224,ATL,2015-11-18,103,,SAC,W 103-97,240,38,89,.427,29,59,.492,9,30,.300,18,24,.750,103,38,86,.442,33,70,.471,5,16,.313,16,18,.889,97
1225,POR,2015-11-18,103,@,HOU,L 103-108 (OT),265,35,88,.398,26,58,.448,9,30,.300,24,29,.828,103,32,92,.348,18,48,.375,14,44,.318,30,35,.857,108
1226,NOP,2015-11-18,103,@,OKC,L 103-110,240,43,95,.453,35,63,.556,8,32,.250,9,9,1.000,103,38,85,.447,31,68,.456,7,17,.412,27,40,.675,110
1227,MIN,2015-11-17,103,@,MIA,W 103-91,240,36,97,.371,32,76,.421,4,21,.190,27,35,.771,103,36,79,.456,31,55,.564,5,24,.208,14,30,.467,91
1228,MIN,2015-11-13,103,@,IND,L 103-107,240,42,83,.506,35,63,.556,7,20,.350,12,13,.923,103,41,86,.477,31,61,.508,10,25,.400,15,23,.652,107
1229,PHI,2015-11-11,103,,TOR,L 103-119,240,40,87,.460,28,58,.483,12,29,.414,11,17,.647,103,43,89,.483,38,71,.535,5,18,.278,28,31,.903,119
1230,DEN,2015-11-11,103,,MIL,W 103-102,240,39,79,.494,31,55,.564,8,24,.333,17,24,.708,103,42,79,.532,32,57,.561,10,22,.455,8,9,.889,102
1231,PHO,2015-11-08,103,@,OKC,L 103-124,240,38,84,.452,31,68,.456,7,16,.438,20,26,.769,103,49,94,.521,45,74,.608,4,20,.200,22,30,.733,124
1232,POR,2015-11-08,103,,DET,L 103-120,240,41,76,.539,32,51,.627,9,25,.360,12,18,.667,103,47,96,.490,36,66,.545,11,30,.367,15,22,.682,120
1233,GSW,2015-11-07,103,@,SAC,W 103-94,240,38,92,.413,30,53,.566,8,39,.205,19,22,.864,103,38,87,.437,32,68,.471,6,19,.316,12,16,.750,94
1234,TOR,2015-11-04,103,@,OKC,W 103-98,240,33,79,.418,28,65,.431,5,14,.357,32,39,.821,103,39,82,.476,31,59,.525,8,23,.348,12,14,.857,98
1235,MEM,2015-11-03,103,@,SAC,W 103-89,240,40,83,.482,37,63,.587,3,20,.150,20,25,.800,103,29,74,.392,22,54,.407,7,20,.350,24,40,.600,89
1236,ORL,2015-11-03,103,@,NOP,W 103-94,240,42,90,.467,35,72,.486,7,18,.389,12,12,1.000,103,32,90,.356,20,54,.370,12,36,.333,18,25,.720,94
1237,MIL,2015-11-02,103,@,BRK,W 103-96,240,38,73,.521,29,50,.580,9,23,.391,18,26,.692,103,36,79,.456,30,60,.500,6,19,.316,18,22,.818,96
1238,DAL,2015-11-01,103,@,LAL,W 103-93,240,40,87,.460,29,57,.509,11,30,.367,12,16,.750,103,31,85,.365,21,51,.412,10,34,.294,21,28,.750,93
1239,BOS,2015-10-30,103,,TOR,L 103-113,240,32,85,.376,25,59,.424,7,26,.269,32,41,.780,103,36,82,.439,25,56,.446,11,26,.423,30,35,.857,113
1240,IND,2015-10-29,103,,MEM,L 103-112,240,37,78,.474,25,48,.521,12,30,.400,17,24,.708,103,41,82,.500,34,66,.515,7,16,.438,23,29,.793,112
1241,IND,2016-04-12,102,,NYK,W 102-90,240,41,80,.513,35,61,.574,6,19,.316,14,20,.700,102,36,80,.450,26,53,.491,10,27,.370,8,9,.889,90
1242,SAS,2016-04-12,102,,OKC,W 102-98 (OT),265,37,87,.425,33,73,.452,4,14,.286,24,32,.750,102,35,87,.402,29,62,.468,6,25,.240,22,25,.880,98
1243,CLE,2016-04-09,102,@,CHI,L 102-105,240,36,83,.434,17,43,.395,19,40,.475,11,18,.611,102,40,89,.449,32,65,.492,8,24,.333,17,21,.810,105
1244,PHI,2016-04-08,102,,NYK,L 102-109,240,32,91,.352,18,54,.333,14,37,.378,24,36,.667,102,43,91,.473,39,75,.520,4,16,.250,19,30,.633,109
1245,LAL,2016-04-08,102,@,NOP,L 102-110,240,34,81,.420,23,57,.404,11,24,.458,23,27,.852,102,42,79,.532,32,57,.561,10,22,.455,16,21,.762,110
1246,DEN,2016-04-08,102,,SAS,W 102-98,240,40,86,.465,34,64,.531,6,22,.273,16,19,.842,102,36,85,.424,33,71,.465,3,14,.214,23,28,.821,98
1247,LAC,2016-04-08,102,@,UTA,W 102-99 (OT),265,37,83,.446,24,54,.444,13,29,.448,15,19,.789,102,36,82,.439,25,51,.490,11,31,.355,16,23,.696,99
1248,DEN,2016-04-05,102,,OKC,L 102-124,240,37,88,.420,27,58,.466,10,30,.333,18,27,.667,102,46,87,.529,31,54,.574,15,33,.455,17,24,.708,124
1249,CHI,2016-04-03,102,@,MIL,W 102-98,240,39,74,.527,32,48,.667,7,26,.269,17,22,.773,102,40,85,.471,38,78,.487,2,7,.286,16,20,.800,98
1250,SAS,2016-04-02,102,,TOR,W 102-95,240,35,77,.455,30,57,.526,5,20,.250,27,30,.900,102,40,80,.500,34,62,.548,6,18,.333,9,10,.900,95
1251,PHI,2016-04-02,102,,IND,L 102-115,240,34,83,.410,18,46,.391,16,37,.432,18,26,.692,102,44,84,.524,36,61,.590,8,23,.348,19,23,.826,115
1252,LAL,2016-03-30,102,,MIA,W 102-100 (OT),265,37,102,.363,31,82,.378,6,20,.300,22,29,.759,102,41,86,.477,38,69,.551,3,17,.176,15,26,.577,100
1253,GSW,2016-03-29,102,,WAS,W 102-94,240,38,87,.437,27,62,.435,11,25,.440,15,23,.652,102,36,86,.419,31,63,.492,5,23,.217,17,27,.630,94
1254,ATL,2016-03-28,102,@,CHI,W 102-100,240,36,85,.424,31,63,.492,5,22,.227,25,28,.893,102,40,106,.377,31,84,.369,9,22,.409,11,15,.733,100
1255,BOS,2016-03-26,102,@,PHO,W 102-99,240,35,84,.417,27,55,.491,8,29,.276,24,27,.889,102,37,85,.435,30,54,.556,7,31,.226,18,21,.857,99
1256,ORL,2016-03-23,102,@,DET,L 102-118,240,39,98,.398,31,73,.425,8,25,.320,16,19,.842,102,43,80,.538,32,56,.571,11,24,.458,21,25,.840,118
1257,ATL,2016-03-21,102,,WAS,L 102-117,240,38,78,.487,25,45,.556,13,33,.394,13,17,.765,102,46,91,.505,33,66,.500,13,25,.520,12,20,.600,117
1258,SAC,2016-03-21,102,@,CHI,L 102-109,240,40,88,.455,31,59,.525,9,29,.310,13,16,.813,102,41,91,.451,29,67,.433,12,24,.500,15,23,.652,109
1259,LAC,2016-03-19,102,@,MEM,L 102-113,240,31,66,.470,19,36,.528,12,30,.400,28,39,.718,102,40,82,.488,36,67,.537,4,15,.267,29,36,.806,113
1260,BRK,2016-03-17,102,@,CHI,L 102-118,240,40,86,.465,34,65,.523,6,21,.286,16,20,.800,102,46,94,.489,35,70,.500,11,24,.458,15,15,1.000,118
1261,HOU,2016-03-11,102,@,BOS,W 102-98,240,40,88,.455,35,62,.565,5,26,.192,17,25,.680,102,34,91,.374,26,60,.433,8,31,.258,22,28,.786,98
1262,DET,2016-03-09,102,@,DAL,W 102-96,240,38,85,.447,29,58,.500,9,27,.333,17,30,.567,102,39,86,.453,30,56,.536,9,30,.300,9,11,.818,96
1263,NYK,2016-03-05,102,,DET,W 102-89,240,42,79,.532,38,63,.603,4,16,.250,14,18,.778,102,36,92,.391,30,66,.455,6,26,.231,11,15,.733,89
1264,PHO,2016-03-04,102,@,ORL,W 102-84,240,35,78,.449,30,64,.469,5,14,.357,27,39,.692,102,35,101,.347,28,74,.378,7,27,.259,7,14,.500,84
1265,PHI,2016-03-04,102,,MIA,L 102-112,240,36,95,.379,27,64,.422,9,31,.290,21,27,.778,102,39,88,.443,34,72,.472,5,16,.313,29,36,.806,112
1266,ORL,2016-03-02,102,,CHI,W 102-89,240,39,97,.402,32,76,.421,7,21,.333,17,22,.773,102,38,99,.384,32,80,.400,6,19,.316,7,11,.636,89
1267,IND,2016-02-28,102,,POR,L 102-111,240,40,93,.430,37,79,.468,3,14,.214,19,25,.760,102,41,81,.506,27,57,.474,14,24,.583,15,21,.714,111
1268,DET,2016-02-27,102,@,MIL,W 102-91,240,37,88,.420,25,58,.431,12,30,.400,16,24,.667,102,38,78,.487,31,66,.470,7,12,.583,8,12,.667,91
1269,GSW,2016-02-22,102,@,ATL,W 102-92,240,39,89,.438,25,44,.568,14,45,.311,10,12,.833,102,36,86,.419,26,52,.500,10,34,.294,10,16,.625,92
1270,ORL,2016-02-21,102,,IND,L 102-105,240,38,91,.418,31,66,.470,7,25,.280,19,29,.655,102,41,82,.500,32,58,.552,9,24,.375,14,21,.667,105
1271,MIN,2016-02-08,102,,NOP,L 102-116,240,36,81,.444,34,69,.493,2,12,.167,28,35,.800,102,47,97,.485,37,73,.507,10,24,.417,12,20,.600,116
1272,LAL,2016-02-06,102,@,SAS,L 102-106,240,34,86,.395,24,56,.429,10,30,.333,24,27,.889,102,39,88,.443,31,64,.484,8,24,.333,20,25,.800,106
1273,ATL,2016-02-05,102,,IND,W 102-96,240,39,76,.513,29,49,.592,10,27,.370,14,20,.700,102,38,91,.418,25,60,.417,13,31,.419,7,9,.778,96
1274,BOS,2016-02-03,102,,DET,W 102-95,240,42,96,.438,35,75,.467,7,21,.333,11,13,.846,102,32,85,.376,21,51,.412,11,34,.324,20,28,.714,95
1275,SAC,2016-02-03,102,,CHI,L 102-107,240,42,88,.477,36,68,.529,6,20,.300,12,19,.632,102,40,88,.455,29,67,.433,11,21,.524,16,21,.762,107
1276,LAC,2016-02-03,102,,MIN,L 102-108,240,33,75,.440,22,43,.512,11,32,.344,25,34,.735,102,39,77,.506,31,60,.517,8,17,.471,22,26,.846,108
1277,MIA,2016-02-02,102,@,HOU,L 102-115,240,38,85,.447,32,68,.471,6,17,.353,20,27,.741,102,44,84,.524,28,49,.571,16,35,.457,11,16,.688,115
1278,NYK,2016-01-29,102,,PHO,W 102-84,240,36,84,.429,29,64,.453,7,20,.350,23,26,.885,102,35,85,.412,28,59,.475,7,26,.269,7,12,.583,84
1279,UTA,2016-01-27,102,,CHO,W 102-73,240,40,81,.494,28,50,.560,12,31,.387,10,15,.667,102,25,68,.368,19,43,.442,6,25,.240,17,21,.810,73
1280,MIA,2016-01-26,102,@,BRK,W 102-98,240,45,83,.542,42,74,.568,3,9,.333,9,10,.900,102,36,71,.507,27,53,.509,9,18,.500,17,23,.739,98
1281,ORL,2016-01-25,102,@,MEM,L 102-108 (OT),265,40,86,.465,30,58,.517,10,28,.357,12,14,.857,102,43,100,.430,37,82,.451,6,18,.333,16,25,.640,108
1282,HOU,2016-01-22,102,,MIL,W 102-98,240,38,94,.404,23,50,.460,15,44,.341,11,16,.688,102,39,85,.459,36,71,.507,3,14,.214,17,22,.773,98
1283,LAC,2016-01-21,102,@,CLE,L 102-115,240,36,80,.450,30,55,.545,6,25,.240,24,36,.667,102,42,83,.506,29,55,.527,13,28,.464,18,24,.750,115
1284,MEM,2016-01-21,102,@,DEN,W 102-101,240,36,72,.500,30,51,.588,6,21,.286,24,29,.828,102,36,80,.450,27,50,.540,9,30,.300,20,26,.769,101
1285,CHO,2016-01-06,102,@,PHO,L 102-111,240,38,87,.437,27,59,.458,11,28,.393,15,22,.682,102,41,84,.488,22,51,.431,19,33,.576,10,13,.769,111
1286,CHI,2015-12-30,102,,IND,W 102-100 (OT),265,37,86,.430,31,68,.456,6,18,.333,22,27,.815,102,37,97,.381,30,75,.400,7,22,.318,19,24,.792,100
1287,IND,2015-12-26,102,@,MIN,W 102-88,240,40,80,.500,31,54,.574,9,26,.346,13,14,.929,102,35,75,.467,31,63,.492,4,12,.333,14,18,.778,88
1288,BOS,2015-12-23,102,@,CHO,W 102-89,240,36,85,.424,29,56,.518,7,29,.241,23,26,.885,102,29,81,.358,21,53,.396,8,28,.286,23,32,.719,89
1289,CHI,2015-12-21,102,,BRK,L 102-105,240,43,95,.453,34,69,.493,9,26,.346,7,13,.538,102,43,94,.457,36,74,.486,7,20,.350,12,14,.857,105
1290,HOU,2015-12-21,102,,CHO,W 102-95,240,33,71,.465,26,43,.605,7,28,.250,29,41,.707,102,29,83,.349,17,42,.405,12,41,.293,25,31,.806,95
1291,ORL,2015-12-18,102,,POR,W 102-94,240,39,84,.464,37,69,.536,2,15,.133,22,31,.710,102,32,73,.438,21,41,.512,11,32,.344,19,26,.731,94
1292,MIN,2015-12-16,102,@,NYK,L 102-107,240,42,101,.416,38,80,.475,4,21,.190,14,14,1.000,102,37,85,.435,29,64,.453,8,21,.381,25,30,.833,107
1293,TOR,2015-12-07,102,,LAL,W 102-93,240,34,74,.459,25,49,.510,9,25,.360,25,32,.781,102,34,83,.410,27,64,.422,7,19,.368,18,20,.900,93
1294,CHO,2015-12-05,102,@,CHI,W 102-96,240,37,89,.416,27,55,.491,10,34,.294,18,25,.720,102,37,89,.416,28,64,.438,9,25,.360,13,19,.684,96
1295,DET,2015-12-04,102,,MIL,W 102-95,240,34,82,.415,27,59,.458,7,23,.304,27,39,.692,102,39,87,.448,35,69,.507,4,18,.222,13,14,.929,95
1296,LAC,2015-11-30,102,,POR,W 102-87,240,33,85,.388,25,66,.379,8,19,.421,28,56,.500,102,33,87,.379,28,64,.438,5,23,.217,16,27,.593,87
1297,TOR,2015-11-29,102,,PHO,L 102-107,240,38,86,.442,26,57,.456,12,29,.414,14,17,.824,102,40,94,.426,29,67,.433,11,27,.407,16,20,.800,107
1298,UTA,2015-11-25,102,@,LAC,W 102-91,240,39,77,.506,33,64,.516,6,13,.462,18,25,.720,102,38,75,.507,34,63,.540,4,12,.333,11,17,.647,91
1299,MEM,2015-11-25,102,@,HOU,W 102-93,240,39,80,.488,36,64,.563,3,16,.188,21,23,.913,102,30,71,.423,20,37,.541,10,34,.294,23,27,.852,93
1300,HOU,2015-11-21,102,,NYK,L 102-107,240,35,81,.432,23,53,.434,12,28,.429,20,28,.714,102,34,80,.425,22,55,.400,12,25,.480,27,34,.794,107
1301,POR,2015-11-20,102,,LAC,W 102-91,240,38,90,.422,30,65,.462,8,25,.320,18,24,.750,102,38,86,.442,31,62,.500,7,24,.292,8,16,.500,91
1302,TOR,2015-11-20,102,@,LAL,W 102-91,240,34,78,.436,19,45,.422,15,33,.455,19,24,.792,102,35,77,.455,27,52,.519,8,25,.320,13,17,.765,91
1303,DAL,2015-11-20,102,,UTA,W 102-93,240,39,83,.470,31,55,.564,8,28,.286,16,17,.941,102,35,80,.438,29,60,.483,6,20,.300,17,21,.810,93
1304,BOS,2015-11-18,102,,DAL,L 102-106,240,38,92,.413,30,66,.455,8,26,.308,18,24,.750,102,37,72,.514,30,52,.577,7,20,.350,25,35,.714,106
1305,NYK,2015-11-17,102,,CHO,W 102-94,240,36,89,.404,26,69,.377,10,20,.500,20,21,.952,102,36,82,.439,31,62,.500,5,20,.250,17,25,.680,94
1306,CHI,2015-11-13,102,,CHO,W 102-97,240,37,84,.440,33,68,.485,4,16,.250,24,31,.774,102,36,95,.379,21,62,.339,15,33,.455,10,12,.833,97
1307,OKC,2015-11-13,102,,PHI,W 102-85,240,39,97,.402,31,72,.431,8,25,.320,16,21,.762,102,30,86,.349,25,69,.362,5,17,.294,20,28,.714,85
1308,ORL,2015-11-13,102,,UTA,W 102-93,240,32,76,.421,22,49,.449,10,27,.370,28,31,.903,102,34,87,.391,26,62,.419,8,25,.320,17,23,.739,93
1309,IND,2015-11-11,102,@,BOS,W 102-91,240,38,79,.481,32,62,.516,6,17,.353,20,31,.645,102,32,77,.416,28,53,.528,4,24,.167,23,32,.719,91
1310,MIL,2015-11-11,102,@,DEN,L 102-103,240,42,79,.532,32,57,.561,10,22,.455,8,9,.889,102,39,79,.494,31,55,.564,8,24,.333,17,24,.708,103
1311,MIN,2015-11-07,102,@,CHI,W 102-93 (OT),265,39,96,.406,32,80,.400,7,16,.438,17,27,.630,102,33,93,.355,22,61,.361,11,32,.344,16,23,.696,93
1312,PHI,2015-11-06,102,@,CLE,L 102-108,240,41,79,.519,31,56,.554,10,23,.435,10,15,.667,102,45,88,.511,35,62,.565,10,26,.385,8,12,.667,108
1313,WAS,2015-11-04,102,,SAS,W 102-99,240,42,87,.483,34,64,.531,8,23,.348,10,14,.714,102,37,81,.457,30,59,.508,7,22,.318,18,20,.900,99
1314,TOR,2015-11-03,102,@,DAL,W 102-91,240,37,82,.451,32,65,.492,5,17,.294,23,26,.885,102,33,86,.384,26,63,.413,7,23,.304,18,25,.720,91
1315,LAC,2015-11-02,102,,PHO,W 102-96,240,37,81,.457,29,55,.527,8,26,.308,20,23,.870,102,36,98,.367,27,68,.397,9,30,.300,15,21,.714,96
1316,CLE,2015-10-30,102,,MIA,W 102-92,240,39,86,.453,33,61,.541,6,25,.240,18,21,.857,102,33,77,.429,27,56,.482,6,21,.286,20,22,.909,92
1317,SAS,2015-10-30,102,,BRK,W 102-75,240,40,86,.465,31,64,.484,9,22,.409,13,13,1.000,102,31,77,.403,26,61,.426,5,16,.313,8,15,.533,75
1318,LAL,2016-04-13,101,,UTA,W 101-96,240,41,85,.482,35,60,.583,6,25,.240,13,15,.867,101,39,83,.470,30,53,.566,9,30,.300,9,15,.600,96
1319,PHO,2016-04-11,101,,SAC,L 101-105,240,41,100,.410,36,78,.462,5,22,.227,14,17,.824,101,41,83,.494,35,66,.530,6,17,.353,17,28,.607,105
1320,DAL,2016-04-11,101,@,UTA,W 101-92,240,36,81,.444,25,49,.510,11,32,.344,18,22,.818,101,35,77,.455,26,44,.591,9,33,.273,13,18,.722,92
1321,SAS,2016-04-07,101,@,GSW,L 101-112,240,39,80,.488,32,64,.500,7,16,.438,16,23,.696,101,45,83,.542,33,58,.569,12,25,.480,10,11,.909,112
1322,UTA,2016-04-03,101,@,PHO,W 101-86,240,39,81,.481,29,54,.537,10,27,.370,13,17,.765,101,33,78,.423,25,51,.490,8,27,.296,12,19,.632,86
1323,NOP,2016-03-31,101,,DEN,W 101-95,240,40,90,.444,27,61,.443,13,29,.448,8,9,.889,101,36,83,.434,26,56,.464,10,27,.370,13,17,.765,95
1324,SAS,2016-03-28,101,@,MEM,W 101-87,240,37,72,.514,32,57,.561,5,15,.333,22,30,.733,101,33,83,.398,27,64,.422,6,19,.316,15,24,.625,87
1325,HOU,2016-03-27,101,@,IND,L 101-104,240,38,85,.447,31,52,.596,7,33,.212,18,27,.667,101,41,87,.471,32,61,.525,9,26,.346,13,20,.650,104
1326,WAS,2016-03-27,101,@,LAL,W 101-88,240,39,72,.542,32,54,.593,7,18,.389,16,29,.552,101,33,87,.379,26,59,.441,7,28,.250,15,17,.882,88
1327,ATL,2016-03-25,101,,MIL,W 101-90,240,41,97,.423,36,65,.554,5,32,.156,14,17,.824,101,35,84,.417,32,71,.451,3,13,.231,17,26,.654,90
1328,WAS,2016-03-23,101,,ATL,L 101-122,240,39,92,.424,27,62,.435,12,30,.400,11,12,.917,101,45,84,.536,28,42,.667,17,42,.405,15,22,.682,122
1329,CLE,2016-03-19,101,@,MIA,L 101-122,240,40,76,.526,30,52,.577,10,24,.417,11,13,.846,101,46,84,.548,35,65,.538,11,19,.579,19,23,.826,122
1330,DEN,2016-03-19,101,@,CHO,W 101-93,240,38,87,.437,29,69,.420,9,18,.500,16,23,.696,101,35,83,.422,26,51,.510,9,32,.281,14,20,.700,93
1331,TOR,2016-03-17,101,@,IND,W 101-94 (OT),265,32,88,.364,25,66,.379,7,22,.318,30,38,.789,101,35,91,.385,27,63,.429,8,28,.286,16,23,.696,94
1332,LAC,2016-03-11,101,,NYK,W 101-94,240,38,85,.447,25,56,.446,13,29,.448,12,16,.750,101,34,83,.410,30,63,.476,4,20,.200,22,25,.880,94
1333,CHI,2016-03-10,101,@,SAS,L 101-109,240,39,86,.453,28,64,.438,11,22,.500,12,13,.923,101,44,93,.473,38,76,.500,6,17,.353,15,19,.789,109
1334,IND,2016-03-04,101,@,CHO,L 101-108,240,37,90,.411,28,62,.452,9,28,.321,18,21,.857,101,38,79,.481,25,48,.521,13,31,.419,19,23,.826,108
1335,MIN,2016-03-04,101,@,MIL,L 101-116,240,42,87,.483,35,65,.538,7,22,.318,10,14,.714,101,43,83,.518,29,59,.492,14,24,.583,16,20,.800,116
1336,DAL,2016-03-03,101,,SAC,L 101-104,240,45,94,.479,38,65,.585,7,29,.241,4,6,.667,101,42,80,.525,35,55,.636,7,25,.280,13,24,.542,104
1337,BRK,2016-03-01,101,@,LAL,L 101-107,240,39,89,.438,34,71,.479,5,18,.278,18,27,.667,101,41,83,.494,30,57,.526,11,26,.423,14,21,.667,107
1338,MIN,2016-02-28,101,@,DAL,L 101-128,240,34,90,.378,27,67,.403,7,23,.304,26,37,.703,101,47,89,.528,34,53,.642,13,36,.361,21,21,1.000,128
1339,TOR,2016-02-28,101,@,DET,L 101-114,240,39,80,.488,29,59,.492,10,21,.476,13,18,.722,101,41,71,.577,29,48,.604,12,23,.522,20,27,.741,114
1340,BOS,2016-02-27,101,,MIA,W 101-89,240,39,96,.406,34,80,.425,5,16,.313,18,22,.818,101,36,87,.414,35,74,.473,1,13,.077,16,23,.696,89
1341,LAL,2016-02-22,101,@,MIL,L 101-108,240,28,76,.368,16,47,.340,12,29,.414,33,43,.767,101,44,86,.512,39,70,.557,5,16,.313,15,25,.600,108
1342,MIA,2016-02-22,101,,IND,W 101-93 (OT),265,38,100,.380,36,87,.414,2,13,.154,23,34,.676,101,36,92,.391,31,77,.403,5,15,.333,16,25,.640,93
1343,DEN,2016-02-21,101,,BOS,L 101-121,240,34,73,.466,28,52,.538,6,21,.286,27,34,.794,101,47,97,.485,37,65,.569,10,32,.313,17,20,.850,121
1344,IND,2016-02-19,101,@,OKC,W 101-98,240,39,88,.443,30,66,.455,9,22,.409,14,22,.636,101,42,96,.438,37,70,.529,5,26,.192,9,10,.900,98
1345,MIA,2016-02-09,101,,SAS,L 101-119,240,40,70,.571,36,58,.621,4,12,.333,17,24,.708,101,47,89,.528,41,75,.547,6,14,.429,19,26,.731,119
1346,DEN,2016-02-07,101,@,NYK,W 101-96,240,37,86,.430,32,65,.492,5,21,.238,22,28,.786,101,37,84,.440,29,62,.468,8,22,.364,14,20,.700,96
1347,CHO,2016-01-31,101,@,LAL,W 101-82,240,36,96,.375,23,60,.383,13,36,.361,16,26,.615,101,27,80,.338,19,51,.373,8,29,.276,20,23,.870,82
1348,DET,2016-01-23,101,@,DEN,L 101-104,240,40,84,.476,29,55,.527,11,29,.379,10,19,.526,101,36,78,.462,28,56,.500,8,22,.364,24,29,.828,104
1349,MEM,2016-01-23,101,@,MIN,L 101-106,240,37,79,.468,28,60,.467,9,19,.474,18,22,.818,101,34,68,.500,29,51,.569,5,17,.294,33,36,.917,106
1350,TOR,2016-01-22,101,,MIA,W 101-81,240,35,75,.467,22,50,.440,13,25,.520,18,21,.857,101,33,81,.407,29,64,.453,4,17,.235,11,17,.647,81
1351,CHI,2016-01-22,101,@,BOS,L 101-110,240,38,89,.427,35,76,.461,3,13,.231,22,26,.846,101,43,96,.448,35,73,.479,8,23,.348,16,21,.762,110
1352,DEN,2016-01-21,101,,MEM,L 101-102,240,36,80,.450,27,50,.540,9,30,.300,20,26,.769,101,36,72,.500,30,51,.588,6,21,.286,24,29,.828,102
1353,MEM,2016-01-18,101,,NOP,W 101-99,240,35,75,.467,27,56,.482,8,19,.421,23,30,.767,101,36,74,.486,30,55,.545,6,19,.316,21,23,.913,99
1354,DET,2016-01-18,101,,CHI,L 101-111,240,42,95,.442,37,69,.536,5,26,.192,12,20,.600,101,44,84,.524,35,63,.556,9,21,.429,14,20,.700,111
1355,ATL,2016-01-15,101,@,MIL,L 101-108 (OT),265,43,100,.430,34,70,.486,9,30,.300,6,6,1.000,101,40,96,.417,37,86,.430,3,10,.300,25,37,.676,108
1356,DET,2016-01-14,101,@,MEM,L 101-103,240,37,72,.514,22,40,.550,15,32,.469,12,17,.706,101,37,76,.487,28,60,.467,9,16,.563,20,25,.800,103
1357,UTA,2016-01-14,101,,SAC,L 101-103,240,35,83,.422,29,49,.592,6,34,.176,25,34,.735,101,34,74,.459,29,63,.460,5,11,.455,30,42,.714,103
1358,MIL,2016-01-13,101,@,WAS,L 101-106,240,38,72,.528,37,64,.578,1,8,.125,24,34,.706,101,38,84,.452,26,57,.456,12,27,.444,18,24,.750,106
1359,CHI,2016-01-12,101,@,MIL,L 101-106,240,35,85,.412,23,56,.411,12,29,.414,19,24,.792,101,43,93,.462,40,80,.500,3,13,.231,17,28,.607,106
1360,OKC,2016-01-12,101,@,MIN,W 101-96,240,39,84,.464,30,62,.484,9,22,.409,14,18,.778,101,36,81,.444,29,63,.460,7,18,.389,17,23,.739,96
1361,MEM,2016-01-10,101,,BOS,W 101-98,240,31,84,.369,27,68,.397,4,16,.250,35,40,.875,101,37,88,.420,30,66,.455,7,22,.318,17,23,.739,98
1362,CHI,2016-01-07,101,,BOS,W 101-92,240,39,94,.415,30,72,.417,9,22,.409,14,17,.824,101,35,98,.357,30,73,.411,5,25,.200,17,22,.773,92
1363,ATL,2016-01-05,101,,NYK,L 101-107,240,37,87,.425,22,48,.458,15,39,.385,12,19,.632,101,40,84,.476,35,66,.530,5,18,.278,22,24,.917,107
1364,CHO,2016-01-04,101,@,GSW,L 101-111,240,38,86,.442,31,65,.477,7,21,.333,18,19,.947,101,45,87,.517,30,53,.566,15,34,.441,6,6,1.000,111
1365,SAS,2015-12-28,101,,MIN,W 101-95,240,37,72,.514,32,55,.582,5,17,.294,22,28,.786,101,39,82,.476,36,71,.507,3,11,.273,14,24,.583,95
1366,CLE,2015-12-28,101,@,PHO,W 101-97,240,33,71,.465,16,30,.533,17,41,.415,18,25,.720,101,36,79,.456,25,54,.463,11,25,.440,14,20,.700,97
1367,SAS,2015-12-26,101,,DEN,W 101-86,240,39,81,.481,32,71,.451,7,10,.700,16,17,.941,101,38,86,.442,33,68,.485,5,18,.278,5,6,.833,86
1368,ORL,2015-12-26,101,,MIA,L 101-108,240,43,79,.544,34,60,.567,9,19,.474,6,13,.462,101,38,77,.494,28,57,.491,10,20,.500,22,23,.957,108
1369,HOU,2015-12-23,101,@,ORL,L 101-104,240,41,83,.494,34,54,.630,7,29,.241,12,17,.706,101,44,84,.524,37,68,.544,7,16,.438,9,13,.692,104
1370,MIL,2015-12-20,101,@,PHO,W 101-95,240,41,79,.519,36,63,.571,5,16,.313,14,24,.583,101,33,74,.446,25,56,.446,8,18,.444,21,24,.875,95
1371,CHO,2015-12-19,101,@,WAS,L 101-109,240,39,93,.419,29,60,.483,10,33,.303,13,16,.813,101,40,79,.506,31,59,.525,9,20,.450,20,23,.870,109
1372,BOS,2015-12-18,101,,ATL,L 101-109,240,34,77,.442,24,54,.444,10,23,.435,23,31,.742,101,41,88,.466,37,68,.544,4,20,.200,23,29,.793,109
1373,NOP,2015-12-14,101,@,POR,L 101-105,240,36,82,.439,28,57,.491,8,25,.320,21,27,.778,101,35,81,.432,22,49,.449,13,32,.406,22,29,.759,105
1374,MIN,2015-12-13,101,@,PHO,L 101-108,240,33,73,.452,25,54,.463,8,19,.421,27,34,.794,101,39,87,.448,29,57,.509,10,30,.333,20,24,.833,108
1375,CHI,2015-12-07,101,,PHO,L 101-103,240,41,90,.456,35,69,.507,6,21,.286,13,18,.722,101,41,92,.446,34,75,.453,7,17,.412,14,17,.824,103
1376,ORL,2015-12-05,101,@,LAC,L 101-103,240,40,90,.444,34,70,.486,6,20,.300,15,18,.833,101,37,82,.451,25,51,.490,12,31,.387,17,25,.680,103
1377,NOP,2015-12-02,101,@,HOU,L 101-108,240,36,88,.409,29,63,.460,7,25,.280,22,25,.880,101,36,87,.414,28,60,.467,8,27,.296,28,39,.718,108
1378,SAC,2015-11-28,101,@,GSW,L 101-120,240,39,100,.390,29,75,.387,10,25,.400,13,15,.867,101,39,80,.488,23,50,.460,16,30,.533,26,31,.839,120
1379,UTA,2015-11-28,101,,NOP,W 101-87,240,38,82,.463,29,64,.453,9,18,.500,16,21,.762,101,29,69,.420,24,52,.462,5,17,.294,24,30,.800,87
1380,MEM,2015-11-27,101,,ATL,L 101-116,240,35,80,.438,23,50,.460,12,30,.400,19,21,.905,101,35,75,.467,21,36,.583,14,39,.359,32,36,.889,116
1381,MIN,2015-11-27,101,@,SAC,W 101-91,240,37,77,.481,28,52,.538,9,25,.360,18,19,.947,101,37,86,.430,29,64,.453,8,22,.364,9,15,.600,91
1382,CHO,2015-11-25,101,,WAS,W 101-87,240,39,83,.470,31,57,.544,8,26,.308,15,15,1.000,101,31,87,.356,21,55,.382,10,32,.313,15,18,.833,87
1383,BOS,2015-11-22,101,@,BRK,L 101-111,240,35,82,.427,21,45,.467,14,37,.378,17,21,.810,101,40,79,.506,35,64,.547,5,15,.333,26,33,.788,111
1384,MIN,2015-11-18,101,@,ORL,L 101-104 (OT),265,36,85,.424,32,67,.478,4,18,.222,25,30,.833,101,41,110,.373,32,89,.360,9,21,.429,13,21,.619,104
1385,LAL,2015-11-16,101,@,PHO,L 101-120,240,37,77,.481,28,57,.491,9,20,.450,18,20,.900,101,45,93,.484,34,63,.540,11,30,.367,19,25,.760,120
1386,TOR,2015-11-15,101,@,SAC,L 101-107,240,38,87,.437,23,56,.411,15,31,.484,10,14,.714,101,39,76,.513,29,51,.569,10,25,.400,19,24,.792,107
1387,LAC,2015-11-14,101,,DET,W 101-96,240,37,79,.468,30,60,.500,7,19,.368,20,26,.769,101,33,74,.446,26,47,.553,7,27,.259,23,35,.657,96
1388,MEM,2015-11-13,101,,POR,W 101-100,240,36,86,.419,30,70,.429,6,16,.375,23,27,.852,101,33,69,.478,25,47,.532,8,22,.364,26,29,.897,100
1389,SAC,2015-11-11,101,,DET,W 101-92,240,37,74,.500,28,58,.483,9,16,.563,18,24,.750,101,34,89,.382,25,57,.439,9,32,.281,15,20,.750,92
1390,POR,2015-11-11,101,,SAS,L 101-113,240,39,88,.443,30,66,.455,9,22,.409,14,23,.609,101,46,82,.561,39,67,.582,7,15,.467,14,18,.778,113
1391,ORL,2015-11-11,101,,LAL,W 101-99,240,40,100,.400,27,72,.375,13,28,.464,8,12,.667,101,39,79,.494,32,57,.561,7,22,.318,14,18,.778,99
1392,MIA,2015-11-10,101,,LAL,W 101-88,240,38,84,.452,33,64,.516,5,20,.250,20,27,.741,101,34,77,.442,23,55,.418,11,22,.500,9,12,.750,88
1393,WAS,2015-11-10,101,,OKC,L 101-125,240,38,97,.392,33,73,.452,5,24,.208,20,26,.769,101,44,86,.512,29,63,.460,15,23,.652,22,29,.759,125
1394,CLE,2015-11-08,101,,IND,W 101-97,240,38,83,.458,30,59,.508,8,24,.333,17,25,.680,101,39,90,.433,33,72,.458,6,18,.333,13,19,.684,97
1395,ATL,2015-11-04,101,,BRK,W 101-87,240,37,76,.487,29,54,.537,8,22,.364,19,24,.792,101,36,83,.434,31,62,.500,5,21,.238,10,13,.769,87
1396,MIN,2015-11-02,101,,POR,L 101-106,240,34,79,.430,31,66,.470,3,13,.231,30,39,.769,101,41,89,.461,32,59,.542,9,30,.300,15,20,.750,106
1397,MEM,2015-10-31,101,,BRK,W 101-91,240,34,80,.425,25,57,.439,9,23,.391,24,28,.857,101,38,79,.481,35,66,.530,3,13,.231,12,18,.667,91
1398,PHO,2015-10-31,101,@,POR,W 101-90,240,39,94,.415,28,62,.452,11,32,.344,12,16,.750,101,33,79,.418,25,49,.510,8,30,.267,16,28,.571,90
1399,NYK,2015-10-29,101,,ATL,L 101-112,240,38,93,.409,32,64,.500,6,29,.207,19,21,.905,101,42,83,.506,32,59,.542,10,24,.417,18,26,.692,112
1400,BOS,2016-04-11,100,,CHO,L 100-114,240,34,89,.382,26,65,.400,8,24,.333,24,29,.828,100,41,81,.506,27,49,.551,14,32,.438,18,22,.818,114
1401,UTA,2016-04-10,100,@,DEN,W 100-84,240,36,79,.456,24,48,.500,12,31,.387,16,21,.762,100,32,80,.400,26,53,.491,6,27,.222,14,19,.737,84
1402,GSW,2016-04-09,100,@,MEM,W 100-99,240,39,87,.448,29,51,.569,10,36,.278,12,13,.923,100,37,96,.385,30,75,.400,7,21,.333,18,20,.900,99
1403,NOP,2016-04-09,100,,PHO,L 100-121,240,39,95,.411,32,74,.432,7,21,.333,15,20,.750,100,43,83,.518,33,58,.569,10,25,.400,25,31,.806,121
1404,LAL,2016-04-03,100,,BOS,L 100-107,240,37,90,.411,31,69,.449,6,21,.286,20,29,.690,100,41,91,.451,33,61,.541,8,30,.267,17,22,.773,107
1405,CHO,2016-04-01,100,,PHI,W 100-91,240,36,84,.429,29,57,.509,7,27,.259,21,27,.778,100,33,90,.367,23,51,.451,10,39,.256,15,21,.714,91
1406,HOU,2016-03-31,100,,CHI,L 100-103,240,36,90,.400,27,65,.415,9,25,.360,19,22,.864,100,37,77,.481,26,53,.491,11,24,.458,18,22,.818,103
1407,SAS,2016-03-30,100,,NOP,W 100-92,240,36,75,.480,24,51,.471,12,24,.500,16,22,.727,100,36,80,.450,28,63,.444,8,17,.471,12,18,.667,92
1408,MIA,2016-03-30,100,@,LAL,L 100-102 (OT),265,41,86,.477,38,69,.551,3,17,.176,15,26,.577,100,37,102,.363,31,82,.378,6,20,.300,22,29,.759,102
1409,CHO,2016-03-29,100,@,PHI,W 100-85,240,38,87,.437,31,62,.500,7,25,.280,17,18,.944,100,30,96,.313,14,52,.269,16,44,.364,9,10,.900,85
1410,CLE,2016-03-29,100,,HOU,L 100-106,240,31,86,.360,17,46,.370,14,40,.350,24,28,.857,100,38,79,.481,29,54,.537,9,25,.360,21,42,.500,106
1411,CHI,2016-03-28,100,,ATL,L 100-102,240,40,106,.377,31,84,.369,9,22,.409,11,15,.733,100,36,85,.424,31,63,.492,5,22,.227,25,28,.893,102
1412,TOR,2016-03-28,100,,OKC,L 100-119,240,38,93,.409,30,69,.435,8,24,.333,16,23,.696,100,41,86,.477,30,60,.500,11,26,.423,26,32,.813,119
1413,BRK,2016-03-22,100,,CHO,L 100-105,240,34,74,.459,26,56,.464,8,18,.444,24,27,.889,100,39,82,.476,29,54,.537,10,28,.357,17,21,.810,105
1414,MEM,2016-03-22,100,@,LAL,L 100-107,240,40,80,.500,36,65,.554,4,15,.267,16,23,.696,100,39,77,.506,33,58,.569,6,19,.316,23,24,.958,107
1415,ORL,2016-03-20,100,@,TOR,L 100-105,240,40,83,.482,32,61,.525,8,22,.364,12,18,.667,100,35,81,.432,29,61,.475,6,20,.300,29,45,.644,105
1416,BRK,2016-03-13,100,,MIL,L 100-109,240,39,70,.557,27,43,.628,12,27,.444,10,13,.769,100,45,89,.506,39,75,.520,6,14,.429,13,21,.619,109
1417,WAS,2016-03-12,100,@,DEN,L 100-116,240,36,86,.419,29,65,.446,7,21,.333,21,29,.724,100,42,80,.525,34,56,.607,8,24,.333,24,29,.828,116
1418,SAC,2016-03-11,100,,ORL,L 100-107,240,35,88,.398,27,63,.429,8,25,.320,22,25,.880,100,41,79,.519,37,64,.578,4,15,.267,21,34,.618,107
1419,CHI,2016-03-07,100,,MIL,W 100-90,240,39,78,.500,29,53,.547,10,25,.400,12,15,.800,100,36,91,.396,29,73,.397,7,18,.389,11,17,.647,90
1420,MEM,2016-03-06,100,,PHO,L 100-109,240,32,80,.400,22,58,.379,10,22,.455,26,33,.788,100,37,71,.521,25,43,.581,12,28,.429,23,30,.767,109
1421,IND,2016-03-05,100,@,WAS,W 100-99,240,37,83,.446,30,62,.484,7,21,.333,19,20,.950,100,39,89,.438,33,74,.446,6,15,.400,15,24,.625,99
1422,HOU,2016-03-05,100,@,CHI,L 100-108,240,35,87,.402,26,52,.500,9,35,.257,21,30,.700,100,36,79,.456,27,58,.466,9,21,.429,27,34,.794,108
1423,HOU,2016-03-02,100,,NOP,W 100-95,240,36,81,.444,33,46,.717,3,35,.086,25,38,.658,100,36,90,.400,22,53,.415,14,37,.378,9,13,.692,95
1424,CLE,2016-02-29,100,,IND,W 100-96,240,35,83,.422,26,54,.481,9,29,.310,21,25,.840,100,37,80,.463,29,62,.468,8,18,.444,14,15,.933,96
1425,BOS,2016-02-29,100,,UTA,W 100-95,240,37,84,.440,31,66,.470,6,18,.333,20,29,.690,100,38,101,.376,31,77,.403,7,24,.292,12,17,.706,95
1426,PHO,2016-02-19,100,,HOU,L 100-116,240,30,82,.366,19,47,.404,11,35,.314,29,35,.829,100,37,78,.474,30,54,.556,7,24,.292,35,56,.625,116
1427,NOP,2016-02-10,100,,UTA,W 100-96,240,39,82,.476,31,63,.492,8,19,.421,14,21,.667,100,33,70,.471,26,49,.531,7,21,.333,23,30,.767,96
1428,SAC,2016-02-08,100,@,CLE,L 100-120,240,36,82,.439,27,59,.458,9,23,.391,19,29,.655,100,45,94,.479,29,59,.492,16,35,.457,14,19,.737,120
1429,LAC,2016-02-07,100,@,MIA,W 100-93,240,37,81,.457,28,56,.500,9,25,.360,17,33,.515,100,33,83,.398,26,66,.394,7,17,.412,20,29,.690,93
1430,BRK,2016-02-03,100,,IND,L 100-114,240,36,81,.444,29,58,.500,7,23,.304,21,31,.677,100,44,88,.500,32,64,.500,12,24,.500,14,17,.824,114
1431,BRK,2016-02-01,100,,DET,L 100-105,240,40,82,.488,33,66,.500,7,16,.438,13,15,.867,100,42,98,.429,32,68,.471,10,30,.333,11,16,.688,105
1432,ORL,2016-01-26,100,@,MIL,L 100-107,240,33,80,.413,20,56,.357,13,24,.542,21,29,.724,100,38,77,.494,33,64,.516,5,13,.385,26,31,.839,107
1433,BRK,2016-01-18,100,@,TOR,L 100-112,240,39,76,.513,34,62,.548,5,14,.357,17,19,.895,100,43,85,.506,30,61,.492,13,24,.542,13,18,.722,112
1434,CHI,2016-01-11,100,,WAS,L 100-114,240,34,81,.420,25,59,.424,9,22,.409,23,27,.852,100,48,99,.485,39,75,.520,9,24,.375,9,10,.900,114
1435,NYK,2016-01-10,100,,MIL,W 100-88,240,39,84,.464,32,60,.533,7,24,.292,15,18,.833,100,32,80,.400,29,67,.433,3,13,.231,21,30,.700,88
1436,SAS,2016-01-08,100,,NYK,W 100-99,240,41,93,.441,37,80,.463,4,13,.308,14,17,.824,100,38,91,.418,29,70,.414,9,21,.429,14,17,.824,99
1437,DAL,2016-01-06,100,@,NOP,W 100-91,240,37,87,.425,30,59,.508,7,28,.250,19,22,.864,100,34,92,.370,27,62,.435,7,30,.233,16,20,.800,91
1438,IND,2016-01-04,100,@,MIA,L 100-103 (OT),265,37,94,.394,29,66,.439,8,28,.286,18,25,.720,100,34,90,.378,29,68,.426,5,22,.227,30,39,.769,103
1439,TOR,2016-01-04,100,@,CLE,L 100-122,240,36,73,.493,28,54,.519,8,19,.421,20,29,.690,100,41,74,.554,24,41,.585,17,33,.515,23,26,.885,122
1440,BRK,2016-01-02,100,@,BOS,W 100-97,240,38,93,.409,35,75,.467,3,18,.167,21,22,.955,100,34,88,.386,27,56,.482,7,32,.219,22,28,.786,97
1441,IND,2015-12-30,100,@,CHI,L 100-102 (OT),265,37,97,.381,30,75,.400,7,22,.318,19,24,.792,100,37,86,.430,31,68,.456,6,18,.333,22,27,.815,102
1442,ORL,2015-12-30,100,,BRK,W 100-93,240,36,82,.439,27,56,.482,9,26,.346,19,21,.905,100,35,83,.422,32,63,.508,3,20,.150,20,22,.909,93
1443,BOS,2015-12-27,100,,NYK,W 100-91,240,36,85,.424,28,65,.431,8,20,.400,20,29,.690,100,33,89,.371,29,70,.414,4,19,.211,21,24,.875,91
1444,PHI,2015-12-23,100,@,MIL,L 100-113,240,37,81,.457,30,61,.492,7,20,.350,19,29,.655,100,51,85,.600,46,73,.630,5,12,.417,6,8,.750,113
1445,WAS,2015-12-23,100,,MEM,W 100-91,240,37,82,.451,26,57,.456,11,25,.440,15,19,.789,100,33,72,.458,30,55,.545,3,17,.176,22,32,.688,91
1446,DET,2015-12-23,100,@,ATL,L 100-107,240,38,89,.427,31,68,.456,7,21,.333,17,33,.515,100,43,89,.483,37,69,.536,6,20,.300,15,20,.750,107
1447,OKC,2015-12-21,100,@,LAC,W 100-99,240,40,85,.471,36,68,.529,4,17,.235,16,20,.800,100,41,87,.471,34,65,.523,7,22,.318,10,14,.714,99
1448,ORL,2015-12-20,100,,ATL,L 100-103,240,38,81,.469,34,69,.493,4,12,.333,20,24,.833,100,39,78,.500,28,56,.500,11,22,.500,14,20,.700,103
1449,MIN,2015-12-20,100,@,BRK,W 100-85,240,38,80,.475,35,68,.515,3,12,.250,21,24,.875,100,32,78,.410,27,57,.474,5,21,.238,16,20,.800,85
1450,OKC,2015-12-17,100,@,CLE,L 100-104,240,35,74,.473,29,54,.537,6,20,.300,24,28,.857,100,41,88,.466,29,59,.492,12,29,.414,10,13,.769,104
1451,MIN,2015-12-15,100,,DEN,L 100-112,240,36,77,.468,32,67,.478,4,10,.400,24,31,.774,100,41,73,.562,31,55,.564,10,18,.556,20,27,.741,112
1452,MIA,2015-12-14,100,@,ATL,W 100-88,240,40,89,.449,33,73,.452,7,16,.438,13,15,.867,100,33,84,.393,25,51,.490,8,33,.242,14,15,.933,88
1453,MIA,2015-12-13,100,,MEM,W 100-97,240,37,77,.481,30,55,.545,7,22,.318,19,23,.826,100,40,77,.519,33,58,.569,7,19,.368,10,14,.714,97
1454,BRK,2015-12-12,100,,LAC,L 100-105,240,35,79,.443,30,60,.500,5,19,.263,25,30,.833,100,43,86,.500,35,62,.565,8,24,.333,11,18,.611,105
1455,BRK,2015-12-10,100,,PHI,W 100-91,240,37,74,.500,31,60,.517,6,14,.429,20,27,.741,100,34,87,.391,30,56,.536,4,31,.129,19,22,.864,91
1456,CHI,2015-12-09,100,@,BOS,L 100-105,240,39,91,.429,33,70,.471,6,21,.286,16,23,.696,100,38,92,.413,33,69,.478,5,23,.217,24,28,.857,105
1457,POR,2015-12-08,100,@,CLE,L 100-105,240,40,79,.506,29,53,.547,11,26,.423,9,16,.563,100,40,79,.506,31,58,.534,9,21,.429,16,20,.800,105
1458,ATL,2015-12-04,100,,LAL,W 100-87,240,37,74,.500,27,48,.563,10,26,.385,16,20,.800,100,32,86,.372,19,59,.322,13,27,.481,10,13,.769,87
1459,HOU,2015-12-04,100,@,DAL,W 100-96,240,39,84,.464,27,58,.466,12,26,.462,10,18,.556,100,37,81,.457,29,52,.558,8,29,.276,14,20,.700,96
1460,OKC,2015-11-30,100,@,ATL,L 100-106,240,37,93,.398,30,74,.405,7,19,.368,19,22,.864,100,39,90,.433,29,62,.468,10,28,.357,18,20,.900,106
1461,ORL,2015-11-25,100,,NYK,W 100-91,240,34,86,.395,29,70,.414,5,16,.313,27,32,.844,100,31,83,.373,22,56,.393,9,27,.333,20,25,.800,91
1462,MIN,2015-11-23,100,,PHI,W 100-95,240,36,78,.462,33,66,.500,3,12,.250,25,27,.926,100,32,78,.410,22,47,.468,10,31,.323,21,27,.778,95
1463,MIL,2015-11-19,100,@,CLE,L 100-115,240,38,73,.521,35,65,.538,3,8,.375,21,26,.808,100,40,71,.563,29,47,.617,11,24,.458,24,30,.800,115
1464,BOS,2015-11-15,100,@,OKC,W 100-85,240,39,82,.476,30,59,.508,9,23,.391,13,20,.650,100,28,77,.364,22,52,.423,6,25,.240,23,29,.793,85
1465,TOR,2015-11-13,100,,NOP,W 100-81,240,34,77,.442,25,56,.446,9,21,.429,23,27,.852,100,30,82,.366,23,59,.390,7,23,.304,14,20,.700,81
1466,POR,2015-11-13,100,@,MEM,L 100-101,240,33,69,.478,25,47,.532,8,22,.364,26,29,.897,100,36,86,.419,30,70,.429,6,16,.375,23,27,.852,101
1467,GSW,2015-11-11,100,@,MEM,W 100-84,240,36,75,.480,25,48,.521,11,27,.407,17,23,.739,100,24,70,.343,21,55,.382,3,15,.200,33,36,.917,84
1468,DET,2015-11-06,100,@,PHO,W 100-92,240,37,74,.500,29,52,.558,8,22,.364,18,36,.500,100,37,92,.402,27,62,.435,10,30,.333,8,13,.615,92
1469,IND,2015-11-04,100,,BOS,W 100-98,240,35,91,.385,27,68,.397,8,23,.348,22,29,.759,100,35,83,.422,25,56,.446,10,27,.370,18,22,.818,98
1470,PHI,2015-11-02,100,,CLE,L 100-107,240,38,85,.447,31,61,.508,7,24,.292,17,23,.739,100,42,81,.519,34,59,.576,8,22,.364,15,20,.750,107
1471,BRK,2015-10-28,100,,CHI,L 100-115,240,39,93,.419,39,84,.464,0,9,.000,22,28,.786,100,42,78,.538,28,50,.560,14,28,.500,17,20,.850,115
1472,DEN,2016-04-13,99,@,POR,L 99-107,240,40,94,.426,33,69,.478,7,25,.280,12,18,.667,99,39,89,.438,28,53,.528,11,36,.306,18,22,.818,107
1473,MIA,2016-04-12,99,@,DET,W 99-93,240,38,78,.487,31,58,.534,7,20,.350,16,22,.727,99,34,84,.405,29,66,.439,5,18,.278,20,30,.667,93
1474,MEM,2016-04-09,99,,GSW,L 99-100,240,37,96,.385,30,75,.400,7,21,.333,18,20,.900,99,39,87,.448,29,51,.569,10,36,.278,12,13,.923,100
1475,WAS,2016-04-08,99,@,DET,L 99-112,240,38,86,.442,32,67,.478,6,19,.316,17,23,.739,99,36,77,.468,22,45,.489,14,32,.438,26,29,.897,112
1476,BRK,2016-04-08,99,@,CHO,L 99-113,240,39,92,.424,29,67,.433,10,25,.400,11,20,.550,99,41,83,.494,27,46,.587,14,37,.378,17,20,.850,113
1477,UTA,2016-04-08,99,,LAC,L 99-102 (OT),265,36,82,.439,25,51,.490,11,31,.355,16,23,.696,99,37,83,.446,24,54,.444,13,29,.448,15,19,.789,102
1478,PHO,2016-04-01,99,,WAS,L 99-106,240,36,93,.387,29,70,.414,7,23,.304,20,26,.769,99,38,86,.442,28,60,.467,10,26,.385,20,25,.800,106
1479,TOR,2016-04-01,99,@,MEM,W 99-95,240,30,71,.423,18,43,.419,12,28,.429,27,29,.931,99,37,91,.407,30,72,.417,7,19,.368,14,17,.824,95
1480,LAC,2016-03-30,99,@,MIN,W 99-79,240,37,84,.440,28,53,.528,9,31,.290,16,18,.889,99,30,87,.345,22,64,.344,8,23,.348,11,17,.647,79
1481,BRK,2016-03-28,99,@,MIA,L 99-110,240,41,77,.532,38,66,.576,3,11,.273,14,18,.778,99,48,84,.571,43,68,.632,5,16,.313,9,12,.750,110
1482,NOP,2016-03-28,99,,NYK,W 99-91,240,32,75,.427,24,56,.429,8,19,.421,27,37,.730,99,36,89,.404,26,58,.448,10,31,.323,9,13,.692,91
1483,PHO,2016-03-26,99,,BOS,L 99-102,240,37,85,.435,30,54,.556,7,31,.226,18,21,.857,99,35,84,.417,27,55,.491,8,29,.276,24,27,.889,102
1484,NOP,2016-03-22,99,,MIA,L 99-113,240,34,87,.391,27,71,.380,7,16,.438,24,30,.800,99,44,88,.500,41,69,.594,3,19,.158,22,27,.815,113
1485,WAS,2016-03-19,99,,NYK,W 99-89,240,39,87,.448,31,58,.534,8,29,.276,13,17,.765,99,32,81,.395,22,60,.367,10,21,.476,15,17,.882,89
1486,WAS,2016-03-17,99,@,PHI,W 99-94,240,40,90,.444,34,63,.540,6,27,.222,13,19,.684,99,35,91,.385,29,58,.500,6,33,.182,18,26,.692,94
1487,ORL,2016-03-16,99,@,CHO,L 99-107,240,35,83,.422,24,58,.414,11,25,.440,18,21,.857,99,40,100,.400,29,63,.460,11,37,.297,16,21,.762,107
1488,CLE,2016-03-16,99,,DAL,W 99-98,240,39,88,.443,29,51,.569,10,37,.270,11,13,.846,99,37,79,.468,30,57,.526,7,22,.318,17,19,.895,98
1489,SAC,2016-03-13,99,,UTA,L 99-108,240,38,81,.469,29,60,.483,9,21,.429,14,21,.667,99,39,82,.476,27,54,.500,12,28,.429,18,22,.818,108
1490,MIN,2016-03-11,99,@,OKC,W 99-96,240,37,86,.430,30,65,.462,7,21,.333,18,21,.857,99,36,84,.429,30,57,.526,6,27,.222,18,25,.720,96
1491,BRK,2016-03-08,99,@,TOR,L 99-104,240,42,82,.512,36,70,.514,6,12,.500,9,9,1.000,99,37,78,.474,27,55,.491,10,23,.435,20,25,.800,104
1492,IND,2016-03-07,99,,SAS,W 99-91,240,32,78,.410,25,62,.403,7,16,.438,28,30,.933,99,34,96,.354,30,68,.441,4,28,.143,19,22,.864,91
1493,WAS,2016-03-05,99,,IND,L 99-100,240,39,89,.438,33,74,.446,6,15,.400,15,24,.625,99,37,83,.446,30,62,.484,7,21,.333,19,20,.950,100
1494,PHI,2016-03-02,99,,CHO,L 99-119,240,34,85,.400,21,52,.404,13,33,.394,18,26,.692,99,40,81,.494,30,56,.536,10,25,.400,29,35,.829,119
1495,MIL,2016-03-02,99,,IND,L 99-104,240,34,76,.447,31,62,.500,3,14,.214,28,32,.875,99,38,80,.475,28,60,.467,10,20,.500,18,26,.692,104
1496,CLE,2016-02-28,99,@,WAS,L 99-113,240,32,80,.400,23,51,.451,9,29,.310,26,30,.867,99,39,79,.494,28,48,.583,11,31,.355,24,34,.706,113
1497,TOR,2016-02-26,99,,CLE,W 99-97,240,37,73,.507,31,56,.554,6,17,.353,19,26,.731,99,35,74,.473,23,50,.460,12,24,.500,15,21,.714,97
1498,MIL,2016-02-11,99,,WAS,W 99-92,240,36,82,.439,32,68,.471,4,14,.286,23,32,.719,99,34,88,.386,28,56,.500,6,32,.188,18,24,.750,92
1499,CLE,2016-02-06,99,,NOP,W 99-84,240,39,90,.433,25,49,.510,14,41,.341,7,7,1.000,99,34,87,.391,29,64,.453,5,23,.217,11,16,.688,84
1500,LAL,2016-02-04,99,@,NOP,W 99-96,240,39,81,.481,32,61,.525,7,20,.350,14,20,.700,99,39,85,.459,35,65,.538,4,20,.200,14,26,.538,96
1501,HOU,2016-01-27,99,@,SAS,L 99-130,240,28,73,.384,20,43,.465,8,30,.267,35,52,.673,99,50,90,.556,38,67,.567,12,23,.522,18,21,.857,130
1502,MIL,2016-01-23,99,@,NOP,L 99-116,240,39,74,.527,33,59,.559,6,15,.400,15,18,.833,99,43,94,.457,26,63,.413,17,31,.548,13,17,.765,116
1503,DET,2016-01-21,99,@,NOP,L 99-115,240,38,91,.418,31,61,.508,7,30,.233,16,20,.800,99,46,86,.535,41,74,.554,5,12,.417,18,18,1.000,115
1504,MIN,2016-01-19,99,@,NOP,L 99-114,240,36,76,.474,33,62,.532,3,14,.214,24,31,.774,99,42,83,.506,32,60,.533,10,23,.435,20,23,.870,114
1505,NOP,2016-01-18,99,@,MEM,L 99-101,240,36,74,.486,30,55,.545,6,19,.316,21,23,.913,99,35,75,.467,27,56,.482,8,19,.421,23,30,.767,101
1506,OKC,2016-01-17,99,,MIA,W 99-74,240,40,88,.455,33,66,.500,7,22,.318,12,12,1.000,99,30,72,.417,26,58,.448,4,14,.286,10,11,.909,74
1507,SAS,2016-01-14,99,,CLE,W 99-95,240,38,83,.458,33,66,.500,5,17,.294,18,22,.818,99,38,82,.463,28,56,.500,10,26,.385,9,11,.818,95
1508,POR,2016-01-13,99,,UTA,W 99-85,240,39,88,.443,28,62,.452,11,26,.423,10,15,.667,99,31,76,.408,23,57,.404,8,19,.421,15,22,.682,85
1509,DET,2016-01-12,99,,SAS,L 99-109,240,38,91,.418,32,68,.471,6,23,.261,17,26,.654,99,41,85,.482,36,71,.507,5,14,.357,22,27,.815,109
1510,ORL,2016-01-09,99,,WAS,L 99-105,240,38,74,.514,33,60,.550,5,14,.357,18,24,.750,99,42,76,.553,29,53,.547,13,23,.565,8,10,.800,105
1511,NYK,2016-01-08,99,@,SAS,L 99-100,240,38,91,.418,29,70,.414,9,21,.429,14,17,.824,99,41,93,.441,37,80,.463,4,13,.308,14,17,.824,100
1512,MIN,2016-01-08,99,,CLE,L 99-125,240,36,79,.456,29,63,.460,7,16,.438,20,26,.769,99,43,81,.531,30,54,.556,13,27,.481,26,29,.897,125
1513,DET,2016-01-06,99,@,BOS,W 99-94,240,33,74,.446,23,47,.489,10,27,.370,23,36,.639,99,34,91,.374,28,63,.444,6,28,.214,20,27,.741,94
1514,MIN,2016-01-04,99,@,PHI,L 99-109,240,39,73,.534,37,68,.544,2,5,.400,19,24,.792,99,48,87,.552,44,67,.657,4,20,.200,9,14,.643,109
1515,PHI,2016-01-02,99,@,LAC,L 99-130,240,41,89,.461,32,66,.485,9,23,.391,8,17,.471,99,49,81,.605,37,58,.638,12,23,.522,20,25,.800,130
1516,MEM,2015-12-29,99,,MIA,W 99-90 (OT),265,38,87,.437,34,72,.472,4,15,.267,19,20,.950,99,35,79,.443,24,50,.480,11,29,.379,9,18,.500,90
1517,BOS,2015-12-26,99,@,DET,W 99-93,240,39,84,.464,35,61,.574,4,23,.174,17,23,.739,99,35,91,.385,29,66,.439,6,25,.240,17,25,.680,93
1518,DAL,2015-12-22,99,@,TOR,L 99-103,240,40,92,.435,29,63,.460,11,29,.379,8,11,.727,99,35,74,.473,23,48,.479,12,26,.462,21,27,.778,103
1519,MIN,2015-12-21,99,@,BOS,L 99-113,240,36,79,.456,34,66,.515,2,13,.154,25,32,.781,99,46,89,.517,34,64,.531,12,25,.480,9,16,.563,113
1520,LAC,2015-12-21,99,,OKC,L 99-100,240,41,87,.471,34,65,.523,7,22,.318,10,14,.714,99,40,85,.471,36,68,.529,4,17,.235,16,20,.800,100
1521,SAC,2015-12-21,99,@,WAS,L 99-113,240,37,91,.407,30,69,.435,7,22,.318,18,22,.818,99,42,83,.506,28,59,.475,14,24,.583,15,17,.882,113
1522,NYK,2015-12-21,99,,ORL,L 99-107,240,39,76,.513,32,52,.615,7,24,.292,14,16,.875,99,44,86,.512,34,64,.531,10,22,.455,9,11,.818,107
1523,MIN,2015-12-18,99,,SAC,W 99-95,240,39,82,.476,33,64,.516,6,18,.333,15,16,.938,99,38,81,.469,31,58,.534,7,23,.304,12,17,.706,95
1524,TOR,2015-12-17,99,@,CHO,L 99-109 (OT),265,35,97,.361,26,58,.448,9,39,.231,20,28,.714,99,37,85,.435,27,56,.482,10,29,.345,25,31,.806,109
1525,MEM,2015-12-11,99,,CHO,L 99-123,240,32,80,.400,25,60,.417,7,20,.350,28,37,.757,99,39,78,.500,21,41,.512,18,37,.486,27,30,.900,123
1526,SAC,2015-12-10,99,,NYK,W 99-97,240,42,93,.452,39,77,.506,3,16,.188,12,16,.750,99,33,83,.398,24,54,.444,9,29,.310,22,28,.786,97
1527,CHO,2015-12-09,99,,MIA,W 99-81,240,40,81,.494,29,54,.537,11,27,.407,8,17,.471,99,29,75,.387,23,54,.426,6,21,.286,17,24,.708,81
1528,MIA,2015-12-05,99,,CLE,W 99-84,240,37,68,.544,30,52,.577,7,16,.438,18,29,.621,99,31,85,.365,25,57,.439,6,28,.214,16,24,.667,84
1529,NYK,2015-12-02,99,,PHI,W 99-87,240,38,88,.432,34,69,.493,4,19,.211,19,22,.864,99,32,86,.372,23,56,.411,9,30,.300,14,24,.583,87
1530,CHO,2015-12-02,99,,GSW,L 99-116,240,35,94,.372,26,63,.413,9,31,.290,20,30,.667,99,46,88,.523,30,54,.556,16,34,.471,8,11,.727,116
1531,CHI,2015-12-02,99,,DEN,W 99-90,240,36,89,.404,30,72,.417,6,17,.353,21,27,.778,99,36,93,.387,31,78,.397,5,15,.333,13,22,.591,90
1532,MIN,2015-11-29,99,@,LAC,L 99-107,240,37,82,.451,29,66,.439,8,16,.500,17,21,.810,99,39,75,.520,31,53,.585,8,22,.364,21,33,.636,107
1533,CLE,2015-11-25,99,@,TOR,L 99-103,240,36,82,.439,22,53,.415,14,29,.483,13,16,.813,99,40,79,.506,29,54,.537,11,25,.440,12,22,.545,103
1534,MIN,2015-11-25,99,,ATL,W 99-95,240,34,82,.415,25,61,.410,9,21,.429,22,29,.759,99,31,82,.378,23,51,.451,8,31,.258,25,35,.714,95
1535,BRK,2015-11-25,99,@,OKC,L 99-110,240,43,94,.457,40,81,.494,3,13,.231,10,12,.833,99,41,78,.526,31,54,.574,10,24,.417,18,21,.857,110
1536,CLE,2015-11-17,99,@,DET,L 99-104,240,38,80,.475,27,47,.574,11,33,.333,12,20,.600,99,36,84,.429,29,63,.460,7,21,.333,25,31,.806,104
1537,ORL,2015-11-14,99,@,WAS,L 99-108,240,38,87,.437,34,69,.493,4,18,.222,19,24,.792,99,39,83,.470,27,54,.500,12,29,.414,18,26,.692,108
1538,BRK,2015-11-14,99,@,GSW,L 99-107 (OT),265,41,98,.418,39,80,.488,2,18,.111,15,16,.938,99,43,97,.443,31,63,.492,12,34,.353,9,10,.900,107
1539,LAL,2015-11-11,99,@,ORL,L 99-101,240,39,79,.494,32,57,.561,7,22,.318,14,18,.778,99,40,100,.400,27,72,.375,13,28,.464,8,12,.667,101
1540,BOS,2015-11-10,99,@,MIL,W 99-83,240,38,86,.442,31,56,.554,7,30,.233,16,19,.842,99,30,73,.411,24,56,.429,6,17,.353,17,23,.739,83
1541,NYK,2015-11-08,99,,LAL,W 99-95,240,33,84,.393,24,57,.421,9,27,.333,24,29,.828,99,36,94,.383,27,67,.403,9,27,.333,14,23,.609,95
1542,WAS,2015-11-07,99,@,ATL,L 99-114,240,38,78,.487,30,54,.556,8,24,.333,15,17,.882,99,43,92,.467,30,59,.508,13,33,.394,15,15,1.000,114
1543,MIL,2015-11-06,99,@,NYK,W 99-92,240,35,81,.432,32,67,.478,3,14,.214,26,29,.897,99,33,81,.407,29,57,.509,4,24,.167,22,28,.786,92
1544,SAS,2015-11-04,99,@,WAS,L 99-102,240,37,81,.457,30,59,.508,7,22,.318,18,20,.900,99,42,87,.483,34,64,.531,8,23,.348,10,14,.714,102
1545,UTA,2015-10-30,99,@,PHI,W 99-71,240,36,88,.409,29,75,.387,7,13,.538,20,25,.800,99,19,63,.302,13,48,.271,6,15,.400,27,37,.730,71
1546,IND,2015-10-28,99,@,TOR,L 99-106,240,32,86,.372,23,63,.365,9,23,.391,26,31,.839,99,36,80,.450,29,62,.468,7,18,.389,27,39,.692,106
1547,BOS,2016-04-13,98,,MIA,W 98-88,240,37,86,.430,32,72,.444,5,14,.357,19,22,.864,98,38,88,.432,36,69,.522,2,19,.105,10,12,.833,88
1548,ATL,2016-04-13,98,@,WAS,L 98-109,240,32,81,.395,21,52,.404,11,29,.379,23,31,.742,98,42,88,.477,33,60,.550,9,28,.321,16,30,.533,109
1549,OKC,2016-04-12,98,@,SAS,L 98-102 (OT),265,35,87,.402,29,62,.468,6,25,.240,22,25,.880,98,37,87,.425,33,73,.452,4,14,.286,24,32,.750,102
1550,PHI,2016-04-12,98,@,TOR,L 98-122,240,35,77,.455,20,42,.476,15,35,.429,13,25,.520,98,48,95,.505,38,70,.543,10,25,.400,16,19,.842,122
1551,MIL,2016-04-11,98,@,ORL,L 98-107,240,41,78,.526,38,63,.603,3,15,.200,13,19,.684,98,41,84,.488,34,61,.557,7,23,.304,18,28,.643,107
1552,LAC,2016-04-10,98,,DAL,W 98-91,240,37,76,.487,28,58,.483,9,18,.500,15,37,.405,98,30,74,.405,22,44,.500,8,30,.267,23,33,.697,91
1553,CHO,2016-04-10,98,@,WAS,L 98-113,240,28,81,.346,16,48,.333,12,33,.364,30,35,.857,98,42,80,.525,33,59,.559,9,21,.429,20,28,.714,113
1554,SAS,2016-04-08,98,@,DEN,L 98-102,240,36,85,.424,33,71,.465,3,14,.214,23,28,.821,98,40,86,.465,34,64,.531,6,22,.273,16,19,.842,102
1555,IND,2016-04-08,98,@,TOR,L 98-111,240,37,83,.446,29,56,.518,8,27,.296,16,20,.800,98,37,68,.544,27,46,.587,10,22,.455,27,38,.711,111
1556,CHI,2016-04-07,98,@,MIA,L 98-106,240,35,78,.449,32,64,.500,3,14,.214,25,28,.893,98,44,92,.478,40,78,.513,4,14,.286,14,17,.824,106
1557,MIL,2016-04-03,98,,CHI,L 98-102,240,40,85,.471,38,78,.487,2,7,.286,16,20,.800,98,39,74,.527,32,48,.667,7,26,.269,17,22,.773,102
1558,UTA,2016-04-01,98,,MIN,W 98-85,240,38,72,.528,30,50,.600,8,22,.364,14,23,.609,98,35,79,.443,26,56,.464,9,23,.391,6,10,.600,85
1559,DAL,2016-04-01,98,@,DET,W 98-89,240,39,85,.459,31,61,.508,8,24,.333,12,14,.857,98,31,81,.383,18,48,.375,13,33,.394,14,24,.583,89
1560,CHI,2016-03-29,98,@,IND,W 98-96,240,37,87,.425,27,61,.443,10,26,.385,14,16,.875,98,39,90,.433,36,71,.507,3,19,.158,15,17,.882,96
1561,LAC,2016-03-23,98,@,GSW,L 98-114,240,36,85,.424,28,57,.491,8,28,.286,18,27,.667,98,39,87,.448,24,53,.453,15,34,.441,21,28,.750,114
1562,DEN,2016-03-17,98,@,ATL,L 98-116,240,39,87,.448,33,65,.508,6,22,.273,14,17,.824,98,40,80,.500,28,54,.519,12,26,.462,24,28,.857,116
1563,DAL,2016-03-16,98,@,CLE,L 98-99,240,37,79,.468,30,57,.526,7,22,.318,17,19,.895,98,39,88,.443,29,51,.569,10,37,.270,11,13,.846,99
1564,BOS,2016-03-15,98,@,IND,L 98-103,240,36,94,.383,28,63,.444,8,31,.258,18,22,.818,98,39,84,.464,34,72,.472,5,12,.417,20,28,.714,103
1565,LAL,2016-03-15,98,,SAC,L 98-106,240,37,84,.440,32,58,.552,5,26,.192,19,26,.731,98,38,79,.481,34,61,.557,4,18,.222,26,33,.788,106
1566,BOS,2016-03-11,98,,HOU,L 98-102,240,34,91,.374,26,60,.433,8,31,.258,22,28,.786,98,40,88,.455,35,62,.565,5,26,.192,17,25,.680,102
1567,PHO,2016-03-10,98,@,DEN,L 98-116,240,33,89,.371,27,61,.443,6,28,.214,26,33,.788,98,44,91,.484,31,63,.492,13,28,.464,15,19,.789,116
1568,ORL,2016-03-08,98,@,LAL,L 98-107,240,37,76,.487,32,57,.561,5,19,.263,19,27,.704,98,40,81,.494,31,54,.574,9,27,.333,18,23,.783,107
1569,PHI,2016-03-06,98,@,MIA,L 98-103,240,37,85,.435,26,54,.481,11,31,.355,13,22,.591,98,36,81,.444,28,67,.418,8,14,.571,23,30,.767,103
1570,MIN,2016-03-02,98,,WAS,L 98-104,240,32,75,.427,27,61,.443,5,14,.357,29,34,.853,98,42,84,.500,31,55,.564,11,29,.379,9,13,.692,104
1571,SAC,2016-03-02,98,@,MEM,L 98-104,240,39,82,.476,30,56,.536,9,26,.346,11,20,.550,98,35,79,.443,30,61,.492,5,18,.278,29,33,.879,104
1572,OKC,2016-03-02,98,@,LAC,L 98-103,240,39,98,.398,29,63,.460,10,35,.286,10,11,.909,98,40,98,.408,31,66,.470,9,32,.281,14,21,.667,103
1573,MIA,2016-02-28,98,@,NYK,W 98-81,240,40,84,.476,39,76,.513,1,8,.125,17,21,.810,98,32,87,.368,26,72,.361,6,15,.400,11,12,.917,81
1574,BRK,2016-02-27,98,@,UTA,W 98-96,240,40,84,.476,33,69,.478,7,15,.467,11,17,.647,98,37,89,.416,32,69,.464,5,20,.250,17,25,.680,96
1575,TOR,2016-02-21,98,,MEM,W 98-85,240,33,81,.407,26,53,.491,7,28,.250,25,31,.806,98,28,76,.368,25,56,.446,3,20,.150,26,32,.813,85
1576,OKC,2016-02-19,98,,IND,L 98-101,240,42,96,.438,37,70,.529,5,26,.192,9,10,.900,98,39,88,.443,30,66,.455,9,22,.409,14,22,.636,101
1577,WAS,2016-02-19,98,,DET,W 98-86,240,36,78,.462,29,56,.518,7,22,.318,19,26,.731,98,35,82,.427,28,59,.475,7,23,.304,9,17,.529,86
1578,NYK,2016-02-19,98,@,BRK,L 98-109,240,36,82,.439,26,56,.464,10,26,.385,16,18,.889,98,42,86,.488,34,69,.493,8,17,.471,17,20,.850,109
1579,CHO,2016-02-19,98,@,MIL,W 98-95,240,37,86,.430,28,55,.509,9,31,.290,15,18,.833,98,36,81,.444,29,62,.468,7,19,.368,16,21,.762,95
1580,SAS,2016-02-10,98,@,ORL,W 98-96,240,38,89,.427,30,69,.435,8,20,.400,14,15,.933,98,37,91,.407,29,71,.408,8,20,.400,14,16,.875,96
1581,LAC,2016-02-08,98,@,PHI,W 98-92 (OT),265,35,95,.368,30,73,.411,5,22,.227,23,31,.742,98,34,90,.378,28,65,.431,6,25,.240,18,21,.857,92
1582,BRK,2016-02-06,98,@,PHI,L 98-103,240,35,76,.461,30,61,.492,5,15,.333,23,26,.885,98,38,81,.469,28,52,.538,10,29,.345,17,22,.773,103
1583,UTA,2016-02-06,98,@,PHO,W 98-89,240,34,78,.436,29,62,.468,5,16,.313,25,31,.806,98,30,80,.375,21,56,.375,9,24,.375,20,26,.769,89
1584,MIA,2016-02-05,98,@,CHO,W 98-95,240,43,94,.457,43,85,.506,0,9,.000,12,18,.667,98,36,81,.444,26,55,.473,10,26,.385,13,15,.867,95
1585,WAS,2016-02-01,98,@,OKC,L 98-114,240,40,86,.465,33,60,.550,7,26,.269,11,15,.733,98,43,83,.518,36,61,.590,7,22,.318,21,27,.778,114
1586,BRK,2016-01-26,98,,MIA,L 98-102,240,36,71,.507,27,53,.509,9,18,.500,17,23,.739,98,45,83,.542,42,74,.568,3,9,.333,9,10,.900,102
1587,PHO,2016-01-23,98,,ATL,W 98-95,240,34,85,.400,24,61,.393,10,24,.417,20,26,.769,98,34,84,.405,22,50,.440,12,34,.353,15,18,.833,95
1588,MIL,2016-01-22,98,@,HOU,L 98-102,240,39,85,.459,36,71,.507,3,14,.214,17,22,.773,98,38,94,.404,23,50,.460,15,44,.341,11,16,.688,102
1589,POR,2016-01-20,98,,ATL,L 98-104,240,41,94,.436,32,63,.508,9,31,.290,7,11,.636,98,39,87,.448,29,63,.460,10,24,.417,16,23,.696,104
1590,CLE,2016-01-18,98,,GSW,L 98-132,240,37,77,.481,30,58,.517,7,19,.368,17,25,.680,98,46,85,.541,27,45,.600,19,40,.475,21,27,.778,132
1591,ATL,2016-01-18,98,,ORL,W 98-81,240,41,80,.513,32,61,.525,9,19,.474,7,10,.700,98,30,87,.345,24,65,.369,6,22,.273,15,20,.750,81
1592,WAS,2016-01-18,98,,POR,L 98-108,240,37,77,.481,28,56,.500,9,21,.429,15,20,.750,98,43,84,.512,26,53,.491,17,31,.548,5,11,.455,108
1593,MIA,2016-01-15,98,@,DEN,W 98-95,240,40,81,.494,36,69,.522,4,12,.333,14,19,.737,98,32,78,.410,26,60,.433,6,18,.333,25,26,.962,95
1594,LAL,2016-01-14,98,@,GSW,L 98-116,240,40,90,.444,36,67,.537,4,23,.174,14,24,.583,98,43,86,.500,30,53,.566,13,33,.394,17,20,.850,116
1595,BOS,2016-01-10,98,@,MEM,L 98-101,240,37,88,.420,30,66,.455,7,22,.318,17,23,.739,98,31,84,.369,27,68,.397,4,16,.250,35,40,.875,101
1596,UTA,2016-01-09,98,,MIA,W 98-83,240,39,71,.549,30,51,.588,9,20,.450,11,18,.611,98,34,82,.415,28,63,.444,6,19,.316,9,17,.529,83
1597,PHI,2016-01-07,98,,ATL,L 98-126,240,39,86,.453,34,68,.500,5,18,.278,15,25,.600,98,49,92,.533,36,60,.600,13,32,.406,15,19,.789,126
1598,NYK,2016-01-06,98,@,MIA,W 98-90,240,39,70,.557,36,62,.581,3,8,.375,17,18,.944,98,37,82,.451,35,65,.538,2,17,.118,14,15,.933,90
1599,UTA,2016-01-06,98,@,SAS,L 98-123,240,37,79,.468,30,61,.492,7,18,.389,17,18,.944,98,52,86,.605,43,65,.662,9,21,.429,10,13,.769,123
1600,POR,2016-01-06,98,,LAC,L 98-109,240,38,86,.442,29,60,.483,9,26,.346,13,23,.565,98,42,83,.506,31,60,.517,11,23,.478,14,17,.824,109
1601,MIL,2016-01-04,98,,SAS,L 98-123,240,37,77,.481,34,65,.523,3,12,.250,21,30,.700,98,49,90,.544,40,70,.571,9,20,.450,16,20,.800,123
1602,DAL,2016-01-02,98,,NOP,L 98-105,240,36,83,.434,26,57,.456,10,26,.385,16,19,.842,98,40,83,.482,34,63,.540,6,20,.300,19,24,.792,105
1603,LAL,2015-12-28,98,@,CHO,L 98-108,240,35,85,.412,26,56,.464,9,29,.310,19,23,.826,98,43,89,.483,37,64,.578,6,25,.240,16,22,.727,108
1604,POR,2015-12-27,98,@,SAC,W 98-94,240,38,92,.413,28,59,.475,10,33,.303,12,16,.750,98,30,76,.395,21,52,.404,9,24,.375,25,31,.806,94
1605,CHO,2015-12-26,98,,MEM,W 98-92,240,28,69,.406,14,37,.378,14,32,.438,28,32,.875,98,37,90,.411,30,71,.423,7,19,.368,11,21,.524,92
1606,NYK,2015-12-26,98,@,ATL,L 98-117,240,39,81,.481,32,57,.561,7,24,.292,13,17,.765,98,47,88,.534,39,63,.619,8,25,.320,15,18,.833,117
1607,BRK,2015-12-16,98,,MIA,L 98-104,240,42,89,.472,38,73,.521,4,16,.250,10,14,.714,98,40,75,.533,33,54,.611,7,21,.333,17,24,.708,104
1608,CHO,2015-12-16,98,@,ORL,L 98-113,240,36,79,.456,22,45,.489,14,34,.412,12,15,.800,98,43,77,.558,29,53,.547,14,24,.583,13,15,.867,113
1609,CHI,2015-12-16,98,,MEM,W 98-85,240,38,86,.442,29,62,.468,9,24,.375,13,19,.684,98,32,76,.421,27,57,.474,5,19,.263,16,28,.571,85
1610,UTA,2015-12-13,98,@,OKC,L 98-104 (OT),265,39,94,.415,31,72,.431,8,22,.364,12,20,.600,98,35,79,.443,28,58,.483,7,21,.333,27,30,.900,104
1611,BOS,2015-12-12,98,@,CHO,W 98-93,240,40,96,.417,31,71,.437,9,25,.360,9,10,.900,98,36,88,.409,25,53,.472,11,35,.314,10,10,1.000,93
1612,CHI,2015-12-12,98,,NOP,W 98-94,240,33,78,.423,25,58,.431,8,20,.400,24,29,.828,98,40,89,.449,34,73,.466,6,16,.375,8,11,.727,94
1613,ATL,2015-12-09,98,@,DAL,W 98-95,240,39,81,.481,33,61,.541,6,20,.300,14,18,.778,98,36,100,.360,29,69,.420,7,31,.226,16,19,.842,95
1614,BRK,2015-12-06,98,,GSW,L 98-114,240,39,89,.438,34,72,.472,5,17,.294,15,23,.652,98,44,86,.512,30,53,.566,14,33,.424,12,23,.522,114
1615,OKC,2015-12-06,98,,SAC,W 98-95,240,35,86,.407,29,64,.453,6,22,.273,22,31,.710,98,35,88,.398,28,64,.438,7,24,.292,18,30,.600,95
1616,DAL,2015-11-30,98,@,SAC,L 98-112,240,36,84,.429,27,47,.574,9,37,.243,17,22,.773,98,36,79,.456,27,48,.563,9,31,.290,31,44,.705,112
1617,SAS,2015-11-23,98,,PHO,W 98-84,240,42,82,.512,33,62,.532,9,20,.450,5,10,.500,98,34,73,.466,27,54,.500,7,19,.368,9,10,.900,84
1618,DEN,2015-11-18,98,@,SAS,L 98-109,240,38,98,.388,33,83,.398,5,15,.333,17,18,.944,98,42,86,.488,33,68,.485,9,18,.500,16,20,.800,109
1619,NOP,2015-11-17,98,,DEN,L 98-115,240,41,83,.494,34,60,.567,7,23,.304,9,11,.818,98,45,85,.529,30,55,.545,15,30,.500,10,13,.769,115
1620,HOU,2015-11-14,98,,DAL,L 98-110,240,32,84,.381,23,50,.460,9,34,.265,25,32,.781,98,43,89,.483,35,61,.574,8,28,.286,16,21,.762,110
1621,HOU,2015-11-13,98,@,DEN,L 98-107,240,33,77,.429,24,48,.500,9,29,.310,23,31,.742,98,37,81,.457,28,61,.459,9,20,.450,24,32,.750,107
1622,HOU,2015-11-11,98,,BRK,L 98-106,240,42,98,.429,34,64,.531,8,34,.235,6,12,.500,98,42,98,.429,34,81,.420,8,17,.471,14,17,.824,106
1623,NOP,2015-11-11,98,@,ATL,L 98-106,240,37,83,.446,23,54,.426,14,29,.483,10,15,.667,98,42,86,.488,32,60,.533,10,26,.385,12,16,.750,106
1624,NOP,2015-11-07,98,@,DAL,L 98-107,240,39,86,.453,30,58,.517,9,28,.321,11,13,.846,98,40,84,.476,31,60,.517,9,24,.375,18,22,.818,107
1625,WAS,2015-11-06,98,@,BOS,L 98-118,240,36,88,.409,28,63,.444,8,25,.320,18,23,.783,98,44,97,.454,32,67,.478,12,30,.400,18,23,.783,118
1626,BRK,2015-11-06,98,,LAL,L 98-104,240,40,93,.430,37,74,.500,3,19,.158,15,20,.750,98,33,78,.423,26,55,.473,7,23,.304,31,40,.775,104
1627,OKC,2015-11-05,98,@,CHI,L 98-104,240,38,84,.452,33,71,.465,5,13,.385,17,20,.850,98,40,90,.444,33,72,.458,7,18,.389,17,21,.810,104
1628,OKC,2015-11-04,98,,TOR,L 98-103,240,39,82,.476,31,59,.525,8,23,.348,12,14,.857,98,33,79,.418,28,65,.431,5,14,.357,32,39,.821,103
1629,BOS,2015-11-04,98,@,IND,L 98-100,240,35,83,.422,25,56,.446,10,27,.370,18,22,.818,98,35,91,.385,27,68,.397,8,23,.348,22,29,.759,100
1630,ATL,2015-11-03,98,@,MIA,W 98-92,240,37,90,.411,30,69,.435,7,21,.333,17,22,.773,98,38,86,.442,33,58,.569,5,28,.179,11,16,.688,92
1631,DET,2015-10-30,98,,CHI,W 98-94 (OT),265,39,104,.375,33,76,.434,6,28,.214,14,28,.500,98,34,84,.405,27,62,.435,7,22,.318,19,26,.731,94
1632,IND,2016-04-13,97,@,MIL,W 97-92,240,39,90,.433,28,66,.424,11,24,.458,8,10,.800,97,37,87,.425,30,64,.469,7,23,.304,11,13,.846,92
1633,SAC,2016-04-07,97,,MIN,L 97-105,240,36,85,.424,30,68,.441,6,17,.353,19,21,.905,97,36,80,.450,25,59,.424,11,21,.524,22,31,.710,105
1634,NOP,2016-04-06,97,@,BOS,L 97-104,240,34,78,.436,25,54,.463,9,24,.375,20,23,.870,97,36,87,.414,26,53,.491,10,34,.294,22,27,.815,104
1635,NYK,2016-04-06,97,,CHO,L 97-111,240,37,78,.474,27,52,.519,10,26,.385,13,15,.867,97,42,90,.467,30,64,.469,12,26,.462,15,17,.882,111
1636,ATL,2016-03-30,97,@,TOR,L 97-105,240,37,83,.446,23,50,.460,14,33,.424,9,13,.692,97,36,80,.450,25,57,.439,11,23,.478,22,28,.786,105
1637,DAL,2016-03-28,97,@,DEN,W 97-88,240,36,88,.409,25,56,.446,11,32,.344,14,15,.933,97,31,70,.443,22,46,.478,9,24,.375,17,19,.895,88
1638,ORL,2016-03-25,97,@,MIA,L 97-108,240,36,84,.429,30,66,.455,6,18,.333,19,28,.679,97,40,80,.500,35,65,.538,5,15,.333,23,33,.697,108
1639,PHO,2016-03-21,97,,MEM,L 97-103,240,30,76,.395,19,48,.396,11,28,.393,26,34,.765,97,39,90,.433,31,70,.443,8,20,.400,17,19,.895,103
1640,HOU,2016-03-19,97,@,ATL,L 97-109,240,33,84,.393,28,61,.459,5,23,.217,26,31,.839,97,44,88,.500,30,50,.600,14,38,.368,7,12,.583,109
1641,PHI,2016-03-18,97,,OKC,L 97-111,240,35,89,.393,25,60,.417,10,29,.345,17,27,.630,97,45,89,.506,38,67,.567,7,22,.318,14,18,.778,111
1642,PHO,2016-03-09,97,,NYK,L 97-128,240,39,89,.438,30,60,.500,9,29,.310,10,15,.667,97,46,82,.561,30,58,.517,16,24,.667,20,24,.833,128
1643,LAC,2016-03-05,97,,ATL,L 97-107,240,34,79,.430,22,47,.468,12,32,.375,17,28,.607,97,40,89,.449,30,62,.484,10,27,.370,17,20,.850,107
1644,SAS,2016-03-02,97,,DET,W 97-81,240,43,84,.512,40,70,.571,3,14,.214,8,9,.889,97,31,78,.397,25,59,.424,6,19,.316,13,23,.565,81
1645,CLE,2016-02-26,97,@,TOR,L 97-99,240,35,74,.473,23,50,.460,12,24,.500,15,21,.714,97,37,73,.507,31,56,.554,6,17,.353,19,26,.731,99
1646,NOP,2016-02-03,97,@,SAS,L 97-110,240,41,90,.456,38,71,.535,3,19,.158,12,14,.857,97,42,81,.519,33,66,.500,9,15,.600,17,18,.944,110
1647,CLE,2016-02-03,97,@,CHO,L 97-106,240,38,83,.458,28,55,.509,10,28,.357,11,14,.786,97,39,79,.494,30,52,.577,9,27,.333,19,23,.826,106
1648,BOS,2016-02-02,97,@,NYK,W 97-89,240,40,90,.444,37,71,.521,3,19,.158,14,17,.824,97,31,82,.378,25,62,.403,6,20,.300,21,28,.750,89
1649,PHO,2016-02-02,97,,TOR,L 97-104,240,37,79,.468,25,48,.521,12,31,.387,11,15,.733,97,35,74,.473,26,47,.553,9,27,.333,25,32,.781,104
1650,DAL,2016-02-01,97,@,ATL,L 97-112,240,31,85,.365,24,59,.407,7,26,.269,28,38,.737,97,42,80,.525,28,45,.622,14,35,.400,14,19,.737,112
1651,PHI,2016-01-27,97,@,DET,L 97-110,240,39,82,.476,32,63,.508,7,19,.368,12,17,.706,97,39,91,.429,34,70,.486,5,21,.238,27,38,.711,110
1652,SAC,2016-01-26,97,@,POR,L 97-112,240,36,86,.419,29,67,.433,7,19,.368,18,32,.563,97,44,90,.489,35,60,.583,9,30,.300,15,19,.789,112
1653,IND,2016-01-23,97,@,SAC,L 97-108,240,36,86,.419,29,67,.433,7,19,.368,18,25,.720,97,38,85,.447,33,69,.478,5,16,.313,27,36,.750,108
1654,CHO,2016-01-23,97,,NYK,W 97-84,240,28,82,.341,19,51,.373,9,31,.290,32,37,.865,97,29,77,.377,22,53,.415,7,24,.292,19,32,.594,84
1655,IND,2016-01-19,97,@,PHO,W 97-94,240,34,83,.410,30,63,.476,4,20,.200,25,34,.735,97,28,81,.346,17,46,.370,11,35,.314,27,29,.931,94
1656,SAC,2016-01-13,97,,NOP,L 97-109,240,41,84,.488,35,61,.574,6,23,.261,9,14,.643,97,42,100,.420,26,67,.388,16,33,.485,9,11,.818,109
1657,PHO,2016-01-12,97,@,IND,L 97-116,240,36,89,.404,28,64,.438,8,25,.320,17,27,.630,97,41,79,.519,31,55,.564,10,24,.417,24,31,.774,116
1658,LAC,2016-01-09,97,,CHO,W 97-83,240,40,91,.440,32,60,.533,8,31,.258,9,10,.900,97,31,84,.369,24,61,.393,7,23,.304,14,19,.737,83
1659,TOR,2016-01-08,97,@,WAS,W 97-88,240,34,75,.453,29,61,.475,5,14,.357,24,26,.923,97,33,84,.393,25,59,.424,8,25,.320,14,15,.933,88
1660,MIA,2016-01-03,97,@,WAS,W 97-75,240,39,86,.453,30,63,.476,9,23,.391,10,12,.833,97,31,91,.341,27,61,.443,4,30,.133,9,13,.692,75
1661,ATL,2016-01-03,97,@,NYK,L 97-111,240,37,84,.440,29,58,.500,8,26,.308,15,20,.750,97,44,88,.500,33,62,.532,11,26,.423,12,14,.857,111
1662,LAL,2016-01-03,97,,PHO,W 97-77,240,38,84,.452,30,62,.484,8,22,.364,13,17,.765,97,32,89,.360,26,62,.419,6,27,.222,7,9,.778,77
1663,BOS,2016-01-02,97,,BRK,L 97-100,240,34,88,.386,27,56,.482,7,32,.219,22,28,.786,97,38,93,.409,35,75,.467,3,18,.167,21,22,.955,100
1664,TOR,2015-12-28,97,@,CHI,L 97-104,240,38,88,.432,32,68,.471,6,20,.300,15,24,.625,97,40,87,.460,32,66,.485,8,21,.381,16,24,.667,104
1665,PHO,2015-12-28,97,,CLE,L 97-101,240,36,79,.456,25,54,.463,11,25,.440,14,20,.700,97,33,71,.465,16,30,.533,17,41,.415,18,25,.720,101
1666,POR,2015-12-21,97,@,ATL,L 97-106,240,38,81,.469,33,57,.579,5,24,.208,16,22,.727,97,37,77,.481,28,48,.583,9,29,.310,23,28,.821,106
1667,LAC,2015-12-19,97,@,HOU,L 97-107,240,34,86,.395,23,48,.479,11,38,.289,18,29,.621,97,34,76,.447,26,51,.510,8,25,.320,31,49,.633,107
1668,UTA,2015-12-18,97,,DEN,W 97-88,240,34,73,.466,24,48,.500,10,25,.400,19,25,.760,97,31,79,.392,25,51,.490,6,28,.214,20,25,.800,88
1669,DAL,2015-12-18,97,,MEM,W 97-88,240,34,78,.436,24,49,.490,10,29,.345,19,21,.905,97,30,80,.375,24,63,.381,6,17,.353,22,24,.917,88
1670,BRK,2015-12-18,97,@,IND,L 97-104,240,36,86,.419,28,70,.400,8,16,.500,17,17,1.000,97,37,89,.416,30,61,.492,7,28,.250,23,26,.885,104
1671,PHI,2015-12-18,97,,NYK,L 97-107,240,37,77,.481,31,53,.585,6,24,.250,17,30,.567,97,40,85,.471,34,66,.515,6,19,.316,21,28,.750,107
1672,HOU,2015-12-15,97,@,SAC,L 97-107,240,34,82,.415,22,43,.512,12,39,.308,17,23,.739,97,38,75,.507,27,51,.529,11,24,.458,20,29,.690,107
1673,MEM,2015-12-13,97,@,MIA,L 97-100,240,40,77,.519,33,58,.569,7,19,.368,10,14,.714,97,37,77,.481,30,55,.545,7,22,.318,19,23,.826,100
1674,LAL,2015-12-12,97,@,HOU,L 97-126,240,35,88,.398,25,56,.446,10,32,.313,17,20,.850,97,47,90,.522,32,57,.561,15,33,.455,17,28,.607,126
1675,NYK,2015-12-10,97,@,SAC,L 97-99,240,33,83,.398,24,54,.444,9,29,.310,22,28,.786,97,42,93,.452,39,77,.506,3,16,.188,12,16,.750,99
1676,TOR,2015-12-09,97,,SAS,W 97-94,240,37,64,.578,34,54,.630,3,10,.300,20,22,.909,97,34,76,.447,27,51,.529,7,25,.280,19,24,.792,94
1677,NYK,2015-12-07,97,,DAL,L 97-104,240,40,84,.476,31,59,.525,9,25,.360,8,9,.889,97,37,82,.451,24,51,.471,13,31,.419,17,20,.850,104
1678,SAC,2015-12-03,97,,BOS,L 97-114,240,29,77,.377,22,56,.393,7,21,.333,32,41,.780,97,40,84,.476,26,51,.510,14,33,.424,20,24,.833,114
1679,MIA,2015-12-03,97,,OKC,W 97-95,240,40,81,.494,37,68,.544,3,13,.231,14,24,.583,97,35,79,.443,31,63,.492,4,16,.250,21,24,.875,95
1680,WAS,2015-12-01,97,@,CLE,W 97-85,240,39,83,.470,32,55,.582,7,28,.250,12,16,.750,97,28,83,.337,19,53,.358,9,30,.300,20,23,.870,85
1681,MIA,2015-11-27,97,@,NYK,W 97-78,240,33,76,.434,26,59,.441,7,17,.412,24,28,.857,97,32,85,.376,29,71,.408,3,14,.214,11,15,.733,78
1682,BOS,2015-11-24,97,@,ATL,L 97-121,240,34,82,.415,25,61,.410,9,21,.429,20,26,.769,97,45,80,.563,33,56,.589,12,24,.500,19,22,.864,121
1683,WAS,2015-11-21,97,@,DET,W 97-95,240,38,78,.487,31,59,.525,7,19,.368,14,20,.700,97,36,79,.456,28,53,.528,8,26,.308,15,21,.714,95
1684,SAC,2015-11-21,97,@,ORL,W 97-91,240,31,81,.383,24,61,.393,7,20,.350,28,31,.903,97,38,92,.413,29,61,.475,9,31,.290,6,8,.750,91
1685,ATL,2015-11-21,97,@,CLE,L 97-109,240,32,86,.372,21,58,.362,11,28,.393,22,25,.880,97,41,85,.482,30,56,.536,11,29,.379,16,19,.842,109
1686,PHO,2015-11-18,97,,CHI,L 97-103,240,37,91,.407,29,64,.453,8,27,.296,15,21,.714,97,41,83,.494,32,64,.500,9,19,.474,12,14,.857,103
1687,SAC,2015-11-18,97,@,ATL,L 97-103,240,38,86,.442,33,70,.471,5,16,.313,16,18,.889,97,38,89,.427,29,59,.492,9,30,.300,18,24,.750,103
1688,UTA,2015-11-15,97,@,ATL,W 97-96,240,39,76,.513,32,55,.582,7,21,.333,12,17,.706,97,37,76,.487,29,54,.537,8,22,.364,14,17,.824,96
1689,LAL,2015-11-15,97,,DET,W 97-85,240,31,75,.413,25,56,.446,6,19,.316,29,39,.744,97,35,96,.365,28,69,.406,7,27,.259,8,15,.533,85
1690,CHO,2015-11-13,97,@,CHI,L 97-102,240,36,95,.379,21,62,.339,15,33,.455,10,12,.833,97,37,84,.440,33,68,.485,4,16,.250,24,31,.774,102
1691,IND,2015-11-09,97,,ORL,W 97-84,240,34,77,.442,23,52,.442,11,25,.440,18,22,.818,97,31,78,.397,21,45,.467,10,33,.303,12,17,.706,84
1692,IND,2015-11-08,97,@,CLE,L 97-101,240,39,90,.433,33,72,.458,6,18,.333,13,19,.684,97,38,83,.458,30,59,.508,8,24,.333,17,25,.680,101
1693,PHI,2015-11-07,97,,ORL,L 97-105,240,36,80,.450,25,47,.532,11,33,.333,14,26,.538,97,39,83,.470,33,70,.471,6,13,.462,21,24,.875,105
1694,SAC,2015-11-04,97,@,PHO,L 97-118,240,40,84,.476,29,60,.483,11,24,.458,6,12,.500,97,45,83,.542,31,60,.517,14,23,.609,14,22,.636,118
1695,UTA,2015-10-31,97,@,IND,W 97-76,240,39,88,.443,33,73,.452,6,15,.400,13,18,.722,97,28,70,.400,24,53,.453,4,17,.235,16,21,.762,76
1696,ATL,2015-10-30,97,,CHO,W 97-94,240,36,83,.434,28,60,.467,8,23,.348,17,22,.773,97,36,88,.409,24,58,.414,12,30,.400,10,13,.769,94
1697,MIL,2015-10-28,97,,NYK,L 97-122,240,30,86,.349,21,68,.309,9,18,.500,28,31,.903,97,42,93,.452,33,70,.471,9,23,.391,29,35,.829,122
1698,CHI,2015-10-27,97,,CLE,W 97-95,240,37,87,.425,30,68,.441,7,19,.368,16,23,.696,97,38,94,.404,29,65,.446,9,29,.310,10,17,.588,95
1699,UTA,2016-04-13,96,@,LAL,L 96-101,240,39,83,.470,30,53,.566,9,30,.300,9,15,.600,96,41,85,.482,35,60,.583,6,25,.240,13,15,.867,101
1700,SAS,2016-04-13,96,@,DAL,W 96-91,240,35,74,.473,29,51,.569,6,23,.261,20,26,.769,96,31,77,.403,19,38,.500,12,39,.308,17,21,.810,91
1701,BRK,2016-04-13,96,,TOR,L 96-103,240,39,89,.438,29,63,.460,10,26,.385,8,12,.667,96,41,93,.441,28,56,.500,13,37,.351,8,15,.533,103
1702,ORL,2016-04-10,96,@,MIA,L 96-118,240,37,83,.446,30,65,.462,7,18,.389,15,19,.789,96,43,77,.558,37,57,.649,6,20,.300,26,30,.867,118
1703,TOR,2016-04-05,96,,CHO,W 96-90,240,34,78,.436,28,55,.509,6,23,.261,22,31,.710,96,32,88,.364,21,53,.396,11,35,.314,15,21,.714,90
1704,UTA,2016-03-30,96,,GSW,L 96-103 (OT),265,37,92,.402,28,60,.467,9,32,.281,13,29,.448,96,39,89,.438,27,54,.500,12,35,.343,13,18,.722,103
1705,IND,2016-03-29,96,,CHI,L 96-98,240,39,90,.433,36,71,.507,3,19,.158,15,17,.882,96,37,87,.425,27,61,.443,10,26,.385,14,16,.875,98
1706,LAC,2016-03-24,96,,POR,W 96-94,240,37,82,.451,33,63,.524,4,19,.211,18,28,.643,96,32,80,.400,26,56,.464,6,24,.250,24,32,.750,94
1707,ORL,2016-03-21,96,@,BOS,L 96-107,240,39,93,.419,34,74,.459,5,19,.263,13,19,.684,96,40,85,.471,33,63,.524,7,22,.318,20,24,.833,107
1708,MIL,2016-03-17,96,,MEM,W 96-86,240,37,75,.493,32,56,.571,5,19,.263,17,25,.680,96,34,92,.370,31,79,.392,3,13,.231,15,17,.882,86
1709,CHI,2016-03-16,96,@,WAS,L 96-117,240,35,87,.402,29,67,.433,6,20,.300,20,23,.870,96,43,88,.489,30,67,.448,13,21,.619,18,24,.750,117
1710,CHO,2016-03-14,96,,DAL,L 96-107,240,32,76,.421,22,46,.478,10,30,.333,22,34,.647,96,42,87,.483,33,57,.579,9,30,.300,14,18,.778,107
1711,OKC,2016-03-11,96,,MIN,L 96-99,240,36,84,.429,30,57,.526,6,27,.222,18,25,.720,96,37,86,.430,30,65,.462,7,21,.333,18,21,.857,99
1712,CHI,2016-03-11,96,,MIA,L 96-118,240,38,81,.469,30,60,.500,8,21,.381,12,15,.800,96,47,91,.516,37,73,.507,10,18,.556,14,20,.700,118
1713,ATL,2016-03-10,96,@,TOR,L 96-104,240,35,82,.427,28,59,.475,7,23,.304,19,27,.704,96,38,82,.463,31,58,.534,7,24,.292,21,29,.724,104
1714,DAL,2016-03-09,96,,DET,L 96-102,240,39,86,.453,30,56,.536,9,30,.300,9,11,.818,96,38,85,.447,29,58,.500,9,27,.333,17,30,.567,102
1715,MEM,2016-03-09,96,@,BOS,L 96-116,240,32,84,.381,25,58,.431,7,26,.269,25,31,.806,96,41,87,.471,26,55,.473,15,32,.469,19,24,.792,116
1716,MIL,2016-03-06,96,,OKC,L 96-104,240,34,90,.378,31,71,.437,3,19,.158,25,30,.833,96,32,76,.421,25,51,.490,7,25,.280,33,43,.767,104
1717,IND,2016-02-29,96,@,CLE,L 96-100,240,37,80,.463,29,62,.468,8,18,.444,14,15,.933,96,35,83,.422,26,54,.481,9,29,.310,21,25,.840,100
1718,DEN,2016-02-29,96,,MEM,L 96-103,240,40,75,.533,32,50,.640,8,25,.320,8,10,.800,96,36,75,.480,33,55,.600,3,20,.150,28,36,.778,103
1719,UTA,2016-02-27,96,,BRK,L 96-98,240,37,89,.416,32,69,.464,5,20,.250,17,25,.680,96,40,84,.476,33,69,.478,7,15,.467,11,17,.647,98
1720,CHO,2016-02-26,96,@,IND,W 96-95,240,36,83,.434,25,55,.455,11,28,.393,13,19,.684,96,35,85,.412,31,66,.470,4,19,.211,21,24,.875,95
1721,SAS,2016-02-25,96,@,UTA,W 96-78,240,38,79,.481,29,61,.475,9,18,.500,11,12,.917,96,33,77,.429,30,60,.500,3,17,.176,9,12,.750,78
1722,DET,2016-02-22,96,@,CLE,W 96-88,240,37,80,.463,29,55,.527,8,25,.320,14,21,.667,96,34,79,.430,26,53,.491,8,26,.308,12,13,.923,88
1723,BRK,2016-02-21,96,,CHO,L 96-104,240,35,81,.432,30,59,.508,5,22,.227,21,24,.875,96,40,79,.506,30,52,.577,10,27,.370,14,15,.933,104
1724,UTA,2016-02-10,96,@,NOP,L 96-100,240,33,70,.471,26,49,.531,7,21,.333,23,30,.767,96,39,82,.476,31,63,.492,8,19,.421,14,21,.667,100
1725,ORL,2016-02-10,96,,SAS,L 96-98,240,37,91,.407,29,71,.408,8,20,.400,14,16,.875,96,38,89,.427,30,69,.435,8,20,.400,14,15,.933,98
1726,ORL,2016-02-07,96,,ATL,W 96-94,240,39,85,.459,32,60,.533,7,25,.280,11,12,.917,96,35,91,.385,22,63,.349,13,28,.464,11,15,.733,94
1727,NYK,2016-02-07,96,,DEN,L 96-101,240,37,84,.440,29,62,.468,8,22,.364,14,20,.700,96,37,86,.430,32,65,.492,5,21,.238,22,28,.786,101
1728,POR,2016-02-06,96,@,HOU,W 96-79,240,35,87,.402,24,52,.462,11,35,.314,15,23,.652,96,25,77,.325,18,41,.439,7,36,.194,22,30,.733,79
1729,IND,2016-02-05,96,@,ATL,L 96-102,240,38,91,.418,25,60,.417,13,31,.419,7,9,.778,96,39,76,.513,29,49,.592,10,27,.370,14,20,.700,102
1730,NOP,2016-02-04,96,,LAL,L 96-99,240,39,85,.459,35,65,.538,4,20,.200,14,26,.538,96,39,81,.481,32,61,.525,7,20,.350,14,20,.700,99
1731,CHI,2016-02-01,96,@,UTA,L 96-105 (OT),265,39,90,.433,34,69,.493,5,21,.238,13,20,.650,96,38,85,.447,31,67,.463,7,18,.389,22,33,.667,105
1732,POR,2016-01-31,96,,MIN,W 96-93,240,32,76,.421,26,49,.531,6,27,.222,26,30,.867,96,35,80,.438,31,64,.484,4,16,.250,19,28,.679,93
1733,CHI,2016-01-23,96,@,CLE,W 96-83,240,38,87,.437,31,70,.443,7,17,.412,13,15,.867,96,35,94,.372,31,70,.443,4,24,.167,9,22,.409,83
1734,PHI,2016-01-20,96,@,ORL,W 96-87,240,36,74,.486,27,55,.491,9,19,.474,15,21,.714,96,33,84,.393,29,67,.433,4,17,.235,17,26,.654,87
1735,MIN,2016-01-12,96,,OKC,L 96-101,240,36,81,.444,29,63,.460,7,18,.389,17,23,.739,96,39,84,.464,30,62,.484,9,22,.409,14,18,.778,101
1736,MIL,2016-01-08,96,,DAL,W 96-95,240,37,80,.463,33,71,.465,4,9,.444,18,29,.621,96,35,84,.417,21,40,.525,14,44,.318,11,16,.688,95
1737,POR,2015-12-31,96,@,UTA,L 96-109,240,35,78,.449,19,42,.452,16,36,.444,10,14,.714,96,43,86,.500,28,53,.528,15,33,.455,8,11,.727,109
1738,DET,2015-12-29,96,@,NYK,L 96-108,240,37,89,.416,27,62,.435,10,27,.370,12,17,.706,96,43,79,.544,35,63,.556,8,16,.500,14,17,.824,108
1739,LAL,2015-12-27,96,@,MEM,L 96-112,240,32,84,.381,24,55,.436,8,29,.276,24,32,.750,96,45,80,.563,39,64,.609,6,16,.375,16,22,.727,112
1740,BRK,2015-12-26,96,,WAS,L 96-111,240,43,89,.483,38,72,.528,5,17,.294,5,16,.313,96,42,84,.500,30,57,.526,12,27,.444,15,22,.682,111
1741,OKC,2015-12-25,96,,CHI,L 96-105,240,37,96,.385,31,72,.431,6,24,.250,16,23,.696,96,40,92,.435,33,74,.446,7,18,.389,18,20,.900,105
1742,PHO,2015-12-23,96,,DEN,L 96-104,240,36,87,.414,23,62,.371,13,25,.520,11,17,.647,96,42,91,.462,28,56,.500,14,35,.400,6,13,.462,104
1743,MEM,2015-12-19,96,,IND,W 96-84,240,37,83,.446,32,64,.500,5,19,.263,17,21,.810,96,30,77,.390,25,49,.510,5,28,.179,19,25,.760,84
1744,PHI,2015-12-14,96,@,CHI,L 96-115,240,38,92,.413,27,61,.443,11,31,.355,9,13,.692,96,43,85,.506,35,63,.556,8,22,.364,21,26,.808,115
1745,TOR,2015-12-13,96,,PHI,W 96-76,240,32,78,.410,25,56,.446,7,22,.318,25,34,.735,96,28,84,.333,18,56,.321,10,28,.357,10,14,.714,76
1746,IND,2015-12-12,96,@,DET,L 96-118,240,41,82,.500,38,66,.576,3,16,.188,11,18,.611,96,45,90,.500,32,61,.525,13,29,.448,15,19,.789,118
1747,PHO,2015-12-11,96,,POR,L 96-106,240,36,83,.434,23,48,.479,13,35,.371,11,18,.611,96,45,96,.469,33,62,.532,12,34,.353,4,7,.571,106
1748,IND,2015-12-11,96,,MIA,W 96-83,240,36,86,.419,30,58,.517,6,28,.214,18,20,.900,96,35,81,.432,30,61,.492,5,20,.250,8,13,.615,83
1749,CHI,2015-12-05,96,,CHO,L 96-102,240,37,89,.416,28,64,.438,9,25,.360,13,19,.684,96,37,89,.416,27,55,.491,10,34,.294,18,25,.720,102
1750,DAL,2015-12-04,96,,HOU,L 96-100,240,37,81,.457,29,52,.558,8,29,.276,14,20,.700,96,39,84,.464,27,58,.466,12,26,.462,10,18,.556,100
1751,TOR,2015-12-02,96,@,ATL,W 96-86,240,36,79,.456,30,54,.556,6,25,.240,18,24,.750,96,33,90,.367,25,63,.397,8,27,.296,12,16,.750,86
1752,ORL,2015-12-01,96,@,MIN,W 96-93,240,38,86,.442,33,69,.478,5,17,.294,15,20,.750,96,29,77,.377,25,58,.431,4,19,.211,31,38,.816,93
1753,LAL,2015-11-28,96,@,POR,L 96-108,240,36,82,.439,29,59,.492,7,23,.304,17,23,.739,96,38,78,.487,26,48,.542,12,30,.400,20,26,.769,108
1754,DAL,2015-11-24,96,@,MEM,L 96-110,240,30,77,.390,19,43,.442,11,34,.324,25,28,.893,96,37,86,.430,30,65,.462,7,21,.333,29,37,.784,110
1755,MIA,2015-11-21,96,,PHI,W 96-91,240,30,69,.435,25,51,.490,5,18,.278,31,45,.689,96,31,82,.378,21,51,.412,10,31,.323,19,24,.792,91
1756,DET,2015-11-20,96,@,MIN,W 96-86,240,40,87,.460,34,59,.576,6,28,.214,10,13,.769,96,33,77,.429,30,64,.469,3,13,.231,17,25,.680,86
1757,MEM,2015-11-20,96,,HOU,W 96-84,240,36,85,.424,28,61,.459,8,24,.333,16,19,.842,96,28,74,.378,22,45,.489,6,29,.207,22,37,.595,84
1758,CHI,2015-11-16,96,,IND,W 96-95,240,35,86,.407,29,71,.408,6,15,.400,20,32,.625,96,35,87,.402,26,66,.394,9,21,.429,16,24,.667,95
1759,ATL,2015-11-15,96,,UTA,L 96-97,240,37,76,.487,29,54,.537,8,22,.364,14,17,.824,96,39,76,.513,32,55,.582,7,21,.333,12,17,.706,97
1760,DET,2015-11-14,96,@,LAC,L 96-101,240,33,74,.446,26,47,.553,7,27,.259,23,35,.657,96,37,79,.468,30,60,.500,7,19,.368,20,26,.769,101
1761,MIA,2015-11-08,96,,TOR,W 96-76,240,35,83,.422,27,63,.429,8,20,.400,18,25,.720,96,28,71,.394,25,52,.481,3,19,.158,17,22,.773,76
1762,MEM,2015-11-05,96,@,POR,L 96-115,240,37,77,.481,30,57,.526,7,20,.350,15,21,.714,96,44,87,.506,29,57,.509,15,30,.500,12,20,.600,115
1763,UTA,2015-11-05,96,@,DEN,W 96-84,240,37,85,.435,26,61,.426,11,24,.458,11,17,.647,96,28,72,.389,23,52,.442,5,20,.250,23,34,.676,84
1764,MIA,2015-11-05,96,@,MIN,W 96-84,240,37,76,.487,33,62,.532,4,14,.286,18,25,.720,96,30,85,.353,26,73,.356,4,12,.333,20,22,.909,84
1765,CLE,2015-11-04,96,,NYK,W 96-86,240,33,83,.398,26,56,.464,7,27,.259,23,32,.719,96,33,84,.393,25,60,.417,8,24,.333,12,15,.800,86
1766,PHO,2015-11-02,96,@,LAC,L 96-102,240,36,98,.367,27,68,.397,9,30,.300,15,21,.714,96,37,81,.457,29,55,.527,8,26,.308,20,23,.870,102
1767,BRK,2015-11-02,96,,MIL,L 96-103,240,36,79,.456,30,60,.500,6,19,.316,18,22,.818,96,38,73,.521,29,50,.580,9,23,.391,18,26,.692,103
1768,ATL,2016-04-07,95,,TOR,W 95-87,240,33,76,.434,21,44,.477,12,32,.375,17,21,.810,95,32,84,.381,24,63,.381,8,21,.381,15,20,.750,87
1769,TOR,2016-04-02,95,@,SAS,L 95-102,240,40,80,.500,34,62,.548,6,18,.333,9,10,.900,95,35,77,.455,30,57,.526,5,20,.250,27,30,.900,102
1770,MEM,2016-04-01,95,,TOR,L 95-99,240,37,91,.407,30,72,.417,7,19,.368,14,17,.824,95,30,71,.423,18,43,.419,12,28,.429,27,29,.931,99
1771,DEN,2016-03-31,95,@,NOP,L 95-101,240,36,83,.434,26,56,.464,10,27,.370,13,17,.765,95,40,90,.444,27,61,.443,13,29,.448,8,9,.889,101
1772,DET,2016-03-26,95,,ATL,L 95-112,240,34,88,.386,27,59,.458,7,29,.241,20,28,.714,95,43,95,.453,30,61,.492,13,34,.382,13,14,.929,112
1773,CLE,2016-03-24,95,@,BRK,L 95-104,240,39,89,.438,29,51,.569,10,38,.263,7,9,.778,95,41,89,.461,33,67,.493,8,22,.364,14,19,.737,104
1774,PHO,2016-03-18,95,@,LAL,W 95-90,240,32,89,.360,24,59,.407,8,30,.267,23,26,.885,95,31,86,.360,25,63,.397,6,23,.261,22,26,.846,90
1775,ATL,2016-03-12,95,,MEM,W 95-83,240,36,84,.429,25,50,.500,11,34,.324,12,17,.706,95,33,95,.347,27,72,.375,6,23,.261,11,14,.786,83
1776,PHI,2016-03-11,95,,BRK,W 95-89,240,38,84,.452,29,56,.518,9,28,.321,10,15,.667,95,33,87,.379,28,70,.400,5,17,.294,18,22,.818,89
1777,GSW,2016-03-06,95,@,LAL,L 95-112,240,37,92,.402,33,62,.532,4,30,.133,17,21,.810,95,41,87,.471,32,62,.516,9,25,.360,21,22,.955,112
1778,NOP,2016-03-02,95,@,HOU,L 95-100,240,36,90,.400,22,53,.415,14,37,.378,9,13,.692,95,36,81,.444,33,46,.717,3,35,.086,25,38,.658,100
1779,BRK,2016-02-29,95,@,LAC,L 95-105,240,32,77,.416,24,58,.414,8,19,.421,23,33,.697,95,41,83,.494,32,60,.533,9,23,.391,14,16,.875,105
1780,UTA,2016-02-29,95,@,BOS,L 95-100,240,38,101,.376,31,77,.403,7,24,.292,12,17,.706,95,37,84,.440,31,66,.470,6,18,.333,20,29,.690,100
1781,CHI,2016-02-27,95,,POR,L 95-103,240,39,94,.415,32,72,.444,7,22,.318,10,12,.833,95,38,87,.437,33,66,.500,5,21,.238,22,27,.815,103
1782,IND,2016-02-26,95,,CHO,L 95-96,240,35,85,.412,31,66,.470,4,19,.211,21,24,.875,95,36,83,.434,25,55,.455,11,28,.393,13,19,.684,96
1783,LAL,2016-02-26,95,,MEM,L 95-112,240,32,78,.410,27,55,.491,5,23,.217,26,39,.667,95,43,85,.506,30,53,.566,13,32,.406,13,15,.867,112
1784,ORL,2016-02-26,95,@,NYK,L 95-108,240,39,93,.419,33,66,.500,6,27,.222,11,16,.688,95,37,80,.463,33,64,.516,4,16,.250,30,36,.833,108
1785,NYK,2016-02-22,95,,TOR,L 95-122,240,37,84,.440,31,64,.484,6,20,.300,15,23,.652,95,46,87,.529,35,62,.565,11,25,.440,19,25,.760,122
1786,MIN,2016-02-20,95,,NYK,L 95-103,240,36,84,.429,31,72,.431,5,12,.417,18,25,.720,95,42,83,.506,37,66,.561,5,17,.294,14,16,.875,103
1787,MIL,2016-02-19,95,,CHO,L 95-98,240,36,81,.444,29,62,.468,7,19,.368,16,21,.762,95,37,86,.430,28,55,.509,9,31,.290,15,18,.833,98
1788,CHI,2016-02-18,95,@,CLE,L 95-106,240,37,93,.398,29,72,.403,8,21,.381,13,22,.591,95,42,91,.462,35,67,.522,7,24,.292,15,17,.882,106
1789,NOP,2016-02-11,95,@,OKC,L 95-121,240,38,88,.432,35,72,.486,3,16,.188,16,24,.667,95,45,86,.523,33,54,.611,12,32,.375,19,23,.826,121
1790,IND,2016-02-10,95,,CHO,L 95-117,240,40,92,.435,36,74,.486,4,18,.222,11,15,.733,95,45,87,.517,33,59,.559,12,28,.429,15,19,.789,117
1791,CHO,2016-02-05,95,,MIA,L 95-98,240,36,81,.444,26,55,.473,10,26,.385,13,15,.867,95,43,94,.457,43,85,.506,0,9,.000,12,18,.667,98
1792,DET,2016-02-03,95,@,BOS,L 95-102,240,32,85,.376,21,51,.412,11,34,.324,20,28,.714,95,42,96,.438,35,75,.467,7,21,.333,11,13,.846,102
1793,MIL,2016-02-02,95,@,POR,L 95-107,240,38,86,.442,33,72,.458,5,14,.357,14,24,.583,95,39,85,.459,28,54,.519,11,31,.355,18,25,.720,107
1794,NOP,2016-02-01,95,,MEM,L 95-110,240,36,88,.409,26,62,.419,10,26,.385,13,21,.619,95,43,71,.606,34,55,.618,9,16,.563,15,18,.833,110
1795,NYK,2016-01-31,95,,GSW,L 95-116,240,33,90,.367,27,72,.375,6,18,.333,23,26,.885,95,42,73,.575,26,44,.591,16,29,.552,16,23,.696,116
1796,DET,2016-01-25,95,@,UTA,W 95-92,240,34,75,.453,23,53,.434,11,22,.500,16,33,.485,95,34,85,.400,25,56,.446,9,29,.310,15,18,.833,92
1797,ATL,2016-01-23,95,@,PHO,L 95-98,240,34,84,.405,22,50,.440,12,34,.353,15,18,.833,95,34,85,.400,24,61,.393,10,24,.417,20,26,.769,98
1798,LAL,2016-01-22,95,,SAS,L 95-108,240,38,84,.452,32,68,.471,6,16,.375,13,18,.722,95,43,85,.506,32,64,.500,11,21,.524,11,13,.846,108
1799,CHO,2016-01-20,95,@,OKC,L 95-109,240,34,81,.420,25,54,.463,9,27,.333,18,21,.857,95,39,83,.470,30,59,.508,9,24,.375,22,30,.733,109
1800,LAL,2016-01-17,95,,HOU,L 95-112,240,37,82,.451,31,63,.492,6,19,.316,15,19,.789,95,44,91,.484,38,70,.543,6,21,.286,18,24,.750,112
1801,GSW,2016-01-16,95,@,DET,L 95-113,240,34,94,.362,24,69,.348,10,25,.400,17,23,.739,95,47,101,.465,39,78,.500,8,23,.348,11,20,.550,113
1802,NYK,2016-01-16,95,@,MEM,L 95-103,240,35,77,.455,30,57,.526,5,20,.250,20,24,.833,95,39,82,.476,34,72,.472,5,10,.500,20,26,.769,103
1803,DEN,2016-01-15,95,,MIA,L 95-98,240,32,78,.410,26,60,.433,6,18,.333,25,26,.962,95,40,81,.494,36,69,.522,4,12,.333,14,19,.737,98
1804,CLE,2016-01-14,95,@,SAS,L 95-99,240,38,82,.463,28,56,.500,10,26,.385,9,11,.818,95,38,83,.458,33,66,.500,5,17,.294,18,22,.818,99
1805,LAL,2016-01-12,95,,NOP,W 95-91,240,32,87,.368,26,58,.448,6,29,.207,25,32,.781,95,38,91,.418,32,68,.471,6,23,.261,9,14,.643,91
1806,CLE,2016-01-10,95,@,PHI,W 95-85,240,35,90,.389,26,58,.448,9,32,.281,16,23,.696,95,35,77,.455,29,59,.492,6,18,.333,9,19,.474,85
1807,DEN,2016-01-10,95,,CHO,W 95-92,240,32,77,.416,20,50,.400,12,27,.444,19,23,.826,95,30,83,.361,18,47,.383,12,36,.333,20,24,.833,92
1808,PHI,2016-01-09,95,,TOR,L 95-108,240,39,80,.488,28,63,.444,11,17,.647,6,14,.429,95,41,75,.547,36,58,.621,5,17,.294,21,27,.778,108
1809,DAL,2016-01-08,95,@,MIL,L 95-96,240,35,84,.417,21,40,.525,14,44,.318,11,16,.688,95,37,80,.463,33,71,.465,4,9,.444,18,29,.621,96
1810,PHO,2016-01-08,95,,MIA,L 95-103,240,40,92,.435,34,68,.500,6,24,.250,9,13,.692,95,36,73,.493,29,55,.527,7,18,.389,24,30,.800,103
1811,IND,2016-01-06,95,@,ORL,W 95-86,240,32,76,.421,26,54,.481,6,22,.273,25,29,.862,95,32,79,.405,26,48,.542,6,31,.194,16,17,.941,86
1812,MIL,2016-01-02,95,@,MIN,W 95-85,240,32,75,.427,24,59,.407,8,16,.500,23,28,.821,95,33,84,.393,30,70,.429,3,14,.214,16,24,.667,85
1813,LAC,2015-12-31,95,@,NOP,W 95-89,240,35,90,.389,25,56,.446,10,34,.294,15,19,.789,95,36,82,.439,29,57,.509,7,25,.280,10,15,.667,89
1814,UTA,2015-12-28,95,,PHI,W 95-91,240,28,84,.333,21,58,.362,7,26,.269,32,36,.889,95,36,86,.419,31,65,.477,5,21,.238,14,19,.737,91
1815,MIN,2015-12-28,95,@,SAS,L 95-101,240,39,82,.476,36,71,.507,3,11,.273,14,24,.583,95,37,72,.514,32,55,.582,5,17,.294,22,28,.786,101
1816,CHO,2015-12-21,95,@,HOU,L 95-102,240,29,83,.349,17,42,.405,12,41,.293,25,31,.806,95,33,71,.465,26,43,.605,7,28,.250,29,41,.707,102
1817,PHO,2015-12-20,95,,MIL,L 95-101,240,33,74,.446,25,56,.446,8,18,.444,21,24,.875,95,41,79,.519,36,63,.571,5,16,.313,14,24,.583,101
1818,SAC,2015-12-18,95,@,MIN,L 95-99,240,38,81,.469,31,58,.534,7,23,.304,12,17,.706,95,39,82,.476,33,64,.516,6,18,.333,15,16,.938,99
1819,WAS,2015-12-16,95,@,SAS,L 95-114,240,35,84,.417,32,69,.464,3,15,.200,22,25,.880,95,44,83,.530,36,61,.590,8,22,.364,18,23,.783,114
1820,MIL,2015-12-15,95,@,LAL,L 95-113,240,40,85,.471,36,72,.500,4,13,.308,11,20,.550,95,41,89,.461,31,62,.500,10,27,.370,21,25,.840,113
1821,WAS,2015-12-14,95,@,MEM,L 95-112,240,37,86,.430,28,62,.452,9,24,.375,12,20,.600,95,44,78,.564,34,63,.540,10,15,.667,14,15,.933,112
1822,GSW,2015-12-12,95,@,MIL,L 95-108,240,36,89,.404,30,62,.484,6,27,.222,17,25,.680,95,44,90,.489,38,76,.500,6,14,.429,14,18,.778,108
1823,PHI,2015-12-11,95,,DET,L 95-107,240,36,80,.450,30,62,.484,6,18,.333,17,24,.708,95,43,93,.462,33,66,.500,10,27,.370,11,16,.688,107
1824,DAL,2015-12-09,95,,ATL,L 95-98,240,36,100,.360,29,69,.420,7,31,.226,16,19,.842,95,39,81,.481,33,61,.541,6,20,.300,14,18,.778,98
1825,MIL,2015-12-09,95,,LAC,L 95-109,240,42,90,.467,40,80,.500,2,10,.200,9,12,.750,95,38,81,.469,26,53,.491,12,28,.429,21,36,.583,109
1826,MEM,2015-12-06,95,,PHO,W 95-93,240,36,90,.400,31,75,.413,5,15,.333,18,24,.750,95,36,82,.439,27,51,.529,9,31,.290,12,17,.706,93
1827,SAC,2015-12-06,95,@,OKC,L 95-98,240,35,88,.398,28,64,.438,7,24,.292,18,30,.600,95,35,86,.407,29,64,.453,6,22,.273,22,31,.710,98
1828,MIL,2015-12-04,95,@,DET,L 95-102,240,39,87,.448,35,69,.507,4,18,.222,13,14,.929,95,34,82,.415,27,59,.458,7,23,.304,27,39,.692,102
1829,OKC,2015-12-03,95,@,MIA,L 95-97,240,35,79,.443,31,63,.492,4,16,.250,21,24,.875,95,40,81,.494,37,68,.544,3,13,.231,14,24,.583,97
1830,SAS,2015-12-02,95,,MIL,W 95-70,240,37,90,.411,30,69,.435,7,21,.333,14,20,.700,95,26,78,.333,23,64,.359,3,14,.214,15,18,.833,70
1831,MIA,2015-11-30,95,,BOS,L 95-105,240,36,75,.480,31,58,.534,5,17,.294,18,24,.750,95,38,80,.475,30,60,.500,8,20,.400,21,25,.840,105
1832,CLE,2015-11-27,95,@,CHO,W 95-90,240,34,81,.420,26,56,.464,8,25,.320,19,25,.760,95,33,80,.413,28,55,.509,5,25,.200,19,25,.760,90
1833,ATL,2015-11-25,95,@,MIN,L 95-99,240,31,82,.378,23,51,.451,8,31,.258,25,35,.714,95,34,82,.415,25,61,.410,9,21,.429,22,29,.759,99
1834,MIA,2015-11-23,95,,NYK,W 95-78,240,31,81,.383,26,62,.419,5,19,.263,28,36,.778,95,28,87,.322,24,63,.381,4,24,.167,18,21,.857,78
1835,PHI,2015-11-23,95,@,MIN,L 95-100,240,32,78,.410,22,47,.468,10,31,.323,21,27,.778,95,36,78,.462,33,66,.500,3,12,.250,25,27,.926,100
1836,DET,2015-11-21,95,,WAS,L 95-97,240,36,79,.456,28,53,.528,8,26,.308,15,21,.714,95,38,78,.487,31,59,.525,7,19,.368,14,20,.700,97
1837,BRK,2015-11-20,95,@,BOS,L 95-120,240,35,89,.393,27,70,.386,8,19,.421,17,24,.708,95,51,87,.586,41,58,.707,10,29,.345,8,10,.800,120
1838,HOU,2015-11-16,95,,BOS,L 95-111,240,36,85,.424,25,53,.472,11,32,.344,12,23,.522,95,44,93,.473,33,57,.579,11,36,.306,12,17,.706,111
1839,IND,2015-11-16,95,@,CHI,L 95-96,240,35,87,.402,26,66,.394,9,21,.429,16,24,.667,95,35,86,.407,29,71,.408,6,15,.400,20,32,.625,96
1840,NYK,2015-11-15,95,,NOP,W 95-87,240,38,88,.432,34,70,.486,4,18,.222,15,19,.789,95,32,71,.451,26,50,.520,6,21,.286,17,19,.895,87
1841,CHO,2015-11-11,95,,NYK,W 95-93,240,35,84,.417,27,61,.443,8,23,.348,17,28,.607,95,42,86,.488,38,65,.585,4,21,.190,5,7,.714,93
1842,MIN,2015-11-10,95,,CHO,L 95-104,240,36,80,.450,27,61,.443,9,19,.474,14,19,.737,95,38,78,.487,30,52,.577,8,26,.308,20,27,.741,104
1843,DET,2015-11-09,95,@,GSW,L 95-109,240,40,85,.471,34,66,.515,6,19,.316,9,15,.600,95,43,91,.473,31,70,.443,12,21,.571,11,13,.846,109
1844,LAL,2015-11-08,95,@,NYK,L 95-99,240,36,94,.383,27,67,.403,9,27,.333,14,23,.609,95,33,84,.393,24,57,.421,9,27,.333,24,29,.828,99
1845,SAS,2015-11-01,95,@,BOS,W 95-87,240,36,83,.434,31,64,.484,5,19,.263,18,25,.720,95,35,98,.357,29,69,.420,6,29,.207,11,14,.786,87
1846,MIN,2015-10-30,95,@,DEN,W 95-78,240,30,71,.423,28,60,.467,2,11,.182,33,41,.805,95,29,95,.305,24,70,.343,5,25,.200,15,20,.750,78
1847,PHI,2015-10-28,95,@,BOS,L 95-112,240,34,83,.410,27,61,.443,7,22,.318,20,23,.870,95,39,85,.459,31,61,.508,8,24,.333,26,27,.963,112
1848,PHO,2015-10-28,95,,DAL,L 95-111,240,34,87,.391,28,63,.444,6,24,.250,21,33,.636,95,40,85,.471,30,64,.469,10,21,.476,21,31,.677,111
1849,CLE,2015-10-27,95,@,CHI,L 95-97,240,38,94,.404,29,65,.446,9,29,.310,10,17,.588,95,37,87,.425,30,68,.441,7,19,.368,16,23,.696,97
1850,NOP,2015-10-27,95,@,GSW,L 95-111,240,35,83,.422,29,65,.446,6,18,.333,19,27,.704,95,41,96,.427,32,66,.485,9,30,.300,20,22,.909,111
1851,ATL,2016-04-11,94,@,CLE,L 94-109,240,39,87,.448,31,57,.544,8,30,.267,8,15,.533,94,40,83,.482,29,54,.537,11,29,.379,18,20,.900,109
1852,DET,2016-04-02,94,@,CHI,W 94-90,240,32,76,.421,22,56,.393,10,20,.500,20,34,.588,94,34,88,.386,25,63,.397,9,25,.360,13,15,.867,90
1853,IND,2016-03-31,94,,ORL,L 94-114,240,36,86,.419,29,67,.433,7,19,.368,15,21,.714,94,48,90,.533,43,74,.581,5,16,.313,13,18,.722,114
1854,PHO,2016-03-30,94,@,MIL,L 94-105,240,38,84,.452,33,60,.550,5,24,.208,13,17,.765,94,37,77,.481,31,62,.500,6,15,.400,25,34,.735,105
1855,WAS,2016-03-29,94,@,GSW,L 94-102,240,36,86,.419,31,63,.492,5,23,.217,17,27,.630,94,38,87,.437,27,62,.435,11,25,.440,15,23,.652,102
1856,PHO,2016-03-25,94,@,SAC,L 94-116,240,35,94,.372,26,62,.419,9,32,.281,15,23,.652,94,40,90,.444,33,68,.485,7,22,.318,29,39,.744,116
1857,POR,2016-03-24,94,@,LAC,L 94-96,240,32,80,.400,26,56,.464,6,24,.250,24,32,.750,94,37,82,.451,33,63,.524,4,19,.211,18,28,.643,96
1858,CHI,2016-03-24,94,@,NYK,L 94-106,240,37,89,.416,31,64,.484,6,25,.240,14,18,.778,94,39,76,.513,26,46,.565,13,30,.433,15,16,.938,106
1859,UTA,2016-03-20,94,@,MIL,W 94-85,240,34,83,.410,21,45,.467,13,38,.342,13,14,.929,94,34,65,.523,31,57,.544,3,8,.375,14,17,.824,85
1860,IND,2016-03-17,94,,TOR,L 94-101 (OT),265,35,91,.385,27,63,.429,8,28,.286,16,23,.696,94,32,88,.364,25,66,.379,7,22,.318,30,38,.789,101
1861,PHI,2016-03-17,94,,WAS,L 94-99,240,35,91,.385,29,58,.500,6,33,.182,18,26,.692,94,40,90,.444,34,63,.540,6,27,.222,13,19,.684,99
1862,POR,2016-03-14,94,@,OKC,L 94-128,240,31,91,.341,24,64,.375,7,27,.259,25,27,.926,94,49,83,.590,40,66,.606,9,17,.529,21,26,.808,128
1863,UTA,2016-03-14,94,,CLE,W 94-85,240,35,71,.493,23,44,.523,12,27,.444,12,14,.857,94,35,88,.398,25,45,.556,10,43,.233,5,8,.625,85
1864,NYK,2016-03-11,94,@,LAC,L 94-101,240,34,83,.410,30,63,.476,4,20,.200,22,25,.880,94,38,85,.447,25,56,.446,13,29,.448,12,16,.750,101
1865,UTA,2016-03-09,94,@,GSW,L 94-115,240,32,79,.405,24,59,.407,8,20,.400,22,31,.710,94,48,84,.571,35,54,.648,13,30,.433,6,10,.600,115
1866,NYK,2016-03-08,94,@,DEN,L 94-110,240,33,75,.440,27,57,.474,6,18,.333,22,26,.846,94,45,99,.455,39,78,.500,6,21,.286,14,19,.737,110
1867,SAC,2016-03-05,94,@,SAS,L 94-104,240,37,81,.457,31,65,.477,6,16,.375,14,21,.667,94,40,81,.494,32,58,.552,8,23,.348,16,19,.842,104
1868,NOP,2016-03-05,94,,UTA,L 94-106,240,38,92,.413,29,73,.397,9,19,.474,9,11,.818,94,37,78,.474,31,58,.534,6,20,.300,26,27,.963,106
1869,MEM,2016-03-04,94,,UTA,W 94-88,240,37,81,.457,33,63,.524,4,18,.222,16,19,.842,94,32,75,.427,27,56,.482,5,19,.263,19,29,.655,88
1870,SAS,2016-03-03,94,@,NOP,W 94-86,240,36,81,.444,28,60,.467,8,21,.381,14,15,.933,94,35,89,.393,27,65,.415,8,24,.333,8,8,1.000,86
1871,UTA,2016-03-02,94,@,TOR,L 94-104,240,37,83,.446,27,57,.474,10,26,.385,10,16,.625,94,40,80,.500,34,58,.586,6,22,.273,18,21,.857,104
1872,HOU,2016-02-27,94,,SAS,L 94-104,240,35,84,.417,27,59,.458,8,25,.320,16,22,.727,94,37,76,.487,29,57,.509,8,19,.421,22,28,.786,104
1873,PHI,2016-02-26,94,,WAS,L 94-103,240,35,82,.427,27,57,.474,8,25,.320,16,21,.762,94,40,94,.426,33,71,.465,7,23,.304,16,17,.941,103
1874,WAS,2016-02-20,94,@,MIA,L 94-114,240,40,99,.404,37,77,.481,3,22,.136,11,21,.524,94,47,96,.490,45,83,.542,2,13,.154,18,28,.643,114
1875,ATL,2016-02-07,94,@,ORL,L 94-96,240,35,91,.385,22,63,.349,13,28,.464,11,15,.733,94,39,85,.459,32,60,.533,7,25,.280,11,12,.917,96
1876,PHI,2016-02-05,94,@,WAS,L 94-106,240,37,87,.425,28,61,.459,9,26,.346,11,14,.786,94,44,84,.524,38,62,.613,6,22,.273,12,20,.600,106
1877,ORL,2016-01-29,94,@,BOS,L 94-113,240,32,79,.405,25,59,.424,7,20,.350,23,29,.793,94,43,86,.500,33,62,.532,10,24,.417,17,21,.810,113
1878,LAC,2016-01-24,94,@,TOR,L 94-112,240,34,76,.447,26,50,.520,8,26,.308,18,30,.600,94,41,83,.494,29,61,.475,12,22,.545,18,26,.692,112
1879,MIN,2016-01-20,94,@,DAL,L 94-106 (OT),265,40,91,.440,35,68,.515,5,23,.217,9,11,.818,94,42,97,.433,37,72,.514,5,25,.200,17,22,.773,106
1880,CHI,2016-01-20,94,,GSW,L 94-125,240,37,100,.370,36,80,.450,1,20,.050,19,24,.792,94,50,95,.526,38,63,.603,12,32,.375,13,20,.650,125
1881,PHO,2016-01-19,94,,IND,L 94-97,240,28,81,.346,17,46,.370,11,35,.314,27,29,.931,94,34,83,.410,30,63,.476,4,20,.200,25,34,.735,97
1882,IND,2016-01-13,94,@,BOS,L 94-103,240,37,91,.407,32,61,.525,5,30,.167,15,20,.750,94,40,90,.444,31,64,.484,9,26,.346,14,20,.700,103
1883,UTA,2016-01-07,94,@,HOU,L 94-103,240,38,78,.487,31,50,.620,7,28,.250,11,17,.647,94,39,75,.520,32,52,.615,7,23,.304,18,26,.692,103
1884,MEM,2016-01-06,94,@,OKC,L 94-112,240,35,90,.389,28,69,.406,7,21,.333,17,24,.708,94,38,83,.458,30,66,.455,8,17,.471,28,33,.848,112
1885,BOS,2016-01-06,94,,DET,L 94-99,240,34,91,.374,28,63,.444,6,28,.214,20,27,.741,94,33,74,.446,23,47,.489,10,27,.370,23,36,.639,99
1886,BRK,2016-01-04,94,,BOS,L 94-103,240,32,85,.376,26,57,.456,6,28,.214,24,27,.889,94,41,92,.446,35,71,.493,6,21,.286,15,19,.789,103
1887,IND,2016-01-02,94,,DET,W 94-82,240,33,73,.452,26,55,.473,7,18,.389,21,29,.724,94,33,93,.355,30,73,.411,3,20,.150,13,23,.565,82
1888,CHO,2016-01-01,94,@,TOR,L 94-104,240,34,85,.400,24,53,.453,10,32,.313,16,18,.889,94,36,91,.396,21,58,.362,15,33,.455,17,18,.944,104
1889,MIN,2015-12-30,94,,UTA,W 94-80,240,36,77,.468,31,67,.463,5,10,.500,17,27,.630,94,28,80,.350,18,41,.439,10,39,.256,14,20,.700,80
1890,TOR,2015-12-30,94,,WAS,W 94-91,240,28,82,.341,22,58,.379,6,24,.250,32,39,.821,94,35,87,.402,27,65,.415,8,22,.364,13,17,.765,91
1891,SAC,2015-12-27,94,,POR,L 94-98,240,30,76,.395,21,52,.404,9,24,.375,25,31,.806,94,38,92,.413,28,59,.475,10,33,.303,12,16,.750,98
1892,LAC,2015-12-25,94,@,LAL,W 94-84,240,38,85,.447,28,59,.475,10,26,.385,8,11,.727,94,32,77,.416,25,54,.463,7,23,.304,13,25,.520,84
1893,MIA,2015-12-25,94,,NOP,W 94-88 (OT),265,35,88,.398,29,62,.468,6,26,.231,18,27,.667,94,36,90,.400,30,70,.429,6,20,.300,10,11,.909,88
1894,TOR,2015-12-20,94,,SAC,L 94-104,240,35,94,.372,27,65,.415,8,29,.276,16,17,.941,94,40,76,.526,31,55,.564,9,21,.429,15,24,.625,104
1895,MIA,2015-12-18,94,,TOR,L 94-108,240,35,74,.473,26,49,.531,9,25,.360,15,17,.882,94,41,80,.513,33,59,.559,8,21,.381,18,22,.818,108
1896,POR,2015-12-18,94,@,ORL,L 94-102,240,32,73,.438,21,41,.512,11,32,.344,19,26,.731,94,39,84,.464,37,69,.536,2,15,.133,22,31,.710,102
1897,UTA,2015-12-16,94,,NOP,L 94-104,240,32,67,.478,25,47,.532,7,20,.350,23,29,.793,94,34,73,.466,24,52,.462,10,21,.476,26,28,.929,104
1898,PHO,2015-12-14,94,@,DAL,L 94-104,240,33,80,.413,24,55,.436,9,25,.360,19,27,.704,94,38,77,.494,26,45,.578,12,32,.375,16,21,.762,104
1899,NOP,2015-12-12,94,@,CHI,L 94-98,240,40,89,.449,34,73,.466,6,16,.375,8,11,.727,94,33,78,.423,25,58,.431,8,20,.400,24,29,.828,98
1900,OKC,2015-12-11,94,@,UTA,W 94-90,240,37,79,.468,31,62,.500,6,17,.353,14,16,.875,94,33,78,.423,25,50,.500,8,28,.286,16,24,.667,90
1901,ATL,2015-12-10,94,@,OKC,L 94-107,240,35,78,.449,25,50,.500,10,28,.357,14,23,.609,94,39,80,.488,30,63,.476,9,17,.529,20,26,.769,107
1902,SAS,2015-12-09,94,@,TOR,L 94-97,240,34,76,.447,27,51,.529,7,25,.280,19,24,.792,94,37,64,.578,34,54,.630,3,10,.300,20,22,.909,97
1903,UTA,2015-12-03,94,,ORL,L 94-103,240,31,72,.431,17,39,.436,14,33,.424,18,24,.750,94,40,89,.449,32,66,.485,8,23,.348,15,15,1.000,103
1904,BRK,2015-12-01,94,,PHO,W 94-91,240,41,84,.488,37,71,.521,4,13,.308,8,12,.667,94,33,75,.440,23,47,.489,10,28,.357,15,22,.682,91
1905,DEN,2015-11-24,94,,LAC,L 94-111,240,31,78,.397,23,53,.434,8,25,.320,24,29,.828,94,37,79,.468,29,59,.492,8,20,.400,29,47,.617,111
1906,CHI,2015-11-20,94,@,GSW,L 94-106,240,35,88,.398,28,66,.424,7,22,.318,17,23,.739,94,39,79,.494,29,50,.580,10,29,.345,18,24,.750,106
1907,CHO,2015-11-17,94,@,NYK,L 94-102,240,36,82,.439,31,62,.500,5,20,.250,17,25,.680,94,36,89,.404,26,69,.377,10,20,.500,20,21,.952,102
1908,POR,2015-11-15,94,@,CHO,L 94-106,240,35,89,.393,30,68,.441,5,21,.238,19,21,.905,94,41,83,.494,32,52,.615,9,31,.290,15,19,.789,106
1909,LAC,2015-11-09,94,,MEM,W 94-92,240,28,68,.412,23,49,.469,5,19,.263,33,37,.892,94,35,80,.438,33,69,.478,2,11,.182,20,29,.690,92
1910,MIL,2015-11-07,94,,BRK,W 94-86,240,37,82,.451,29,62,.468,8,20,.400,12,16,.750,94,34,82,.415,31,73,.425,3,9,.333,15,19,.789,86
1911,CHO,2015-11-07,94,@,SAS,L 94-114,240,34,73,.466,28,54,.519,6,19,.316,20,31,.645,94,45,81,.556,36,60,.600,9,21,.429,15,23,.652,114
1912,SAC,2015-11-07,94,,GSW,L 94-103,240,38,87,.437,32,68,.471,6,19,.316,12,16,.750,94,38,92,.413,30,53,.566,8,39,.205,19,22,.864,103
1913,DAL,2015-11-05,94,,CHO,L 94-108,240,32,82,.390,26,53,.491,6,29,.207,24,27,.889,94,44,89,.494,38,62,.613,6,27,.222,14,17,.824,108
1914,IND,2015-11-03,94,@,DET,W 94-82,240,38,88,.432,31,65,.477,7,23,.304,11,12,.917,94,33,86,.384,28,64,.438,5,22,.227,11,17,.647,82
1915,NOP,2015-11-03,94,,ORL,L 94-103,240,32,90,.356,20,54,.370,12,36,.333,18,25,.720,94,42,90,.467,35,72,.486,7,18,.389,12,12,1.000,103
1916,SAS,2015-11-02,94,@,NYK,W 94-84,240,39,79,.494,35,66,.530,4,13,.308,12,17,.706,94,32,89,.360,28,76,.368,4,13,.308,16,21,.762,84
1917,ATL,2015-11-01,94,@,CHO,W 94-92,240,37,88,.420,30,59,.508,7,29,.241,13,14,.929,94,32,86,.372,18,49,.367,14,37,.378,14,15,.933,92
1918,CHO,2015-10-30,94,@,ATL,L 94-97,240,36,88,.409,24,58,.414,12,30,.400,10,13,.769,94,36,83,.434,28,60,.467,8,23,.348,17,22,.773,97
1919,CHI,2015-10-30,94,@,DET,L 94-98 (OT),265,34,84,.405,27,62,.435,7,22,.318,19,26,.731,94,39,104,.375,33,76,.434,6,28,.214,14,28,.500,98
1920,CHO,2015-10-28,94,@,MIA,L 94-104,240,33,84,.393,27,60,.450,6,24,.250,22,29,.759,94,36,73,.493,24,53,.453,12,20,.600,20,21,.952,104
1921,NOP,2015-10-28,94,@,POR,L 94-112,240,36,91,.396,25,58,.431,11,33,.333,11,18,.611,94,44,88,.500,32,56,.571,12,32,.375,12,14,.857,112
1922,ATL,2015-10-27,94,,DET,L 94-106,240,37,82,.451,29,55,.527,8,27,.296,12,15,.800,94,37,96,.385,25,67,.373,12,29,.414,20,26,.769,106
1923,DET,2016-04-12,93,,MIA,L 93-99,240,34,84,.405,29,66,.439,5,18,.278,20,30,.667,93,38,78,.487,31,58,.534,7,20,.350,16,22,.727,99
1924,TOR,2016-04-10,93,@,NYK,W 93-89,240,37,78,.474,30,58,.517,7,20,.350,12,19,.632,93,32,89,.360,25,69,.362,7,20,.350,18,21,.857,89
1925,MEM,2016-04-08,93,@,DAL,L 93-103,240,35,87,.402,28,65,.431,7,22,.318,16,22,.727,93,30,60,.500,18,29,.621,12,31,.387,31,39,.795,103
1926,NOP,2016-04-05,93,@,PHI,L 93-107,240,37,82,.451,30,64,.469,7,18,.389,12,16,.750,93,40,88,.455,27,54,.500,13,34,.382,14,17,.824,107
1927,MIA,2016-04-02,93,@,POR,L 93-110,240,34,88,.386,28,69,.406,6,19,.316,19,27,.704,93,41,79,.519,31,64,.484,10,15,.667,18,23,.783,110
1928,SAC,2016-03-28,93,@,POR,L 93-105,240,37,89,.416,30,74,.405,7,15,.467,12,19,.632,93,38,80,.475,24,51,.471,14,29,.483,15,18,.833,105
1929,NYK,2016-03-26,93,,CLE,L 93-107,240,33,79,.418,25,56,.446,8,23,.348,19,28,.679,93,37,83,.446,23,49,.469,14,34,.412,19,25,.760,107
1930,UTA,2016-03-26,93,@,MIN,W 93-84,240,39,83,.470,30,62,.484,9,21,.429,6,7,.857,93,32,84,.381,28,73,.384,4,11,.364,16,19,.842,84
1931,CHO,2016-03-19,93,,DEN,L 93-101,240,35,83,.422,26,51,.510,9,32,.281,14,20,.700,93,38,87,.437,29,69,.420,9,18,.500,16,23,.696,101
1932,SAS,2016-03-12,93,,OKC,W 93-85,240,34,85,.400,30,61,.492,4,24,.167,21,25,.840,93,31,81,.383,29,63,.460,2,18,.111,21,25,.840,85
1933,WAS,2016-03-11,93,@,UTA,L 93-114,240,35,80,.438,28,56,.500,7,24,.292,16,22,.727,93,38,67,.567,29,51,.569,9,16,.563,29,38,.763,114
1934,POR,2016-03-02,93,@,BOS,L 93-116,240,34,84,.405,23,55,.418,11,29,.379,14,20,.700,93,43,107,.402,36,81,.444,7,26,.269,23,24,.958,116
1935,IND,2016-02-22,93,@,MIA,L 93-101 (OT),265,36,92,.391,31,77,.403,5,15,.333,16,25,.640,93,38,100,.380,36,87,.414,2,13,.154,23,34,.676,101
1936,BOS,2016-02-19,93,@,UTA,L 93-111,240,30,81,.370,23,56,.411,7,25,.280,26,36,.722,93,37,68,.544,27,45,.600,10,23,.435,27,44,.614,111
1937,MIA,2016-02-07,93,,LAC,L 93-100,240,33,83,.398,26,66,.394,7,17,.412,20,29,.690,93,37,81,.457,28,56,.500,9,25,.360,17,33,.515,100
1938,ORL,2016-02-05,93,,LAC,L 93-107,240,34,81,.420,30,61,.492,4,20,.200,21,28,.750,93,40,74,.541,32,47,.681,8,27,.296,19,23,.826,107
1939,MIA,2016-02-03,93,@,DAL,W 93-90,240,37,88,.420,35,73,.479,2,15,.133,17,23,.739,93,34,87,.391,26,67,.388,8,20,.400,14,19,.737,90
1940,TOR,2016-02-01,93,@,DEN,L 93-112,240,29,78,.372,21,53,.396,8,25,.320,27,39,.692,93,45,83,.542,35,61,.574,10,22,.455,12,15,.800,112
1941,MIN,2016-01-31,93,@,POR,L 93-96,240,35,80,.438,31,64,.484,4,16,.250,19,28,.679,93,32,76,.421,26,49,.531,6,27,.222,26,30,.867,96
1942,CHI,2016-01-31,93,@,LAC,L 93-120,240,40,93,.430,35,78,.449,5,15,.333,8,11,.727,93,45,84,.536,28,52,.538,17,32,.531,13,19,.684,120
1943,LAL,2016-01-29,93,@,LAC,L 93-105,240,34,78,.436,29,65,.446,5,13,.385,20,25,.800,93,40,81,.494,32,55,.582,8,26,.308,17,24,.708,105
1944,NYK,2016-01-28,93,@,TOR,L 93-103,240,38,87,.437,31,69,.449,7,18,.389,10,20,.500,93,37,85,.435,29,65,.446,8,20,.400,21,29,.724,103
1945,PHO,2016-01-27,93,@,CLE,L 93-115,240,33,70,.471,25,50,.500,8,20,.400,19,25,.760,93,45,81,.556,34,53,.642,11,28,.393,14,16,.875,115
1946,LAL,2016-01-20,93,,SAC,L 93-112,240,32,90,.356,28,65,.431,4,25,.160,25,31,.806,93,43,89,.483,37,69,.536,6,20,.300,20,28,.714,112
1947,MIN,2016-01-15,93,@,OKC,L 93-113,240,34,85,.400,29,73,.397,5,12,.417,20,23,.870,93,47,89,.528,42,66,.636,5,23,.217,14,22,.636,113
1948,DAL,2016-01-10,93,@,MIN,W 93-87,240,36,77,.468,30,57,.526,6,20,.300,15,21,.714,93,33,79,.418,29,63,.460,4,16,.250,17,22,.773,87
1949,HOU,2016-01-04,93,@,UTA,W 93-91,240,33,68,.485,22,42,.524,11,26,.423,16,21,.762,93,30,75,.400,18,46,.391,12,29,.414,19,25,.760,91
1950,LAL,2016-01-01,93,,PHI,W 93-84,240,33,87,.379,28,71,.394,5,16,.313,22,29,.759,93,31,84,.369,27,60,.450,4,24,.167,18,25,.720,84
1951,BRK,2015-12-30,93,@,ORL,L 93-100,240,35,83,.422,32,63,.508,3,20,.150,20,22,.909,93,36,82,.439,27,56,.482,9,26,.346,19,21,.905,100
1952,CLE,2015-12-29,93,@,DEN,W 93-87,240,38,86,.442,34,64,.531,4,22,.182,13,22,.591,93,37,89,.416,32,65,.492,5,24,.208,8,11,.727,87
1953,MIL,2015-12-28,93,@,DAL,L 93-103,240,38,79,.481,34,65,.523,4,14,.286,13,15,.867,93,38,84,.452,28,62,.452,10,22,.455,17,26,.654,103
1954,IND,2015-12-28,93,,ATL,W 93-87,240,38,87,.437,31,61,.508,7,26,.269,10,18,.556,93,31,74,.419,25,49,.510,6,25,.240,19,25,.760,87
1955,DET,2015-12-26,93,,BOS,L 93-99,240,35,91,.385,29,66,.439,6,25,.240,17,25,.680,93,39,84,.464,35,61,.574,4,23,.174,17,23,.739,99
1956,DET,2015-12-22,93,@,MIA,W 93-92,240,35,78,.449,20,48,.417,15,30,.500,8,14,.571,93,39,88,.443,35,70,.500,4,18,.222,10,12,.833,92
1957,CHO,2015-12-12,93,,BOS,L 93-98,240,36,88,.409,25,53,.472,11,35,.314,10,10,1.000,93,40,96,.417,31,71,.437,9,25,.360,9,10,.900,98
1958,MEM,2015-12-09,93,@,DET,W 93-92,240,41,88,.466,37,73,.507,4,15,.267,7,13,.538,93,37,87,.425,29,58,.500,8,29,.276,10,15,.667,92
1959,LAL,2015-12-07,93,@,TOR,L 93-102,240,34,83,.410,27,64,.422,7,19,.368,18,20,.900,93,34,74,.459,25,49,.510,9,25,.360,25,32,.781,102
1960,NOP,2015-12-07,93,,BOS,L 93-111,240,37,90,.411,33,77,.429,4,13,.308,15,18,.833,93,40,81,.494,28,53,.528,12,28,.429,19,24,.792,111
1961,PHO,2015-12-06,93,@,MEM,L 93-95,240,36,82,.439,27,51,.529,9,31,.290,12,17,.706,93,36,90,.400,31,75,.413,5,15,.333,18,24,.750,95
1962,MIN,2015-12-01,93,,ORL,L 93-96,240,29,77,.377,25,58,.431,4,19,.211,31,38,.816,93,38,86,.442,33,69,.478,5,17,.294,15,20,.750,96
1963,HOU,2015-11-25,93,,MEM,L 93-102,240,30,71,.423,20,37,.541,10,34,.294,23,27,.852,93,39,80,.488,36,64,.563,3,16,.188,21,23,.913,102
1964,CHI,2015-11-24,93,@,POR,W 93-88,240,33,86,.384,26,68,.382,7,18,.389,20,23,.870,93,31,88,.352,25,66,.379,6,22,.273,20,27,.741,88
1965,LAL,2015-11-22,93,,POR,L 93-107,240,32,88,.364,26,70,.371,6,18,.333,23,27,.852,93,43,87,.494,35,62,.565,8,25,.320,13,17,.765,107
1966,UTA,2015-11-20,93,@,DAL,L 93-102,240,35,80,.438,29,60,.483,6,20,.300,17,21,.810,93,39,83,.470,31,55,.564,8,28,.286,16,17,.941,102
1967,NYK,2015-11-20,93,@,OKC,W 93-90,240,33,72,.458,21,52,.404,12,20,.600,15,23,.652,93,35,92,.380,32,63,.508,3,29,.103,17,23,.739,90
1968,UTA,2015-11-18,93,,TOR,W 93-89,240,35,72,.486,28,50,.560,7,22,.318,16,22,.727,93,34,80,.425,29,60,.483,5,20,.250,16,18,.889,89
1969,SAS,2015-11-16,93,,POR,W 93-80,240,38,89,.427,31,66,.470,7,23,.304,10,13,.769,93,31,75,.413,24,56,.429,7,19,.368,11,13,.846,80
1970,ATL,2015-11-13,93,@,BOS,L 93-106,240,36,76,.474,30,56,.536,6,20,.300,15,20,.750,93,42,103,.408,31,70,.443,11,33,.333,11,12,.917,106
1971,UTA,2015-11-13,93,@,ORL,L 93-102,240,34,87,.391,26,62,.419,8,25,.320,17,23,.739,93,32,76,.421,22,49,.449,10,27,.370,28,31,.903,102
1972,NYK,2015-11-11,93,@,CHO,L 93-95,240,42,86,.488,38,65,.585,4,21,.190,5,7,.714,93,35,84,.417,27,61,.443,8,23,.348,17,28,.607,95
1973,CHI,2015-11-07,93,,MIN,L 93-102 (OT),265,33,93,.355,22,61,.361,11,32,.344,16,23,.696,93,39,96,.406,32,80,.400,7,16,.438,17,27,.630,102
1974,DEN,2015-11-01,93,@,OKC,L 93-117,240,35,92,.380,26,66,.394,9,26,.346,14,19,.737,93,45,86,.523,32,61,.525,13,25,.520,14,18,.778,117
1975,LAL,2015-11-01,93,,DAL,L 93-103,240,31,85,.365,21,51,.412,10,34,.294,21,28,.750,93,40,87,.460,29,57,.509,11,30,.367,12,16,.750,103
1976,MIL,2016-04-13,92,,IND,L 92-97,240,37,87,.425,30,64,.469,7,23,.304,11,13,.846,92,39,90,.433,28,66,.424,11,24,.458,8,10,.800,97
1977,UTA,2016-04-11,92,,DAL,L 92-101,240,35,77,.455,26,44,.591,9,33,.273,13,18,.722,92,36,81,.444,25,49,.510,11,32,.344,18,22,.818,101
1978,GSW,2016-04-10,92,@,SAS,W 92-86,240,34,77,.442,24,50,.480,10,27,.370,14,18,.778,92,34,90,.378,31,73,.425,3,17,.176,15,19,.789,86
1979,CHI,2016-04-05,92,@,MEM,L 92-108,240,34,77,.442,23,48,.479,11,29,.379,13,19,.684,92,39,87,.448,32,68,.471,7,19,.368,23,26,.885,108
1980,IND,2016-04-03,92,@,NYK,W 92-87,240,34,81,.420,27,59,.458,7,22,.318,17,20,.850,92,33,96,.344,26,71,.366,7,25,.280,14,20,.700,87
1981,NOP,2016-03-30,92,@,SAS,L 92-100,240,36,80,.450,28,63,.444,8,17,.471,12,18,.667,92,36,75,.480,24,51,.471,12,24,.500,16,22,.727,100
1982,SAS,2016-03-26,92,@,OKC,L 92-111,240,37,86,.430,33,71,.465,4,15,.267,14,17,.824,92,44,85,.518,37,65,.569,7,20,.350,16,18,.889,111
1983,IND,2016-03-24,92,,NOP,W 92-84,240,36,79,.456,29,59,.492,7,20,.350,13,15,.867,92,35,85,.412,31,69,.449,4,16,.250,10,14,.714,84
1984,DET,2016-03-21,92,,MIL,W 92-91,240,35,85,.412,26,52,.500,9,33,.273,13,17,.765,92,41,76,.539,36,67,.537,5,9,.556,4,7,.571,91
1985,CHI,2016-03-19,92,,UTA,W 92-85,240,39,80,.488,33,61,.541,6,19,.316,8,11,.727,92,35,86,.407,27,59,.458,8,27,.296,7,12,.583,85
1986,NOP,2016-03-12,92,@,MIL,L 92-103,240,35,89,.393,29,60,.483,6,29,.207,16,21,.762,92,40,81,.494,36,68,.529,4,13,.308,19,24,.792,103
1987,PHO,2016-03-03,92,@,MIA,L 92-108,240,33,82,.402,28,60,.467,5,22,.227,21,27,.778,92,40,83,.482,31,66,.470,9,17,.529,19,25,.760,108
1988,PHO,2016-03-01,92,@,CHO,L 92-126,240,33,91,.363,27,64,.422,6,27,.222,20,27,.741,92,45,93,.484,32,66,.485,13,27,.481,23,27,.852,126
1989,SAC,2016-02-24,92,,SAS,L 92-108,240,39,96,.406,33,78,.423,6,18,.333,8,15,.533,92,44,85,.518,36,66,.545,8,19,.421,12,15,.800,108
1990,ATL,2016-02-22,92,,GSW,L 92-102,240,36,86,.419,26,52,.500,10,34,.294,10,16,.625,92,39,89,.438,25,44,.568,14,45,.311,10,12,.833,102
1991,OKC,2016-02-21,92,,CLE,L 92-115,240,37,90,.411,32,69,.464,5,21,.238,13,19,.684,92,41,80,.513,31,57,.544,10,23,.435,23,27,.852,115
1992,WAS,2016-02-11,92,@,MIL,L 92-99,240,34,88,.386,28,56,.500,6,32,.188,18,24,.750,92,36,82,.439,32,68,.471,4,14,.286,23,32,.719,99
1993,DET,2016-02-10,92,,DEN,L 92-103,240,38,88,.432,28,61,.459,10,27,.370,6,7,.857,92,39,83,.470,33,64,.516,6,19,.316,19,24,.792,103
1994,PHI,2016-02-08,92,,LAC,L 92-98 (OT),265,34,90,.378,28,65,.431,6,25,.240,18,21,.857,92,35,95,.368,30,73,.411,5,22,.227,23,31,.742,98
1995,ORL,2016-02-01,92,@,SAS,L 92-107,240,39,96,.406,34,79,.430,5,17,.294,9,11,.818,92,40,78,.513,31,54,.574,9,24,.375,18,21,.857,107
1996,ATL,2016-01-28,92,@,IND,L 92-111,240,33,83,.398,26,55,.473,7,28,.250,19,21,.905,92,38,78,.487,29,63,.460,9,15,.600,26,30,.867,111
1997,DAL,2016-01-26,92,@,LAL,W 92-90,240,33,76,.434,27,51,.529,6,25,.240,20,26,.769,92,30,74,.405,23,49,.469,7,25,.280,23,28,.821,90
1998,UTA,2016-01-25,92,,DET,L 92-95,240,34,85,.400,25,56,.446,9,29,.310,15,18,.833,92,34,75,.453,23,53,.434,11,22,.500,16,33,.485,95
1999,PHI,2016-01-24,92,,BOS,L 92-112,240,35,89,.393,27,63,.429,8,26,.308,14,20,.700,92,43,97,.443,32,72,.444,11,25,.440,15,19,.789,112
2000,CHO,2016-01-16,92,,MIL,L 92-105,240,33,87,.379,24,51,.471,9,36,.250,17,22,.773,92,39,72,.542,34,60,.567,5,12,.417,22,26,.846,105
2001,CHO,2016-01-10,92,@,DEN,L 92-95,240,30,83,.361,18,47,.383,12,36,.333,20,24,.833,92,32,77,.416,20,50,.400,12,27,.444,19,23,.826,95
2002,BOS,2016-01-07,92,@,CHI,L 92-101,240,35,98,.357,30,73,.411,5,25,.200,17,22,.773,92,39,94,.415,30,72,.417,9,22,.409,14,17,.824,101
2003,UTA,2016-01-02,92,,MEM,W 92-87 (OT),265,31,75,.413,22,48,.458,9,27,.333,21,28,.750,92,33,81,.407,26,63,.413,7,18,.389,14,26,.538,87
2004,MEM,2015-12-26,92,@,CHO,L 92-98,240,37,90,.411,30,71,.423,7,19,.368,11,21,.524,92,28,69,.406,14,37,.378,14,32,.438,28,32,.875,98
2005,MIA,2015-12-22,92,,DET,L 92-93,240,39,88,.443,35,70,.500,4,18,.222,10,12,.833,92,35,78,.449,20,48,.417,15,30,.500,8,14,.571,93
2006,IND,2015-12-21,92,@,SAS,L 92-106,240,38,90,.422,31,71,.437,7,19,.368,9,15,.600,92,46,89,.517,40,69,.580,6,20,.300,8,9,.889,106
2007,DET,2015-12-09,92,,MEM,L 92-93,240,37,87,.425,29,58,.500,8,29,.276,10,15,.667,92,41,88,.466,37,73,.507,4,15,.267,7,13,.538,93
2008,MIL,2015-11-30,92,,DEN,W 92-74,240,35,77,.455,29,59,.492,6,18,.333,16,22,.727,92,28,75,.373,22,56,.393,6,19,.316,12,16,.750,74
2009,CHI,2015-11-30,92,,SAS,W 92-89,240,37,86,.430,31,70,.443,6,16,.375,12,20,.600,92,37,90,.411,35,76,.461,2,14,.143,13,18,.722,89
2010,MEM,2015-11-29,92,,PHI,W 92-84,240,34,81,.420,30,68,.441,4,13,.308,20,27,.741,92,30,77,.390,18,41,.439,12,36,.333,12,16,.750,84
2011,DAL,2015-11-28,92,,DEN,W 92-81,240,33,77,.429,26,51,.510,7,26,.269,19,27,.704,92,30,75,.400,22,50,.440,8,25,.320,13,17,.765,81
2012,CHI,2015-11-27,92,@,IND,L 92-104,240,32,92,.348,21,66,.318,11,26,.423,17,20,.850,92,37,87,.425,29,59,.492,8,28,.286,22,29,.759,104
2013,SAS,2015-11-21,92,,MEM,W 92-82,240,34,72,.472,27,51,.529,7,21,.333,17,22,.773,92,32,74,.432,31,65,.477,1,9,.111,17,17,1.000,82
2014,DAL,2015-11-16,92,@,PHI,W 92-86,240,30,76,.395,23,52,.442,7,24,.292,25,30,.833,92,34,76,.447,29,54,.537,5,22,.227,13,20,.650,86
2015,SAS,2015-11-14,92,,PHI,W 92-83,240,33,85,.388,28,69,.406,5,16,.313,21,25,.840,92,33,82,.402,25,60,.417,8,22,.364,9,11,.818,83
2016,MIA,2015-11-12,92,,UTA,W 92-91,240,36,77,.468,32,64,.500,4,13,.308,16,25,.640,92,34,89,.382,30,72,.417,4,17,.235,19,25,.760,91
2017,DET,2015-11-11,92,@,SAC,L 92-101,240,34,89,.382,25,57,.439,9,32,.281,15,20,.750,92,37,74,.500,28,58,.483,9,16,.563,18,24,.750,101
2018,MEM,2015-11-09,92,@,LAC,L 92-94,240,35,80,.438,33,69,.478,2,11,.182,20,29,.690,92,28,68,.412,23,49,.469,5,19,.263,33,37,.892,94
2019,NYK,2015-11-06,92,,MIL,L 92-99,240,33,81,.407,29,57,.509,4,24,.167,22,28,.786,92,35,81,.432,32,67,.478,3,14,.214,26,29,.897,99
2020,PHO,2015-11-06,92,,DET,L 92-100,240,37,92,.402,27,62,.435,10,30,.333,8,13,.615,92,37,74,.500,29,52,.558,8,22,.364,18,36,.500,100
2021,ORL,2015-11-06,92,,TOR,W 92-87,240,33,77,.429,24,52,.462,9,25,.360,17,22,.773,92,30,86,.349,25,63,.397,5,23,.217,22,29,.759,87
2022,UTA,2015-11-04,92,,POR,L 92-108,240,33,88,.375,28,64,.438,5,24,.208,21,33,.636,92,41,77,.532,30,52,.577,11,25,.440,15,32,.469,108
2023,MIA,2015-11-03,92,,ATL,L 92-98,240,38,86,.442,33,58,.569,5,28,.179,11,16,.688,92,37,90,.411,30,69,.435,7,21,.333,17,22,.773,98
2024,CHI,2015-11-01,92,,ORL,W 92-87,240,33,87,.379,26,59,.441,7,28,.250,19,22,.864,92,35,90,.389,28,67,.418,7,23,.304,10,17,.588,87
2025,CHO,2015-11-01,92,,ATL,L 92-94,240,32,86,.372,18,49,.367,14,37,.378,14,15,.933,92,37,88,.420,30,59,.508,7,29,.241,13,14,.929,94
2026,HOU,2015-10-30,92,,GSW,L 92-112,240,30,82,.366,25,59,.424,5,23,.217,27,36,.750,92,43,93,.462,34,67,.507,9,26,.346,17,25,.680,112
2027,MIA,2015-10-30,92,@,CLE,L 92-102,240,33,77,.429,27,56,.482,6,21,.286,20,22,.909,92,39,86,.453,33,61,.541,6,25,.240,18,21,.857,102
2028,POR,2015-10-30,92,@,PHO,L 92-110,240,34,86,.395,25,62,.403,9,24,.375,15,19,.789,92,37,83,.446,33,65,.508,4,18,.222,32,42,.762,110
2029,DET,2015-10-28,92,,UTA,W 92-87,240,30,74,.405,23,55,.418,7,19,.368,25,34,.735,92,35,75,.467,33,63,.524,2,12,.167,15,21,.714,87
2030,DAL,2016-04-13,91,,SAS,L 91-96,240,31,77,.403,19,38,.500,12,39,.308,17,21,.810,91,35,74,.473,29,51,.569,6,23,.261,20,26,.769,96
2031,DAL,2016-04-10,91,@,LAC,L 91-98,240,30,74,.405,22,44,.500,8,30,.267,23,33,.697,91,37,76,.487,28,58,.483,9,18,.500,15,37,.405,98
2032,LAC,2016-04-06,91,@,LAL,W 91-81,240,37,83,.446,30,58,.517,7,25,.280,10,14,.714,91,32,90,.356,28,71,.394,4,19,.211,13,17,.765,81
2033,PHI,2016-04-01,91,@,CHO,L 91-100,240,33,90,.367,23,51,.451,10,39,.256,15,21,.714,91,36,84,.429,29,57,.509,7,27,.259,21,27,.778,100
2034,BRK,2016-04-01,91,@,NYK,L 91-105,240,36,101,.356,32,77,.416,4,24,.167,15,20,.750,91,42,84,.500,28,61,.459,14,23,.609,7,7,1.000,105
2035,DAL,2016-03-30,91,,NYK,W 91-89,240,35,85,.412,27,60,.450,8,25,.320,13,17,.765,91,35,77,.455,32,60,.533,3,17,.176,16,18,.889,89
2036,NYK,2016-03-28,91,@,NOP,L 91-99,240,36,89,.404,26,58,.448,10,31,.323,9,13,.692,91,32,75,.427,24,56,.429,8,19,.421,27,37,.730,99
2037,MIL,2016-03-26,91,,CHO,L 91-115,240,37,84,.440,33,69,.478,4,15,.267,13,15,.867,91,41,74,.554,25,45,.556,16,29,.552,17,21,.810,115
2038,NOP,2016-03-26,91,,TOR,L 91-115,240,37,85,.435,33,70,.471,4,15,.267,13,20,.650,91,39,73,.534,27,44,.614,12,29,.414,25,28,.893,115
2039,UTA,2016-03-24,91,@,OKC,L 91-113,240,35,73,.479,30,51,.588,5,22,.227,16,23,.696,91,45,83,.542,36,61,.590,9,22,.409,14,22,.636,113
2040,BOS,2016-03-23,91,,TOR,W 91-79,240,35,80,.438,27,60,.450,8,20,.400,13,21,.619,91,31,89,.348,25,67,.373,6,22,.273,11,20,.550,79
2041,DEN,2016-03-21,91,@,CLE,L 91-124,240,32,81,.395,24,59,.407,8,22,.364,19,25,.760,91,48,86,.558,33,55,.600,15,31,.484,13,17,.765,124
2042,MIL,2016-03-21,91,@,DET,L 91-92,240,41,76,.539,36,67,.537,5,9,.556,4,7,.571,91,35,85,.412,26,52,.500,9,33,.273,13,17,.765,92
2043,CHO,2016-03-21,91,,SAS,W 91-88,240,35,87,.402,27,68,.397,8,19,.421,13,19,.684,91,37,86,.430,33,69,.478,4,17,.235,10,13,.769,88
2044,IND,2016-03-21,91,,PHI,W 91-75,240,35,81,.432,25,55,.455,10,26,.385,11,13,.846,91,31,80,.388,27,62,.435,4,18,.222,9,14,.643,75
2045,BOS,2016-03-18,91,@,TOR,L 91-105,240,36,82,.439,27,61,.443,9,21,.429,10,12,.833,91,37,77,.481,24,49,.490,13,28,.464,18,25,.720,105
2046,ATL,2016-03-08,91,@,UTA,W 91-84,240,38,80,.475,30,55,.545,8,25,.320,7,14,.500,91,30,86,.349,23,60,.383,7,26,.269,17,23,.739,84
2047,MIN,2016-03-08,91,,SAS,L 91-116,240,36,79,.456,32,64,.500,4,15,.267,15,19,.789,91,47,85,.553,43,66,.652,4,19,.211,18,19,.947,116
2048,SAS,2016-03-07,91,@,IND,L 91-99,240,34,96,.354,30,68,.441,4,28,.143,19,22,.864,91,32,78,.410,25,62,.403,7,16,.438,28,30,.933,99
2049,MIL,2016-02-27,91,,DET,L 91-102,240,38,78,.487,31,66,.470,7,12,.583,8,12,.667,91,37,88,.420,25,58,.431,12,30,.400,16,24,.667,102
2050,PHI,2016-02-24,91,@,DET,L 91-111,240,33,83,.398,26,60,.433,7,23,.304,18,26,.692,91,39,83,.470,28,55,.509,11,28,.393,22,34,.647,111
2051,CHI,2016-02-08,91,@,CHO,L 91-108,240,35,90,.389,25,65,.385,10,25,.400,11,14,.786,91,35,80,.438,21,44,.477,14,36,.389,24,31,.774,108
2052,MEM,2016-02-05,91,@,NYK,W 91-85,240,33,76,.434,29,58,.500,4,18,.222,21,24,.875,91,30,80,.375,20,51,.392,10,29,.345,15,17,.882,85
2053,DAL,2016-01-31,91,,PHO,W 91-78,240,31,78,.397,23,49,.469,8,29,.276,21,23,.913,91,27,74,.365,22,51,.431,5,23,.217,19,24,.792,78
2054,DAL,2016-01-29,91,,BRK,W 91-79,240,37,80,.463,29,59,.492,8,21,.381,9,15,.600,91,28,78,.359,24,58,.414,4,20,.200,19,23,.826,79
2055,CHO,2016-01-29,91,@,POR,L 91-109,240,31,80,.388,21,51,.412,10,29,.345,19,28,.679,91,45,92,.489,38,72,.528,7,20,.350,12,16,.750,109
2056,LAL,2016-01-28,91,,CHI,L 91-114,240,32,85,.376,23,60,.383,9,25,.360,18,23,.783,91,47,95,.495,41,78,.526,6,17,.353,14,16,.875,114
2057,LAC,2016-01-26,91,@,IND,W 91-89,240,32,78,.410,17,41,.415,15,37,.405,12,24,.500,91,35,83,.422,30,67,.448,5,16,.313,14,24,.583,89
2058,WAS,2016-01-25,91,,BOS,L 91-116,240,32,75,.427,25,51,.490,7,24,.292,20,30,.667,91,44,90,.489,35,68,.515,9,22,.409,19,23,.826,116
2059,SAC,2016-01-21,91,,ATL,W 91-88,240,33,92,.359,26,68,.382,7,24,.292,18,24,.750,91,35,84,.417,27,51,.529,8,33,.242,10,15,.667,88
2060,CLE,2016-01-20,91,@,BRK,W 91-78,240,36,77,.468,31,60,.517,5,17,.294,14,20,.700,91,35,84,.417,31,65,.477,4,19,.211,4,8,.500,78
2061,MIL,2016-01-19,91,@,MIA,W 91-79,240,36,74,.486,31,62,.500,5,12,.417,14,16,.875,91,27,74,.365,22,52,.423,5,22,.227,20,26,.769,79
2062,CLE,2016-01-15,91,@,HOU,W 91-77,240,34,87,.391,26,52,.500,8,35,.229,15,23,.652,91,26,74,.351,20,49,.408,6,25,.240,19,29,.655,77
2063,MEM,2016-01-12,91,,HOU,L 91-107,240,33,72,.458,26,54,.481,7,18,.389,18,24,.750,91,33,77,.429,15,42,.357,18,35,.514,23,27,.852,107
2064,NOP,2016-01-12,91,@,LAL,L 91-95,240,38,91,.418,32,68,.471,6,23,.261,9,14,.643,91,32,87,.368,26,58,.448,6,29,.207,25,32,.781,95
2065,MEM,2016-01-08,91,,DEN,W 91-84,240,30,82,.366,22,64,.344,8,18,.444,23,30,.767,91,32,87,.368,28,68,.412,4,19,.211,16,19,.842,84
2066,IND,2016-01-08,91,@,NOP,W 91-86,240,36,81,.444,31,60,.517,5,21,.238,14,19,.737,91,31,83,.373,22,54,.407,9,29,.310,15,20,.750,86
2067,TOR,2016-01-06,91,@,BRK,W 91-74,240,35,80,.438,31,58,.534,4,22,.182,17,18,.944,91,31,78,.397,26,62,.419,5,16,.313,7,12,.583,74
2068,NOP,2016-01-06,91,,DAL,L 91-100,240,34,92,.370,27,62,.435,7,30,.233,16,20,.800,91,37,87,.425,30,59,.508,7,28,.250,19,22,.864,100
2069,MEM,2016-01-04,91,@,POR,W 91-78,240,35,91,.385,32,76,.421,3,15,.200,18,26,.692,91,28,72,.389,21,44,.477,7,28,.250,15,24,.625,78
2070,UTA,2016-01-04,91,,HOU,L 91-93,240,30,75,.400,18,46,.391,12,29,.414,19,25,.760,91,33,68,.485,22,42,.524,11,26,.423,16,21,.762,93
2071,ORL,2016-01-01,91,@,WAS,L 91-103,240,40,85,.471,35,65,.538,5,20,.250,6,8,.750,91,43,92,.467,35,66,.530,8,26,.308,9,10,.900,103
2072,GSW,2015-12-30,91,@,DAL,L 91-114,240,33,81,.407,26,62,.419,7,19,.368,18,24,.750,91,42,82,.512,28,55,.509,14,27,.519,16,20,.800,114
2073,WAS,2015-12-30,91,@,TOR,L 91-94,240,35,87,.402,27,65,.415,8,22,.364,13,17,.765,91,28,82,.341,22,58,.379,6,24,.250,32,39,.821,94
2074,WAS,2015-12-28,91,,LAC,L 91-108,240,34,87,.391,27,63,.429,7,24,.292,16,24,.667,91,41,78,.526,34,55,.618,7,23,.304,19,25,.760,108
2075,PHI,2015-12-28,91,@,UTA,L 91-95,240,36,86,.419,31,65,.477,5,21,.238,14,19,.737,91,28,84,.333,21,58,.362,7,26,.269,32,36,.889,95
2076,NYK,2015-12-27,91,@,BOS,L 91-100,240,33,89,.371,29,70,.414,4,19,.211,21,24,.875,91,36,85,.424,28,65,.431,8,20,.400,20,29,.690,100
2077,CLE,2015-12-23,91,,NYK,W 91-84,240,32,83,.386,27,61,.443,5,22,.227,22,25,.880,91,32,82,.390,27,66,.409,5,16,.313,15,16,.938,84
2078,MEM,2015-12-23,91,@,WAS,L 91-100,240,33,72,.458,30,55,.545,3,17,.176,22,32,.688,91,37,82,.451,26,57,.456,11,25,.440,15,19,.789,100
2079,CHI,2015-12-19,91,@,NYK,L 91-107,240,37,94,.394,32,73,.438,5,21,.238,12,17,.706,91,41,82,.500,36,62,.581,5,20,.250,20,24,.833,107
2080,PHI,2015-12-10,91,@,BRK,L 91-100,240,34,87,.391,30,56,.536,4,31,.129,19,22,.864,91,37,74,.500,31,60,.517,6,14,.429,20,27,.741,100
2081,LAL,2015-12-06,91,@,DET,L 91-111,240,32,80,.400,27,62,.435,5,18,.278,22,29,.759,91,41,93,.441,32,69,.464,9,24,.375,20,26,.769,111
2082,NYK,2015-12-05,91,@,MIL,L 91-106,240,32,76,.421,26,51,.510,6,25,.240,21,28,.750,91,44,89,.494,42,85,.494,2,4,.500,16,24,.667,106
2083,BRK,2015-12-04,91,@,NYK,L 91-108,240,39,91,.429,36,80,.450,3,11,.273,10,15,.667,91,39,87,.448,27,60,.450,12,27,.444,18,21,.857,108
2084,LAC,2015-12-02,91,,IND,L 91-103,240,30,79,.380,24,52,.462,6,27,.222,25,39,.641,91,32,76,.421,25,56,.446,7,20,.350,32,39,.821,103
2085,PHO,2015-12-01,91,@,BRK,L 91-94,240,33,75,.440,23,47,.489,10,28,.357,15,22,.682,91,41,84,.488,37,71,.521,4,13,.308,8,12,.667,94
2086,LAL,2015-12-01,91,@,PHI,L 91-103,240,33,89,.371,25,55,.455,8,34,.235,17,24,.708,91,37,79,.468,23,47,.489,14,32,.438,15,23,.652,103
2087,BOS,2015-11-29,91,@,ORL,L 91-110,240,36,88,.409,31,61,.508,5,27,.185,14,20,.700,91,45,93,.484,36,68,.529,9,25,.360,11,16,.688,110
2088,SAC,2015-11-27,91,,MIN,L 91-101,240,37,86,.430,29,64,.453,8,22,.364,9,15,.600,91,37,77,.481,28,52,.538,9,25,.360,18,19,.947,101
2089,SAS,2015-11-27,91,@,DEN,W 91-80,240,36,75,.480,28,53,.528,8,22,.364,11,14,.786,91,31,77,.403,24,57,.421,7,20,.350,11,13,.846,80
2090,NYK,2015-11-25,91,@,ORL,L 91-100,240,31,83,.373,22,56,.393,9,27,.333,20,25,.800,91,34,86,.395,29,70,.414,5,16,.313,27,32,.844,100
2091,LAC,2015-11-25,91,,UTA,L 91-102,240,38,75,.507,34,63,.540,4,12,.333,11,17,.647,91,39,77,.506,33,64,.516,6,13,.462,18,25,.720,102
2092,TOR,2015-11-22,91,@,LAC,W 91-80,240,29,78,.372,25,61,.410,4,17,.235,29,31,.935,91,29,74,.392,22,42,.524,7,32,.219,15,20,.750,80
2093,PHI,2015-11-21,91,@,MIA,L 91-96,240,31,82,.378,21,51,.412,10,31,.323,19,24,.792,91,30,69,.435,25,51,.490,5,18,.278,31,45,.689,96
2094,ORL,2015-11-21,91,,SAC,L 91-97,240,38,92,.413,29,61,.475,9,31,.290,6,8,.750,91,31,81,.383,24,61,.393,7,20,.350,28,31,.903,97
2095,LAC,2015-11-20,91,@,POR,L 91-102,240,38,86,.442,31,62,.500,7,24,.292,8,16,.500,91,38,90,.422,30,65,.462,8,25,.320,18,24,.750,102
2096,LAL,2015-11-20,91,,TOR,L 91-102,240,35,77,.455,27,52,.519,8,25,.320,13,17,.765,91,34,78,.436,19,45,.422,15,33,.455,19,24,.792,102
2097,MIA,2015-11-17,91,,MIN,L 91-103,240,36,79,.456,31,55,.564,5,24,.208,14,30,.467,91,36,97,.371,32,76,.421,4,21,.190,27,35,.771,103
2098,UTA,2015-11-12,91,@,MIA,L 91-92,240,34,89,.382,30,72,.417,4,17,.235,19,25,.760,91,36,77,.468,32,64,.500,4,13,.308,16,25,.640,92
2099,BOS,2015-11-11,91,,IND,L 91-102,240,32,77,.416,28,53,.528,4,24,.167,23,32,.719,91,38,79,.481,32,62,.516,6,17,.353,20,31,.645,102
2100,MIL,2015-11-04,91,,PHI,W 91-87,240,35,86,.407,27,63,.429,8,23,.348,13,17,.765,91,34,81,.420,28,53,.528,6,28,.214,13,15,.867,87
2101,DAL,2015-11-03,91,,TOR,L 91-102,240,33,86,.384,26,63,.413,7,23,.304,18,25,.720,91,37,82,.451,32,65,.492,5,17,.294,23,26,.885,102
2102,BRK,2015-10-31,91,@,MEM,L 91-101,240,38,79,.481,35,66,.530,3,13,.231,12,18,.667,91,34,80,.425,25,57,.439,9,23,.391,24,28,.857,101
2103,NYK,2016-04-12,90,@,IND,L 90-102,240,36,80,.450,26,53,.491,10,27,.370,8,9,.889,90,41,80,.513,35,61,.574,6,19,.316,14,20,.700,102
2104,CHO,2016-04-05,90,@,TOR,L 90-96,240,32,88,.364,21,53,.396,11,35,.314,15,21,.714,90,34,78,.436,28,55,.509,6,23,.261,22,31,.710,96
2105,PHO,2016-04-05,90,@,ATL,L 90-103,240,30,81,.370,18,50,.360,12,31,.387,18,30,.600,90,39,95,.411,28,61,.459,11,34,.324,14,19,.737,103
2106,CHI,2016-04-02,90,,DET,L 90-94,240,34,88,.386,25,63,.397,9,25,.360,13,15,.867,90,32,76,.421,22,56,.393,10,20,.500,20,34,.588,94
2107,BOS,2016-03-28,90,@,LAC,L 90-114,240,31,89,.348,24,70,.343,7,19,.368,21,27,.778,90,44,84,.524,33,59,.559,11,25,.440,15,18,.833,114
2108,DEN,2016-03-27,90,@,LAC,L 90-105,240,37,94,.394,30,65,.462,7,29,.241,9,13,.692,90,38,80,.475,28,52,.538,10,28,.357,19,26,.731,105
2109,MIL,2016-03-25,90,@,ATL,L 90-101,240,35,84,.417,32,71,.451,3,13,.231,17,26,.654,90,41,97,.423,36,65,.554,5,32,.156,14,17,.824,101
2110,LAL,2016-03-18,90,,PHO,L 90-95,240,31,86,.360,25,63,.397,6,23,.261,22,26,.846,90,32,89,.360,24,59,.407,8,30,.267,23,26,.885,95
2111,LAC,2016-03-13,90,,CLE,L 90-114,240,32,79,.405,22,47,.468,10,32,.313,16,19,.842,90,41,84,.488,23,47,.489,18,37,.486,14,20,.700,114
2112,NYK,2016-03-13,90,@,LAL,W 90-87,240,33,75,.440,28,54,.519,5,21,.238,19,27,.704,90,34,85,.400,31,69,.449,3,16,.188,16,21,.762,87
2113,DAL,2016-03-07,90,,LAC,L 90-109,240,30,81,.370,26,56,.464,4,25,.160,26,32,.813,90,39,83,.470,27,51,.529,12,32,.375,19,29,.655,109
2114,MIL,2016-03-07,90,@,CHI,L 90-100,240,36,91,.396,29,73,.397,7,18,.389,11,17,.647,90,39,78,.500,29,53,.547,10,25,.400,12,15,.800,100
2115,CHI,2016-02-10,90,,ATL,L 90-113,240,38,86,.442,33,72,.458,5,14,.357,9,12,.750,90,43,90,.478,30,57,.526,13,33,.394,14,15,.933,113
2116,BRK,2016-02-10,90,,MEM,L 90-109,240,33,71,.465,22,49,.449,11,22,.500,13,19,.684,90,45,86,.523,36,66,.545,9,20,.450,10,12,.833,109
2117,DAL,2016-02-05,90,,SAS,L 90-116,240,33,73,.452,30,58,.517,3,15,.200,21,27,.778,90,41,80,.513,29,58,.500,12,22,.545,22,25,.880,116
2118,DAL,2016-02-03,90,,MIA,L 90-93,240,34,87,.391,26,67,.388,8,20,.400,14,19,.737,90,37,88,.420,35,73,.479,2,15,.133,17,23,.739,93
2119,MIN,2016-01-29,90,@,UTA,L 90-103,240,35,75,.467,33,65,.508,2,10,.200,18,26,.692,90,40,76,.526,30,51,.588,10,25,.400,13,16,.813,103
2120,LAL,2016-01-26,90,,DAL,L 90-92,240,30,74,.405,23,49,.469,7,25,.280,23,28,.821,90,33,76,.434,27,51,.529,6,25,.240,20,26,.769,92
2121,SAS,2016-01-25,90,@,GSW,L 90-120,240,31,74,.419,26,60,.433,5,14,.357,23,31,.742,90,44,85,.518,33,59,.559,11,26,.423,21,25,.840,120
2122,MIA,2016-01-13,90,@,LAC,L 90-104,240,31,70,.443,22,46,.478,9,24,.375,19,29,.655,90,40,94,.426,29,69,.420,11,25,.440,13,16,.813,104
2123,MIA,2016-01-06,90,,NYK,L 90-98,240,37,82,.451,35,65,.538,2,17,.118,14,15,.933,90,39,70,.557,36,62,.581,3,8,.375,17,18,.944,98
2124,CHO,2016-01-02,90,,OKC,L 90-109,240,29,84,.345,23,62,.371,6,22,.273,26,34,.765,90,35,79,.443,26,56,.464,9,23,.391,30,37,.811,109
2125,MIN,2015-12-31,90,@,DET,L 90-115,240,35,86,.407,30,72,.417,5,14,.357,15,19,.789,90,41,86,.477,27,51,.529,14,35,.400,19,28,.679,115
2126,MIA,2015-12-29,90,@,MEM,L 90-99 (OT),265,35,79,.443,24,50,.480,11,29,.379,9,18,.500,90,38,87,.437,34,72,.472,4,15,.267,19,20,.950,99
2127,MIL,2015-12-26,90,,TOR,L 90-111,240,34,81,.420,28,67,.418,6,14,.429,16,18,.889,90,42,81,.519,29,52,.558,13,29,.448,14,19,.737,111
2128,PHI,2015-12-22,90,,MEM,L 90-104,240,31,66,.470,24,43,.558,7,23,.304,21,32,.656,90,40,85,.471,35,70,.500,5,15,.333,19,24,.792,104
2129,MIL,2015-12-16,90,@,LAC,L 90-103,240,38,88,.432,33,72,.458,5,16,.313,9,11,.818,90,36,75,.480,25,54,.463,11,21,.524,20,24,.833,103
2130,POR,2015-12-16,90,@,OKC,L 90-106,240,32,92,.348,21,66,.318,11,26,.423,15,18,.833,90,38,79,.481,36,65,.554,2,14,.143,28,37,.757,106
2131,TOR,2015-12-14,90,@,IND,L 90-106,240,29,79,.367,19,51,.373,10,28,.357,22,26,.846,90,41,86,.477,31,64,.484,10,22,.455,14,16,.875,106
2132,TOR,2015-12-11,90,,MIL,W 90-83,240,34,70,.486,27,50,.540,7,20,.350,15,23,.652,90,33,80,.413,29,69,.420,4,11,.364,13,16,.813,83
2133,UTA,2015-12-11,90,,OKC,L 90-94,240,33,78,.423,25,50,.500,8,28,.286,16,24,.667,90,37,79,.468,31,62,.500,6,17,.353,14,16,.875,94
2134,MIL,2015-12-07,90,,POR,W 90-88,240,30,73,.411,26,60,.433,4,13,.308,26,33,.788,90,33,85,.388,25,52,.481,8,33,.242,14,18,.778,88
2135,DEN,2015-12-02,90,@,CHI,L 90-99,240,36,93,.387,31,78,.397,5,15,.333,13,22,.591,90,36,89,.404,30,72,.417,6,17,.353,21,27,.778,99
2136,CLE,2015-11-28,90,,BRK,W 90-88,240,35,87,.402,26,60,.433,9,27,.333,11,17,.647,90,33,81,.407,29,64,.453,4,17,.235,18,24,.750,88
2137,CHO,2015-11-27,90,,CLE,L 90-95,240,33,80,.413,28,55,.509,5,25,.200,19,25,.760,90,34,81,.420,26,56,.464,8,25,.320,19,25,.760,95
2138,NOP,2015-11-27,90,@,LAC,L 90-111,240,34,94,.362,29,74,.392,5,20,.250,17,23,.739,90,40,83,.482,33,64,.516,7,19,.368,24,30,.800,111
2139,MIL,2015-11-27,90,@,ORL,L 90-114,240,31,74,.419,23,48,.479,8,26,.308,20,22,.909,90,43,82,.524,31,55,.564,12,27,.444,16,22,.727,114
2140,OKC,2015-11-20,90,,NYK,L 90-93,240,35,92,.380,32,63,.508,3,29,.103,17,23,.739,90,33,72,.458,21,52,.404,12,20,.600,15,23,.652,93
2141,SAS,2015-11-20,90,@,NOP,L 90-104,240,34,84,.405,25,67,.373,9,17,.529,13,16,.813,90,40,88,.455,32,66,.485,8,22,.364,16,17,.941,104
2142,BRK,2015-11-17,90,,ATL,W 90-88,240,37,84,.440,28,64,.438,9,20,.450,7,13,.538,90,33,76,.434,21,47,.447,12,29,.414,10,14,.714,88
2143,CLE,2015-11-13,90,@,NYK,W 90-84,240,33,78,.423,27,50,.540,6,28,.214,18,31,.581,90,29,79,.367,20,52,.385,9,27,.333,17,21,.810,84
2144,DAL,2015-11-13,90,,LAL,W 90-82,240,30,82,.366,23,55,.418,7,27,.259,23,29,.793,90,29,88,.330,20,61,.328,9,27,.333,15,18,.833,82
2145,IND,2015-11-06,90,,MIA,W 90-87,240,36,80,.450,31,65,.477,5,15,.333,13,24,.542,90,36,81,.444,30,61,.492,6,20,.300,9,13,.692,87
2146,POR,2015-10-31,90,,PHO,L 90-101,240,33,79,.418,25,49,.510,8,30,.267,16,28,.571,90,39,94,.415,28,62,.452,11,32,.344,12,16,.750,101
2147,NYK,2016-04-10,89,,TOR,L 89-93,240,32,89,.360,25,69,.362,7,20,.350,18,21,.857,89,37,78,.474,30,58,.517,7,20,.350,12,19,.632,93
2148,DET,2016-04-05,89,@,MIA,L 89-107,240,32,80,.400,27,58,.466,5,22,.227,20,25,.800,89,44,84,.524,35,70,.500,9,14,.643,10,14,.714,107
2149,DET,2016-04-01,89,,DAL,L 89-98,240,31,81,.383,18,48,.375,13,33,.394,14,24,.583,89,39,85,.459,31,61,.508,8,24,.333,12,14,.857,98
2150,NYK,2016-03-30,89,@,DAL,L 89-91,240,35,77,.455,32,60,.533,3,17,.176,16,18,.889,89,35,85,.412,27,60,.450,8,25,.320,13,17,.765,91
2151,CHI,2016-03-26,89,@,ORL,L 89-111,240,36,88,.409,30,64,.469,6,24,.250,11,17,.647,89,48,89,.539,41,70,.586,7,19,.368,8,12,.667,111
2152,UTA,2016-03-23,89,@,HOU,W 89-87,240,31,77,.403,20,48,.417,11,29,.379,16,20,.800,89,33,74,.446,24,51,.471,9,23,.391,12,22,.545,87
2153,NYK,2016-03-19,89,@,WAS,L 89-99,240,32,81,.395,22,60,.367,10,21,.476,15,17,.882,89,39,87,.448,31,58,.534,8,29,.276,13,17,.765,99
2154,MIL,2016-03-15,89,,TOR,L 89-107,240,34,77,.442,32,64,.500,2,13,.154,19,26,.731,89,39,83,.470,25,53,.472,14,30,.467,15,17,.882,107
2155,BRK,2016-03-11,89,@,PHI,L 89-95,240,33,87,.379,28,70,.400,5,17,.294,18,22,.818,89,38,84,.452,29,56,.518,9,28,.321,10,15,.667,95
2156,DET,2016-03-05,89,@,NYK,L 89-102,240,36,92,.391,30,66,.455,6,26,.231,11,15,.733,89,42,79,.532,38,63,.603,4,16,.250,14,18,.778,102
2157,CHI,2016-03-02,89,@,ORL,L 89-102,240,38,99,.384,32,80,.400,6,19,.316,7,11,.636,89,39,97,.402,32,76,.421,7,21,.333,17,22,.773,102
2158,MIA,2016-02-27,89,@,BOS,L 89-101,240,36,87,.414,35,74,.473,1,13,.077,16,23,.696,89,39,96,.406,34,80,.425,5,16,.313,18,22,.818,101
2159,NOP,2016-02-23,89,@,WAS,L 89-109,240,29,83,.349,23,60,.383,6,23,.261,25,33,.758,89,43,94,.457,31,68,.456,12,26,.462,11,17,.647,109
2160,UTA,2016-02-18,89,@,WAS,L 89-103,240,31,77,.403,27,62,.435,4,15,.267,23,29,.793,89,42,86,.488,35,68,.515,7,18,.389,12,21,.571,103
2161,DET,2016-02-08,89,,TOR,L 89-103,240,36,80,.450,28,52,.538,8,28,.286,9,17,.529,89,39,70,.557,28,50,.560,11,20,.550,14,17,.824,103
2162,IND,2016-02-08,89,,LAL,W 89-87,240,31,78,.397,27,51,.529,4,27,.148,23,33,.697,89,29,93,.312,21,58,.362,8,35,.229,21,26,.808,87
2163,PHO,2016-02-06,89,,UTA,L 89-98,240,30,80,.375,21,56,.375,9,24,.375,20,26,.769,89,34,78,.436,29,62,.468,5,16,.313,25,31,.806,98
2164,NYK,2016-02-02,89,,BOS,L 89-97,240,31,82,.378,25,62,.403,6,20,.300,21,28,.750,89,40,90,.444,37,71,.521,3,19,.158,14,17,.824,97
2165,WAS,2016-01-26,89,@,TOR,L 89-106,240,32,78,.410,28,63,.444,4,15,.267,21,28,.750,89,35,79,.443,24,50,.480,11,29,.379,25,32,.781,106
2166,IND,2016-01-26,89,,LAC,L 89-91,240,35,83,.422,30,67,.448,5,16,.313,14,24,.583,89,32,78,.410,17,41,.415,15,37,.405,12,24,.500,91
2167,MIA,2016-01-25,89,@,CHI,W 89-84,240,37,81,.457,34,67,.507,3,14,.214,12,17,.706,89,35,88,.398,30,70,.429,5,18,.278,9,12,.750,84
2168,PHO,2016-01-21,89,,SAS,L 89-117,240,32,81,.395,26,63,.413,6,18,.333,19,23,.826,89,42,86,.488,33,72,.458,9,14,.643,24,28,.857,117
2169,POR,2016-01-16,89,@,PHI,L 89-114,240,34,87,.391,29,58,.500,5,29,.172,16,24,.667,89,42,76,.553,32,53,.604,10,23,.435,20,30,.667,114
2170,DAL,2016-01-13,89,@,OKC,L 89-108,240,32,82,.390,26,51,.510,6,31,.194,19,25,.760,89,38,82,.463,23,49,.469,15,33,.455,17,29,.586,108
2171,BRK,2016-01-09,89,@,DET,L 89-103,240,38,82,.463,33,73,.452,5,9,.556,8,10,.800,89,43,92,.467,35,65,.538,8,27,.296,9,14,.643,103
2172,ORL,2016-01-04,89,@,DET,L 89-115,240,36,81,.444,30,61,.492,6,20,.300,11,11,1.000,89,43,88,.489,29,58,.500,14,30,.467,15,21,.714,115
2173,NOP,2015-12-31,89,,LAC,L 89-95,240,36,82,.439,29,57,.509,7,25,.280,10,15,.667,89,35,90,.389,25,56,.446,10,34,.294,15,19,.789,95
2174,NOP,2015-12-28,89,@,ORL,L 89-104,240,37,83,.446,32,63,.508,5,20,.250,10,15,.667,89,45,82,.549,38,65,.585,7,17,.412,7,11,.636,104
2175,GSW,2015-12-25,89,,CLE,W 89-83,240,32,78,.410,27,60,.450,5,18,.278,20,27,.741,89,30,95,.316,25,65,.385,5,30,.167,18,25,.720,83
2176,CHO,2015-12-23,89,,BOS,L 89-102,240,29,81,.358,21,53,.396,8,28,.286,23,32,.719,89,36,85,.424,29,56,.518,7,29,.241,23,26,.885,102
2177,POR,2015-12-23,89,@,NOP,L 89-115,240,33,95,.347,26,67,.388,7,28,.250,16,24,.667,89,41,85,.482,28,54,.519,13,31,.419,20,23,.870,115
2178,PHO,2015-12-21,89,@,UTA,L 89-110,240,31,79,.392,24,55,.436,7,24,.292,20,22,.909,89,36,79,.456,27,54,.500,9,25,.360,29,37,.784,110
2179,CLE,2015-12-15,89,@,BOS,W 89-77,240,36,78,.462,28,55,.509,8,23,.348,9,10,.900,89,28,87,.322,19,55,.345,9,32,.281,12,14,.857,77
2180,SAS,2015-11-30,89,@,CHI,L 89-92,240,37,90,.411,35,76,.461,2,14,.143,13,18,.722,89,37,86,.430,31,70,.443,6,16,.375,12,20,.600,92
2181,UTA,2015-11-23,89,,OKC,L 89-111,240,28,73,.384,23,54,.426,5,19,.263,28,40,.700,89,42,77,.545,31,50,.620,11,27,.407,16,18,.889,111
2182,TOR,2015-11-18,89,@,UTA,L 89-93,240,34,80,.425,29,60,.483,5,20,.250,16,18,.889,89,35,72,.486,28,50,.560,7,22,.318,16,22,.727,93
2183,UTA,2015-11-07,89,,MEM,W 89-79,240,31,74,.419,19,47,.404,12,27,.444,15,18,.833,89,30,91,.330,24,72,.333,6,19,.316,13,14,.929,79
2184,SAC,2015-11-03,89,,MEM,L 89-103,240,29,74,.392,22,54,.407,7,20,.350,24,40,.600,89,40,83,.482,37,63,.587,3,20,.150,20,25,.800,103
2185,HOU,2015-11-01,89,@,MIA,L 89-109,240,32,79,.405,22,43,.512,10,36,.278,15,18,.833,89,42,86,.488,33,64,.516,9,22,.409,16,21,.762,109
2186,MIA,2016-04-13,88,@,BOS,L 88-98,240,38,88,.432,36,69,.522,2,19,.105,10,12,.833,88,37,86,.430,32,72,.444,5,14,.357,19,22,.864,98
2187,DAL,2016-04-06,88,,HOU,W 88-86,240,33,80,.413,23,47,.489,10,33,.303,12,14,.857,88,34,78,.436,28,58,.483,6,20,.300,12,18,.667,86
2188,SAS,2016-04-05,88,@,UTA,W 88-86,240,32,72,.444,25,55,.455,7,17,.412,17,19,.895,88,32,68,.471,27,51,.529,5,17,.294,17,21,.810,86
2189,DAL,2016-04-03,88,@,MIN,W 88-78,240,32,83,.386,18,43,.419,14,40,.350,10,17,.588,88,29,71,.408,25,50,.500,4,21,.190,16,18,.889,78
2190,DET,2016-03-29,88,,OKC,W 88-82,240,33,87,.379,29,68,.426,4,19,.211,18,20,.900,88,31,82,.378,25,61,.410,6,21,.286,14,22,.636,82
2191,DEN,2016-03-28,88,,DAL,L 88-97,240,31,70,.443,22,46,.478,9,24,.375,17,19,.895,88,36,88,.409,25,56,.446,11,32,.344,14,15,.933,97
2192,LAL,2016-03-27,88,,WAS,L 88-101,240,33,87,.379,26,59,.441,7,28,.250,15,17,.882,88,39,72,.542,32,54,.593,7,18,.389,16,29,.552,101
2193,MIA,2016-03-23,88,@,SAS,L 88-112,240,37,77,.481,30,63,.476,7,14,.500,7,12,.583,88,42,81,.519,34,67,.507,8,14,.571,20,24,.833,112
2194,SAS,2016-03-21,88,@,CHO,L 88-91,240,37,86,.430,33,69,.478,4,17,.235,10,13,.769,88,35,87,.402,27,68,.397,8,19,.421,13,19,.684,91
2195,SAC,2016-03-20,88,@,NYK,W 88-80,240,35,88,.398,28,63,.444,7,25,.280,11,14,.786,88,32,91,.352,28,72,.389,4,19,.211,12,15,.800,80
2196,UTA,2016-03-04,88,@,MEM,L 88-94,240,32,75,.427,27,56,.482,5,19,.263,19,29,.655,88,37,81,.457,33,63,.524,4,18,.222,16,19,.842,94
2197,CHI,2016-02-26,88,@,ATL,L 88-103,240,32,88,.364,27,68,.397,5,20,.250,19,22,.864,88,37,89,.416,30,55,.545,7,34,.206,22,24,.917,103
2198,CLE,2016-02-22,88,,DET,L 88-96,240,34,79,.430,26,53,.491,8,26,.308,12,13,.923,88,37,80,.463,29,55,.527,8,25,.320,14,21,.667,96
2199,NYK,2016-01-22,88,,LAC,L 88-116,240,33,85,.388,29,67,.433,4,18,.222,18,20,.900,88,43,76,.566,30,53,.566,13,23,.565,17,24,.708,116
2200,ATL,2016-01-21,88,@,SAC,L 88-91,240,35,84,.417,27,51,.529,8,33,.242,10,15,.667,88,33,92,.359,26,68,.382,7,24,.292,18,24,.750,91
2201,MIL,2016-01-10,88,@,NYK,L 88-100,240,32,80,.400,29,67,.433,3,13,.231,21,30,.700,88,39,84,.464,32,60,.533,7,24,.292,15,18,.833,100
2202,WAS,2016-01-08,88,,TOR,L 88-97,240,33,84,.393,25,59,.424,8,25,.320,14,15,.933,88,34,75,.453,29,61,.475,5,14,.357,24,26,.923,97
2203,LAL,2016-01-05,88,,GSW,L 88-109,240,29,91,.319,24,70,.343,5,21,.238,25,30,.833,88,40,86,.465,27,55,.491,13,31,.419,16,21,.762,109
2204,MIN,2015-12-26,88,,IND,L 88-102,240,35,75,.467,31,63,.492,4,12,.333,14,18,.778,88,40,80,.500,31,54,.574,9,26,.346,13,14,.929,102
2205,HOU,2015-12-25,88,,SAS,W 88-84,240,32,74,.432,25,59,.424,7,15,.467,17,26,.654,88,36,88,.409,31,68,.456,5,20,.250,7,8,.875,84
2206,NOP,2015-12-25,88,@,MIA,L 88-94 (OT),265,36,90,.400,30,70,.429,6,20,.300,10,11,.909,88,35,88,.398,29,62,.468,6,26,.231,18,27,.667,94
2207,NOP,2015-12-18,88,@,PHO,L 88-104,240,26,71,.366,22,49,.449,4,22,.182,32,38,.842,88,44,84,.524,38,68,.559,6,16,.375,10,17,.588,104
2208,DEN,2015-12-18,88,@,UTA,L 88-97,240,31,79,.392,25,51,.490,6,28,.214,20,25,.800,88,34,73,.466,24,48,.500,10,25,.400,19,25,.760,97
2209,MEM,2015-12-18,88,@,DAL,L 88-97,240,30,80,.375,24,63,.381,6,17,.353,22,24,.917,88,34,78,.436,24,49,.490,10,29,.345,19,21,.905,97
2210,ATL,2015-12-14,88,,MIA,L 88-100,240,33,84,.393,25,51,.490,8,33,.242,14,15,.933,88,40,89,.449,33,73,.452,7,16,.438,13,15,.867,100
2211,MEM,2015-12-08,88,,OKC,L 88-125,240,33,81,.407,30,67,.448,3,14,.214,19,22,.864,88,47,84,.560,34,58,.586,13,26,.500,18,23,.783,125
2212,POR,2015-12-07,88,@,MIL,L 88-90,240,33,85,.388,25,52,.481,8,33,.242,14,18,.778,88,30,73,.411,26,60,.433,4,13,.308,26,33,.788,90
2213,BRK,2015-11-28,88,@,CLE,L 88-90,240,33,81,.407,29,64,.453,4,17,.235,18,24,.750,88,35,87,.402,26,60,.433,9,27,.333,11,17,.647,90
2214,ATL,2015-11-28,88,@,SAS,L 88-108,240,37,87,.425,31,61,.508,6,26,.231,8,13,.615,88,40,85,.471,31,68,.456,9,17,.529,19,20,.950,108
2215,SAS,2015-11-25,88,,DAL,W 88-83,240,33,81,.407,25,53,.472,8,28,.286,14,19,.737,88,34,83,.410,28,61,.459,6,22,.273,9,12,.750,83
2216,POR,2015-11-24,88,,CHI,L 88-93,240,31,88,.352,25,66,.379,6,22,.273,20,27,.741,88,33,86,.384,26,68,.382,7,18,.389,20,23,.870,93
2217,DET,2015-11-23,88,@,MIL,L 88-109,240,31,91,.341,25,63,.397,6,28,.214,20,24,.833,88,43,83,.518,34,70,.486,9,13,.692,14,17,.824,109
2218,PHI,2015-11-20,88,@,CHO,L 88-113,240,32,79,.405,24,53,.453,8,26,.308,16,22,.727,88,40,81,.494,28,56,.500,12,25,.480,21,22,.955,113
2219,ATL,2015-11-17,88,@,BRK,L 88-90,240,33,76,.434,21,47,.447,12,29,.414,10,14,.714,88,37,84,.440,28,64,.438,9,20,.450,7,13,.538,90
2220,LAL,2015-11-10,88,@,MIA,L 88-101,240,34,77,.442,23,55,.418,11,22,.500,9,12,.750,88,38,84,.452,33,64,.516,5,20,.250,20,27,.741,101
2221,SAC,2015-11-09,88,,SAS,L 88-106,240,34,84,.405,27,65,.415,7,19,.368,13,19,.684,88,46,87,.529,40,64,.625,6,23,.261,8,11,.727,106
2222,PHI,2015-11-09,88,,CHI,L 88-111,240,35,100,.350,30,75,.400,5,25,.200,13,23,.565,88,41,96,.427,31,71,.437,10,25,.400,19,23,.826,111
2223,DAL,2015-10-29,88,@,LAC,L 88-104,240,35,97,.361,29,67,.433,6,30,.200,12,15,.800,88,38,87,.437,30,56,.536,8,31,.258,20,33,.606,104
2224,WAS,2015-10-28,88,@,ORL,W 88-87,240,33,84,.393,26,56,.464,7,28,.250,15,25,.600,88,37,100,.370,32,74,.432,5,26,.192,8,12,.667,87
2225,TOR,2016-04-07,87,@,ATL,L 87-95,240,32,84,.381,24,63,.381,8,21,.381,15,20,.750,87,33,76,.434,21,44,.477,12,32,.375,17,21,.810,95
2226,NYK,2016-04-03,87,,IND,L 87-92,240,33,96,.344,26,71,.366,7,25,.280,14,20,.700,87,34,81,.420,27,59,.458,7,22,.318,17,20,.850,92
2227,BRK,2016-04-03,87,,NOP,L 87-106,240,33,85,.388,25,62,.403,8,23,.348,13,21,.619,87,42,76,.553,34,54,.630,8,22,.364,14,23,.609,106
2228,BRK,2016-03-31,87,@,CLE,L 87-107,240,35,94,.372,31,73,.425,4,21,.190,13,21,.619,87,38,87,.437,26,49,.531,12,38,.316,19,24,.792,107
2229,MEM,2016-03-28,87,,SAS,L 87-101,240,33,83,.398,27,64,.422,6,19,.316,15,24,.625,87,37,72,.514,32,57,.561,5,15,.333,22,30,.733,101
2230,HOU,2016-03-23,87,,UTA,L 87-89,240,33,74,.446,24,51,.471,9,23,.391,12,22,.545,87,31,77,.403,20,48,.417,11,29,.379,16,20,.800,89
2231,SAS,2016-03-19,87,,GSW,W 87-79,240,32,78,.410,24,57,.421,8,21,.381,15,18,.833,87,31,82,.378,22,46,.478,9,36,.250,8,10,.800,79
2232,LAC,2016-03-15,87,@,SAS,L 87-108,240,32,69,.464,24,50,.480,8,19,.421,15,22,.682,87,44,82,.537,36,62,.581,8,20,.400,12,16,.750,108
2233,LAL,2016-03-13,87,,NYK,L 87-90,240,34,85,.400,31,69,.449,3,16,.188,16,21,.762,87,33,75,.440,28,54,.519,5,21,.238,19,27,.704,90
2234,ATL,2016-02-28,87,,CHO,W 87-76,240,38,77,.494,30,60,.500,8,17,.471,3,5,.600,87,27,81,.333,20,49,.408,7,32,.219,15,23,.652,76
2235,DEN,2016-02-24,87,@,LAC,W 87-81,240,34,90,.378,28,66,.424,6,24,.250,13,17,.765,87,30,85,.353,17,39,.436,13,46,.283,8,14,.571,81
2236,LAL,2016-02-08,87,@,IND,L 87-89,240,29,93,.312,21,58,.362,8,35,.229,21,26,.808,87,31,78,.397,27,51,.529,4,27,.148,23,33,.697,89
2237,ATL,2016-01-31,87,@,MIA,L 87-105,240,27,70,.386,22,48,.458,5,22,.227,28,32,.875,87,39,81,.481,34,61,.557,5,20,.250,22,26,.846,105
2238,ORL,2016-01-20,87,,PHI,L 87-96,240,33,84,.393,29,67,.433,4,17,.235,17,26,.654,87,36,74,.486,27,55,.491,9,19,.474,15,21,.714,96
2239,MIA,2016-01-20,87,@,WAS,L 87-106,240,33,68,.485,26,53,.491,7,15,.467,14,18,.778,87,45,86,.523,40,70,.571,5,16,.313,11,13,.846,106
2240,PHO,2016-01-17,87,@,MIN,L 87-117,240,35,81,.432,32,66,.485,3,15,.200,14,25,.560,87,39,69,.565,32,51,.627,7,18,.389,32,40,.800,117
2241,MIN,2016-01-10,87,,DAL,L 87-93,240,33,79,.418,29,63,.460,4,16,.250,17,22,.773,87,36,77,.468,30,57,.526,6,20,.300,15,21,.714,93
2242,MEM,2016-01-02,87,@,UTA,L 87-92 (OT),265,33,81,.407,26,63,.413,7,18,.389,14,26,.538,87,31,75,.413,22,48,.458,9,27,.333,21,28,.750,92
2243,DEN,2015-12-29,87,,CLE,L 87-93,240,37,89,.416,32,65,.492,5,24,.208,8,11,.727,87,38,86,.442,34,64,.531,4,22,.182,13,22,.591,93
2244,ATL,2015-12-28,87,@,IND,L 87-93,240,31,74,.419,25,49,.510,6,25,.240,19,25,.760,87,38,87,.437,31,61,.508,7,26,.269,10,18,.556,93
2245,LAL,2015-12-17,87,,HOU,L 87-107,240,36,84,.429,31,60,.517,5,24,.208,10,18,.556,87,34,88,.386,22,57,.386,12,31,.387,27,42,.643,107
2246,LAL,2015-12-11,87,@,SAS,L 87-109,240,36,88,.409,27,63,.429,9,25,.360,6,10,.600,87,44,82,.537,38,68,.559,6,14,.429,15,25,.600,109
2247,LAL,2015-12-04,87,@,ATL,L 87-100,240,32,86,.372,19,59,.322,13,27,.481,10,13,.769,87,37,74,.500,27,48,.563,10,26,.385,16,20,.800,100
2248,PHI,2015-12-02,87,@,NYK,L 87-99,240,32,86,.372,23,56,.411,9,30,.300,14,24,.583,87,38,88,.432,34,69,.493,4,19,.211,19,22,.864,99
2249,POR,2015-11-30,87,@,LAC,L 87-102,240,33,87,.379,28,64,.438,5,23,.217,16,27,.593,87,33,85,.388,25,66,.379,8,19,.421,28,56,.500,102
2250,CHO,2015-11-29,87,,MIL,W 87-82,240,27,70,.386,12,39,.308,15,31,.484,18,22,.818,87,33,82,.402,25,54,.463,8,28,.286,8,14,.571,82
2251,BRK,2015-11-29,87,,DET,W 87-83,240,35,81,.432,31,69,.449,4,12,.333,13,16,.813,87,34,101,.337,28,77,.364,6,24,.250,9,21,.429,83
2252,NOP,2015-11-28,87,@,UTA,L 87-101,240,29,69,.420,24,52,.462,5,17,.294,24,30,.800,87,38,82,.463,29,64,.453,9,18,.500,16,21,.762,101
2253,DET,2015-11-27,87,@,OKC,L 87-103,240,31,90,.344,22,61,.361,9,29,.310,16,20,.800,87,37,79,.468,30,55,.545,7,24,.292,22,26,.846,103
2254,WAS,2015-11-25,87,@,CHO,L 87-101,240,31,87,.356,21,55,.382,10,32,.313,15,18,.833,87,39,83,.470,31,57,.544,8,26,.308,15,15,1.000,101
2255,NOP,2015-11-15,87,@,NYK,L 87-95,240,32,71,.451,26,50,.520,6,21,.286,17,19,.895,87,38,88,.432,34,70,.486,4,18,.222,15,19,.789,95
2256,TOR,2015-11-06,87,@,ORL,L 87-92,240,30,86,.349,25,63,.397,5,23,.217,22,29,.759,87,33,77,.429,24,52,.462,9,25,.360,17,22,.773,92
2257,MIA,2015-11-06,87,@,IND,L 87-90,240,36,81,.444,30,61,.492,6,20,.300,9,13,.692,87,36,80,.450,31,65,.477,5,15,.333,13,24,.542,90
2258,BRK,2015-11-04,87,@,ATL,L 87-101,240,36,83,.434,31,62,.500,5,21,.238,10,13,.769,87,37,76,.487,29,54,.537,8,22,.364,19,24,.792,101
2259,PHI,2015-11-04,87,@,MIL,L 87-91,240,34,81,.420,28,53,.528,6,28,.214,13,15,.867,87,35,86,.407,27,63,.429,8,23,.348,13,17,.765,91
2260,MIL,2015-11-01,87,@,TOR,L 87-106,240,29,69,.420,24,50,.480,5,19,.263,24,24,1.000,87,41,90,.456,30,65,.462,11,25,.440,13,20,.650,106
2261,ORL,2015-11-01,87,@,CHI,L 87-92,240,35,90,.389,28,67,.418,7,23,.304,10,17,.588,87,33,87,.379,26,59,.441,7,28,.250,19,22,.864,92
2262,BOS,2015-11-01,87,,SAS,L 87-95,240,35,98,.357,29,69,.420,6,29,.207,11,14,.786,87,36,83,.434,31,64,.484,5,19,.263,18,25,.720,95
2263,ORL,2015-10-28,87,,WAS,L 87-88,240,37,100,.370,32,74,.432,5,26,.192,8,12,.667,87,33,84,.393,26,56,.464,7,28,.250,15,25,.600,88
2264,UTA,2015-10-28,87,@,DET,L 87-92,240,35,75,.467,33,63,.524,2,12,.167,15,21,.714,87,30,74,.405,23,55,.418,7,19,.368,25,34,.735,92
2265,SAS,2016-04-10,86,,GSW,L 86-92,240,34,90,.378,31,73,.425,3,17,.176,15,19,.789,86,34,77,.442,24,50,.480,10,27,.370,14,18,.778,92
2266,HOU,2016-04-06,86,@,DAL,L 86-88,240,34,78,.436,28,58,.483,6,20,.300,12,18,.667,86,33,80,.413,23,47,.489,10,33,.303,12,14,.857,88
2267,UTA,2016-04-05,86,,SAS,L 86-88,240,32,68,.471,27,51,.529,5,17,.294,17,21,.810,86,32,72,.444,25,55,.455,7,17,.412,17,19,.895,88
2268,PHO,2016-04-03,86,,UTA,L 86-101,240,33,78,.423,25,51,.490,8,27,.296,12,19,.632,86,39,81,.481,29,54,.537,10,27,.370,13,17,.765,101
2269,MEM,2016-03-17,86,@,MIL,L 86-96,240,34,92,.370,31,79,.392,3,13,.231,15,17,.882,86,37,75,.493,32,56,.571,5,19,.263,17,25,.680,96
2270,NOP,2016-03-03,86,,SAS,L 86-94,240,35,89,.393,27,65,.415,8,24,.333,8,8,1.000,86,36,81,.444,28,60,.467,8,21,.381,14,15,.933,94
2271,DET,2016-02-19,86,@,WAS,L 86-98,240,35,82,.427,28,59,.475,7,23,.304,9,17,.529,86,36,78,.462,29,56,.518,7,22,.318,19,26,.731,98
2272,SAS,2016-02-18,86,@,LAC,L 86-105,240,35,83,.422,31,66,.470,4,17,.235,12,15,.800,86,39,78,.500,27,53,.509,12,25,.480,15,20,.750,105
2273,PHI,2016-02-03,86,,ATL,L 86-124,240,35,84,.417,29,57,.509,6,27,.222,10,14,.714,86,48,92,.522,38,72,.528,10,20,.500,18,25,.720,124
2274,BRK,2016-01-22,86,,UTA,L 86-108,240,33,75,.440,27,59,.458,6,16,.375,14,18,.778,86,43,75,.573,34,59,.576,9,16,.563,13,15,.867,108
2275,BRK,2016-01-16,86,@,ATL,L 86-114,240,34,78,.436,28,58,.483,6,20,.300,12,19,.632,86,44,79,.557,36,50,.720,8,29,.276,18,24,.750,114
2276,UTA,2016-01-10,86,@,LAL,W 86-74,240,31,69,.449,26,53,.491,5,16,.313,19,25,.760,86,29,89,.326,26,68,.382,3,21,.143,13,15,.867,74
2277,NOP,2016-01-08,86,,IND,L 86-91,240,31,83,.373,22,54,.407,9,29,.310,15,20,.750,86,36,81,.444,31,60,.517,5,21,.238,14,19,.737,91
2278,ORL,2016-01-06,86,,IND,L 86-95,240,32,79,.405,26,48,.542,6,31,.194,16,17,.941,86,32,76,.421,26,54,.481,6,22,.273,25,29,.862,95
2279,DEN,2015-12-26,86,@,SAS,L 86-101,240,38,86,.442,33,68,.485,5,18,.278,5,6,.833,86,39,81,.481,32,71,.451,7,10,.700,16,17,.941,101
2280,PHI,2015-12-20,86,@,CLE,L 86-108,240,30,86,.349,25,62,.403,5,24,.208,21,30,.700,86,40,85,.471,29,60,.483,11,25,.440,17,21,.810,108
2281,ATL,2015-12-02,86,,TOR,L 86-96,240,33,90,.367,25,63,.397,8,27,.296,12,16,.750,86,36,79,.456,30,54,.556,6,25,.240,18,24,.750,96
2282,MIL,2015-11-21,86,@,IND,L 86-123,240,34,79,.430,29,62,.468,5,17,.294,13,19,.684,86,47,91,.516,32,61,.525,15,30,.500,14,23,.609,123
2283,MIN,2015-11-20,86,,DET,L 86-96,240,33,77,.429,30,64,.469,3,13,.231,17,25,.680,86,40,87,.460,34,59,.576,6,28,.214,10,13,.769,96
2284,MIL,2015-11-17,86,@,WAS,L 86-115,240,31,72,.431,21,51,.412,10,21,.476,14,24,.583,86,37,70,.529,25,48,.521,12,22,.545,29,41,.707,115
2285,PHI,2015-11-16,86,,DAL,L 86-92,240,34,76,.447,29,54,.537,5,22,.227,13,20,.650,86,30,76,.395,23,52,.442,7,24,.292,25,30,.833,92
2286,BRK,2015-11-07,86,@,MIL,L 86-94,240,34,82,.415,31,73,.425,3,9,.333,15,19,.789,86,37,82,.451,29,62,.468,8,20,.400,12,16,.750,94
2287,NYK,2015-11-04,86,@,CLE,L 86-96,240,33,84,.393,25,60,.417,8,24,.333,12,15,.800,86,33,83,.398,26,56,.464,7,27,.259,23,32,.719,96
2288,MIN,2016-04-01,85,@,UTA,L 85-98,240,35,79,.443,26,56,.464,9,23,.391,6,10,.600,85,38,72,.528,30,50,.600,8,22,.364,14,23,.609,98
2289,PHI,2016-03-29,85,,CHO,L 85-100,240,30,96,.313,14,52,.269,16,44,.364,9,10,.900,85,38,87,.437,31,62,.500,7,25,.280,17,18,.944,100
2290,MIL,2016-03-20,85,,UTA,L 85-94,240,34,65,.523,31,57,.544,3,8,.375,14,17,.824,85,34,83,.410,21,45,.467,13,38,.342,13,14,.929,94
2291,UTA,2016-03-19,85,@,CHI,L 85-92,240,35,86,.407,27,59,.458,8,27,.296,7,12,.583,85,39,80,.488,33,61,.541,6,19,.316,8,11,.727,92
2292,NYK,2016-03-16,85,@,GSW,L 85-121,240,36,91,.396,29,72,.403,7,19,.368,6,10,.600,85,46,91,.505,28,54,.519,18,37,.486,11,12,.917,121
2293,CLE,2016-03-14,85,@,UTA,L 85-94,240,35,88,.398,25,45,.556,10,43,.233,5,8,.625,85,35,71,.493,23,44,.523,12,27,.444,12,14,.857,94
2294,OKC,2016-03-12,85,@,SAS,L 85-93,240,31,81,.383,29,63,.460,2,18,.111,21,25,.840,85,34,85,.400,30,61,.492,4,24,.167,21,25,.840,93
2295,NYK,2016-03-01,85,,POR,L 85-104,240,33,88,.375,27,67,.403,6,21,.286,13,18,.722,85,37,88,.420,25,58,.431,12,30,.400,18,20,.900,104
2296,MEM,2016-02-21,85,@,TOR,L 85-98,240,28,76,.368,25,56,.446,3,20,.150,26,32,.813,85,33,81,.407,26,53,.491,7,28,.250,25,31,.806,98
2297,NYK,2016-02-05,85,,MEM,L 85-91,240,30,80,.375,20,51,.392,10,29,.345,15,17,.882,85,33,76,.434,29,58,.500,4,18,.222,21,24,.875,91
2298,UTA,2016-02-03,85,,DEN,W 85-81,240,33,74,.446,28,52,.538,5,22,.227,14,20,.700,85,26,70,.371,22,52,.423,4,18,.222,25,33,.758,81
2299,LAC,2016-01-27,85,@,ATL,W 85-83,240,33,85,.388,28,58,.483,5,27,.185,14,21,.667,85,33,79,.418,23,56,.411,10,23,.435,7,14,.500,83
2300,UTA,2016-01-13,85,@,POR,L 85-99,240,31,76,.408,23,57,.404,8,19,.421,15,22,.682,85,39,88,.443,28,62,.452,11,26,.423,10,15,.667,99
2301,PHI,2016-01-10,85,,CLE,L 85-95,240,35,77,.455,29,59,.492,6,18,.333,9,19,.474,85,35,90,.389,26,58,.448,9,32,.281,16,23,.696,95
2302,MIN,2016-01-02,85,,MIL,L 85-95,240,33,84,.393,30,70,.429,3,14,.214,16,24,.667,85,32,75,.427,24,59,.407,8,16,.500,23,28,.821,95
2303,UTA,2015-12-23,85,@,GSW,L 85-103,240,33,80,.413,26,60,.433,7,20,.350,12,14,.857,85,39,83,.470,30,60,.500,9,23,.391,16,16,1.000,103
2304,LAL,2015-12-23,85,,OKC,L 85-120,240,32,89,.360,25,64,.391,7,25,.280,14,22,.636,85,51,95,.537,46,76,.605,5,19,.263,13,17,.765,120
2305,BRK,2015-12-20,85,,MIN,L 85-100,240,32,78,.410,27,57,.474,5,21,.238,16,20,.800,85,38,80,.475,35,68,.515,3,12,.250,21,24,.875,100
2306,MEM,2015-12-16,85,@,CHI,L 85-98,240,32,76,.421,27,57,.474,5,19,.263,16,28,.571,85,38,86,.442,29,62,.468,9,24,.375,13,19,.684,98
2307,NYK,2015-12-09,85,@,UTA,L 85-106,240,31,78,.397,23,57,.404,8,21,.381,15,27,.556,85,39,80,.488,30,59,.508,9,21,.429,19,23,.826,106
2308,ORL,2015-12-08,85,@,DEN,W 85-74,240,38,88,.432,37,72,.514,1,16,.063,8,10,.800,85,28,84,.333,21,60,.350,7,24,.292,11,20,.550,74
2309,CLE,2015-12-01,85,,WAS,L 85-97,240,28,83,.337,19,53,.358,9,30,.300,20,23,.870,85,39,83,.470,32,55,.582,7,28,.250,12,16,.750,97
2310,PHI,2015-11-18,85,,IND,L 85-112,240,35,76,.461,30,51,.588,5,25,.200,10,16,.625,85,42,92,.457,30,65,.462,12,27,.444,16,20,.800,112
2311,OKC,2015-11-15,85,,BOS,L 85-100,240,28,77,.364,22,52,.423,6,25,.240,23,29,.793,85,39,82,.476,30,59,.508,9,23,.391,13,20,.650,100
2312,DET,2015-11-15,85,@,LAL,L 85-97,240,35,96,.365,28,69,.406,7,27,.259,8,15,.533,85,31,75,.413,25,56,.446,6,19,.316,29,39,.744,97
2313,PHI,2015-11-13,85,@,OKC,L 85-102,240,30,86,.349,25,69,.362,5,17,.294,20,28,.714,85,39,97,.402,31,72,.431,8,25,.320,16,21,.762,102
2314,HOU,2015-10-28,85,,DEN,L 85-105,240,30,87,.345,22,52,.423,8,35,.229,17,26,.654,85,40,79,.506,27,52,.519,13,27,.481,12,18,.667,105
2315,MEM,2016-04-12,84,@,LAC,L 84-110,240,35,86,.407,30,66,.455,5,20,.250,9,14,.643,84,41,75,.547,29,50,.580,12,25,.480,16,21,.762,110
2316,DEN,2016-04-10,84,,UTA,L 84-100,240,32,80,.400,26,53,.491,6,27,.222,14,19,.737,84,36,79,.456,24,48,.500,12,31,.387,16,21,.762,100
2317,MIN,2016-03-26,84,,UTA,L 84-93,240,32,84,.381,28,73,.384,4,11,.364,16,19,.842,84,39,83,.470,30,62,.484,9,21,.429,6,7,.857,93
2318,NOP,2016-03-24,84,@,IND,L 84-92,240,35,85,.412,31,69,.449,4,16,.250,10,14,.714,84,36,79,.456,29,59,.492,7,20,.350,13,15,.867,92
2319,ORL,2016-03-12,84,@,POR,L 84-121,240,34,91,.374,27,65,.415,7,26,.269,9,18,.500,84,47,84,.560,30,49,.612,17,35,.486,10,11,.909,121
2320,UTA,2016-03-08,84,,ATL,L 84-91,240,30,86,.349,23,60,.383,7,26,.269,17,23,.739,84,38,80,.475,30,55,.545,8,25,.320,7,14,.500,91
2321,ORL,2016-03-04,84,,PHO,L 84-102,240,35,101,.347,28,74,.378,7,27,.259,7,14,.500,84,35,78,.449,30,64,.469,5,14,.357,27,39,.692,102
2322,PHO,2016-02-22,84,@,LAC,L 84-124,240,31,88,.352,24,64,.375,7,24,.292,15,20,.750,84,44,80,.550,31,56,.554,13,24,.542,23,35,.657,124
2323,NOP,2016-02-06,84,@,CLE,L 84-99,240,34,87,.391,29,64,.453,5,23,.217,11,16,.688,84,39,90,.433,25,49,.510,14,41,.341,7,7,1.000,99
2324,UTA,2016-02-05,84,,MIL,W 84-81,240,30,77,.390,22,50,.440,8,27,.296,16,23,.696,84,30,71,.423,23,57,.404,7,14,.500,14,21,.667,81
2325,PHO,2016-01-29,84,@,NYK,L 84-102,240,35,85,.412,28,59,.475,7,26,.269,7,12,.583,84,36,84,.429,29,64,.453,7,20,.350,23,26,.885,102
2326,CHI,2016-01-25,84,,MIA,L 84-89,240,35,88,.398,30,70,.429,5,18,.278,9,12,.750,84,37,81,.457,34,67,.507,3,14,.214,12,17,.706,89
2327,NYK,2016-01-23,84,@,CHO,L 84-97,240,29,77,.377,22,53,.415,7,24,.292,19,32,.594,84,28,82,.341,19,51,.373,9,31,.290,32,37,.865,97
2328,ATL,2016-01-13,84,@,CHO,L 84-107,240,30,81,.370,23,56,.411,7,25,.280,17,21,.810,84,36,82,.439,23,43,.535,13,39,.333,22,26,.846,107
2329,DEN,2016-01-08,84,@,MEM,L 84-91,240,32,87,.368,28,68,.412,4,19,.211,16,19,.842,84,30,82,.366,22,64,.344,8,18,.444,23,30,.767,91
2330,PHI,2016-01-01,84,@,LAL,L 84-93,240,31,84,.369,27,60,.450,4,24,.167,18,25,.720,84,33,87,.379,28,71,.394,5,16,.313,22,29,.759,93
2331,LAL,2015-12-25,84,,LAC,L 84-94,240,32,77,.416,25,54,.463,7,23,.304,13,25,.520,84,38,85,.447,28,59,.475,10,26,.385,8,11,.727,94
2332,SAS,2015-12-25,84,@,HOU,L 84-88,240,36,88,.409,31,68,.456,5,20,.250,7,8,.875,84,32,74,.432,25,59,.424,7,15,.467,17,26,.654,88
2333,NYK,2015-12-23,84,@,CLE,L 84-91,240,32,82,.390,27,66,.409,5,16,.313,15,16,.938,84,32,83,.386,27,61,.443,5,22,.227,22,25,.880,91
2334,IND,2015-12-19,84,@,MEM,L 84-96,240,30,77,.390,25,49,.510,5,28,.179,19,25,.760,84,37,83,.446,32,64,.500,5,19,.263,17,21,.810,96
2335,DET,2015-12-07,84,@,CHO,L 84-104,240,32,87,.368,22,53,.415,10,34,.294,10,22,.455,84,36,84,.429,28,58,.483,8,26,.308,24,35,.686,104
2336,CLE,2015-12-05,84,@,MIA,L 84-99,240,31,85,.365,25,57,.439,6,28,.214,16,24,.667,84,37,68,.544,30,52,.577,7,16,.438,18,29,.621,99
2337,PHI,2015-11-29,84,@,MEM,L 84-92,240,30,77,.390,18,41,.439,12,36,.333,12,16,.750,84,34,81,.420,30,68,.441,4,13,.308,20,27,.741,92
2338,TOR,2015-11-28,84,@,WAS,W 84-82,240,31,72,.431,20,48,.417,11,24,.458,11,14,.786,84,27,82,.329,20,59,.339,7,23,.304,21,27,.778,82
2339,BOS,2015-11-25,84,,PHI,W 84-80,240,31,91,.341,22,62,.355,9,29,.310,13,18,.722,84,31,83,.373,24,56,.429,7,27,.259,11,15,.733,80
2340,PHO,2015-11-23,84,@,SAS,L 84-98,240,34,73,.466,27,54,.500,7,19,.368,9,10,.900,84,42,82,.512,33,62,.532,9,20,.450,5,10,.500,98
2341,HOU,2015-11-20,84,@,MEM,L 84-96,240,28,74,.378,22,45,.489,6,29,.207,22,37,.595,84,36,85,.424,28,61,.459,8,24,.333,16,19,.842,96
2342,NYK,2015-11-13,84,,CLE,L 84-90,240,29,79,.367,20,52,.385,9,27,.333,17,21,.810,84,33,78,.423,27,50,.540,6,28,.214,18,31,.581,90
2343,MEM,2015-11-11,84,,GSW,L 84-100,240,24,70,.343,21,55,.382,3,15,.200,33,36,.917,84,36,75,.480,25,48,.521,11,27,.407,17,23,.739,100
2344,ORL,2015-11-09,84,@,IND,L 84-97,240,31,78,.397,21,45,.467,10,33,.303,12,17,.706,84,34,77,.442,23,52,.442,11,25,.440,18,22,.818,97
2345,DEN,2015-11-05,84,,UTA,L 84-96,240,28,72,.389,23,52,.442,5,20,.250,23,34,.676,84,37,85,.435,26,61,.426,11,24,.458,11,17,.647,96
2346,MIN,2015-11-05,84,,MIA,L 84-96,240,30,85,.353,26,73,.356,4,12,.333,20,22,.909,84,37,76,.487,33,62,.532,4,14,.286,18,25,.720,96
2347,NYK,2015-11-02,84,,SAS,L 84-94,240,32,89,.360,28,76,.368,4,13,.308,16,21,.762,84,39,79,.494,35,66,.530,4,13,.308,12,17,.706,94
2348,MEM,2016-03-12,83,@,ATL,L 83-95,240,33,95,.347,27,72,.375,6,23,.261,11,14,.786,83,36,84,.429,25,50,.500,11,34,.324,12,17,.706,95
2349,WAS,2016-03-04,83,@,CLE,L 83-108,240,32,81,.395,29,61,.475,3,20,.150,16,24,.667,83,42,90,.467,30,63,.476,12,27,.444,12,16,.750,108
2350,MIL,2016-01-28,83,@,MEM,L 83-103,240,29,79,.367,28,63,.444,1,16,.063,24,27,.889,83,38,80,.475,28,52,.538,10,28,.357,17,20,.850,103
2351,ATL,2016-01-27,83,,LAC,L 83-85,240,33,79,.418,23,56,.411,10,23,.435,7,14,.500,83,33,85,.388,28,58,.483,5,27,.185,14,21,.667,85
2352,CLE,2016-01-23,83,,CHI,L 83-96,240,35,94,.372,31,70,.443,4,24,.167,9,22,.409,83,38,87,.437,31,70,.443,7,17,.412,13,15,.867,96
2353,DAL,2016-01-17,83,@,SAS,L 83-112,240,29,81,.358,23,58,.397,6,23,.261,19,25,.760,83,42,90,.467,37,70,.529,5,20,.250,23,28,.821,112
2354,DAL,2016-01-15,83,@,CHI,W 83-77,240,30,77,.390,22,55,.400,8,22,.364,15,17,.882,83,31,86,.360,29,67,.433,2,19,.105,13,15,.867,77
2355,MIA,2016-01-09,83,@,UTA,L 83-98,240,34,82,.415,28,63,.444,6,19,.316,9,17,.529,83,39,71,.549,30,51,.588,9,20,.450,11,18,.611,98
2356,CHO,2016-01-09,83,@,LAC,L 83-97,240,31,84,.369,24,61,.393,7,23,.304,14,19,.737,83,40,91,.440,32,60,.533,8,31,.258,9,10,.900,97
2357,ORL,2016-01-08,83,@,BRK,W 83-77,240,33,83,.398,20,55,.364,13,28,.464,4,6,.667,83,29,73,.397,22,51,.431,7,22,.318,12,20,.600,77
2358,CLE,2015-12-25,83,@,GSW,L 83-89,240,30,95,.316,25,65,.385,5,30,.167,18,25,.720,83,32,78,.410,27,60,.450,5,18,.278,20,27,.741,89
2359,MIN,2015-12-23,83,,SAS,L 83-108,240,30,72,.417,27,62,.435,3,10,.300,20,25,.800,83,44,82,.537,34,58,.586,10,24,.417,10,14,.714,108
2360,MIA,2015-12-11,83,@,IND,L 83-96,240,35,81,.432,30,61,.492,5,20,.250,8,13,.615,83,36,86,.419,30,58,.517,6,28,.214,18,20,.900,96
2361,MIL,2015-12-11,83,@,TOR,L 83-90,240,33,80,.413,29,69,.420,4,11,.364,13,16,.813,83,34,70,.486,27,50,.540,7,20,.350,15,23,.652,90
2362,CHI,2015-12-10,83,,LAC,W 83-80,240,31,87,.356,24,64,.375,7,23,.304,14,16,.875,83,30,88,.341,20,66,.303,10,22,.455,10,12,.833,80
2363,MEM,2015-12-03,83,,SAS,L 83-103,240,30,80,.375,28,64,.438,2,16,.125,21,25,.840,83,40,80,.500,30,62,.484,10,18,.556,13,18,.722,103
2364,DET,2015-11-29,83,@,BRK,L 83-87,240,34,101,.337,28,77,.364,6,24,.250,9,21,.429,83,35,81,.432,31,69,.449,4,12,.333,13,16,.813,87
2365,DAL,2015-11-25,83,@,SAS,L 83-88,240,34,83,.410,28,61,.459,6,22,.273,9,12,.750,83,33,81,.407,25,53,.472,8,28,.286,14,19,.737,88
2366,PHI,2015-11-14,83,@,SAS,L 83-92,240,33,82,.402,25,60,.417,8,22,.364,9,11,.818,83,33,85,.388,28,69,.406,5,16,.313,21,25,.840,92
2367,MIL,2015-11-10,83,,BOS,L 83-99,240,30,73,.411,24,56,.429,6,17,.353,17,23,.739,83,38,86,.442,31,56,.554,7,30,.233,16,19,.842,99
2368,OKC,2016-03-29,82,@,DET,L 82-88,240,31,82,.378,25,61,.410,6,21,.286,14,22,.636,82,33,87,.379,29,68,.426,4,19,.211,18,20,.900,88
2369,LAL,2016-01-31,82,,CHO,L 82-101,240,27,80,.338,19,51,.373,8,29,.276,20,23,.870,82,36,96,.375,23,60,.383,13,36,.361,16,26,.615,101
2370,LAL,2016-01-16,82,@,UTA,L 82-109,240,31,90,.344,22,67,.328,9,23,.391,11,18,.611,82,41,83,.494,29,59,.492,12,24,.500,15,18,.833,109
2371,DET,2016-01-02,82,@,IND,L 82-94,240,33,93,.355,30,73,.411,3,20,.150,13,23,.565,82,33,73,.452,26,55,.473,7,18,.389,21,29,.724,94
2372,DAL,2016-01-01,82,@,MIA,L 82-106,240,32,88,.364,25,57,.439,7,31,.226,11,14,.786,82,46,82,.561,38,64,.594,8,18,.444,6,9,.667,106
2373,BRK,2015-12-14,82,,ORL,L 82-105,240,31,80,.388,24,61,.393,7,19,.368,13,16,.813,82,41,76,.539,32,55,.582,9,21,.429,14,20,.700,105
2374,MIL,2015-11-29,82,@,CHO,L 82-87,240,33,82,.402,25,54,.463,8,28,.286,8,14,.571,82,27,70,.386,12,39,.308,15,31,.484,18,22,.818,87
2375,WAS,2015-11-28,82,,TOR,L 82-84,240,27,82,.329,20,59,.339,7,23,.304,21,27,.778,82,31,72,.431,20,48,.417,11,24,.458,11,14,.786,84
2376,MEM,2015-11-21,82,@,SAS,L 82-92,240,32,74,.432,31,65,.477,1,9,.111,17,17,1.000,82,34,72,.472,27,51,.529,7,21,.333,17,22,.773,92
2377,LAL,2015-11-13,82,@,DAL,L 82-90,240,29,88,.330,20,61,.328,9,27,.333,15,18,.833,82,30,82,.366,23,55,.418,7,27,.259,23,29,.793,90
2378,DET,2015-11-03,82,,IND,L 82-94,240,33,86,.384,28,64,.438,5,22,.227,11,17,.647,82,38,88,.432,31,65,.477,7,23,.304,11,12,.917,94
2379,SAC,2016-04-13,81,@,HOU,L 81-116,240,32,96,.333,21,59,.356,11,37,.297,6,13,.462,81,47,97,.485,37,62,.597,10,35,.286,12,19,.632,116
2380,LAL,2016-04-06,81,,LAC,L 81-91,240,32,90,.356,28,71,.394,4,19,.211,13,17,.765,81,37,83,.446,30,58,.517,7,25,.280,10,14,.714,91
2381,LAL,2016-04-05,81,@,LAC,L 81-103,240,26,83,.313,20,63,.317,6,20,.300,23,25,.920,81,40,78,.513,33,58,.569,7,20,.350,16,26,.615,103
2382,MEM,2016-03-14,81,@,HOU,L 81-130,240,30,101,.297,26,84,.310,4,17,.235,17,28,.607,81,46,85,.541,30,52,.577,16,33,.485,22,34,.647,130
2383,DET,2016-03-14,81,@,WAS,L 81-124,240,32,79,.405,29,56,.518,3,23,.130,14,22,.636,81,51,90,.567,43,72,.597,8,18,.444,14,18,.778,124
2384,DET,2016-03-02,81,@,SAS,L 81-97,240,31,78,.397,25,59,.424,6,19,.316,13,23,.565,81,43,84,.512,40,70,.571,3,14,.214,8,9,.889,97
2385,NYK,2016-02-28,81,,MIA,L 81-98,240,32,87,.368,26,72,.361,6,15,.400,11,12,.917,81,40,84,.476,39,76,.513,1,8,.125,17,21,.810,98
2386,LAC,2016-02-24,81,,DEN,L 81-87,240,30,85,.353,17,39,.436,13,46,.283,8,14,.571,81,34,90,.378,28,66,.424,6,24,.250,13,17,.765,87
2387,MIL,2016-02-05,81,@,UTA,L 81-84,240,30,71,.423,23,57,.404,7,14,.500,14,21,.667,81,30,77,.390,22,50,.440,8,27,.296,16,23,.696,84
2388,DEN,2016-02-03,81,@,UTA,L 81-85,240,26,70,.371,22,52,.423,4,18,.222,25,33,.758,81,33,74,.446,28,52,.538,5,22,.227,14,20,.700,85
2389,MIA,2016-01-22,81,@,TOR,L 81-101,240,33,81,.407,29,64,.453,4,17,.235,11,17,.647,81,35,75,.467,22,50,.440,13,25,.520,18,21,.857,101
2390,ORL,2016-01-18,81,@,ATL,L 81-98,240,30,87,.345,24,65,.369,6,22,.273,15,20,.750,81,41,80,.513,32,61,.525,9,19,.474,7,10,.700,98
2391,NYK,2016-01-01,81,@,CHI,L 81-108,240,31,84,.369,25,65,.385,6,19,.316,13,17,.765,81,39,85,.459,29,69,.420,10,16,.625,20,25,.800,108
2392,DAL,2015-12-16,81,@,IND,L 81-107,240,33,90,.367,25,57,.439,8,33,.242,7,10,.700,81,43,89,.483,32,60,.533,11,29,.379,10,17,.588,107
2393,UTA,2015-12-14,81,@,SAS,L 81-118,240,32,79,.405,29,68,.426,3,11,.273,14,17,.824,81,42,75,.560,33,54,.611,9,21,.429,25,27,.926,118
2394,MIA,2015-12-09,81,@,CHO,L 81-99,240,29,75,.387,23,54,.426,6,21,.286,17,24,.708,81,40,81,.494,29,54,.537,11,27,.407,8,17,.471,99
2395,DEN,2015-11-28,81,@,DAL,L 81-92,240,30,75,.400,22,50,.440,8,25,.320,13,17,.765,81,33,77,.429,26,51,.510,7,26,.269,19,27,.704,92
2396,MIA,2015-11-25,81,@,DET,L 81-104,240,32,79,.405,26,59,.441,6,20,.300,11,16,.688,81,41,98,.418,25,67,.373,16,31,.516,6,7,.857,104
2397,DEN,2015-11-14,81,@,PHO,L 81-105,240,34,98,.347,28,63,.444,6,35,.171,7,8,.875,81,37,84,.440,26,60,.433,11,24,.458,20,26,.769,105
2398,NOP,2015-11-13,81,@,TOR,L 81-100,240,30,82,.366,23,59,.390,7,23,.304,14,20,.700,81,34,77,.442,25,56,.446,9,21,.429,23,27,.852,100
2399,MIL,2016-04-05,80,,CLE,L 80-109,240,35,88,.398,31,72,.431,4,16,.250,6,12,.500,80,41,75,.547,23,39,.590,18,36,.500,9,10,.900,109
2400,NYK,2016-03-20,80,,SAC,L 80-88,240,32,91,.352,28,72,.389,4,19,.211,12,15,.800,80,35,88,.398,28,63,.444,7,25,.280,11,14,.786,88
2401,UTA,2015-12-30,80,@,MIN,L 80-94,240,28,80,.350,18,41,.439,10,39,.256,14,20,.700,80,36,77,.468,31,67,.463,5,10,.500,17,27,.630,94
2402,LAC,2015-12-10,80,@,CHI,L 80-83,240,30,88,.341,20,66,.303,10,22,.455,10,12,.833,80,31,87,.356,24,64,.375,7,23,.304,14,16,.875,83
2403,DEN,2015-11-27,80,,SAS,L 80-91,240,31,77,.403,24,57,.421,7,20,.350,11,13,.846,80,36,75,.480,28,53,.528,8,22,.364,11,14,.786,91
2404,PHI,2015-11-25,80,@,BOS,L 80-84,240,31,83,.373,24,56,.429,7,27,.259,11,15,.733,80,31,91,.341,22,62,.355,9,29,.310,13,18,.722,84
2405,LAC,2015-11-22,80,,TOR,L 80-91,240,29,74,.392,22,42,.524,7,32,.219,15,20,.750,80,29,78,.372,25,61,.410,4,17,.235,29,31,.935,91
2406,POR,2015-11-16,80,@,SAS,L 80-93,240,31,75,.413,24,56,.429,7,19,.368,11,13,.846,80,38,89,.427,31,66,.470,7,23,.304,10,13,.769,93
2407,LAL,2016-04-11,79,@,OKC,L 79-112,240,23,81,.284,16,50,.320,7,31,.226,26,30,.867,79,42,96,.438,30,59,.508,12,37,.324,16,27,.593,112
2408,MIN,2016-03-30,79,,LAC,L 79-99,240,30,87,.345,22,64,.344,8,23,.348,11,17,.647,79,37,84,.440,28,53,.528,9,31,.290,16,18,.889,99
2409,TOR,2016-03-23,79,@,BOS,L 79-91,240,31,89,.348,25,67,.373,6,22,.273,11,20,.550,79,35,80,.438,27,60,.450,8,20,.400,13,21,.619,91
2410,GSW,2016-03-19,79,@,SAS,L 79-87,240,31,82,.378,22,46,.478,9,36,.250,8,10,.800,79,32,78,.410,24,57,.421,8,21,.381,15,18,.833,87
2411,HOU,2016-02-06,79,,POR,L 79-96,240,25,77,.325,18,41,.439,7,36,.194,22,30,.733,79,35,87,.402,24,52,.462,11,35,.314,15,23,.652,96
2412,BRK,2016-01-29,79,@,DAL,L 79-91,240,28,78,.359,24,58,.414,4,20,.200,19,23,.826,79,37,80,.463,29,59,.492,8,21,.381,9,15,.600,91
2413,MIA,2016-01-19,79,,MIL,L 79-91,240,27,74,.365,22,52,.423,5,22,.227,20,26,.769,79,36,74,.486,31,62,.500,5,12,.417,14,16,.875,91
2414,BRK,2016-01-11,79,,SAS,L 79-106,240,33,73,.452,31,61,.508,2,12,.167,11,13,.846,79,44,82,.537,40,69,.580,4,13,.308,14,19,.737,106
2415,ORL,2016-01-02,79,@,CLE,L 79-104,240,29,76,.382,23,51,.451,6,25,.240,15,17,.882,79,34,82,.415,22,45,.489,12,37,.324,24,39,.615,104
2416,PHO,2015-12-30,79,@,SAS,L 79-112,240,32,81,.395,27,63,.429,5,18,.278,10,18,.556,79,43,76,.566,37,62,.597,6,14,.429,20,33,.606,112
2417,MEM,2015-11-07,79,@,UTA,L 79-89,240,30,91,.330,24,72,.333,6,19,.316,13,14,.929,79,31,74,.419,19,47,.404,12,27,.444,15,18,.833,89
2418,MIN,2016-04-03,78,,DAL,L 78-88,240,29,71,.408,25,50,.500,4,21,.190,16,18,.889,78,32,83,.386,18,43,.419,14,40,.350,10,17,.588,88
2419,UTA,2016-02-25,78,,SAS,L 78-96,240,33,77,.429,30,60,.500,3,17,.176,9,12,.750,78,38,79,.481,29,61,.475,9,18,.500,11,12,.917,96
2420,PHO,2016-01-31,78,@,DAL,L 78-91,240,27,74,.365,22,51,.431,5,23,.217,19,24,.792,78,31,78,.397,23,49,.469,8,29,.276,21,23,.913,91
2421,BRK,2016-01-20,78,,CLE,L 78-91,240,35,84,.417,31,65,.477,4,19,.211,4,8,.500,78,36,77,.468,31,60,.517,5,17,.294,14,20,.700,91
2422,DEN,2016-01-06,78,@,MIN,W 78-74,240,29,81,.358,21,61,.344,8,20,.400,12,17,.706,78,28,73,.384,25,62,.403,3,11,.273,15,20,.750,74
2423,POR,2016-01-04,78,,MEM,L 78-91,240,28,72,.389,21,44,.477,7,28,.250,15,24,.625,78,35,91,.385,32,76,.421,3,15,.200,18,26,.692,91
2424,LAL,2015-12-19,78,@,OKC,L 78-118,240,30,86,.349,22,58,.379,8,28,.286,10,17,.588,78,46,84,.548,37,65,.569,9,19,.474,17,25,.680,118
2425,ATL,2015-12-12,78,,SAS,L 78-103,240,30,80,.375,25,56,.446,5,24,.208,13,16,.813,78,36,74,.486,26,54,.481,10,20,.500,21,22,.955,103
2426,NYK,2015-11-27,78,,MIA,L 78-97,240,32,85,.376,29,71,.408,3,14,.214,11,15,.733,78,33,76,.434,26,59,.441,7,17,.412,24,28,.857,97
2427,WAS,2015-11-27,78,@,BOS,L 78-111,240,27,84,.321,22,66,.333,5,18,.278,19,22,.864,78,42,97,.433,30,64,.469,12,33,.364,15,19,.789,111
2428,NYK,2015-11-23,78,@,MIA,L 78-95,240,28,87,.322,24,63,.381,4,24,.167,18,21,.857,78,31,81,.383,26,62,.419,5,19,.263,28,36,.778,95
2429,DEN,2015-10-30,78,,MIN,L 78-95,240,29,95,.305,24,70,.343,5,25,.200,15,20,.750,78,30,71,.423,28,60,.467,2,11,.182,33,41,.805,95
2430,LAL,2016-03-04,77,,ATL,L 77-106,240,29,85,.341,24,58,.414,5,27,.185,14,20,.700,77,37,68,.544,24,40,.600,13,28,.464,19,26,.731,106
2431,HOU,2016-01-15,77,,CLE,L 77-91,240,26,74,.351,20,49,.408,6,25,.240,19,29,.655,77,34,87,.391,26,52,.500,8,35,.229,15,23,.652,91
2432,CHI,2016-01-15,77,,DAL,L 77-83,240,31,86,.360,29,67,.433,2,19,.105,13,15,.867,77,30,77,.390,22,55,.400,8,22,.364,15,17,.882,83
2433,BRK,2016-01-08,77,,ORL,L 77-83,240,29,73,.397,22,51,.431,7,22,.318,12,20,.600,77,33,83,.398,20,55,.364,13,28,.464,4,6,.667,83
2434,PHO,2016-01-03,77,@,LAL,L 77-97,240,32,89,.360,26,62,.419,6,27,.222,7,9,.778,77,38,84,.452,30,62,.484,8,22,.364,13,17,.765,97
2435,BOS,2015-12-15,77,,CLE,L 77-89,240,28,87,.322,19,55,.345,9,32,.281,12,14,.857,77,36,78,.462,28,55,.509,8,23,.348,9,10,.900,89
2436,LAL,2015-11-24,77,@,GSW,L 77-111,240,31,83,.373,28,62,.452,3,21,.143,12,16,.750,77,45,92,.489,33,57,.579,12,35,.343,9,15,.600,111
2437,CHO,2016-02-28,76,@,ATL,L 76-87,240,27,81,.333,20,49,.408,7,32,.219,15,23,.652,76,38,77,.494,30,60,.500,8,17,.471,3,5,.600,87
2438,CLE,2015-12-26,76,@,POR,L 76-105,240,28,77,.364,17,46,.370,11,31,.355,9,15,.600,76,41,89,.461,32,67,.478,9,22,.409,14,19,.737,105
2439,PHI,2015-12-13,76,@,TOR,L 76-96,240,28,84,.333,18,56,.321,10,28,.357,10,14,.714,76,32,78,.410,25,56,.446,7,22,.318,25,34,.735,96
2440,ORL,2015-12-11,76,,CLE,L 76-111,240,28,72,.389,22,50,.440,6,22,.273,14,20,.700,76,41,72,.569,30,51,.588,11,21,.524,18,27,.667,111
2441,TOR,2015-11-08,76,@,MIA,L 76-96,240,28,71,.394,25,52,.481,3,19,.158,17,22,.773,76,35,83,.422,27,63,.429,8,20,.400,18,25,.720,96
2442,IND,2015-10-31,76,,UTA,L 76-97,240,28,70,.400,24,53,.453,4,17,.235,16,21,.762,76,39,88,.443,33,73,.452,6,15,.400,13,18,.722,97
2443,MEM,2015-10-28,76,,CLE,L 76-106,240,29,82,.354,27,66,.409,2,16,.125,16,22,.727,76,41,84,.488,28,55,.509,13,29,.448,11,17,.647,106
2444,LAL,2016-03-28,75,@,UTA,L 75-123,240,26,85,.306,19,65,.292,7,20,.350,16,22,.727,75,46,89,.517,29,57,.509,17,32,.531,14,19,.737,123
2445,PHI,2016-03-21,75,@,IND,L 75-91,240,31,80,.388,27,62,.435,4,18,.222,9,14,.643,75,35,81,.432,25,55,.455,10,26,.385,11,13,.846,91
2446,IND,2016-03-13,75,@,ATL,L 75-104,240,33,87,.379,28,63,.444,5,24,.208,4,7,.571,75,40,85,.471,25,55,.455,15,30,.500,9,10,.900,104
2447,WAS,2016-01-03,75,,MIA,L 75-97,240,31,91,.341,27,61,.443,4,30,.133,9,13,.692,75,39,86,.453,30,63,.476,9,23,.391,10,12,.833,97
2448,BRK,2015-10-30,75,@,SAS,L 75-102,240,31,77,.403,26,61,.426,5,16,.313,8,15,.533,75,40,86,.465,31,64,.484,9,22,.409,13,13,1.000,102
2449,MIA,2016-01-17,74,@,OKC,L 74-99,240,30,72,.417,26,58,.448,4,14,.286,10,11,.909,74,40,88,.455,33,66,.500,7,22,.318,12,12,1.000,99
2450,LAL,2016-01-10,74,,UTA,L 74-86,240,29,89,.326,26,68,.382,3,21,.143,13,15,.867,74,31,69,.449,26,53,.491,5,16,.313,19,25,.760,86
2451,MIN,2016-01-06,74,,DEN,L 74-78,240,28,73,.384,25,62,.403,3,11,.273,15,20,.750,74,29,81,.358,21,61,.344,8,20,.400,12,17,.706,78
2452,BRK,2016-01-06,74,,TOR,L 74-91,240,31,78,.397,26,62,.419,5,16,.313,7,12,.583,74,35,80,.438,31,58,.534,4,22,.182,17,18,.944,91
2453,DEN,2015-12-08,74,,ORL,L 74-85,240,28,84,.333,21,60,.350,7,24,.292,11,20,.550,74,38,88,.432,37,72,.514,1,16,.063,8,10,.800,85
2454,DEN,2015-11-30,74,@,MIL,L 74-92,240,28,75,.373,22,56,.393,6,19,.316,12,16,.750,74,35,77,.455,29,59,.492,6,18,.333,16,22,.727,92
2455,CHO,2016-01-27,73,@,UTA,L 73-102,240,25,68,.368,19,43,.442,6,25,.240,17,21,.810,73,40,81,.494,28,50,.560,12,31,.387,10,15,.667,102
2456,PHI,2015-10-30,71,,UTA,L 71-99,240,19,63,.302,13,48,.271,6,15,.400,27,37,.730,71,36,88,.409,29,75,.387,7,13,.538,20,25,.800,99
2457,MIL,2015-12-02,70,@,SAS,L 70-95,240,26,78,.333,23,64,.359,3,14,.214,15,18,.833,70,37,90,.411,30,69,.435,7,21,.333,14,20,.700,95
2458,PHO,2016-03-17,69,@,UTA,L 69-103,240,28,82,.341,22,56,.393,6,26,.231,7,14,.500,69,43,88,.489,32,63,.508,11,25,.440,6,9,.667,103
2459,MEM,2015-11-02,69,@,GSW,L 69-119,240,26,96,.271,23,73,.315,3,23,.130,14,20,.700,69,43,84,.512,32,59,.542,11,25,.440,22,30,.733,119
2460,PHI,2015-12-07,68,,SAS,L 68-119,240,26,75,.347,22,51,.431,4,24,.167,12,21,.571,68,47,76,.618,43,65,.662,4,11,.364,21,25,.840,119