Rk,Team,Date,PTS,,Opp,Result,MP,FG,FGA,FG%,2P,2PA,2P%,3P,3PA,3P%,FT,FTA,FT%,PTS,FG,FGA,FG%,2P,2PA,2P%,3P,3PA,3P%,FT,FTA,FT%,PTS
1,SAC,2023-02-24,176,@,LAC,W 176-175 (2OT),290,65,111,.586,47,70,.671,18,41,.439,28,35,.800,176,59,98,.602,33,53,.623,26,45,.578,31,36,.861,175
2,LAC,2023-02-24,175,,SAC,L 175-176 (2OT),290,59,98,.602,33,53,.623,26,45,.578,31,36,.861,175,65,111,.586,47,70,.671,18,41,.439,28,35,.800,176
3,GSW,2023-04-09,157,@,POR,W 157-101,240,58,96,.604,31,47,.660,27,49,.551,14,16,.875,157,38,95,.400,29,60,.483,9,35,.257,16,24,.667,101
4,OKC,2023-02-04,153,,HOU,W 153-121,240,56,97,.577,35,51,.686,21,46,.457,20,23,.870,153,45,89,.506,35,59,.593,10,30,.333,21,27,.778,121
5,SAC,2022-11-15,153,,BRK,W 153-121,240,56,94,.596,36,53,.679,20,41,.488,21,25,.840,153,40,81,.494,29,53,.547,11,28,.393,30,33,.909,121
6,MIN,2023-04-08,151,@,SAS,W 151-131,240,56,101,.554,32,58,.552,24,43,.558,15,21,.714,151,50,95,.526,37,66,.561,13,29,.448,18,24,.750,131
7,MEM,2023-03-24,151,,HOU,W 151-114,240,57,93,.613,32,51,.627,25,42,.595,12,14,.857,151,47,87,.540,40,64,.625,7,23,.304,13,21,.619,114
8,MIL,2023-01-23,150,@,DET,W 150-130,240,55,98,.561,32,46,.696,23,52,.442,17,24,.708,150,43,87,.494,30,55,.545,13,32,.406,31,40,.775,130
9,OKC,2023-01-03,150,,BOS,W 150-117,240,58,98,.592,38,58,.655,20,40,.500,14,22,.636,150,40,88,.455,28,48,.583,12,40,.300,25,31,.806,117
10,MIN,2022-12-18,150,,CHI,W 150-126,240,57,87,.655,34,44,.773,23,43,.535,13,16,.813,150,46,88,.523,30,50,.600,16,38,.421,18,24,.750,126
11,MIL,2023-03-29,149,@,IND,W 149-136,240,58,93,.624,48,68,.706,10,25,.400,23,30,.767,149,53,101,.525,39,71,.549,14,30,.467,16,22,.727,136
12,PHI,2023-03-06,147,@,IND,W 147-143,240,48,82,.585,32,48,.667,16,34,.471,35,38,.921,147,53,90,.589,38,53,.717,15,37,.405,22,31,.710,143
13,POR,2023-01-23,147,,SAS,W 147-127,240,55,92,.598,35,59,.593,20,33,.606,17,22,.773,147,47,90,.522,34,63,.540,13,27,.481,20,26,.769,127
14,PHI,2023-01-10,147,,DET,W 147-116,240,54,89,.607,43,58,.741,11,31,.355,28,30,.933,147,36,89,.404,22,50,.440,14,39,.359,30,36,.833,116
15,DEN,2023-02-07,146,,MIN,W 146-112,240,58,93,.624,45,66,.682,13,27,.481,17,22,.773,146,40,85,.471,30,50,.600,10,35,.286,22,26,.846,112
16,CLE,2023-01-02,145,,CHI,W 145-134 (OT),265,48,92,.522,32,46,.696,16,46,.348,33,45,.733,145,47,95,.495,37,62,.597,10,33,.303,30,34,.882,134
17,OKC,2022-11-13,145,@,NYK,W 145-135,240,55,88,.625,38,57,.667,17,31,.548,18,20,.900,145,48,97,.495,38,66,.576,10,31,.323,29,33,.879,135
18,MIL,2023-03-24,144,@,UTA,W 144-116,240,55,99,.556,33,49,.673,22,50,.440,12,16,.750,144,40,104,.385,29,64,.453,11,40,.275,25,34,.735,116
19,CHO,2023-02-13,144,,ATL,W 144-138,240,53,84,.631,33,47,.702,20,37,.541,18,23,.783,144,53,108,.491,42,80,.525,11,28,.393,21,21,1.000,138
20,GSW,2023-01-13,144,@,SAS,W 144-113,240,55,101,.545,37,53,.698,18,48,.375,16,20,.800,144,40,88,.455,32,66,.485,8,22,.364,25,34,.735,113
21,CHI,2022-12-10,144,,DAL,W 144-115,240,54,85,.635,35,51,.686,19,34,.559,17,24,.708,144,41,90,.456,30,46,.652,11,44,.250,22,26,.846,115
22,ATL,2023-03-25,143,,IND,W 143-130,240,53,96,.552,38,66,.576,15,30,.500,22,25,.880,143,52,96,.542,38,59,.644,14,37,.378,12,12,1.000,130
23,IND,2023-03-06,143,,PHI,L 143-147,240,53,90,.589,38,53,.717,15,37,.405,22,31,.710,143,48,82,.585,32,48,.667,16,34,.471,35,38,.921,147
24,MIN,2023-02-08,143,@,UTA,W 143-118,240,56,98,.571,33,55,.600,23,43,.535,8,8,1.000,143,44,105,.419,32,71,.451,12,34,.353,18,21,.857,118
25,GSW,2023-01-02,143,,ATL,W 143-141 (2OT),290,54,121,.446,35,62,.565,19,59,.322,16,24,.667,143,53,109,.486,42,74,.568,11,35,.314,24,29,.828,141
26,BRK,2022-12-21,143,,GSW,W 143-113,240,54,84,.643,33,51,.647,21,33,.636,14,16,.875,143,41,83,.494,29,50,.580,12,33,.364,19,25,.760,113
27,LAL,2022-11-26,143,@,SAS,W 143-138,240,47,81,.580,30,48,.625,17,33,.515,32,37,.865,143,53,105,.505,35,68,.515,18,37,.486,14,20,.700,138
28,TOR,2022-11-02,143,@,SAS,W 143-100,240,57,106,.538,43,73,.589,14,33,.424,15,16,.938,143,37,94,.394,23,51,.451,14,43,.326,12,14,.857,100
29,SAS,2023-04-02,142,@,SAC,W 142-134 (OT),265,52,98,.531,39,64,.609,13,34,.382,25,29,.862,142,49,103,.476,38,59,.644,11,44,.250,25,32,.781,134
30,HOU,2023-03-05,142,,SAS,W 142-110,240,52,85,.612,39,61,.639,13,24,.542,25,29,.862,142,43,93,.462,32,59,.542,11,34,.324,13,21,.619,110
31,NYK,2023-03-01,142,,BRK,W 142-118,240,54,89,.607,34,54,.630,20,35,.571,14,21,.667,142,42,90,.467,27,51,.529,15,39,.385,19,20,.950,118
32,DAL,2023-02-23,142,,SAS,W 142-116,240,46,82,.561,24,40,.600,22,42,.524,28,36,.778,142,45,86,.523,35,61,.574,10,25,.400,16,23,.696,116
33,BOS,2023-02-23,142,@,IND,W 142-138 (OT),265,51,99,.515,33,60,.550,18,39,.462,22,26,.846,142,49,94,.521,27,45,.600,22,49,.449,18,22,.818,138
34,LAC,2022-12-26,142,@,DET,W 142-131 (OT),265,49,91,.538,30,47,.638,19,44,.432,25,29,.862,142,44,100,.440,28,66,.424,16,34,.471,27,34,.794,131
35,MEM,2022-12-15,142,,MIL,W 142-101,240,56,102,.549,44,70,.629,12,32,.375,18,23,.783,142,35,94,.372,22,44,.500,13,50,.260,18,27,.667,101
36,WAS,2022-11-28,142,,MIN,W 142-127,240,52,91,.571,37,60,.617,15,31,.484,23,27,.852,142,42,84,.500,35,57,.614,7,27,.259,36,42,.857,127
37,IND,2023-04-09,141,@,NYK,W 141-136,240,46,89,.517,27,55,.491,19,34,.559,30,38,.789,141,52,108,.481,37,68,.544,15,40,.375,17,22,.773,136
38,LAC,2023-03-29,141,@,MEM,W 141-132,240,48,78,.615,26,41,.634,22,37,.595,23,31,.742,141,49,95,.516,38,63,.603,11,32,.344,23,28,.821,132
39,PHI,2023-03-18,141,@,IND,W 141-121,240,54,88,.614,39,53,.736,15,35,.429,18,22,.818,141,45,87,.517,33,56,.589,12,31,.387,19,20,.950,121
40,GSW,2023-02-06,141,,OKC,W 141-114,240,56,97,.577,30,47,.638,26,50,.520,3,7,.429,141,44,91,.484,33,59,.559,11,32,.344,15,21,.714,114
41,MIL,2023-01-27,141,@,IND,W 141-131,240,52,98,.531,34,55,.618,18,43,.419,19,31,.613,141,49,89,.551,36,56,.643,13,33,.394,20,28,.714,131
42,ATL,2023-01-02,141,@,GSW,L 141-143 (2OT),290,53,109,.486,42,74,.568,11,35,.314,24,29,.828,141,54,121,.446,35,62,.565,19,59,.322,16,24,.667,143
43,DET,2022-12-14,141,@,CHO,W 141-134 (OT),265,48,93,.516,30,53,.566,18,40,.450,27,36,.750,141,47,114,.412,30,63,.476,17,51,.333,23,29,.793,134
44,DEN,2022-12-14,141,,WAS,W 141-128,240,54,83,.651,50,67,.746,4,16,.250,29,35,.829,141,48,91,.527,29,52,.558,19,39,.487,13,23,.565,128
45,MIL,2023-04-04,140,@,WAS,W 140-128,240,50,92,.543,27,50,.540,23,42,.548,17,29,.586,140,50,99,.505,37,72,.514,13,27,.481,15,21,.714,128
46,BOS,2023-03-30,140,@,MIL,W 140-99,240,51,91,.560,29,48,.604,22,43,.512,16,20,.800,140,38,101,.376,24,58,.414,14,43,.326,9,13,.692,99
47,MIN,2023-03-20,140,@,NYK,W 140-134,240,51,83,.614,37,59,.627,14,24,.583,24,32,.750,140,48,85,.565,34,57,.596,14,28,.500,24,28,.857,134
48,SAC,2023-02-06,140,@,HOU,W 140-120,240,52,89,.584,31,48,.646,21,41,.512,15,18,.833,140,44,88,.500,31,56,.554,13,32,.406,19,24,.792,120
49,LAL,2023-01-16,140,,HOU,W 140-132,240,49,91,.538,37,58,.638,12,33,.364,30,35,.857,140,49,100,.490,38,70,.543,11,30,.367,23,31,.742,132
50,POR,2023-01-15,140,,DAL,W 140-123,240,43,85,.506,26,41,.634,17,44,.386,37,42,.881,140,41,89,.461,27,47,.574,14,42,.333,27,33,.818,123
51,NYK,2022-11-29,140,@,DET,W 140-110,240,54,96,.563,38,61,.623,16,35,.457,16,21,.762,140,42,83,.506,29,44,.659,13,39,.333,13,20,.650,110
52,BOS,2022-11-28,140,,CHO,W 140-105,240,55,93,.591,31,41,.756,24,52,.462,6,7,.857,140,42,86,.488,31,57,.544,11,29,.379,10,15,.667,105
53,CHI,2023-03-17,139,,MIN,W 139-131 (2OT),290,51,94,.543,40,70,.571,11,24,.458,26,30,.867,139,46,100,.460,28,58,.483,18,42,.429,21,31,.677,131
54,IND,2023-03-16,139,@,MIL,W 139-123,240,54,97,.557,32,51,.627,22,46,.478,9,15,.600,139,47,89,.528,36,57,.632,11,32,.344,18,26,.692,123
55,MIL,2023-03-01,139,,ORL,W 139-117,240,49,94,.521,23,38,.605,26,56,.464,15,19,.789,139,43,94,.457,34,61,.557,9,33,.273,22,29,.759,117
56,BOS,2023-02-01,139,,BRK,W 139-96,240,53,92,.576,27,38,.711,26,54,.481,7,10,.700,139,36,88,.409,27,49,.551,9,39,.231,15,18,.833,96
57,ATL,2023-01-20,139,,NYK,W 139-124,240,56,100,.560,43,66,.652,13,34,.382,14,16,.875,139,49,83,.590,36,53,.679,13,30,.433,13,17,.765,124
58,SAC,2023-01-13,139,,HOU,W 139-114,240,47,86,.547,27,46,.587,20,40,.500,25,29,.862,139,43,91,.473,31,54,.574,12,37,.324,16,25,.640,114
59,BRK,2023-01-02,139,,SAS,W 139-103,240,58,93,.624,47,73,.644,11,20,.550,12,15,.800,139,42,97,.433,34,66,.515,8,31,.258,11,18,.611,103
60,BOS,2022-12-25,139,,MIL,W 139-118,240,50,85,.588,31,46,.674,19,39,.487,20,25,.800,139,42,84,.500,29,48,.604,13,36,.361,21,27,.778,118
61,UTA,2022-12-02,139,,IND,W 139-119,240,46,83,.554,31,49,.633,15,34,.441,32,37,.865,139,40,92,.435,28,58,.483,12,34,.353,27,33,.818,119
62,UTA,2022-11-07,139,,LAL,W 139-116,240,53,95,.558,37,57,.649,16,38,.421,17,22,.773,139,40,82,.488,31,58,.534,9,24,.375,27,30,.900,116
63,TOR,2022-10-31,139,,ATL,W 139-109,240,46,92,.500,32,58,.552,14,34,.412,33,40,.825,139,39,84,.464,28,55,.509,11,29,.379,20,25,.800,109
64,SAS,2023-04-09,138,@,DAL,W 138-117,240,51,104,.490,36,66,.545,15,38,.395,21,30,.700,138,46,108,.426,29,55,.527,17,53,.321,8,16,.500,117
65,NYK,2023-04-05,138,@,IND,W 138-129,240,52,100,.520,34,54,.630,18,46,.391,16,25,.640,138,45,87,.517,30,57,.526,15,30,.500,24,30,.800,129
66,NOP,2023-04-05,138,,MEM,W 138-131 (OT),265,44,88,.500,23,49,.469,21,39,.538,29,39,.744,138,50,104,.481,38,68,.559,12,36,.333,19,25,.760,131
67,SAC,2023-03-31,138,@,POR,W 138-114,240,54,88,.614,35,49,.714,19,39,.487,11,15,.733,138,40,85,.471,21,47,.447,19,38,.500,15,23,.652,114
68,MIA,2023-03-15,138,,MEM,W 138-119,240,49,82,.598,36,53,.679,13,29,.448,27,33,.818,138,46,91,.505,28,45,.622,18,46,.391,9,14,.643,119
69,MIN,2023-03-04,138,@,SAC,W 138-134,240,48,80,.600,28,41,.683,20,39,.513,22,31,.710,138,49,89,.551,35,62,.565,14,27,.519,22,30,.733,134
70,IND,2023-02-23,138,,BOS,L 138-142 (OT),265,49,94,.521,27,45,.600,22,49,.449,18,22,.818,138,51,99,.515,33,60,.550,18,39,.462,22,26,.846,142
71,ATL,2023-02-13,138,@,CHO,L 138-144,240,53,108,.491,42,80,.525,11,28,.393,21,21,1.000,138,53,84,.631,33,47,.702,20,37,.541,18,23,.783,144
72,OKC,2023-02-10,138,@,POR,W 138-129,240,47,83,.566,35,59,.593,12,24,.500,32,35,.914,138,42,76,.553,26,36,.722,16,40,.400,29,31,.935,129
73,DET,2023-02-10,138,,SAS,W 138-131 (2OT),290,46,107,.430,39,70,.557,7,37,.189,39,49,.796,138,45,107,.421,31,65,.477,14,42,.333,27,34,.794,131
74,LAC,2023-01-26,138,,SAS,W 138-100,240,52,89,.584,34,51,.667,18,38,.474,16,21,.762,138,37,82,.451,29,58,.500,8,24,.333,18,28,.643,100
75,WAS,2023-01-21,138,,ORL,W 138-118,240,51,95,.537,33,61,.541,18,34,.529,18,25,.720,138,42,90,.467,28,56,.500,14,34,.412,20,24,.833,118
76,CHO,2023-01-06,138,@,MIL,W 138-109,240,53,102,.520,33,54,.611,20,48,.417,12,19,.632,138,37,84,.440,17,36,.472,20,48,.417,15,24,.625,109
77,SAS,2022-11-26,138,,LAL,L 138-143,240,53,105,.505,35,68,.515,18,37,.486,14,20,.700,138,47,81,.580,30,48,.625,17,33,.515,32,37,.865,143
78,MEM,2023-04-07,137,@,MIL,W 137-114,240,53,93,.570,33,51,.647,20,42,.476,11,15,.733,137,42,92,.457,21,43,.488,21,49,.429,9,11,.818,114
79,CHO,2023-03-28,137,@,OKC,W 137-134,240,52,94,.553,38,59,.644,14,35,.400,19,30,.633,137,50,96,.521,39,66,.591,11,30,.367,23,29,.793,134
80,NYK,2023-03-27,137,,HOU,W 137-115,240,50,86,.581,33,47,.702,17,39,.436,20,28,.714,137,42,87,.483,35,61,.574,7,26,.269,24,29,.828,115
81,BOS,2023-03-26,137,,SAS,W 137-93,240,52,91,.571,34,47,.723,18,44,.409,15,21,.714,137,36,97,.371,28,61,.459,8,36,.222,13,18,.722,93
82,DAL,2023-03-15,137,@,SAS,W 137-128 (OT),265,44,86,.512,27,53,.509,17,33,.515,32,37,.865,137,49,107,.458,34,73,.466,15,34,.441,15,26,.577,128
83,OKC,2023-03-07,137,,GSW,W 137-128,240,50,94,.532,33,57,.579,17,37,.459,20,24,.833,137,47,89,.528,27,38,.711,20,51,.392,14,16,.875,128
84,PHI,2023-02-03,137,@,SAS,W 137-125,240,46,87,.529,33,60,.550,13,27,.481,32,41,.780,137,52,89,.584,45,68,.662,7,21,.333,14,15,.933,125
85,ATL,2023-01-25,137,@,OKC,W 137-132,240,50,84,.595,39,55,.709,11,29,.379,26,33,.788,137,53,102,.520,38,68,.559,15,34,.441,11,16,.688,132
86,PHI,2023-01-25,137,,BRK,W 137-133,240,42,82,.512,24,44,.545,18,38,.474,35,36,.972,137,49,76,.645,35,50,.700,14,26,.538,21,27,.778,133
87,SAC,2022-11-30,137,,IND,W 137-114,240,48,95,.505,32,52,.615,16,43,.372,25,29,.862,137,40,100,.400,28,63,.444,12,37,.324,22,30,.733,114
88,GSW,2022-11-27,137,@,MIN,W 137-114,240,50,87,.575,30,40,.750,20,47,.426,17,20,.850,137,39,88,.443,25,53,.472,14,35,.400,22,29,.759,114
89,SAC,2022-11-20,137,,DET,W 137-129,240,47,85,.553,35,50,.700,12,35,.343,31,35,.886,137,47,89,.528,32,60,.533,15,29,.517,20,23,.870,129
90,DAL,2022-10-22,137,,MEM,W 137-96,240,45,90,.500,28,51,.549,17,39,.436,30,36,.833,137,34,79,.430,25,46,.543,9,33,.273,19,24,.792,96
91,SAS,2022-10-21,137,@,IND,W 137-134,240,44,81,.543,27,50,.540,17,31,.548,32,44,.727,137,51,104,.490,40,69,.580,11,35,.314,21,22,.955,134
92,NYK,2023-04-09,136,,IND,L 136-141,240,52,108,.481,37,68,.544,15,40,.375,17,22,.773,136,46,89,.517,27,55,.491,19,34,.559,30,38,.789,141
93,LAC,2023-04-08,136,,POR,W 136-125,240,49,93,.527,37,58,.638,12,35,.343,26,30,.867,136,47,89,.528,33,57,.579,14,32,.438,17,23,.739,125
94,PHI,2023-04-07,136,@,ATL,W 136-131 (OT),265,51,102,.500,40,80,.500,11,22,.500,23,29,.793,136,51,92,.554,41,59,.695,10,33,.303,19,28,.679,131
95,GSW,2023-04-04,136,,OKC,W 136-125,240,47,95,.495,27,48,.563,20,47,.426,22,30,.733,136,44,93,.473,33,61,.541,11,32,.344,26,35,.743,125
96,IND,2023-03-29,136,,MIL,L 136-149,240,53,101,.525,39,71,.549,14,30,.467,16,22,.727,136,58,93,.624,48,68,.706,10,25,.400,23,30,.767,149
97,WAS,2023-03-24,136,,SAS,W 136-124,240,51,85,.600,36,55,.655,15,30,.500,19,26,.731,136,51,101,.505,38,63,.603,13,38,.342,9,15,.600,124
98,MIN,2023-03-13,136,@,ATL,W 136-115,240,54,92,.587,42,64,.656,12,28,.429,16,23,.696,136,44,97,.454,40,75,.533,4,22,.182,23,28,.821,115
99,ATL,2023-02-24,136,,CLE,W 136-119,240,50,85,.588,35,57,.614,15,28,.536,21,23,.913,136,40,88,.455,27,53,.509,13,35,.371,26,29,.897,119
100,NOP,2023-02-05,136,,SAC,W 136-104,240,48,85,.565,34,59,.576,14,26,.538,26,34,.765,136,35,82,.427,24,40,.600,11,42,.262,23,27,.852,104
101,MEM,2023-01-16,136,,PHO,W 136-106,240,52,98,.531,36,61,.590,16,37,.432,16,20,.800,136,39,89,.438,29,56,.518,10,33,.303,18,19,.947,106
102,POR,2023-01-14,136,,DAL,W 136-119,240,49,88,.557,32,47,.681,17,41,.415,21,22,.955,136,43,82,.524,21,36,.583,22,46,.478,11,19,.579,119
103,SAC,2023-01-09,136,,ORL,W 136-111,240,52,97,.536,29,51,.569,23,46,.500,9,12,.750,136,41,90,.456,27,46,.587,14,44,.318,15,20,.750,111
104,LAL,2023-01-07,136,@,SAC,W 136-134,240,50,82,.610,41,61,.672,9,21,.429,27,33,.818,136,45,86,.523,31,54,.574,14,32,.438,30,37,.811,134
105,BRK,2022-12-10,136,@,IND,W 136-133,240,52,100,.520,43,72,.597,9,28,.321,23,32,.719,136,47,85,.553,26,41,.634,21,44,.477,18,24,.750,133
106,MIL,2022-11-09,136,@,OKC,W 136-132 (2OT),290,50,106,.472,33,70,.471,17,36,.472,19,22,.864,136,50,111,.450,32,66,.485,18,45,.400,14,19,.737,132
107,ATL,2022-10-28,136,@,DET,W 136-112,240,55,97,.567,43,68,.632,12,29,.414,14,18,.778,136,37,86,.430,30,54,.556,7,32,.219,31,38,.816,112
108,LAL,2023-04-04,135,@,UTA,W 135-133 (OT),265,48,96,.500,36,62,.581,12,34,.353,27,35,.771,135,47,90,.522,32,57,.561,15,33,.455,24,31,.774,133
109,SAC,2023-03-24,135,,PHO,W 135-127,240,47,89,.528,34,50,.680,13,39,.333,28,32,.875,135,48,89,.539,39,60,.650,9,29,.310,22,29,.759,127
110,LAC,2023-03-05,135,,MEM,W 135-129,240,45,85,.529,33,56,.589,12,29,.414,33,35,.943,135,50,92,.543,32,58,.552,18,34,.529,11,15,.733,129
111,GSW,2023-02-13,135,,WAS,W 135-126,240,52,89,.584,32,49,.653,20,40,.500,11,15,.733,135,48,80,.600,36,52,.692,12,28,.429,18,21,.857,126
112,MIL,2023-01-29,135,,NOP,W 135-110,240,53,96,.552,36,53,.679,17,43,.395,12,20,.600,135,41,93,.441,28,59,.475,13,34,.382,15,21,.714,110
113,SAC,2023-01-11,135,,HOU,W 135-115,240,45,94,.479,26,46,.565,19,48,.396,26,31,.839,135,44,96,.458,28,55,.509,16,41,.390,11,17,.647,115
114,MEM,2023-01-11,135,,SAS,W 135-129,240,52,101,.515,38,79,.481,14,22,.636,17,25,.680,135,50,107,.467,39,73,.534,11,34,.324,18,23,.783,129
115,DET,2023-01-11,135,,MIN,W 135-118,240,48,80,.600,31,48,.646,17,32,.531,22,28,.786,135,43,88,.489,27,55,.491,16,33,.485,16,21,.762,118
116,POR,2023-01-02,135,,DET,W 135-106,240,48,84,.571,34,53,.642,14,31,.452,25,35,.714,135,34,82,.415,28,64,.438,6,18,.333,32,41,.780,106
117,IND,2022-12-29,135,,CLE,W 135-126,240,48,85,.565,29,54,.537,19,31,.613,20,21,.952,135,50,96,.521,38,68,.559,12,28,.429,14,20,.700,126
118,ORL,2022-12-14,135,,ATL,W 135-124,240,47,93,.505,31,57,.544,16,36,.444,25,30,.833,135,44,88,.500,32,53,.604,12,35,.343,24,27,.889,124
119,OKC,2022-12-03,135,@,MIN,W 135-128,240,48,93,.516,37,67,.552,11,26,.423,28,35,.800,135,47,89,.528,37,59,.627,10,30,.333,24,30,.800,128
120,NYK,2022-11-13,135,,OKC,L 135-145,240,48,97,.495,38,66,.576,10,31,.323,29,33,.879,135,55,88,.625,38,57,.667,17,31,.548,18,20,.900,145
121,POR,2022-10-24,135,,DEN,W 135-110,240,48,83,.578,32,48,.667,16,35,.457,23,31,.742,135,45,91,.495,33,60,.550,12,31,.387,8,14,.571,110
122,PHI,2023-04-09,134,@,BRK,W 134-105,240,53,101,.525,39,69,.565,14,32,.438,14,19,.737,134,35,83,.422,23,51,.451,12,32,.375,23,28,.821,105
123,ATL,2023-04-05,134,,WAS,W 134-116,240,43,84,.512,30,54,.556,13,30,.433,35,40,.875,134,45,94,.479,39,66,.591,6,28,.214,20,26,.769,116
124,LAL,2023-04-02,134,@,HOU,W 134-109,240,52,93,.559,43,63,.683,9,30,.300,21,28,.750,134,44,102,.431,31,68,.456,13,34,.382,8,10,.800,109
125,SAC,2023-04-02,134,,SAS,L 134-142 (OT),265,49,103,.476,38,59,.644,11,44,.250,25,32,.781,134,52,98,.531,39,64,.609,13,34,.382,25,29,.862,142
126,OKC,2023-03-28,134,,CHO,L 134-137,240,50,96,.521,39,66,.591,11,30,.367,23,29,.793,134,52,94,.553,38,59,.644,14,35,.400,19,30,.633,137
127,NYK,2023-03-20,134,,MIN,L 134-140,240,48,85,.565,34,57,.596,14,28,.500,24,28,.857,134,51,83,.614,37,59,.627,14,24,.583,24,32,.750,140
128,LAC,2023-03-15,134,,GSW,W 134-126,240,46,96,.479,30,62,.484,16,34,.471,26,32,.813,134,49,88,.557,32,52,.615,17,36,.472,11,15,.733,126
129,BOS,2023-03-11,134,@,ATL,W 134-125,240,52,95,.547,32,53,.604,20,42,.476,10,12,.833,134,50,100,.500,40,66,.606,10,34,.294,15,16,.938,125
130,IND,2023-03-09,134,,HOU,W 134-125 (OT),265,48,100,.480,30,55,.545,18,45,.400,20,21,.952,134,49,107,.458,43,90,.478,6,17,.353,21,29,.724,125
131,MIL,2023-03-07,134,@,ORL,W 134-123,240,46,78,.590,36,50,.720,10,28,.357,32,34,.941,134,50,100,.500,41,70,.586,9,30,.300,14,19,.737,123
132,SAC,2023-03-04,134,,MIN,L 134-138,240,49,89,.551,35,62,.565,14,27,.519,22,30,.733,134,48,80,.600,28,41,.683,20,39,.513,22,31,.710,138
133,DEN,2023-02-26,134,,LAC,W 134-124 (OT),265,49,96,.510,36,57,.632,13,39,.333,23,31,.742,134,44,90,.489,33,56,.589,11,34,.324,25,30,.833,124
134,LAC,2023-02-14,134,,GSW,W 134-124,240,49,92,.533,32,56,.571,17,36,.472,19,22,.864,134,45,83,.542,30,49,.612,15,34,.441,19,27,.704,124
135,LAC,2023-02-04,134,@,NYK,W 134-128 (OT),265,44,92,.478,28,55,.509,16,37,.432,30,35,.857,134,45,94,.479,27,54,.500,18,40,.450,20,26,.769,128
136,DEN,2023-02-02,134,,GSW,W 134-117,240,51,90,.567,35,55,.636,16,35,.457,16,21,.762,134,43,85,.506,24,47,.511,19,38,.500,12,19,.632,117
137,POR,2023-01-25,134,,UTA,W 134-124,240,51,89,.573,34,53,.642,17,36,.472,15,18,.833,134,47,90,.522,27,49,.551,20,41,.488,10,15,.667,124
138,DEN,2023-01-20,134,,IND,W 134-111,240,51,83,.614,37,55,.673,14,28,.500,18,26,.692,134,37,84,.440,29,52,.558,8,32,.250,29,37,.784,111
139,SAC,2023-01-07,134,,LAL,L 134-136,240,45,86,.523,31,54,.574,14,32,.438,30,37,.811,134,50,82,.610,41,61,.672,9,21,.429,27,33,.818,136
140,CHI,2023-01-02,134,@,CLE,L 134-145 (OT),265,47,95,.495,37,62,.597,10,33,.303,30,34,.882,134,48,92,.522,32,46,.696,16,46,.348,33,45,.733,145
141,CHO,2022-12-23,134,@,LAL,W 134-130,240,52,94,.553,36,53,.679,16,41,.390,14,18,.778,134,48,92,.522,29,48,.604,19,44,.432,15,22,.682,130
142,SAC,2022-12-21,134,,LAL,W 134-120,240,48,95,.505,31,48,.646,17,47,.362,21,28,.750,134,42,84,.500,31,60,.517,11,24,.458,25,30,.833,120
143,CHO,2022-12-14,134,,DET,L 134-141 (OT),265,47,114,.412,30,63,.476,17,51,.333,23,29,.793,134,48,93,.516,30,53,.566,18,40,.450,27,36,.750,141
144,BOS,2022-11-30,134,,MIA,W 134-121,240,46,83,.554,24,38,.632,22,45,.489,20,23,.870,134,47,90,.522,29,50,.580,18,40,.450,9,9,1.000,121
145,UTA,2022-11-18,134,,PHO,W 134-133,240,51,91,.560,35,60,.583,16,31,.516,16,24,.667,134,49,94,.521,40,64,.625,9,30,.300,26,28,.929,133
146,HOU,2022-11-07,134,@,ORL,W 134-127,240,46,87,.529,22,39,.564,24,48,.500,18,25,.720,134,45,82,.549,33,57,.579,12,25,.480,25,31,.806,127
147,NYK,2022-10-26,134,,CHO,W 134-131 (OT),265,52,97,.536,41,67,.612,11,30,.367,19,22,.864,134,49,99,.495,36,68,.529,13,31,.419,20,30,.667,131
148,MIN,2022-10-26,134,,SAS,W 134-122,240,52,80,.650,32,46,.696,20,34,.588,10,16,.625,134,43,95,.453,27,59,.458,16,36,.444,20,22,.909,122
149,PHO,2022-10-25,134,,GSW,W 134-105,240,47,92,.511,35,63,.556,12,29,.414,28,34,.824,134,41,91,.451,31,56,.554,10,35,.286,13,17,.765,105
150,MEM,2022-10-24,134,,BRK,W 134-124,240,47,94,.500,31,60,.517,16,34,.471,24,31,.774,134,47,87,.540,38,58,.655,9,29,.310,21,26,.808,124
151,IND,2022-10-21,134,,SAS,L 134-137,240,51,104,.490,40,69,.580,11,35,.314,21,22,.955,134,44,81,.543,27,50,.540,17,31,.548,32,44,.727,137
152,UTA,2023-04-04,133,,LAL,L 133-135 (OT),265,47,90,.522,32,57,.561,15,33,.455,24,31,.774,133,48,96,.500,36,62,.581,12,34,.353,27,35,.771,135
153,MEM,2023-03-18,133,,GSW,W 133-119,240,52,95,.547,34,57,.596,18,38,.474,11,17,.647,133,39,91,.429,26,56,.464,13,35,.371,28,34,.824,119
154,MIL,2023-03-13,133,@,SAC,W 133-124,240,50,86,.581,35,53,.660,15,33,.455,18,22,.818,133,46,104,.442,25,54,.463,21,50,.420,11,15,.733,124
155,PHI,2023-03-04,133,@,MIL,W 133-130,240,42,84,.500,24,47,.511,18,37,.486,31,37,.838,133,44,83,.530,27,49,.551,17,34,.500,25,28,.893,130
156,DAL,2023-03-02,133,,PHI,W 133-126,240,45,82,.549,20,34,.588,25,48,.521,18,27,.667,133,45,78,.577,33,51,.647,12,27,.444,24,29,.828,126
157,DEN,2023-02-28,133,@,HOU,W 133-112,240,53,92,.576,37,55,.673,16,37,.432,11,16,.688,133,48,97,.495,39,66,.591,9,31,.290,7,10,.700,112
158,SAC,2023-02-23,133,,POR,W 133-116,240,47,85,.553,33,51,.647,14,34,.412,25,31,.806,133,43,93,.462,27,55,.491,16,38,.421,14,17,.824,116
159,OKC,2023-02-15,133,,HOU,W 133-96,240,42,87,.483,33,53,.623,9,34,.265,40,47,.851,133,30,89,.337,20,52,.385,10,37,.270,26,38,.684,96
160,SAC,2023-02-11,133,,DAL,W 133-128 (OT),265,51,100,.510,43,68,.632,8,32,.250,23,25,.920,133,47,91,.516,27,40,.675,20,51,.392,14,19,.737,128
161,OKC,2023-02-07,133,@,LAL,W 133-130,240,49,94,.521,32,60,.533,17,34,.500,18,20,.900,133,49,85,.576,35,54,.648,14,31,.452,18,26,.692,130
162,BRK,2023-01-25,133,@,PHI,L 133-137,240,49,76,.645,35,50,.700,14,26,.538,21,27,.778,133,42,82,.512,24,44,.545,18,38,.474,35,36,.972,137
163,LAC,2023-01-24,133,@,LAL,W 133-115,240,51,84,.607,32,46,.696,19,38,.500,12,15,.800,133,42,95,.442,26,55,.473,16,40,.400,15,24,.625,115
164,SAC,2023-01-23,133,,MEM,W 133-100,240,49,88,.557,27,48,.563,22,40,.550,13,14,.929,133,40,98,.408,28,62,.452,12,36,.333,8,10,.800,100
165,OKC,2023-01-12,133,@,PHI,W 133-114,240,44,86,.512,30,53,.566,14,33,.424,31,33,.939,133,39,88,.443,28,52,.538,11,36,.306,25,27,.926,114
166,HOU,2022-12-26,133,@,CHI,W 133-118,240,50,90,.556,33,46,.717,17,44,.386,16,22,.727,133,45,92,.489,32,57,.561,13,35,.371,15,21,.714,118
167,ORL,2022-12-23,133,,SAS,W 133-113,240,50,87,.575,33,55,.600,17,32,.531,16,20,.800,133,44,97,.454,32,59,.542,12,38,.316,13,18,.722,113
168,POR,2022-12-12,133,,MIN,W 133-112,240,48,89,.539,27,43,.628,21,46,.457,16,21,.762,133,46,93,.495,36,66,.545,10,27,.370,10,19,.526,112
169,IND,2022-12-10,133,,BRK,L 133-136,240,47,85,.553,26,41,.634,21,44,.477,18,24,.750,133,52,100,.520,43,72,.597,9,28,.321,23,32,.719,136
170,PHI,2022-12-09,133,,LAL,W 133-122 (OT),265,48,90,.533,30,50,.600,18,40,.450,19,22,.864,133,44,88,.500,33,57,.579,11,31,.355,23,30,.767,122
171,PHO,2022-12-04,133,@,SAS,W 133-95,240,49,94,.521,30,57,.526,19,37,.514,16,20,.800,133,38,87,.437,32,56,.571,6,31,.194,13,18,.722,95
172,LAL,2022-12-02,133,@,MIL,W 133-129,240,52,96,.542,41,70,.586,11,26,.423,18,24,.750,133,50,94,.532,33,51,.647,17,43,.395,12,15,.800,129
173,PHI,2022-11-27,133,@,ORL,W 133-103,240,50,77,.649,39,50,.780,11,27,.407,22,27,.815,133,36,79,.456,24,39,.615,12,40,.300,19,25,.760,103
174,PHO,2022-11-18,133,@,UTA,L 133-134,240,49,94,.521,40,64,.625,9,30,.300,26,28,.929,133,51,91,.560,35,60,.583,16,31,.516,16,24,.667,134
175,BOS,2022-11-05,133,@,NYK,W 133-118,240,47,88,.534,20,37,.541,27,51,.529,12,12,1.000,133,46,90,.511,35,63,.556,11,27,.407,15,16,.938,118
176,ATL,2023-04-02,132,,DAL,W 132-130 (OT),265,51,108,.472,39,73,.534,12,35,.343,18,22,.818,132,49,95,.516,39,57,.684,10,38,.263,22,32,.688,130
177,MEM,2023-03-29,132,,LAC,L 132-141,240,49,95,.516,38,63,.603,11,32,.344,23,28,.821,132,48,78,.615,26,41,.634,22,37,.595,23,31,.742,141
178,BOS,2023-03-21,132,@,SAC,W 132-109,240,49,92,.533,31,48,.646,18,44,.409,16,23,.696,132,39,81,.481,22,37,.595,17,44,.386,14,21,.667,109
179,SAC,2023-03-18,132,@,WAS,W 132-118,240,48,86,.558,26,49,.531,22,37,.595,14,23,.609,132,41,91,.451,28,55,.509,13,36,.361,23,27,.852,118
180,SAS,2023-03-14,132,,ORL,W 132-114,240,48,85,.565,26,44,.591,22,41,.537,14,18,.778,132,44,97,.454,34,68,.500,10,29,.345,16,21,.762,114
181,PHO,2023-03-08,132,,OKC,W 132-101,240,49,94,.521,29,51,.569,20,43,.465,14,16,.875,132,33,88,.375,18,45,.400,15,43,.349,20,21,.952,101
182,ATL,2023-02-01,132,@,PHO,W 132-100,240,52,91,.571,33,58,.569,19,33,.576,9,11,.818,132,35,86,.407,31,58,.534,4,28,.143,26,31,.839,100
183,OKC,2023-01-25,132,,ATL,L 132-137,240,53,102,.520,38,68,.559,15,34,.441,11,16,.688,132,50,84,.595,39,55,.709,11,29,.379,26,33,.788,137
184,HOU,2023-01-16,132,@,LAL,L 132-140,240,49,100,.490,38,70,.543,11,30,.367,23,31,.742,132,49,91,.538,37,58,.638,12,33,.364,30,35,.857,140
185,MIL,2023-01-16,132,,IND,W 132-119,240,48,91,.527,25,45,.556,23,46,.500,13,15,.867,132,43,84,.512,24,44,.545,19,40,.475,14,15,.933,119
186,SAC,2023-01-15,132,@,SAS,W 132-119,240,49,89,.551,35,59,.593,14,30,.467,20,25,.800,132,48,93,.516,38,67,.567,10,26,.385,13,20,.650,119
187,CHI,2023-01-15,132,,GSW,W 132-118,240,48,95,.505,33,56,.589,15,39,.385,21,24,.875,132,41,83,.494,20,32,.625,21,51,.412,15,22,.682,118
188,TOR,2023-01-10,132,,CHO,W 132-120,240,45,91,.495,25,47,.532,20,44,.455,22,27,.815,132,47,86,.547,32,51,.627,15,35,.429,11,15,.733,120
189,NOP,2023-01-09,132,@,WAS,W 132-112,240,49,93,.527,39,67,.582,10,26,.385,24,31,.774,132,42,82,.512,28,48,.583,14,34,.412,14,18,.778,112
190,CHI,2022-12-30,132,,DET,W 132-118,240,53,92,.576,41,65,.631,12,27,.444,14,15,.933,132,41,86,.477,24,47,.511,17,39,.436,19,24,.792,118
191,NYK,2022-12-20,132,,GSW,W 132-94,240,45,87,.517,28,47,.596,17,40,.425,25,32,.781,132,35,74,.473,23,39,.590,12,35,.343,12,13,.923,94
192,UTA,2022-12-15,132,,NOP,W 132-129 (OT),265,42,92,.457,24,45,.533,18,47,.383,30,37,.811,132,47,99,.475,35,69,.507,12,30,.400,23,28,.821,129
193,HOU,2022-12-05,132,,PHI,W 132-123 (2OT),290,42,94,.447,28,55,.509,14,39,.359,34,44,.773,132,39,87,.448,22,51,.431,17,36,.472,28,36,.778,123
194,PHO,2022-11-30,132,,CHI,W 132-113,240,49,93,.527,34,60,.567,15,33,.455,19,21,.905,132,41,82,.500,37,57,.649,4,25,.160,27,33,.818,113
195,MEM,2022-11-25,132,,NOP,W 132-111,240,47,91,.516,29,53,.547,18,38,.474,20,27,.741,132,37,86,.430,27,55,.491,10,31,.323,27,31,.871,111
196,POR,2022-11-25,132,@,NYK,W 132-129 (OT),265,42,85,.494,32,53,.604,10,32,.313,38,51,.745,132,46,105,.438,33,64,.516,13,41,.317,24,28,.857,129
197,CLE,2022-11-18,132,,CHO,W 132-122 (2OT),290,49,92,.533,41,64,.641,8,28,.286,26,32,.813,132,44,110,.400,30,66,.455,14,44,.318,20,24,.833,122
198,GSW,2022-11-14,132,,SAS,W 132-95,240,47,88,.534,24,43,.558,23,45,.511,15,16,.938,132,36,100,.360,26,60,.433,10,40,.250,13,19,.684,95
199,MIA,2022-11-12,132,,CHO,W 132-115,240,49,93,.527,33,52,.635,16,41,.390,18,21,.857,132,46,90,.511,37,59,.627,9,31,.290,14,16,.875,115
200,OKC,2022-11-11,132,,TOR,W 132-113,240,52,93,.559,37,57,.649,15,36,.417,13,17,.765,132,38,88,.432,27,58,.466,11,30,.367,26,36,.722,113
201,OKC,2022-11-09,132,,MIL,L 132-136 (2OT),290,50,111,.450,32,66,.485,18,45,.400,14,19,.737,132,50,106,.472,33,70,.471,17,36,.472,19,22,.864,136
202,CLE,2022-10-28,132,@,BOS,W 132-123 (OT),265,45,87,.517,29,52,.558,16,35,.457,26,34,.765,132,42,82,.512,29,49,.592,13,33,.394,26,32,.813,123
203,UTA,2022-10-21,132,@,MIN,W 132-126 (OT),265,49,111,.441,29,61,.475,20,50,.400,14,21,.667,132,49,107,.458,38,74,.514,11,33,.333,17,23,.739,126
204,SAS,2023-04-08,131,,MIN,L 131-151,240,50,95,.526,37,66,.561,13,29,.448,18,24,.750,131,56,101,.554,32,58,.552,24,43,.558,15,21,.714,151
205,ATL,2023-04-07,131,,PHI,L 131-136 (OT),265,51,92,.554,41,59,.695,10,33,.303,19,28,.679,131,51,102,.500,40,80,.500,11,22,.500,23,29,.793,136
206,MEM,2023-04-05,131,@,NOP,L 131-138 (OT),265,50,104,.481,38,68,.559,12,36,.333,19,25,.760,131,44,88,.500,23,49,.469,21,39,.538,29,39,.744,138
207,NOP,2023-03-25,131,@,LAC,W 131-110,240,51,96,.531,30,62,.484,21,34,.618,8,9,.889,131,39,75,.520,24,42,.571,15,33,.455,17,21,.810,110
208,MIN,2023-03-17,131,@,CHI,L 131-139 (2OT),290,46,100,.460,28,58,.483,18,42,.429,21,31,.677,131,51,94,.543,40,70,.571,11,24,.458,26,30,.867,139
209,MEM,2023-03-09,131,,GSW,W 131-110,240,50,93,.538,32,53,.604,18,40,.450,13,18,.722,131,36,82,.439,21,37,.568,15,45,.333,23,24,.958,110
210,UTA,2023-03-09,131,@,ORL,W 131-124,240,49,88,.557,36,54,.667,13,34,.382,20,21,.952,131,44,94,.468,28,60,.467,16,34,.471,20,31,.645,124
211,NYK,2023-03-05,131,@,BOS,W 131-129 (2OT),290,47,95,.495,32,54,.593,15,41,.366,22,32,.688,131,43,109,.394,22,50,.440,21,59,.356,22,25,.880,129
212,POR,2023-02-26,131,,HOU,W 131-114,240,42,77,.545,22,38,.579,20,39,.513,27,35,.771,131,45,100,.450,38,74,.514,7,26,.269,17,25,.680,114
213,CHI,2023-02-24,131,,BRK,W 131-87,240,50,88,.568,38,62,.613,12,26,.462,19,28,.679,131,30,81,.370,18,37,.486,12,44,.273,15,19,.789,87
214,MIL,2023-02-14,131,,BOS,W 131-125 (OT),265,43,90,.478,25,48,.521,18,42,.429,27,35,.771,131,46,99,.465,29,49,.592,17,50,.340,16,20,.800,125
215,SAS,2023-02-10,131,@,DET,L 131-138 (2OT),290,45,107,.421,31,65,.477,14,42,.333,27,34,.794,131,46,107,.430,39,70,.557,7,37,.189,39,49,.796,138
216,NOP,2023-02-04,131,,LAL,W 131-126,240,52,100,.520,43,70,.614,9,30,.300,18,20,.900,131,45,94,.479,34,62,.548,11,32,.344,25,33,.758,126
217,UTA,2023-02-01,131,,TOR,W 131-128,240,44,83,.530,27,36,.750,17,47,.362,26,30,.867,131,50,110,.455,40,87,.460,10,23,.435,18,26,.692,128
218,IND,2023-01-27,131,,MIL,L 131-141,240,49,89,.551,36,56,.643,13,33,.394,20,28,.714,131,52,98,.531,34,55,.618,18,43,.419,19,31,.613,141
219,LAC,2023-01-20,131,@,SAS,W 131-126,240,51,81,.630,36,53,.679,15,28,.536,14,20,.700,131,51,89,.573,37,63,.587,14,26,.538,10,14,.714,126
220,UTA,2023-01-05,131,@,HOU,W 131-114,240,46,93,.495,27,45,.600,19,48,.396,20,21,.952,131,38,92,.413,23,50,.460,15,42,.357,23,26,.885,114
221,MEM,2023-01-04,131,@,CHO,W 131-107,240,47,94,.500,38,64,.594,9,30,.300,28,37,.757,131,38,94,.404,27,56,.482,11,38,.289,20,24,.833,107
222,IND,2022-12-31,131,,LAC,W 131-130,240,46,88,.523,32,50,.640,14,38,.368,25,29,.862,131,43,80,.538,27,46,.587,16,34,.471,28,29,.966,130
223,DET,2022-12-26,131,,LAC,L 131-142 (OT),265,44,100,.440,28,66,.424,16,34,.471,27,34,.794,131,49,91,.538,30,47,.638,19,44,.432,25,29,.862,142
224,PHI,2022-12-11,131,,CHO,W 131-113,240,46,83,.554,33,56,.589,13,27,.481,26,32,.813,131,38,93,.409,27,63,.429,11,30,.367,26,30,.867,113
225,DET,2022-12-01,131,,DAL,W 131-125 (OT),265,51,94,.543,36,59,.610,15,35,.429,14,24,.583,131,46,86,.535,27,40,.675,19,46,.413,14,29,.483,125
226,DEN,2022-11-23,131,@,OKC,W 131-126 (OT),265,42,88,.477,28,50,.560,14,38,.368,33,41,.805,131,42,97,.433,24,57,.421,18,40,.450,24,28,.857,126
227,BOS,2022-11-11,131,,DEN,W 131-112,240,50,90,.556,34,53,.642,16,37,.432,15,20,.750,131,42,92,.457,30,63,.476,12,29,.414,16,20,.800,112
228,CHO,2022-10-26,131,@,NYK,L 131-134 (OT),265,49,99,.495,36,68,.529,13,31,.419,20,30,.667,131,52,97,.536,41,67,.612,11,30,.367,19,22,.864,134
229,DAL,2023-04-02,130,@,ATL,L 130-132 (OT),265,49,95,.516,39,57,.684,10,38,.263,22,32,.688,130,51,108,.472,39,73,.534,12,35,.343,18,22,.818,132
230,NYK,2023-03-31,130,@,CLE,W 130-116,240,49,93,.527,32,57,.561,17,36,.472,15,24,.625,130,44,86,.512,27,49,.551,17,37,.459,11,13,.846,116
231,GSW,2023-03-31,130,,SAS,W 130-115,240,47,93,.505,26,44,.591,21,49,.429,15,21,.714,130,42,91,.462,27,53,.509,15,38,.395,16,23,.696,115
232,WAS,2023-03-28,130,,BOS,W 130-111,240,54,99,.545,41,62,.661,13,37,.351,9,13,.692,130,45,93,.484,34,49,.694,11,44,.250,10,11,.909,111
233,IND,2023-03-25,130,@,ATL,L 130-143,240,52,96,.542,38,59,.644,14,37,.378,12,12,1.000,130,53,96,.552,38,66,.576,15,30,.500,22,25,.880,143
234,MEM,2023-03-22,130,,HOU,W 130-125,240,45,87,.517,33,51,.647,12,36,.333,28,33,.848,130,48,93,.516,36,60,.600,12,33,.364,17,23,.739,125
235,MIL,2023-03-22,130,,SAS,W 130-94,240,51,98,.520,36,55,.655,15,43,.349,13,24,.542,130,36,93,.387,27,54,.500,9,39,.231,13,20,.650,94
236,MIA,2023-03-06,130,,ATL,W 130-128,240,41,77,.532,25,48,.521,16,29,.552,32,37,.865,130,51,92,.554,42,63,.667,9,29,.310,17,23,.739,128
237,PHO,2023-03-05,130,@,DAL,W 130-126,240,49,89,.551,37,55,.673,12,34,.353,20,25,.800,130,38,77,.494,23,39,.590,15,38,.395,35,38,.921,126
238,MIL,2023-03-04,130,,PHI,L 130-133,240,44,83,.530,27,49,.551,17,34,.500,25,28,.893,130,42,84,.500,24,47,.511,18,37,.486,31,37,.838,133
239,OKC,2023-03-03,130,,UTA,W 130-103,240,52,104,.500,35,61,.574,17,43,.395,9,14,.643,130,38,78,.487,29,49,.592,9,29,.310,18,23,.783,103
240,SAC,2023-02-08,130,@,HOU,W 130-128,240,46,92,.500,36,62,.581,10,30,.333,28,30,.933,130,47,86,.547,37,64,.578,10,22,.455,24,28,.857,128
241,LAL,2023-02-07,130,,OKC,L 130-133,240,49,85,.576,35,54,.648,14,31,.452,18,26,.692,130,49,94,.521,32,60,.533,17,34,.500,18,20,.900,133
242,DET,2023-01-26,130,@,BRK,W 130-122,240,48,95,.505,37,68,.544,11,27,.407,23,26,.885,130,43,94,.457,30,56,.536,13,38,.342,23,27,.852,122
243,DET,2023-01-23,130,,MIL,L 130-150,240,43,87,.494,30,55,.545,13,32,.406,31,40,.775,130,55,98,.561,32,46,.696,23,52,.442,17,24,.708,150
244,ATL,2023-01-18,130,@,DAL,W 130-122,240,49,86,.570,36,60,.600,13,26,.500,19,20,.950,130,44,84,.524,28,42,.667,16,42,.381,18,24,.750,122
245,MIL,2023-01-17,130,,TOR,W 130-122,240,46,86,.535,27,47,.574,19,39,.487,19,21,.905,130,46,101,.455,33,66,.500,13,35,.371,17,27,.630,122
246,BOS,2023-01-16,130,@,CHO,W 130-118,240,43,87,.494,23,44,.523,20,43,.465,24,25,.960,130,41,90,.456,28,59,.475,13,31,.419,23,30,.767,118
247,MEM,2023-01-14,130,@,IND,W 130-112,240,48,87,.552,36,55,.655,12,32,.375,22,28,.786,130,38,103,.369,27,56,.482,11,47,.234,25,28,.893,112
248,LAL,2023-01-06,130,,ATL,W 130-114,240,51,93,.548,35,58,.603,16,35,.457,12,16,.750,130,44,96,.458,35,65,.538,9,31,.290,17,22,.773,114
249,LAC,2022-12-31,130,@,IND,L 130-131,240,43,80,.538,27,46,.587,16,34,.471,28,29,.966,130,46,88,.523,32,50,.640,14,38,.368,25,29,.862,131
250,LAL,2022-12-30,130,@,ATL,W 130-121,240,52,96,.542,42,64,.656,10,32,.313,16,18,.889,130,48,101,.475,37,63,.587,11,38,.289,14,20,.700,121
251,OKC,2022-12-27,130,,SAS,W 130-114,240,46,86,.535,33,62,.532,13,24,.542,25,31,.806,130,46,99,.465,36,70,.514,10,29,.345,12,14,.857,114
252,ATL,2022-12-23,130,,DET,W 130-105,240,49,92,.533,37,58,.638,12,34,.353,20,24,.833,130,37,90,.411,28,57,.491,9,33,.273,22,29,.759,105
253,LAL,2022-12-23,130,,CHO,L 130-134,240,48,92,.522,29,48,.604,19,44,.432,15,22,.682,130,52,94,.553,36,53,.679,16,41,.390,14,18,.778,134
254,PHO,2022-12-19,130,,LAL,W 130-104,240,46,93,.495,26,54,.481,20,39,.513,18,24,.750,130,39,87,.448,27,59,.458,12,28,.429,14,17,.824,104
255,DAL,2022-12-16,130,,POR,W 130-110,240,45,81,.556,27,38,.711,18,43,.419,22,26,.846,130,39,89,.438,26,52,.500,13,37,.351,19,25,.760,110
256,DAL,2022-12-05,130,,PHO,W 130-111,240,44,84,.524,24,43,.558,20,41,.488,22,26,.846,130,40,91,.440,27,54,.500,13,37,.351,18,26,.692,111
257,LAL,2022-12-04,130,@,WAS,W 130-119,240,52,96,.542,42,70,.600,10,26,.385,16,22,.727,130,49,105,.467,39,66,.591,10,39,.256,11,15,.733,119
258,BOS,2022-11-27,130,,WAS,W 130-121,240,44,80,.550,28,46,.609,16,34,.471,26,26,1.000,130,44,82,.537,37,54,.685,7,28,.250,26,33,.788,121
259,SAC,2022-11-17,130,,SAS,W 130-112,240,48,83,.578,36,53,.679,12,30,.400,22,24,.917,130,46,84,.548,35,58,.603,11,26,.423,9,12,.750,112
260,PHO,2022-11-16,130,,GSW,W 130-119,240,44,86,.512,23,46,.500,21,40,.525,21,25,.840,130,42,92,.457,24,50,.480,18,42,.429,17,17,1.000,119
261,UTA,2022-11-04,130,@,LAL,W 130-116,240,52,103,.505,35,63,.556,17,40,.425,9,10,.900,130,40,83,.482,29,57,.509,11,26,.423,25,28,.893,116
262,MEM,2022-11-04,130,,CHO,W 130-99,240,50,98,.510,34,62,.548,16,36,.444,14,18,.778,130,33,86,.384,25,59,.424,8,27,.296,25,31,.806,99
263,ORL,2022-11-03,130,,GSW,W 130-129,240,42,78,.538,29,48,.604,13,30,.433,33,46,.717,130,50,97,.515,31,54,.574,19,43,.442,10,15,.667,129
264,GSW,2022-10-23,130,,SAC,W 130-125,240,45,87,.517,31,54,.574,14,33,.424,26,36,.722,130,47,100,.470,36,57,.632,11,43,.256,20,25,.800,125
265,NYK,2022-10-21,130,,DET,W 130-106,240,50,95,.526,34,57,.596,16,38,.421,14,22,.636,130,39,90,.433,30,54,.556,9,36,.250,19,32,.594,106
266,NOP,2022-10-19,130,@,BRK,W 130-108,240,50,102,.490,38,76,.500,12,26,.462,18,25,.720,130,40,89,.449,30,56,.536,10,33,.303,18,24,.750,108
267,SAS,2023-04-06,129,,POR,W 129-127,240,47,106,.443,37,71,.521,10,35,.286,25,28,.893,129,51,96,.531,41,68,.603,10,28,.357,15,18,.833,127
268,MIA,2023-04-06,129,@,PHI,W 129-101,240,49,88,.557,31,49,.633,18,39,.462,13,15,.867,129,39,76,.513,29,40,.725,10,36,.278,13,15,.867,101
269,IND,2023-04-05,129,,NYK,L 129-138,240,45,87,.517,30,57,.526,15,30,.500,24,30,.800,129,52,100,.520,34,54,.630,18,46,.391,16,25,.640,138
270,MIA,2023-04-01,129,,DAL,W 129-122,240,45,86,.523,32,49,.653,13,37,.351,26,29,.897,129,47,77,.610,33,43,.767,14,34,.412,14,16,.875,122
271,DEN,2023-03-25,129,,MIL,W 129-106,240,47,89,.528,32,53,.604,15,36,.417,20,28,.714,129,39,88,.443,30,52,.577,9,36,.250,19,21,.905,106
272,BRK,2023-03-25,129,@,MIA,W 129-100,240,44,89,.494,26,49,.531,18,40,.450,23,25,.920,129,38,80,.475,26,50,.520,12,30,.400,12,14,.857,100
273,ATL,2023-03-21,129,,DET,W 129-107,240,44,95,.463,30,57,.526,14,38,.368,27,36,.750,129,37,91,.407,24,51,.471,13,40,.325,20,24,.833,107
274,OKC,2023-03-05,129,,UTA,W 129-119,240,44,87,.506,30,50,.600,14,37,.378,27,33,.818,129,43,88,.489,32,51,.627,11,37,.297,22,27,.815,119
275,BOS,2023-03-05,129,,NYK,L 129-131 (2OT),290,43,109,.394,22,50,.440,21,59,.356,22,25,.880,129,47,95,.495,32,54,.593,15,41,.366,22,32,.688,131
276,MEM,2023-03-05,129,@,LAC,L 129-135,240,50,92,.543,32,58,.552,18,34,.529,11,15,.733,129,45,85,.529,33,56,.589,12,29,.414,33,35,.943,135
277,ATL,2023-03-03,129,,POR,W 129-111,240,52,91,.571,40,65,.615,12,26,.462,13,16,.813,129,41,87,.471,28,48,.583,13,39,.333,16,20,.800,111
278,ATL,2023-02-26,129,,BRK,W 129-127,240,45,90,.500,29,60,.483,16,30,.533,23,28,.821,129,43,87,.494,29,48,.604,14,39,.359,27,29,.931,127
279,POR,2023-02-10,129,,OKC,L 129-138,240,42,76,.553,26,36,.722,16,40,.400,29,31,.935,129,47,83,.566,35,59,.593,12,24,.500,32,35,.914,138
280,CHI,2023-02-04,129,,POR,W 129-121,240,48,80,.600,36,54,.667,12,26,.462,21,25,.840,129,44,87,.506,30,44,.682,14,43,.326,19,21,.905,121
281,LAL,2023-01-31,129,@,NYK,W 129-123 (OT),265,48,93,.516,37,60,.617,11,33,.333,22,31,.710,129,44,98,.449,37,64,.578,7,34,.206,28,32,.875,123
282,POR,2023-01-30,129,,ATL,W 129-125,240,43,79,.544,24,39,.615,19,40,.475,24,27,.889,129,44,94,.468,31,64,.484,13,30,.433,24,30,.800,125
283,GSW,2023-01-27,129,,TOR,W 129-117,240,50,90,.556,32,47,.681,18,43,.419,11,15,.733,129,46,101,.455,34,68,.500,12,33,.364,13,21,.619,117
284,PHI,2023-01-21,129,@,SAC,W 129-127,240,49,93,.527,37,65,.569,12,28,.429,19,23,.826,129,46,84,.548,33,51,.647,13,33,.394,22,29,.759,127
285,SAS,2023-01-11,129,@,MEM,L 129-135,240,50,107,.467,39,73,.534,11,34,.324,18,23,.783,129,52,101,.515,38,79,.481,14,22,.636,17,25,.680,135
286,PHI,2023-01-04,129,,IND,W 129-126 (OT),265,48,98,.490,34,62,.548,14,36,.389,19,22,.864,129,45,95,.474,32,59,.542,13,36,.361,23,26,.885,126
287,DAL,2022-12-29,129,,HOU,W 129-114,240,47,91,.516,29,46,.630,18,45,.400,17,25,.680,129,38,86,.442,26,52,.500,12,34,.353,26,37,.703,114
288,IND,2022-12-27,129,,ATL,W 129-114,240,47,92,.511,34,57,.596,13,35,.371,22,27,.815,129,40,89,.449,28,59,.475,12,30,.400,22,29,.759,114
289,LAL,2022-12-27,129,@,ORL,W 129-110,240,49,90,.544,32,47,.681,17,43,.395,14,17,.824,129,42,84,.500,32,56,.571,10,28,.357,16,25,.640,110
290,NOP,2022-12-15,129,@,UTA,L 129-132 (OT),265,47,99,.475,35,69,.507,12,30,.400,23,28,.821,129,42,92,.457,24,45,.533,18,47,.383,30,37,.811,132
291,NOP,2022-12-11,129,,PHO,W 129-124 (OT),265,50,86,.581,42,61,.689,8,25,.320,21,28,.750,129,49,105,.467,36,67,.537,13,38,.342,13,17,.765,124
292,MIL,2022-12-02,129,,LAL,L 129-133,240,50,94,.532,33,51,.647,17,43,.395,12,15,.800,129,52,96,.542,41,70,.586,11,26,.423,18,24,.750,133
293,DEN,2022-11-28,129,,HOU,W 129-113,240,50,88,.568,38,58,.655,12,30,.400,17,20,.850,129,39,85,.459,23,41,.561,16,44,.364,19,25,.760,113
294,NYK,2022-11-25,129,,POR,L 129-132 (OT),265,46,105,.438,33,64,.516,13,41,.317,24,28,.857,129,42,85,.494,32,53,.604,10,32,.313,38,51,.745,132
295,GSW,2022-11-25,129,,UTA,W 129-118,240,52,101,.515,32,56,.571,20,45,.444,5,6,.833,129,46,97,.474,35,52,.673,11,45,.244,15,17,.882,118
296,NOP,2022-11-23,129,@,SAS,W 129-110,240,47,82,.573,33,49,.673,14,33,.424,21,30,.700,129,41,85,.482,31,51,.608,10,34,.294,18,28,.643,110
297,NYK,2022-11-21,129,@,OKC,W 129-119,240,51,97,.526,40,63,.635,11,34,.324,16,20,.800,129,43,88,.489,35,64,.547,8,24,.333,25,32,.781,119
298,DET,2022-11-20,129,@,SAC,L 129-137,240,47,89,.528,32,60,.533,15,29,.517,20,23,.870,129,47,85,.553,35,50,.700,12,35,.343,31,35,.886,137
299,MIN,2022-11-13,129,@,CLE,W 129-124,240,46,82,.561,34,58,.586,12,24,.500,25,34,.735,129,40,89,.449,23,55,.418,17,34,.500,27,39,.692,124
300,PHO,2022-11-09,129,@,MIN,W 129-117,240,47,97,.485,31,62,.500,16,35,.457,19,20,.950,129,41,78,.526,32,51,.627,9,27,.333,26,32,.813,117
301,IND,2022-11-07,129,,NOP,W 129-122,240,43,86,.500,21,38,.553,22,48,.458,21,23,.913,129,48,97,.495,34,63,.540,14,34,.412,12,17,.706,122
302,MIN,2022-11-05,129,,HOU,W 129-117,240,49,80,.613,34,47,.723,15,33,.455,16,20,.800,129,40,84,.476,24,46,.522,16,38,.421,21,31,.677,117
303,GSW,2022-11-03,129,@,ORL,L 129-130,240,50,97,.515,31,54,.574,19,43,.442,10,15,.667,129,42,78,.538,29,48,.604,13,30,.433,33,46,.717,130
304,SAS,2022-10-28,129,,CHI,W 129-124,240,46,86,.535,30,48,.625,16,38,.421,21,26,.808,129,47,99,.475,38,72,.528,9,27,.333,21,26,.808,124
305,DAL,2022-10-27,129,@,BRK,W 129-125 (OT),265,41,81,.506,21,41,.512,20,40,.500,27,35,.771,129,43,93,.462,31,58,.534,12,35,.343,27,30,.900,125
306,MEM,2022-10-21,129,@,HOU,W 129-122,240,45,98,.459,26,56,.464,19,42,.452,20,29,.690,129,44,93,.473,28,58,.483,16,35,.457,18,30,.600,122
307,CHO,2022-10-19,129,@,SAS,W 129-102,240,48,94,.511,35,65,.538,13,29,.448,20,23,.870,129,40,99,.404,33,65,.508,7,34,.206,15,21,.714,102
308,LAL,2023-04-09,128,,UTA,W 128-117,240,47,97,.485,29,52,.558,18,45,.400,16,21,.762,128,51,101,.505,41,66,.621,10,35,.286,5,6,.833,117
309,WAS,2023-04-04,128,,MIL,L 128-140,240,50,99,.505,37,72,.514,13,27,.481,15,21,.714,128,50,92,.543,27,50,.540,23,42,.548,17,29,.586,140
310,PHO,2023-04-02,128,@,OKC,W 128-118,240,46,81,.568,33,47,.702,13,34,.382,23,28,.821,128,36,88,.409,25,56,.446,11,32,.344,35,41,.854,118
311,TOR,2023-04-02,128,@,CHO,W 128-108,240,56,104,.538,48,76,.632,8,28,.286,8,8,1.000,128,42,85,.494,27,54,.500,15,31,.484,9,13,.692,108
312,CHI,2023-04-02,128,,MEM,W 128-107,240,50,94,.532,41,63,.651,9,31,.290,19,22,.864,128,39,84,.464,20,41,.488,19,43,.442,10,12,.833,107
313,ORL,2023-04-02,128,,DET,W 128-102,240,43,75,.573,26,42,.619,17,33,.515,25,40,.625,128,32,78,.410,23,45,.511,9,33,.273,29,36,.806,102
314,UTA,2023-03-29,128,@,SAS,W 128-117,240,49,90,.544,37,59,.627,12,31,.387,18,20,.900,128,45,95,.474,35,60,.583,10,35,.286,17,21,.810,117
315,UTA,2023-03-20,128,,SAC,W 128-120,240,46,88,.523,30,52,.577,16,36,.444,20,23,.870,128,41,97,.423,22,45,.489,19,52,.365,19,25,.760,120
316,TOR,2023-03-16,128,,OKC,W 128-111,240,47,97,.485,33,65,.508,14,32,.438,20,28,.714,128,40,94,.426,27,63,.429,13,31,.419,18,20,.900,111
317,SAS,2023-03-15,128,,DAL,L 128-137 (OT),265,49,107,.458,34,73,.466,15,34,.441,15,26,.577,128,44,86,.512,27,53,.509,17,33,.515,32,37,.865,137
318,SAC,2023-03-11,128,@,PHO,W 128-119,240,41,85,.482,26,50,.520,15,35,.429,31,37,.838,128,44,89,.494,31,45,.689,13,44,.295,18,22,.818,119
319,SAS,2023-03-10,128,,DEN,W 128-120,240,51,94,.543,38,61,.623,13,33,.394,13,17,.765,128,44,90,.489,31,55,.564,13,35,.371,19,20,.950,120
320,GSW,2023-03-07,128,@,OKC,L 128-137,240,47,89,.528,27,38,.711,20,51,.392,14,16,.875,128,50,94,.532,33,57,.579,17,37,.459,20,24,.833,137
321,ATL,2023-03-06,128,@,MIA,L 128-130,240,51,92,.554,42,63,.667,9,29,.310,17,23,.739,128,41,77,.532,25,48,.521,16,29,.552,32,37,.865,130
322,SAC,2023-03-03,128,,LAC,W 128-127,240,46,87,.529,36,54,.667,10,33,.303,26,26,1.000,128,47,87,.540,33,46,.717,14,41,.341,19,27,.704,127
323,NYK,2023-02-25,128,,NOP,W 128-106,240,45,88,.511,26,40,.650,19,48,.396,19,23,.826,128,40,102,.392,32,64,.500,8,38,.211,18,21,.857,106
324,MIL,2023-02-24,128,,MIA,W 128-99,240,47,98,.480,28,52,.538,19,46,.413,15,19,.789,128,36,92,.391,27,52,.519,9,40,.225,18,25,.720,99
325,DAL,2023-02-11,128,@,SAC,L 128-133 (OT),265,47,91,.516,27,40,.675,20,51,.392,14,19,.737,128,51,100,.510,43,68,.632,8,32,.250,23,25,.920,133
326,MEM,2023-02-10,128,,MIN,W 128-107,240,49,84,.583,39,59,.661,10,25,.400,20,27,.741,128,41,88,.466,26,51,.510,15,37,.405,10,12,.833,107
327,HOU,2023-02-08,128,,SAC,L 128-130,240,47,86,.547,37,64,.578,10,22,.455,24,28,.857,128,46,92,.500,36,62,.581,10,30,.333,28,30,.933,130
328,CHI,2023-02-06,128,,SAS,W 128-104,240,50,89,.562,44,67,.657,6,22,.273,22,25,.880,128,40,90,.444,32,64,.500,8,26,.308,16,17,.941,104
329,MIN,2023-02-05,128,,DEN,W 128-98,240,48,87,.552,38,60,.633,10,27,.370,22,30,.733,128,34,71,.479,28,46,.609,6,25,.240,24,31,.774,98
330,DEN,2023-02-04,128,,ATL,W 128-108,240,48,95,.505,33,57,.579,15,38,.395,17,20,.850,128,44,91,.484,38,71,.535,6,20,.300,14,17,.824,108
331,NYK,2023-02-04,128,,LAC,L 128-134 (OT),265,45,94,.479,27,54,.500,18,40,.450,20,26,.769,128,44,92,.478,28,55,.509,16,37,.432,30,35,.857,134
332,CLE,2023-02-02,128,,MEM,W 128-113,240,49,91,.538,35,62,.565,14,29,.483,16,22,.727,128,41,87,.471,31,64,.484,10,23,.435,21,22,.955,113
333,TOR,2023-02-01,128,@,UTA,L 128-131,240,50,110,.455,40,87,.460,10,23,.435,18,26,.692,128,44,83,.530,27,36,.750,17,47,.362,26,30,.867,131
334,GSW,2023-01-30,128,@,OKC,W 128-120,240,46,90,.511,26,43,.605,20,47,.426,16,20,.800,128,46,93,.495,35,69,.507,11,24,.458,17,20,.850,120
335,CHI,2023-01-28,128,@,ORL,W 128-109,240,48,81,.593,32,46,.696,16,35,.457,16,19,.842,128,41,83,.494,31,55,.564,10,28,.357,17,24,.708,109
336,PHO,2023-01-28,128,@,SAS,W 128-118 (OT),265,50,103,.485,42,79,.532,8,24,.333,20,26,.769,128,48,109,.440,38,80,.475,10,29,.345,12,17,.706,118
337,PHO,2023-01-24,128,,CHO,W 128-97,240,47,94,.500,25,55,.455,22,39,.564,12,13,.923,128,39,96,.406,33,71,.465,6,25,.240,13,18,.722,97
338,MIN,2023-01-19,128,,TOR,W 128-126,240,45,89,.506,28,49,.571,17,40,.425,21,23,.913,128,46,87,.529,32,59,.542,14,28,.500,20,27,.741,126
339,MIN,2023-01-06,128,,LAC,W 128-115,240,46,81,.568,33,46,.717,13,35,.371,23,29,.793,128,44,100,.440,35,75,.467,9,25,.360,18,27,.667,115
340,DEN,2022-12-25,128,,PHO,W 128-125 (OT),265,45,94,.479,32,58,.552,13,36,.361,25,34,.735,128,45,94,.479,28,59,.475,17,35,.486,18,26,.692,125
341,NOP,2022-12-23,128,@,OKC,W 128-125 (OT),265,41,94,.436,28,57,.491,13,37,.351,33,40,.825,128,47,102,.461,34,67,.507,13,35,.371,18,25,.720,125
342,MIL,2022-12-19,128,@,NOP,W 128-119,240,45,81,.556,32,41,.780,13,40,.325,25,31,.806,128,42,99,.424,24,54,.444,18,45,.400,17,24,.708,119
343,POR,2022-12-14,128,@,SAS,W 128-112,240,49,81,.605,31,41,.756,18,40,.450,12,17,.706,128,45,97,.464,34,68,.500,11,29,.379,11,19,.579,112
344,NYK,2022-12-14,128,@,CHI,W 128-120 (OT),265,45,91,.495,27,57,.474,18,34,.529,20,25,.800,128,46,84,.548,37,56,.661,9,28,.321,19,22,.864,120
345,WAS,2022-12-14,128,@,DEN,L 128-141,240,48,91,.527,29,52,.558,19,39,.487,13,23,.565,128,54,83,.651,50,67,.746,4,16,.250,29,35,.829,141
346,MIL,2022-12-13,128,,GSW,W 128-111,240,45,82,.549,33,53,.623,12,29,.414,26,32,.813,128,38,95,.400,18,45,.400,20,50,.400,15,19,.789,111
347,MEM,2022-12-12,128,,ATL,W 128-103,240,50,83,.602,37,51,.725,13,32,.406,15,18,.833,128,37,104,.356,25,67,.373,12,37,.324,17,22,.773,103
348,NOP,2022-12-09,128,,PHO,W 128-117,240,46,90,.511,38,63,.603,8,27,.296,28,35,.800,128,43,86,.500,21,42,.500,22,44,.500,9,13,.692,117
349,MIN,2022-12-03,128,,OKC,L 128-135,240,47,89,.528,37,59,.627,10,30,.333,24,30,.800,128,48,93,.516,37,67,.552,11,26,.423,28,35,.800,135
350,LAL,2022-11-30,128,,POR,W 128-109,240,48,97,.495,34,60,.567,14,37,.378,18,26,.692,128,42,90,.467,34,66,.515,8,24,.333,17,21,.810,109
351,IND,2022-11-25,128,,BRK,W 128-117,240,43,86,.500,31,52,.596,12,34,.353,30,38,.789,128,47,88,.534,32,47,.681,15,41,.366,8,10,.800,117
352,HOU,2022-11-25,128,,ATL,W 128-122,240,41,87,.471,29,52,.558,12,35,.343,34,41,.829,128,39,82,.476,24,43,.558,15,39,.385,29,36,.806,122
353,NOP,2022-11-21,128,,GSW,W 128-83,240,49,91,.538,34,49,.694,15,42,.357,15,21,.714,128,28,74,.378,18,31,.581,10,43,.233,17,19,.895,83
354,LAL,2022-11-18,128,,DET,W 128-121,240,43,78,.551,36,58,.621,7,20,.350,35,40,.875,128,43,92,.467,32,58,.552,11,34,.324,24,32,.750,121
355,BOS,2022-11-09,128,,DET,W 128-112,240,47,88,.534,29,42,.690,18,46,.391,16,21,.762,128,37,89,.416,30,56,.536,7,33,.212,31,40,.775,112
356,BRK,2022-11-04,128,@,WAS,W 128-86,240,50,90,.556,36,62,.581,14,28,.500,14,14,1.000,128,30,83,.361,22,49,.449,8,34,.235,18,22,.818,86
357,DET,2022-10-30,128,,GSW,W 128-114,240,40,83,.482,26,50,.520,14,33,.424,34,38,.895,128,39,92,.424,27,53,.509,12,39,.308,24,25,.960,114
358,CLE,2022-10-22,128,@,CHI,W 128-96,240,48,85,.565,32,58,.552,16,27,.593,16,18,.889,128,34,84,.405,27,55,.491,7,29,.241,21,25,.840,96
359,DEN,2022-10-21,128,@,GSW,W 128-123,240,46,86,.535,31,52,.596,15,34,.441,21,25,.840,128,42,88,.477,27,44,.614,15,44,.341,24,27,.889,123
360,POR,2023-04-06,127,@,SAS,L 127-129,240,51,96,.531,41,68,.603,10,28,.357,15,18,.833,127,47,106,.443,37,71,.521,10,35,.286,25,28,.893,129
361,DAL,2023-03-27,127,@,IND,W 127-104,240,47,83,.566,29,46,.630,18,37,.486,15,17,.882,127,39,93,.419,31,65,.477,8,28,.286,18,23,.783,104
362,PHO,2023-03-24,127,@,SAC,L 127-135,240,48,89,.539,39,60,.650,9,29,.310,22,29,.759,127,47,89,.528,34,50,.680,13,39,.333,28,32,.875,135
363,LAC,2023-03-23,127,,OKC,W 127-105,240,47,84,.560,29,47,.617,18,37,.486,15,20,.750,127,41,93,.441,28,54,.519,13,39,.333,10,11,.909,105
364,GSW,2023-03-22,127,@,DAL,W 127-125,240,50,90,.556,38,51,.745,12,39,.308,15,18,.833,127,44,89,.494,27,49,.551,17,40,.425,20,28,.714,125
365,MIA,2023-03-22,127,,NYK,W 127-120,240,45,79,.570,29,51,.569,16,28,.571,21,26,.808,127,42,82,.512,26,42,.619,16,40,.400,20,25,.800,120
366,POR,2023-03-22,127,@,UTA,W 127-115,240,45,93,.484,32,52,.615,13,41,.317,24,30,.800,127,39,82,.476,28,47,.596,11,35,.314,26,36,.722,115
367,ATL,2023-03-17,127,,GSW,W 127-119,240,47,100,.470,31,59,.525,16,41,.390,17,25,.680,127,47,98,.480,36,58,.621,11,40,.275,14,20,.700,119
368,NOP,2023-03-12,127,,POR,W 127-110,240,43,86,.500,24,46,.522,19,40,.475,22,29,.759,127,43,88,.489,33,55,.600,10,33,.303,14,20,.700,110
369,LAC,2023-03-03,127,@,SAC,L 127-128,240,47,87,.540,33,46,.717,14,41,.341,19,27,.704,127,46,87,.529,36,54,.667,10,33,.303,26,26,1.000,128
370,BRK,2023-02-26,127,@,ATL,L 127-129,240,43,87,.494,29,48,.604,14,39,.359,27,29,.931,127,45,90,.500,29,60,.483,16,30,.533,23,28,.821,129
371,BOS,2023-02-15,127,,DET,W 127-109,240,49,92,.533,28,47,.596,21,45,.467,8,10,.800,127,43,84,.512,32,55,.582,11,29,.379,12,16,.750,109
372,POR,2023-02-13,127,,LAL,W 127-115,240,46,97,.474,23,50,.460,23,47,.489,12,13,.923,127,42,95,.442,30,58,.517,12,37,.324,19,21,.905,115
373,WAS,2023-02-11,127,,IND,W 127-113,240,48,75,.640,36,49,.735,12,26,.462,19,22,.864,127,43,95,.453,29,55,.527,14,40,.350,13,17,.765,113
374,BOS,2023-02-10,127,,CHO,W 127-116,240,44,89,.494,19,34,.559,25,55,.455,14,17,.824,127,45,93,.484,37,70,.529,8,23,.348,18,26,.692,116
375,MIL,2023-02-06,127,@,POR,W 127-108,240,47,87,.540,31,45,.689,16,42,.381,17,21,.810,127,37,91,.407,28,55,.509,9,36,.250,25,29,.862,108
376,ORL,2023-02-03,127,@,MIN,W 127-120,240,45,85,.529,33,62,.532,12,23,.522,25,38,.658,127,40,87,.460,24,43,.558,16,44,.364,24,28,.857,120
377,WAS,2023-01-30,127,@,SAS,W 127-106,240,48,86,.558,32,56,.571,16,30,.533,15,17,.882,127,42,97,.433,35,68,.515,7,29,.241,15,23,.652,106
378,WAS,2023-01-24,127,@,DAL,W 127-126,240,42,83,.506,31,53,.585,11,30,.367,32,41,.780,127,47,89,.528,37,59,.627,10,30,.333,22,26,.846,126
379,SAS,2023-01-23,127,@,POR,L 127-147,240,47,90,.522,34,63,.540,13,27,.481,20,26,.769,127,55,92,.598,35,59,.593,20,33,.606,17,22,.773,147
380,SAC,2023-01-21,127,,PHI,L 127-129,240,46,84,.548,33,51,.647,13,33,.394,22,29,.759,127,49,93,.527,37,65,.569,12,28,.429,19,23,.826,129
381,GSW,2023-01-16,127,@,WAS,W 127-118,240,45,91,.495,27,47,.574,18,44,.409,19,21,.905,127,42,86,.488,28,51,.549,14,35,.400,20,23,.870,118
382,DAL,2023-01-07,127,,NOP,W 127-117,240,42,74,.568,29,45,.644,13,29,.448,30,38,.789,127,45,94,.479,40,65,.615,5,29,.172,22,35,.629,117
383,OKC,2023-01-06,127,,WAS,W 127-110,240,50,98,.510,33,61,.541,17,37,.459,10,14,.714,127,38,79,.481,31,55,.564,7,24,.292,27,36,.750,110
384,NOP,2022-12-30,127,,PHI,W 127-116,240,43,80,.538,28,49,.571,15,31,.484,26,36,.722,127,42,75,.560,28,41,.683,14,34,.412,18,22,.818,116
385,SAC,2022-12-28,127,,DEN,W 127-126,240,47,89,.528,33,58,.569,14,31,.452,19,25,.760,127,49,85,.576,37,58,.638,12,27,.444,16,18,.889,126
386,WAS,2022-12-28,127,,PHO,W 127-102,240,47,82,.573,39,56,.696,8,26,.308,25,28,.893,127,39,87,.448,26,56,.464,13,31,.419,11,16,.688,102
387,MIN,2022-11-28,127,@,WAS,L 127-142,240,42,84,.500,35,57,.614,7,27,.259,36,42,.857,127,52,91,.571,37,60,.617,15,31,.484,23,27,.852,142
388,MEM,2022-11-27,127,@,NYK,W 127-123,240,46,95,.484,34,63,.540,12,32,.375,23,31,.742,127,44,87,.506,34,57,.596,10,30,.333,25,30,.833,123
389,BRK,2022-11-20,127,,MEM,W 127-115,240,50,83,.602,34,49,.694,16,34,.471,11,15,.733,127,43,99,.434,31,62,.500,12,37,.324,17,31,.548,115
390,GSW,2022-11-20,127,@,HOU,W 127-120,240,46,86,.535,22,39,.564,24,47,.511,11,15,.733,127,41,90,.456,26,45,.578,15,45,.333,23,27,.852,120
391,DAL,2022-11-18,127,,DEN,W 127-99,240,46,77,.597,33,45,.733,13,32,.406,22,28,.786,127,38,90,.422,28,60,.467,10,30,.333,13,18,.722,99
392,SAC,2022-11-09,127,,CLE,W 127-120,240,40,76,.526,23,37,.622,17,39,.436,30,35,.857,127,46,86,.535,35,60,.583,11,26,.423,17,20,.850,120
393,ORL,2022-11-07,127,,HOU,L 127-134,240,45,82,.549,33,57,.579,12,25,.480,25,31,.806,127,46,87,.529,22,39,.564,24,48,.500,18,25,.720,134
394,IND,2022-10-28,127,@,WAS,W 127-117,240,41,81,.506,26,52,.500,15,29,.517,30,33,.909,127,41,86,.477,29,56,.518,12,30,.400,23,28,.821,117
395,MIL,2023-03-27,126,@,DET,W 126-117,240,45,95,.474,31,50,.620,14,45,.311,22,26,.846,126,41,92,.446,34,68,.500,7,24,.292,28,36,.778,117
396,SAS,2023-03-19,126,,ATL,W 126-118,240,51,94,.543,37,66,.561,14,28,.500,10,16,.625,126,48,101,.475,43,79,.544,5,22,.227,17,20,.850,118
397,MEM,2023-03-17,126,@,SAS,W 126-120 (OT),265,49,101,.485,35,63,.556,14,38,.368,14,21,.667,126,39,98,.398,19,46,.413,20,52,.385,22,29,.759,120
398,BOS,2023-03-17,126,@,POR,W 126-112,240,41,87,.471,26,45,.578,15,42,.357,29,35,.829,126,38,79,.481,24,41,.585,14,38,.368,22,31,.710,112
399,GSW,2023-03-15,126,@,LAC,L 126-134,240,49,88,.557,32,52,.615,17,36,.472,11,15,.733,126,46,96,.479,30,62,.484,16,34,.471,26,32,.813,134
400,ORL,2023-03-11,126,,MIA,W 126-114 (OT),265,48,99,.485,35,62,.565,13,37,.351,17,20,.850,126,42,94,.447,31,57,.544,11,37,.297,19,20,.950,114
401,DAL,2023-03-05,126,,PHO,L 126-130,240,38,77,.494,23,39,.590,15,38,.395,35,38,.921,126,49,89,.551,37,55,.673,12,34,.353,20,25,.800,130
402,PHI,2023-03-02,126,@,DAL,L 126-133,240,45,78,.577,33,51,.647,12,27,.444,24,29,.828,126,45,82,.549,20,34,.588,25,48,.521,18,27,.667,133
403,WAS,2023-02-14,126,@,POR,W 126-101,240,45,79,.570,28,46,.609,17,33,.515,19,22,.864,126,36,86,.419,24,44,.545,12,42,.286,17,24,.708,101
404,WAS,2023-02-13,126,@,GSW,L 126-135,240,48,80,.600,36,52,.692,12,28,.429,18,21,.857,126,52,89,.584,32,49,.653,20,40,.500,11,15,.733,135
405,NYK,2023-02-11,126,,UTA,W 126-120,240,43,95,.453,31,59,.525,12,36,.333,28,38,.737,126,45,88,.511,36,56,.643,9,32,.281,21,28,.750,120
406,LAL,2023-02-04,126,@,NOP,L 126-131,240,45,94,.479,34,62,.548,11,32,.344,25,33,.758,126,52,100,.520,43,70,.614,9,30,.300,18,20,.900,131
407,PHI,2023-01-28,126,,DEN,W 126-119,240,46,89,.517,28,54,.519,18,35,.514,16,24,.667,126,44,81,.543,30,47,.638,14,34,.412,17,20,.850,119
408,ORL,2023-01-25,126,,IND,W 126-120,240,46,82,.561,31,54,.574,15,28,.536,19,25,.760,126,41,85,.482,26,50,.520,15,35,.429,23,29,.793,120
409,DAL,2023-01-24,126,,WAS,L 126-127,240,47,89,.528,37,59,.627,10,30,.333,22,26,.846,126,42,83,.506,31,53,.585,11,30,.367,32,41,.780,127
410,SAS,2023-01-20,126,,LAC,L 126-131,240,51,89,.573,37,63,.587,14,26,.538,10,14,.714,126,51,81,.630,36,53,.679,15,28,.536,14,20,.700,131
411,CHI,2023-01-19,126,@,DET,W 126-108,240,50,92,.543,43,69,.623,7,23,.304,19,21,.905,126,39,97,.402,31,63,.492,8,34,.235,22,27,.815,108
412,TOR,2023-01-19,126,@,MIN,L 126-128,240,46,87,.529,32,59,.542,14,28,.500,20,27,.741,126,45,89,.506,28,49,.571,17,40,.425,21,23,.913,128
413,OKC,2023-01-18,126,,IND,W 126-106,240,47,93,.505,31,55,.564,16,38,.421,16,21,.762,126,39,94,.415,27,61,.443,12,33,.364,16,24,.667,106
414,UTA,2023-01-18,126,,LAC,W 126-103,240,45,87,.517,26,55,.473,19,32,.594,17,22,.773,126,37,92,.402,22,58,.379,15,34,.441,14,21,.667,103
415,UTA,2023-01-16,126,@,MIN,W 126-125,240,45,84,.536,32,50,.640,13,34,.382,23,28,.821,126,46,101,.455,28,60,.467,18,41,.439,15,18,.833,125
416,DEN,2023-01-11,126,,PHO,W 126-97,240,48,85,.565,33,51,.647,15,34,.441,15,21,.714,126,39,90,.433,30,58,.517,9,32,.281,10,14,.714,97
417,CHI,2023-01-07,126,,UTA,W 126-118,240,44,83,.530,31,55,.564,13,28,.464,25,32,.781,126,46,93,.495,34,52,.654,12,41,.293,14,18,.778,118
418,CHI,2023-01-06,126,@,PHI,W 126-112,240,48,84,.571,28,50,.560,20,34,.588,10,17,.588,126,40,92,.435,22,51,.431,18,41,.439,14,18,.778,112
419,IND,2023-01-04,126,@,PHI,L 126-129 (OT),265,45,95,.474,32,59,.542,13,36,.361,23,26,.885,126,48,98,.490,34,62,.548,14,36,.389,19,22,.864,129
420,ORL,2023-01-04,126,,OKC,W 126-115,240,42,81,.519,29,48,.604,13,33,.394,29,36,.806,126,36,89,.404,21,52,.404,15,37,.405,28,31,.903,115
421,DAL,2022-12-31,126,@,SAS,W 126-125,240,50,86,.581,36,52,.692,14,34,.412,12,21,.571,126,47,85,.553,39,66,.591,8,19,.421,23,32,.719,125
422,MIA,2022-12-31,126,@,UTA,W 126-123,240,45,89,.506,32,50,.640,13,39,.333,23,30,.767,126,35,81,.432,18,41,.439,17,40,.425,36,44,.818,123
423,SAC,2022-12-30,126,,UTA,W 126-125,240,50,90,.556,38,60,.633,12,30,.400,14,19,.737,126,46,84,.548,38,52,.731,8,32,.250,25,30,.833,125
424,CLE,2022-12-29,126,@,IND,L 126-135,240,50,96,.521,38,68,.559,12,28,.429,14,20,.700,126,48,85,.565,29,54,.537,19,31,.613,20,21,.952,135
425,DEN,2022-12-28,126,@,SAC,L 126-127,240,49,85,.576,37,58,.638,12,27,.444,16,18,.889,126,47,89,.528,33,58,.569,14,31,.452,19,25,.760,127
426,DAL,2022-12-27,126,,NYK,W 126-121 (OT),265,44,90,.489,31,44,.705,13,46,.283,25,33,.758,126,45,103,.437,29,53,.547,16,50,.320,15,24,.625,121
427,BOS,2022-12-27,126,,HOU,W 126-102,240,43,91,.473,23,35,.657,20,56,.357,20,23,.870,126,38,95,.400,24,50,.480,14,45,.311,12,14,.857,102
428,SAS,2022-12-26,126,,UTA,W 126-122,240,48,87,.552,42,69,.609,6,18,.333,24,34,.706,126,39,97,.402,26,54,.481,13,43,.302,31,37,.838,122
429,NOP,2022-12-22,126,,SAS,W 126-117,240,44,91,.484,31,57,.544,13,34,.382,25,27,.926,126,43,90,.478,34,62,.548,9,28,.321,22,27,.815,117
430,LAC,2022-12-21,126,,CHO,W 126-105,240,41,81,.506,18,32,.563,23,49,.469,21,23,.913,126,37,92,.402,28,61,.459,9,31,.290,22,29,.759,105
431,UTA,2022-12-20,126,@,DET,W 126-111,240,47,93,.505,27,47,.574,20,46,.435,12,19,.632,126,41,81,.506,32,56,.571,9,25,.360,20,27,.741,111
432,ATL,2022-12-19,126,,ORL,W 126-125,240,48,94,.511,36,62,.581,12,32,.375,18,20,.900,126,45,95,.474,33,61,.541,12,34,.353,23,25,.920,125
433,CHI,2022-12-18,126,@,MIN,L 126-150,240,46,88,.523,30,50,.600,16,38,.421,18,24,.750,126,57,87,.655,34,44,.773,23,43,.535,13,16,.813,150
434,GSW,2022-12-18,126,@,TOR,W 126-110,240,43,81,.531,25,42,.595,18,39,.462,22,26,.846,126,40,95,.421,27,62,.435,13,33,.394,17,22,.773,110
435,LAL,2022-12-16,126,,DEN,W 126-108,240,48,91,.527,36,58,.621,12,33,.364,18,24,.750,126,39,81,.481,30,54,.556,9,27,.333,21,28,.750,108
436,MIL,2022-12-07,126,,SAC,W 126-113,240,46,96,.479,32,63,.508,14,33,.424,20,24,.833,126,43,91,.473,31,53,.585,12,38,.316,15,16,.938,113
437,TOR,2022-12-07,126,,LAL,W 126-113,240,47,106,.443,35,63,.556,12,43,.279,20,24,.833,126,37,87,.425,30,54,.556,7,33,.212,32,35,.914,113
438,NOP,2022-11-30,126,,TOR,W 126-108,240,45,86,.523,31,53,.585,14,33,.424,22,26,.846,126,42,88,.477,31,50,.620,11,38,.289,13,19,.684,108
439,OKC,2022-11-23,126,,DEN,L 126-131 (OT),265,42,97,.433,24,57,.421,18,40,.450,24,28,.857,126,42,88,.477,28,50,.560,14,38,.368,33,41,.805,131
440,BOS,2022-11-16,126,@,ATL,W 126-101,240,48,88,.545,27,42,.643,21,46,.457,9,10,.900,126,42,101,.416,35,69,.507,7,32,.219,10,13,.769,101
441,MIN,2022-11-16,126,@,ORL,W 126-108,240,46,88,.523,34,52,.654,12,36,.333,22,28,.786,126,42,93,.452,33,58,.569,9,35,.257,15,17,.882,108
442,BOS,2022-11-14,126,,OKC,W 126-122,240,46,96,.479,36,59,.610,10,37,.270,24,29,.828,126,47,98,.480,36,68,.529,11,30,.367,17,21,.810,122
443,DEN,2022-11-13,126,@,CHI,W 126-103,240,48,80,.600,35,53,.660,13,27,.481,17,21,.810,126,40,81,.494,34,59,.576,6,22,.273,17,21,.810,103
444,SAC,2022-11-05,126,@,ORL,W 126-123 (OT),265,47,93,.505,32,53,.604,15,40,.375,17,26,.654,126,50,92,.543,46,69,.667,4,23,.174,19,20,.950,123
445,DEN,2022-11-05,126,,SAS,W 126-101,240,53,87,.609,38,58,.655,15,29,.517,5,10,.500,126,39,80,.488,27,50,.540,12,30,.400,11,19,.579,101
446,CHO,2022-10-23,126,@,ATL,W 126-109,240,47,90,.522,36,64,.563,11,26,.423,21,30,.700,126,39,95,.411,31,60,.517,8,35,.229,23,28,.821,109
447,BOS,2022-10-22,126,@,ORL,W 126-120,240,42,87,.483,23,40,.575,19,47,.404,23,28,.821,126,45,95,.474,30,61,.492,15,34,.441,15,23,.652,120
448,MIN,2022-10-21,126,,UTA,L 126-132 (OT),265,49,107,.458,38,74,.514,11,33,.333,17,23,.739,126,49,111,.441,29,61,.475,20,50,.400,14,21,.667,132
449,BOS,2022-10-18,126,,PHI,W 126-117,240,46,82,.561,34,47,.723,12,35,.343,22,28,.786,126,40,80,.500,27,46,.587,13,34,.382,24,28,.857,117
450,POR,2023-04-08,125,@,LAC,L 125-136,240,47,89,.528,33,57,.579,14,32,.438,17,23,.739,125,49,93,.527,37,58,.638,12,35,.343,26,30,.867,136
451,LAC,2023-04-05,125,,LAL,W 125-118,240,43,82,.524,27,46,.587,16,36,.444,23,27,.852,125,45,89,.506,33,60,.550,12,29,.414,16,24,.667,118
452,OKC,2023-04-04,125,@,GSW,L 125-136,240,44,93,.473,33,61,.541,11,32,.344,26,35,.743,125,47,95,.495,27,48,.563,20,47,.426,22,30,.733,136
453,PHO,2023-03-25,125,,PHI,W 125-105,240,47,93,.505,32,61,.525,15,32,.469,16,19,.842,125,34,78,.436,21,47,.447,13,31,.419,24,27,.889,105
454,MIN,2023-03-22,125,,ATL,W 125-124,240,45,92,.489,34,66,.515,11,26,.423,24,29,.828,125,45,85,.529,33,59,.559,12,26,.462,22,25,.880,124
455,DAL,2023-03-22,125,,GSW,L 125-127,240,44,89,.494,27,49,.551,17,40,.425,20,28,.714,125,50,90,.556,38,51,.745,12,39,.308,15,18,.833,127
456,HOU,2023-03-22,125,@,MEM,L 125-130,240,48,93,.516,36,60,.600,12,33,.364,17,23,.739,125,45,87,.517,33,51,.647,12,36,.333,28,33,.848,130
457,TOR,2023-03-14,125,,DEN,W 125-110,240,49,93,.527,37,63,.587,12,30,.400,15,17,.882,125,42,76,.553,36,51,.706,6,25,.240,20,25,.800,110
458,GSW,2023-03-11,125,,MIL,W 125-116 (OT),265,46,112,.411,23,57,.404,23,55,.418,10,11,.909,125,43,100,.430,22,49,.449,21,51,.412,9,11,.818,116
459,ATL,2023-03-11,125,,BOS,L 125-134,240,50,100,.500,40,66,.606,10,34,.294,15,16,.938,125,52,95,.547,32,53,.604,20,42,.476,10,12,.833,134
460,HOU,2023-03-09,125,@,IND,L 125-134 (OT),265,49,107,.458,43,90,.478,6,17,.353,21,29,.724,125,48,100,.480,30,55,.545,18,45,.400,20,21,.952,134
461,IND,2023-03-05,125,@,CHI,W 125-122,240,48,94,.511,32,50,.640,16,44,.364,13,16,.813,125,45,74,.608,35,52,.673,10,22,.455,22,25,.880,122
462,PHO,2023-03-03,125,@,CHI,W 125-104,240,42,84,.500,22,37,.595,20,47,.426,21,25,.840,125,39,83,.470,32,60,.533,7,23,.304,19,25,.760,104
463,BOS,2023-02-14,125,@,MIL,L 125-131 (OT),265,46,99,.465,29,49,.592,17,50,.340,16,20,.800,125,43,90,.478,25,48,.521,18,42,.429,27,35,.771,131
464,ATL,2023-02-11,125,,SAS,W 125-106,240,50,103,.485,40,77,.519,10,26,.385,15,19,.789,125,40,94,.426,29,57,.509,11,37,.297,15,17,.882,106
465,POR,2023-02-08,125,,GSW,W 125-122,240,43,78,.551,35,51,.686,8,27,.296,31,32,.969,125,46,97,.474,25,48,.521,21,49,.429,9,10,.900,122
466,BRK,2023-02-04,125,,WAS,W 125-123,240,43,86,.500,29,53,.547,14,33,.424,25,28,.893,125,39,81,.481,26,53,.491,13,28,.464,32,41,.780,123
467,SAS,2023-02-03,125,,PHI,L 125-137,240,52,89,.584,45,68,.662,7,21,.333,14,15,.933,125,46,87,.529,33,60,.550,13,27,.481,32,41,.780,137
468,ATL,2023-01-30,125,@,POR,L 125-129,240,44,94,.468,31,64,.484,13,30,.433,24,30,.800,125,43,79,.544,24,39,.615,19,40,.475,24,27,.889,129
469,BOS,2023-01-28,125,,LAL,W 125-121 (OT),265,39,84,.464,26,44,.591,13,40,.325,34,39,.872,125,47,105,.448,35,63,.556,12,42,.286,15,20,.750,121
470,TOR,2023-01-22,125,,NYK,W 125-116,240,41,90,.456,26,56,.464,15,34,.441,28,35,.800,125,40,82,.488,22,41,.537,18,41,.439,18,26,.692,116
471,MIN,2023-01-16,125,,UTA,L 125-126,240,46,101,.455,28,60,.467,18,41,.439,15,18,.833,125,45,84,.536,32,50,.640,13,34,.382,23,28,.821,126
472,BOS,2023-01-11,125,,NOP,W 125-114,240,44,91,.484,29,47,.617,15,44,.341,22,25,.880,125,45,87,.517,34,57,.596,11,30,.367,13,17,.765,114
473,PHO,2023-01-10,125,@,GSW,W 125-113,240,41,90,.456,27,59,.458,14,31,.452,29,31,.935,125,37,96,.385,19,48,.396,18,48,.375,21,27,.778,113
474,SAS,2022-12-31,125,,DAL,L 125-126,240,47,85,.553,39,66,.591,8,19,.421,23,32,.719,125,50,86,.581,36,52,.692,14,34,.412,12,21,.571,126
475,UTA,2022-12-30,125,@,SAC,L 125-126,240,46,84,.548,38,52,.731,8,32,.250,25,30,.833,125,50,90,.556,38,60,.633,12,30,.400,14,19,.737,126
476,PHO,2022-12-27,125,@,MEM,W 125-108,240,43,87,.494,26,56,.464,17,31,.548,22,25,.880,125,36,91,.396,28,61,.459,8,30,.267,28,34,.824,108
477,BRK,2022-12-26,125,@,CLE,W 125-117,240,47,82,.573,29,52,.558,18,30,.600,13,17,.765,125,39,82,.476,26,46,.565,13,36,.361,26,30,.867,117
478,PHO,2022-12-25,125,@,DEN,L 125-128 (OT),265,45,94,.479,28,59,.475,17,35,.486,18,26,.692,125,45,94,.479,32,58,.552,13,36,.361,25,34,.735,128
479,MEM,2022-12-23,125,@,PHO,W 125-100,240,45,91,.495,38,68,.559,7,23,.304,28,38,.737,125,38,87,.437,29,52,.558,9,35,.257,15,26,.577,100
480,WAS,2022-12-23,125,@,SAC,W 125-111,240,49,88,.557,39,56,.696,10,32,.313,17,24,.708,125,37,84,.440,27,52,.519,10,32,.313,27,35,.771,111
481,OKC,2022-12-23,125,,NOP,L 125-128 (OT),265,47,102,.461,34,67,.507,13,35,.371,18,25,.720,125,41,94,.436,28,57,.491,13,37,.351,33,40,.825,128
482,ORL,2022-12-19,125,@,ATL,L 125-126,240,45,95,.474,33,61,.541,12,34,.353,23,25,.920,125,48,94,.511,36,62,.581,12,32,.375,18,20,.900,126
483,CHO,2022-12-19,125,@,SAC,W 125-119,240,49,95,.516,39,64,.609,10,31,.323,17,23,.739,125,45,95,.474,33,62,.532,12,33,.364,17,31,.548,119
484,ATL,2022-12-16,125,@,CHO,W 125-106,240,41,75,.547,26,46,.565,15,29,.517,28,34,.824,125,39,98,.398,24,55,.436,15,43,.349,13,19,.684,106
485,IND,2022-12-14,125,,GSW,W 125-119,240,44,87,.506,28,48,.583,16,39,.410,21,25,.840,125,40,86,.465,26,53,.491,14,33,.424,25,29,.862,119
486,BOS,2022-12-07,125,@,PHO,W 125-98,240,49,101,.485,33,56,.589,16,45,.356,11,13,.846,125,37,93,.398,29,61,.475,8,32,.250,16,19,.842,98
487,DAL,2022-12-01,125,@,DET,L 125-131 (OT),265,46,86,.535,27,40,.675,19,46,.413,14,29,.483,125,51,94,.543,36,59,.610,15,35,.429,14,24,.583,131
488,ATL,2022-11-30,125,@,ORL,W 125-108,240,51,94,.543,43,62,.694,8,32,.250,15,19,.789,125,39,79,.494,31,52,.596,8,27,.296,22,25,.880,108
489,UTA,2022-11-30,125,,LAC,W 125-112,240,45,81,.556,31,49,.633,14,32,.438,21,28,.750,125,37,93,.398,27,63,.429,10,30,.333,28,36,.778,112
490,DET,2022-11-23,125,@,UTA,W 125-116,240,44,89,.494,32,65,.492,12,24,.500,25,27,.926,125,41,83,.494,23,42,.548,18,41,.439,16,19,.842,116
491,BOS,2022-11-23,125,,DAL,W 125-112,240,45,84,.536,28,50,.560,17,34,.500,18,21,.857,125,44,82,.537,33,51,.647,11,31,.355,13,21,.619,112
492,IND,2022-11-16,125,@,CHO,W 125-113,240,44,82,.537,33,54,.611,11,28,.393,26,31,.839,125,43,94,.457,31,61,.508,12,33,.364,15,18,.833,113
493,UTA,2022-11-09,125,@,ATL,W 125-119,240,44,94,.468,27,55,.491,17,39,.436,20,24,.833,125,51,109,.468,43,81,.531,8,28,.286,9,11,.818,119
494,IND,2022-10-29,125,@,BRK,W 125-116,240,40,94,.426,17,48,.354,23,46,.500,22,26,.846,125,41,82,.500,27,43,.628,14,39,.359,20,26,.769,116
495,POR,2022-10-28,125,,HOU,W 125-111,240,48,90,.533,35,55,.636,13,35,.371,16,20,.800,125,40,94,.426,26,56,.464,14,38,.368,17,21,.810,111
496,MEM,2022-10-27,125,@,SAC,W 125-110,240,49,92,.533,35,59,.593,14,33,.424,13,18,.722,125,40,83,.482,28,45,.622,12,38,.316,18,22,.818,110
497,BRK,2022-10-27,125,,DAL,L 125-129 (OT),265,43,93,.462,31,58,.534,12,35,.343,27,30,.900,125,41,81,.506,21,41,.512,20,40,.500,27,35,.771,129
498,SAC,2022-10-23,125,@,GSW,L 125-130,240,47,100,.470,36,57,.632,11,43,.256,20,25,.800,125,45,87,.517,31,54,.574,14,33,.424,26,36,.722,130
499,MIL,2022-10-22,125,,HOU,W 125-105,240,48,85,.565,32,54,.593,16,31,.516,13,21,.619,125,36,93,.387,20,56,.357,16,37,.432,17,22,.773,105
500,HOU,2023-04-04,124,,DEN,W 124-103,240,47,102,.461,35,71,.493,12,31,.387,18,24,.750,124,41,87,.471,30,51,.588,11,36,.306,10,18,.556,103
501,BRK,2023-03-31,124,,ATL,W 124-107,240,49,88,.557,34,55,.618,15,33,.455,11,13,.846,124,39,91,.429,31,54,.574,8,37,.216,21,23,.913,107
502,LAC,2023-03-27,124,,CHI,W 124-112,240,48,81,.593,28,41,.683,20,40,.500,8,16,.500,124,44,82,.537,35,59,.593,9,23,.391,15,21,.714,112
503,NOP,2023-03-27,124,@,POR,W 124-90,240,49,86,.570,37,58,.638,12,28,.429,14,17,.824,124,35,90,.389,28,57,.491,7,33,.212,13,15,.867,90
504,CHI,2023-03-24,124,@,POR,W 124-96,240,48,84,.571,31,56,.554,17,28,.607,11,14,.786,124,37,86,.430,31,55,.564,6,31,.194,16,18,.889,96
505,SAS,2023-03-24,124,@,WAS,L 124-136,240,51,101,.505,38,63,.603,13,38,.342,9,15,.600,124,51,85,.600,36,55,.655,15,30,.500,19,26,.731,136
506,ATL,2023-03-22,124,@,MIN,L 124-125,240,45,85,.529,33,59,.559,12,26,.462,22,25,.880,124,45,92,.489,34,66,.515,11,26,.423,24,29,.828,125
507,OKC,2023-03-19,124,,PHO,W 124-120,240,42,84,.500,31,56,.554,11,28,.393,29,36,.806,124,44,92,.478,29,56,.518,15,36,.417,17,24,.708,120
508,SAC,2023-03-13,124,,MIL,L 124-133,240,46,104,.442,25,54,.463,21,50,.420,11,15,.733,124,50,86,.581,35,53,.660,15,33,.455,18,22,.818,133
509,BRK,2023-03-10,124,@,MIN,W 124-123 (OT),265,42,91,.462,26,57,.456,16,34,.471,24,33,.727,124,48,98,.490,39,68,.574,9,30,.300,18,29,.621,123
510,ORL,2023-03-09,124,,UTA,L 124-131,240,44,94,.468,28,60,.467,16,34,.471,20,31,.645,124,49,88,.557,36,54,.667,13,34,.382,20,21,.952,131
511,IND,2023-02-28,124,@,DAL,W 124-122,240,41,78,.526,30,50,.600,11,28,.393,31,40,.775,124,46,91,.505,34,54,.630,12,37,.324,18,28,.643,122
512,LAC,2023-02-26,124,@,DEN,L 124-134 (OT),265,44,90,.489,33,56,.589,11,34,.324,25,30,.833,124,49,96,.510,36,57,.632,13,39,.333,23,31,.742,134
513,SAC,2023-02-26,124,@,OKC,W 124-115,240,45,85,.529,27,42,.643,18,43,.419,16,24,.667,124,41,86,.477,25,46,.543,16,40,.400,17,23,.739,115
514,PHO,2023-02-24,124,,OKC,W 124-115,240,42,90,.467,28,52,.538,14,38,.368,26,32,.813,124,41,95,.432,26,57,.456,15,38,.395,18,24,.750,115
515,LAL,2023-02-23,124,,GSW,W 124-111,240,42,86,.488,26,56,.464,16,30,.533,24,34,.706,124,40,105,.381,26,56,.464,14,49,.286,17,21,.810,111
516,GSW,2023-02-14,124,@,LAC,L 124-134,240,45,83,.542,30,49,.612,15,34,.441,19,27,.704,124,49,92,.533,32,56,.571,17,36,.472,19,22,.864,134
517,NYK,2023-02-13,124,,BRK,W 124-106,240,45,82,.549,30,48,.625,15,34,.441,19,26,.731,124,35,78,.449,23,49,.469,12,29,.414,24,33,.727,106
518,MIN,2023-02-13,124,@,DAL,W 124-121,240,48,83,.578,39,54,.722,9,29,.310,19,26,.731,124,43,84,.512,30,45,.667,13,39,.333,22,29,.759,121
519,DAL,2023-02-06,124,@,UTA,W 124-111,240,41,88,.466,26,49,.531,15,39,.385,27,31,.871,124,41,87,.471,35,56,.625,6,31,.194,23,26,.885,111
520,LAC,2023-02-06,124,@,BRK,W 124-116,240,44,92,.478,32,62,.516,12,30,.400,24,30,.800,124,41,84,.488,25,53,.472,16,31,.516,18,22,.818,116
521,POR,2023-02-03,124,@,WAS,W 124-116,240,43,88,.489,26,47,.553,17,41,.415,21,23,.913,124,42,84,.500,30,51,.588,12,33,.364,20,22,.909,116
522,MIL,2023-01-31,124,,CHO,W 124-115,240,43,105,.410,28,61,.459,15,44,.341,23,27,.852,124,42,111,.378,31,72,.431,11,39,.282,20,26,.769,115
523,UTA,2023-01-25,124,@,POR,L 124-134,240,47,90,.522,27,49,.551,20,41,.488,10,15,.667,124,51,89,.573,34,53,.642,17,36,.472,15,18,.833,134
524,NYK,2023-01-20,124,@,ATL,L 124-139,240,49,83,.590,36,53,.679,13,30,.433,13,17,.765,124,56,100,.560,43,66,.652,13,34,.382,14,16,.875,139
525,MIA,2023-01-18,124,@,NOP,W 124-98,240,50,94,.532,38,59,.644,12,35,.343,12,16,.750,124,37,80,.463,24,50,.480,13,30,.433,11,18,.611,98
526,OKC,2023-01-13,124,@,CHI,W 124-110,240,47,92,.511,36,59,.610,11,33,.333,19,22,.864,124,38,85,.447,26,47,.553,12,38,.316,22,24,.917,110
527,TOR,2023-01-12,124,,CHO,W 124-114,240,43,83,.518,33,55,.600,10,28,.357,28,36,.778,124,41,77,.532,28,44,.636,13,33,.394,19,27,.704,114
528,BOS,2023-01-05,124,@,DAL,W 124-95,240,41,84,.488,25,41,.610,16,43,.372,26,31,.839,124,34,90,.378,27,58,.466,7,32,.219,20,25,.800,95
529,MIN,2023-01-02,124,,DEN,W 124-111,240,45,87,.517,32,51,.627,13,36,.361,21,27,.778,124,42,91,.462,31,62,.500,11,29,.379,16,20,.800,111
530,DEN,2022-12-30,124,,MIA,W 124-119,240,45,76,.592,28,48,.583,17,28,.607,17,22,.773,124,39,87,.448,25,52,.481,14,35,.400,27,30,.900,119
531,LAC,2022-12-27,124,@,TOR,W 124-113,240,45,93,.484,30,55,.545,15,38,.395,19,23,.826,124,43,84,.512,37,61,.607,6,23,.261,21,26,.808,113
532,POR,2022-12-26,124,,CHO,W 124-113,240,43,86,.500,29,48,.604,14,38,.368,24,28,.857,124,41,103,.398,29,67,.433,12,36,.333,19,25,.760,113
533,DAL,2022-12-25,124,,LAL,W 124-115,240,44,84,.524,26,40,.650,18,44,.409,18,25,.720,124,39,80,.488,30,52,.577,9,28,.321,28,32,.875,115
534,SAS,2022-12-19,124,@,HOU,W 124-105,240,46,83,.554,29,49,.592,17,34,.500,15,19,.789,124,40,94,.426,35,70,.500,5,24,.208,20,31,.645,105
535,BRK,2022-12-18,124,@,DET,W 124-121,240,44,80,.550,29,51,.569,15,29,.517,21,23,.913,124,42,88,.477,34,58,.586,8,30,.267,29,34,.853,121
536,SAC,2022-12-14,124,@,TOR,W 124-123,240,45,93,.484,28,47,.596,17,46,.370,17,20,.850,124,47,94,.500,41,73,.562,6,21,.286,23,27,.852,123
537,ATL,2022-12-14,124,@,ORL,L 124-135,240,44,88,.500,32,53,.604,12,35,.343,24,27,.889,124,47,93,.505,31,57,.544,16,36,.444,25,30,.833,135
538,LAL,2022-12-11,124,@,DET,W 124-117,240,46,84,.548,35,58,.603,11,26,.423,21,27,.778,124,43,93,.462,26,48,.542,17,45,.378,14,17,.824,117
539,PHO,2022-12-11,124,@,NOP,L 124-129 (OT),265,49,105,.467,36,67,.537,13,38,.342,13,17,.765,124,50,86,.581,42,61,.689,8,25,.320,21,28,.750,129
540,POR,2022-12-10,124,,MIN,W 124-118,240,43,83,.518,30,49,.612,13,34,.382,25,28,.893,124,45,83,.542,35,60,.583,10,23,.435,18,24,.750,118
541,UTA,2022-12-07,124,,GSW,W 124-123,240,46,86,.535,31,51,.608,15,35,.429,17,21,.810,124,45,98,.459,31,56,.554,14,42,.333,19,25,.760,123
542,MIL,2022-11-27,124,,DAL,W 124-115,240,48,86,.558,31,49,.633,17,37,.459,11,15,.733,124,41,80,.513,24,39,.615,17,41,.415,16,25,.640,115
543,GSW,2022-11-23,124,,LAC,W 124-107,240,48,97,.495,29,46,.630,19,51,.373,9,13,.692,124,39,86,.453,28,57,.491,11,29,.379,18,27,.667,107
544,ATL,2022-11-19,124,,TOR,W 124-122 (OT),265,46,92,.500,39,67,.582,7,25,.280,25,32,.781,124,48,108,.444,40,71,.563,8,37,.216,18,22,.818,122
545,NOP,2022-11-16,124,,CHI,W 124-110,240,43,85,.506,26,52,.500,17,33,.515,21,24,.875,124,44,89,.494,33,57,.579,11,32,.344,11,17,.647,110
546,CLE,2022-11-13,124,,MIN,L 124-129,240,40,89,.449,23,55,.418,17,34,.500,27,39,.692,124,46,82,.561,34,58,.586,12,24,.500,25,34,.735,129
547,MEM,2022-11-09,124,@,SAS,W 124-122 (OT),265,50,98,.510,36,66,.545,14,32,.438,10,13,.769,124,47,98,.480,35,61,.574,12,37,.324,16,23,.696,122
548,ATL,2022-11-05,124,,NOP,W 124-121 (OT),265,47,103,.456,38,67,.567,9,36,.250,21,25,.840,124,47,108,.435,40,85,.471,7,23,.304,20,28,.714,121
549,PHO,2022-10-30,124,,HOU,W 124-109,240,45,84,.536,33,44,.750,12,40,.300,22,30,.733,124,38,87,.437,27,53,.509,11,34,.324,22,26,.846,109
550,UTA,2022-10-29,124,,MEM,W 124-123,240,45,87,.517,26,43,.605,19,44,.432,15,20,.750,124,50,88,.568,38,61,.623,12,27,.444,11,15,.733,123
551,PHO,2022-10-28,124,,NOP,W 124-111,240,48,92,.522,38,59,.644,10,33,.303,18,20,.900,124,38,86,.442,23,49,.469,15,37,.405,20,22,.909,111
552,CHI,2022-10-28,124,@,SAS,L 124-129,240,47,99,.475,38,72,.528,9,27,.333,21,26,.808,124,46,86,.535,30,48,.625,16,38,.421,21,26,.808,129
553,CHI,2022-10-26,124,,IND,W 124-109,240,43,87,.494,27,57,.474,16,30,.533,22,24,.917,124,37,86,.430,21,46,.457,16,40,.400,19,24,.792,109
554,BRK,2022-10-24,124,@,MEM,L 124-134,240,47,87,.540,38,58,.655,9,29,.310,21,26,.808,124,47,94,.500,31,60,.517,16,34,.471,24,31,.774,134
555,IND,2022-10-22,124,,DET,W 124-115,240,45,103,.437,29,61,.475,16,42,.381,18,24,.750,124,37,95,.389,19,53,.358,18,42,.429,23,30,.767,115
556,NOP,2022-10-21,124,@,CHO,W 124-112,240,42,89,.472,34,67,.507,8,22,.364,32,37,.865,124,44,97,.454,31,63,.492,13,34,.382,11,14,.786,112
557,MIA,2023-04-09,123,,ORL,W 123-110,240,45,83,.542,27,39,.692,18,44,.409,15,20,.750,123,38,90,.422,21,43,.488,17,47,.362,17,24,.708,110
558,BRK,2023-04-05,123,@,DET,W 123-108,240,45,86,.523,28,43,.651,17,43,.395,16,23,.696,123,41,84,.488,28,56,.500,13,28,.464,13,14,.929,108
559,DAL,2023-04-05,123,,SAC,W 123-119,240,44,89,.494,24,45,.533,20,44,.455,15,18,.833,123,46,106,.434,34,69,.493,12,37,.324,15,19,.789,119
560,ATL,2023-04-04,123,@,CHI,W 123-105,240,48,86,.558,38,58,.655,10,28,.357,17,19,.895,123,41,89,.461,34,58,.586,7,31,.226,16,20,.800,105
561,LAL,2023-03-31,123,@,MIN,W 123-111,240,45,90,.500,36,68,.529,9,22,.409,24,30,.800,123,41,95,.432,28,56,.500,13,39,.333,16,19,.842,111
562,BRK,2023-03-29,123,,HOU,W 123-114,240,44,82,.537,27,47,.574,17,35,.486,18,27,.667,123,46,98,.469,37,68,.544,9,30,.300,13,21,.619,114
563,MEM,2023-03-26,123,@,ATL,W 123-119,240,48,89,.539,35,56,.625,13,33,.394,14,19,.737,123,45,98,.459,38,67,.567,7,31,.226,22,26,.846,119
564,MIL,2023-03-16,123,,IND,L 123-139,240,47,89,.528,36,57,.632,11,32,.344,18,26,.692,123,54,97,.557,32,51,.627,22,46,.478,9,15,.600,139
565,LAL,2023-03-14,123,@,NOP,W 123-108,240,40,82,.488,22,43,.512,18,39,.462,25,28,.893,123,42,98,.429,31,55,.564,11,43,.256,13,20,.650,108
566,NYK,2023-03-14,123,@,POR,W 123-107,240,42,81,.519,27,46,.587,15,35,.429,24,34,.706,123,38,99,.384,21,54,.389,17,45,.378,14,18,.778,107
567,GSW,2023-03-13,123,,PHO,W 123-112,240,45,83,.542,26,44,.591,19,39,.487,14,24,.583,123,46,95,.484,42,74,.568,4,21,.190,16,22,.727,112
568,MIN,2023-03-10,123,,BRK,L 123-124 (OT),265,48,98,.490,39,68,.574,9,30,.300,18,29,.621,123,42,91,.462,26,57,.456,16,34,.471,24,33,.727,124
569,ORL,2023-03-07,123,,MIL,L 123-134,240,50,100,.500,41,70,.586,9,30,.300,14,19,.737,123,46,78,.590,36,50,.720,10,28,.357,32,34,.941,134
570,SAC,2023-03-06,123,,NOP,W 123-108,240,47,83,.566,31,45,.689,16,38,.421,13,20,.650,123,43,80,.538,32,51,.627,11,29,.379,11,14,.786,108
571,LAL,2023-03-01,123,@,OKC,W 123-117,240,38,80,.475,22,45,.489,16,35,.457,31,39,.795,123,44,91,.484,33,51,.647,11,40,.275,18,24,.750,117
572,SAC,2023-02-28,123,@,OKC,W 123-117,240,43,82,.524,28,40,.700,15,42,.357,22,30,.733,123,43,98,.439,32,63,.508,11,35,.314,20,24,.833,117
573,GSW,2023-02-28,123,,POR,W 123-105,240,49,91,.538,37,61,.607,12,30,.400,13,16,.813,123,37,86,.430,25,47,.532,12,39,.308,19,22,.864,105
574,TOR,2023-02-14,123,,ORL,W 123-113,240,50,83,.602,42,59,.712,8,24,.333,15,20,.750,123,43,84,.512,30,53,.566,13,31,.419,14,18,.778,113
575,UTA,2023-02-13,123,@,IND,W 123-117,240,43,85,.506,28,52,.538,15,33,.455,22,25,.880,123,46,91,.505,35,57,.614,11,34,.324,14,20,.700,117
576,PHI,2023-02-13,123,,HOU,W 123-104,240,46,82,.561,31,48,.646,15,34,.441,16,17,.941,123,35,86,.407,29,62,.468,6,24,.250,28,31,.903,104
577,WAS,2023-02-04,123,@,BRK,L 123-125,240,39,81,.481,26,53,.491,13,28,.464,32,41,.780,123,43,86,.500,29,53,.547,14,33,.424,25,28,.893,125
578,MIL,2023-02-04,123,,MIA,W 123-115,240,46,88,.523,32,48,.667,14,40,.350,17,28,.607,123,45,101,.446,37,70,.529,8,31,.258,17,21,.810,115
579,NYK,2023-01-31,123,,LAL,L 123-129 (OT),265,44,98,.449,37,64,.578,7,34,.206,28,32,.875,123,48,93,.516,37,60,.617,11,33,.333,22,31,.710,129
580,TOR,2023-01-28,123,@,POR,W 123-105,240,48,92,.522,38,62,.613,10,30,.333,17,18,.944,123,40,76,.526,33,52,.635,7,24,.292,18,23,.783,105
581,ORL,2023-01-20,123,,NOP,W 123-110,240,39,75,.520,24,45,.533,15,30,.500,30,34,.882,123,41,91,.451,31,56,.554,10,35,.286,18,24,.750,110
582,TOR,2023-01-16,123,@,NYK,W 123-121 (OT),265,38,96,.396,25,52,.481,13,44,.295,34,41,.829,123,42,99,.424,33,68,.485,9,31,.290,28,35,.800,121
583,DAL,2023-01-15,123,@,POR,L 123-140,240,41,89,.461,27,47,.574,14,42,.333,27,33,.818,123,43,85,.506,26,41,.634,17,44,.386,37,42,.881,140
584,PHI,2023-01-08,123,@,DET,W 123-111,240,46,94,.489,35,57,.614,11,37,.297,20,23,.870,123,44,87,.506,36,64,.563,8,23,.348,15,18,.833,111
585,MEM,2023-01-08,123,,UTA,W 123-118,240,46,102,.451,31,64,.484,15,38,.395,16,22,.727,123,45,88,.511,35,56,.625,10,32,.313,18,22,.818,118
586,MEM,2023-01-05,123,@,ORL,W 123-115,240,48,92,.522,36,56,.643,12,36,.333,15,23,.652,123,39,84,.464,28,48,.583,11,36,.306,26,30,.867,115
587,MIL,2023-01-03,123,,WAS,W 123-113,240,48,100,.480,37,60,.617,11,40,.275,16,17,.941,123,42,97,.433,34,70,.486,8,27,.296,21,23,.913,113
588,DEN,2023-01-01,123,,BOS,W 123-111,240,45,79,.570,28,49,.571,17,30,.567,16,18,.889,123,40,87,.460,31,54,.574,9,33,.273,22,27,.815,111
589,BRK,2022-12-31,123,@,CHO,W 123-106,240,48,80,.600,35,46,.761,13,34,.382,14,19,.737,123,38,96,.396,27,55,.491,11,41,.268,19,21,.905,106
590,UTA,2022-12-31,123,,MIA,L 123-126,240,35,81,.432,18,41,.439,17,40,.425,36,44,.818,123,45,89,.506,32,50,.640,13,39,.333,23,30,.767,126
591,MIL,2022-12-30,123,,MIN,W 123-114,240,43,93,.462,29,54,.537,14,39,.359,23,33,.697,123,40,92,.435,32,62,.516,8,30,.267,26,34,.765,114
592,GSW,2022-12-25,123,,MEM,W 123-109,240,43,91,.473,25,47,.532,18,44,.409,19,26,.731,123,39,94,.415,30,55,.545,9,39,.231,22,30,.733,109
593,OKC,2022-12-19,123,,POR,W 123-121,240,40,88,.455,29,57,.509,11,31,.355,32,37,.865,123,44,88,.500,28,51,.549,16,37,.432,17,21,.810,121
594,MIL,2022-12-17,123,,UTA,W 123-97,240,48,90,.533,30,52,.577,18,38,.474,9,11,.818,123,39,86,.453,23,39,.590,16,47,.340,3,6,.500,97
595,TOR,2022-12-14,123,,SAC,L 123-124,240,47,94,.500,41,73,.562,6,21,.286,23,27,.852,123,45,93,.484,28,47,.596,17,46,.370,17,20,.850,124
596,PHI,2022-12-13,123,,SAC,W 123-103,240,43,84,.512,27,49,.551,16,35,.457,21,27,.778,123,38,92,.413,28,50,.560,10,42,.238,17,20,.850,103
597,ATL,2022-12-11,123,,CHI,W 123-122 (OT),265,47,98,.480,34,59,.576,13,39,.333,16,21,.762,123,48,100,.480,41,73,.562,7,27,.259,19,23,.826,122
598,GSW,2022-12-10,123,,BOS,W 123-107,240,47,92,.511,34,53,.642,13,39,.333,16,20,.800,123,38,87,.437,26,47,.553,12,40,.300,19,26,.731,107
599,MEM,2022-12-07,123,,OKC,W 123-102,240,48,94,.511,34,56,.607,14,38,.368,13,16,.813,123,34,92,.370,20,54,.370,14,38,.368,20,23,.870,102
600,GSW,2022-12-07,123,@,UTA,L 123-124,240,45,98,.459,31,56,.554,14,42,.333,19,25,.760,123,46,86,.535,31,51,.608,15,35,.429,17,21,.810,124
601,PHI,2022-12-05,123,@,HOU,L 123-132 (2OT),290,39,87,.448,22,51,.431,17,36,.472,28,36,.778,123,42,94,.447,28,55,.509,14,39,.359,34,44,.773,132
602,SAC,2022-12-03,123,@,LAC,W 123-96,240,46,89,.517,35,57,.614,11,32,.344,20,30,.667,123,33,93,.355,24,60,.400,9,33,.273,21,26,.808,96
603,NYK,2022-11-27,123,,MEM,L 123-127,240,44,87,.506,34,57,.596,10,30,.333,25,30,.833,123,46,95,.484,34,63,.540,12,32,.375,23,31,.742,127
604,OKC,2022-11-25,123,,CHI,W 123-119 (OT),265,44,95,.463,37,66,.561,7,29,.241,28,32,.875,123,44,101,.436,32,68,.471,12,33,.364,19,23,.826,119
605,IND,2022-11-21,123,,ORL,W 123-102,240,43,86,.500,30,40,.750,13,46,.283,24,27,.889,123,36,85,.424,25,50,.500,11,35,.314,19,25,.760,102
606,LAL,2022-11-20,123,,SAS,W 123-92,240,45,85,.529,33,51,.647,12,34,.353,21,24,.875,123,41,105,.390,34,71,.479,7,34,.206,3,10,.300,92
607,ORL,2022-11-05,123,,SAC,L 123-126 (OT),265,50,92,.543,46,69,.667,4,23,.174,19,20,.950,123,47,93,.505,32,53,.604,15,40,.375,17,26,.654,126
608,BOS,2022-11-04,123,,CHI,W 123-119,240,41,83,.494,32,52,.615,9,31,.290,32,39,.821,123,43,83,.518,32,55,.582,11,28,.393,22,25,.880,119
609,MEM,2022-10-29,123,@,UTA,L 123-124,240,50,88,.568,38,61,.623,12,27,.444,11,15,.733,123,45,87,.517,26,43,.605,19,44,.432,15,20,.750,124
610,MIL,2022-10-29,123,,ATL,W 123-115,240,45,92,.489,31,56,.554,14,36,.389,19,29,.655,123,45,94,.479,32,65,.492,13,29,.448,12,15,.800,115
611,BOS,2022-10-28,123,,CLE,L 123-132 (OT),265,42,82,.512,29,49,.592,13,33,.394,26,32,.813,123,45,87,.517,29,52,.558,16,35,.457,26,34,.765,132
612,GSW,2022-10-27,123,,MIA,W 123-110,240,46,92,.500,28,46,.609,18,46,.391,13,15,.867,123,39,88,.443,25,45,.556,14,43,.326,18,22,.818,110
613,GSW,2022-10-21,123,,DEN,L 123-128,240,42,88,.477,27,44,.614,15,44,.341,24,27,.889,123,46,86,.535,31,52,.596,15,34,.441,21,25,.840,128
614,UTA,2022-10-19,123,,DEN,W 123-102,240,42,83,.506,26,45,.578,16,38,.421,23,31,.742,123,40,83,.482,35,61,.574,5,22,.227,17,18,.944,102
615,GSW,2022-10-18,123,,LAL,W 123-109,240,45,99,.455,29,54,.537,16,45,.356,17,23,.739,123,40,94,.426,30,54,.556,10,40,.250,19,25,.760,109
616,DET,2023-04-07,122,@,IND,W 122-115,240,44,90,.489,31,59,.525,13,31,.419,21,26,.808,122,41,83,.494,30,52,.577,11,31,.355,22,28,.786,115
617,DAL,2023-04-01,122,@,MIA,L 122-129,240,47,77,.610,33,43,.767,14,34,.412,14,16,.875,122,45,86,.523,32,49,.653,13,37,.351,26,29,.897,129
618,NOP,2023-04-01,122,,LAC,W 122-114,240,42,86,.488,35,69,.507,7,17,.412,31,35,.886,122,42,85,.494,31,56,.554,11,29,.379,19,23,.826,114
619,BOS,2023-03-31,122,,UTA,W 122-114,240,42,96,.438,25,45,.556,17,51,.333,21,22,.955,122,46,96,.479,37,67,.552,9,29,.310,13,14,.929,114
620,LAL,2023-03-22,122,,PHO,W 122-111,240,39,70,.557,31,53,.585,8,17,.471,36,46,.783,122,42,90,.467,30,59,.508,12,31,.387,15,20,.750,111
621,ORL,2023-03-21,122,,WAS,W 122-112,240,43,80,.538,31,53,.585,12,27,.444,24,25,.960,122,42,83,.506,32,51,.627,10,32,.313,18,23,.783,112
622,TOR,2023-03-18,122,,MIN,W 122-107,240,48,90,.533,39,63,.619,9,27,.333,17,21,.810,122,39,85,.459,34,62,.548,5,23,.217,24,28,.857,107
623,BRK,2023-03-12,122,@,DEN,W 122-120,240,42,84,.500,25,40,.625,17,44,.386,21,24,.875,122,45,90,.500,33,59,.559,12,31,.387,18,24,.750,120
624,LAL,2023-03-10,122,,TOR,W 122-112,240,45,80,.563,32,50,.640,13,30,.433,19,19,1.000,122,46,92,.500,36,64,.563,10,28,.357,10,13,.769,112
625,SAC,2023-03-09,122,,NYK,W 122-117,240,44,84,.524,34,52,.654,10,32,.313,24,32,.750,122,42,101,.416,29,51,.569,13,50,.260,20,31,.645,117
626,ATL,2023-03-08,122,@,WAS,W 122-120,240,45,85,.529,33,56,.589,12,29,.414,20,26,.769,122,47,83,.566,35,54,.648,12,29,.414,14,17,.824,120
627,CHI,2023-03-05,122,,IND,L 122-125,240,45,74,.608,35,52,.673,10,22,.455,22,25,.880,122,48,94,.511,32,50,.640,16,44,.364,13,16,.813,125
628,POR,2023-03-05,122,@,ORL,W 122-119,240,39,83,.470,23,36,.639,16,47,.340,28,32,.875,122,42,84,.500,31,53,.585,11,31,.355,24,31,.774,119
629,HOU,2023-03-04,122,@,SAS,W 122-110,240,49,87,.563,41,64,.641,8,23,.348,16,22,.727,122,38,86,.442,23,49,.469,15,37,.405,19,20,.950,110
630,NYK,2023-03-03,122,@,MIA,W 122-120,240,47,81,.580,30,40,.750,17,41,.415,11,17,.647,122,39,81,.481,27,56,.482,12,25,.480,30,32,.938,120
631,DAL,2023-02-28,122,,IND,L 122-124,240,46,91,.505,34,54,.630,12,37,.324,18,28,.643,122,41,78,.526,30,50,.600,11,28,.393,31,40,.775,124
632,NYK,2023-02-15,122,@,ATL,W 122-101,240,45,96,.469,31,53,.585,14,43,.326,18,22,.818,122,40,97,.412,35,71,.493,5,26,.192,16,21,.762,101
633,DAL,2023-02-10,122,@,SAC,W 122-114,240,43,88,.489,25,45,.556,18,43,.419,18,19,.947,122,39,72,.542,30,45,.667,9,27,.333,27,32,.844,114
634,UTA,2023-02-10,122,@,TOR,W 122-116,240,47,87,.540,41,63,.651,6,24,.250,22,29,.759,122,41,91,.451,29,57,.509,12,34,.353,22,30,.733,116
635,GSW,2023-02-08,122,@,POR,L 122-125,240,46,97,.474,25,48,.521,21,49,.429,9,10,.900,122,43,78,.551,35,51,.686,8,27,.296,31,32,.969,125
636,CLE,2023-02-05,122,@,IND,W 122-103,240,46,88,.523,31,51,.608,15,37,.405,15,16,.938,122,40,92,.435,32,60,.533,8,32,.250,15,22,.682,103
637,POR,2023-02-01,122,@,MEM,W 122-112,240,41,87,.471,27,51,.529,14,36,.389,26,27,.963,122,41,87,.471,32,50,.640,9,37,.243,21,28,.750,112
638,DEN,2023-01-31,122,,NOP,W 122-113,240,43,87,.494,27,51,.529,16,36,.444,20,24,.833,122,42,85,.494,34,58,.586,8,27,.296,21,25,.840,113
639,CLE,2023-01-29,122,,LAC,W 122-99,240,44,78,.564,24,45,.533,20,33,.606,14,19,.737,122,37,89,.416,35,70,.500,2,19,.105,23,27,.852,99
640,CHO,2023-01-29,122,,MIA,W 122-117,240,45,83,.542,30,43,.698,15,40,.375,17,22,.773,122,45,93,.484,35,62,.565,10,31,.323,17,23,.739,117
641,BRK,2023-01-28,122,,NYK,W 122-115,240,46,87,.529,24,47,.511,22,40,.550,8,14,.571,122,45,88,.511,35,60,.583,10,28,.357,15,19,.789,115
642,BRK,2023-01-26,122,,DET,L 122-130,240,43,94,.457,30,56,.536,13,38,.342,23,27,.852,122,48,95,.505,37,68,.544,11,27,.407,23,26,.885,130
643,GSW,2023-01-25,122,,MEM,W 122-120,240,43,85,.506,29,53,.547,14,32,.438,22,28,.786,122,42,88,.477,32,57,.561,10,31,.323,26,37,.703,120
644,CHO,2023-01-21,122,@,ATL,W 122-118,240,45,89,.506,32,55,.582,13,34,.382,19,22,.864,122,45,83,.542,34,58,.586,11,25,.440,17,20,.850,118
645,LAL,2023-01-20,122,,MEM,W 122-121,240,38,93,.409,25,52,.481,13,41,.317,33,41,.805,122,43,102,.422,34,73,.466,9,29,.310,26,40,.650,121
646,DEN,2023-01-18,122,,MIN,W 122-118,240,45,85,.529,37,64,.578,8,21,.381,24,32,.750,122,42,81,.519,30,49,.612,12,32,.375,22,28,.786,118
647,CHO,2023-01-18,122,@,HOU,W 122-117,240,48,96,.500,39,60,.650,9,36,.250,17,25,.680,122,46,91,.505,36,59,.610,10,32,.313,15,20,.750,117
648,DAL,2023-01-18,122,,ATL,L 122-130,240,44,84,.524,28,42,.667,16,42,.381,18,24,.750,122,49,86,.570,36,60,.600,13,26,.500,19,20,.950,130
649,DEN,2023-01-17,122,,POR,W 122-113,240,44,88,.500,33,56,.589,11,32,.344,23,28,.821,122,38,83,.458,25,43,.581,13,40,.325,24,25,.960,113
650,TOR,2023-01-17,122,@,MIL,L 122-130,240,46,101,.455,33,66,.500,13,35,.371,17,27,.630,122,46,86,.535,27,47,.574,19,39,.487,19,21,.905,130
651,BOS,2023-01-14,122,@,CHO,W 122-106,240,47,99,.475,28,46,.609,19,53,.358,9,10,.900,122,41,88,.466,33,61,.541,8,27,.296,16,19,.842,106
652,DEN,2023-01-09,122,,LAL,W 122-109,240,46,99,.465,31,57,.544,15,42,.357,15,17,.882,122,41,93,.441,33,65,.508,8,28,.286,19,25,.760,109
653,DEN,2023-01-05,122,,LAC,W 122-91,240,45,89,.506,31,53,.585,14,36,.389,18,21,.857,122,34,91,.374,29,54,.537,5,37,.135,18,25,.720,91
654,DET,2023-01-04,122,@,GSW,W 122-119,240,45,92,.489,29,56,.518,16,36,.444,16,23,.696,122,45,87,.517,30,47,.638,15,40,.375,14,15,.933,119
655,IND,2023-01-02,122,,TOR,W 122-114,240,45,93,.484,35,66,.530,10,27,.370,22,26,.846,122,41,91,.451,27,49,.551,14,42,.333,18,23,.783,114
656,SAS,2022-12-29,122,,NYK,W 122-115,240,45,88,.511,34,60,.567,11,28,.393,21,29,.724,122,38,90,.422,23,49,.469,15,41,.366,24,31,.774,115
657,UTA,2022-12-26,122,@,SAS,L 122-126,240,39,97,.402,26,54,.481,13,43,.302,31,37,.838,122,48,87,.552,42,69,.609,6,18,.333,24,34,.706,126
658,CLE,2022-12-19,122,,UTA,W 122-99,240,43,70,.614,28,44,.636,15,26,.577,21,26,.808,122,36,93,.387,26,59,.441,10,34,.294,17,23,.739,99
659,SAC,2022-12-16,122,@,DET,W 122-113,240,43,82,.524,31,51,.608,12,31,.387,24,29,.828,122,39,85,.459,29,56,.518,10,29,.345,25,31,.806,113
660,BOS,2022-12-13,122,@,LAL,W 122-118 (OT),265,46,104,.442,27,56,.482,19,48,.396,11,16,.688,122,44,93,.473,36,64,.563,8,29,.276,22,30,.733,118
661,CHI,2022-12-11,122,@,ATL,L 122-123 (OT),265,48,100,.480,41,73,.562,7,27,.259,19,23,.826,122,47,98,.480,34,59,.576,13,39,.333,16,21,.762,123
662,LAL,2022-12-09,122,@,PHI,L 122-133 (OT),265,44,88,.500,33,57,.579,11,31,.355,23,30,.767,122,48,90,.533,30,50,.600,18,40,.450,19,22,.864,133
663,BRK,2022-12-07,122,,CHO,W 122-116,240,49,86,.570,37,55,.673,12,31,.387,12,16,.750,122,47,88,.534,37,64,.578,10,24,.417,12,23,.522,116
664,MEM,2022-12-04,122,@,DET,W 122-112,240,43,92,.467,28,57,.491,15,35,.429,21,29,.724,122,37,84,.440,24,49,.490,13,35,.371,25,30,.833,112
665,HOU,2022-12-02,122,@,PHO,W 122-121,240,40,81,.494,32,57,.561,8,24,.333,34,43,.791,122,45,85,.529,28,48,.583,17,37,.459,14,19,.737,121
666,PHO,2022-11-28,122,@,SAC,W 122-117,240,50,94,.532,40,62,.645,10,32,.313,12,14,.857,122,46,88,.523,37,63,.587,9,25,.360,16,18,.889,117
667,ATL,2022-11-25,122,@,HOU,L 122-128,240,39,82,.476,24,43,.558,15,39,.385,29,36,.806,122,41,87,.471,29,52,.558,12,35,.343,34,41,.829,128
668,BOS,2022-11-25,122,,SAC,W 122-104,240,41,83,.494,25,46,.543,16,37,.432,24,27,.889,122,36,87,.414,27,51,.529,9,36,.250,23,26,.885,104
669,TOR,2022-11-19,122,@,ATL,L 122-124 (OT),265,48,108,.444,40,71,.563,8,37,.216,18,22,.818,122,46,92,.500,39,67,.582,7,25,.280,25,32,.781,124
670,CHO,2022-11-18,122,@,CLE,L 122-132 (2OT),290,44,110,.400,30,66,.455,14,44,.318,20,24,.833,122,49,92,.533,41,64,.641,8,28,.286,26,32,.813,132
671,OKC,2022-11-14,122,@,BOS,L 122-126,240,47,98,.480,36,68,.529,11,30,.367,17,21,.810,122,46,96,.479,36,59,.610,10,37,.270,24,29,.828,126
672,LAC,2022-11-14,122,@,HOU,W 122-106,240,41,81,.506,27,43,.628,14,38,.368,26,33,.788,122,39,86,.453,30,56,.536,9,30,.300,19,31,.613,106
673,SAC,2022-11-13,122,,GSW,W 122-115,240,47,91,.516,31,54,.574,16,37,.432,12,19,.632,122,42,90,.467,26,43,.605,16,47,.340,15,16,.938,115
674,DEN,2022-11-09,122,@,IND,W 122-119,240,43,88,.489,31,60,.517,12,28,.429,24,26,.923,122,45,96,.469,31,54,.574,14,42,.333,15,19,.789,119
675,SAS,2022-11-09,122,,MEM,L 122-124 (OT),265,47,98,.480,35,61,.574,12,37,.324,16,23,.696,122,50,98,.510,36,66,.545,14,32,.438,10,13,.769,124
676,NOP,2022-11-07,122,@,IND,L 122-129,240,48,97,.495,34,63,.540,14,34,.412,12,17,.706,122,43,86,.500,21,38,.553,22,48,.458,21,23,.913,129
677,DEN,2022-11-03,122,@,OKC,W 122-110,240,45,84,.536,27,53,.509,18,31,.581,14,16,.875,122,45,93,.484,39,64,.609,6,29,.207,14,19,.737,110
678,SAS,2022-10-26,122,@,MIN,L 122-134,240,43,95,.453,27,59,.458,16,36,.444,20,22,.909,122,52,80,.650,32,46,.696,20,34,.588,10,16,.625,134
679,UTA,2022-10-23,122,@,NOP,W 122-121 (OT),265,43,98,.439,30,60,.500,13,38,.342,23,28,.821,122,48,102,.471,40,75,.533,8,27,.296,17,22,.773,121
680,DEN,2022-10-22,122,,OKC,W 122-117,240,42,85,.494,22,47,.468,20,38,.526,18,31,.581,122,42,94,.447,27,56,.482,15,38,.395,18,23,.783,117
681,HOU,2022-10-21,122,,MEM,L 122-129,240,44,93,.473,28,58,.483,16,35,.457,18,30,.600,122,45,98,.459,26,56,.464,19,42,.452,20,29,.690,129
682,TOR,2023-04-09,121,,MIL,W 121-105,240,48,95,.505,37,62,.597,11,33,.333,14,16,.875,121,38,82,.463,26,48,.542,12,34,.353,17,21,.810,105
683,BOS,2023-04-07,121,,TOR,W 121-102,240,45,81,.556,30,37,.811,15,44,.341,16,21,.762,121,40,93,.430,31,62,.500,9,31,.290,13,17,.765,102
684,LAL,2023-04-07,121,,PHO,W 121-107,240,45,92,.489,27,56,.482,18,36,.500,13,17,.765,121,43,104,.413,34,68,.500,9,36,.250,12,14,.857,107
685,SAC,2023-04-04,121,@,NOP,W 121-103,240,46,91,.505,29,49,.592,17,42,.405,12,15,.800,121,37,84,.440,30,64,.469,7,20,.350,22,27,.815,103
686,HOU,2023-03-31,121,,DET,W 121-115,240,38,83,.458,27,52,.519,11,31,.355,34,45,.756,121,43,89,.483,32,54,.593,11,35,.314,18,27,.667,115
687,CHI,2023-03-31,121,@,CHO,W 121-91,240,45,88,.511,32,57,.561,13,31,.419,18,22,.818,121,35,77,.455,21,40,.525,14,37,.378,7,10,.700,91
688,IND,2023-03-31,121,,OKC,W 121-117,240,45,98,.459,33,57,.579,12,41,.293,19,28,.679,121,42,88,.477,38,58,.655,4,30,.133,29,34,.853,117
689,LAL,2023-03-29,121,@,CHI,W 121-110,240,45,86,.523,38,66,.576,7,20,.350,24,30,.800,121,45,88,.511,36,55,.655,9,33,.273,11,13,.846,110
690,SAC,2023-03-25,121,,UTA,W 121-113,240,44,95,.463,28,52,.538,16,43,.372,17,21,.810,121,47,91,.516,38,63,.603,9,28,.321,10,16,.625,113
691,GSW,2023-03-20,121,@,HOU,W 121-108,240,44,88,.500,27,40,.675,17,48,.354,16,19,.842,121,39,93,.419,29,57,.509,10,36,.278,20,24,.833,108
692,IND,2023-03-18,121,,PHI,L 121-141,240,45,87,.517,33,56,.589,12,31,.387,19,20,.950,121,54,88,.614,39,53,.736,15,35,.429,18,22,.818,141
693,PHI,2023-03-17,121,@,CHO,W 121-82,240,46,92,.500,36,60,.600,10,32,.313,19,25,.760,121,29,86,.337,24,51,.471,5,35,.143,19,26,.731,82
694,OKC,2023-03-14,121,,BRK,W 121-107,240,45,99,.455,34,66,.515,11,33,.333,20,23,.870,121,35,82,.427,23,41,.561,12,41,.293,25,34,.735,107
695,IND,2023-03-11,121,@,DET,W 121-115,240,43,93,.462,34,58,.586,9,35,.257,26,34,.765,121,43,94,.457,32,60,.533,11,34,.324,18,27,.667,115
696,NOP,2023-03-01,121,@,POR,W 121-110,240,46,89,.517,37,64,.578,9,25,.360,20,23,.870,121,36,81,.444,25,43,.581,11,38,.289,27,29,.931,110
697,MEM,2023-02-28,121,,LAL,W 121-109,240,51,112,.455,45,81,.556,6,31,.194,13,17,.765,121,38,86,.442,25,52,.481,13,34,.382,20,23,.870,109
698,IND,2023-02-25,121,@,ORL,W 121-108,240,48,99,.485,33,59,.559,15,40,.375,10,14,.714,121,35,90,.389,29,61,.475,6,29,.207,32,38,.842,108
699,CHO,2023-02-24,121,@,MIN,W 121-113,240,43,92,.467,33,64,.516,10,28,.357,25,28,.893,121,46,93,.495,35,60,.583,11,33,.333,10,16,.625,113
700,DAL,2023-02-13,121,,MIN,L 121-124,240,43,84,.512,30,45,.667,13,39,.333,22,29,.759,121,48,83,.578,39,54,.722,9,29,.310,19,26,.731,124
701,HOU,2023-02-04,121,@,OKC,L 121-153,240,45,89,.506,35,59,.593,10,30,.333,21,27,.778,121,56,97,.577,35,51,.686,21,46,.457,20,23,.870,153
702,POR,2023-02-04,121,@,CHI,L 121-129,240,44,87,.506,30,44,.682,14,43,.326,19,21,.905,121,48,80,.600,36,54,.667,12,26,.462,21,25,.840,129
703,BRK,2023-01-30,121,,LAL,W 121-104,240,45,95,.474,29,54,.537,16,41,.390,15,19,.789,121,35,89,.393,24,60,.400,11,29,.379,23,37,.622,104
704,LAL,2023-01-28,121,@,BOS,L 121-125 (OT),265,47,105,.448,35,63,.556,12,42,.286,15,20,.750,121,39,84,.464,26,44,.591,13,40,.325,34,39,.872,125
705,LAL,2023-01-22,121,@,POR,W 121-112,240,45,86,.523,35,56,.625,10,30,.333,21,27,.778,121,37,86,.430,20,40,.500,17,46,.370,21,25,.840,112
706,MEM,2023-01-20,121,@,LAL,L 121-122,240,43,102,.422,34,73,.466,9,29,.310,26,40,.650,121,38,93,.409,25,52,.481,13,41,.317,33,41,.805,122
707,BOS,2023-01-19,121,,GSW,W 121-118 (OT),265,43,108,.398,30,67,.448,13,41,.317,22,30,.733,121,40,100,.400,22,48,.458,18,52,.346,20,23,.870,118
708,ATL,2023-01-16,121,,MIA,W 121-113,240,45,76,.592,32,49,.653,13,27,.481,18,22,.818,121,43,89,.483,35,58,.603,8,31,.258,19,20,.950,113
709,NYK,2023-01-16,121,,TOR,L 121-123 (OT),265,42,99,.424,33,68,.485,9,31,.290,28,35,.800,121,38,96,.396,25,52,.481,13,44,.295,34,41,.829,123
710,LAC,2023-01-15,121,,HOU,W 121-100,240,46,88,.523,32,56,.571,14,32,.438,15,21,.714,121,38,84,.452,31,53,.585,7,31,.226,17,23,.739,100
711,MIN,2023-01-13,121,,PHO,W 121-116,240,47,90,.522,37,62,.597,10,28,.357,17,20,.850,121,41,86,.477,27,63,.429,14,23,.609,20,24,.833,116
712,MEM,2023-01-09,121,,SAS,W 121-113,240,45,91,.495,34,65,.523,11,26,.423,20,35,.571,121,44,97,.454,33,65,.508,11,32,.344,14,16,.875,113
713,BOS,2023-01-07,121,@,SAS,W 121-116,240,47,95,.495,32,61,.525,15,34,.441,12,18,.667,121,49,100,.490,42,75,.560,7,25,.280,11,14,.786,116
714,DEN,2023-01-06,121,,CLE,W 121-108,240,43,81,.531,26,46,.565,17,35,.486,18,23,.783,121,40,88,.455,30,62,.484,10,26,.385,18,32,.563,108
715,SAS,2023-01-06,121,,DET,W 121-109,240,45,81,.556,36,57,.632,9,24,.375,22,26,.846,121,44,93,.473,33,62,.532,11,31,.355,10,17,.588,109
716,CHI,2023-01-04,121,,BRK,W 121-112,240,43,81,.531,35,61,.574,8,20,.400,27,29,.931,121,42,91,.462,30,54,.556,12,37,.324,16,21,.762,112
717,LAL,2023-01-02,121,@,CHO,W 121-115,240,45,93,.484,35,63,.556,10,30,.333,21,30,.700,121,42,93,.452,31,61,.508,11,32,.344,20,29,.690,115
718,ATL,2022-12-30,121,,LAL,L 121-130,240,48,101,.475,37,63,.587,11,38,.289,14,20,.700,121,52,96,.542,42,64,.656,10,32,.313,16,18,.889,130
719,CHO,2022-12-29,121,,OKC,W 121-113,240,46,84,.548,36,52,.692,10,32,.313,19,29,.655,121,42,99,.424,31,63,.492,11,36,.306,18,21,.857,113
720,DET,2022-12-28,121,,ORL,W 121-101,240,36,80,.450,18,38,.474,18,42,.429,31,40,.775,121,35,85,.412,30,63,.476,5,22,.227,26,34,.765,101
721,NYK,2022-12-27,121,@,DAL,L 121-126 (OT),265,45,103,.437,29,53,.547,16,50,.320,15,24,.625,121,44,90,.489,31,44,.705,13,46,.283,25,33,.758,126
722,BOS,2022-12-23,121,,MIN,W 121-109,240,44,100,.440,31,54,.574,13,46,.283,20,26,.769,121,44,91,.484,34,59,.576,10,32,.313,11,15,.733,109
723,POR,2022-12-19,121,@,OKC,L 121-123,240,44,88,.500,28,51,.549,16,37,.432,17,21,.810,121,40,88,.455,29,57,.509,11,31,.355,32,37,.865,123
724,DET,2022-12-18,121,,BRK,L 121-124,240,42,88,.477,34,58,.586,8,30,.267,29,34,.853,121,44,80,.550,29,51,.569,15,29,.517,21,23,.913,124
725,UTA,2022-12-13,121,,NOP,W 121-100,240,49,103,.476,34,56,.607,15,47,.319,8,12,.667,121,37,93,.398,33,66,.500,4,27,.148,22,33,.667,100
726,DAL,2022-12-12,121,,OKC,W 121-114,240,39,93,.419,17,39,.436,22,54,.407,21,25,.840,121,42,88,.477,32,57,.561,10,31,.323,20,21,.952,114
727,NYK,2022-12-09,121,@,CHO,W 121-102,240,41,93,.441,28,59,.475,13,34,.382,26,30,.867,121,37,84,.440,31,58,.534,6,26,.231,22,28,.786,102
728,IND,2022-12-09,121,,WAS,W 121-111,240,43,85,.506,25,44,.568,18,41,.439,17,20,.850,121,41,77,.532,31,48,.646,10,29,.345,19,25,.760,111
729,DEN,2022-12-08,121,@,POR,W 121-120,240,47,91,.516,35,61,.574,12,30,.400,15,22,.682,121,44,91,.484,28,51,.549,16,40,.400,16,16,1.000,120
730,MIN,2022-12-07,121,,IND,W 121-115,240,44,93,.473,36,70,.514,8,23,.348,25,27,.926,121,39,81,.481,20,39,.513,19,42,.452,18,24,.750,115
731,OKC,2022-12-05,121,@,ATL,W 121-114,240,43,95,.453,31,61,.508,12,34,.353,23,24,.958,121,44,102,.431,31,64,.484,13,38,.342,13,17,.765,114
732,NOP,2022-12-04,121,,DEN,W 121-106,240,41,81,.506,30,55,.545,11,26,.423,28,36,.778,121,41,81,.506,33,50,.660,8,31,.258,16,24,.667,106
733,TOR,2022-12-03,121,,ORL,W 121-108,240,47,84,.560,38,55,.691,9,29,.310,18,25,.720,121,38,78,.487,27,50,.540,11,28,.393,21,26,.808,108
734,DAL,2022-12-03,121,@,NYK,W 121-100,240,43,100,.430,19,39,.487,24,61,.393,11,14,.786,121,35,77,.455,25,46,.543,10,31,.323,20,28,.714,100
735,PHO,2022-12-02,121,,HOU,L 121-122,240,45,85,.529,28,48,.583,17,37,.459,14,19,.737,121,40,81,.494,32,57,.561,8,24,.333,34,43,.791,122
736,MIA,2022-11-30,121,@,BOS,L 121-134,240,47,90,.522,29,50,.580,18,40,.450,9,9,1.000,121,46,83,.554,24,38,.632,22,45,.489,20,23,.870,134
737,WAS,2022-11-27,121,@,BOS,L 121-130,240,44,82,.537,37,54,.685,7,28,.250,26,33,.788,121,44,80,.550,28,46,.609,16,34,.471,26,26,1.000,130
738,CHI,2022-11-21,121,,BOS,W 121-107,240,46,89,.517,32,60,.533,14,29,.483,15,20,.750,121,38,87,.437,19,37,.514,19,50,.380,12,17,.706,107
739,LAC,2022-11-21,121,,UTA,W 121-114,240,47,91,.516,38,67,.567,9,24,.375,18,19,.947,121,40,89,.449,28,51,.549,12,38,.316,22,24,.917,114
740,MEM,2022-11-18,121,,OKC,W 121-110,240,39,93,.419,25,54,.463,14,39,.359,29,40,.725,121,45,96,.469,34,62,.548,11,34,.324,9,11,.818,110
741,DET,2022-11-18,121,@,LAL,L 121-128,240,43,92,.467,32,58,.552,11,34,.324,24,32,.750,121,43,78,.551,36,58,.621,7,20,.350,35,40,.875,128
742,OKC,2022-11-16,121,@,WAS,W 121-120,240,44,81,.543,28,50,.560,16,31,.516,17,26,.654,121,44,86,.512,27,52,.519,17,34,.500,15,17,.882,120
743,BRK,2022-11-15,121,@,SAC,L 121-153,240,40,81,.494,29,53,.547,11,28,.393,30,33,.909,121,56,94,.596,36,53,.679,20,41,.488,21,25,.840,153
744,ATL,2022-11-14,121,@,MIL,W 121-106,240,44,92,.478,37,72,.514,7,20,.350,26,30,.867,121,34,82,.415,28,53,.528,6,29,.207,32,41,.780,106
745,WAS,2022-11-12,121,,UTA,W 121-112,240,44,88,.500,28,52,.538,16,36,.444,17,20,.850,121,44,94,.468,30,54,.556,14,40,.350,10,11,.909,112
746,PHI,2022-11-12,121,,ATL,W 121-109,240,44,80,.550,36,56,.643,8,24,.333,25,31,.806,121,40,89,.449,34,65,.523,6,24,.250,23,27,.852,109
747,NYK,2022-11-11,121,,DET,W 121-112,240,42,94,.447,32,54,.593,10,40,.250,27,29,.931,121,37,80,.463,30,49,.612,7,31,.226,31,41,.756,112
748,NOP,2022-11-05,121,@,ATL,L 121-124 (OT),265,47,108,.435,40,85,.471,7,23,.304,20,28,.714,121,47,103,.456,38,67,.567,9,36,.250,21,25,.840,124
749,WAS,2022-11-02,121,@,PHI,W 121-111,240,45,78,.577,40,57,.702,5,21,.238,26,32,.813,121,39,84,.464,20,48,.417,19,36,.528,14,20,.700,111
750,UTA,2022-10-31,121,,MEM,W 121-105,240,42,89,.472,23,42,.548,19,47,.404,18,22,.818,121,38,92,.413,32,66,.485,6,26,.231,23,42,.548,105
751,LAL,2022-10-30,121,,DEN,W 121-110,240,46,96,.479,33,66,.500,13,30,.433,16,20,.800,121,41,96,.427,26,56,.464,15,40,.375,13,18,.722,110
752,CLE,2022-10-30,121,,NYK,W 121-108,240,41,89,.461,18,39,.462,23,50,.460,16,19,.842,121,45,92,.489,35,65,.538,10,27,.370,8,16,.500,108
753,NOP,2022-10-23,121,,UTA,L 121-122 (OT),265,48,102,.471,40,75,.533,8,27,.296,17,22,.773,121,43,98,.439,30,60,.500,13,38,.342,23,28,.821,122
754,BOS,2023-04-09,120,,ATL,W 120-114,240,42,89,.472,17,35,.486,25,54,.463,11,14,.786,120,44,97,.454,33,58,.569,11,39,.282,15,19,.789,114
755,TOR,2023-04-04,120,@,CHO,W 120-100,240,42,88,.477,27,55,.491,15,33,.455,21,28,.750,120,36,77,.468,24,46,.522,12,31,.387,16,19,.842,100
756,SAC,2023-03-29,120,@,POR,W 120-80,240,42,92,.457,24,44,.545,18,48,.375,18,24,.750,120,30,93,.323,21,54,.389,9,39,.231,11,12,.917,80
757,GSW,2023-03-28,120,,NOP,W 120-109,240,43,82,.524,25,42,.595,18,40,.450,16,22,.727,120,42,90,.467,30,63,.476,12,27,.444,13,14,.929,109
758,ATL,2023-03-28,120,,CLE,W 120-118,240,41,89,.461,29,62,.468,12,27,.444,26,33,.788,120,47,93,.505,38,68,.559,9,25,.360,15,22,.682,118
759,GSW,2023-03-24,120,,PHI,W 120-112,240,42,88,.477,24,38,.632,18,50,.360,18,24,.750,120,38,78,.487,30,49,.612,8,29,.276,28,34,.824,112
760,BOS,2023-03-24,120,,IND,W 120-95,240,44,93,.473,26,51,.510,18,42,.429,14,19,.737,120,39,84,.464,35,58,.603,4,26,.154,13,22,.591,95
761,NYK,2023-03-22,120,@,MIA,L 120-127,240,42,82,.512,26,42,.619,16,40,.400,20,25,.800,120,45,79,.570,29,51,.569,16,28,.571,21,26,.808,127
762,SAC,2023-03-20,120,@,UTA,L 120-128,240,41,97,.423,22,45,.489,19,52,.365,19,25,.760,120,46,88,.523,30,52,.577,16,36,.444,20,23,.870,128
763,PHO,2023-03-19,120,@,OKC,L 120-124,240,44,92,.478,29,56,.518,15,36,.417,17,24,.708,120,42,84,.500,31,56,.554,11,28,.393,29,36,.806,124
764,SAS,2023-03-17,120,,MEM,L 120-126 (OT),265,39,98,.398,19,46,.413,20,52,.385,22,29,.759,120,49,101,.485,35,63,.556,14,38,.368,14,21,.667,126
765,CLE,2023-03-14,120,@,CHO,W 120-104,240,45,88,.511,31,58,.534,14,30,.467,16,19,.842,120,43,76,.566,37,53,.698,6,23,.261,12,15,.800,104
766,DEN,2023-03-12,120,,BRK,L 120-122,240,45,90,.500,33,59,.559,12,31,.387,18,24,.750,120,42,84,.500,25,40,.625,17,44,.386,21,24,.875,122
767,DEN,2023-03-10,120,@,SAS,L 120-128,240,44,90,.489,31,55,.564,13,35,.371,19,20,.950,120,51,94,.543,38,61,.623,13,33,.394,13,17,.765,128
768,PHI,2023-03-10,120,,POR,W 120-119,240,43,83,.518,32,53,.604,11,30,.367,23,29,.793,120,42,80,.525,27,44,.614,15,36,.417,20,30,.667,119
769,WAS,2023-03-08,120,,ATL,L 120-122,240,47,83,.566,35,54,.648,12,29,.414,14,17,.824,120,45,85,.529,33,56,.589,12,29,.414,20,26,.769,122
770,DAL,2023-03-07,120,,UTA,W 120-116,240,42,89,.472,23,44,.523,19,45,.422,17,22,.773,120,41,92,.446,26,48,.542,15,44,.341,19,25,.760,116
771,MIA,2023-03-03,120,,NYK,L 120-122,240,39,81,.481,27,56,.482,12,25,.480,30,32,.938,120,47,81,.580,30,40,.750,17,41,.415,11,17,.647,122
772,UTA,2023-02-23,120,,OKC,W 120-119 (OT),265,42,100,.420,29,52,.558,13,48,.271,23,27,.852,120,45,112,.402,37,75,.493,8,37,.216,21,27,.778,119
773,LAL,2023-02-15,120,,NOP,W 120-102,240,44,83,.530,34,46,.739,10,37,.270,22,36,.611,120,39,89,.438,32,64,.500,7,25,.280,17,24,.708,102
774,CHO,2023-02-15,120,,SAS,W 120-110,240,43,96,.448,29,61,.475,14,35,.400,20,29,.690,120,41,107,.383,28,69,.406,13,38,.342,15,20,.750,110
775,PHO,2023-02-14,120,,SAC,W 120-109,240,50,88,.568,43,66,.652,7,22,.318,13,16,.813,120,37,83,.446,23,45,.511,14,38,.368,21,24,.875,109
776,UTA,2023-02-11,120,@,NYK,L 120-126,240,45,88,.511,36,56,.643,9,32,.281,21,28,.750,120,43,95,.453,31,59,.525,12,36,.333,28,38,.737,126
777,HOU,2023-02-06,120,,SAC,L 120-140,240,44,88,.500,31,56,.554,13,32,.406,19,24,.792,120,52,89,.584,31,48,.646,21,41,.512,15,18,.833,140
778,MIN,2023-02-03,120,,ORL,L 120-127,240,40,87,.460,24,43,.558,16,44,.364,24,28,.857,120,45,85,.529,33,62,.532,12,23,.522,25,38,.658,127
779,OKC,2023-01-30,120,,GSW,L 120-128,240,46,93,.495,35,69,.507,11,24,.458,17,20,.850,120,46,90,.511,26,43,.605,20,47,.426,16,20,.800,128
780,LAC,2023-01-28,120,@,ATL,W 120-113,240,42,80,.525,23,41,.561,19,39,.487,17,19,.895,120,45,95,.474,38,68,.559,7,27,.259,16,20,.800,113
781,NYK,2023-01-26,120,@,BOS,W 120-117 (OT),265,44,96,.458,31,58,.534,13,38,.342,19,23,.826,120,41,100,.410,25,54,.463,16,46,.348,19,23,.826,117
782,IND,2023-01-25,120,@,ORL,L 120-126,240,41,85,.482,26,50,.520,15,35,.429,23,29,.793,120,46,82,.561,31,54,.574,15,28,.536,19,25,.760,126
783,MEM,2023-01-25,120,@,GSW,L 120-122,240,42,88,.477,32,57,.561,10,31,.323,26,37,.703,120,43,85,.506,29,53,.547,14,32,.438,22,28,.786,122
784,UTA,2023-01-23,120,,CHO,W 120-102,240,41,86,.477,25,46,.543,16,40,.400,22,26,.846,120,38,85,.447,36,69,.522,2,16,.125,24,34,.706,102
785,BRK,2023-01-22,120,@,GSW,W 120-116,240,43,79,.544,29,52,.558,14,27,.519,20,31,.645,120,41,90,.456,28,58,.483,13,32,.406,21,27,.778,116
786,GSW,2023-01-20,120,@,CLE,W 120-114,240,42,86,.488,19,43,.442,23,43,.535,13,19,.684,120,42,84,.500,28,51,.549,14,33,.424,16,19,.842,114
787,PHI,2023-01-17,120,@,LAC,W 120-110,240,39,73,.534,26,42,.619,13,31,.419,29,34,.853,120,41,82,.500,29,48,.604,12,34,.353,16,20,.800,110
788,CHO,2023-01-10,120,@,TOR,L 120-132,240,47,86,.547,32,51,.627,15,35,.429,11,15,.733,120,45,91,.495,25,47,.532,20,44,.455,22,27,.815,132
789,OKC,2023-01-08,120,,DAL,W 120-109,240,46,95,.484,34,67,.507,12,28,.429,16,20,.800,120,31,73,.425,17,34,.500,14,39,.359,33,42,.786,109
790,ATL,2023-01-04,120,@,SAC,W 120-117,240,45,84,.536,35,54,.648,10,30,.333,20,22,.909,120,41,88,.466,31,63,.492,10,25,.400,25,27,.926,117
791,PHI,2023-01-02,120,,NOP,W 120-111,240,41,86,.477,26,51,.510,15,35,.429,23,28,.821,120,42,84,.500,31,55,.564,11,29,.379,16,20,.800,111
792,DEN,2022-12-23,120,,POR,W 120-107,240,47,81,.580,37,60,.617,10,21,.476,16,26,.615,120,39,87,.448,30,52,.577,9,35,.257,20,26,.769,107
793,UTA,2022-12-22,120,,WAS,W 120-112,240,42,86,.488,26,51,.510,16,35,.457,20,21,.952,120,46,82,.561,39,61,.639,7,21,.333,13,17,.765,112
794,LAL,2022-12-21,120,@,SAC,L 120-134,240,42,84,.500,31,60,.517,11,24,.458,25,30,.833,120,48,95,.505,31,48,.646,17,47,.362,21,28,.750,134
795,CHI,2022-12-14,120,,NYK,L 120-128 (OT),265,46,84,.548,37,56,.661,9,28,.321,19,22,.864,120,45,91,.495,27,57,.474,18,34,.529,20,25,.800,128
796,BRK,2022-12-09,120,,ATL,W 120-116,240,45,83,.542,32,53,.604,13,30,.433,17,21,.810,120,46,93,.495,36,64,.563,10,29,.345,14,16,.875,116
797,POR,2022-12-08,120,,DEN,L 120-121,240,44,91,.484,28,51,.549,16,40,.400,16,16,1.000,120,47,91,.516,35,61,.574,12,30,.400,15,22,.682,121
798,GSW,2022-12-03,120,,HOU,W 120-101,240,45,85,.529,20,33,.606,25,52,.481,5,10,.500,120,40,91,.440,37,63,.587,3,28,.107,18,20,.900,101
799,MIA,2022-12-02,120,@,BOS,W 120-116 (OT),265,48,101,.475,37,66,.561,11,35,.314,13,18,.722,120,40,87,.460,25,42,.595,15,45,.333,21,28,.750,116
800,DEN,2022-11-30,120,,HOU,W 120-100,240,44,83,.530,27,51,.529,17,32,.531,15,20,.750,120,37,88,.420,25,47,.532,12,41,.293,14,18,.778,100
801,HOU,2022-11-20,120,,GSW,L 120-127,240,41,90,.456,26,45,.578,15,45,.333,23,27,.852,120,46,86,.535,22,39,.564,24,47,.511,11,15,.733,127
802,WAS,2022-11-16,120,,OKC,L 120-121,240,44,86,.512,27,52,.519,17,34,.500,15,17,.882,120,44,81,.543,28,50,.560,16,31,.516,17,26,.654,121
803,SAC,2022-11-11,120,@,LAL,W 120-114,240,45,87,.517,33,51,.647,12,36,.333,18,21,.857,120,42,88,.477,32,63,.508,10,25,.400,20,26,.769,114
804,CLE,2022-11-09,120,@,SAC,L 120-127,240,46,86,.535,35,60,.583,11,26,.423,17,20,.850,120,40,76,.526,23,37,.622,17,39,.436,30,35,.857,127
805,NYK,2022-11-07,120,@,MIN,W 120-107,240,39,89,.438,20,41,.488,19,48,.396,23,25,.920,120,38,81,.469,27,40,.675,11,41,.268,20,24,.833,107
806,LAL,2022-11-02,120,,NOP,W 120-117 (OT),265,45,98,.459,35,62,.565,10,36,.278,20,23,.870,120,47,102,.461,39,77,.506,8,25,.320,15,21,.714,117
807,CHO,2022-10-29,120,,GSW,W 120-113 (OT),265,43,102,.422,33,71,.465,10,31,.323,24,31,.774,120,44,100,.440,31,56,.554,13,44,.295,12,16,.750,113
808,WAS,2022-10-25,120,,DET,W 120-99,240,44,85,.518,34,52,.654,10,33,.303,22,26,.846,120,36,88,.409,28,60,.467,8,28,.286,19,25,.760,99
809,PHI,2022-10-24,120,,IND,W 120-106,240,38,80,.475,19,37,.514,19,43,.442,25,28,.893,120,38,90,.422,26,46,.565,12,44,.273,18,23,.783,106
810,CHI,2022-10-24,120,,BOS,W 120-102,240,42,87,.483,32,66,.485,10,21,.476,26,29,.897,120,37,100,.370,19,52,.365,18,48,.375,10,12,.833,102
811,ORL,2022-10-22,120,,BOS,L 120-126,240,45,95,.474,30,61,.492,15,34,.441,15,23,.652,120,42,87,.483,23,40,.575,19,47,.404,23,28,.821,126
812,LAC,2023-04-09,119,@,PHO,W 119-114,240,49,100,.490,44,77,.571,5,23,.217,16,24,.667,119,42,99,.424,28,62,.452,14,37,.378,16,22,.727,114
813,GSW,2023-04-07,119,@,SAC,W 119-97,240,41,78,.526,25,42,.595,16,36,.444,21,24,.875,119,38,98,.388,27,59,.458,11,39,.282,10,18,.556,97
814,PHO,2023-04-06,119,,DEN,W 119-115,240,41,79,.519,24,43,.558,17,36,.472,20,25,.800,119,44,83,.530,36,60,.600,8,23,.348,19,23,.826,115
815,SAC,2023-04-05,119,@,DAL,L 119-123,240,46,106,.434,34,69,.493,12,37,.324,15,19,.789,119,44,89,.494,24,45,.533,20,44,.455,15,18,.833,123
816,MEM,2023-04-04,119,,POR,W 119-109,240,42,87,.483,24,39,.615,18,48,.375,17,22,.773,119,42,97,.433,28,55,.509,14,42,.333,11,17,.647,109
817,MIN,2023-03-27,119,@,SAC,W 119-115,240,44,86,.512,35,62,.565,9,24,.375,22,34,.647,119,39,84,.464,34,57,.596,5,27,.185,32,40,.800,115
818,ORL,2023-03-26,119,,BRK,W 119-106,240,45,85,.529,38,63,.603,7,22,.318,22,28,.786,119,37,91,.407,29,56,.518,8,35,.229,24,28,.857,106
819,ATL,2023-03-26,119,,MEM,L 119-123,240,45,98,.459,38,67,.567,7,31,.226,22,26,.846,119,48,89,.539,35,56,.625,13,33,.394,14,19,.737,123
820,NOP,2023-03-21,119,,SAS,W 119-84,240,45,81,.556,35,57,.614,10,24,.417,19,23,.826,119,30,87,.345,17,46,.370,13,41,.317,11,19,.579,84
821,GSW,2023-03-18,119,@,MEM,L 119-133,240,39,91,.429,26,56,.464,13,35,.371,28,34,.824,119,52,95,.547,34,57,.596,18,38,.474,11,17,.647,133
822,GSW,2023-03-17,119,@,ATL,L 119-127,240,47,98,.480,36,58,.621,11,40,.275,14,20,.700,119,47,100,.470,31,59,.525,16,41,.390,17,25,.680,127
823,DEN,2023-03-16,119,@,DET,W 119-100,240,47,89,.528,39,65,.600,8,24,.333,17,25,.680,119,39,85,.459,27,58,.466,12,27,.444,10,18,.556,100
824,MEM,2023-03-15,119,@,MIA,L 119-138,240,46,91,.505,28,45,.622,18,46,.391,9,14,.643,119,49,82,.598,36,53,.679,13,29,.448,27,33,.818,138
825,MIA,2023-03-13,119,,UTA,W 119-115,240,37,79,.468,23,45,.511,14,34,.412,31,36,.861,119,43,90,.478,27,52,.519,16,38,.421,13,18,.722,115
826,PHO,2023-03-11,119,,SAC,L 119-128,240,44,89,.494,31,45,.689,13,44,.295,18,22,.818,119,41,85,.482,26,50,.520,15,35,.429,31,37,.838,128
827,CHI,2023-03-11,119,@,HOU,W 119-111,240,44,86,.512,29,54,.537,15,32,.469,16,22,.727,119,41,85,.482,25,51,.490,16,34,.471,13,17,.765,111
828,UTA,2023-03-11,119,@,CHO,W 119-111,240,46,103,.447,37,71,.521,9,32,.281,18,20,.900,119,40,98,.408,23,58,.397,17,40,.425,14,15,.933,111
829,MIA,2023-03-10,119,,CLE,W 119-115,240,42,82,.512,28,53,.528,14,29,.483,21,23,.913,119,40,86,.465,22,43,.512,18,43,.419,17,21,.810,115
830,POR,2023-03-10,119,@,PHI,L 119-120,240,42,80,.525,27,44,.614,15,36,.417,20,30,.667,119,43,83,.518,32,53,.604,11,30,.367,23,29,.793,120
831,WAS,2023-03-07,119,@,DET,W 119-117,240,47,81,.580,35,56,.625,12,25,.480,13,17,.765,119,43,84,.512,30,54,.556,13,30,.433,18,22,.818,117
832,UTA,2023-03-05,119,@,OKC,L 119-129,240,43,88,.489,32,51,.627,11,37,.297,22,27,.815,119,44,87,.506,30,50,.600,14,37,.378,27,33,.818,129
833,ORL,2023-03-05,119,,POR,L 119-122,240,42,84,.500,31,53,.585,11,31,.355,24,31,.774,119,39,83,.470,23,36,.639,16,47,.340,28,32,.875,122
834,WAS,2023-03-02,119,,TOR,W 119-108,240,43,84,.512,29,54,.537,14,30,.467,19,24,.792,119,41,92,.446,32,59,.542,9,33,.273,17,17,1.000,108
835,PHI,2023-03-01,119,@,MIA,W 119-96,240,41,83,.494,26,44,.591,15,39,.385,22,22,1.000,119,34,78,.436,27,49,.551,7,29,.241,21,23,.913,96
836,WAS,2023-02-28,119,@,ATL,W 119-116,240,48,97,.495,42,76,.553,6,21,.286,17,20,.850,119,43,93,.462,30,58,.517,13,35,.371,17,19,.895,116
837,CLE,2023-02-24,119,@,ATL,L 119-136,240,40,88,.455,27,53,.509,13,35,.371,26,29,.897,119,50,85,.588,35,57,.614,15,28,.536,21,23,.913,136
838,OKC,2023-02-23,119,@,UTA,L 119-120 (OT),265,45,112,.402,37,75,.493,8,37,.216,21,27,.778,119,42,100,.420,29,52,.558,13,48,.271,23,27,.852,120
839,TOR,2023-02-12,119,,DET,W 119-118,240,42,87,.483,31,57,.544,11,30,.367,24,36,.667,119,40,79,.506,27,45,.600,13,34,.382,25,32,.781,118
840,BOS,2023-02-12,119,,MEM,W 119-109,240,39,88,.443,18,37,.486,21,51,.412,20,26,.769,119,42,84,.500,30,50,.600,12,34,.353,13,21,.619,109
841,DEN,2023-02-11,119,@,CHO,W 119-105,240,50,99,.505,45,76,.592,5,23,.217,14,17,.824,119,40,85,.471,32,53,.604,8,32,.250,17,29,.586,105
842,MIL,2023-02-10,119,@,LAC,W 119-106,240,45,90,.500,28,51,.549,17,39,.436,12,16,.750,119,42,85,.494,31,52,.596,11,33,.333,11,14,.786,106
843,PHI,2023-02-10,119,,NYK,W 119-108,240,44,84,.524,30,46,.652,14,38,.368,17,22,.773,119,43,81,.531,32,49,.653,11,32,.344,11,16,.688,108
844,ORL,2023-02-05,119,@,CHO,W 119-113,240,42,91,.462,34,68,.500,8,23,.348,27,30,.900,119,45,83,.542,33,50,.660,12,33,.364,11,23,.478,113
845,GSW,2023-02-04,119,,DAL,W 119-113,240,45,82,.549,31,47,.660,14,35,.400,15,19,.789,119,39,85,.459,25,45,.556,14,40,.350,21,27,.778,113
846,SAC,2023-02-01,119,@,SAS,W 119-109,240,48,90,.533,40,63,.635,8,27,.296,15,19,.789,119,48,88,.545,40,64,.625,8,24,.333,5,7,.714,109
847,MIN,2023-02-01,119,,GSW,W 119-114 (OT),265,46,106,.434,32,56,.571,14,50,.280,13,24,.542,119,38,91,.418,27,56,.482,11,35,.314,27,34,.794,114
848,ORL,2023-01-30,119,@,PHI,W 119-109,240,42,99,.424,31,70,.443,11,29,.379,24,30,.800,119,40,85,.471,29,55,.527,11,30,.367,18,23,.783,109
849,DEN,2023-01-28,119,@,PHI,L 119-126,240,44,81,.543,30,47,.638,14,34,.412,17,20,.850,119,46,89,.517,28,54,.519,18,35,.514,16,24,.667,126
850,HOU,2023-01-23,119,,MIN,W 119-114,240,44,88,.500,33,58,.569,11,30,.367,20,30,.667,119,41,91,.451,25,49,.510,16,42,.381,16,22,.727,114
851,IND,2023-01-16,119,@,MIL,L 119-132,240,43,84,.512,24,44,.545,19,40,.475,14,15,.933,119,48,91,.527,25,45,.556,23,46,.500,13,15,.867,132
852,SAS,2023-01-15,119,,SAC,L 119-132,240,48,93,.516,38,67,.567,10,26,.385,13,20,.650,119,49,89,.551,35,59,.593,14,30,.467,20,25,.800,132
853,DEN,2023-01-15,119,,ORL,W 119-116,240,48,89,.539,35,50,.700,13,39,.333,10,19,.526,119,41,84,.488,34,55,.618,7,29,.241,27,34,.794,116
854,DAL,2023-01-14,119,@,POR,L 119-136,240,43,82,.524,21,36,.583,22,46,.478,11,19,.579,119,49,88,.557,32,47,.681,17,41,.415,21,22,.955,136
855,CLE,2023-01-12,119,@,POR,W 119-113,240,44,89,.494,37,67,.552,7,22,.318,24,31,.774,119,40,78,.513,29,45,.644,11,33,.333,22,29,.759,113
856,DAL,2023-01-12,119,@,LAL,W 119-115 (2OT),290,48,96,.500,34,54,.630,14,42,.333,9,17,.529,119,44,112,.393,34,71,.479,10,41,.244,17,27,.630,115
857,NYK,2023-01-11,119,,IND,W 119-113,240,38,84,.452,23,42,.548,15,42,.357,28,33,.848,119,43,90,.478,31,51,.608,12,39,.308,15,21,.714,113
858,NOP,2023-01-04,119,,HOU,W 119-108,240,41,89,.461,27,51,.529,14,38,.368,23,26,.885,119,39,88,.443,27,50,.540,12,38,.316,18,27,.667,108
859,GSW,2023-01-04,119,,DET,L 119-122,240,45,87,.517,30,47,.638,15,40,.375,14,15,.933,119,45,92,.489,29,56,.518,16,36,.444,16,23,.696,122
860,MIA,2022-12-30,119,@,DEN,L 119-124,240,39,87,.448,25,52,.481,14,35,.400,27,30,.900,119,45,76,.592,28,48,.583,17,28,.607,17,22,.773,124
861,WAS,2022-12-30,119,@,ORL,W 119-100,240,42,75,.560,27,40,.675,15,35,.429,20,25,.800,119,42,100,.420,37,73,.507,5,27,.185,11,16,.688,100
862,MEM,2022-12-29,119,@,TOR,W 119-106,240,48,95,.505,35,66,.530,13,29,.448,10,14,.714,119,39,96,.406,29,68,.426,10,28,.357,18,24,.750,106
863,CHI,2022-12-28,119,,MIL,W 119-113 (OT),265,42,92,.457,33,69,.478,9,23,.391,26,30,.867,119,41,110,.373,32,66,.485,9,44,.205,22,32,.688,113
864,NOP,2022-12-28,119,,MIN,W 119-118,240,39,81,.481,28,58,.483,11,23,.478,30,43,.698,119,42,83,.506,32,54,.593,10,29,.345,24,32,.750,118
865,PHI,2022-12-25,119,@,NYK,W 119-112,240,39,77,.506,21,38,.553,18,39,.462,23,29,.793,119,43,90,.478,31,58,.534,12,32,.375,14,17,.824,112
866,PHI,2022-12-23,119,,LAC,W 119-114,240,47,88,.534,35,59,.593,12,29,.414,13,14,.929,119,41,81,.506,27,43,.628,14,38,.368,18,23,.783,114
867,NOP,2022-12-19,119,,MIL,L 119-128,240,42,99,.424,24,54,.444,18,45,.400,17,24,.708,119,45,81,.556,32,41,.780,13,40,.325,25,31,.806,128
868,SAC,2022-12-19,119,,CHO,L 119-125,240,45,95,.474,33,62,.532,12,33,.364,17,31,.548,119,49,95,.516,39,64,.609,10,31,.323,17,23,.739,125
869,LAL,2022-12-18,119,,WAS,W 119-117,240,46,92,.500,35,65,.538,11,27,.407,16,22,.727,119,44,95,.463,34,56,.607,10,39,.256,19,24,.792,117
870,DEN,2022-12-18,119,,CHO,W 119-115,240,43,94,.457,32,61,.525,11,33,.333,22,34,.647,119,41,96,.427,29,58,.500,12,38,.316,21,23,.913,115
871,BRK,2022-12-16,119,@,TOR,W 119-116,240,46,76,.605,37,50,.740,9,26,.346,18,23,.783,119,41,84,.488,32,60,.533,9,24,.375,25,29,.862,116
872,GSW,2022-12-14,119,@,IND,L 119-125,240,40,86,.465,26,53,.491,14,33,.424,25,29,.862,119,44,87,.506,28,48,.583,16,39,.410,21,25,.840,125
873,LAC,2022-12-05,119,@,CHO,W 119-117,240,45,93,.484,30,57,.526,15,36,.417,14,21,.667,119,47,98,.480,35,64,.547,12,34,.353,11,17,.647,117
874,WAS,2022-12-04,119,,LAL,L 119-130,240,49,105,.467,39,66,.591,10,39,.256,11,15,.733,119,52,96,.542,42,70,.600,10,26,.385,16,22,.727,130
875,IND,2022-12-02,119,@,UTA,L 119-139,240,40,92,.435,28,58,.483,12,34,.353,27,33,.818,119,46,83,.554,31,49,.633,15,34,.441,32,37,.865,139
876,GSW,2022-12-02,119,,CHI,W 119-111,240,42,87,.483,22,37,.595,20,50,.400,15,23,.652,119,43,93,.462,34,66,.515,9,27,.333,16,24,.667,111
877,OKC,2022-11-30,119,,SAS,W 119-111,240,48,94,.511,39,67,.582,9,27,.333,14,21,.667,119,41,92,.446,31,55,.564,10,37,.270,19,25,.760,111
878,CHI,2022-11-25,119,@,OKC,L 119-123 (OT),265,44,101,.436,32,68,.471,12,33,.364,19,23,.826,119,44,95,.463,37,66,.561,7,29,.241,28,32,.875,123
879,OKC,2022-11-21,119,,NYK,L 119-129,240,43,88,.489,35,64,.547,8,24,.333,25,32,.781,119,51,97,.526,40,63,.635,11,34,.324,16,20,.800,129
880,MIL,2022-11-21,119,,POR,W 119-111,240,47,86,.547,38,58,.655,9,28,.321,16,25,.640,119,44,93,.473,36,64,.563,8,29,.276,15,19,.789,111
881,LAC,2022-11-19,119,,SAS,W 119-97,240,44,81,.543,23,41,.561,21,40,.525,10,19,.526,119,36,87,.414,29,61,.475,7,26,.269,18,21,.857,97
882,GSW,2022-11-16,119,@,PHO,L 119-130,240,42,92,.457,24,50,.480,18,42,.429,17,17,1.000,119,44,86,.512,23,46,.500,21,40,.525,21,25,.840,130
883,NOP,2022-11-12,119,,HOU,W 119-106,240,42,86,.488,34,57,.596,8,29,.276,27,31,.871,119,40,79,.506,28,43,.651,12,36,.333,14,18,.778,106
884,ATL,2022-11-09,119,,UTA,L 119-125,240,51,109,.468,43,81,.531,8,28,.286,9,11,.818,119,44,94,.468,27,55,.491,17,39,.436,20,24,.833,125
885,IND,2022-11-09,119,,DEN,L 119-122,240,45,96,.469,31,54,.574,14,42,.333,15,19,.789,119,43,88,.489,31,60,.517,12,28,.429,24,26,.923,122
886,LAC,2022-11-07,119,,CLE,W 119-117,240,40,79,.506,23,41,.561,17,38,.447,22,28,.786,119,43,83,.518,27,50,.540,16,33,.485,15,21,.714,117
887,CHI,2022-11-04,119,@,BOS,L 119-123,240,43,83,.518,32,55,.582,11,28,.393,22,25,.880,119,41,83,.494,32,52,.615,9,31,.290,32,39,.821,123
888,SAC,2022-10-29,119,,MIA,W 119-113,240,42,76,.553,28,45,.622,14,31,.452,21,29,.724,119,38,89,.427,27,61,.443,11,28,.393,26,31,.839,113
889,MIL,2022-10-28,119,,NYK,W 119-108,240,42,109,.385,29,64,.453,13,45,.289,22,27,.815,119,37,93,.398,25,58,.431,12,35,.343,22,32,.688,108
890,TOR,2022-10-26,119,,PHI,W 119-109,240,46,84,.548,30,47,.638,16,37,.432,11,14,.786,119,40,79,.506,24,43,.558,16,36,.444,13,19,.684,109
891,MIA,2022-10-26,119,@,POR,W 119-98,240,44,87,.506,29,49,.592,15,38,.395,16,19,.842,119,34,78,.436,22,41,.537,12,37,.324,18,26,.692,98
892,UTA,2023-04-08,118,,DEN,W 118-114,240,44,100,.440,33,65,.508,11,35,.314,19,23,.826,118,41,90,.456,26,44,.591,15,46,.326,17,24,.708,114
893,CLE,2023-04-06,118,@,ORL,W 118-94,240,46,88,.523,28,50,.560,18,38,.474,8,9,.889,118,33,83,.398,20,44,.455,13,39,.333,15,19,.789,94
894,LAL,2023-04-05,118,@,LAC,L 118-125,240,45,89,.506,33,60,.550,12,29,.414,16,24,.667,118,43,82,.524,27,46,.587,16,36,.444,23,27,.852,125
895,MIA,2023-04-04,118,@,DET,W 118-105,240,41,80,.513,28,44,.636,13,36,.361,23,26,.885,118,36,73,.493,25,45,.556,11,28,.393,22,27,.815,105
896,NYK,2023-04-02,118,,WAS,W 118-109,240,46,88,.523,33,56,.589,13,32,.406,13,18,.722,118,39,79,.494,23,42,.548,16,37,.432,15,18,.833,109
897,OKC,2023-04-02,118,,PHO,L 118-128,240,36,88,.409,25,56,.446,11,32,.344,35,41,.854,118,46,81,.568,33,47,.702,13,34,.382,23,28,.821,128
898,CLE,2023-03-28,118,@,ATL,L 118-120,240,47,93,.505,38,68,.559,9,25,.360,15,22,.682,118,41,89,.461,29,62,.468,12,27,.444,26,33,.788,120
899,OKC,2023-03-26,118,@,POR,W 118-112,240,41,94,.436,29,59,.492,12,35,.343,24,28,.857,118,39,82,.476,25,50,.500,14,32,.438,20,27,.741,112
900,CHI,2023-03-26,118,@,LAL,W 118-108,240,47,87,.540,33,56,.589,14,31,.452,10,13,.769,118,38,75,.507,25,39,.641,13,36,.361,19,28,.679,108
901,TOR,2023-03-24,118,,DET,W 118-97,240,41,92,.446,28,55,.509,13,37,.351,23,29,.793,118,34,73,.466,28,48,.583,6,25,.240,23,30,.767,97
902,DEN,2023-03-22,118,@,WAS,W 118-104,240,42,83,.506,27,51,.529,15,32,.469,19,21,.905,118,44,87,.506,40,61,.656,4,26,.154,12,16,.750,104
903,IND,2023-03-22,118,@,TOR,W 118-114,240,43,77,.558,32,56,.571,11,21,.524,21,25,.840,118,39,89,.438,32,55,.582,7,34,.206,29,39,.744,114
904,ATL,2023-03-19,118,@,SAS,L 118-126,240,48,101,.475,43,79,.544,5,22,.227,17,20,.850,118,51,94,.543,37,66,.561,14,28,.500,10,16,.625,126
905,MIL,2023-03-19,118,,TOR,W 118-111,240,43,82,.524,27,37,.730,16,45,.356,16,21,.762,118,44,99,.444,30,65,.462,14,34,.412,9,12,.750,111
906,UTA,2023-03-18,118,,BOS,W 118-117,240,42,97,.433,25,56,.446,17,41,.415,17,22,.773,118,42,88,.477,20,37,.541,22,51,.431,11,16,.688,117
907,WAS,2023-03-18,118,,SAC,L 118-132,240,41,91,.451,28,55,.509,13,36,.361,23,27,.852,118,48,86,.558,26,49,.531,22,37,.595,14,23,.609,132
908,PHI,2023-03-15,118,@,CLE,W 118-109,240,39,75,.520,22,39,.564,17,36,.472,23,27,.852,118,40,85,.471,26,44,.591,14,41,.341,15,22,.682,109
909,MIL,2023-03-09,118,,BRK,W 118-113,240,44,104,.423,25,54,.463,19,50,.380,11,14,.786,118,41,104,.394,27,68,.397,14,36,.389,17,17,1.000,113
910,BRK,2023-03-07,118,@,HOU,W 118-96,240,40,81,.494,25,41,.610,15,40,.375,23,29,.793,118,36,83,.434,29,57,.509,7,26,.269,17,24,.708,96
911,DEN,2023-03-06,118,,TOR,W 118-113,240,43,86,.500,30,53,.566,13,33,.394,19,23,.826,118,43,86,.500,33,59,.559,10,27,.370,17,20,.850,113
912,CLE,2023-03-06,118,,BOS,W 118-114 (OT),265,43,96,.448,31,62,.500,12,34,.353,20,25,.800,118,42,101,.416,26,53,.491,16,48,.333,14,21,.667,114
913,BRK,2023-03-01,118,@,NYK,L 118-142,240,42,90,.467,27,51,.529,15,39,.385,19,20,.950,118,54,89,.607,34,54,.630,20,35,.571,14,21,.667,142
914,MIL,2023-02-28,118,@,BRK,W 118-104,240,50,102,.490,36,65,.554,14,37,.378,4,12,.333,118,36,83,.434,24,47,.511,12,36,.333,20,25,.800,104
915,CLE,2023-02-26,118,,TOR,W 118-93,240,44,84,.524,26,48,.542,18,36,.500,12,14,.857,118,36,93,.387,27,68,.397,9,25,.360,12,15,.800,93
916,UTA,2023-02-25,118,,SAS,W 118-102,240,43,92,.467,33,64,.516,10,28,.357,22,28,.786,118,38,97,.392,29,63,.460,9,34,.265,17,21,.810,102
917,PHI,2023-02-15,118,,CLE,W 118-112,240,39,78,.500,26,51,.510,13,27,.481,27,29,.931,118,41,82,.500,31,52,.596,10,30,.333,20,25,.800,112
918,DEN,2023-02-15,118,,DAL,W 118-109,240,48,84,.571,37,53,.698,11,31,.355,11,15,.733,118,39,84,.464,25,45,.556,14,39,.359,17,20,.850,109
919,DET,2023-02-12,118,@,TOR,L 118-119,240,40,79,.506,27,45,.600,13,34,.382,25,32,.781,118,42,87,.483,31,57,.544,11,30,.367,24,36,.667,119
920,CLE,2023-02-10,118,@,NOP,W 118-107,240,48,85,.565,38,57,.667,10,28,.357,12,15,.800,118,39,82,.476,30,58,.517,9,24,.375,20,25,.800,107
921,UTA,2023-02-08,118,,MIN,L 118-143,240,44,105,.419,32,71,.451,12,34,.353,18,21,.857,118,56,98,.571,33,55,.600,23,43,.535,8,8,1.000,143
922,WAS,2023-02-08,118,,CHO,W 118-104,240,44,87,.506,29,50,.580,15,37,.405,15,17,.882,118,39,93,.419,30,62,.484,9,31,.290,17,21,.810,104
923,DET,2023-02-03,118,,CHO,W 118-112,240,44,86,.512,30,54,.556,14,32,.438,16,23,.696,118,40,90,.444,31,56,.554,9,34,.265,23,30,.767,112
924,SAC,2023-01-30,118,@,MIN,W 118-111 (OT),265,47,99,.475,38,69,.551,9,30,.300,15,22,.682,118,43,92,.467,31,53,.585,12,39,.308,13,25,.520,111
925,SAS,2023-01-28,118,,PHO,L 118-128 (OT),265,48,109,.440,38,80,.475,10,29,.345,12,17,.706,118,50,103,.485,42,79,.532,8,24,.333,20,26,.769,128
926,ATL,2023-01-21,118,,CHO,L 118-122,240,45,83,.542,34,58,.586,11,25,.440,17,20,.850,118,45,89,.506,32,55,.582,13,34,.382,19,22,.864,122
927,ORL,2023-01-21,118,@,WAS,L 118-138,240,42,90,.467,28,56,.500,14,34,.412,20,24,.833,118,51,95,.537,33,61,.541,18,34,.529,18,25,.720,138
928,SAC,2023-01-20,118,,OKC,W 118-113,240,41,87,.471,29,49,.592,12,38,.316,24,28,.857,118,45,93,.484,29,53,.547,16,40,.400,7,11,.636,113
929,GSW,2023-01-19,118,@,BOS,L 118-121 (OT),265,40,100,.400,22,48,.458,18,52,.346,20,23,.870,118,43,108,.398,30,67,.448,13,41,.317,22,30,.733,121
930,MIN,2023-01-18,118,@,DEN,L 118-122,240,42,81,.519,30,49,.612,12,32,.375,22,28,.786,118,45,85,.529,37,64,.578,8,21,.381,24,32,.750,122
931,WAS,2023-01-16,118,,GSW,L 118-127,240,42,86,.488,28,51,.549,14,35,.400,20,23,.870,118,45,91,.495,27,47,.574,18,44,.409,19,21,.905,127
932,CHO,2023-01-16,118,,BOS,L 118-130,240,41,90,.456,28,59,.475,13,31,.419,23,30,.767,118,43,87,.494,23,44,.523,20,43,.465,24,25,.960,130
933,GSW,2023-01-15,118,@,CHI,L 118-132,240,41,83,.494,20,32,.625,21,51,.412,15,22,.682,118,48,95,.505,33,56,.589,15,39,.385,21,24,.875,132
934,PHI,2023-01-14,118,@,UTA,W 118-117,240,40,89,.449,23,50,.460,17,39,.436,21,26,.808,118,43,90,.478,31,50,.620,12,40,.300,19,23,.826,117
935,MIN,2023-01-11,118,@,DET,L 118-135,240,43,88,.489,27,55,.491,16,33,.485,16,21,.762,118,48,80,.600,31,48,.646,17,32,.531,22,28,.786,135
936,UTA,2023-01-08,118,@,MEM,L 118-123,240,45,88,.511,35,56,.625,10,32,.313,18,22,.818,118,46,102,.451,31,64,.484,15,38,.395,16,22,.727,123
937,UTA,2023-01-07,118,@,CHI,L 118-126,240,46,93,.495,34,52,.654,12,41,.293,14,18,.778,118,44,83,.530,31,55,.564,13,28,.464,25,32,.781,126
938,MEM,2023-01-01,118,,SAC,W 118-108,240,46,100,.460,36,68,.529,10,32,.313,16,24,.667,118,39,96,.406,24,53,.453,15,43,.349,15,15,1.000,108
939,WAS,2023-01-01,118,@,MIL,W 118-95,240,50,94,.532,43,67,.642,7,27,.259,11,16,.688,118,34,96,.354,21,47,.447,13,49,.265,14,15,.933,95
940,GSW,2022-12-30,118,,POR,W 118-112,240,42,91,.462,25,48,.521,17,43,.395,17,21,.810,118,42,91,.462,30,52,.577,12,39,.308,16,23,.696,112
941,DET,2022-12-30,118,@,CHI,L 118-132,240,41,86,.477,24,47,.511,17,39,.436,19,24,.792,118,53,92,.576,41,65,.631,12,27,.444,14,15,.933,132
942,MIN,2022-12-28,118,@,NOP,L 118-119,240,42,83,.506,32,54,.593,10,29,.345,24,32,.750,118,39,81,.481,28,58,.483,11,23,.478,30,43,.698,119
943,CHI,2022-12-26,118,,HOU,L 118-133,240,45,92,.489,32,57,.561,13,35,.371,15,21,.714,118,50,90,.556,33,46,.717,17,44,.386,16,22,.727,133
944,MIL,2022-12-25,118,@,BOS,L 118-139,240,42,84,.500,29,48,.604,13,36,.361,21,27,.778,118,50,85,.588,31,46,.674,19,39,.487,20,25,.800,139
945,TOR,2022-12-23,118,@,CLE,W 118-107,240,42,84,.500,23,47,.489,19,37,.514,15,18,.833,118,39,76,.513,28,43,.651,11,33,.333,18,30,.600,107
946,CHI,2022-12-23,118,@,NYK,W 118-117,240,45,93,.484,31,62,.500,14,31,.452,14,18,.778,118,43,86,.500,27,51,.529,16,35,.457,15,26,.577,117
947,BRK,2022-12-23,118,,MIL,W 118-100,240,46,93,.495,32,61,.525,14,32,.438,12,13,.923,118,37,84,.440,28,47,.596,9,37,.243,17,22,.773,100
948,PHO,2022-12-17,118,,NOP,W 118-114,240,39,83,.470,24,42,.571,15,41,.366,25,35,.714,118,45,77,.584,31,47,.660,14,30,.467,10,13,.769,114
949,PHI,2022-12-16,118,,GSW,W 118-106,240,39,85,.459,24,47,.511,15,38,.395,25,31,.806,118,39,94,.415,22,51,.431,17,43,.395,11,13,.846,106
950,CLE,2022-12-16,118,,IND,W 118-112,240,38,76,.500,24,45,.533,14,31,.452,28,32,.875,118,42,80,.525,31,44,.705,11,36,.306,17,19,.895,112
951,LAL,2022-12-13,118,,BOS,L 118-122 (OT),265,44,93,.473,36,64,.563,8,29,.276,22,30,.733,118,46,104,.442,27,56,.482,19,48,.396,11,16,.688,122
952,MIN,2022-12-10,118,@,POR,L 118-124,240,45,83,.542,35,60,.583,10,23,.435,18,24,.750,118,43,83,.518,30,49,.612,13,34,.382,25,28,.893,124
953,MIN,2022-12-09,118,@,UTA,W 118-108,240,42,79,.532,28,44,.636,14,35,.400,20,26,.769,118,39,90,.433,26,46,.565,13,44,.295,17,24,.708,108
954,SAS,2022-12-08,118,,HOU,W 118-109,240,46,83,.554,33,47,.702,13,36,.361,13,15,.867,118,44,98,.449,34,69,.493,10,29,.345,11,15,.733,109
955,LAC,2022-11-29,118,@,POR,W 118-112,240,41,89,.461,28,58,.483,13,31,.419,23,28,.821,118,42,90,.467,25,55,.455,17,35,.486,11,15,.733,112
956,HOU,2022-11-26,118,,OKC,W 118-105,240,45,86,.523,27,50,.540,18,36,.500,10,14,.714,118,38,97,.392,28,53,.528,10,44,.227,19,23,.826,105
957,UTA,2022-11-25,118,@,GSW,L 118-129,240,46,97,.474,35,52,.673,11,45,.244,15,17,.882,118,52,101,.515,32,56,.571,20,45,.444,5,6,.833,129
958,CHI,2022-11-23,118,@,MIL,W 118-113,240,43,87,.494,25,45,.556,18,42,.429,14,18,.778,118,41,90,.456,29,52,.558,12,38,.316,19,25,.760,113
959,UTA,2022-11-19,118,@,POR,W 118-113,240,42,91,.462,28,52,.538,14,39,.359,20,23,.870,118,39,83,.470,26,41,.634,13,42,.310,22,27,.815,113
960,NYK,2022-11-15,118,@,UTA,W 118-111,240,44,93,.473,33,61,.541,11,32,.344,19,25,.760,118,36,83,.434,22,40,.550,14,43,.326,25,30,.833,111
961,IND,2022-11-12,118,,TOR,W 118-104,240,41,82,.500,22,39,.564,19,43,.442,17,23,.739,118,37,94,.394,30,59,.508,7,35,.200,23,29,.793,104
962,NYK,2022-11-05,118,,BOS,L 118-133,240,46,90,.511,35,63,.556,11,27,.407,15,16,.938,118,47,88,.534,20,37,.541,27,51,.529,12,12,1.000,133
963,PHI,2022-10-31,118,@,WAS,W 118-111,240,46,83,.554,34,53,.642,12,30,.400,14,20,.700,118,38,81,.469,28,56,.500,10,25,.400,25,26,.962,111
964,OKC,2022-10-27,118,,LAC,W 118-110,240,47,95,.495,30,57,.526,17,38,.447,7,8,.875,118,44,82,.537,35,54,.648,9,28,.321,13,18,.722,110
965,ATL,2022-10-26,118,@,DET,W 118-113,240,45,91,.495,37,69,.536,8,22,.364,20,25,.800,118,42,91,.462,28,59,.475,14,32,.438,15,22,.682,113
966,DAL,2023-04-09,117,,SAS,L 117-138,240,46,108,.426,29,55,.527,17,53,.321,8,16,.500,117,51,104,.490,36,66,.545,15,38,.395,21,30,.700,138
967,UTA,2023-04-09,117,@,LAL,L 117-128,240,51,101,.505,41,66,.621,10,35,.286,5,6,.833,117,47,97,.485,29,52,.558,18,45,.400,16,21,.762,128
968,CLE,2023-04-04,117,@,ORL,W 117-113,240,42,84,.500,27,53,.509,15,31,.484,18,20,.900,117,45,89,.506,35,66,.530,10,23,.435,13,17,.765,113
969,MIL,2023-04-02,117,,PHI,W 117-104,240,46,80,.575,36,52,.692,10,28,.357,15,21,.714,117,40,87,.460,28,51,.549,12,36,.333,12,13,.923,104
970,OKC,2023-03-31,117,@,IND,L 117-121,240,42,88,.477,38,58,.655,4,30,.133,29,34,.853,117,45,98,.459,33,57,.579,12,41,.293,19,28,.679,121
971,PHI,2023-03-31,117,,TOR,W 117-110,240,41,73,.562,29,42,.690,12,31,.387,23,25,.920,117,42,84,.500,34,58,.586,8,26,.308,18,23,.783,110
972,SAS,2023-03-29,117,,UTA,L 117-128,240,45,95,.474,35,60,.583,10,35,.286,17,21,.810,117,49,90,.544,37,59,.627,12,31,.387,18,20,.900,128
973,PHO,2023-03-27,117,@,UTA,W 117-103,240,43,101,.426,32,65,.492,11,36,.306,20,22,.909,117,38,86,.442,29,50,.580,9,36,.250,18,27,.667,103
974,DET,2023-03-27,117,,MIL,L 117-126,240,41,92,.446,34,68,.500,7,24,.292,28,36,.778,117,45,95,.474,31,50,.620,14,45,.311,22,26,.846,126
975,CHO,2023-03-24,117,@,DAL,W 117-109,240,43,89,.483,32,61,.525,11,28,.393,20,27,.741,117,41,84,.488,32,48,.667,9,36,.250,18,24,.750,109
976,NOP,2023-03-19,117,@,HOU,W 117-107,240,42,85,.494,29,54,.537,13,31,.419,20,24,.833,117,31,76,.408,22,43,.512,9,33,.273,36,38,.947,107
977,LAC,2023-03-19,117,@,POR,W 117-102,240,43,94,.457,31,66,.470,12,28,.429,19,23,.826,117,37,82,.451,31,53,.585,6,29,.207,22,24,.917,102
978,BOS,2023-03-18,117,@,UTA,L 117-118,240,42,88,.477,20,37,.541,22,51,.431,11,16,.688,117,42,97,.433,25,56,.446,17,41,.415,17,22,.773,118
979,CLE,2023-03-17,117,,WAS,W 117-94,240,48,87,.552,44,68,.647,4,19,.211,17,22,.773,117,35,76,.461,27,53,.509,8,23,.348,16,20,.800,94
980,SAC,2023-03-15,117,@,CHI,W 117-114,240,38,78,.487,20,36,.556,18,42,.429,23,29,.793,117,38,97,.392,22,55,.400,16,42,.381,22,25,.880,114
981,WAS,2023-03-14,117,,DET,W 117-97,240,44,85,.518,37,53,.698,7,32,.219,22,22,1.000,117,38,99,.384,28,65,.431,10,34,.294,11,12,.917,97
982,DET,2023-03-13,117,,IND,W 117-97,240,48,100,.480,34,64,.531,14,36,.389,7,10,.700,117,36,86,.419,26,52,.500,10,34,.294,15,24,.625,97
983,NYK,2023-03-09,117,@,SAC,L 117-122,240,42,101,.416,29,51,.569,13,50,.260,20,31,.645,117,44,84,.524,34,52,.654,10,32,.313,24,32,.750,122
984,CHI,2023-03-08,117,@,DEN,W 117-96,240,46,89,.517,38,65,.585,8,24,.333,17,18,.944,117,37,88,.420,22,48,.458,15,40,.375,7,15,.467,96
985,PHI,2023-03-07,117,@,MIN,W 117-94,240,40,81,.494,25,56,.446,15,25,.600,22,23,.957,117,34,86,.395,23,50,.460,11,36,.306,15,21,.714,94
986,DET,2023-03-07,117,,WAS,L 117-119,240,43,84,.512,30,54,.556,13,30,.433,18,22,.818,117,47,81,.580,35,56,.625,12,25,.480,13,17,.765,119
987,MIL,2023-03-05,117,@,WAS,W 117-111,240,39,83,.470,17,34,.500,22,49,.449,17,22,.773,117,46,108,.426,38,77,.494,8,31,.258,11,12,.917,111
988,MIA,2023-03-04,117,,ATL,W 117-109,240,42,83,.506,29,48,.604,13,35,.371,20,23,.870,117,37,79,.468,28,49,.571,9,30,.300,26,30,.867,109
989,ORL,2023-03-03,117,@,CHO,W 117-106,240,46,86,.535,36,60,.600,10,26,.385,15,19,.789,117,38,78,.487,29,54,.537,9,24,.375,21,25,.840,106
990,BOS,2023-03-01,117,,CLE,W 117-113,240,39,78,.500,23,46,.500,16,32,.500,23,28,.821,117,45,92,.489,35,60,.583,10,32,.313,13,21,.619,113
991,OKC,2023-03-01,117,,LAL,L 117-123,240,44,91,.484,33,51,.647,11,40,.275,18,24,.750,117,38,80,.475,22,45,.489,16,35,.457,31,39,.795,123
992,ORL,2023-03-01,117,@,MIL,L 117-139,240,43,94,.457,34,61,.557,9,33,.273,22,29,.759,117,49,94,.521,23,38,.605,26,56,.464,15,19,.789,139
993,CHI,2023-03-01,117,@,DET,W 117-115,240,41,85,.482,29,58,.500,12,27,.444,23,31,.742,117,39,78,.500,25,43,.581,14,35,.400,23,28,.821,115
994,OKC,2023-02-28,117,,SAC,L 117-123,240,43,98,.439,32,63,.508,11,35,.314,20,24,.833,117,43,82,.524,28,40,.700,15,42,.357,22,30,.733,123
995,CHO,2023-02-27,117,,DET,W 117-106,240,43,83,.518,30,57,.526,13,26,.500,18,22,.818,117,42,92,.457,39,66,.591,3,26,.115,19,27,.704,106
996,IND,2023-02-15,117,,CHI,W 117-113,240,39,82,.476,21,39,.538,18,43,.419,21,22,.955,117,41,84,.488,26,49,.531,15,35,.429,16,21,.762,113
997,MEM,2023-02-15,117,,UTA,W 117-111,240,43,107,.402,29,67,.433,14,40,.350,17,25,.680,117,42,91,.462,30,55,.545,12,36,.333,15,19,.789,111
998,IND,2023-02-13,117,,UTA,L 117-123,240,46,91,.505,35,57,.614,11,34,.324,14,20,.700,117,43,85,.506,28,52,.538,15,33,.455,22,25,.880,123
999,CLE,2023-02-13,117,,SAS,W 117-109,240,44,78,.564,35,50,.700,9,28,.321,20,25,.800,117,43,85,.506,35,64,.547,8,21,.381,15,20,.750,109
1000,PHO,2023-02-10,117,@,IND,W 117-104,240,43,93,.462,33,60,.550,10,33,.303,21,24,.875,117,36,85,.424,25,46,.543,11,39,.282,21,28,.750,104
1001,TOR,2023-02-03,117,@,HOU,W 117-111,240,41,90,.456,26,51,.510,15,39,.385,20,27,.741,117,40,80,.500,33,59,.559,7,21,.333,24,33,.727,111
1002,GSW,2023-02-02,117,@,DEN,L 117-134,240,43,85,.506,24,47,.511,19,38,.500,12,19,.632,117,51,90,.567,35,55,.636,16,35,.457,16,21,.762,134
1003,MIA,2023-01-29,117,@,CHO,L 117-122,240,45,93,.484,35,62,.565,10,31,.323,17,23,.739,117,45,83,.542,30,43,.698,15,40,.375,17,22,.773,122
1004,MIN,2023-01-28,117,,SAC,W 117-110,240,42,80,.525,25,43,.581,17,37,.459,16,21,.762,117,37,82,.451,28,49,.571,9,33,.273,27,36,.750,110
1005,HOU,2023-01-28,117,@,DET,W 117-114,240,44,92,.478,36,65,.554,8,27,.296,21,27,.778,117,38,83,.458,24,45,.533,14,38,.368,24,31,.774,114
1006,TOR,2023-01-27,117,@,GSW,L 117-129,240,46,101,.455,34,68,.500,12,33,.364,13,21,.619,117,50,90,.556,32,47,.681,18,43,.419,11,15,.733,129
1007,BOS,2023-01-26,117,,NYK,L 117-120 (OT),265,41,100,.410,25,54,.463,16,46,.348,19,23,.826,117,44,96,.458,31,58,.534,13,38,.342,19,23,.826,120
1008,BRK,2023-01-20,117,@,UTA,W 117-106,240,43,80,.538,25,39,.641,18,41,.439,13,20,.650,117,37,88,.420,21,49,.429,16,39,.410,16,23,.696,106
1009,PHO,2023-01-19,117,,BRK,W 117-112,240,39,85,.459,28,57,.491,11,28,.393,28,41,.683,117,43,82,.524,32,56,.571,11,26,.423,15,25,.600,112
1010,HOU,2023-01-18,117,,CHO,L 117-122,240,46,91,.505,36,59,.610,10,32,.313,15,20,.750,117,48,96,.500,39,60,.650,9,36,.250,17,25,.680,122
1011,NYK,2023-01-15,117,@,DET,W 117-104,240,40,88,.455,28,58,.483,12,30,.400,25,31,.806,117,37,83,.446,19,39,.487,18,44,.409,12,15,.800,104
1012,UTA,2023-01-14,117,,PHI,L 117-118,240,43,90,.478,31,50,.620,12,40,.300,19,23,.826,117,40,89,.449,23,50,.460,17,39,.436,21,26,.808,118
1013,TOR,2023-01-08,117,,POR,W 117-105,240,40,91,.440,28,60,.467,12,31,.387,25,29,.862,117,34,76,.447,25,46,.543,9,30,.300,28,37,.757,105
1014,NOP,2023-01-07,117,@,DAL,L 117-127,240,45,94,.479,40,65,.615,5,29,.172,22,35,.629,117,42,74,.568,29,45,.644,13,29,.448,30,38,.789,127
1015,SAC,2023-01-04,117,,ATL,L 117-120,240,41,88,.466,31,63,.492,10,25,.400,25,27,.926,117,45,84,.536,35,54,.648,10,30,.333,20,22,.909,120
1016,NYK,2023-01-04,117,,SAS,W 117-114,240,45,94,.479,35,63,.556,10,31,.323,17,26,.654,117,41,82,.500,30,54,.556,11,28,.393,21,26,.808,114
1017,SAC,2023-01-03,117,@,UTA,W 117-115,240,46,86,.535,37,54,.685,9,32,.281,16,18,.889,117,38,88,.432,25,44,.568,13,44,.295,26,29,.897,115
1018,BOS,2023-01-03,117,@,OKC,L 117-150,240,40,88,.455,28,48,.583,12,40,.300,25,31,.806,117,58,98,.592,38,58,.655,20,40,.500,14,22,.636,150
1019,CLE,2022-12-26,117,,BRK,L 117-125,240,39,82,.476,26,46,.565,13,36,.361,26,30,.867,117,47,82,.573,29,52,.558,18,30,.600,13,17,.765,125
1020,NYK,2022-12-23,117,,CHI,L 117-118,240,43,86,.500,27,51,.529,16,35,.457,15,26,.577,117,45,93,.484,31,62,.500,14,31,.452,14,18,.778,118
1021,SAS,2022-12-22,117,@,NOP,L 117-126,240,43,90,.478,34,62,.548,9,28,.321,22,27,.815,117,44,91,.484,31,57,.544,13,34,.382,25,27,.926,126
1022,IND,2022-12-21,117,@,BOS,W 117-112,240,46,98,.469,28,59,.475,18,39,.462,7,9,.778,117,39,101,.386,26,60,.433,13,41,.317,21,25,.840,112
1023,WAS,2022-12-18,117,@,LAL,L 117-119,240,44,95,.463,34,56,.607,10,39,.256,19,24,.792,117,46,92,.500,35,65,.538,11,27,.407,16,22,.727,119
1024,ORL,2022-12-16,117,@,BOS,W 117-109,240,42,91,.462,33,58,.569,9,33,.273,24,28,.857,117,35,84,.417,24,38,.632,11,46,.239,28,34,.824,109
1025,DET,2022-12-11,117,,LAL,L 117-124,240,43,93,.462,26,48,.542,17,45,.378,14,17,.824,117,46,84,.548,35,58,.603,11,26,.423,21,27,.778,124
1026,PHO,2022-12-09,117,@,NOP,L 117-128,240,43,86,.500,21,42,.500,22,44,.500,9,13,.692,117,46,90,.511,38,63,.603,8,27,.296,28,35,.800,128
1027,CHO,2022-12-05,117,,LAC,L 117-119,240,47,98,.480,35,64,.547,12,34,.353,11,17,.647,117,45,93,.484,30,57,.526,15,36,.417,14,21,.667,119
1028,MEM,2022-12-02,117,,PHI,W 117-109,240,42,97,.433,31,67,.463,11,30,.367,22,28,.786,117,40,91,.440,26,58,.448,14,33,.424,15,17,.882,109
1029,CHO,2022-12-02,117,,WAS,W 117-116,240,40,95,.421,28,66,.424,12,29,.414,25,31,.806,117,39,86,.453,27,53,.509,12,33,.364,26,35,.743,116
1030,ATL,2022-12-02,117,,DEN,W 117-109,240,49,88,.557,39,60,.650,10,28,.357,9,14,.643,117,45,85,.529,33,53,.623,12,32,.375,7,13,.538,109
1031,NOP,2022-12-02,117,@,SAS,W 117-99,240,40,92,.435,28,50,.560,12,42,.286,25,26,.962,117,38,98,.388,27,59,.458,11,39,.282,12,16,.750,99
1032,SAC,2022-11-28,117,,PHO,L 117-122,240,46,88,.523,37,63,.587,9,25,.360,16,18,.889,117,50,94,.532,40,62,.645,10,32,.313,12,14,.857,122
1033,MIL,2022-11-25,117,,CLE,W 117-102,240,42,83,.506,27,51,.529,15,32,.469,18,25,.720,117,34,87,.391,22,54,.407,12,33,.364,22,26,.846,102
1034,BRK,2022-11-25,117,@,IND,L 117-128,240,47,88,.534,32,47,.681,15,41,.366,8,10,.800,117,43,86,.500,31,52,.596,12,34,.353,30,38,.789,128
1035,BOS,2022-11-18,117,@,NOP,W 117-109,240,41,85,.482,21,39,.538,20,46,.435,15,17,.882,117,43,87,.494,30,52,.577,13,35,.371,10,13,.769,109
1036,POR,2022-11-15,117,,SAS,W 117-110,240,41,79,.519,26,47,.553,15,32,.469,20,26,.769,117,44,85,.518,35,56,.625,9,29,.310,13,17,.765,110
1037,DAL,2022-11-12,117,,POR,W 117-112,240,41,81,.506,27,38,.711,14,43,.326,21,26,.808,117,36,80,.450,23,49,.469,13,31,.419,27,35,.771,112
1038,BOS,2022-11-12,117,@,DET,W 117-108,240,39,91,.429,21,43,.488,18,48,.375,21,24,.875,117,37,89,.416,21,51,.412,16,38,.421,18,21,.857,108
1039,MIA,2022-11-10,117,,CHO,W 117-112 (OT),265,39,90,.433,29,54,.537,10,36,.278,29,36,.806,117,43,88,.489,29,49,.592,14,39,.359,12,20,.600,112
1040,MIN,2022-11-09,117,,PHO,L 117-129,240,41,78,.526,32,51,.627,9,27,.333,26,32,.813,117,47,97,.485,31,62,.500,16,35,.457,19,20,.950,129
1041,ATL,2022-11-07,117,,MIL,W 117-98,240,46,99,.465,35,70,.500,11,29,.379,14,17,.824,117,36,87,.414,23,47,.489,13,40,.325,13,16,.813,98
1042,CLE,2022-11-07,117,@,LAC,L 117-119,240,43,83,.518,27,50,.540,16,33,.485,15,21,.714,117,40,79,.506,23,41,.561,17,38,.447,22,28,.786,119
1043,HOU,2022-11-05,117,@,MIN,L 117-129,240,40,84,.476,24,46,.522,16,38,.421,21,31,.677,117,49,80,.613,34,47,.723,15,33,.455,16,20,.800,129
1044,NOP,2022-11-02,117,@,LAL,L 117-120 (OT),265,47,102,.461,39,77,.506,8,25,.320,15,21,.714,117,45,98,.459,35,62,.565,10,36,.278,20,23,.870,120
1045,OKC,2022-10-29,117,@,DAL,W 117-111 (OT),265,44,89,.494,39,64,.609,5,25,.200,24,31,.774,117,38,95,.400,30,55,.545,8,40,.200,27,34,.794,111
1046,DEN,2022-10-28,117,,UTA,W 117-101,240,39,85,.459,22,48,.458,17,37,.459,22,34,.647,117,38,91,.418,28,52,.538,10,39,.256,15,19,.789,101
1047,WAS,2022-10-28,117,,IND,L 117-127,240,41,86,.477,29,56,.518,12,30,.400,23,28,.821,117,41,81,.506,26,52,.500,15,29,.517,30,33,.909,127
1048,CLE,2022-10-23,117,,WAS,W 117-107 (OT),265,41,96,.427,28,63,.444,13,33,.394,22,25,.880,117,43,87,.494,31,59,.525,12,28,.429,9,15,.600,107
1049,OKC,2022-10-22,117,@,DEN,L 117-122,240,42,94,.447,27,56,.482,15,38,.395,18,23,.783,117,42,85,.494,22,47,.468,20,38,.526,18,31,.581,122
1050,ATL,2022-10-19,117,,HOU,W 117-107,240,45,90,.500,38,65,.585,7,25,.280,20,24,.833,117,42,98,.429,33,63,.524,9,35,.257,14,15,.933,107
1051,PHI,2022-10-18,117,@,BOS,L 117-126,240,40,80,.500,27,46,.587,13,34,.382,24,28,.857,117,46,82,.561,34,47,.723,12,35,.343,22,28,.786,126
1052,WAS,2023-04-05,116,@,ATL,L 116-134,240,45,94,.479,39,66,.591,6,28,.214,20,26,.769,116,43,84,.512,30,54,.556,13,30,.433,35,40,.875,134
1053,CLE,2023-03-31,116,,NYK,L 116-130,240,44,86,.512,27,49,.551,17,37,.459,11,13,.846,116,49,93,.527,32,57,.561,17,36,.472,15,24,.625,130
1054,ORL,2023-03-31,116,@,WAS,W 116-109,240,44,88,.500,36,64,.563,8,24,.333,20,26,.769,116,41,105,.390,24,55,.436,17,50,.340,10,12,.833,109
1055,PHI,2023-03-29,116,,DAL,W 116-108,240,37,80,.463,20,44,.455,17,36,.472,25,30,.833,116,38,83,.458,20,37,.541,18,46,.391,14,18,.778,108
1056,DEN,2023-03-27,116,,PHI,W 116-111,240,43,85,.506,32,53,.604,11,32,.344,19,22,.864,116,43,89,.483,35,59,.593,8,30,.267,17,22,.773,111
1057,UTA,2023-03-24,116,,MIL,L 116-144,240,40,104,.385,29,64,.453,11,40,.275,25,34,.735,116,55,99,.556,33,49,.673,22,50,.440,12,16,.750,144
1058,LAL,2023-03-24,116,,OKC,W 116-111,240,42,91,.462,30,57,.526,12,34,.353,20,28,.714,116,40,92,.435,26,56,.464,14,36,.389,17,19,.895,111
1059,CLE,2023-03-23,116,@,BRK,W 116-114,240,42,89,.472,30,57,.526,12,32,.375,20,26,.769,116,39,81,.481,27,47,.574,12,34,.353,24,27,.889,114
1060,PHI,2023-03-22,116,@,CHI,W 116-91,240,39,82,.476,23,45,.511,16,37,.432,22,26,.846,116,34,83,.410,28,58,.483,6,25,.240,17,22,.773,91
1061,NYK,2023-03-18,116,,DEN,W 116-110,240,41,83,.494,32,51,.627,9,32,.281,25,28,.893,116,43,84,.512,31,51,.608,12,33,.364,12,15,.800,110
1062,PHO,2023-03-16,116,,ORL,W 116-113,240,43,90,.478,30,55,.545,13,35,.371,17,17,1.000,116,43,86,.500,35,58,.603,8,28,.286,19,23,.826,113
1063,MIL,2023-03-14,116,@,PHO,W 116-104,240,40,85,.471,28,46,.609,12,39,.308,24,37,.649,116,41,95,.432,33,72,.458,8,23,.348,14,16,.875,104
1064,MIL,2023-03-11,116,@,GSW,L 116-125 (OT),265,43,100,.430,22,49,.449,21,51,.412,9,11,.818,116,46,112,.411,23,57,.404,23,55,.418,10,11,.909,125
1065,UTA,2023-03-07,116,@,DAL,L 116-120,240,41,92,.446,26,48,.542,15,44,.341,19,25,.760,116,42,89,.472,23,44,.523,19,45,.422,17,22,.773,120
1066,TOR,2023-03-04,116,@,WAS,W 116-109 (OT),265,47,90,.522,35,60,.583,12,30,.400,10,14,.714,116,38,75,.507,24,51,.471,14,24,.583,19,22,.864,109
1067,ATL,2023-02-28,116,,WAS,L 116-119,240,43,93,.462,30,58,.517,13,35,.371,17,19,.895,116,48,97,.495,42,76,.553,6,21,.286,17,20,.850,119
1068,GSW,2023-02-24,116,,HOU,W 116-101,240,37,78,.474,11,24,.458,26,54,.481,16,18,.889,116,36,92,.391,25,57,.439,11,35,.314,18,22,.818,101
1069,SAS,2023-02-23,116,@,DAL,L 116-142,240,45,86,.523,35,61,.574,10,25,.400,16,23,.696,116,46,82,.561,24,40,.600,22,42,.524,28,36,.778,142
1070,POR,2023-02-23,116,@,SAC,L 116-133,240,43,93,.462,27,55,.491,16,38,.421,14,17,.824,116,47,85,.553,33,51,.647,14,34,.412,25,31,.806,133
1071,LAC,2023-02-16,116,@,PHO,W 116-107,240,40,82,.488,29,48,.604,11,34,.324,25,27,.926,116,42,89,.472,31,58,.534,11,31,.355,12,16,.750,107
1072,BRK,2023-02-15,116,,MIA,W 116-105,240,41,77,.532,24,38,.632,17,39,.436,17,20,.850,116,38,83,.458,30,55,.545,8,28,.286,21,29,.724,105
1073,CHO,2023-02-10,116,@,BOS,L 116-127,240,45,93,.484,37,70,.529,8,23,.348,18,26,.692,116,44,89,.494,19,34,.559,25,55,.455,14,17,.824,127
1074,TOR,2023-02-10,116,,UTA,L 116-122,240,41,91,.451,29,57,.509,12,34,.353,22,30,.733,116,47,87,.540,41,63,.651,6,24,.250,22,29,.759,122
1075,ATL,2023-02-09,116,,PHO,W 116-107,240,43,95,.453,33,66,.500,10,29,.345,20,27,.741,116,39,86,.453,32,56,.571,7,30,.233,22,29,.759,107
1076,BRK,2023-02-09,116,,CHI,W 116-105,240,39,91,.429,22,47,.468,17,44,.386,21,25,.840,116,42,91,.462,37,65,.569,5,26,.192,16,21,.762,105
1077,MIA,2023-02-08,116,,IND,W 116-111,240,37,79,.468,31,60,.517,6,19,.316,36,39,.923,116,38,78,.487,23,45,.511,15,33,.455,20,28,.714,111
1078,PHO,2023-02-07,116,@,BRK,W 116-112,240,43,92,.467,34,61,.557,9,31,.290,21,28,.750,116,38,79,.481,29,51,.569,9,28,.321,27,31,.871,112
1079,NOP,2023-02-07,116,,ATL,W 116-107,240,45,91,.495,33,59,.559,12,32,.375,14,21,.667,116,38,85,.447,26,49,.531,12,36,.333,19,25,.760,107
1080,BRK,2023-02-06,116,,LAC,L 116-124,240,41,84,.488,25,53,.472,16,31,.516,18,22,.818,116,44,92,.478,32,62,.516,12,30,.400,24,30,.800,124
1081,PHO,2023-02-04,116,@,DET,W 116-100,240,42,75,.560,31,52,.596,11,23,.478,21,31,.677,116,35,81,.432,19,39,.487,16,42,.381,14,22,.636,100
1082,WAS,2023-02-03,116,,POR,L 116-124,240,42,84,.500,30,51,.588,12,33,.364,20,22,.909,116,43,88,.489,26,47,.553,17,41,.415,21,23,.913,124
1083,IND,2023-01-24,116,,CHI,W 116-110,240,42,99,.424,32,62,.516,10,37,.270,22,28,.786,116,43,88,.489,38,64,.594,5,24,.208,19,25,.760,110
1084,NYK,2023-01-22,116,@,TOR,L 116-125,240,40,82,.488,22,41,.537,18,41,.439,18,26,.692,116,41,90,.456,26,56,.464,15,34,.441,28,35,.800,125
1085,GSW,2023-01-22,116,,BRK,L 116-120,240,41,90,.456,28,58,.483,13,32,.406,21,27,.778,116,43,79,.544,29,52,.558,14,27,.519,20,31,.645,120
1086,WAS,2023-01-18,116,@,NYK,W 116-105,240,42,95,.442,26,53,.491,16,42,.381,16,19,.842,116,40,96,.417,33,70,.471,7,26,.269,18,27,.667,105
1087,SAC,2023-01-18,116,@,LAL,W 116-111,240,43,87,.494,34,57,.596,9,30,.300,21,27,.778,116,43,89,.483,32,55,.582,11,34,.324,14,18,.778,111
1088,ORL,2023-01-15,116,@,DEN,L 116-119,240,41,84,.488,34,55,.618,7,29,.241,27,34,.794,116,48,89,.539,35,50,.700,13,39,.333,10,19,.526,119
1089,PHO,2023-01-13,116,@,MIN,L 116-121,240,41,86,.477,27,63,.429,14,23,.609,20,24,.833,116,47,90,.522,37,62,.597,10,28,.357,17,20,.850,121
1090,NOP,2023-01-13,116,@,DET,W 116-110,240,42,86,.488,31,55,.564,11,31,.355,21,30,.700,116,43,90,.478,36,60,.600,7,30,.233,17,24,.708,110
1091,UTA,2023-01-10,116,,CLE,W 116-114,240,38,87,.437,28,51,.549,10,36,.278,30,37,.811,116,42,90,.467,32,53,.604,10,37,.270,20,24,.833,114
1092,DET,2023-01-10,116,@,PHI,L 116-147,240,36,89,.404,22,50,.440,14,39,.359,30,36,.833,116,54,89,.607,43,58,.741,11,31,.355,28,30,.933,147
1093,IND,2023-01-08,116,,CHO,W 116-111,240,38,87,.437,25,49,.510,13,38,.342,27,33,.818,116,38,88,.432,27,55,.491,11,33,.333,24,27,.889,111
1094,SAS,2023-01-07,116,,BOS,L 116-121,240,49,100,.490,42,75,.560,7,25,.280,11,14,.786,116,47,95,.495,32,61,.525,15,34,.441,12,18,.667,121
1095,MEM,2022-12-31,116,,NOP,W 116-101,240,47,92,.511,42,63,.667,5,29,.172,17,22,.773,116,32,91,.352,24,61,.393,8,30,.267,29,36,.806,101
1096,DET,2022-12-31,116,@,MIN,W 116-104,240,43,89,.483,33,62,.532,10,27,.370,20,28,.714,116,36,83,.434,26,49,.531,10,34,.294,22,26,.846,104
1097,PHI,2022-12-30,116,@,NOP,L 116-127,240,42,75,.560,28,41,.683,14,34,.412,18,22,.818,116,43,80,.538,28,49,.571,15,31,.484,26,36,.722,127
1098,BOS,2022-12-29,116,,LAC,W 116-110,240,44,91,.484,33,52,.635,11,39,.282,17,22,.773,116,43,89,.483,28,50,.560,15,39,.385,9,14,.643,110
1099,WAS,2022-12-27,116,,PHI,W 116-111,240,39,85,.459,28,52,.538,11,33,.333,27,31,.871,116,39,84,.464,33,53,.623,6,31,.194,27,31,.871,111
1100,ORL,2022-12-21,116,@,HOU,W 116-110,240,41,91,.451,30,54,.556,11,37,.297,23,33,.697,116,41,88,.466,24,45,.533,17,43,.395,11,17,.647,110
1101,MIN,2022-12-19,116,,DAL,W 116-106,240,42,89,.472,30,58,.517,12,31,.387,20,24,.833,116,31,76,.408,12,31,.387,19,45,.422,25,31,.806,106
1102,TOR,2022-12-16,116,,BRK,L 116-119,240,41,84,.488,32,60,.533,9,24,.375,25,29,.862,116,46,76,.605,37,50,.740,9,26,.346,18,23,.783,119
1103,ATL,2022-12-09,116,@,BRK,L 116-120,240,46,93,.495,36,64,.563,10,29,.345,14,16,.875,116,45,83,.542,32,53,.604,13,30,.433,17,21,.810,120
1104,CHO,2022-12-07,116,@,BRK,L 116-122,240,47,88,.534,37,64,.578,10,24,.417,12,23,.522,116,49,86,.570,37,55,.673,12,31,.387,12,16,.750,122
1105,ORL,2022-12-07,116,,LAC,W 116-111 (OT),265,40,95,.421,32,67,.478,8,28,.286,28,31,.903,116,39,95,.411,24,54,.444,15,41,.366,18,26,.692,111
1106,CLE,2022-12-06,116,,LAL,W 116-102,240,48,93,.516,41,66,.621,7,27,.259,13,17,.765,116,38,89,.427,32,53,.604,6,36,.167,20,24,.833,102
1107,DET,2022-12-06,116,@,MIA,W 116-96,240,43,87,.494,24,46,.522,19,41,.463,11,15,.733,116,33,77,.429,23,45,.511,10,32,.313,20,26,.769,96
1108,DAL,2022-12-06,116,@,DEN,W 116-115,240,36,72,.500,19,36,.528,17,36,.472,27,31,.871,116,40,78,.513,27,46,.587,13,32,.406,22,28,.786,115
1109,BOS,2022-12-05,116,@,TOR,W 116-110,240,44,90,.489,31,54,.574,13,36,.361,15,21,.714,116,39,85,.459,29,57,.509,10,28,.357,22,30,.733,110
1110,POR,2022-12-04,116,,IND,W 116-100,240,42,86,.488,25,46,.543,17,40,.425,15,22,.682,116,40,91,.440,30,58,.517,10,33,.303,10,12,.833,100
1111,POR,2022-12-03,116,@,UTA,W 116-111,240,41,85,.482,31,60,.517,10,25,.400,24,31,.774,116,38,84,.452,25,48,.521,13,36,.361,22,28,.786,111
1112,WAS,2022-12-02,116,@,CHO,L 116-117,240,39,86,.453,27,53,.509,12,33,.364,26,35,.743,116,40,95,.421,28,66,.424,12,29,.414,25,31,.806,117
1113,BOS,2022-12-02,116,,MIA,L 116-120 (OT),265,40,87,.460,25,42,.595,15,45,.333,21,28,.750,116,48,101,.475,37,66,.561,11,35,.314,13,18,.722,120
1114,DAL,2022-11-29,116,,GSW,W 116-113,240,42,91,.462,27,47,.574,15,44,.341,17,27,.630,116,42,88,.477,31,45,.689,11,43,.256,18,23,.783,113
1115,IND,2022-11-28,116,@,LAL,W 116-115,240,43,105,.410,26,56,.464,17,49,.347,13,16,.813,116,40,93,.430,29,62,.468,11,31,.355,24,31,.774,115
1116,UTA,2022-11-23,116,,DET,L 116-125,240,41,83,.494,23,42,.548,18,41,.439,16,19,.842,116,44,89,.494,32,65,.492,12,24,.500,25,27,.926,125
1117,PHO,2022-11-20,116,,NYK,W 116-95,240,43,101,.426,26,62,.419,17,39,.436,13,18,.722,116,34,85,.400,27,60,.450,7,25,.280,20,25,.800,95
1118,LAL,2022-11-13,116,,BRK,W 116-103,240,44,91,.484,33,64,.516,11,27,.407,17,20,.850,116,36,80,.450,29,53,.547,7,27,.259,24,31,.774,103
1119,TOR,2022-11-09,116,,HOU,W 116-109,240,42,102,.412,27,58,.466,15,44,.341,17,20,.850,116,37,84,.440,28,49,.571,9,35,.257,26,31,.839,109
1120,GSW,2022-11-07,116,,SAC,W 116-113,240,44,88,.500,30,50,.600,14,38,.368,14,21,.667,116,37,91,.407,23,51,.451,14,40,.350,25,29,.862,113
1121,LAL,2022-11-07,116,@,UTA,L 116-139,240,40,82,.488,31,58,.534,9,24,.375,27,30,.900,116,53,95,.558,37,57,.649,16,38,.421,17,22,.773,139
1122,LAL,2022-11-04,116,,UTA,L 116-130,240,40,83,.482,29,57,.509,11,26,.423,25,28,.893,116,52,103,.505,35,63,.556,17,40,.425,9,10,.900,130
1123,MIL,2022-11-02,116,,DET,W 116-91,240,43,92,.467,33,54,.611,10,38,.263,20,24,.833,116,33,79,.418,22,48,.458,11,31,.355,14,15,.933,91
1124,PHO,2022-11-01,116,,MIN,W 116-107,240,41,89,.461,24,46,.522,17,43,.395,17,22,.773,116,37,87,.425,24,53,.453,13,34,.382,20,24,.833,107
1125,MIA,2022-11-01,116,,GSW,W 116-109,240,40,88,.455,24,46,.522,16,42,.381,20,20,1.000,116,39,84,.464,21,35,.600,18,49,.367,13,17,.765,109
1126,OKC,2022-11-01,116,,ORL,W 116-108,240,45,95,.474,35,61,.574,10,34,.294,16,20,.800,116,39,87,.448,29,58,.500,10,29,.345,20,20,1.000,108
1127,BRK,2022-10-31,116,,IND,W 116-109,240,43,80,.538,32,50,.640,11,30,.367,19,20,.950,116,41,87,.471,30,48,.625,11,39,.282,16,23,.696,109
1128,BRK,2022-10-29,116,,IND,L 116-125,240,41,82,.500,27,43,.628,14,39,.359,20,26,.769,116,40,94,.426,17,48,.354,23,46,.500,22,26,.846,125
1129,MIN,2022-10-23,116,@,OKC,W 116-106,240,46,88,.523,36,54,.667,10,34,.294,14,22,.636,116,41,94,.436,32,53,.604,9,41,.220,15,21,.714,106
1130,CHI,2022-10-19,116,@,MIA,W 116-108,240,41,93,.441,28,57,.491,13,36,.361,21,28,.750,116,37,80,.463,25,52,.481,12,28,.429,22,28,.786,108
1131,OKC,2023-04-09,115,,MEM,W 115-100,240,45,90,.500,33,54,.611,12,36,.333,13,16,.813,115,40,92,.435,33,55,.600,7,37,.189,13,18,.722,100
1132,IND,2023-04-07,115,,DET,L 115-122,240,41,83,.494,30,52,.577,11,31,.355,22,28,.786,115,44,90,.489,31,59,.525,13,31,.419,21,26,.808,122
1133,CHI,2023-04-07,115,@,DAL,W 115-112,240,46,88,.523,35,57,.614,11,31,.355,12,18,.667,115,42,93,.452,24,38,.632,18,55,.327,10,13,.769,112
1134,DEN,2023-04-06,115,@,PHO,L 115-119,240,44,83,.530,36,60,.600,8,23,.348,19,23,.826,115,41,79,.519,24,43,.558,17,36,.472,20,25,.800,119
1135,PHO,2023-04-04,115,,SAS,W 115-94,240,43,89,.483,33,56,.589,10,33,.303,19,26,.731,115,35,90,.389,22,50,.440,13,40,.325,11,14,.786,94
1136,CLE,2023-04-02,115,,IND,W 115-105,240,44,90,.489,35,66,.530,9,24,.375,18,26,.692,115,36,83,.434,27,59,.458,9,24,.375,24,29,.828,105
1137,DET,2023-03-31,115,@,HOU,L 115-121,240,43,89,.483,32,54,.593,11,35,.314,18,27,.667,115,38,83,.458,27,52,.519,11,31,.355,34,45,.756,121
1138,SAS,2023-03-31,115,@,GSW,L 115-130,240,42,91,.462,27,53,.509,15,38,.395,16,23,.696,115,47,93,.505,26,44,.591,21,49,.429,15,21,.714,130
1139,HOU,2023-03-27,115,@,NYK,L 115-137,240,42,87,.483,35,61,.574,7,26,.269,24,29,.828,115,50,86,.581,33,47,.702,17,39,.436,20,28,.714,137
1140,SAC,2023-03-27,115,,MIN,L 115-119,240,39,84,.464,34,57,.596,5,27,.185,32,40,.800,115,44,86,.512,35,62,.565,9,24,.375,22,34,.647,119
1141,NOP,2023-03-23,115,,CHO,W 115-96,240,45,98,.459,34,64,.531,11,34,.324,14,15,.933,115,38,83,.458,29,46,.630,9,37,.243,11,16,.688,96
1142,UTA,2023-03-22,115,,POR,L 115-127,240,39,82,.476,28,47,.596,11,35,.314,26,36,.722,115,45,93,.484,32,52,.615,13,41,.317,24,30,.800,127
1143,CLE,2023-03-21,115,@,BRK,W 115-109,240,42,83,.506,28,54,.519,14,29,.483,17,21,.810,115,41,92,.446,32,59,.542,9,33,.273,18,23,.783,109
1144,CHO,2023-03-20,115,,IND,W 115-109,240,41,90,.456,31,59,.525,10,31,.323,23,32,.719,115,37,82,.451,28,56,.500,9,26,.346,26,34,.765,109
1145,UTA,2023-03-13,115,@,MIA,L 115-119,240,43,90,.478,27,52,.519,16,38,.421,13,18,.722,115,37,79,.468,23,45,.511,14,34,.412,31,36,.861,119
1146,ATL,2023-03-13,115,,MIN,L 115-136,240,44,97,.454,40,75,.533,4,22,.182,23,28,.821,115,54,92,.587,42,64,.656,12,28,.429,16,23,.696,136
1147,DET,2023-03-11,115,,IND,L 115-121,240,43,94,.457,32,60,.533,11,34,.324,18,27,.667,115,43,93,.462,34,58,.586,9,35,.257,26,34,.765,121
1148,CLE,2023-03-10,115,@,MIA,L 115-119,240,40,86,.465,22,43,.512,18,43,.419,17,21,.810,115,42,82,.512,28,53,.528,14,29,.483,21,23,.913,119
1149,BOS,2023-03-08,115,,POR,W 115-93,240,42,88,.477,24,39,.615,18,49,.367,13,20,.650,115,30,82,.366,19,43,.442,11,39,.282,22,27,.815,93
1150,BRK,2023-03-03,115,@,BOS,W 115-105,240,40,95,.421,26,51,.510,14,44,.318,21,26,.808,115,41,84,.488,32,55,.582,9,29,.310,14,20,.700,105
1151,GSW,2023-03-02,115,,LAC,W 115-91,240,39,93,.419,25,47,.532,14,46,.304,23,27,.852,115,32,89,.360,23,46,.500,9,43,.209,18,21,.857,91
1152,DET,2023-03-01,115,,CHI,L 115-117,240,39,78,.500,25,43,.581,14,35,.400,23,28,.821,115,41,85,.482,29,58,.500,12,27,.444,23,31,.742,117
1153,OKC,2023-02-26,115,,SAC,L 115-124,240,41,86,.477,25,46,.543,16,40,.400,17,23,.739,115,45,85,.529,27,42,.643,18,43,.419,16,24,.667,124
1154,OKC,2023-02-24,115,@,PHO,L 115-124,240,41,95,.432,26,57,.456,15,38,.395,18,24,.750,115,42,90,.467,28,52,.538,14,38,.368,26,32,.813,124
1155,NYK,2023-02-24,115,@,WAS,W 115-109,240,45,92,.489,33,63,.524,12,29,.414,13,16,.813,115,39,79,.494,20,35,.571,19,44,.432,12,12,1.000,109
1156,TOR,2023-02-23,115,,NOP,W 115-110,240,43,92,.467,34,61,.557,9,31,.290,20,25,.800,115,39,84,.464,26,54,.481,13,30,.433,19,25,.760,110
1157,DEN,2023-02-23,115,@,CLE,W 115-109,240,39,84,.464,22,48,.458,17,36,.472,20,23,.870,115,43,90,.478,37,64,.578,6,26,.231,17,20,.850,109
1158,LAL,2023-02-13,115,@,POR,L 115-127,240,42,95,.442,30,58,.517,12,37,.324,19,21,.905,115,46,97,.474,23,50,.460,23,47,.489,12,13,.923,127
1159,ORL,2023-02-09,115,,DEN,W 115-104,240,47,97,.485,38,70,.543,9,27,.333,12,19,.632,115,39,84,.464,29,51,.569,10,33,.303,16,24,.667,104
1160,MIL,2023-02-09,115,@,LAL,W 115-106,240,45,99,.455,33,52,.635,12,47,.255,13,18,.722,115,42,89,.472,35,71,.493,7,18,.389,15,21,.714,106
1161,MIA,2023-02-04,115,@,MIL,L 115-123,240,45,101,.446,37,70,.529,8,31,.258,17,21,.810,115,46,88,.523,32,48,.667,14,40,.350,17,28,.607,123
1162,ATL,2023-02-03,115,@,UTA,W 115-108,240,44,95,.463,34,58,.586,10,37,.270,17,23,.739,115,41,91,.451,28,47,.596,13,44,.295,13,18,.722,108
1163,CHO,2023-01-31,115,@,MIL,L 115-124,240,42,111,.378,31,72,.431,11,39,.282,20,26,.769,115,43,105,.410,28,61,.459,15,44,.341,23,27,.852,124
1164,NYK,2023-01-28,115,@,BRK,L 115-122,240,45,88,.511,35,60,.583,10,28,.357,15,19,.789,115,46,87,.529,24,47,.511,22,40,.550,8,14,.571,122
1165,LAL,2023-01-24,115,,LAC,L 115-133,240,42,95,.442,26,55,.473,16,40,.400,15,24,.625,115,51,84,.607,32,46,.696,19,38,.500,12,15,.800,133
1166,DAL,2023-01-20,115,,MIA,W 115-90,240,37,80,.463,19,42,.452,18,38,.474,23,28,.821,115,33,69,.478,29,49,.592,4,20,.200,20,27,.741,90
1167,MEM,2023-01-18,115,,CLE,W 115-114,240,44,97,.454,33,63,.524,11,34,.324,16,22,.727,115,42,82,.512,26,47,.553,16,35,.457,14,21,.667,114
1168,DEN,2023-01-13,115,@,LAC,W 115-103,240,41,82,.500,27,49,.551,14,33,.424,19,25,.760,115,41,87,.471,31,58,.534,10,29,.345,11,14,.786,103
1169,LAL,2023-01-12,115,,DAL,L 115-119 (2OT),290,44,112,.393,34,71,.479,10,41,.244,17,27,.630,115,48,96,.500,34,54,.630,14,42,.333,9,17,.529,119
1170,HOU,2023-01-11,115,@,SAC,L 115-135,240,44,96,.458,28,55,.509,16,41,.390,11,17,.647,115,45,94,.479,26,46,.565,19,48,.396,26,31,.839,135
1171,ORL,2023-01-07,115,@,GSW,W 115-101,240,44,87,.506,31,55,.564,13,32,.406,14,24,.583,115,33,88,.375,15,30,.500,18,58,.310,17,21,.810,101
1172,LAC,2023-01-06,115,@,MIN,L 115-128,240,44,100,.440,35,75,.467,9,25,.360,18,27,.667,115,46,81,.568,33,46,.717,13,35,.371,23,29,.793,128
1173,ORL,2023-01-05,115,,MEM,L 115-123,240,39,84,.464,28,48,.583,11,36,.306,26,30,.867,115,48,92,.522,36,56,.643,12,36,.333,15,23,.652,123
1174,OKC,2023-01-04,115,@,ORL,L 115-126,240,36,89,.404,21,52,.404,15,37,.405,28,31,.903,115,42,81,.519,29,48,.604,13,33,.394,29,36,.806,126
1175,UTA,2023-01-03,115,,SAC,L 115-117,240,38,88,.432,25,44,.568,13,44,.295,26,29,.897,115,46,86,.535,37,54,.685,9,32,.281,16,18,.889,117
1176,CHO,2023-01-02,115,,LAL,L 115-121,240,42,93,.452,31,61,.508,11,32,.344,20,29,.690,115,45,93,.484,35,63,.556,10,30,.333,21,30,.700,121
1177,PHI,2022-12-31,115,@,OKC,W 115-96,240,46,99,.465,35,65,.538,11,34,.324,12,17,.706,115,35,92,.380,23,56,.411,12,36,.333,14,22,.636,96
1178,NYK,2022-12-29,115,@,SAS,L 115-122,240,38,90,.422,23,49,.469,15,41,.366,24,31,.774,115,45,88,.511,34,60,.567,11,28,.393,21,29,.724,122
1179,LAL,2022-12-25,115,@,DAL,L 115-124,240,39,80,.488,30,52,.577,9,28,.321,28,32,.875,115,44,84,.524,26,40,.650,18,44,.409,18,25,.720,124
1180,CHO,2022-12-18,115,@,DEN,L 115-119,240,41,96,.427,29,58,.500,12,38,.316,21,23,.913,115,43,94,.457,32,61,.525,11,33,.333,22,34,.647,119
1181,OKC,2022-12-17,115,,MEM,W 115-109,240,38,92,.413,19,47,.404,19,45,.422,20,31,.645,115,34,90,.378,22,45,.489,12,45,.267,29,37,.784,109
1182,DEN,2022-12-10,115,,UTA,W 115-110,240,47,86,.547,39,60,.650,8,26,.308,13,16,.813,115,39,85,.459,24,44,.545,15,41,.366,17,21,.810,110
1183,DAL,2022-12-10,115,@,CHI,L 115-144,240,41,90,.456,30,46,.652,11,44,.250,22,26,.846,115,54,85,.635,35,51,.686,19,34,.559,17,24,.708,144
1184,SAS,2022-12-10,115,@,MIA,W 115-111,240,42,78,.538,35,57,.614,7,21,.333,24,31,.774,115,39,81,.481,26,47,.553,13,34,.382,20,28,.714,111
1185,MIA,2022-12-08,115,,LAC,W 115-110,240,46,90,.511,34,58,.586,12,32,.375,11,14,.786,115,37,80,.463,20,44,.455,17,36,.472,19,21,.905,110
1186,IND,2022-12-07,115,@,MIN,L 115-121,240,39,81,.481,20,39,.513,19,42,.452,18,24,.750,115,44,93,.473,36,70,.514,8,23,.348,25,27,.926,121
1187,CHI,2022-12-07,115,,WAS,W 115-111,240,45,90,.500,35,67,.522,10,23,.435,15,17,.882,115,41,84,.488,32,53,.604,9,31,.290,20,29,.690,111
1188,DEN,2022-12-06,115,,DAL,L 115-116,240,40,78,.513,27,46,.587,13,32,.406,22,28,.786,115,36,72,.500,19,36,.528,17,36,.472,27,31,.871,116
1189,LAL,2022-11-28,115,,IND,L 115-116,240,40,93,.430,29,62,.468,11,31,.355,24,31,.774,115,43,105,.410,26,56,.464,17,49,.347,13,16,.813,116
1190,DAL,2022-11-27,115,@,MIL,L 115-124,240,41,80,.513,24,39,.615,17,41,.415,16,25,.640,115,48,86,.558,31,49,.633,17,37,.459,11,15,.733,124
1191,ATL,2022-11-23,115,,SAC,W 115-106,240,41,92,.446,30,62,.484,11,30,.367,22,23,.957,115,41,89,.461,32,58,.552,9,31,.290,15,21,.714,106
1192,MIN,2022-11-23,115,@,IND,W 115-101,240,47,77,.610,39,55,.709,8,22,.364,13,17,.765,115,37,96,.385,21,52,.404,16,44,.364,11,16,.688,101
1193,PHI,2022-11-22,115,,BRK,W 115-106,240,43,99,.434,27,67,.403,16,32,.500,13,16,.813,115,44,80,.550,35,52,.673,9,28,.321,9,13,.692,106
1194,PHO,2022-11-22,115,,LAL,W 115-105,240,48,102,.471,32,68,.471,16,34,.471,3,5,.600,115,36,85,.424,32,63,.508,4,22,.182,29,35,.829,105
1195,MEM,2022-11-20,115,@,BRK,L 115-127,240,43,99,.434,31,62,.500,12,37,.324,17,31,.548,115,50,83,.602,34,49,.694,16,34,.471,11,15,.733,127
1196,TOR,2022-11-14,115,@,DET,W 115-111,240,40,82,.488,32,55,.582,8,27,.296,27,28,.964,115,35,77,.455,25,46,.543,10,31,.323,31,43,.721,111
1197,GSW,2022-11-13,115,@,SAC,L 115-122,240,42,90,.467,26,43,.605,16,47,.340,15,16,.938,115,47,91,.516,31,54,.574,16,37,.432,12,19,.632,122
1198,CHO,2022-11-12,115,@,MIA,L 115-132,240,46,90,.511,37,59,.627,9,31,.290,14,16,.875,115,49,93,.527,33,52,.635,16,41,.390,18,21,.857,132
1199,NOP,2022-11-09,115,@,CHI,W 115-111,240,42,84,.500,39,65,.600,3,19,.158,28,36,.778,115,44,87,.506,37,60,.617,7,27,.259,16,18,.889,111
1200,DEN,2022-11-07,115,@,SAS,W 115-109,240,47,88,.534,39,64,.609,8,24,.333,13,20,.650,115,43,82,.524,31,49,.633,12,33,.364,11,18,.611,109
1201,MIL,2022-11-04,115,@,MIN,W 115-102,240,41,85,.482,24,47,.511,17,38,.447,16,28,.571,115,39,92,.424,28,51,.549,11,41,.268,13,17,.765,102
1202,SAC,2022-10-31,115,@,CHO,W 115-108,240,37,85,.435,20,41,.488,17,44,.386,24,28,.857,115,43,84,.512,29,55,.527,14,29,.483,8,14,.571,108
1203,ATL,2022-10-29,115,@,MIL,L 115-123,240,45,94,.479,32,65,.492,13,29,.448,12,15,.800,115,45,92,.489,31,56,.554,14,36,.389,19,29,.655,123
1204,NYK,2022-10-24,115,,ORL,W 115-102,240,43,93,.462,32,56,.571,11,37,.297,18,25,.720,115,36,86,.419,29,51,.569,7,35,.200,23,27,.852,102
1205,SAS,2022-10-24,115,@,MIN,W 115-106,240,48,105,.457,36,68,.529,12,37,.324,7,13,.538,115,38,86,.442,30,55,.545,8,31,.258,22,24,.917,106
1206,DET,2022-10-22,115,@,IND,L 115-124,240,37,95,.389,19,53,.358,18,42,.429,23,30,.767,115,45,103,.437,29,61,.475,16,42,.381,18,24,.750,124
1207,MEM,2022-10-19,115,,NYK,W 115-112 (OT),265,42,108,.389,25,58,.431,17,50,.340,14,23,.609,115,44,109,.404,35,72,.486,9,37,.243,15,18,.833,112
1208,MIN,2022-10-19,115,,OKC,W 115-108,240,39,94,.415,29,56,.518,10,38,.263,27,33,.818,115,38,99,.384,24,54,.444,14,45,.311,18,22,.818,108
1209,POR,2022-10-19,115,@,SAC,W 115-108,240,39,88,.443,28,60,.467,11,28,.393,26,33,.788,115,39,85,.459,22,41,.537,17,44,.386,13,19,.684,108
1210,ATL,2023-04-09,114,@,BOS,L 114-120,240,44,97,.454,33,58,.569,11,39,.282,15,19,.789,114,42,89,.472,17,35,.486,25,54,.463,11,14,.786,120
1211,PHO,2023-04-09,114,,LAC,L 114-119,240,42,99,.424,28,62,.452,14,37,.378,16,22,.727,114,49,100,.490,44,77,.571,5,23,.217,16,24,.667,119
1212,HOU,2023-04-09,114,@,WAS,W 114-109,240,44,90,.489,38,69,.551,6,21,.286,20,28,.714,114,41,97,.423,27,52,.519,14,45,.311,13,21,.619,109
1213,DEN,2023-04-08,114,@,UTA,L 114-118,240,41,90,.456,26,44,.591,15,46,.326,17,24,.708,114,44,100,.440,33,65,.508,11,35,.314,19,23,.826,118
1214,MIL,2023-04-07,114,,MEM,L 114-137,240,42,92,.457,21,43,.488,21,49,.429,9,11,.818,114,53,93,.570,33,51,.647,20,42,.476,11,15,.733,137
1215,WAS,2023-04-07,114,,MIA,W 114-108,240,39,84,.464,32,51,.627,7,33,.212,29,37,.784,114,43,98,.439,28,51,.549,15,47,.319,7,12,.583,108
1216,OKC,2023-04-06,114,@,UTA,W 114-98,240,39,97,.402,24,52,.462,15,45,.333,21,26,.808,114,41,83,.494,36,52,.692,5,31,.161,11,16,.688,98
1217,LAC,2023-04-01,114,@,NOP,L 114-122,240,42,85,.494,31,56,.554,11,29,.379,19,23,.826,114,42,86,.488,35,69,.507,7,17,.412,31,35,.886,122
1218,UTA,2023-03-31,114,@,BOS,L 114-122,240,46,96,.479,37,67,.552,9,29,.310,13,14,.929,114,42,96,.438,25,45,.556,17,51,.333,21,22,.955,122
1219,POR,2023-03-31,114,,SAC,L 114-138,240,40,85,.471,21,47,.447,19,38,.500,15,23,.652,114,54,88,.614,35,49,.714,19,39,.487,11,15,.733,138
1220,HOU,2023-03-29,114,@,BRK,L 114-123,240,46,98,.469,37,68,.544,9,30,.300,13,21,.619,114,44,82,.537,27,47,.574,17,35,.486,18,27,.667,123
1221,TOR,2023-03-26,114,,WAS,W 114-104,240,45,98,.459,34,67,.507,11,31,.355,13,16,.813,114,38,86,.442,22,50,.440,16,36,.444,12,20,.600,104
1222,HOU,2023-03-24,114,@,MEM,L 114-151,240,47,87,.540,40,64,.625,7,23,.304,13,21,.619,114,57,93,.613,32,51,.627,25,42,.595,12,14,.857,151
1223,BRK,2023-03-23,114,,CLE,L 114-116,240,39,81,.481,27,47,.574,12,34,.353,24,27,.889,114,42,89,.472,30,57,.526,12,32,.375,20,26,.769,116
1224,TOR,2023-03-22,114,,IND,L 114-118,240,39,89,.438,32,55,.582,7,34,.206,29,39,.744,114,43,77,.558,32,56,.571,11,21,.524,21,25,.840,118
1225,HOU,2023-03-17,114,,NOP,W 114-112,240,43,88,.489,32,56,.571,11,32,.344,17,24,.708,114,39,82,.476,27,54,.500,12,28,.429,22,25,.880,112
1226,HOU,2023-03-15,114,,LAL,W 114-110,240,47,89,.528,39,60,.650,8,29,.276,12,19,.632,114,34,90,.378,23,46,.500,11,44,.250,31,37,.838,110
1227,CHI,2023-03-15,114,,SAC,L 114-117,240,38,97,.392,22,55,.400,16,42,.381,22,25,.880,114,38,78,.487,20,36,.556,18,42,.429,23,29,.793,117
1228,ORL,2023-03-14,114,@,SAS,L 114-132,240,44,97,.454,34,68,.500,10,29,.345,16,21,.762,114,48,85,.565,26,44,.591,22,41,.537,14,18,.778,132
1229,CLE,2023-03-12,114,@,CHO,W 114-108,240,41,87,.471,34,60,.567,7,27,.259,25,34,.735,114,41,80,.513,31,59,.525,10,21,.476,16,22,.727,108
1230,MIA,2023-03-11,114,@,ORL,L 114-126 (OT),265,42,94,.447,31,57,.544,11,37,.297,19,20,.950,114,48,99,.485,35,62,.565,13,37,.351,17,20,.850,126
1231,ATL,2023-03-10,114,@,WAS,W 114-107,240,42,95,.442,27,64,.422,15,31,.484,15,19,.789,114,43,88,.489,36,61,.590,7,27,.259,14,18,.778,107
1232,BOS,2023-03-06,114,@,CLE,L 114-118 (OT),265,42,101,.416,26,53,.491,16,48,.333,14,21,.667,114,43,96,.448,31,62,.500,12,34,.353,20,25,.800,118
1233,CLE,2023-03-04,114,,DET,W 114-90,240,45,91,.495,31,57,.544,14,34,.412,10,18,.556,114,33,81,.407,27,57,.474,6,24,.250,18,25,.720,90
1234,HOU,2023-02-26,114,@,POR,L 114-131,240,45,100,.450,38,74,.514,7,26,.269,17,25,.680,114,42,77,.545,22,38,.579,20,39,.513,27,35,.771,131
1235,WAS,2023-02-16,114,@,MIN,W 114-106,240,43,95,.453,29,60,.483,14,35,.400,14,17,.824,114,39,95,.411,31,66,.470,8,29,.276,20,22,.909,106
1236,SAC,2023-02-10,114,,DAL,L 114-122,240,39,72,.542,30,45,.667,9,27,.333,27,32,.844,114,43,88,.489,25,45,.556,18,43,.419,18,19,.947,122
1237,CLE,2023-02-06,114,@,WAS,W 114-91,240,44,78,.564,32,49,.653,12,29,.414,14,20,.700,114,35,82,.427,29,54,.537,6,28,.214,15,19,.789,91
1238,OKC,2023-02-06,114,@,GSW,L 114-141,240,44,91,.484,33,59,.559,11,32,.344,15,21,.714,114,56,97,.577,30,47,.638,26,50,.520,3,7,.429,141
1239,CHI,2023-02-02,114,,CHO,W 114-98,240,41,79,.519,30,51,.588,11,28,.393,21,26,.808,114,39,93,.419,32,58,.552,7,35,.200,13,15,.867,98
1240,GSW,2023-02-01,114,@,MIN,L 114-119 (OT),265,38,91,.418,27,56,.482,11,35,.314,27,34,.794,114,46,106,.434,32,56,.571,14,50,.280,13,24,.542,119
1241,PHO,2023-01-30,114,,TOR,W 114-106,240,43,87,.494,32,59,.542,11,28,.393,17,21,.810,114,40,89,.449,31,56,.554,9,33,.273,17,19,.895,106
1242,DET,2023-01-28,114,,HOU,L 114-117,240,38,83,.458,24,45,.533,14,38,.368,24,31,.774,114,44,92,.478,36,65,.554,8,27,.296,21,27,.778,117
1243,MIN,2023-01-23,114,@,HOU,L 114-119,240,41,91,.451,25,49,.510,16,42,.381,16,22,.727,114,44,88,.500,33,58,.569,11,30,.367,20,30,.667,119
1244,CLE,2023-01-21,114,,MIL,W 114-102,240,48,86,.558,41,64,.641,7,22,.318,11,17,.647,114,39,86,.453,25,47,.532,14,39,.359,10,11,.909,102
1245,CLE,2023-01-20,114,,GSW,L 114-120,240,42,84,.500,28,51,.549,14,33,.424,16,19,.842,114,42,86,.488,19,43,.442,23,43,.535,13,19,.684,120
1246,CLE,2023-01-18,114,@,MEM,L 114-115,240,42,82,.512,26,47,.553,16,35,.457,14,21,.667,114,44,97,.454,33,63,.524,11,34,.324,16,22,.727,115
1247,ATL,2023-01-14,114,@,TOR,W 114-103,240,43,84,.512,32,57,.561,11,27,.407,17,18,.944,114,36,87,.414,29,58,.500,7,29,.241,24,30,.800,103
1248,HOU,2023-01-13,114,@,SAC,L 114-139,240,43,91,.473,31,54,.574,12,37,.324,16,25,.640,114,47,86,.547,27,46,.587,20,40,.500,25,29,.862,139
1249,CHO,2023-01-12,114,@,TOR,L 114-124,240,41,77,.532,28,44,.636,13,33,.394,19,27,.704,114,43,83,.518,33,55,.600,10,28,.357,28,36,.778,124
1250,PHI,2023-01-12,114,,OKC,L 114-133,240,39,88,.443,28,52,.538,11,36,.306,25,27,.926,114,44,86,.512,30,53,.566,14,33,.424,31,33,.939,133
1251,MIL,2023-01-11,114,@,ATL,W 114-105,240,45,98,.459,27,50,.540,18,48,.375,6,11,.545,114,39,87,.448,28,57,.491,11,30,.367,16,18,.889,105
1252,NOP,2023-01-11,114,@,BOS,L 114-125,240,45,87,.517,34,57,.596,11,30,.367,13,17,.765,114,44,91,.484,29,47,.617,15,44,.341,22,25,.880,125
1253,CLE,2023-01-10,114,@,UTA,L 114-116,240,42,90,.467,32,53,.604,10,37,.270,20,24,.833,114,38,87,.437,28,51,.549,10,36,.278,30,37,.811,116
1254,ATL,2023-01-06,114,@,LAL,L 114-130,240,44,96,.458,35,65,.538,9,31,.290,17,22,.773,114,51,93,.548,35,58,.603,16,35,.457,12,16,.750,130
1255,HOU,2023-01-05,114,,UTA,L 114-131,240,38,92,.413,23,50,.460,15,42,.357,23,26,.885,114,46,93,.495,27,45,.600,19,48,.396,20,21,.952,131
1256,SAS,2023-01-04,114,@,NYK,L 114-117,240,41,82,.500,30,54,.556,11,28,.393,21,26,.808,114,45,94,.479,35,63,.556,10,31,.323,17,26,.654,117
1257,TOR,2023-01-02,114,@,IND,L 114-122,240,41,91,.451,27,49,.551,14,42,.333,18,23,.783,114,45,93,.484,35,66,.530,10,27,.370,22,26,.846,122
1258,MIN,2022-12-30,114,@,MIL,L 114-123,240,40,92,.435,32,62,.516,8,30,.267,26,34,.765,114,43,93,.462,29,54,.537,14,39,.359,23,33,.697,123
1259,HOU,2022-12-29,114,@,DAL,L 114-129,240,38,86,.442,26,52,.500,12,34,.353,26,37,.703,114,47,91,.516,29,46,.630,18,45,.400,17,25,.680,129
1260,ATL,2022-12-27,114,@,IND,L 114-129,240,40,89,.449,28,59,.475,12,30,.400,22,29,.759,114,47,92,.511,34,57,.596,13,35,.371,22,27,.815,129
1261,SAS,2022-12-27,114,@,OKC,L 114-130,240,46,99,.465,36,70,.514,10,29,.345,12,14,.857,114,46,86,.535,33,62,.532,13,24,.542,25,31,.806,130
1262,LAC,2022-12-23,114,@,PHI,L 114-119,240,41,81,.506,27,43,.628,14,38,.368,18,23,.783,114,47,88,.534,35,59,.593,12,29,.414,13,14,.929,119
1263,CLE,2022-12-21,114,,MIL,W 114-106,240,41,85,.482,31,53,.585,10,32,.313,22,28,.786,114,39,83,.470,26,53,.491,13,30,.433,15,22,.682,106
1264,NOP,2022-12-17,114,@,PHO,L 114-118,240,45,77,.584,31,47,.660,14,30,.467,10,13,.769,114,39,83,.470,24,42,.571,15,41,.366,25,35,.714,118
1265,NYK,2022-12-16,114,@,CHI,W 114-91,240,37,92,.402,20,48,.417,17,44,.386,23,32,.719,114,36,77,.468,24,47,.511,12,30,.400,7,8,.875,91
1266,OKC,2022-12-12,114,@,DAL,L 114-121,240,42,88,.477,32,57,.561,10,31,.323,20,21,.952,114,39,93,.419,17,39,.436,22,54,.407,21,25,.840,121
1267,LAC,2022-12-10,114,@,WAS,W 114-107,240,40,94,.426,21,46,.457,19,48,.396,15,16,.938,114,37,85,.435,21,51,.412,16,34,.471,17,19,.895,107
1268,MEM,2022-12-09,114,,DET,W 114-103,240,44,91,.484,35,59,.593,9,32,.281,17,32,.531,114,36,90,.400,25,55,.455,11,35,.314,20,27,.741,103
1269,ATL,2022-12-05,114,,OKC,L 114-121,240,44,102,.431,31,64,.484,13,38,.342,13,17,.765,114,43,95,.453,31,61,.508,12,34,.353,23,24,.958,121
1270,BRK,2022-12-02,114,,TOR,W 114-105,240,44,82,.537,33,50,.660,11,32,.344,15,22,.682,114,38,87,.437,31,63,.492,7,24,.292,22,30,.733,105
1271,IND,2022-11-30,114,@,SAC,L 114-137,240,40,100,.400,28,63,.444,12,37,.324,22,30,.733,114,48,95,.505,32,52,.615,16,43,.372,25,29,.862,137
1272,CHI,2022-11-28,114,@,UTA,W 114-107,240,43,93,.462,37,71,.521,6,22,.273,22,25,.880,114,41,85,.482,22,36,.611,19,49,.388,6,15,.400,107
1273,MIN,2022-11-27,114,,GSW,L 114-137,240,39,88,.443,25,53,.472,14,35,.400,22,29,.759,114,50,87,.575,30,40,.750,20,47,.426,17,20,.850,137
1274,LAC,2022-11-27,114,,IND,W 114-100,240,42,94,.447,36,62,.581,6,32,.188,24,32,.750,114,36,94,.383,27,52,.519,9,42,.214,19,23,.826,100
1275,DEN,2022-11-25,114,@,LAC,W 114-104,240,44,89,.494,34,59,.576,10,30,.333,16,23,.696,114,37,68,.544,26,46,.565,11,22,.500,19,34,.559,104
1276,CLE,2022-11-23,114,,POR,W 114-96,240,41,74,.554,29,47,.617,12,27,.444,20,23,.870,114,35,78,.449,22,47,.468,13,31,.419,13,13,1.000,96
1277,UTA,2022-11-21,114,@,LAC,L 114-121,240,40,89,.449,28,51,.549,12,38,.316,22,24,.917,114,47,91,.516,38,67,.567,9,24,.375,18,19,.947,121
1278,CLE,2022-11-21,114,,ATL,W 114-102,240,42,70,.600,32,51,.627,10,19,.526,20,23,.870,114,38,87,.437,27,53,.509,11,34,.324,15,17,.882,102
1279,IND,2022-11-19,114,,ORL,W 114-113,240,41,90,.456,23,44,.523,18,46,.391,14,19,.737,114,39,91,.429,23,49,.469,16,42,.381,19,26,.731,113
1280,ORL,2022-11-11,114,,PHO,W 114-97,240,43,82,.524,28,49,.571,15,33,.455,13,15,.867,114,38,95,.400,25,53,.472,13,42,.310,8,9,.889,97
1281,LAL,2022-11-11,114,,SAC,L 114-120,240,42,88,.477,32,63,.508,10,25,.400,20,26,.769,114,45,87,.517,33,51,.647,12,36,.333,18,21,.857,120
1282,MEM,2022-11-11,114,,MIN,W 114-103,240,44,88,.500,37,55,.673,7,33,.212,19,27,.704,114,37,79,.468,27,49,.551,10,30,.333,19,22,.864,103
1283,LAC,2022-11-09,114,,LAL,W 114-101,240,41,81,.506,29,48,.604,12,33,.364,20,26,.769,114,40,88,.455,30,56,.536,10,32,.313,11,17,.647,101
1284,CLE,2022-11-06,114,@,LAL,W 114-100,240,37,84,.440,29,52,.558,8,32,.250,32,36,.889,114,40,87,.460,32,60,.533,8,27,.296,12,21,.571,100
1285,NOP,2022-11-04,114,,GSW,W 114-105,240,41,81,.506,29,52,.558,12,29,.414,20,29,.690,114,35,71,.493,23,39,.590,12,32,.375,23,25,.920,105
1286,CLE,2022-11-02,114,,BOS,W 114-113 (OT),265,42,100,.420,31,61,.508,11,39,.282,19,24,.792,114,38,93,.409,27,52,.519,11,41,.268,26,27,.963,113
1287,DAL,2022-10-30,114,,ORL,W 114-105,240,41,83,.494,30,48,.625,11,35,.314,21,28,.750,114,37,81,.457,26,52,.500,11,29,.379,20,27,.741,105
1288,GSW,2022-10-30,114,@,DET,L 114-128,240,39,92,.424,27,53,.509,12,39,.308,24,25,.960,114,40,83,.482,26,50,.520,14,33,.424,34,38,.895,128
1289,PHI,2022-10-29,114,@,CHI,W 114-109,240,39,79,.494,25,50,.500,14,29,.483,22,27,.815,114,36,80,.450,25,49,.510,11,31,.355,26,29,.897,109
1290,HOU,2022-10-24,114,,UTA,W 114-108,240,38,90,.422,27,55,.491,11,35,.314,27,32,.844,114,44,93,.473,33,61,.541,11,32,.344,9,16,.563,108
1291,SAS,2022-10-22,114,@,PHI,W 114-105,240,43,89,.483,27,51,.529,16,38,.421,12,15,.800,114,37,84,.440,27,53,.509,10,31,.323,21,28,.750,105
1292,WAS,2022-10-19,114,@,IND,W 114-107,240,42,92,.457,31,61,.508,11,31,.355,19,24,.792,114,39,97,.402,24,55,.436,15,42,.357,14,21,.667,107
1293,MIN,2023-04-09,113,,NOP,W 113-108,240,39,82,.476,26,46,.565,13,36,.361,22,31,.710,113,40,90,.444,37,69,.536,3,21,.143,25,29,.862,108
1294,NOP,2023-04-07,113,,NYK,W 113-105,240,42,79,.532,32,51,.627,10,28,.357,19,20,.950,113,38,88,.432,24,45,.533,14,43,.326,15,20,.750,105
1295,ORL,2023-04-04,113,,CLE,L 113-117,240,45,89,.506,35,66,.530,10,23,.435,13,17,.765,113,42,84,.500,27,53,.509,15,31,.484,18,20,.900,117
1296,MEM,2023-03-28,113,,ORL,W 113-108,240,42,88,.477,30,54,.556,12,34,.353,17,23,.739,113,41,100,.410,27,51,.529,14,49,.286,12,15,.800,108
1297,UTA,2023-03-25,113,@,SAC,L 113-121,240,47,91,.516,38,63,.603,9,28,.321,10,16,.625,113,44,95,.463,28,52,.538,16,43,.372,17,21,.810,121
1298,ORL,2023-03-18,113,@,LAC,W 113-108,240,42,84,.500,32,53,.604,10,31,.323,19,25,.760,113,42,90,.467,36,68,.529,6,22,.273,18,24,.750,108
1299,CHI,2023-03-18,113,,MIA,W 113-99,240,45,80,.563,28,46,.609,17,34,.500,6,6,1.000,113,35,82,.427,25,45,.556,10,37,.270,19,24,.792,99
1300,ORL,2023-03-16,113,@,PHO,L 113-116,240,43,86,.500,35,58,.603,8,28,.286,19,23,.826,113,43,90,.478,30,55,.545,13,35,.371,17,17,1.000,116
1301,BRK,2023-03-09,113,@,MIL,L 113-118,240,41,104,.394,27,68,.397,14,36,.389,17,17,1.000,113,44,104,.423,25,54,.463,19,50,.380,11,14,.786,118
1302,CHO,2023-03-09,113,@,DET,W 113-103,240,43,86,.500,35,62,.565,8,24,.333,19,32,.594,113,40,89,.449,33,68,.485,7,21,.333,16,20,.800,103
1303,NOP,2023-03-08,113,,DAL,W 113-106,240,42,83,.506,29,56,.518,13,27,.481,16,18,.889,113,38,88,.432,22,42,.524,16,46,.348,14,19,.737,106
1304,TOR,2023-03-06,113,@,DEN,L 113-118,240,43,86,.500,33,59,.559,10,27,.370,17,20,.850,113,43,86,.500,30,53,.566,13,33,.394,19,23,.826,118
1305,LAL,2023-03-05,113,,GSW,W 113-105,240,42,95,.442,31,62,.500,11,33,.333,18,22,.818,113,36,91,.396,18,39,.462,18,52,.346,15,18,.833,105
1306,DEN,2023-03-03,113,,MEM,W 113-97,240,40,87,.460,32,56,.571,8,31,.258,25,31,.806,113,31,84,.369,20,52,.385,11,32,.344,24,31,.774,97
1307,MEM,2023-03-01,113,@,HOU,W 113-99,240,40,83,.482,23,42,.548,17,41,.415,16,19,.842,113,36,90,.400,25,56,.446,11,34,.324,16,25,.640,99
1308,CLE,2023-03-01,113,@,BOS,L 113-117,240,45,92,.489,35,60,.583,10,32,.313,13,21,.619,113,39,78,.500,23,46,.500,16,32,.500,23,28,.821,117
1309,MIN,2023-02-24,113,,CHO,L 113-121,240,46,93,.495,35,60,.583,11,33,.333,10,16,.625,113,43,92,.467,33,64,.516,10,28,.357,25,28,.893,121
1310,CHI,2023-02-15,113,@,IND,L 113-117,240,41,84,.488,26,49,.531,15,35,.429,16,21,.762,113,39,82,.476,21,39,.538,18,43,.419,21,22,.955,117
1311,ORL,2023-02-14,113,@,TOR,L 113-123,240,43,84,.512,30,53,.566,13,31,.419,14,18,.778,113,50,83,.602,42,59,.712,8,24,.333,15,20,.750,123
1312,IND,2023-02-11,113,@,WAS,L 113-127,240,43,95,.453,29,55,.527,14,40,.350,13,17,.765,113,48,75,.640,36,49,.735,12,26,.462,19,22,.864,127
1313,CLE,2023-02-08,113,,DET,W 113-85,240,43,87,.494,37,61,.607,6,26,.231,21,25,.840,113,30,81,.370,22,49,.449,8,32,.250,17,18,.944,85
1314,CHO,2023-02-05,113,,ORL,L 113-119,240,45,83,.542,33,50,.660,12,33,.364,11,23,.478,113,42,91,.462,34,68,.500,8,23,.348,27,30,.900,119
1315,DAL,2023-02-04,113,@,GSW,L 113-119,240,39,85,.459,25,45,.556,14,40,.350,21,27,.778,113,45,82,.549,31,47,.660,14,35,.400,15,19,.789,119
1316,MEM,2023-02-02,113,@,CLE,L 113-128,240,41,87,.471,31,64,.484,10,23,.435,21,22,.955,113,49,91,.538,35,62,.565,14,29,.483,16,22,.727,128
1317,NOP,2023-01-31,113,@,DEN,L 113-122,240,42,85,.494,34,58,.586,8,27,.296,21,25,.840,113,43,87,.494,27,51,.529,16,36,.444,20,24,.833,122
1318,ATL,2023-01-28,113,,LAC,L 113-120,240,45,95,.474,38,68,.559,7,27,.259,16,20,.800,113,42,80,.525,23,41,.561,19,39,.487,17,19,.895,120
1319,WAS,2023-01-28,113,@,NOP,W 113-103,240,40,88,.455,29,52,.558,11,36,.306,22,29,.759,113,39,92,.424,31,63,.492,8,29,.276,17,19,.895,103
1320,CLE,2023-01-26,113,@,HOU,W 113-95,240,40,87,.460,25,51,.490,15,36,.417,18,22,.818,113,39,76,.513,34,55,.618,5,21,.238,12,20,.600,95
1321,LAL,2023-01-25,113,,SAS,W 113-104,240,40,90,.444,30,57,.526,10,33,.303,23,30,.767,113,40,106,.377,32,72,.444,8,34,.235,16,18,.889,104
1322,TOR,2023-01-25,113,@,SAC,W 113-95,240,48,97,.495,36,57,.632,12,40,.300,5,7,.714,113,35,73,.479,22,41,.537,13,32,.406,12,13,.923,95
1323,ORL,2023-01-23,113,,BOS,W 113-98,240,43,84,.512,32,57,.561,11,27,.407,16,24,.667,113,36,83,.434,18,37,.486,18,46,.391,8,11,.727,98
1324,MIN,2023-01-21,113,,HOU,W 113-104,240,38,83,.458,21,42,.500,17,41,.415,20,24,.833,113,38,79,.481,29,55,.527,9,24,.375,19,33,.576,104
1325,OKC,2023-01-20,113,@,SAC,L 113-118,240,45,93,.484,29,53,.547,16,40,.400,7,11,.636,113,41,87,.471,29,49,.592,12,38,.316,24,28,.857,118
1326,POR,2023-01-17,113,@,DEN,L 113-122,240,38,83,.458,25,43,.581,13,40,.325,24,25,.960,113,44,88,.500,33,56,.589,11,32,.344,23,28,.821,122
1327,MIA,2023-01-16,113,@,ATL,L 113-121,240,43,89,.483,35,58,.603,8,31,.258,19,20,.950,113,45,76,.592,32,49,.653,13,27,.481,18,22,.818,121
1328,CLE,2023-01-16,113,,NOP,W 113-103,240,39,80,.488,30,52,.577,9,28,.321,26,33,.788,113,38,75,.507,28,48,.583,10,27,.370,17,22,.773,103
1329,PHI,2023-01-15,113,@,LAL,W 113-112,240,43,85,.506,31,51,.608,12,34,.353,15,19,.789,113,48,87,.552,42,67,.627,6,20,.300,10,13,.769,112
1330,ATL,2023-01-13,113,@,IND,W 113-111,240,41,94,.436,25,61,.410,16,33,.485,15,21,.714,113,40,101,.396,33,71,.465,7,30,.233,24,29,.828,111
1331,SAS,2023-01-13,113,,GSW,L 113-144,240,40,88,.455,32,66,.485,8,22,.364,25,34,.735,113,55,101,.545,37,53,.698,18,48,.375,16,20,.800,144
1332,POR,2023-01-12,113,,CLE,L 113-119,240,40,78,.513,29,45,.644,11,33,.333,22,29,.759,113,44,89,.494,37,67,.552,7,22,.318,24,31,.774,119
1333,IND,2023-01-11,113,@,NYK,L 113-119,240,43,90,.478,31,51,.608,12,39,.308,15,21,.714,113,38,84,.452,23,42,.548,15,42,.357,28,33,.848,119
1334,GSW,2023-01-10,113,,PHO,L 113-125,240,37,96,.385,19,48,.396,18,48,.375,21,27,.778,113,41,90,.456,27,59,.458,14,31,.452,29,31,.935,125
1335,LAC,2023-01-10,113,,DAL,W 113-101,240,39,86,.453,27,55,.491,12,31,.387,23,30,.767,113,30,69,.435,18,31,.581,12,38,.316,29,36,.806,101
1336,SAS,2023-01-09,113,@,MEM,L 113-121,240,44,97,.454,33,65,.508,11,32,.344,14,16,.875,113,45,91,.495,34,65,.523,11,26,.423,20,35,.571,121
1337,MIN,2023-01-04,113,,POR,W 113-106,240,39,76,.513,30,52,.577,9,24,.375,26,36,.722,113,33,75,.440,24,46,.522,9,29,.310,31,42,.738,106
1338,WAS,2023-01-03,113,@,MIL,L 113-123,240,42,97,.433,34,70,.486,8,27,.296,21,23,.913,113,48,100,.480,37,60,.617,11,40,.275,16,17,.941,123
1339,TOR,2022-12-30,113,,PHO,W 113-104,240,40,81,.494,29,48,.604,11,33,.333,22,26,.846,113,35,71,.493,21,41,.512,14,30,.467,20,23,.870,104
1340,OKC,2022-12-29,113,@,CHO,L 113-121,240,42,99,.424,31,63,.492,11,36,.306,18,21,.857,113,46,84,.548,36,52,.692,10,32,.313,19,29,.655,121
1341,MIL,2022-12-28,113,@,CHI,L 113-119 (OT),265,41,110,.373,32,66,.485,9,44,.205,22,32,.688,113,42,92,.457,33,69,.478,9,23,.391,26,30,.867,119
1342,DEN,2022-12-27,113,@,SAC,W 113-106,240,41,86,.477,28,49,.571,13,37,.351,18,21,.857,113,40,82,.488,30,47,.638,10,35,.286,16,19,.842,106
1343,TOR,2022-12-27,113,,LAC,L 113-124,240,43,84,.512,37,61,.607,6,23,.261,21,26,.808,113,45,93,.484,30,55,.545,15,38,.395,19,23,.826,124
1344,NOP,2022-12-26,113,,IND,W 113-93,240,41,90,.456,29,50,.580,12,40,.300,19,24,.792,113,35,83,.422,26,48,.542,9,35,.257,14,20,.700,93
1345,CHO,2022-12-26,113,@,POR,L 113-124,240,41,103,.398,29,67,.433,12,36,.333,19,25,.760,113,43,86,.500,29,48,.604,14,38,.368,24,28,.857,124
1346,MIA,2022-12-26,113,,MIN,W 113-110,240,47,102,.461,34,53,.642,13,49,.265,6,8,.750,113,43,79,.544,28,45,.622,15,34,.441,9,14,.643,110
1347,SAS,2022-12-23,113,@,ORL,L 113-133,240,44,97,.454,32,59,.542,12,38,.316,13,18,.722,113,50,87,.575,33,55,.600,17,32,.531,16,20,.800,133
1348,TOR,2022-12-21,113,@,NYK,W 113-106,240,42,94,.447,33,60,.550,9,34,.265,20,22,.909,113,42,76,.553,31,50,.620,11,26,.423,11,18,.611,106
1349,PHI,2022-12-21,113,,DET,W 113-93,240,41,93,.441,30,56,.536,11,37,.297,20,22,.909,113,31,79,.392,25,56,.446,6,23,.261,25,34,.735,93
1350,GSW,2022-12-21,113,@,BRK,L 113-143,240,41,83,.494,29,50,.580,12,33,.364,19,25,.760,113,54,84,.643,33,51,.647,21,33,.636,14,16,.875,143
1351,WAS,2022-12-20,113,@,PHO,W 113-110,240,38,80,.475,27,53,.509,11,27,.407,26,37,.703,113,41,89,.461,28,57,.491,13,32,.406,15,19,.789,110
1352,CHI,2022-12-20,113,@,MIA,W 113-103,240,40,73,.548,27,42,.643,13,31,.419,20,24,.833,113,38,81,.469,23,37,.622,15,44,.341,12,17,.706,103
1353,DET,2022-12-16,113,,SAC,L 113-122,240,39,85,.459,29,56,.518,10,29,.345,25,31,.806,113,43,82,.524,31,51,.608,12,31,.387,24,29,.828,122
1354,LAC,2022-12-12,113,,BOS,W 113-93,240,44,90,.489,34,65,.523,10,25,.400,15,21,.714,113,33,76,.434,24,37,.649,9,39,.231,18,26,.692,93
1355,CHO,2022-12-11,113,@,PHI,L 113-131,240,38,93,.409,27,63,.429,11,30,.367,26,30,.867,113,46,83,.554,33,56,.589,13,27,.481,26,32,.813,131
1356,ORL,2022-12-09,113,,TOR,W 113-109,240,42,71,.592,32,45,.711,10,26,.385,19,21,.905,113,36,85,.424,26,50,.520,10,35,.286,27,33,.818,109
1357,LAL,2022-12-07,113,@,TOR,L 113-126,240,37,87,.425,30,54,.556,7,33,.212,32,35,.914,113,47,106,.443,35,63,.556,12,43,.279,20,24,.833,126
1358,SAC,2022-12-07,113,@,MIL,L 113-126,240,43,91,.473,31,53,.585,12,38,.316,15,16,.938,113,46,96,.479,32,63,.508,14,33,.424,20,24,.833,126
1359,NYK,2022-12-07,113,,ATL,W 113-89,240,37,83,.446,20,47,.426,17,36,.472,22,24,.917,113,32,85,.376,26,49,.531,6,36,.167,19,24,.792,89
1360,BRK,2022-11-30,113,,WAS,W 113-107,240,39,84,.464,28,58,.483,11,26,.423,24,26,.923,113,39,89,.438,33,65,.508,6,24,.250,23,34,.676,107
1361,CHI,2022-11-30,113,@,PHO,L 113-132,240,41,82,.500,37,57,.649,4,25,.160,27,33,.818,113,49,93,.527,34,60,.567,15,33,.455,19,21,.905,132
1362,CLE,2022-11-30,113,,PHI,W 113-85,240,45,74,.608,30,45,.667,15,29,.517,8,10,.800,113,32,77,.416,26,51,.510,6,26,.231,15,18,.833,85
1363,GSW,2022-11-29,113,@,DAL,L 113-116,240,42,88,.477,31,45,.689,11,43,.256,18,23,.783,113,42,91,.462,27,47,.574,15,44,.341,17,27,.630,116
1364,HOU,2022-11-28,113,@,DEN,L 113-129,240,39,85,.459,23,41,.561,16,44,.364,19,25,.760,113,50,88,.568,38,58,.655,12,30,.400,17,20,.850,129
1365,PHO,2022-11-26,113,,UTA,W 113-112,240,42,92,.457,36,70,.514,6,22,.273,23,30,.767,113,40,79,.506,27,47,.574,13,32,.406,19,25,.760,112
1366,MIL,2022-11-23,113,,CHI,L 113-118,240,41,90,.456,29,52,.558,12,38,.316,19,25,.760,113,43,87,.494,25,45,.556,18,42,.429,14,18,.778,118
1367,MIA,2022-11-23,113,,WAS,W 113-105,240,39,93,.419,23,52,.442,16,41,.390,19,22,.864,113,42,89,.472,32,51,.627,10,38,.263,11,19,.579,105
1368,SAC,2022-11-22,113,@,MEM,W 113-109,240,39,90,.433,24,45,.533,15,45,.333,20,27,.741,113,41,91,.451,33,61,.541,8,30,.267,19,30,.633,109
1369,CLE,2022-11-20,113,,MIA,W 113-87,240,44,83,.530,31,46,.674,13,37,.351,12,16,.750,113,31,80,.388,25,49,.510,6,31,.194,19,22,.864,87
1370,ORL,2022-11-19,113,@,IND,L 113-114,240,39,91,.429,23,49,.469,16,42,.381,19,26,.731,113,41,90,.456,23,44,.523,18,46,.391,14,19,.737,114
1371,POR,2022-11-19,113,,UTA,L 113-118,240,39,83,.470,26,41,.634,13,42,.310,22,27,.815,113,42,91,.462,28,52,.538,14,39,.359,20,23,.870,118
1372,MIL,2022-11-16,113,,CLE,W 113-98,240,41,86,.477,25,47,.532,16,39,.410,15,27,.556,113,36,84,.429,24,56,.429,12,28,.429,14,17,.824,98
1373,CHO,2022-11-16,113,,IND,L 113-125,240,43,94,.457,31,61,.508,12,33,.364,15,18,.833,113,44,82,.537,33,54,.611,11,28,.393,26,31,.839,125
1374,NOP,2022-11-15,113,,MEM,W 113-102,240,43,91,.473,25,53,.472,18,38,.474,9,12,.750,113,38,92,.413,29,57,.509,9,35,.257,17,25,.680,102
1375,MIA,2022-11-14,113,,PHO,W 113-112,240,38,83,.458,23,50,.460,15,33,.455,22,25,.880,113,48,99,.485,34,63,.540,14,36,.389,2,4,.500,112
1376,TOR,2022-11-11,113,@,OKC,L 113-132,240,38,88,.432,27,58,.466,11,30,.367,26,36,.722,113,52,93,.559,37,57,.649,15,36,.417,13,17,.765,132
1377,WAS,2022-11-10,113,,DAL,W 113-105,240,41,84,.488,29,54,.537,12,30,.400,19,20,.950,113,37,86,.430,19,39,.487,18,47,.383,13,21,.619,105
1378,SAC,2022-11-07,113,@,GSW,L 113-116,240,37,91,.407,23,51,.451,14,40,.350,25,29,.862,113,44,88,.500,30,50,.600,14,38,.368,14,21,.667,116
1379,TOR,2022-11-06,113,,CHI,W 113-104,240,44,103,.427,34,66,.515,10,37,.270,15,20,.750,113,40,88,.455,27,52,.519,13,36,.361,11,13,.846,104
1380,LAC,2022-11-04,113,@,SAS,W 113-106,240,42,80,.525,27,47,.574,15,33,.455,14,19,.737,113,42,88,.477,30,57,.526,12,31,.387,10,18,.556,106
1381,BOS,2022-11-02,113,@,CLE,L 113-114 (OT),265,38,93,.409,27,52,.519,11,41,.268,26,27,.963,113,42,100,.420,31,61,.508,11,39,.282,19,24,.792,114
1382,MIA,2022-10-29,113,@,SAC,L 113-119,240,38,89,.427,27,61,.443,11,28,.393,26,31,.839,113,42,76,.553,28,45,.622,14,31,.452,21,29,.724,119
1383,GSW,2022-10-29,113,@,CHO,L 113-120 (OT),265,44,100,.440,31,56,.554,13,44,.295,12,16,.750,113,43,102,.422,33,71,.465,10,31,.323,24,31,.774,120
1384,ORL,2022-10-28,113,,CHO,W 113-93,240,42,85,.494,32,48,.667,10,37,.270,19,26,.731,113,33,86,.384,22,48,.458,11,38,.289,16,24,.667,93
1385,DET,2022-10-26,113,,ATL,L 113-118,240,42,91,.462,28,59,.475,14,32,.438,15,22,.682,113,45,91,.495,37,69,.536,8,22,.364,20,25,.800,118
1386,NOP,2022-10-25,113,,DAL,W 113-111,240,44,76,.579,32,49,.653,12,27,.444,13,18,.722,113,41,82,.500,29,43,.674,12,39,.308,17,24,.708,111
1387,POR,2022-10-21,113,,PHO,W 113-111 (OT),265,36,82,.439,26,53,.491,10,29,.345,31,36,.861,113,43,94,.457,33,67,.493,10,27,.370,15,21,.714,111
1388,DET,2022-10-19,113,,ORL,W 113-109,240,40,94,.426,26,56,.464,14,38,.368,19,24,.792,113,42,86,.488,31,56,.554,11,30,.367,14,19,.737,109
1389,DAL,2023-04-07,112,,CHI,L 112-115,240,42,93,.452,24,38,.632,18,55,.327,10,13,.769,112,46,88,.523,35,57,.614,11,31,.355,12,18,.667,115
1390,HOU,2023-04-07,112,@,CHO,W 112-109,240,42,89,.472,35,68,.515,7,21,.333,21,28,.750,112,38,88,.432,25,47,.532,13,41,.317,20,27,.741,109
1391,DEN,2023-04-02,112,,GSW,W 112-110,240,44,100,.440,35,67,.522,9,33,.273,15,18,.833,112,42,105,.400,33,63,.524,9,42,.214,17,17,1.000,110
1392,CHI,2023-03-27,112,@,LAC,L 112-124,240,44,82,.537,35,59,.593,9,23,.391,15,21,.714,112,48,81,.593,28,41,.683,20,40,.500,8,16,.500,124
1393,POR,2023-03-26,112,,OKC,L 112-118,240,39,82,.476,25,50,.500,14,32,.438,20,27,.741,112,41,94,.436,29,59,.492,12,35,.343,24,28,.857,118
1394,PHI,2023-03-24,112,@,GSW,L 112-120,240,38,78,.487,30,49,.612,8,29,.276,28,34,.824,112,42,88,.477,24,38,.632,18,50,.360,18,24,.750,120
1395,WAS,2023-03-21,112,@,ORL,L 112-122,240,42,83,.506,32,51,.627,10,32,.313,18,23,.783,112,43,80,.538,31,53,.585,12,27,.444,24,25,.960,122
1396,MEM,2023-03-20,112,,DAL,W 112-108,240,41,89,.461,31,54,.574,10,35,.286,20,26,.769,112,39,84,.464,28,48,.583,11,36,.306,19,20,.950,108
1397,MIA,2023-03-19,112,@,DET,W 112-100,240,38,79,.481,25,40,.625,13,39,.333,23,25,.920,112,38,82,.463,28,50,.560,10,32,.313,14,17,.824,100
1398,NOP,2023-03-17,112,@,HOU,L 112-114,240,39,82,.476,27,54,.500,12,28,.429,22,25,.880,112,43,88,.489,32,56,.571,11,32,.344,17,24,.708,114
1399,POR,2023-03-17,112,,BOS,L 112-126,240,38,79,.481,24,41,.585,14,38,.368,22,31,.710,112,41,87,.471,26,45,.578,15,42,.357,29,35,.829,126
1400,PHO,2023-03-13,112,@,GSW,L 112-123,240,46,95,.484,42,74,.568,4,21,.190,16,22,.727,112,45,83,.542,26,44,.591,19,39,.487,14,24,.583,123
1401,PHI,2023-03-12,112,,WAS,W 112-93,240,41,80,.513,30,51,.588,11,29,.379,19,23,.826,112,34,84,.405,28,58,.483,6,26,.231,19,23,.826,93
1402,NYK,2023-03-12,112,@,LAL,W 112-108,240,42,88,.477,31,51,.608,11,37,.297,17,21,.810,112,43,89,.483,31,53,.585,12,36,.333,10,17,.588,108
1403,MEM,2023-03-11,112,,DAL,W 112-108,240,41,86,.477,31,48,.646,10,38,.263,20,24,.833,112,39,85,.459,24,42,.571,15,43,.349,15,23,.652,108
1404,TOR,2023-03-10,112,@,LAL,L 112-122,240,46,92,.500,36,64,.563,10,28,.357,10,13,.769,112,45,80,.563,32,50,.640,13,30,.433,19,19,1.000,122
1405,CHO,2023-03-07,112,@,NYK,W 112-105,240,42,85,.494,30,53,.566,12,32,.375,16,21,.762,112,38,89,.427,27,49,.551,11,40,.275,18,24,.750,105
1406,LAL,2023-03-07,112,,MEM,W 112-103,240,41,90,.456,34,62,.548,7,28,.250,23,29,.793,112,36,93,.387,27,56,.482,9,37,.243,22,29,.759,103
1407,HOU,2023-02-28,112,,DEN,L 112-133,240,48,97,.495,39,66,.591,9,31,.290,7,10,.700,112,53,92,.576,37,55,.673,16,37,.432,11,16,.688,133
1408,MEM,2023-02-25,112,,DEN,W 112-94,240,45,95,.474,30,51,.588,15,44,.341,7,8,.875,112,36,89,.404,25,52,.481,11,37,.297,11,14,.786,94
1409,MIL,2023-02-16,112,@,CHI,W 112-100,240,40,88,.455,22,41,.537,18,47,.383,14,18,.778,112,37,97,.381,27,65,.415,10,32,.313,16,21,.762,100
1410,CLE,2023-02-15,112,@,PHI,L 112-118,240,41,82,.500,31,52,.596,10,30,.333,20,25,.800,112,39,78,.500,26,51,.510,13,27,.481,27,29,.931,118
1411,DEN,2023-02-13,112,@,MIA,W 112-108,240,44,76,.579,33,48,.688,11,28,.393,13,15,.867,112,39,89,.438,27,54,.500,12,35,.343,18,20,.900,108
1412,TOR,2023-02-08,112,,SAS,W 112-98,240,43,88,.489,33,60,.550,10,28,.357,16,21,.762,112,35,87,.402,26,55,.473,9,32,.281,19,27,.704,98
1413,BRK,2023-02-07,112,,PHO,L 112-116,240,38,79,.481,29,51,.569,9,28,.321,27,31,.871,112,43,92,.467,34,61,.557,9,31,.290,21,28,.750,116
1414,MIN,2023-02-07,112,@,DEN,L 112-146,240,40,85,.471,30,50,.600,10,35,.286,22,26,.846,112,58,93,.624,45,66,.682,13,27,.481,17,22,.773,146
1415,CHO,2023-02-03,112,@,DET,L 112-118,240,40,90,.444,31,56,.554,9,34,.265,23,30,.767,112,44,86,.512,30,54,.556,14,32,.438,16,23,.696,118
1416,LAL,2023-02-02,112,@,IND,W 112-111,240,42,92,.457,36,70,.514,6,22,.273,22,31,.710,112,45,93,.484,29,52,.558,16,41,.390,5,6,.833,111
1417,HOU,2023-02-01,112,,OKC,W 112-106,240,41,94,.436,34,71,.479,7,23,.304,23,31,.742,112,38,103,.369,26,60,.433,12,43,.279,18,22,.818,106
1418,MEM,2023-02-01,112,,POR,L 112-122,240,41,87,.471,32,50,.640,9,37,.243,21,28,.750,112,41,87,.471,27,51,.529,14,36,.389,26,27,.963,122
1419,MEM,2023-01-29,112,,IND,W 112-100,240,43,89,.483,34,52,.654,9,37,.243,17,22,.773,112,36,79,.456,27,47,.574,9,32,.281,19,21,.905,100
1420,OKC,2023-01-27,112,,CLE,W 112-100,240,40,76,.526,30,58,.517,10,18,.556,22,25,.880,112,39,88,.443,31,59,.525,8,29,.276,14,18,.778,100
1421,PHO,2023-01-22,112,,MEM,W 112-110,240,39,88,.443,26,53,.491,13,35,.371,21,25,.840,112,40,92,.435,29,60,.483,11,32,.344,19,27,.704,110
1422,POR,2023-01-22,112,,LAL,L 112-121,240,37,86,.430,20,40,.500,17,46,.370,21,25,.840,112,45,86,.523,35,56,.625,10,30,.333,21,27,.778,121
1423,LAC,2023-01-22,112,@,DAL,W 112-98,240,35,77,.455,23,49,.469,12,28,.429,30,31,.968,112,35,80,.438,22,45,.489,13,35,.371,15,26,.577,98
1424,PHO,2023-01-21,112,,IND,W 112-107,240,38,91,.418,26,60,.433,12,31,.387,24,35,.686,112,36,96,.375,23,59,.390,13,37,.351,22,26,.846,107
1425,BRK,2023-01-19,112,@,PHO,L 112-117,240,43,82,.524,32,56,.571,11,26,.423,15,25,.600,112,39,85,.459,28,57,.491,11,28,.393,28,41,.683,117
1426,LAL,2023-01-15,112,,PHI,L 112-113,240,48,87,.552,42,67,.627,6,20,.300,10,13,.769,112,43,85,.506,31,51,.608,12,34,.353,15,19,.789,113
1427,OKC,2023-01-15,112,@,BRK,W 112-102,240,40,90,.444,28,59,.475,12,31,.387,20,26,.769,112,39,91,.429,27,50,.540,12,41,.293,12,19,.632,102
1428,IND,2023-01-14,112,,MEM,L 112-130,240,38,103,.369,27,56,.482,11,47,.234,25,28,.893,112,48,87,.552,36,55,.655,12,32,.375,22,28,.786,130
1429,NYK,2023-01-13,112,@,WAS,W 112-108,240,41,92,.446,33,63,.524,8,29,.276,22,31,.710,112,36,93,.387,23,51,.451,13,42,.310,23,26,.885,108
1430,UTA,2023-01-13,112,,ORL,W 112-108,240,36,83,.434,25,48,.521,11,35,.314,29,40,.725,112,42,96,.438,28,60,.467,14,36,.389,10,16,.625,108
1431,MIA,2023-01-10,112,,OKC,W 112-111,240,31,79,.392,21,46,.457,10,33,.303,40,40,1.000,112,44,91,.484,35,56,.625,9,35,.257,14,21,.667,111
1432,WAS,2023-01-09,112,,NOP,L 112-132,240,42,82,.512,28,48,.583,14,34,.412,14,18,.778,112,49,93,.527,39,67,.582,10,26,.385,24,31,.774,132
1433,ATL,2023-01-08,112,@,LAC,W 112-108,240,44,89,.494,36,63,.571,8,26,.308,16,20,.800,112,37,95,.389,27,65,.415,10,30,.333,24,31,.774,108
1434,CLE,2023-01-08,112,@,PHO,W 112-98,240,45,78,.577,34,49,.694,11,29,.379,11,17,.647,112,37,84,.440,23,58,.397,14,26,.538,10,11,.909,98
1435,NYK,2023-01-06,112,@,TOR,W 112-108,240,39,83,.470,23,46,.500,16,37,.432,18,26,.692,112,35,83,.422,25,54,.463,10,29,.345,28,35,.800,108
1436,PHI,2023-01-06,112,,CHI,L 112-126,240,40,92,.435,22,51,.431,18,41,.439,14,18,.778,112,48,84,.571,28,50,.560,20,34,.588,10,17,.588,126
1437,BRK,2023-01-04,112,@,CHI,L 112-121,240,42,91,.462,30,54,.556,12,37,.324,16,21,.762,112,43,81,.531,35,61,.574,8,20,.400,27,29,.931,121
1438,LAL,2023-01-04,112,,MIA,W 112-109,240,40,81,.494,32,54,.593,8,27,.296,24,30,.800,112,43,95,.453,35,66,.530,8,29,.276,15,21,.714,109
1439,POR,2022-12-30,112,@,GSW,L 112-118,240,42,91,.462,30,52,.577,12,39,.308,16,23,.696,112,42,91,.462,25,48,.521,17,43,.395,17,21,.810,118
1440,GSW,2022-12-28,112,,UTA,W 112-107,240,37,87,.425,21,42,.500,16,45,.356,22,27,.815,112,37,91,.407,22,45,.489,15,46,.326,18,26,.692,107
1441,MIA,2022-12-28,112,,LAL,W 112-98,240,44,92,.478,33,57,.579,11,35,.314,13,16,.813,112,37,77,.481,24,41,.585,13,36,.361,11,15,.733,98
1442,NYK,2022-12-25,112,,PHI,L 112-119,240,43,90,.478,31,58,.534,12,32,.375,14,17,.824,112,39,77,.506,21,38,.553,18,39,.462,23,29,.793,119
1443,DAL,2022-12-23,112,@,HOU,W 112-106,240,36,80,.450,20,36,.556,16,44,.364,24,27,.889,112,37,81,.457,29,55,.527,8,26,.308,24,28,.857,106
1444,WAS,2022-12-22,112,@,UTA,L 112-120,240,46,82,.561,39,61,.639,7,21,.333,13,17,.765,112,42,86,.488,26,51,.510,16,35,.457,20,21,.952,120
1445,BOS,2022-12-21,112,,IND,L 112-117,240,39,101,.386,26,60,.433,13,41,.317,21,25,.840,112,46,98,.469,28,59,.475,18,39,.462,7,9,.778,117
1446,MIN,2022-12-16,112,@,OKC,W 112-110,240,43,87,.494,31,62,.500,12,25,.480,14,25,.560,112,41,88,.466,30,51,.588,11,37,.297,17,21,.810,110
1447,IND,2022-12-16,112,@,CLE,L 112-118,240,42,80,.525,31,44,.705,11,36,.306,17,19,.895,112,38,76,.500,24,45,.533,14,31,.452,28,32,.875,118
1448,SAS,2022-12-14,112,,POR,L 112-128,240,45,97,.464,34,68,.500,11,29,.379,11,19,.579,112,49,81,.605,31,41,.756,18,40,.450,12,17,.706,128
1449,MIN,2022-12-12,112,@,POR,L 112-133,240,46,93,.495,36,66,.545,10,27,.370,10,19,.526,112,48,89,.539,27,43,.628,21,46,.457,16,21,.762,133
1450,BRK,2022-12-12,112,@,WAS,W 112-100,240,44,89,.494,36,62,.581,8,27,.296,16,18,.889,112,37,79,.468,26,48,.542,11,31,.355,15,22,.682,100
1451,SAS,2022-12-12,112,,CLE,W 112-111,240,46,97,.474,37,70,.529,9,27,.333,11,16,.688,112,45,92,.489,40,69,.580,5,23,.217,16,17,.941,111
1452,NYK,2022-12-11,112,,SAC,W 112-99,240,40,89,.449,32,54,.593,8,35,.229,24,27,.889,112,33,83,.398,23,44,.523,10,39,.256,23,35,.657,99
1453,IND,2022-12-05,112,@,GSW,W 112-104,240,43,90,.478,28,51,.549,15,39,.385,11,18,.611,112,38,94,.404,25,50,.500,13,44,.295,15,19,.789,104
1454,DET,2022-12-04,112,,MEM,L 112-122,240,37,84,.440,24,49,.490,13,35,.371,25,30,.833,112,43,92,.467,28,57,.491,15,35,.429,21,29,.724,122
1455,LAC,2022-11-30,112,@,UTA,L 112-125,240,37,93,.398,27,63,.429,10,30,.333,28,36,.778,112,45,81,.556,31,49,.633,14,32,.438,21,28,.750,125
1456,POR,2022-11-29,112,,LAC,L 112-118,240,42,90,.467,25,55,.455,17,35,.486,11,15,.733,112,41,89,.461,28,58,.483,13,31,.419,23,28,.821,118
1457,UTA,2022-11-26,112,@,PHO,L 112-113,240,40,79,.506,27,47,.574,13,32,.406,19,25,.760,112,42,92,.457,36,70,.514,6,22,.273,23,30,.767,113
1458,BRK,2022-11-23,112,@,TOR,W 112-98,240,45,82,.549,28,44,.636,17,38,.447,5,7,.714,112,36,101,.356,29,72,.403,7,29,.241,19,25,.760,98
1459,DAL,2022-11-23,112,@,BOS,L 112-125,240,44,82,.537,33,51,.647,11,31,.355,13,21,.619,112,45,84,.536,28,50,.560,17,34,.500,18,21,.857,125
1460,MIN,2022-11-19,112,@,PHI,W 112-109,240,40,85,.471,28,49,.571,12,36,.333,20,24,.833,112,34,71,.479,20,39,.513,14,32,.438,27,32,.844,109
1461,SAS,2022-11-17,112,@,SAC,L 112-130,240,46,84,.548,35,58,.603,11,26,.423,9,12,.750,112,48,83,.578,36,53,.679,12,30,.400,22,24,.917,130
1462,TOR,2022-11-16,112,,MIA,W 112-104,240,44,86,.512,37,60,.617,7,26,.269,17,22,.773,112,36,66,.545,23,31,.742,13,35,.371,19,22,.864,104
1463,PHO,2022-11-14,112,@,MIA,L 112-113,240,48,99,.485,34,63,.540,14,36,.389,2,4,.500,112,38,83,.458,23,50,.460,15,33,.455,22,25,.880,113
1464,CHO,2022-11-14,112,@,ORL,W 112-105,240,42,88,.477,35,53,.660,7,35,.200,21,24,.875,112,36,88,.409,22,52,.423,14,36,.389,19,23,.826,105
1465,POR,2022-11-12,112,@,DAL,L 112-117,240,36,80,.450,23,49,.469,13,31,.419,27,35,.771,112,41,81,.506,27,38,.711,14,43,.326,21,26,.808,117
1466,UTA,2022-11-12,112,@,WAS,L 112-121,240,44,94,.468,30,54,.556,14,40,.350,10,11,.909,112,44,88,.500,28,52,.538,16,36,.444,17,20,.850,121
1467,DEN,2022-11-11,112,@,BOS,L 112-131,240,42,92,.457,30,63,.476,12,29,.414,16,20,.800,112,50,90,.556,34,53,.642,16,37,.432,15,20,.750,131
1468,DET,2022-11-11,112,@,NYK,L 112-121,240,37,80,.463,30,49,.612,7,31,.226,31,41,.756,112,42,94,.447,32,54,.593,10,40,.250,27,29,.931,121
1469,CHO,2022-11-10,112,@,MIA,L 112-117 (OT),265,43,88,.489,29,49,.592,14,39,.359,12,20,.600,112,39,90,.433,29,54,.537,10,36,.278,29,36,.806,117
1470,BRK,2022-11-09,112,,NYK,W 112-85,240,42,87,.483,28,53,.528,14,34,.412,14,20,.700,112,28,87,.322,16,44,.364,12,43,.279,17,26,.654,85
1471,DET,2022-11-09,112,@,BOS,L 112-128,240,37,89,.416,30,56,.536,7,33,.212,31,40,.775,112,47,88,.534,29,42,.690,18,46,.391,16,21,.762,128
1472,DET,2022-11-07,112,,OKC,W 112-103,240,39,93,.419,30,60,.500,9,33,.273,25,33,.758,112,41,102,.402,31,69,.449,10,33,.303,11,17,.647,103
1473,CLE,2022-11-04,112,@,DET,W 112-88,240,44,81,.543,33,55,.600,11,26,.423,13,16,.813,112,31,83,.373,18,46,.391,13,37,.351,13,15,.867,88
1474,ATL,2022-11-02,112,@,NYK,W 112-99,240,44,107,.411,32,73,.438,12,34,.353,12,16,.750,112,37,90,.411,27,54,.500,10,36,.278,15,20,.750,99
1475,BOS,2022-10-30,112,,WAS,W 112-94,240,36,79,.456,15,32,.469,21,47,.447,19,20,.950,112,38,98,.388,31,66,.470,7,32,.219,11,16,.688,94
1476,NOP,2022-10-30,112,@,LAC,W 112-91,240,46,93,.495,31,57,.544,15,36,.417,5,8,.625,112,36,86,.419,25,47,.532,11,39,.282,8,13,.615,91
1477,PHI,2022-10-28,112,@,TOR,W 112-90,240,43,82,.524,27,44,.614,16,38,.421,10,11,.909,112,33,86,.384,24,47,.511,9,39,.231,15,24,.625,90
1478,DET,2022-10-28,112,,ATL,L 112-136,240,37,86,.430,30,54,.556,7,32,.219,31,38,.816,112,55,97,.567,43,68,.632,12,29,.414,14,18,.778,136
1479,PHO,2022-10-23,112,@,LAC,W 112-95,240,43,93,.462,28,51,.549,15,42,.357,11,12,.917,112,36,82,.439,27,50,.540,9,32,.281,14,20,.700,95
1480,MIA,2022-10-22,112,,TOR,W 112-109,240,38,76,.500,27,46,.587,11,30,.367,25,27,.926,112,37,87,.425,23,48,.479,14,39,.359,21,28,.750,109
1481,CHO,2022-10-21,112,,NOP,L 112-124,240,44,97,.454,31,63,.492,13,34,.382,11,14,.786,112,42,89,.472,34,67,.507,8,22,.364,32,37,.865,124
1482,NYK,2022-10-19,112,@,MEM,L 112-115 (OT),265,44,109,.404,35,72,.486,9,37,.243,15,18,.833,112,42,108,.389,25,58,.431,17,50,.340,14,23,.609,115
1483,BRK,2023-04-02,111,,UTA,W 111-110,240,38,86,.442,29,54,.537,9,32,.281,26,34,.765,111,40,91,.440,32,59,.542,8,32,.250,22,30,.733,110
1484,MIN,2023-03-31,111,,LAL,L 111-123,240,41,95,.432,28,56,.500,13,39,.333,16,19,.842,111,45,90,.500,36,68,.529,9,22,.409,24,30,.800,123
1485,BOS,2023-03-28,111,@,WAS,L 111-130,240,45,93,.484,34,49,.694,11,44,.250,10,11,.909,111,54,99,.545,41,62,.661,13,37,.351,9,13,.692,130
1486,PHI,2023-03-27,111,@,DEN,L 111-116,240,43,89,.483,35,59,.593,8,30,.267,17,22,.773,111,43,85,.506,32,53,.604,11,32,.344,19,22,.864,116
1487,OKC,2023-03-24,111,@,LAL,L 111-116,240,40,92,.435,26,56,.464,14,36,.389,17,19,.895,111,42,91,.462,30,57,.526,12,34,.353,20,28,.714,116
1488,ORL,2023-03-23,111,,NYK,W 111-106,240,40,87,.460,27,55,.491,13,32,.406,18,21,.857,111,37,88,.420,25,48,.521,12,40,.300,20,26,.769,106
1489,PHO,2023-03-22,111,@,LAL,L 111-122,240,42,90,.467,30,59,.508,12,31,.387,15,20,.750,111,39,70,.557,31,53,.585,8,17,.471,36,46,.783,122
1490,TOR,2023-03-19,111,@,MIL,L 111-118,240,44,99,.444,30,65,.462,14,34,.412,9,12,.750,111,43,82,.524,27,37,.730,16,45,.356,16,21,.762,118
1491,LAL,2023-03-19,111,,ORL,W 111-105,240,36,78,.462,23,46,.500,13,32,.406,26,32,.813,111,41,102,.402,31,64,.484,10,38,.263,13,17,.765,105
1492,DAL,2023-03-17,111,@,LAL,W 111-110,240,40,79,.506,24,45,.533,16,34,.471,15,19,.789,111,43,84,.512,38,64,.594,5,20,.250,19,31,.613,110
1493,OKC,2023-03-16,111,@,TOR,L 111-128,240,40,94,.426,27,63,.429,13,31,.419,18,20,.900,111,47,97,.485,33,65,.508,14,32,.438,20,28,.714,128
1494,HOU,2023-03-13,111,,BOS,W 111-109,240,40,90,.444,29,55,.527,11,35,.314,20,27,.741,111,39,87,.448,27,45,.600,12,42,.286,19,21,.905,109
1495,HOU,2023-03-11,111,,CHI,L 111-119,240,41,85,.482,25,51,.490,16,34,.471,13,17,.765,111,44,86,.512,29,54,.537,15,32,.469,16,22,.727,119
1496,CHO,2023-03-11,111,,UTA,L 111-119,240,40,98,.408,23,58,.397,17,40,.425,14,15,.933,111,46,103,.447,37,71,.521,9,32,.281,18,20,.900,119
1497,WAS,2023-03-05,111,,MIL,L 111-117,240,46,108,.426,38,77,.494,8,31,.258,11,12,.917,111,39,83,.470,17,34,.500,22,49,.449,17,22,.773,117
1498,POR,2023-03-03,111,@,ATL,L 111-129,240,41,87,.471,28,48,.583,13,39,.333,16,20,.800,111,52,91,.571,40,65,.615,12,26,.462,13,16,.813,129
1499,LAL,2023-02-26,111,@,DAL,W 111-108,240,42,97,.433,36,63,.571,6,34,.176,21,28,.750,111,39,93,.419,19,44,.432,20,49,.408,10,14,.714,108
1500,GSW,2023-02-23,111,@,LAL,L 111-124,240,40,105,.381,26,56,.464,14,49,.286,17,21,.810,111,42,86,.488,26,56,.464,16,30,.533,24,34,.706,124
1501,UTA,2023-02-15,111,@,MEM,L 111-117,240,42,91,.462,30,55,.545,12,36,.333,15,19,.789,111,43,107,.402,29,67,.433,14,40,.350,17,25,.680,117
1502,IND,2023-02-08,111,@,MIA,L 111-116,240,38,78,.487,23,45,.511,15,33,.455,20,28,.714,111,37,79,.468,31,60,.517,6,19,.316,36,39,.923,116
1503,BOS,2023-02-06,111,@,DET,W 111-99,240,39,83,.470,23,46,.500,16,37,.432,17,21,.810,111,37,87,.425,28,54,.519,9,33,.273,16,21,.762,99
1504,UTA,2023-02-06,111,,DAL,L 111-124,240,41,87,.471,35,56,.625,6,31,.194,23,26,.885,111,41,88,.466,26,49,.531,15,39,.385,27,31,.871,124
1505,HOU,2023-02-03,111,,TOR,L 111-117,240,40,80,.500,33,59,.559,7,21,.333,24,33,.727,111,41,90,.456,26,51,.510,15,39,.385,20,27,.741,117
1506,DAL,2023-02-02,111,,NOP,W 111-106,240,37,85,.435,23,44,.523,14,41,.341,23,29,.793,111,42,84,.500,37,64,.578,5,20,.250,17,21,.810,106
1507,IND,2023-02-02,111,,LAL,L 111-112,240,45,93,.484,29,52,.558,16,41,.390,5,6,.833,111,42,92,.457,36,70,.514,6,22,.273,22,31,.710,112
1508,MIN,2023-01-30,111,,SAC,L 111-118 (OT),265,43,92,.467,31,53,.585,12,39,.308,13,25,.520,111,47,99,.475,38,69,.551,9,30,.300,15,22,.682,118
1509,DAL,2023-01-30,111,,DET,W 111-105,240,39,79,.494,29,45,.644,10,34,.294,23,33,.697,111,36,79,.456,22,40,.550,14,39,.359,19,27,.704,105
1510,MIN,2023-01-27,111,,MEM,W 111-100,240,44,86,.512,31,51,.608,13,35,.371,10,15,.667,111,38,93,.409,30,60,.500,8,33,.242,16,19,.842,100
1511,CHO,2023-01-26,111,,CHI,W 111-96,240,39,84,.464,32,52,.615,7,32,.219,26,31,.839,111,37,91,.407,33,66,.500,4,25,.160,18,22,.818,96
1512,MIN,2023-01-25,111,@,NOP,W 111-102,240,40,82,.488,29,53,.547,11,29,.379,20,28,.714,111,37,85,.435,25,47,.532,12,38,.316,16,21,.762,102
1513,CHI,2023-01-23,111,,ATL,W 111-100,240,44,95,.463,33,61,.541,11,34,.324,12,18,.667,111,39,85,.459,29,52,.558,10,33,.303,12,19,.632,100
1514,IND,2023-01-20,111,@,DEN,L 111-134,240,37,84,.440,29,52,.558,8,32,.250,29,37,.784,111,51,83,.614,37,55,.673,14,28,.500,18,26,.692,134
1515,LAL,2023-01-18,111,,SAC,L 111-116,240,43,89,.483,32,55,.582,11,34,.324,14,18,.778,111,43,87,.494,34,57,.596,9,30,.300,21,27,.778,116
1516,MIA,2023-01-14,111,,MIL,W 111-95,240,45,87,.517,34,65,.523,11,22,.500,10,12,.833,111,34,84,.405,15,36,.417,19,48,.396,8,12,.667,95
1517,IND,2023-01-13,111,,ATL,L 111-113,240,40,101,.396,33,71,.465,7,30,.233,24,29,.828,111,41,94,.436,25,61,.410,16,33,.485,15,21,.714,113
1518,OKC,2023-01-10,111,@,MIA,L 111-112,240,44,91,.484,35,56,.625,9,35,.257,14,21,.667,111,31,79,.392,21,46,.457,10,33,.303,40,40,1.000,112
1519,ORL,2023-01-09,111,@,SAC,L 111-136,240,41,90,.456,27,46,.587,14,44,.318,15,20,.750,111,52,97,.536,29,51,.569,23,46,.500,9,12,.750,136
1520,MIL,2023-01-09,111,@,NYK,W 111-107,240,39,89,.438,20,40,.500,19,49,.388,14,18,.778,111,38,100,.380,27,59,.458,11,41,.268,20,22,.909,107
1521,DET,2023-01-08,111,,PHI,L 111-123,240,44,87,.506,36,64,.563,8,23,.348,15,18,.833,111,46,94,.489,35,57,.614,11,37,.297,20,23,.870,123
1522,CHO,2023-01-08,111,@,IND,L 111-116,240,38,88,.432,27,55,.491,11,33,.333,24,27,.889,111,38,87,.437,25,49,.510,13,38,.342,27,33,.818,116
1523,DEN,2023-01-02,111,@,MIN,L 111-124,240,42,91,.462,31,62,.500,11,29,.379,16,20,.800,111,45,87,.517,32,51,.627,13,36,.361,21,27,.778,124
1524,NOP,2023-01-02,111,@,PHI,L 111-120,240,42,84,.500,31,55,.564,11,29,.379,16,20,.800,111,41,86,.477,26,51,.510,15,35,.429,23,28,.821,120
1525,DAL,2023-01-02,111,@,HOU,W 111-106,240,34,81,.420,21,38,.553,13,43,.302,30,34,.882,111,38,82,.463,29,53,.547,9,29,.310,21,29,.724,106
1526,BOS,2023-01-01,111,@,DEN,L 111-123,240,40,87,.460,31,54,.574,9,33,.273,22,27,.815,111,45,79,.570,28,49,.571,17,30,.567,16,18,.889,123
1527,PHI,2022-12-27,111,@,WAS,L 111-116,240,39,84,.464,33,53,.623,6,31,.194,27,31,.871,111,39,85,.459,28,52,.538,11,33,.333,27,31,.871,116
1528,SAC,2022-12-23,111,,WAS,L 111-125,240,37,84,.440,27,52,.519,10,32,.313,27,35,.771,111,49,88,.557,39,56,.696,10,32,.313,17,24,.708,125
1529,IND,2022-12-23,111,@,MIA,W 111-108,240,40,83,.482,19,36,.528,21,47,.447,10,14,.714,111,41,95,.432,28,62,.452,13,33,.394,13,14,.929,108
1530,DET,2022-12-20,111,,UTA,L 111-126,240,41,81,.506,32,56,.571,9,25,.360,20,27,.741,111,47,93,.505,27,47,.574,20,46,.435,12,19,.632,126
1531,MIA,2022-12-17,111,@,SAS,W 111-101,240,42,82,.512,31,52,.596,11,30,.367,16,23,.696,111,33,77,.429,23,50,.460,10,27,.370,25,33,.758,101
1532,PHO,2022-12-15,111,@,LAC,W 111-95,240,44,95,.463,35,63,.556,9,32,.281,14,18,.778,111,34,90,.378,22,57,.386,12,33,.364,15,21,.714,95
1533,MIA,2022-12-15,111,@,HOU,W 111-108,240,39,88,.443,23,41,.561,16,47,.340,17,23,.739,111,44,94,.468,35,61,.574,9,33,.273,11,17,.647,108
1534,GSW,2022-12-13,111,@,MIL,L 111-128,240,38,95,.400,18,45,.400,20,50,.400,15,19,.789,111,45,82,.549,33,53,.623,12,29,.414,26,32,.813,128
1535,HOU,2022-12-13,111,,PHO,W 111-97,240,34,81,.420,22,46,.478,12,35,.343,31,34,.912,111,33,103,.320,20,52,.385,13,51,.255,18,19,.947,97
1536,CLE,2022-12-12,111,@,SAS,L 111-112,240,45,92,.489,40,69,.580,5,23,.217,16,17,.941,111,46,97,.474,37,70,.529,9,27,.333,11,16,.688,112
1537,ORL,2022-12-11,111,,TOR,W 111-99,240,36,77,.468,22,46,.478,14,31,.452,25,31,.806,111,30,75,.400,24,50,.480,6,25,.240,33,38,.868,99
1538,MIA,2022-12-10,111,,SAS,L 111-115,240,39,81,.481,26,47,.553,13,34,.382,20,28,.714,111,42,78,.538,35,57,.614,7,21,.333,24,31,.774,115
1539,WAS,2022-12-09,111,@,IND,L 111-121,240,41,77,.532,31,48,.646,10,29,.345,19,25,.760,111,43,85,.506,25,44,.568,18,41,.439,17,20,.850,121
1540,WAS,2022-12-07,111,@,CHI,L 111-115,240,41,84,.488,32,53,.604,9,31,.290,20,29,.690,111,45,90,.500,35,67,.522,10,23,.435,15,17,.882,115
1541,LAC,2022-12-07,111,@,ORL,L 111-116 (OT),265,39,95,.411,24,54,.444,15,41,.366,18,26,.692,111,40,95,.421,32,67,.478,8,28,.286,28,31,.903,116
1542,PHO,2022-12-05,111,@,DAL,L 111-130,240,40,91,.440,27,54,.500,13,37,.351,18,26,.692,111,44,84,.524,24,43,.558,20,41,.488,22,26,.846,130
1543,UTA,2022-12-03,111,,POR,L 111-116,240,38,84,.452,25,48,.521,13,36,.361,22,28,.786,111,41,85,.482,31,60,.517,10,25,.400,24,31,.774,116
1544,CHI,2022-12-02,111,@,GSW,L 111-119,240,43,93,.462,34,66,.515,9,27,.333,16,24,.667,111,42,87,.483,22,37,.595,20,50,.400,15,23,.652,119
1545,SAS,2022-11-30,111,@,OKC,L 111-119,240,41,92,.446,31,55,.564,10,37,.270,19,25,.760,111,48,94,.511,39,67,.582,9,27,.333,14,21,.667,119
1546,BRK,2022-11-27,111,,POR,W 111-97,240,41,78,.526,26,43,.605,15,35,.429,14,18,.778,111,35,79,.443,23,46,.500,12,33,.364,15,22,.682,97
1547,NOP,2022-11-25,111,@,MEM,L 111-132,240,37,86,.430,27,55,.491,10,31,.323,27,31,.871,111,47,91,.516,29,53,.547,18,38,.474,20,27,.741,132
1548,POR,2022-11-21,111,@,MIL,L 111-119,240,44,93,.473,36,64,.563,8,29,.276,15,19,.789,111,47,86,.547,38,58,.655,9,28,.321,16,25,.640,119
1549,GSW,2022-11-18,111,,NYK,W 111-101,240,41,91,.451,23,41,.561,18,50,.360,11,20,.550,111,30,87,.345,21,53,.396,9,34,.265,32,34,.941,101
1550,UTA,2022-11-15,111,,NYK,L 111-118,240,36,83,.434,22,40,.550,14,43,.326,25,30,.833,111,44,93,.473,33,61,.541,11,32,.344,19,25,.760,118
1551,DET,2022-11-14,111,,TOR,L 111-115,240,35,77,.455,25,46,.543,10,31,.323,31,43,.721,111,40,82,.488,32,55,.582,8,27,.296,27,28,.964,115
1552,SAS,2022-11-11,111,,MIL,W 111-93,240,43,85,.506,31,54,.574,12,31,.387,13,15,.867,111,32,98,.327,20,55,.364,12,43,.279,17,23,.739,93
1553,CHI,2022-11-09,111,,NOP,L 111-115,240,44,87,.506,37,60,.617,7,27,.259,16,18,.889,111,42,84,.500,39,65,.600,3,19,.158,28,36,.778,115
1554,CHI,2022-11-07,111,,TOR,W 111-97,240,42,80,.525,33,52,.635,9,28,.321,18,22,.818,111,36,85,.424,27,57,.474,9,28,.321,16,22,.727,97
1555,DAL,2022-11-04,111,,TOR,W 111-110,240,39,77,.506,27,43,.628,12,34,.353,21,25,.840,111,39,88,.443,28,54,.519,11,34,.324,21,25,.840,110
1556,MEM,2022-11-02,111,@,POR,W 111-106,240,38,83,.458,25,55,.455,13,28,.464,22,27,.815,111,36,89,.404,23,56,.411,13,33,.394,21,26,.808,106
1557,PHI,2022-11-02,111,,WAS,L 111-121,240,39,84,.464,20,48,.417,19,36,.528,14,20,.700,111,45,78,.577,40,57,.702,5,21,.238,26,32,.813,121
1558,WAS,2022-10-31,111,,PHI,L 111-118,240,38,81,.469,28,56,.500,10,25,.400,25,26,.962,111,46,83,.554,34,53,.642,12,30,.400,14,20,.700,118
1559,DAL,2022-10-29,111,,OKC,L 111-117 (OT),265,38,95,.400,30,55,.545,8,40,.200,27,34,.794,111,44,89,.494,39,64,.609,5,25,.200,24,31,.774,117
1560,MIN,2022-10-28,111,,LAL,W 111-102,240,41,99,.414,28,59,.475,13,40,.325,16,24,.667,111,37,89,.416,28,60,.467,9,29,.310,19,27,.704,102
1561,HOU,2022-10-28,111,@,POR,L 111-125,240,40,94,.426,26,56,.464,14,38,.368,17,21,.810,111,48,90,.533,35,55,.636,13,35,.371,16,20,.800,125
1562,NOP,2022-10-28,111,@,PHO,L 111-124,240,38,86,.442,23,49,.469,15,37,.405,20,22,.909,111,48,92,.522,38,59,.644,10,33,.303,18,20,.900,124
1563,DAL,2022-10-25,111,@,NOP,L 111-113,240,41,82,.500,29,43,.674,12,39,.308,17,24,.708,111,44,76,.579,32,49,.653,12,27,.444,13,18,.722,113
1564,LAC,2022-10-22,111,@,SAC,W 111-109,240,41,81,.506,32,59,.542,9,22,.409,20,22,.909,111,40,85,.471,26,50,.520,14,35,.400,15,26,.577,109
1565,BOS,2022-10-21,111,@,MIA,W 111-104,240,41,79,.519,27,46,.587,14,33,.424,15,15,1.000,111,42,92,.457,34,66,.515,8,26,.308,12,15,.800,104
1566,PHO,2022-10-21,111,@,POR,L 111-113 (OT),265,43,94,.457,33,67,.493,10,27,.370,15,21,.714,111,36,82,.439,26,53,.491,10,29,.345,31,36,.861,113
1567,ORL,2023-04-09,110,@,MIA,L 110-123,240,38,90,.422,21,43,.488,17,47,.362,17,24,.708,110,45,83,.542,27,39,.692,18,44,.409,15,20,.750,123
1568,GSW,2023-04-02,110,@,DEN,L 110-112,240,42,105,.400,33,63,.524,9,42,.214,17,17,1.000,110,44,100,.440,35,67,.522,9,33,.273,15,18,.833,112
1569,UTA,2023-04-02,110,@,BRK,L 110-111,240,40,91,.440,32,59,.542,8,32,.250,22,30,.733,110,38,86,.442,29,54,.537,9,32,.281,26,34,.765,111
1570,TOR,2023-03-31,110,@,PHI,L 110-117,240,42,84,.500,34,58,.586,8,26,.308,18,23,.783,110,41,73,.562,29,42,.690,12,31,.387,23,25,.920,117
1571,CHI,2023-03-29,110,,LAL,L 110-121,240,45,88,.511,36,55,.655,9,33,.273,11,13,.846,110,45,86,.523,38,66,.576,7,20,.350,24,30,.800,121
1572,CHO,2023-03-26,110,,DAL,W 110-104,240,39,88,.443,27,59,.458,12,29,.414,20,24,.833,110,32,84,.381,13,35,.371,19,49,.388,21,22,.955,104
1573,LAC,2023-03-25,110,,NOP,L 110-131,240,39,75,.520,24,42,.571,15,33,.455,17,21,.810,110,51,96,.531,30,62,.484,21,34,.618,8,9,.889,131
1574,DEN,2023-03-18,110,@,NYK,L 110-116,240,43,84,.512,31,51,.608,12,33,.364,12,15,.800,110,41,83,.494,32,51,.627,9,32,.281,25,28,.893,116
1575,LAL,2023-03-17,110,,DAL,L 110-111,240,43,84,.512,38,64,.594,5,20,.250,19,31,.613,110,40,79,.506,24,45,.533,16,34,.471,15,19,.789,111
1576,LAL,2023-03-15,110,@,HOU,L 110-114,240,34,90,.378,23,46,.500,11,44,.250,31,37,.838,110,47,89,.528,39,60,.650,8,29,.276,12,19,.632,114
1577,DEN,2023-03-14,110,@,TOR,L 110-125,240,42,76,.553,36,51,.706,6,25,.240,20,25,.800,110,49,93,.527,37,63,.587,12,30,.400,15,17,.882,125
1578,POR,2023-03-12,110,@,NOP,L 110-127,240,43,88,.489,33,55,.600,10,33,.303,14,20,.700,110,43,86,.500,24,46,.522,19,40,.475,22,29,.759,127
1579,OKC,2023-03-11,110,@,NOP,W 110-96,240,37,80,.463,28,52,.538,9,28,.321,27,32,.844,110,34,81,.420,22,47,.468,12,34,.353,16,19,.842,96
1580,GSW,2023-03-09,110,@,MEM,L 110-131,240,36,82,.439,21,37,.568,15,45,.333,23,24,.958,110,50,93,.538,32,53,.604,18,40,.450,13,18,.722,131
1581,POR,2023-03-06,110,@,DET,W 110-104,240,38,78,.487,23,45,.511,15,33,.455,19,25,.760,110,40,86,.465,30,54,.556,10,32,.313,14,20,.700,104
1582,SAS,2023-03-05,110,@,HOU,L 110-142,240,43,93,.462,32,59,.542,11,34,.324,13,21,.619,110,52,85,.612,39,61,.639,13,24,.542,25,29,.862,142
1583,SAS,2023-03-04,110,,HOU,L 110-122,240,38,86,.442,23,49,.469,15,37,.405,19,20,.950,110,49,87,.563,41,64,.641,8,23,.348,16,22,.727,122
1584,MIN,2023-03-03,110,@,LAL,W 110-102,240,42,89,.472,28,55,.509,14,34,.412,12,16,.750,110,36,87,.414,26,56,.464,10,31,.323,20,24,.833,102
1585,SAS,2023-03-02,110,,IND,W 110-99,240,45,98,.459,35,66,.530,10,32,.313,10,13,.769,110,41,90,.456,33,67,.493,8,23,.348,9,11,.818,99
1586,POR,2023-03-01,110,,NOP,L 110-121,240,36,81,.444,25,43,.581,11,38,.289,27,29,.931,110,46,89,.517,37,64,.578,9,25,.360,20,23,.870,121
1587,BOS,2023-02-25,110,@,PHI,W 110-107,240,43,86,.500,27,50,.540,16,36,.444,8,12,.667,110,35,78,.449,26,51,.510,9,27,.333,28,35,.800,107
1588,NOP,2023-02-23,110,@,TOR,L 110-115,240,39,84,.464,26,54,.481,13,30,.433,19,25,.760,110,43,92,.467,34,61,.557,9,31,.290,20,25,.800,115
1589,PHI,2023-02-23,110,,MEM,W 110-105,240,34,84,.405,21,48,.438,13,36,.361,29,36,.806,110,34,87,.391,27,55,.491,7,32,.219,30,36,.833,105
1590,SAS,2023-02-15,110,@,CHO,L 110-120,240,41,107,.383,28,69,.406,13,38,.342,15,20,.750,110,43,96,.448,29,61,.475,14,35,.400,20,29,.690,120
1591,DAL,2023-02-08,110,@,LAC,W 110-104,240,41,78,.526,24,43,.558,17,35,.486,11,17,.647,110,38,86,.442,26,53,.491,12,33,.364,16,21,.762,104
1592,NOP,2023-01-29,110,@,MIL,L 110-135,240,41,93,.441,28,59,.475,13,34,.382,15,21,.714,110,53,96,.552,36,53,.679,17,43,.395,12,20,.600,135
1593,SAC,2023-01-28,110,@,MIN,L 110-117,240,37,82,.451,28,49,.571,9,33,.273,27,36,.750,110,42,80,.525,25,43,.581,17,37,.459,16,21,.762,117
1594,MIA,2023-01-27,110,,ORL,W 110-105,240,39,85,.459,29,52,.558,10,33,.303,22,26,.846,110,33,69,.478,21,35,.600,12,34,.353,27,32,.844,105
1595,CHI,2023-01-24,110,@,IND,L 110-116,240,43,88,.489,38,64,.594,5,24,.208,19,25,.760,110,42,99,.424,32,62,.516,10,37,.270,22,28,.786,116
1596,MEM,2023-01-22,110,@,PHO,L 110-112,240,40,92,.435,29,60,.483,11,32,.344,19,27,.704,110,39,88,.443,26,53,.491,13,35,.371,21,25,.840,112
1597,NOP,2023-01-20,110,@,ORL,L 110-123,240,41,91,.451,31,56,.554,10,35,.286,18,24,.750,110,39,75,.520,24,45,.533,15,30,.500,30,34,.882,123
1598,LAC,2023-01-17,110,,PHI,L 110-120,240,41,82,.500,29,48,.604,12,34,.353,16,20,.800,110,39,73,.534,26,42,.619,13,31,.419,29,34,.853,120
1599,MIN,2023-01-14,110,,CLE,W 110-102,240,45,80,.563,36,52,.692,9,28,.321,11,15,.733,110,37,76,.487,29,48,.604,8,28,.286,20,23,.870,102
1600,CHI,2023-01-13,110,,OKC,L 110-124,240,38,85,.447,26,47,.553,12,38,.316,22,24,.917,110,47,92,.511,36,59,.610,11,33,.333,19,22,.864,124
1601,CHI,2023-01-13,110,,OKC,L 110-124,240,38,85,.447,26,47,.553,12,38,.316,22,24,.917,110,47,92,.511,36,59,.610,11,33,.333,19,22,.864,124
1602,WAS,2023-01-06,110,@,OKC,L 110-127,240,38,79,.481,31,55,.564,7,24,.292,27,36,.750,110,50,98,.510,33,61,.541,17,37,.459,10,14,.714,127
1603,MIA,2023-01-02,110,@,LAC,W 110-100,240,39,85,.459,27,49,.551,12,36,.333,20,24,.833,110,29,67,.433,17,38,.447,12,29,.414,30,34,.882,100
1604,LAC,2022-12-29,110,@,BOS,L 110-116,240,43,89,.483,28,50,.560,15,39,.385,9,14,.643,110,44,91,.484,33,52,.635,11,39,.282,17,22,.773,116
1605,ORL,2022-12-27,110,,LAL,L 110-129,240,42,84,.500,32,56,.571,10,28,.357,16,25,.640,110,49,90,.544,32,47,.681,17,43,.395,14,17,.824,129
1606,GSW,2022-12-27,110,,CHO,W 110-105,240,41,95,.432,33,58,.569,8,37,.216,20,24,.833,110,38,92,.413,28,54,.519,10,38,.263,19,25,.760,105
1607,MIN,2022-12-26,110,@,MIA,L 110-113,240,43,79,.544,28,45,.622,15,34,.441,9,14,.643,110,47,102,.461,34,53,.642,13,49,.265,6,8,.750,113
1608,HOU,2022-12-21,110,,ORL,L 110-116,240,41,88,.466,24,45,.533,17,43,.395,11,17,.647,110,41,91,.451,30,54,.556,11,37,.297,23,33,.697,116
1609,CHI,2022-12-21,110,@,ATL,W 110-108,240,43,86,.500,36,62,.581,7,24,.292,17,22,.773,110,39,91,.429,25,54,.463,14,37,.378,16,16,1.000,108
1610,PHO,2022-12-20,110,,WAS,L 110-113,240,41,89,.461,28,57,.491,13,32,.406,15,19,.789,110,38,80,.475,27,53,.509,11,27,.407,26,37,.703,113
1611,TOR,2022-12-18,110,,GSW,L 110-126,240,40,95,.421,27,62,.435,13,33,.394,17,22,.773,110,43,81,.531,25,42,.595,18,39,.462,22,26,.846,126
1612,POR,2022-12-16,110,@,DAL,L 110-130,240,39,89,.438,26,52,.500,13,37,.351,19,25,.760,110,45,81,.556,27,38,.711,18,43,.419,22,26,.846,130
1613,OKC,2022-12-16,110,,MIN,L 110-112,240,41,88,.466,30,51,.588,11,37,.297,17,21,.810,110,43,87,.494,31,62,.500,12,25,.480,14,25,.560,112
1614,MIA,2022-12-14,110,@,OKC,W 110-108,240,37,86,.430,13,30,.433,24,56,.429,12,15,.800,110,41,82,.500,32,58,.552,9,24,.375,17,23,.739,108
1615,UTA,2022-12-10,110,@,DEN,L 110-115,240,39,85,.459,24,44,.545,15,41,.366,17,21,.810,110,47,86,.547,39,60,.650,8,26,.308,13,16,.813,115
1616,CLE,2022-12-10,110,,OKC,W 110-102,240,40,85,.471,28,53,.528,12,32,.375,18,26,.692,110,38,83,.458,28,54,.519,10,29,.345,16,20,.800,102
1617,LAC,2022-12-08,110,@,MIA,L 110-115,240,37,80,.463,20,44,.455,17,36,.472,19,21,.905,110,46,90,.511,34,58,.586,12,32,.375,11,14,.786,115
1618,TOR,2022-12-05,110,,BOS,L 110-116,240,39,85,.459,29,57,.509,10,28,.357,22,30,.733,110,44,90,.489,31,54,.574,13,36,.361,15,21,.714,116
1619,SAC,2022-12-04,110,,CHI,W 110-101,240,40,86,.465,27,43,.628,13,43,.302,17,19,.895,110,38,86,.442,29,61,.475,9,25,.360,16,19,.842,101
1620,DET,2022-11-29,110,,NYK,L 110-140,240,42,83,.506,29,44,.659,13,39,.333,13,20,.650,110,54,96,.563,38,61,.623,16,35,.457,16,21,.762,140
1621,CHO,2022-11-25,110,,MIN,W 110-108,240,40,89,.449,32,64,.500,8,25,.320,22,32,.688,110,41,96,.427,32,55,.582,9,41,.220,17,18,.944,108
1622,MIA,2022-11-25,110,,WAS,W 110-107,240,42,89,.472,35,63,.556,7,26,.269,19,23,.826,110,40,93,.430,29,54,.537,11,39,.282,16,20,.800,107
1623,SAS,2022-11-23,110,,NOP,L 110-129,240,41,85,.482,31,51,.608,10,34,.294,18,28,.643,110,47,82,.573,33,49,.673,14,33,.424,21,30,.700,129
1624,DET,2022-11-22,110,@,DEN,W 110-108,240,45,88,.511,37,60,.617,8,28,.286,12,14,.857,110,43,86,.500,38,67,.567,5,19,.263,17,26,.654,108
1625,OKC,2022-11-18,110,@,MEM,L 110-121,240,45,96,.469,34,62,.548,11,34,.324,9,11,.818,110,39,93,.419,25,54,.463,14,39,.359,29,40,.725,121
1626,PHI,2022-11-18,110,,MIL,W 110-102,240,40,78,.513,27,50,.540,13,28,.464,17,26,.654,110,41,90,.456,29,54,.537,12,36,.333,8,21,.381,102
1627,CHI,2022-11-16,110,@,NOP,L 110-124,240,44,89,.494,33,57,.579,11,32,.344,11,17,.647,110,43,85,.506,26,52,.500,17,33,.515,21,24,.875,124
1628,SAS,2022-11-15,110,@,POR,L 110-117,240,44,85,.518,35,56,.625,9,29,.310,13,17,.765,110,41,79,.519,26,47,.553,15,32,.469,20,26,.769,117
1629,BRK,2022-11-12,110,@,LAC,W 110-95,240,40,83,.482,24,48,.500,16,35,.457,14,21,.667,110,34,85,.400,23,54,.426,11,31,.355,16,20,.800,95
1630,POR,2022-11-07,110,@,MIA,W 110-107,240,38,72,.528,22,35,.629,16,37,.432,18,21,.857,110,40,84,.476,26,45,.578,14,39,.359,13,15,.867,107
1631,UTA,2022-11-06,110,@,LAC,W 110-102,240,35,75,.467,20,35,.571,15,40,.375,25,26,.962,110,43,87,.494,35,54,.648,8,33,.242,8,13,.615,102
1632,TOR,2022-11-04,110,@,DAL,L 110-111,240,39,88,.443,28,54,.519,11,34,.324,21,25,.840,110,39,77,.506,27,43,.628,12,34,.353,21,25,.840,111
1633,OKC,2022-11-03,110,,DEN,L 110-122,240,45,93,.484,39,64,.609,6,29,.207,14,19,.737,110,45,84,.536,27,53,.509,18,31,.581,14,16,.875,122
1634,MIA,2022-11-02,110,,SAC,W 110-107,240,44,89,.494,33,55,.600,11,34,.324,11,13,.846,110,41,86,.477,28,50,.560,13,36,.361,12,14,.857,107
1635,MIL,2022-10-31,110,,DET,W 110-108,240,38,87,.437,27,47,.574,11,40,.275,23,29,.793,110,41,92,.446,33,63,.524,8,29,.276,18,21,.857,108
1636,DEN,2022-10-30,110,@,LAL,L 110-121,240,41,96,.427,26,56,.464,15,40,.375,13,18,.722,110,46,96,.479,33,66,.500,13,30,.433,16,20,.800,121
1637,LAC,2022-10-27,110,@,OKC,L 110-118,240,44,82,.537,35,54,.648,9,28,.321,13,18,.722,110,47,95,.495,30,57,.526,17,38,.447,7,8,.875,118
1638,SAC,2022-10-27,110,,MEM,L 110-125,240,40,83,.482,28,45,.622,12,38,.316,18,22,.818,110,49,92,.533,35,59,.593,14,33,.424,13,18,.722,125
1639,MIA,2022-10-27,110,@,GSW,L 110-123,240,39,88,.443,25,45,.556,14,43,.326,18,22,.818,110,46,92,.500,28,46,.609,18,46,.391,13,15,.867,123
1640,MIL,2022-10-26,110,,BRK,W 110-99,240,39,88,.443,29,52,.558,10,36,.278,22,29,.759,110,34,86,.395,27,59,.458,7,27,.259,24,30,.800,99
1641,DEN,2022-10-26,110,,LAL,W 110-99,240,42,92,.457,33,58,.569,9,34,.265,17,21,.810,110,40,90,.444,32,60,.533,8,30,.267,11,16,.688,99
1642,DEN,2022-10-24,110,@,POR,L 110-135,240,45,91,.495,33,60,.550,12,31,.387,8,14,.571,110,48,83,.578,32,48,.667,16,35,.457,23,31,.742,135
1643,WAS,2023-04-09,109,,HOU,L 109-114,240,41,97,.423,27,52,.519,14,45,.311,13,21,.619,109,44,90,.489,38,69,.551,6,21,.286,20,28,.714,114
1644,DEN,2023-04-09,109,,SAC,W 109-95,240,42,84,.500,35,56,.625,7,28,.250,18,25,.720,109,37,85,.435,26,42,.619,11,43,.256,10,15,.667,95
1645,CHO,2023-04-07,109,,HOU,L 109-112,240,38,88,.432,25,47,.532,13,41,.317,20,27,.741,109,42,89,.472,35,68,.515,7,21,.333,21,28,.750,112
1646,POR,2023-04-04,109,@,MEM,L 109-119,240,42,97,.433,28,55,.509,14,42,.333,11,17,.647,109,42,87,.483,24,39,.615,18,48,.375,17,22,.773,119
1647,WAS,2023-04-02,109,@,NYK,L 109-118,240,39,79,.494,23,42,.548,16,37,.432,15,18,.833,109,46,88,.523,33,56,.589,13,32,.406,13,18,.722,118
1648,HOU,2023-04-02,109,,LAL,L 109-134,240,44,102,.431,31,68,.456,13,34,.382,8,10,.800,109,52,93,.559,43,63,.683,9,30,.300,21,28,.750,134
1649,WAS,2023-03-31,109,,ORL,L 109-116,240,41,105,.390,24,55,.436,17,50,.340,10,12,.833,109,44,88,.500,36,64,.563,8,24,.333,20,26,.769,116
1650,NOP,2023-03-28,109,@,GSW,L 109-120,240,42,90,.467,30,63,.476,12,27,.444,13,14,.929,109,43,82,.524,25,42,.595,18,40,.450,16,22,.727,120
1651,DAL,2023-03-24,109,,CHO,L 109-117,240,41,84,.488,32,48,.667,9,36,.250,18,24,.750,109,43,89,.483,32,61,.525,11,28,.393,20,27,.741,117
1652,BRK,2023-03-21,109,,CLE,L 109-115,240,41,92,.446,32,59,.542,9,33,.273,18,23,.783,109,42,83,.506,28,54,.519,14,29,.483,17,21,.810,115
1653,SAC,2023-03-21,109,,BOS,L 109-132,240,39,81,.481,22,37,.595,17,44,.386,14,21,.667,109,49,92,.533,31,48,.646,18,44,.409,16,23,.696,132
1654,CHI,2023-03-20,109,@,PHI,W 109-105 (2OT),290,39,94,.415,32,61,.525,7,33,.212,24,29,.828,109,38,90,.422,28,54,.519,10,36,.278,19,22,.864,105
1655,IND,2023-03-20,109,@,CHO,L 109-115,240,37,82,.451,28,56,.500,9,26,.346,26,34,.765,109,41,90,.456,31,59,.525,10,31,.323,23,32,.719,115
1656,CLE,2023-03-15,109,,PHI,L 109-118,240,40,85,.471,26,44,.591,14,41,.341,15,22,.682,109,39,75,.520,22,39,.564,17,36,.472,23,27,.852,118
1657,BOS,2023-03-13,109,@,HOU,L 109-111,240,39,87,.448,27,45,.600,12,42,.286,19,21,.905,109,40,90,.444,29,55,.527,11,35,.314,20,27,.741,111
1658,ATL,2023-03-04,109,@,MIA,L 109-117,240,37,79,.468,28,49,.571,9,30,.300,26,30,.867,109,42,83,.506,29,48,.604,13,35,.371,20,23,.870,117
1659,WAS,2023-03-04,109,,TOR,L 109-116 (OT),265,38,75,.507,24,51,.471,14,24,.583,19,22,.864,109,47,90,.522,35,60,.583,12,30,.400,10,14,.714,116
1660,LAL,2023-02-28,109,@,MEM,L 109-121,240,38,86,.442,25,52,.481,13,34,.382,20,23,.870,109,51,112,.455,45,81,.556,6,31,.194,13,17,.765,121
1661,NYK,2023-02-27,109,,BOS,W 109-94,240,37,78,.474,25,47,.532,12,31,.387,23,34,.676,109,37,84,.440,28,42,.667,9,42,.214,11,14,.786,94
1662,GSW,2023-02-26,109,,MIN,W 109-104,240,39,91,.429,24,49,.490,15,42,.357,16,22,.727,109,38,90,.422,21,45,.467,17,45,.378,11,21,.524,104
1663,WAS,2023-02-24,109,,NYK,L 109-115,240,39,79,.494,20,35,.571,19,44,.432,12,12,1.000,109,45,92,.489,33,63,.524,12,29,.414,13,16,.813,115
1664,CLE,2023-02-23,109,,DEN,L 109-115,240,43,90,.478,37,64,.578,6,26,.231,17,20,.850,109,39,84,.464,22,48,.458,17,36,.472,20,23,.870,115
1665,DAL,2023-02-15,109,@,DEN,L 109-118,240,39,84,.464,25,45,.556,14,39,.359,17,20,.850,109,48,84,.571,37,53,.698,11,31,.355,11,15,.733,118
1666,DET,2023-02-15,109,@,BOS,L 109-127,240,43,84,.512,32,55,.582,11,29,.379,12,16,.750,109,49,92,.533,28,47,.596,21,45,.467,8,10,.800,127
1667,SAC,2023-02-14,109,@,PHO,L 109-120,240,37,83,.446,23,45,.511,14,38,.368,21,24,.875,109,50,88,.568,43,66,.652,7,22,.318,13,16,.813,120
1668,SAS,2023-02-13,109,@,CLE,L 109-117,240,43,85,.506,35,64,.547,8,21,.381,15,20,.750,109,44,78,.564,35,50,.700,9,28,.321,20,25,.800,117
1669,MEM,2023-02-12,109,@,BOS,L 109-119,240,42,84,.500,30,50,.600,12,34,.353,13,21,.619,109,39,88,.443,18,37,.486,21,51,.412,20,26,.769,119
1670,LAL,2023-02-11,109,@,GSW,W 109-103,240,40,89,.449,32,64,.500,8,25,.320,21,26,.808,109,40,96,.417,28,52,.538,12,44,.273,11,12,.917,103
1671,SAS,2023-02-01,109,,SAC,L 109-119,240,48,88,.545,40,64,.625,8,24,.333,5,7,.714,109,48,90,.533,40,63,.635,8,27,.296,15,19,.789,119
1672,PHI,2023-01-30,109,,ORL,L 109-119,240,40,85,.471,29,55,.527,11,30,.367,18,23,.783,109,42,99,.424,31,70,.443,11,29,.379,24,30,.800,119
1673,ORL,2023-01-28,109,,CHI,L 109-128,240,41,83,.494,31,55,.564,10,28,.357,17,24,.708,109,48,81,.593,32,46,.696,16,35,.457,16,19,.842,128
1674,BOS,2023-01-12,109,@,BRK,W 109-98,240,41,86,.477,29,50,.580,12,36,.333,15,17,.882,109,38,84,.452,25,50,.500,13,34,.382,9,11,.818,98
1675,ORL,2023-01-10,109,@,POR,W 109-106,240,40,78,.513,31,54,.574,9,24,.375,20,25,.800,109,42,87,.483,36,52,.692,6,35,.171,16,19,.842,106
1676,LAL,2023-01-09,109,@,DEN,L 109-122,240,41,93,.441,33,65,.508,8,28,.286,19,25,.760,109,46,99,.465,31,57,.544,15,42,.357,15,17,.882,122
1677,DAL,2023-01-08,109,@,OKC,L 109-120,240,31,73,.425,17,34,.500,14,39,.359,33,42,.786,109,46,95,.484,34,67,.507,12,28,.429,16,20,.800,120
1678,MIL,2023-01-06,109,,CHO,L 109-138,240,37,84,.440,17,36,.472,20,48,.417,15,24,.625,109,53,102,.520,33,54,.611,20,48,.417,12,19,.632,138
1679,DET,2023-01-06,109,@,SAS,L 109-121,240,44,93,.473,33,62,.532,11,31,.355,10,17,.588,109,45,81,.556,36,57,.632,9,24,.375,22,26,.846,121
1680,MIA,2023-01-04,109,@,LAL,L 109-112,240,43,95,.453,35,66,.530,8,29,.276,15,21,.714,109,40,81,.494,32,54,.593,8,27,.296,24,30,.800,112
1681,MEM,2022-12-25,109,@,GSW,L 109-123,240,39,94,.415,30,55,.545,9,39,.231,22,30,.733,109,43,91,.473,25,47,.532,18,44,.409,19,26,.731,123
1682,MIN,2022-12-23,109,@,BOS,L 109-121,240,44,91,.484,34,59,.576,10,32,.313,11,15,.733,109,44,100,.440,31,54,.574,13,46,.283,20,26,.769,121
1683,NYK,2022-12-18,109,@,IND,W 109-106,240,39,83,.470,31,57,.544,8,26,.308,23,30,.767,109,39,90,.433,26,52,.500,13,38,.342,15,23,.652,106
1684,MEM,2022-12-17,109,@,OKC,L 109-115,240,34,90,.378,22,45,.489,12,45,.267,29,37,.784,109,38,92,.413,19,47,.404,19,45,.422,20,31,.645,115
1685,BOS,2022-12-16,109,,ORL,L 109-117,240,35,84,.417,24,38,.632,11,46,.239,28,34,.824,109,42,91,.462,33,58,.569,9,33,.273,24,28,.857,117
1686,TOR,2022-12-09,109,@,ORL,L 109-113,240,36,85,.424,26,50,.520,10,35,.286,27,33,.818,109,42,71,.592,32,45,.711,10,26,.385,19,21,.905,113
1687,HOU,2022-12-08,109,@,SAS,L 109-118,240,44,98,.449,34,69,.493,10,29,.345,11,15,.733,109,46,83,.554,33,47,.702,13,36,.361,13,15,.867,118
1688,MIL,2022-12-05,109,@,ORL,W 109-102,240,38,85,.447,25,45,.556,13,40,.325,20,26,.769,109,34,93,.366,26,61,.426,8,32,.250,26,29,.897,102
1689,DEN,2022-12-02,109,@,ATL,L 109-117,240,45,85,.529,33,53,.623,12,32,.375,7,13,.538,109,49,88,.557,39,60,.650,10,28,.357,9,14,.643,117
1690,PHI,2022-12-02,109,@,MEM,L 109-117,240,40,91,.440,26,58,.448,14,33,.424,15,17,.882,109,42,97,.433,31,67,.463,11,30,.367,22,28,.786,117
1691,MIN,2022-11-30,109,,MEM,W 109-101,240,41,89,.461,29,50,.580,12,39,.308,15,19,.789,109,37,87,.425,28,61,.459,9,26,.346,18,30,.600,101
1692,MIL,2022-11-30,109,@,NYK,W 109-103,240,39,90,.433,29,55,.527,10,35,.286,21,26,.808,109,42,100,.420,36,70,.514,6,30,.200,13,20,.650,103
1693,POR,2022-11-30,109,@,LAL,L 109-128,240,42,90,.467,34,66,.515,8,24,.333,17,21,.810,109,48,97,.495,34,60,.567,14,37,.378,18,26,.692,128
1694,BRK,2022-11-28,109,,ORL,W 109-102,240,44,81,.543,35,53,.660,9,28,.321,12,14,.857,109,38,80,.475,25,49,.510,13,31,.419,13,22,.591,102
1695,MEM,2022-11-22,109,,SAC,L 109-113,240,41,91,.451,33,61,.541,8,30,.267,19,30,.633,109,39,90,.433,24,45,.533,15,45,.333,20,27,.741,113
1696,PHI,2022-11-19,109,,MIN,L 109-112,240,34,71,.479,20,39,.513,14,32,.438,27,32,.844,109,40,85,.471,28,49,.571,12,36,.333,20,24,.833,112
1697,NOP,2022-11-18,109,,BOS,L 109-117,240,43,87,.494,30,52,.577,13,35,.371,10,13,.769,109,41,85,.482,21,39,.538,20,46,.435,15,17,.882,117
1698,BRK,2022-11-17,109,@,POR,W 109-107,240,40,79,.506,29,50,.580,11,29,.379,18,23,.783,109,36,93,.387,23,57,.404,13,36,.361,22,27,.815,107
1699,ATL,2022-11-12,109,@,PHI,L 109-121,240,40,89,.449,34,65,.523,6,24,.250,23,27,.852,109,44,80,.550,36,56,.643,8,24,.333,25,31,.806,121
1700,HOU,2022-11-09,109,@,TOR,L 109-116,240,37,84,.440,28,49,.571,9,35,.257,26,31,.839,109,42,102,.412,27,58,.466,15,44,.341,17,20,.850,116
1701,SAS,2022-11-07,109,,DEN,L 109-115,240,43,82,.524,31,49,.633,12,33,.364,11,18,.611,109,47,88,.534,39,64,.609,8,24,.333,13,20,.650,115
1702,BOS,2022-11-07,109,@,MEM,W 109-106,240,38,82,.463,26,45,.578,12,37,.324,21,28,.750,109,41,91,.451,26,47,.553,15,44,.341,9,14,.643,106
1703,LAC,2022-11-02,109,@,HOU,W 109-101,240,41,84,.488,29,51,.569,12,33,.364,15,19,.789,109,37,88,.420,26,50,.520,11,38,.289,16,21,.762,101
1704,GSW,2022-11-01,109,@,MIA,L 109-116,240,39,84,.464,21,35,.600,18,49,.367,13,17,.765,109,40,88,.455,24,46,.522,16,42,.381,20,20,1.000,116
1705,IND,2022-10-31,109,@,BRK,L 109-116,240,41,87,.471,30,48,.625,11,39,.282,16,23,.696,109,43,80,.538,32,50,.640,11,30,.367,19,20,.950,116
1706,ATL,2022-10-31,109,@,TOR,L 109-139,240,39,84,.464,28,55,.509,11,29,.379,20,25,.800,109,46,92,.500,32,58,.552,14,34,.412,33,40,.825,139
1707,HOU,2022-10-30,109,@,PHO,L 109-124,240,38,87,.437,27,53,.509,11,34,.324,22,26,.846,109,45,84,.536,33,44,.750,12,40,.300,22,30,.733,124
1708,CHI,2022-10-29,109,,PHI,L 109-114,240,36,80,.450,25,49,.510,11,31,.355,26,29,.897,109,39,79,.494,25,50,.500,14,29,.483,22,27,.815,114
1709,UTA,2022-10-26,109,,HOU,W 109-101,240,38,90,.422,25,45,.556,13,45,.289,20,30,.667,109,36,94,.383,25,54,.463,11,40,.275,18,24,.750,101
1710,IND,2022-10-26,109,@,CHI,L 109-124,240,37,86,.430,21,46,.457,16,40,.400,19,24,.792,109,43,87,.494,27,57,.474,16,30,.533,22,24,.917,124
1711,PHI,2022-10-26,109,@,TOR,L 109-119,240,40,79,.506,24,43,.558,16,36,.444,13,19,.684,109,46,84,.548,30,47,.638,16,37,.432,11,14,.786,119
1712,ATL,2022-10-23,109,,CHO,L 109-126,240,39,95,.411,31,60,.517,8,35,.229,23,28,.821,109,47,90,.522,36,64,.563,11,26,.423,21,30,.700,126
1713,SAC,2022-10-22,109,,LAC,L 109-111,240,40,85,.471,26,50,.520,14,35,.400,15,26,.577,109,41,81,.506,32,59,.542,9,22,.409,20,22,.909,111
1714,TOR,2022-10-22,109,@,MIA,L 109-112,240,37,87,.425,23,48,.479,14,39,.359,21,28,.750,109,38,76,.500,27,46,.587,11,30,.367,25,27,.926,112
1715,BRK,2022-10-21,109,,TOR,W 109-105,240,38,80,.475,25,45,.556,13,35,.371,20,29,.690,109,41,84,.488,30,56,.536,11,28,.393,12,18,.667,105
1716,ORL,2022-10-19,109,@,DET,L 109-113,240,42,86,.488,31,56,.554,11,30,.367,14,19,.737,109,40,94,.426,26,56,.464,14,38,.368,19,24,.792,113
1717,LAL,2022-10-18,109,@,GSW,L 109-123,240,40,94,.426,30,54,.556,10,40,.250,19,25,.760,109,45,99,.455,29,54,.537,16,45,.356,17,23,.739,123
1718,NOP,2023-04-09,108,@,MIN,L 108-113,240,40,90,.444,37,69,.536,3,21,.143,25,29,.862,108,39,82,.476,26,46,.565,13,36,.361,22,31,.710,113
1719,MIA,2023-04-07,108,@,WAS,L 108-114,240,43,98,.439,28,51,.549,15,47,.319,7,12,.583,108,39,84,.464,32,51,.627,7,33,.212,29,37,.784,114
1720,DET,2023-04-05,108,,BRK,L 108-123,240,41,84,.488,28,56,.500,13,28,.464,13,14,.929,108,45,86,.523,28,43,.651,17,43,.395,16,23,.696,123
1721,CHO,2023-04-02,108,,TOR,L 108-128,240,42,85,.494,27,54,.500,15,31,.484,9,13,.692,108,56,104,.538,48,76,.632,8,28,.286,8,8,1.000,128
1722,MEM,2023-03-31,108,,LAC,W 108-94,240,43,96,.448,34,63,.540,9,33,.273,13,17,.765,108,34,90,.378,23,55,.418,11,35,.314,15,18,.833,94
1723,DAL,2023-03-29,108,@,PHI,L 108-116,240,38,83,.458,20,37,.541,18,46,.391,14,18,.778,108,37,80,.463,20,44,.455,17,36,.472,25,30,.833,116
1724,ORL,2023-03-28,108,@,MEM,L 108-113,240,41,100,.410,27,51,.529,14,49,.286,12,15,.800,108,42,88,.477,30,54,.556,12,34,.353,17,23,.739,113
1725,CLE,2023-03-26,108,,HOU,W 108-91,240,39,83,.470,30,53,.566,9,30,.300,21,24,.875,108,35,80,.438,29,55,.527,6,25,.240,15,18,.833,91
1726,LAL,2023-03-26,108,,CHI,L 108-118,240,38,75,.507,25,39,.641,13,36,.361,19,28,.679,108,47,87,.540,33,56,.589,14,31,.452,10,13,.769,118
1727,HOU,2023-03-20,108,,GSW,L 108-121,240,39,93,.419,29,57,.509,10,36,.278,20,24,.833,108,44,88,.500,27,40,.675,17,48,.354,16,19,.842,121
1728,DAL,2023-03-20,108,@,MEM,L 108-112,240,39,84,.464,28,48,.583,11,36,.306,19,20,.950,108,41,89,.461,31,54,.574,10,35,.286,20,26,.769,112
1729,DEN,2023-03-19,108,@,BRK,W 108-102,240,42,80,.525,30,57,.526,12,23,.522,12,13,.923,108,38,82,.463,26,47,.553,12,35,.343,14,16,.875,102
1730,LAC,2023-03-18,108,,ORL,L 108-113,240,42,90,.467,36,68,.529,6,22,.273,18,24,.750,108,42,84,.500,32,53,.604,10,31,.323,19,25,.760,113
1731,NOP,2023-03-14,108,,LAL,L 108-123,240,42,98,.429,31,55,.564,11,43,.256,13,20,.650,108,40,82,.488,22,43,.512,18,39,.462,25,28,.893,123
1732,CHO,2023-03-12,108,,CLE,L 108-114,240,41,80,.513,31,59,.525,10,21,.476,16,22,.727,108,41,87,.471,34,60,.567,7,27,.259,25,34,.735,114
1733,LAL,2023-03-12,108,,NYK,L 108-112,240,43,89,.483,31,53,.585,12,36,.333,10,17,.588,108,42,88,.477,31,51,.608,11,37,.297,17,21,.810,112
1734,DAL,2023-03-11,108,@,MEM,L 108-112,240,39,85,.459,24,42,.571,15,43,.349,15,23,.652,108,41,86,.477,31,48,.646,10,38,.263,20,24,.833,112
1735,LAC,2023-03-08,108,,TOR,W 108-100,240,39,71,.549,33,51,.647,6,20,.300,24,31,.774,108,37,96,.385,24,64,.375,13,32,.406,13,14,.929,100
1736,NOP,2023-03-06,108,@,SAC,L 108-123,240,43,80,.538,32,51,.627,11,29,.379,11,14,.786,108,47,83,.566,31,45,.689,16,38,.421,13,20,.650,123
1737,GSW,2023-03-03,108,,NOP,W 108-99,240,40,78,.513,30,47,.638,10,31,.323,18,20,.900,108,34,77,.442,24,48,.500,10,29,.345,21,27,.778,99
1738,TOR,2023-03-02,108,@,WAS,L 108-119,240,41,92,.446,32,59,.542,9,33,.273,17,17,1.000,108,43,84,.512,29,54,.537,14,30,.467,19,24,.792,119
1739,MIN,2023-02-28,108,@,LAC,W 108-101,240,43,90,.478,34,64,.531,9,26,.346,13,22,.591,108,35,83,.422,24,55,.436,11,28,.393,20,23,.870,101
1740,DAL,2023-02-26,108,,LAL,L 108-111,240,39,93,.419,19,44,.432,20,49,.408,10,14,.714,108,42,97,.433,36,63,.571,6,34,.176,21,28,.750,111
1741,ORL,2023-02-25,108,,IND,L 108-121,240,35,90,.389,29,61,.475,6,29,.207,32,38,.842,108,48,99,.485,33,59,.559,15,40,.375,10,14,.714,121
1742,CHO,2023-02-25,108,,MIA,W 108-103,240,38,88,.432,28,57,.491,10,31,.323,22,27,.815,108,32,80,.400,21,44,.477,11,36,.306,28,34,.824,103
1743,ORL,2023-02-23,108,,DET,W 108-106,240,39,95,.411,27,64,.422,12,31,.387,18,23,.783,108,37,81,.457,20,47,.426,17,34,.500,15,19,.789,106
1744,MIA,2023-02-13,108,,DEN,L 108-112,240,39,89,.438,27,54,.500,12,35,.343,18,20,.900,108,44,76,.579,33,48,.688,11,28,.393,13,15,.867,112
1745,NYK,2023-02-10,108,@,PHI,L 108-119,240,43,81,.531,32,49,.653,11,32,.344,11,16,.688,108,44,84,.524,30,46,.652,14,38,.368,17,22,.773,119
1746,POR,2023-02-06,108,,MIL,L 108-127,240,37,91,.407,28,55,.509,9,36,.250,25,29,.862,108,47,87,.540,31,45,.689,16,42,.381,17,21,.810,127
1747,NYK,2023-02-05,108,,PHI,W 108-97,240,34,79,.430,22,43,.512,12,36,.333,28,39,.718,108,30,74,.405,23,49,.469,7,25,.280,30,36,.833,97
1748,ATL,2023-02-04,108,@,DEN,L 108-128,240,44,91,.484,38,71,.535,6,20,.300,14,17,.824,108,48,95,.505,33,57,.579,15,38,.395,17,20,.850,128
1749,UTA,2023-02-03,108,,ATL,L 108-115,240,41,91,.451,28,47,.596,13,44,.295,13,18,.722,108,44,95,.463,34,58,.586,10,37,.270,17,23,.739,115
1750,LAC,2023-01-31,108,@,CHI,W 108-103,240,37,93,.398,25,49,.510,12,44,.273,22,26,.846,108,38,77,.494,26,53,.491,12,24,.500,15,21,.714,103
1751,UTA,2023-01-28,108,,DAL,W 108-100,240,39,82,.476,26,46,.565,13,36,.361,17,24,.708,108,35,80,.438,17,34,.500,18,46,.391,12,17,.706,100
1752,WAS,2023-01-25,108,@,HOU,W 108-103,240,39,98,.398,27,60,.450,12,38,.316,18,23,.783,108,42,97,.433,37,69,.536,5,28,.179,14,20,.700,103
1753,DET,2023-01-19,108,,CHI,L 108-126,240,39,97,.402,31,63,.492,8,34,.235,22,27,.815,108,50,92,.543,43,69,.623,7,23,.304,19,21,.905,126
1754,ORL,2023-01-13,108,@,UTA,L 108-112,240,42,96,.438,28,60,.467,14,36,.389,10,16,.625,108,36,83,.434,25,48,.521,11,35,.314,29,40,.725,112
1755,WAS,2023-01-13,108,,NYK,L 108-112,240,36,93,.387,23,51,.451,13,42,.310,23,26,.885,108,41,92,.446,33,63,.524,8,29,.276,22,31,.710,112
1756,MIA,2023-01-12,108,,MIL,W 108-102,240,42,95,.442,33,61,.541,9,34,.265,15,16,.938,108,35,87,.402,13,30,.433,22,57,.386,10,15,.667,102
1757,LAC,2023-01-08,108,,ATL,L 108-112,240,37,95,.389,27,65,.415,10,30,.333,24,31,.774,108,44,89,.494,36,63,.571,8,26,.308,16,20,.800,112
1758,TOR,2023-01-06,108,,NYK,L 108-112,240,35,83,.422,25,54,.463,10,29,.345,28,35,.800,108,39,83,.470,23,46,.500,16,37,.432,18,26,.692,112
1759,BRK,2023-01-06,108,@,NOP,W 108-102,240,37,85,.435,22,52,.423,15,33,.455,19,20,.950,108,35,88,.398,23,59,.390,12,29,.414,20,25,.800,102
1760,IND,2023-01-06,108,,POR,W 108-99,240,38,84,.452,31,59,.525,7,25,.280,25,28,.893,108,38,94,.404,29,61,.475,9,33,.273,14,17,.824,99
1761,CLE,2023-01-06,108,@,DEN,L 108-121,240,40,88,.455,30,62,.484,10,26,.385,18,32,.563,108,43,81,.531,26,46,.565,17,35,.486,18,23,.783,121
1762,HOU,2023-01-04,108,@,NOP,L 108-119,240,39,88,.443,27,50,.540,12,38,.316,18,27,.667,108,41,89,.461,27,51,.529,14,38,.368,23,26,.885,119
1763,SAC,2023-01-01,108,@,MEM,L 108-118,240,39,96,.406,24,53,.453,15,43,.349,15,15,1.000,108,46,100,.460,36,68,.529,10,32,.313,16,24,.667,118
1764,NYK,2022-12-31,108,@,HOU,W 108-88,240,35,90,.389,20,39,.513,15,51,.294,23,32,.719,108,29,77,.377,15,31,.484,14,46,.304,16,23,.696,88
1765,BRK,2022-12-28,108,@,ATL,W 108-107,240,42,83,.506,32,57,.561,10,26,.385,14,17,.824,108,42,97,.433,34,75,.453,8,22,.364,15,22,.682,107
1766,MEM,2022-12-27,108,,PHO,L 108-125,240,36,91,.396,28,61,.459,8,30,.267,28,34,.824,108,43,87,.494,26,56,.464,17,31,.548,22,25,.880,125
1767,MIA,2022-12-23,108,,IND,L 108-111,240,41,95,.432,28,62,.452,13,33,.394,13,14,.929,108,40,83,.482,19,36,.528,21,47,.447,10,14,.714,111
1768,ATL,2022-12-21,108,,CHI,L 108-110,240,39,91,.429,25,54,.463,14,37,.378,16,16,1.000,108,43,86,.500,36,62,.581,7,24,.292,17,22,.773,110
1769,DEN,2022-12-16,108,@,LAL,L 108-126,240,39,81,.481,30,54,.556,9,27,.333,21,28,.750,108,48,91,.527,36,58,.621,12,33,.364,18,24,.750,126
1770,HOU,2022-12-15,108,,MIA,L 108-111,240,44,94,.468,35,61,.574,9,33,.273,11,17,.647,108,39,88,.443,23,41,.561,16,47,.340,17,23,.739,111
1771,OKC,2022-12-14,108,,MIA,L 108-110,240,41,82,.500,32,58,.552,9,24,.375,17,23,.739,108,37,86,.430,13,30,.433,24,56,.429,12,15,.800,110
1772,UTA,2022-12-09,108,,MIN,L 108-118,240,39,90,.433,26,46,.565,13,44,.295,17,24,.708,108,42,79,.532,28,44,.636,14,35,.400,20,26,.769,118
1773,ORL,2022-12-03,108,@,TOR,L 108-121,240,38,78,.487,27,50,.540,11,28,.393,21,26,.808,108,47,84,.560,38,55,.691,9,29,.310,18,25,.720,121
1774,TOR,2022-11-30,108,@,NOP,L 108-126,240,42,88,.477,31,50,.620,11,38,.289,13,19,.684,108,45,86,.523,31,53,.585,14,33,.424,22,26,.846,126
1775,ORL,2022-11-30,108,,ATL,L 108-125,240,39,79,.494,31,52,.596,8,27,.296,22,25,.880,108,51,94,.543,43,62,.694,8,32,.250,15,19,.789,125
1776,PHO,2022-11-25,108,,DET,W 108-102,240,42,87,.483,35,58,.603,7,29,.241,17,26,.654,108,39,92,.424,30,66,.455,9,26,.346,15,16,.938,102
1777,MIN,2022-11-25,108,@,CHO,L 108-110,240,41,96,.427,32,55,.582,9,41,.220,17,18,.944,108,40,89,.449,32,64,.500,8,25,.320,22,32,.688,110
1778,DEN,2022-11-22,108,,DET,L 108-110,240,43,86,.500,38,67,.567,5,19,.263,17,26,.654,108,45,88,.511,37,60,.617,8,28,.286,12,14,.857,110
1779,ORL,2022-11-18,108,@,CHI,W 108-107,240,38,77,.494,26,49,.531,12,28,.429,20,22,.909,108,41,89,.461,36,68,.529,5,21,.238,20,25,.800,107
1780,ORL,2022-11-16,108,,MIN,L 108-126,240,42,93,.452,33,58,.569,9,35,.257,15,17,.882,108,46,88,.523,34,52,.654,12,36,.333,22,28,.786,126
1781,DET,2022-11-12,108,,BOS,L 108-117,240,37,89,.416,21,51,.412,16,38,.421,18,21,.857,108,39,91,.429,21,43,.488,18,48,.375,21,24,.875,117
1782,WAS,2022-11-07,108,@,CHO,W 108-100,240,42,80,.525,37,61,.607,5,19,.263,19,30,.633,108,42,101,.416,37,69,.536,5,32,.156,11,16,.688,100
1783,MIL,2022-11-05,108,,OKC,W 108-94,240,38,90,.422,21,43,.488,17,47,.362,15,17,.882,108,36,84,.429,24,49,.490,12,35,.343,10,16,.625,94
1784,POR,2022-11-04,108,@,PHO,W 108-106,240,43,85,.506,33,62,.532,10,23,.435,12,15,.800,108,36,83,.434,22,49,.449,14,34,.412,20,21,.952,106
1785,CHI,2022-11-01,108,@,BRK,W 108-99,240,39,89,.438,27,59,.458,12,30,.400,18,21,.857,108,36,74,.486,24,42,.571,12,32,.375,15,19,.789,99
1786,ORL,2022-11-01,108,@,OKC,L 108-116,240,39,87,.448,29,58,.500,10,29,.345,20,20,1.000,108,45,95,.474,35,61,.574,10,34,.294,16,20,.800,116
1787,DET,2022-10-31,108,@,MIL,L 108-110,240,41,92,.446,33,63,.524,8,29,.276,18,21,.857,108,38,87,.437,27,47,.574,11,40,.275,23,29,.793,110
1788,CHO,2022-10-31,108,,SAC,L 108-115,240,43,84,.512,29,55,.527,14,29,.483,8,14,.571,108,37,85,.435,20,41,.488,17,44,.386,24,28,.857,115
1789,NYK,2022-10-30,108,@,CLE,L 108-121,240,45,92,.489,35,65,.538,10,27,.370,8,16,.500,108,41,89,.461,18,39,.462,23,50,.460,16,19,.842,121
1790,NYK,2022-10-28,108,@,MIL,L 108-119,240,37,93,.398,25,58,.431,12,35,.343,22,32,.688,108,42,109,.385,29,64,.453,13,45,.289,22,27,.815,119
1791,OKC,2022-10-25,108,,LAC,W 108-94,240,42,110,.382,38,80,.475,4,30,.133,20,25,.800,108,35,83,.422,25,52,.481,10,31,.323,14,18,.778,94
1792,UTA,2022-10-24,108,@,HOU,L 108-114,240,44,93,.473,33,61,.541,11,32,.344,9,16,.563,108,38,90,.422,27,55,.491,11,35,.314,27,32,.844,114
1793,ATL,2022-10-21,108,,ORL,W 108-98,240,40,89,.449,27,58,.466,13,31,.419,15,16,.938,108,33,80,.413,25,46,.543,8,34,.235,24,30,.800,98
1794,MIA,2022-10-19,108,,CHI,L 108-116,240,37,80,.463,25,52,.481,12,28,.429,22,28,.786,108,41,93,.441,28,57,.491,13,36,.361,21,28,.750,116
1795,OKC,2022-10-19,108,@,MIN,L 108-115,240,38,99,.384,24,54,.444,14,45,.311,18,22,.818,108,39,94,.415,29,56,.518,10,38,.263,27,33,.818,115
1796,TOR,2022-10-19,108,,CLE,W 108-105,240,36,86,.419,23,56,.411,13,30,.433,23,32,.719,108,38,77,.494,28,49,.571,10,28,.357,19,23,.826,105
1797,BRK,2022-10-19,108,,NOP,L 108-130,240,40,89,.449,30,56,.536,10,33,.303,18,24,.750,108,50,102,.490,38,76,.500,12,26,.462,18,25,.720,130
1798,SAC,2022-10-19,108,,POR,L 108-115,240,39,85,.459,22,41,.537,17,44,.386,13,19,.684,108,39,88,.443,28,60,.467,11,28,.393,26,33,.788,115
1799,PHO,2023-04-07,107,@,LAL,L 107-121,240,43,104,.413,34,68,.500,9,36,.250,12,14,.857,107,45,92,.489,27,56,.482,18,36,.500,13,17,.765,121
1800,MIN,2023-04-04,107,@,BRK,W 107-102,240,41,85,.482,33,61,.541,8,24,.333,17,22,.773,107,39,90,.433,26,55,.473,13,35,.371,11,14,.786,102
1801,MEM,2023-04-02,107,@,CHI,L 107-128,240,39,84,.464,20,41,.488,19,43,.442,10,12,.833,107,50,94,.532,41,63,.651,9,31,.290,19,22,.864,128
1802,POR,2023-04-02,107,@,MIN,W 107-105,240,43,93,.462,34,63,.540,9,30,.300,12,20,.600,107,38,79,.481,27,53,.509,11,26,.423,18,23,.783,105
1803,ATL,2023-03-31,107,@,BRK,L 107-124,240,39,91,.429,31,54,.574,8,37,.216,21,23,.913,107,49,88,.557,34,55,.618,15,33,.455,11,13,.846,124
1804,NOP,2023-03-30,107,@,DEN,W 107-88,240,38,80,.475,25,53,.472,13,27,.481,18,22,.818,107,32,80,.400,28,52,.538,4,28,.143,20,32,.625,88
1805,OKC,2023-03-29,107,,DET,W 107-106,240,39,87,.448,29,58,.500,10,29,.345,19,25,.760,107,40,80,.500,24,47,.511,16,33,.485,10,14,.714,106
1806,PHO,2023-03-29,107,,MIN,W 107-100,240,40,96,.417,34,76,.447,6,20,.300,21,27,.778,107,40,90,.444,28,55,.509,12,35,.343,8,12,.667,100
1807,DET,2023-03-21,107,@,ATL,L 107-129,240,37,91,.407,24,51,.471,13,40,.325,20,24,.833,107,44,95,.463,30,57,.526,14,38,.368,27,36,.750,129
1808,HOU,2023-03-19,107,,NOP,L 107-117,240,31,76,.408,22,43,.512,9,33,.273,36,38,.947,107,42,85,.494,29,54,.537,13,31,.419,20,24,.833,117
1809,MIN,2023-03-18,107,@,TOR,L 107-122,240,39,85,.459,34,62,.548,5,23,.217,24,28,.857,107,48,90,.533,39,63,.619,9,27,.333,17,21,.810,122
1810,BRK,2023-03-14,107,@,OKC,L 107-121,240,35,82,.427,23,41,.561,12,41,.293,25,34,.735,107,45,99,.455,34,66,.515,11,33,.333,20,23,.870,121
1811,POR,2023-03-14,107,,NYK,L 107-123,240,38,99,.384,21,54,.389,17,45,.378,14,18,.778,107,42,81,.519,27,46,.587,15,35,.429,24,34,.706,123
1812,WAS,2023-03-10,107,,ATL,L 107-114,240,43,88,.489,36,61,.590,7,27,.259,14,18,.778,107,42,95,.442,27,64,.422,15,31,.484,15,19,.789,114
1813,PHI,2023-02-25,107,,BOS,L 107-110,240,35,78,.449,26,51,.510,9,27,.333,28,35,.800,107,43,86,.500,27,50,.540,16,36,.444,8,12,.667,110
1814,PHO,2023-02-16,107,,LAC,L 107-116,240,42,89,.472,31,58,.534,11,31,.355,12,16,.750,107,40,82,.488,29,48,.604,11,34,.324,25,27,.926,116
1815,MIA,2023-02-11,107,@,ORL,W 107-103 (OT),265,37,85,.435,25,46,.543,12,39,.308,21,23,.913,107,37,87,.425,26,58,.448,11,29,.379,18,23,.783,103
1816,MIN,2023-02-10,107,@,MEM,L 107-128,240,41,88,.466,26,51,.510,15,37,.405,10,12,.833,107,49,84,.583,39,59,.661,10,25,.400,20,27,.741,128
1817,NOP,2023-02-10,107,,CLE,L 107-118,240,39,82,.476,30,58,.517,9,24,.375,20,25,.800,107,48,85,.565,38,57,.667,10,28,.357,12,15,.800,118
1818,PHO,2023-02-09,107,@,ATL,L 107-116,240,39,86,.453,32,56,.571,7,30,.233,22,29,.759,107,43,95,.453,33,66,.500,10,29,.345,20,27,.741,116
1819,ATL,2023-02-07,107,@,NOP,L 107-116,240,38,85,.447,26,49,.531,12,36,.333,19,25,.760,107,45,91,.495,33,59,.559,12,32,.375,14,21,.667,116
1820,IND,2023-02-03,107,,SAC,W 107-104,240,40,89,.449,23,48,.479,17,41,.415,10,14,.714,107,37,86,.430,24,48,.500,13,38,.342,17,20,.850,104
1821,MIL,2023-01-25,107,,DEN,W 107-99,240,37,78,.474,24,48,.500,13,30,.433,20,28,.714,107,38,97,.392,27,63,.429,11,34,.324,12,16,.750,99
1822,IND,2023-01-21,107,@,PHO,L 107-112,240,36,96,.375,23,59,.390,13,37,.351,22,26,.846,107,38,91,.418,26,60,.433,12,31,.387,24,35,.686,112
1823,BOS,2023-01-09,107,,CHI,W 107-99,240,38,87,.437,27,46,.587,11,41,.268,20,21,.952,107,39,86,.453,27,51,.529,12,35,.343,9,14,.643,99
1824,NYK,2023-01-09,107,,MIL,L 107-111,240,38,100,.380,27,59,.458,11,41,.268,20,22,.909,107,39,89,.438,20,40,.500,19,49,.388,14,18,.778,111
1825,CHO,2023-01-04,107,,MEM,L 107-131,240,38,94,.404,27,56,.482,11,38,.289,20,24,.833,107,47,94,.500,38,64,.594,9,30,.300,28,37,.757,131
1826,UTA,2022-12-28,107,@,GSW,L 107-112,240,37,91,.407,22,45,.489,15,46,.326,18,26,.692,107,37,87,.425,21,42,.500,16,45,.356,22,27,.815,112
1827,ATL,2022-12-28,107,,BRK,L 107-108,240,42,97,.433,34,75,.453,8,22,.364,15,22,.682,107,42,83,.506,32,57,.561,10,26,.385,14,17,.824,108
1828,CLE,2022-12-23,107,,TOR,L 107-118,240,39,76,.513,28,43,.651,11,33,.333,18,30,.600,107,42,84,.500,23,47,.489,19,37,.514,15,18,.833,118
1829,POR,2022-12-23,107,@,DEN,L 107-120,240,39,87,.448,30,52,.577,9,35,.257,20,26,.769,107,47,81,.580,37,60,.617,10,21,.476,16,26,.615,120
1830,POR,2022-12-17,107,@,HOU,W 107-95,240,40,85,.471,27,49,.551,13,36,.361,14,19,.737,107,36,90,.400,33,61,.541,3,29,.103,20,29,.690,95
1831,WAS,2022-12-10,107,,LAC,L 107-114,240,37,85,.435,21,51,.412,16,34,.471,17,19,.895,107,40,94,.426,21,46,.457,19,48,.396,15,16,.938,114
1832,BOS,2022-12-10,107,@,GSW,L 107-123,240,38,87,.437,26,47,.553,12,40,.300,19,26,.731,107,47,92,.511,34,53,.642,13,39,.333,16,20,.800,123
1833,CLE,2022-12-02,107,,ORL,W 107-96,240,41,84,.488,25,42,.595,16,42,.381,9,9,1.000,107,40,81,.494,32,58,.552,8,23,.348,8,12,.667,96
1834,WAS,2022-11-30,107,@,BRK,L 107-113,240,39,89,.438,33,65,.508,6,24,.250,23,34,.676,107,39,84,.464,28,58,.483,11,26,.423,24,26,.923,113
1835,UTA,2022-11-28,107,,CHI,L 107-114,240,41,85,.482,22,36,.611,19,49,.388,6,15,.400,107,43,93,.462,37,71,.521,6,22,.273,22,25,.880,114
1836,WAS,2022-11-25,107,@,MIA,L 107-110,240,40,93,.430,29,54,.537,11,39,.282,16,20,.800,107,42,89,.472,35,63,.556,7,26,.269,19,23,.826,110
1837,PHI,2022-11-25,107,@,ORL,W 107-99,240,39,82,.476,25,46,.543,14,36,.389,15,18,.833,107,34,80,.425,25,45,.556,9,35,.257,22,27,.815,99
1838,LAC,2022-11-23,107,@,GSW,L 107-124,240,39,86,.453,28,57,.491,11,29,.379,18,27,.667,107,48,97,.495,29,46,.630,19,51,.373,9,13,.692,124
1839,CHO,2022-11-23,107,,PHI,W 107-101,240,44,92,.478,38,69,.551,6,23,.261,13,21,.619,107,38,86,.442,29,48,.604,9,38,.237,16,18,.889,101
1840,BOS,2022-11-21,107,@,CHI,L 107-121,240,38,87,.437,19,37,.514,19,50,.380,12,17,.706,107,46,89,.517,32,60,.533,14,29,.483,15,20,.750,121
1841,WAS,2022-11-18,107,,MIA,W 107-106 (OT),265,41,96,.427,26,50,.520,15,46,.326,10,14,.714,107,35,98,.357,24,55,.436,11,43,.256,25,32,.781,106
1842,CHI,2022-11-18,107,,ORL,L 107-108,240,41,89,.461,36,68,.529,5,21,.238,20,25,.800,107,38,77,.494,26,49,.531,12,28,.429,20,22,.909,108
1843,POR,2022-11-17,107,,BRK,L 107-109,240,36,93,.387,23,57,.404,13,36,.361,22,27,.815,107,40,79,.506,29,50,.580,11,29,.379,18,23,.783,109
1844,MIA,2022-11-07,107,,POR,L 107-110,240,40,84,.476,26,45,.578,14,39,.359,13,15,.867,107,38,72,.528,22,35,.629,16,37,.432,18,21,.857,110
1845,MIN,2022-11-07,107,,NYK,L 107-120,240,38,81,.469,27,40,.675,11,41,.268,20,24,.833,107,39,89,.438,20,41,.488,19,48,.396,23,25,.920,120
1846,SAC,2022-11-02,107,@,MIA,L 107-110,240,41,86,.477,28,50,.560,13,36,.361,12,14,.857,107,44,89,.494,33,55,.600,11,34,.324,11,13,.846,110
1847,MIN,2022-11-01,107,@,PHO,L 107-116,240,37,87,.425,24,53,.453,13,34,.382,20,24,.833,107,41,89,.461,24,46,.522,17,43,.395,17,22,.773,116
1848,SAS,2022-10-30,107,,MIN,W 107-98,240,36,86,.419,20,46,.435,16,40,.400,19,25,.760,107,40,99,.404,36,70,.514,4,29,.138,14,20,.700,98
1849,WAS,2022-10-23,107,@,CLE,L 107-117 (OT),265,43,87,.494,31,59,.525,12,28,.429,9,15,.600,107,41,96,.427,28,63,.444,13,33,.394,22,25,.880,117
1850,HOU,2022-10-19,107,@,ATL,L 107-117,240,42,98,.429,33,63,.524,9,35,.257,14,15,.933,107,45,90,.500,38,65,.585,7,25,.280,20,24,.833,117
1851,PHO,2022-10-19,107,,DAL,W 107-105,240,40,85,.471,32,63,.508,8,22,.364,19,22,.864,107,35,75,.467,21,40,.525,14,35,.400,21,34,.618,105
1852,IND,2022-10-19,107,,WAS,L 107-114,240,39,97,.402,24,55,.436,15,42,.357,14,21,.667,107,42,92,.457,31,61,.508,11,31,.355,19,24,.792,114
1853,CHO,2023-04-09,106,@,CLE,W 106-95,240,37,81,.457,31,49,.633,6,32,.188,26,30,.867,106,35,89,.393,25,52,.481,10,37,.270,15,16,.938,95
1854,DET,2023-03-29,106,@,OKC,L 106-107,240,40,80,.500,24,47,.511,16,33,.485,10,14,.714,106,39,87,.448,29,58,.500,10,29,.345,19,25,.760,107
1855,TOR,2023-03-28,106,,MIA,W 106-92,240,45,93,.484,37,57,.649,8,36,.222,8,9,.889,106,32,80,.400,22,47,.468,10,33,.303,18,19,.947,92
1856,BRK,2023-03-26,106,@,ORL,L 106-119,240,37,91,.407,29,56,.518,8,35,.229,24,28,.857,106,45,85,.529,38,63,.603,7,22,.318,22,28,.786,119
1857,MIL,2023-03-25,106,@,DEN,L 106-129,240,39,88,.443,30,52,.577,9,36,.250,19,21,.905,106,47,89,.528,32,53,.604,15,36,.417,20,28,.714,129
1858,NYK,2023-03-23,106,@,ORL,L 106-111,240,37,88,.420,25,48,.521,12,40,.300,20,26,.769,106,40,87,.460,27,55,.491,13,32,.406,18,21,.857,111
1859,LAC,2023-03-11,106,,NYK,W 106-95,240,42,87,.483,32,57,.561,10,30,.333,12,16,.750,106,32,90,.356,25,59,.424,7,31,.226,24,27,.889,95
1860,DAL,2023-03-08,106,@,NOP,L 106-113,240,38,88,.432,22,42,.524,16,46,.348,14,19,.737,106,42,83,.506,29,56,.518,13,27,.481,16,18,.889,113
1861,CHO,2023-03-03,106,,ORL,L 106-117,240,38,78,.487,29,54,.537,9,24,.375,21,25,.840,106,46,86,.535,36,60,.600,10,26,.385,15,19,.789,117
1862,DET,2023-02-27,106,@,CHO,L 106-117,240,42,92,.457,39,66,.591,3,26,.115,19,27,.704,106,43,83,.518,30,57,.526,13,26,.500,18,22,.818,117
1863,NOP,2023-02-25,106,@,NYK,L 106-128,240,40,102,.392,32,64,.500,8,38,.211,18,21,.857,106,45,88,.511,26,40,.650,19,48,.396,19,23,.826,128
1864,DET,2023-02-23,106,@,ORL,L 106-108,240,37,81,.457,20,47,.426,17,34,.500,15,19,.789,106,39,95,.411,27,64,.422,12,31,.387,18,23,.783,108
1865,MIN,2023-02-16,106,,WAS,L 106-114,240,39,95,.411,31,66,.470,8,29,.276,20,22,.909,106,43,95,.453,29,60,.483,14,35,.400,14,17,.824,114
1866,BRK,2023-02-13,106,@,NYK,L 106-124,240,35,78,.449,23,49,.469,12,29,.414,24,33,.727,106,45,82,.549,30,48,.625,15,34,.441,19,26,.731,124
1867,SAS,2023-02-11,106,@,ATL,L 106-125,240,40,94,.426,29,57,.509,11,37,.297,15,17,.882,106,50,103,.485,40,77,.519,10,26,.385,15,19,.789,125
1868,LAC,2023-02-10,106,,MIL,L 106-119,240,42,85,.494,31,52,.596,11,33,.333,11,14,.786,106,45,90,.500,28,51,.549,17,39,.436,12,16,.750,119
1869,LAL,2023-02-09,106,,MIL,L 106-115,240,42,89,.472,35,71,.493,7,18,.389,15,21,.714,106,45,99,.455,33,52,.635,12,47,.255,13,18,.722,115
1870,BOS,2023-02-08,106,,PHI,W 106-99,240,40,76,.526,21,41,.512,19,35,.543,7,10,.700,106,37,83,.446,27,52,.519,10,31,.323,15,20,.750,99
1871,TOR,2023-02-05,106,@,MEM,W 106-103,240,44,101,.436,33,65,.508,11,36,.306,7,12,.583,106,38,78,.487,28,51,.549,10,27,.370,17,23,.739,103
1872,PHO,2023-02-03,106,@,BOS,W 106-94,240,41,95,.432,29,63,.460,12,32,.375,12,14,.857,106,29,75,.387,19,37,.514,10,38,.263,26,31,.839,94
1873,NOP,2023-02-02,106,@,DAL,L 106-111,240,42,84,.500,37,64,.578,5,20,.250,17,21,.810,106,37,85,.435,23,44,.523,14,41,.341,23,29,.793,111
1874,MIL,2023-02-02,106,,LAC,W 106-105,240,39,90,.433,30,53,.566,9,37,.243,19,27,.704,106,39,95,.411,26,59,.441,13,36,.361,14,20,.700,105
1875,NYK,2023-02-02,106,,MIA,W 106-104,240,40,83,.482,28,47,.596,12,36,.333,14,18,.778,106,39,87,.448,26,51,.510,13,36,.361,13,16,.813,104
1876,OKC,2023-02-01,106,@,HOU,L 106-112,240,38,103,.369,26,60,.433,12,43,.279,18,22,.818,106,41,94,.436,34,71,.479,7,23,.304,23,31,.742,112
1877,SAS,2023-01-30,106,,WAS,L 106-127,240,42,97,.433,35,68,.515,7,29,.241,15,23,.652,106,48,86,.558,32,56,.571,16,30,.533,15,17,.882,127
1878,TOR,2023-01-30,106,@,PHO,L 106-114,240,40,89,.449,31,56,.554,9,33,.273,17,19,.895,106,43,87,.494,32,59,.542,11,28,.393,17,21,.810,114
1879,BOS,2023-01-21,106,@,TOR,W 106-104,240,38,85,.447,22,50,.440,16,35,.457,14,15,.933,106,46,86,.535,39,67,.582,7,19,.368,5,7,.714,104
1880,UTA,2023-01-20,106,,BRK,L 106-117,240,37,88,.420,21,49,.429,16,39,.410,16,23,.696,106,43,80,.538,25,39,.641,18,41,.439,13,20,.650,117
1881,IND,2023-01-18,106,@,OKC,L 106-126,240,39,94,.415,27,61,.443,12,33,.364,16,24,.667,106,47,93,.505,31,55,.564,16,38,.421,16,21,.762,126
1882,SAS,2023-01-17,106,,BRK,W 106-98,240,37,97,.381,30,63,.476,7,34,.206,25,28,.893,106,37,88,.420,34,65,.523,3,23,.130,21,24,.875,98
1883,PHO,2023-01-16,106,@,MEM,L 106-136,240,39,89,.438,29,56,.518,10,33,.303,18,19,.947,106,52,98,.531,36,61,.590,16,37,.432,16,20,.800,136
1884,CHO,2023-01-14,106,,BOS,L 106-122,240,41,88,.466,33,61,.541,8,27,.296,16,19,.842,106,47,99,.475,28,46,.609,19,53,.358,9,10,.900,122
1885,POR,2023-01-10,106,,ORL,L 106-109,240,42,87,.483,36,52,.692,6,35,.171,16,19,.842,106,40,78,.513,31,54,.574,9,24,.375,20,25,.800,109
1886,POR,2023-01-04,106,@,MIN,L 106-113,240,33,75,.440,24,46,.522,9,29,.310,31,42,.738,106,39,76,.513,30,52,.577,9,24,.375,26,36,.722,113
1887,HOU,2023-01-02,106,,DAL,L 106-111,240,38,82,.463,29,53,.547,9,29,.310,21,29,.724,106,34,81,.420,21,38,.553,13,43,.302,30,34,.882,111
1888,DET,2023-01-02,106,@,POR,L 106-135,240,34,82,.415,28,64,.438,6,18,.333,32,41,.780,106,48,84,.571,34,53,.642,14,31,.452,25,35,.714,135
1889,CHO,2022-12-31,106,,BRK,L 106-123,240,38,96,.396,27,55,.491,11,41,.268,19,21,.905,106,48,80,.600,35,46,.761,13,34,.382,14,19,.737,123
1890,TOR,2022-12-29,106,,MEM,L 106-119,240,39,96,.406,29,68,.426,10,28,.357,18,24,.750,106,48,95,.505,35,66,.530,13,29,.448,10,14,.714,119
1891,SAC,2022-12-27,106,,DEN,L 106-113,240,40,82,.488,30,47,.638,10,35,.286,16,19,.842,106,41,86,.477,28,49,.571,13,37,.351,18,21,.857,113
1892,HOU,2022-12-23,106,,DAL,L 106-112,240,37,81,.457,29,55,.527,8,26,.308,24,28,.857,106,36,80,.450,20,36,.556,16,44,.364,24,27,.889,112
1893,MIL,2022-12-21,106,@,CLE,L 106-114,240,39,83,.470,26,53,.491,13,30,.433,15,22,.682,106,41,85,.482,31,53,.585,10,32,.313,22,28,.786,114
1894,NYK,2022-12-21,106,,TOR,L 106-113,240,42,76,.553,31,50,.620,11,26,.423,11,18,.611,106,42,94,.447,33,60,.550,9,34,.265,20,22,.909,113
1895,DAL,2022-12-19,106,@,MIN,L 106-116,240,31,76,.408,12,31,.387,19,45,.422,25,31,.806,106,42,89,.472,30,58,.517,12,31,.387,20,24,.833,116
1896,IND,2022-12-18,106,,NYK,L 106-109,240,39,90,.433,26,52,.500,13,38,.342,15,23,.652,106,39,83,.470,31,57,.544,8,26,.308,23,30,.767,109
1897,GSW,2022-12-16,106,@,PHI,L 106-118,240,39,94,.415,22,51,.431,17,43,.395,11,13,.846,106,39,85,.459,24,47,.511,15,38,.395,25,31,.806,118
1898,CHO,2022-12-16,106,,ATL,L 106-125,240,39,98,.398,24,55,.436,15,43,.349,13,19,.684,106,41,75,.547,26,46,.565,15,29,.517,28,34,.824,125
1899,MIL,2022-12-09,106,@,DAL,W 106-105,240,38,87,.437,27,55,.491,11,32,.344,19,23,.826,106,41,88,.466,28,48,.583,13,40,.325,10,24,.417,105
1900,SAC,2022-12-09,106,@,CLE,W 106-95,240,35,66,.530,19,33,.576,16,33,.485,20,32,.625,106,34,79,.430,24,49,.490,10,30,.333,17,22,.773,95
1901,DEN,2022-12-04,106,@,NOP,L 106-121,240,41,81,.506,33,50,.660,8,31,.258,16,24,.667,106,41,81,.506,30,55,.545,11,26,.423,28,36,.778,121
1902,MIA,2022-11-27,106,@,ATL,W 106-98,240,40,82,.488,31,49,.633,9,33,.273,17,19,.895,106,35,88,.398,25,52,.481,10,36,.278,18,19,.947,98
1903,SAC,2022-11-23,106,@,ATL,L 106-115,240,41,89,.461,32,58,.552,9,31,.290,15,21,.714,106,41,92,.446,30,62,.484,11,30,.367,22,23,.957,115
1904,BRK,2022-11-22,106,@,PHI,L 106-115,240,44,80,.550,35,52,.673,9,28,.321,9,13,.692,106,43,99,.434,27,67,.403,16,32,.500,13,16,.813,115
1905,WAS,2022-11-20,106,,CHO,W 106-102,240,40,93,.430,27,59,.458,13,34,.382,13,18,.722,106,39,100,.390,31,68,.456,8,32,.250,16,23,.696,102
1906,MIA,2022-11-18,106,@,WAS,L 106-107 (OT),265,35,98,.357,24,55,.436,11,43,.256,25,32,.781,106,41,96,.427,26,50,.520,15,46,.326,10,14,.714,107
1907,NYK,2022-11-16,106,@,DEN,W 106-103,240,37,84,.440,29,50,.580,8,34,.235,24,31,.774,106,36,82,.439,22,44,.500,14,38,.368,17,20,.850,103
1908,HOU,2022-11-14,106,,LAC,L 106-122,240,39,86,.453,30,56,.536,9,30,.300,19,31,.613,106,41,81,.506,27,43,.628,14,38,.368,26,33,.788,122
1909,MIL,2022-11-14,106,,ATL,L 106-121,240,34,82,.415,28,53,.528,6,29,.207,32,41,.780,106,44,92,.478,37,72,.514,7,20,.350,26,30,.867,121
1910,HOU,2022-11-12,106,@,NOP,L 106-119,240,40,79,.506,28,43,.651,12,36,.333,14,18,.778,106,42,86,.488,34,57,.596,8,29,.276,27,31,.871,119
1911,GSW,2022-11-11,106,,CLE,W 106-101,240,40,82,.488,25,46,.543,15,36,.417,11,14,.786,106,37,92,.402,29,62,.468,8,30,.267,19,26,.731,101
1912,POR,2022-11-10,106,@,NOP,W 106-95,240,37,85,.435,25,51,.490,12,34,.353,20,26,.769,106,33,79,.418,23,51,.451,10,28,.357,19,24,.792,95
1913,MEM,2022-11-07,106,,BOS,L 106-109,240,41,91,.451,26,47,.553,15,44,.341,9,14,.643,106,38,82,.463,26,45,.578,12,37,.324,21,28,.750,109
1914,SAS,2022-11-04,106,,LAC,L 106-113,240,42,88,.477,30,57,.526,12,31,.387,10,18,.556,106,42,80,.525,27,47,.574,15,33,.455,14,19,.737,113
1915,NYK,2022-11-04,106,@,PHI,W 106-104,240,37,80,.463,28,47,.596,9,33,.273,23,27,.852,106,37,98,.378,24,51,.471,13,47,.277,17,21,.810,104
1916,PHO,2022-11-04,106,,POR,L 106-108,240,36,83,.434,22,49,.449,14,34,.412,20,21,.952,106,43,85,.506,33,62,.532,10,23,.435,12,15,.800,108
1917,CHI,2022-11-02,106,,CHO,W 106-88,240,38,88,.432,24,57,.421,14,31,.452,16,18,.889,106,36,92,.391,29,60,.483,7,32,.219,9,16,.563,88
1918,POR,2022-11-02,106,,MEM,L 106-111,240,36,89,.404,23,56,.411,13,33,.394,21,26,.808,106,38,83,.458,25,55,.455,13,28,.464,22,27,.815,111
1919,IND,2022-10-24,106,@,PHI,L 106-120,240,38,90,.422,26,46,.565,12,44,.273,18,23,.783,106,38,80,.475,19,37,.514,19,43,.442,25,28,.893,120
1920,MIN,2022-10-24,106,,SAS,L 106-115,240,38,86,.442,30,55,.545,8,31,.258,22,24,.917,106,48,105,.457,36,68,.529,12,37,.324,7,13,.538,115
1921,OKC,2022-10-23,106,,MIN,L 106-116,240,41,94,.436,32,53,.604,9,41,.220,15,21,.714,106,46,88,.523,36,54,.667,10,34,.294,14,22,.636,116
1922,POR,2022-10-23,106,@,LAL,W 106-104,240,37,84,.440,27,57,.474,10,27,.370,22,27,.815,106,41,92,.446,35,59,.593,6,33,.182,16,20,.800,104
1923,DET,2022-10-21,106,@,NYK,L 106-130,240,39,90,.433,30,54,.556,9,36,.250,19,32,.594,106,50,95,.526,34,57,.596,16,38,.421,14,22,.636,130
1924,BRK,2023-04-09,105,,PHI,L 105-134,240,35,83,.422,23,51,.451,12,32,.375,23,28,.821,105,53,101,.525,39,69,.565,14,32,.438,14,19,.737,134
1925,MIL,2023-04-09,105,@,TOR,L 105-121,240,38,82,.463,26,48,.542,12,34,.353,17,21,.810,105,48,95,.505,37,62,.597,11,33,.333,14,16,.875,121
1926,NYK,2023-04-07,105,@,NOP,L 105-113,240,38,88,.432,24,45,.533,14,43,.326,15,20,.750,105,42,79,.532,32,51,.627,10,28,.357,19,20,.950,113
1927,MIL,2023-04-05,105,,CHI,W 105-92,240,39,92,.424,21,46,.457,18,46,.391,9,11,.818,105,36,83,.434,25,50,.500,11,33,.333,9,11,.818,92
1928,DET,2023-04-04,105,,MIA,L 105-118,240,36,73,.493,25,45,.556,11,28,.393,22,27,.815,105,41,80,.513,28,44,.636,13,36,.361,23,26,.885,118
1929,CHI,2023-04-04,105,,ATL,L 105-123,240,41,89,.461,34,58,.586,7,31,.226,16,20,.800,105,48,86,.558,38,58,.655,10,28,.357,17,19,.895,123
1930,MIN,2023-04-02,105,,POR,L 105-107,240,38,79,.481,27,53,.509,11,26,.423,18,23,.783,105,43,93,.462,34,63,.540,9,30,.300,12,20,.600,107
1931,IND,2023-04-02,105,@,CLE,L 105-115,240,36,83,.434,27,59,.458,9,24,.375,24,29,.828,105,44,90,.489,35,66,.530,9,24,.375,18,26,.692,115
1932,PHI,2023-03-25,105,@,PHO,L 105-125,240,34,78,.436,21,47,.447,13,31,.419,24,27,.889,105,47,93,.505,32,61,.525,15,32,.469,16,19,.842,125
1933,OKC,2023-03-23,105,@,LAC,L 105-127,240,41,93,.441,28,54,.519,13,39,.333,10,11,.909,105,47,84,.560,29,47,.617,18,37,.486,15,20,.750,127
1934,PHI,2023-03-20,105,,CHI,L 105-109 (2OT),290,38,90,.422,28,54,.519,10,36,.278,19,22,.864,105,39,94,.415,32,61,.525,7,33,.212,24,29,.828,109
1935,ORL,2023-03-19,105,@,LAL,L 105-111,240,41,102,.402,31,64,.484,10,38,.263,13,17,.765,105,36,78,.462,23,46,.500,13,32,.406,26,32,.813,111
1936,NYK,2023-03-07,105,,CHO,L 105-112,240,38,89,.427,27,49,.551,11,40,.275,18,24,.750,105,42,85,.494,30,53,.566,12,32,.375,16,21,.762,112
1937,GSW,2023-03-05,105,@,LAL,L 105-113,240,36,91,.396,18,39,.462,18,52,.346,15,18,.833,105,42,95,.442,31,62,.500,11,33,.333,18,22,.818,113
1938,BOS,2023-03-03,105,,BRK,L 105-115,240,41,84,.488,32,55,.582,9,29,.310,14,20,.700,105,40,95,.421,26,51,.510,14,44,.318,21,26,.808,115
1939,PHO,2023-03-01,105,@,CHO,W 105-91,240,42,89,.472,33,64,.516,9,25,.360,12,15,.800,105,32,88,.364,23,55,.418,9,33,.273,18,28,.643,91
1940,POR,2023-02-28,105,@,GSW,L 105-123,240,37,86,.430,25,47,.532,12,39,.308,19,22,.864,105,49,91,.538,37,61,.607,12,30,.400,13,16,.813,123
1941,MEM,2023-02-23,105,@,PHI,L 105-110,240,34,87,.391,27,55,.491,7,32,.219,30,36,.833,105,34,84,.405,21,48,.438,13,36,.361,29,36,.806,110
1942,MIA,2023-02-15,105,@,BRK,L 105-116,240,38,83,.458,30,55,.545,8,28,.286,21,29,.724,105,41,77,.532,24,38,.632,17,39,.436,17,20,.850,116
1943,CHO,2023-02-11,105,,DEN,L 105-119,240,40,85,.471,32,53,.604,8,32,.250,17,29,.586,105,50,99,.505,45,76,.592,5,23,.217,14,17,.824,119
1944,CHI,2023-02-09,105,@,BRK,L 105-116,240,42,91,.462,37,65,.569,5,26,.192,16,21,.762,105,39,91,.429,22,47,.468,17,44,.386,21,25,.840,116
1945,LAC,2023-02-02,105,@,MIL,L 105-106,240,39,95,.411,26,59,.441,13,36,.361,14,20,.700,105,39,90,.433,30,53,.566,9,37,.243,19,27,.704,106
1946,PHI,2023-02-01,105,,ORL,W 105-94,240,34,78,.436,20,43,.465,14,35,.400,23,26,.885,105,33,87,.379,27,49,.551,6,38,.158,22,29,.759,94
1947,DET,2023-01-30,105,@,DAL,L 105-111,240,36,79,.456,22,40,.550,14,39,.359,19,27,.704,105,39,79,.494,29,45,.644,10,34,.294,23,33,.697,111
1948,POR,2023-01-28,105,,TOR,L 105-123,240,40,76,.526,33,52,.635,7,24,.292,18,23,.783,105,48,92,.522,38,62,.613,10,30,.333,17,18,.944,123
1949,ORL,2023-01-27,105,@,MIA,L 105-110,240,33,69,.478,21,35,.600,12,34,.353,27,32,.844,105,39,85,.459,29,52,.558,10,33,.303,22,26,.846,110
1950,NYK,2023-01-24,105,,CLE,W 105-103,240,37,75,.493,20,42,.476,17,33,.515,14,21,.667,105,40,87,.460,28,54,.519,12,33,.364,11,16,.688,103
1951,PHI,2023-01-19,105,@,POR,W 105-95,240,41,81,.506,33,55,.600,8,26,.308,15,19,.789,105,32,85,.376,23,48,.479,9,37,.243,22,29,.759,95
1952,NYK,2023-01-18,105,,WAS,L 105-116,240,40,96,.417,33,70,.471,7,26,.269,18,27,.667,105,42,95,.442,26,53,.491,16,42,.381,16,19,.842,116
1953,ATL,2023-01-11,105,,MIL,L 105-114,240,39,87,.448,28,57,.491,11,30,.367,16,18,.889,105,45,98,.459,27,50,.540,18,48,.375,6,11,.545,114
1954,POR,2023-01-08,105,@,TOR,L 105-117,240,34,76,.447,25,46,.543,9,30,.300,28,37,.757,105,40,91,.440,28,60,.467,12,31,.387,25,29,.862,117
1955,CHO,2022-12-27,105,@,GSW,L 105-110,240,38,92,.413,28,54,.519,10,38,.263,19,25,.760,105,41,95,.432,33,58,.569,8,37,.216,20,24,.833,110
1956,DET,2022-12-23,105,@,ATL,L 105-130,240,37,90,.411,28,57,.491,9,33,.273,22,29,.759,105,49,92,.533,37,58,.638,12,34,.353,20,24,.833,130
1957,CHO,2022-12-21,105,@,LAC,L 105-126,240,37,92,.402,28,61,.459,9,31,.290,22,29,.759,105,41,81,.506,18,32,.563,23,49,.469,21,23,.913,126
1958,DEN,2022-12-20,105,,MEM,W 105-91,240,40,89,.449,30,62,.484,10,27,.370,15,25,.600,105,36,81,.444,31,55,.564,5,26,.192,14,21,.667,91
1959,HOU,2022-12-19,105,,SAS,L 105-124,240,40,94,.426,35,70,.500,5,24,.208,20,31,.645,105,46,83,.554,29,49,.592,17,34,.500,15,19,.789,124
1960,CLE,2022-12-14,105,@,DAL,W 105-90,240,41,78,.526,33,54,.611,8,24,.333,15,19,.789,105,29,74,.392,16,36,.444,13,38,.342,19,26,.731,90
1961,DAL,2022-12-09,105,,MIL,L 105-106,240,41,88,.466,28,48,.583,13,40,.325,10,24,.417,105,38,87,.437,27,55,.491,11,32,.344,19,23,.826,106
1962,MIL,2022-12-03,105,@,CHO,W 105-96,240,39,83,.470,27,51,.529,12,32,.375,15,19,.789,105,34,87,.391,29,63,.460,5,24,.208,23,26,.885,96
1963,TOR,2022-12-02,105,@,BRK,L 105-114,240,38,87,.437,31,63,.492,7,24,.292,22,30,.733,105,44,82,.537,33,50,.660,11,32,.344,15,22,.682,114
1964,CHO,2022-11-28,105,@,BOS,L 105-140,240,42,86,.488,31,57,.544,11,29,.379,10,15,.667,105,55,93,.591,31,41,.756,24,52,.462,6,7,.857,140
1965,NOP,2022-11-28,105,,OKC,W 105-101,240,39,87,.448,30,55,.545,9,32,.281,18,20,.900,105,34,92,.370,22,54,.407,12,38,.316,21,23,.913,101
1966,TOR,2022-11-26,105,,DAL,W 105-100,240,38,88,.432,30,62,.484,8,26,.308,21,26,.808,105,35,73,.479,24,34,.706,11,39,.282,19,24,.792,100
1967,OKC,2022-11-26,105,@,HOU,L 105-118,240,38,97,.392,28,53,.528,10,44,.227,19,23,.826,105,45,86,.523,27,50,.540,18,36,.500,10,14,.714,118
1968,LAL,2022-11-25,105,@,SAS,W 105-94,240,40,83,.482,32,56,.571,8,27,.296,17,20,.850,105,38,100,.380,32,67,.478,6,33,.182,12,16,.750,94
1969,WAS,2022-11-23,105,@,MIA,L 105-113,240,42,89,.472,32,51,.627,10,38,.263,11,19,.579,105,39,93,.419,23,52,.442,16,41,.390,19,22,.864,113
1970,LAL,2022-11-22,105,@,PHO,L 105-115,240,36,85,.424,32,63,.508,4,22,.182,29,35,.829,105,48,102,.471,32,68,.471,16,34,.471,3,5,.600,115
1971,MIN,2022-11-21,105,,MIA,W 105-101,240,37,85,.435,23,38,.605,14,47,.298,17,20,.850,105,35,90,.389,24,52,.462,11,38,.289,20,30,.667,101
1972,ORL,2022-11-14,105,,CHO,L 105-112,240,36,88,.409,22,52,.423,14,36,.389,19,23,.826,105,42,88,.477,35,53,.660,7,35,.200,21,24,.875,112
1973,PHI,2022-11-13,105,,UTA,W 105-98,240,40,83,.482,36,60,.600,4,23,.174,21,26,.808,105,37,94,.394,26,57,.456,11,37,.297,13,23,.565,98
1974,DAL,2022-11-10,105,@,WAS,L 105-113,240,37,86,.430,19,39,.487,18,47,.383,13,21,.619,105,41,84,.488,29,54,.537,12,30,.400,19,20,.950,113
1975,POR,2022-11-09,105,@,CHO,W 105-95,240,40,75,.533,29,41,.707,11,34,.324,14,25,.560,105,34,91,.374,24,51,.471,10,40,.250,17,24,.708,95
1976,GSW,2022-11-04,105,@,NOP,L 105-114,240,35,71,.493,23,39,.590,12,32,.375,23,25,.920,105,41,81,.506,29,52,.558,12,29,.414,20,29,.690,114
1977,MEM,2022-10-31,105,@,UTA,L 105-121,240,38,92,.413,32,66,.485,6,26,.231,23,42,.548,105,42,89,.472,23,42,.548,19,47,.404,18,22,.818,121
1978,ORL,2022-10-30,105,@,DAL,L 105-114,240,37,81,.457,26,52,.500,11,29,.379,20,27,.741,105,41,83,.494,30,48,.625,11,35,.314,21,28,.750,114
1979,GSW,2022-10-25,105,@,PHO,L 105-134,240,41,91,.451,31,56,.554,10,35,.286,13,17,.765,105,47,92,.511,35,63,.556,12,29,.414,28,34,.824,134
1980,PHI,2022-10-22,105,,SAS,L 105-114,240,37,84,.440,27,53,.509,10,31,.323,21,28,.750,105,43,89,.483,27,51,.529,16,38,.421,12,15,.800,114
1981,HOU,2022-10-22,105,@,MIL,L 105-125,240,36,93,.387,20,56,.357,16,37,.432,17,22,.773,105,48,85,.565,32,54,.593,16,31,.516,13,21,.619,125
1982,TOR,2022-10-21,105,@,BRK,L 105-109,240,41,84,.488,30,56,.536,11,28,.393,12,18,.667,105,38,80,.475,25,45,.556,13,35,.371,20,29,.690,109
1983,CLE,2022-10-19,105,@,TOR,L 105-108,240,38,77,.494,28,49,.571,10,28,.357,19,23,.826,105,36,86,.419,23,56,.411,13,30,.433,23,32,.719,108
1984,DAL,2022-10-19,105,@,PHO,L 105-107,240,35,75,.467,21,40,.525,14,35,.400,21,34,.618,105,40,85,.471,32,63,.508,8,22,.364,19,22,.864,107
1985,PHI,2023-04-02,104,@,MIL,L 104-117,240,40,87,.460,28,51,.549,12,36,.333,12,13,.923,104,46,80,.575,36,52,.692,10,28,.357,15,21,.714,117
1986,IND,2023-03-27,104,,DAL,L 104-127,240,39,93,.419,31,65,.477,8,28,.286,18,23,.783,104,47,83,.566,29,46,.630,18,37,.486,15,17,.882,127
1987,WAS,2023-03-26,104,@,TOR,L 104-114,240,38,86,.442,22,50,.440,16,36,.444,12,20,.600,104,45,98,.459,34,67,.507,11,31,.355,13,16,.813,114
1988,DAL,2023-03-26,104,@,CHO,L 104-110,240,32,84,.381,13,35,.371,19,49,.388,21,22,.955,104,39,88,.443,27,59,.458,12,29,.414,20,24,.833,110
1989,WAS,2023-03-22,104,,DEN,L 104-118,240,44,87,.506,40,61,.656,4,26,.154,12,16,.750,104,42,83,.506,27,51,.529,15,32,.469,19,21,.905,118
1990,BOS,2023-03-15,104,@,MIN,W 104-102,240,34,84,.405,22,44,.500,12,40,.300,24,30,.800,104,37,84,.440,25,48,.521,12,36,.333,16,22,.727,102
1991,CHO,2023-03-14,104,,CLE,L 104-120,240,43,76,.566,37,53,.698,6,23,.261,12,15,.800,104,45,88,.511,31,58,.534,14,30,.467,16,19,.842,120
1992,PHO,2023-03-14,104,,MIL,L 104-116,240,41,95,.432,33,72,.458,8,23,.348,14,16,.875,104,40,85,.471,28,46,.609,12,39,.308,24,37,.649,116
1993,MEM,2023-03-13,104,@,DAL,W 104-88,240,38,83,.458,26,46,.565,12,37,.324,16,19,.842,104,35,90,.389,23,44,.523,12,46,.261,6,8,.750,88
1994,CLE,2023-03-08,104,@,MIA,W 104-100,240,39,80,.488,30,52,.577,9,28,.321,17,19,.895,104,35,70,.500,27,41,.659,8,29,.276,22,29,.759,100
1995,DET,2023-03-06,104,,POR,L 104-110,240,40,86,.465,30,54,.556,10,32,.313,14,20,.700,104,38,78,.487,23,45,.511,15,33,.455,19,25,.760,110
1996,CHI,2023-03-03,104,,PHO,L 104-125,240,39,83,.470,32,60,.533,7,23,.304,19,25,.760,104,42,84,.500,22,37,.595,20,47,.426,21,25,.840,125
1997,TOR,2023-02-28,104,,CHI,W 104-98,240,38,94,.404,23,52,.442,15,42,.357,13,19,.684,104,37,71,.521,27,46,.587,10,25,.400,14,17,.824,98
1998,BRK,2023-02-28,104,,MIL,L 104-118,240,36,83,.434,24,47,.511,12,36,.333,20,25,.800,104,50,102,.490,36,65,.554,14,37,.378,4,12,.333,118
1999,MIN,2023-02-26,104,@,GSW,L 104-109,240,38,90,.422,21,45,.467,17,45,.378,11,21,.524,104,39,91,.429,24,49,.490,15,42,.357,16,22,.727,109
2000,MIL,2023-02-26,104,,PHO,W 104-101,240,38,87,.437,25,42,.595,13,45,.289,15,21,.714,104,40,95,.421,32,71,.451,8,24,.333,13,22,.591,101
2001,HOU,2023-02-13,104,@,PHI,L 104-123,240,35,86,.407,29,62,.468,6,24,.250,28,31,.903,104,46,82,.561,31,48,.646,15,34,.441,16,17,.941,123
2002,IND,2023-02-10,104,,PHO,L 104-117,240,36,85,.424,25,46,.543,11,39,.282,21,28,.750,104,43,93,.462,33,60,.550,10,33,.303,21,24,.875,117
2003,DEN,2023-02-09,104,@,ORL,L 104-115,240,39,84,.464,29,51,.569,10,33,.303,16,24,.667,104,47,97,.485,38,70,.543,9,27,.333,12,19,.632,115
2004,CHO,2023-02-08,104,@,WAS,L 104-118,240,39,93,.419,30,62,.484,9,31,.290,17,21,.810,104,44,87,.506,29,50,.580,15,37,.405,15,17,.882,118
2005,LAC,2023-02-08,104,,DAL,L 104-110,240,38,86,.442,26,53,.491,12,33,.364,16,21,.762,104,41,78,.526,24,43,.558,17,35,.486,11,17,.647,110
2006,MEM,2023-02-07,104,,CHI,W 104-89,240,39,81,.481,28,48,.583,11,33,.333,15,21,.714,104,32,87,.368,25,52,.481,7,35,.200,18,27,.667,89
2007,SAS,2023-02-06,104,@,CHI,L 104-128,240,40,90,.444,32,64,.500,8,26,.308,16,17,.941,104,50,89,.562,44,67,.657,6,22,.273,22,25,.880,128
2008,SAC,2023-02-05,104,@,NOP,L 104-136,240,35,82,.427,24,40,.600,11,42,.262,23,27,.852,104,48,85,.565,34,59,.576,14,26,.538,26,34,.765,136
2009,SAC,2023-02-03,104,@,IND,L 104-107,240,37,86,.430,24,48,.500,13,38,.342,17,20,.850,104,40,89,.449,23,48,.479,17,41,.415,10,14,.714,107
2010,MIA,2023-02-02,104,@,NYK,L 104-106,240,39,87,.448,26,51,.510,13,36,.361,13,16,.813,104,40,83,.482,28,47,.596,12,36,.333,14,18,.778,106
2011,LAL,2023-01-30,104,@,BRK,L 104-121,240,35,89,.393,24,60,.400,11,29,.379,23,37,.622,104,45,95,.474,29,54,.537,16,41,.390,15,19,.789,121
2012,SAS,2023-01-25,104,@,LAL,L 104-113,240,40,106,.377,32,72,.444,8,34,.235,16,18,.889,104,40,90,.444,30,57,.526,10,33,.303,23,30,.767,113
2013,TOR,2023-01-21,104,,BOS,L 104-106,240,46,86,.535,39,67,.582,7,19,.368,5,7,.714,104,38,85,.447,22,50,.440,16,35,.457,14,15,.933,106
2014,HOU,2023-01-21,104,@,MIN,L 104-113,240,38,79,.481,29,55,.527,9,24,.375,19,33,.576,104,38,83,.458,21,42,.500,17,41,.415,20,24,.833,113
2015,DET,2023-01-15,104,,NYK,L 104-117,240,37,83,.446,19,39,.487,18,44,.409,12,15,.800,104,40,88,.455,28,58,.483,12,30,.400,25,31,.806,117
2016,MIN,2023-01-08,104,@,HOU,W 104-96,240,38,80,.475,28,52,.538,10,28,.357,18,22,.818,104,38,89,.427,27,53,.509,11,36,.306,9,15,.600,96
2017,MIA,2023-01-06,104,@,PHO,W 104-96,240,33,78,.423,21,40,.525,12,38,.316,26,31,.839,104,34,82,.415,28,59,.475,6,23,.261,22,25,.880,96
2018,MIL,2023-01-04,104,@,TOR,W 104-101 (OT),265,35,88,.398,22,49,.449,13,39,.333,21,30,.700,104,38,116,.328,29,70,.414,9,46,.196,16,20,.800,101
2019,MIN,2022-12-31,104,,DET,L 104-116,240,36,83,.434,26,49,.531,10,34,.294,22,26,.846,104,43,89,.483,33,62,.532,10,27,.370,20,28,.714,116
2020,PHO,2022-12-30,104,@,TOR,L 104-113,240,35,71,.493,21,41,.512,14,30,.467,20,23,.870,104,40,81,.494,29,48,.604,11,33,.333,22,26,.846,113
2021,DAL,2022-12-21,104,@,MIN,W 104-99,240,34,75,.453,21,36,.583,13,39,.333,23,27,.852,104,42,85,.494,34,55,.618,8,30,.267,7,10,.700,99
2022,PHI,2022-12-19,104,,TOR,W 104-101 (OT),265,32,80,.400,17,38,.447,15,42,.357,25,27,.926,104,37,88,.420,26,48,.542,11,40,.275,16,20,.800,101
2023,LAL,2022-12-19,104,@,PHO,L 104-130,240,39,87,.448,27,59,.458,12,28,.429,14,17,.824,104,46,93,.495,26,54,.481,20,39,.513,18,24,.750,130
2024,NOP,2022-12-07,104,,DET,W 104-98,240,39,85,.459,31,58,.534,8,27,.296,18,23,.783,104,35,90,.389,20,48,.417,15,42,.357,13,16,.813,98
2025,GSW,2022-12-05,104,,IND,L 104-112,240,38,94,.404,25,50,.500,13,44,.295,15,19,.789,104,43,90,.478,28,51,.549,15,39,.385,11,18,.611,112
2026,PHI,2022-11-28,104,,ATL,W 104-101,240,39,86,.453,29,58,.500,10,28,.357,16,18,.889,104,37,74,.500,25,47,.532,12,27,.444,15,22,.682,101
2027,LAC,2022-11-25,104,,DEN,L 104-114,240,37,68,.544,26,46,.565,11,22,.500,19,34,.559,104,44,89,.494,34,59,.576,10,30,.333,16,23,.696,114
2028,SAC,2022-11-25,104,@,BOS,L 104-122,240,36,87,.414,27,51,.529,9,36,.250,23,26,.885,104,41,83,.494,25,46,.543,16,37,.432,24,27,.889,122
2029,MIA,2022-11-16,104,@,TOR,L 104-112,240,36,66,.545,23,31,.742,13,35,.371,19,22,.864,104,44,86,.512,37,60,.617,7,26,.269,17,22,.773,112
2030,TOR,2022-11-12,104,@,IND,L 104-118,240,37,94,.394,30,59,.508,7,35,.200,23,29,.793,104,41,82,.500,22,39,.564,19,43,.442,17,23,.739,118
2031,ATL,2022-11-10,104,,PHI,W 104-95,240,39,88,.443,33,62,.532,6,26,.231,20,23,.870,104,32,83,.386,26,53,.491,6,30,.200,25,30,.833,95
2032,CHI,2022-11-06,104,@,TOR,L 104-113,240,40,88,.455,27,52,.519,13,36,.361,11,13,.846,104,44,103,.427,34,66,.515,10,37,.270,15,20,.750,113
2033,PHI,2022-11-04,104,,NYK,L 104-106,240,37,98,.378,24,51,.471,13,47,.277,17,21,.810,104,37,80,.463,28,47,.596,9,33,.273,23,27,.852,106
2034,LAL,2022-10-23,104,,POR,L 104-106,240,41,92,.446,35,59,.593,6,33,.182,16,20,.800,104,37,84,.440,27,57,.474,10,27,.370,22,27,.815,106
2035,MIA,2022-10-21,104,,BOS,L 104-111,240,42,92,.457,34,66,.515,8,26,.308,12,15,.800,104,41,79,.519,27,46,.587,14,33,.424,15,15,1.000,111
2036,CHI,2023-04-09,103,,DET,W 103-81,240,40,95,.421,34,65,.523,6,30,.200,17,22,.773,103,31,85,.365,22,52,.423,9,33,.273,10,13,.769,81
2037,DEN,2023-04-04,103,@,HOU,L 103-124,240,41,87,.471,30,51,.588,11,36,.306,10,18,.556,103,47,102,.461,35,71,.493,12,31,.387,18,24,.750,124
2038,PHI,2023-04-04,103,,BOS,W 103-101,240,39,78,.500,28,49,.571,11,29,.379,14,16,.875,103,38,91,.418,23,46,.500,15,45,.333,10,16,.625,101
2039,NOP,2023-04-04,103,,SAC,L 103-121,240,37,84,.440,30,64,.469,7,20,.350,22,27,.815,103,46,91,.505,29,49,.592,17,42,.405,12,15,.800,121
2040,UTA,2023-03-27,103,,PHO,L 103-117,240,38,86,.442,29,50,.580,9,36,.250,18,27,.667,103,43,101,.426,32,65,.492,11,36,.306,20,22,.909,117
2041,DET,2023-03-09,103,,CHO,L 103-113,240,40,89,.449,33,68,.485,7,21,.333,16,20,.800,103,43,86,.500,35,62,.565,8,24,.333,19,32,.594,113
2042,MEM,2023-03-07,103,@,LAL,L 103-112,240,36,93,.387,27,56,.482,9,37,.243,22,29,.759,103,41,90,.456,34,62,.548,7,28,.250,23,29,.793,112
2043,UTA,2023-03-03,103,@,OKC,L 103-130,240,38,78,.487,29,49,.592,9,29,.310,18,23,.783,103,52,104,.500,35,61,.574,17,43,.395,9,14,.643,130
2044,MIA,2023-02-25,103,@,CHO,L 103-108,240,32,80,.400,21,44,.477,11,36,.306,28,34,.824,103,38,88,.432,28,57,.491,10,31,.323,22,27,.815,108
2045,NOP,2023-02-13,103,@,OKC,W 103-100,240,39,74,.527,30,44,.682,9,30,.300,16,18,.889,103,38,90,.422,29,57,.509,9,33,.273,15,18,.833,100
2046,ORL,2023-02-11,103,,MIA,L 103-107 (OT),265,37,87,.425,26,58,.448,11,29,.379,18,23,.783,103,37,85,.435,25,46,.543,12,39,.308,21,23,.913,107
2047,GSW,2023-02-11,103,,LAL,L 103-109,240,40,96,.417,28,52,.538,12,44,.273,11,12,.917,103,40,89,.449,32,64,.500,8,25,.320,21,26,.808,109
2048,MEM,2023-02-05,103,,TOR,L 103-106,240,38,78,.487,28,51,.549,10,27,.370,17,23,.739,103,44,101,.436,33,65,.508,11,36,.306,7,12,.583,106
2049,IND,2023-02-05,103,,CLE,L 103-122,240,40,92,.435,32,60,.533,8,32,.250,15,22,.682,103,46,88,.523,31,51,.608,15,37,.405,15,16,.938,122
2050,CHI,2023-01-31,103,,LAC,L 103-108,240,38,77,.494,26,53,.491,12,24,.500,15,21,.714,103,37,93,.398,25,49,.510,12,44,.273,22,26,.846,108
2051,NOP,2023-01-28,103,,WAS,L 103-113,240,39,92,.424,31,63,.492,8,29,.276,17,19,.895,103,40,88,.455,29,52,.558,11,36,.306,22,29,.759,113
2052,HOU,2023-01-25,103,,WAS,L 103-108,240,42,97,.433,37,69,.536,5,28,.179,14,20,.700,103,39,98,.398,27,60,.450,12,38,.316,18,23,.783,108
2053,CLE,2023-01-24,103,@,NYK,L 103-105,240,40,87,.460,28,54,.519,12,33,.364,11,16,.688,103,37,75,.493,20,42,.476,17,33,.515,14,21,.667,105
2054,LAC,2023-01-18,103,@,UTA,L 103-126,240,37,92,.402,22,58,.379,15,34,.441,14,21,.667,103,45,87,.517,26,55,.473,19,32,.594,17,22,.773,126
2055,NOP,2023-01-16,103,@,CLE,L 103-113,240,38,75,.507,28,48,.583,10,27,.370,17,22,.773,103,39,80,.488,30,52,.577,9,28,.321,26,33,.788,113
2056,TOR,2023-01-14,103,,ATL,L 103-114,240,36,87,.414,29,58,.500,7,29,.241,24,30,.800,103,43,84,.512,32,57,.561,11,27,.407,17,18,.944,114
2057,LAC,2023-01-13,103,,DEN,L 103-115,240,41,87,.471,31,58,.534,10,29,.345,11,14,.786,103,41,82,.500,27,49,.551,14,33,.424,19,25,.760,115
2058,SAS,2023-01-02,103,@,BRK,L 103-139,240,42,97,.433,34,66,.515,8,31,.258,11,18,.611,103,58,93,.624,47,73,.644,11,20,.550,12,15,.800,139
2059,CLE,2022-12-31,103,@,CHI,W 103-102,240,39,85,.459,26,47,.553,13,38,.342,12,19,.632,103,39,81,.481,32,60,.533,7,21,.333,17,24,.708,102
2060,MIA,2022-12-20,103,,CHI,L 103-113,240,38,81,.469,23,37,.622,15,44,.341,12,17,.706,103,40,73,.548,27,42,.643,13,31,.419,20,24,.833,113
2061,SAC,2022-12-13,103,@,PHI,L 103-123,240,38,92,.413,28,50,.560,10,42,.238,17,20,.850,103,43,84,.512,27,49,.551,16,35,.457,21,27,.778,123
2062,ATL,2022-12-12,103,@,MEM,L 103-128,240,37,104,.356,25,67,.373,12,37,.324,17,22,.773,103,50,83,.602,37,51,.725,13,32,.406,15,18,.833,128
2063,DET,2022-12-09,103,@,MEM,L 103-114,240,36,90,.400,25,55,.455,11,35,.314,20,27,.741,103,44,91,.484,35,59,.593,9,32,.281,17,32,.531,114
2064,BOS,2022-12-04,103,@,BRK,W 103-92,240,35,81,.432,20,43,.465,15,38,.395,18,20,.900,103,34,84,.405,25,58,.431,9,26,.346,15,22,.682,92
2065,NYK,2022-11-30,103,,MIL,L 103-109,240,42,100,.420,36,70,.514,6,30,.200,13,20,.650,103,39,90,.433,29,55,.527,10,35,.286,21,26,.808,109
2066,ORL,2022-11-27,103,,PHI,L 103-133,240,36,79,.456,24,39,.615,12,40,.300,19,25,.760,103,50,77,.649,39,50,.780,11,27,.407,22,27,.815,133
2067,DEN,2022-11-16,103,,NYK,L 103-106,240,36,82,.439,22,44,.500,14,38,.368,17,20,.850,103,37,84,.440,29,50,.580,8,34,.235,24,31,.774,106
2068,DAL,2022-11-15,103,,LAC,W 103-101,240,35,80,.438,18,37,.486,17,43,.395,16,24,.667,103,34,64,.531,22,36,.611,12,28,.429,21,26,.808,101
2069,BRK,2022-11-13,103,@,LAL,L 103-116,240,36,80,.450,29,53,.547,7,27,.259,24,31,.774,103,44,91,.484,33,64,.516,11,27,.407,17,20,.850,116
2070,CHI,2022-11-13,103,,DEN,L 103-126,240,40,81,.494,34,59,.576,6,22,.273,17,21,.810,103,48,80,.600,35,53,.660,13,27,.481,17,21,.810,126
2071,MIN,2022-11-11,103,@,MEM,L 103-114,240,37,79,.468,27,49,.551,10,30,.333,19,22,.864,103,44,88,.500,37,55,.673,7,33,.212,19,27,.704,114
2072,OKC,2022-11-07,103,@,DET,L 103-112,240,41,102,.402,31,69,.449,10,33,.303,11,17,.647,103,39,93,.419,30,60,.500,9,33,.273,25,33,.758,112
2073,MEM,2022-11-06,103,,WAS,W 103-97,240,39,91,.429,30,62,.484,9,29,.310,16,20,.800,103,41,96,.427,33,55,.600,8,41,.195,7,10,.700,97
2074,DAL,2022-11-02,103,,UTA,W 103-100,240,42,84,.500,31,46,.674,11,38,.289,8,15,.533,103,39,84,.464,29,54,.537,10,30,.333,12,14,.857,100
2075,CLE,2022-10-26,103,,ORL,W 103-92,240,36,87,.414,26,54,.481,10,33,.303,21,30,.700,103,35,81,.432,29,57,.509,6,24,.250,16,21,.762,92
2076,LAC,2022-10-20,103,@,LAL,W 103-97,240,37,80,.463,28,51,.549,9,29,.310,20,31,.645,103,33,94,.351,24,49,.490,9,45,.200,22,26,.846,97
2077,TOR,2023-04-07,102,@,BOS,L 102-121,240,40,93,.430,31,62,.500,9,31,.290,13,17,.765,102,45,81,.556,30,37,.811,15,44,.341,16,21,.762,121
2078,BRK,2023-04-04,102,,MIN,L 102-107,240,39,90,.433,26,55,.473,13,35,.371,11,14,.786,102,41,85,.482,33,61,.541,8,24,.333,17,22,.773,107
2079,DET,2023-04-02,102,@,ORL,L 102-128,240,32,78,.410,23,45,.511,9,33,.273,29,36,.806,102,43,75,.573,26,42,.619,17,33,.515,25,40,.625,128
2080,POR,2023-03-19,102,,LAC,L 102-117,240,37,82,.451,31,53,.585,6,29,.207,22,24,.917,102,43,94,.457,31,66,.470,12,28,.429,19,23,.826,117
2081,BRK,2023-03-19,102,,DEN,L 102-108,240,38,82,.463,26,47,.553,12,35,.343,14,16,.875,102,42,80,.525,30,57,.526,12,23,.522,12,13,.923,108
2082,MIN,2023-03-15,102,,BOS,L 102-104,240,37,84,.440,25,48,.521,12,36,.333,16,22,.727,102,34,84,.405,22,44,.500,12,40,.300,24,30,.800,104
2083,OKC,2023-03-12,102,@,SAS,W 102-90,240,36,95,.379,26,56,.464,10,39,.256,20,23,.870,102,33,88,.375,23,52,.442,10,36,.278,14,19,.737,90
2084,BRK,2023-03-05,102,,CHO,W 102-86,240,36,92,.391,24,49,.490,12,43,.279,18,22,.818,102,33,88,.375,25,58,.431,8,30,.267,12,15,.800,86
2085,LAL,2023-03-03,102,,MIN,L 102-110,240,36,87,.414,26,56,.464,10,31,.323,20,24,.833,102,42,89,.472,28,55,.509,14,34,.412,12,16,.750,110
2086,SAS,2023-02-28,102,@,UTA,W 102-94,240,39,91,.429,31,65,.477,8,26,.308,16,25,.640,102,30,85,.353,20,51,.392,10,34,.294,24,36,.667,94
2087,CHI,2023-02-26,102,,WAS,W 102-82,240,40,79,.506,32,49,.653,8,30,.267,14,17,.824,102,32,76,.421,26,48,.542,6,28,.214,12,23,.522,82
2088,SAS,2023-02-25,102,@,UTA,L 102-118,240,38,97,.392,29,63,.460,9,34,.265,17,21,.810,102,43,92,.467,33,64,.516,10,28,.357,22,28,.786,118
2089,NOP,2023-02-15,102,@,LAL,L 102-120,240,39,89,.438,32,64,.500,7,25,.280,17,24,.708,102,44,83,.530,34,46,.739,10,37,.270,22,36,.611,120
2090,NYK,2023-02-07,102,@,ORL,W 102-98,240,37,81,.457,22,38,.579,15,43,.349,13,19,.684,102,37,79,.468,31,54,.574,6,25,.240,18,24,.750,98
2091,NOP,2023-01-25,102,,MIN,L 102-111,240,37,85,.435,25,47,.532,12,38,.316,16,21,.762,102,40,82,.488,29,53,.547,11,29,.379,20,28,.714,111
2092,CHO,2023-01-23,102,@,UTA,L 102-120,240,38,85,.447,36,69,.522,2,16,.125,24,34,.706,102,41,86,.477,25,46,.543,16,40,.400,22,26,.846,120
2093,MIL,2023-01-21,102,@,CLE,L 102-114,240,39,86,.453,25,47,.532,14,39,.359,10,11,.909,102,48,86,.558,41,64,.641,7,22,.318,11,17,.647,114
2094,BRK,2023-01-15,102,,OKC,L 102-112,240,39,91,.429,27,50,.540,12,41,.293,12,19,.632,102,40,90,.444,28,59,.475,12,31,.387,20,26,.769,112
2095,CLE,2023-01-14,102,@,MIN,L 102-110,240,37,76,.487,29,48,.604,8,28,.286,20,23,.870,102,45,80,.563,36,52,.692,9,28,.321,11,15,.733,110
2096,MIL,2023-01-12,102,@,MIA,L 102-108,240,35,87,.402,13,30,.433,22,57,.386,10,15,.667,102,42,95,.442,33,61,.541,9,34,.265,15,16,.938,108
2097,BRK,2023-01-08,102,@,MIA,W 102-101,240,39,76,.513,27,43,.628,12,33,.364,12,15,.800,102,38,92,.413,25,57,.439,13,35,.371,12,17,.706,101
2098,NOP,2023-01-06,102,,BRK,L 102-108,240,35,88,.398,23,59,.390,12,29,.414,20,25,.800,102,37,85,.435,22,52,.423,15,33,.455,19,20,.950,108
2099,NYK,2023-01-02,102,,PHO,W 102-83,240,36,74,.486,23,41,.561,13,33,.394,17,25,.680,102,34,87,.391,24,50,.480,10,37,.270,5,7,.714,83
2100,CHI,2022-12-31,102,,CLE,L 102-103,240,39,81,.481,32,60,.533,7,21,.333,17,24,.708,102,39,85,.459,26,47,.553,13,38,.342,12,19,.632,103
2101,PHO,2022-12-28,102,@,WAS,L 102-127,240,39,87,.448,26,56,.464,13,31,.419,11,16,.688,102,47,82,.573,39,56,.696,8,26,.308,25,28,.893,127
2102,HOU,2022-12-27,102,@,BOS,L 102-126,240,38,95,.400,24,50,.480,14,45,.311,12,14,.857,102,43,91,.473,23,35,.657,20,56,.357,20,23,.870,126
2103,LAC,2022-12-17,102,,WAS,W 102-93,240,37,86,.430,25,57,.439,12,29,.414,16,26,.615,102,36,84,.429,27,59,.458,9,25,.360,12,13,.923,93
2104,OKC,2022-12-10,102,@,CLE,L 102-110,240,38,83,.458,28,54,.519,10,29,.345,16,20,.800,102,40,85,.471,28,53,.528,12,32,.375,18,26,.692,110
2105,CHO,2022-12-09,102,,NYK,L 102-121,240,37,84,.440,31,58,.534,6,26,.231,22,28,.786,102,41,93,.441,28,59,.475,13,34,.382,26,30,.867,121
2106,OKC,2022-12-07,102,@,MEM,L 102-123,240,34,92,.370,20,54,.370,14,38,.368,20,23,.870,102,48,94,.511,34,56,.607,14,38,.368,13,16,.813,123
2107,LAL,2022-12-06,102,@,CLE,L 102-116,240,38,89,.427,32,53,.604,6,36,.167,20,24,.833,102,48,93,.516,41,66,.621,7,27,.259,13,17,.765,116
2108,ORL,2022-12-05,102,,MIL,L 102-109,240,34,93,.366,26,61,.426,8,32,.250,26,29,.897,102,38,85,.447,25,45,.556,13,40,.325,20,26,.769,109
2109,ORL,2022-11-28,102,@,BRK,L 102-109,240,38,80,.475,25,49,.510,13,31,.419,13,22,.591,102,44,81,.543,35,53,.660,9,28,.321,12,14,.857,109
2110,CLE,2022-11-27,102,@,DET,W 102-94,240,33,77,.429,25,49,.510,8,28,.286,28,33,.848,102,36,79,.456,28,51,.549,8,28,.286,14,26,.538,94
2111,DET,2022-11-25,102,@,PHO,L 102-108,240,39,92,.424,30,66,.455,9,26,.346,15,16,.938,102,42,87,.483,35,58,.603,7,29,.241,17,26,.654,108
2112,CLE,2022-11-25,102,@,MIL,L 102-117,240,34,87,.391,22,54,.407,12,33,.364,22,26,.846,102,42,83,.506,27,51,.529,15,32,.469,18,25,.720,117
2113,ATL,2022-11-21,102,@,CLE,L 102-114,240,38,87,.437,27,53,.509,11,34,.324,15,17,.882,102,42,70,.600,32,51,.627,10,19,.526,20,23,.870,114
2114,ORL,2022-11-21,102,@,IND,L 102-123,240,36,85,.424,25,50,.500,11,35,.314,19,25,.760,102,43,86,.500,30,40,.750,13,46,.283,24,27,.889,123
2115,CHO,2022-11-20,102,@,WAS,L 102-106,240,39,100,.390,31,68,.456,8,32,.250,16,23,.696,102,40,93,.430,27,59,.458,13,34,.382,13,18,.722,106
2116,MIL,2022-11-18,102,@,PHI,L 102-110,240,41,90,.456,29,54,.537,12,36,.333,8,21,.381,102,40,78,.513,27,50,.540,13,28,.464,17,26,.654,110
2117,MEM,2022-11-15,102,@,NOP,L 102-113,240,38,92,.413,29,57,.509,9,35,.257,17,25,.680,102,43,91,.473,25,53,.472,18,38,.474,9,12,.750,113
2118,WAS,2022-11-13,102,,MEM,W 102-92,240,36,86,.419,17,46,.370,19,40,.475,11,21,.524,102,38,96,.396,29,68,.426,9,28,.321,7,10,.700,92
2119,LAC,2022-11-06,102,,UTA,L 102-110,240,43,87,.494,35,54,.648,8,33,.242,8,13,.615,102,35,75,.467,20,35,.571,15,40,.375,25,26,.962,110
2120,PHO,2022-11-05,102,,POR,W 102-82,240,35,82,.427,24,52,.462,11,30,.367,21,28,.750,102,30,79,.380,23,64,.359,7,15,.467,15,24,.625,82
2121,MIN,2022-11-04,102,,MIL,L 102-115,240,39,92,.424,28,51,.549,11,41,.268,13,17,.765,102,41,85,.482,24,47,.511,17,38,.447,16,28,.571,115
2122,LAL,2022-10-28,102,@,MIN,L 102-111,240,37,89,.416,28,60,.467,9,29,.310,19,27,.704,102,41,99,.414,28,59,.475,13,40,.325,16,24,.667,111
2123,BOS,2022-10-24,102,@,CHI,L 102-120,240,37,100,.370,19,52,.365,18,48,.375,10,12,.833,102,42,87,.483,32,66,.485,10,21,.476,26,29,.897,120
2124,ORL,2022-10-24,102,@,NYK,L 102-115,240,36,86,.419,29,51,.569,7,35,.200,23,27,.852,102,43,93,.462,32,56,.571,11,37,.297,18,25,.720,115
2125,WAS,2022-10-21,102,,CHI,W 102-100,240,41,80,.513,31,54,.574,10,26,.385,10,11,.909,102,33,79,.418,26,52,.500,7,27,.259,27,33,.818,100
2126,DEN,2022-10-19,102,@,UTA,L 102-123,240,40,83,.482,35,61,.574,5,22,.227,17,18,.944,102,42,83,.506,26,45,.578,16,38,.421,23,31,.742,123
2127,SAS,2022-10-19,102,,CHO,L 102-129,240,40,99,.404,33,65,.508,7,34,.206,15,21,.714,102,48,94,.511,35,65,.538,13,29,.448,20,23,.870,129
2128,POR,2023-04-09,101,,GSW,L 101-157,240,38,95,.400,29,60,.483,9,35,.257,16,24,.667,101,58,96,.604,31,47,.660,27,49,.551,14,16,.875,157
2129,BRK,2023-04-07,101,,ORL,W 101-84,240,35,89,.393,26,47,.553,9,42,.214,22,25,.880,101,31,87,.356,24,49,.490,7,38,.184,15,17,.882,84
2130,PHI,2023-04-06,101,,MIA,L 101-129,240,39,76,.513,29,40,.725,10,36,.278,13,15,.867,101,49,88,.557,31,49,.633,18,39,.462,13,15,.867,129
2131,BOS,2023-04-04,101,@,PHI,L 101-103,240,38,91,.418,23,46,.500,15,45,.333,10,16,.625,101,39,78,.500,28,49,.571,11,29,.379,14,16,.875,103
2132,NYK,2023-03-29,101,,MIA,W 101-92,240,38,76,.500,25,45,.556,13,31,.419,12,23,.522,101,35,79,.443,22,40,.550,13,39,.333,9,14,.643,92
2133,OKC,2023-03-21,101,@,LAC,W 101-100,240,39,93,.419,29,56,.518,10,37,.270,13,14,.929,101,41,86,.477,35,55,.636,6,31,.194,12,21,.571,100
2134,SAC,2023-03-16,101,@,BRK,W 101-96,240,32,82,.390,19,41,.463,13,41,.317,24,32,.750,101,33,80,.413,19,41,.463,14,39,.359,16,23,.696,96
2135,OKC,2023-03-08,101,@,PHO,L 101-132,240,33,88,.375,18,45,.400,15,43,.349,20,21,.952,101,49,94,.521,29,51,.569,20,43,.465,14,16,.875,132
2136,LAC,2023-02-28,101,,MIN,L 101-108,240,35,83,.422,24,55,.436,11,28,.393,20,23,.870,101,43,90,.478,34,64,.531,9,26,.346,13,22,.591,108
2137,ORL,2023-02-27,101,@,NOP,W 101-93,240,36,79,.456,27,45,.600,9,34,.265,20,26,.769,101,34,76,.447,28,49,.571,6,27,.222,19,23,.826,93
2138,MIA,2023-02-27,101,@,PHI,W 101-99,240,35,81,.432,20,44,.455,15,37,.405,16,22,.727,101,32,73,.438,22,46,.478,10,27,.370,25,28,.893,99
2139,PHO,2023-02-26,101,@,MIL,L 101-104,240,40,95,.421,32,71,.451,8,24,.333,13,22,.591,101,38,87,.437,25,42,.595,13,45,.289,15,21,.714,104
2140,HOU,2023-02-24,101,@,GSW,L 101-116,240,36,92,.391,25,57,.439,11,35,.314,18,22,.818,101,37,78,.474,11,24,.458,26,54,.481,16,18,.889,116
2141,ATL,2023-02-15,101,,NYK,L 101-122,240,40,97,.412,35,71,.493,5,26,.192,16,21,.762,101,45,96,.469,31,53,.585,14,43,.326,18,22,.818,122
2142,POR,2023-02-14,101,,WAS,L 101-126,240,36,86,.419,24,44,.545,12,42,.286,17,24,.708,101,45,79,.570,28,46,.609,17,33,.515,19,22,.864,126
2143,PHI,2023-02-11,101,@,BRK,W 101-98,240,33,75,.440,27,52,.519,6,23,.261,29,30,.967,101,37,92,.402,24,52,.462,13,40,.325,11,13,.846,98
2144,OKC,2023-01-22,101,@,DEN,W 101-99,240,40,89,.449,33,63,.524,7,26,.269,14,16,.875,101,36,82,.439,26,54,.481,10,28,.357,17,33,.515,99
2145,DAL,2023-01-10,101,@,LAC,L 101-113,240,30,69,.435,18,31,.581,12,38,.316,29,36,.806,101,39,86,.453,27,55,.491,12,31,.387,23,30,.767,113
2146,MIA,2023-01-08,101,,BRK,L 101-102,240,38,92,.413,25,57,.439,13,35,.371,12,17,.706,101,39,76,.513,27,43,.628,12,33,.364,12,15,.800,102
2147,GSW,2023-01-07,101,,ORL,L 101-115,240,33,88,.375,15,30,.500,18,58,.310,17,21,.810,101,44,87,.506,31,55,.564,13,32,.406,14,24,.583,115
2148,TOR,2023-01-04,101,,MIL,L 101-104 (OT),265,38,116,.328,29,70,.414,9,46,.196,16,20,.800,101,35,88,.398,22,49,.449,13,39,.333,21,30,.700,104
2149,NOP,2022-12-31,101,@,MEM,L 101-116,240,32,91,.352,24,61,.393,8,30,.267,29,36,.806,101,47,92,.511,42,63,.667,5,29,.172,17,22,.773,116
2150,ORL,2022-12-28,101,@,DET,L 101-121,240,35,85,.412,30,63,.476,5,22,.227,26,34,.765,101,36,80,.450,18,38,.474,18,42,.429,31,40,.775,121
2151,OKC,2022-12-21,101,,POR,W 101-98,240,36,77,.468,28,53,.528,8,24,.333,21,25,.840,101,39,79,.494,25,43,.581,14,36,.389,6,9,.667,98
2152,TOR,2022-12-19,101,@,PHI,L 101-104 (OT),265,37,88,.420,26,48,.542,11,40,.275,16,20,.800,101,32,80,.400,17,38,.447,15,42,.357,25,27,.926,104
2153,SAS,2022-12-17,101,,MIA,L 101-111,240,33,77,.429,23,50,.460,10,27,.370,25,33,.758,101,42,82,.512,31,52,.596,11,30,.367,16,23,.696,111
2154,MIL,2022-12-15,101,@,MEM,L 101-142,240,35,94,.372,22,44,.500,13,50,.260,18,27,.667,101,56,102,.549,44,70,.629,12,32,.375,18,23,.783,142
2155,MEM,2022-12-05,101,,MIA,W 101-93,240,42,90,.467,34,58,.586,8,32,.250,9,9,1.000,101,31,79,.392,17,39,.436,14,40,.350,17,22,.773,93
2156,CHI,2022-12-04,101,@,SAC,L 101-110,240,38,86,.442,29,61,.475,9,25,.360,16,19,.842,101,40,86,.465,27,43,.628,13,43,.302,17,19,.895,110
2157,HOU,2022-12-03,101,@,GSW,L 101-120,240,40,91,.440,37,63,.587,3,28,.107,18,20,.900,101,45,85,.529,20,33,.606,25,52,.481,5,10,.500,120
2158,MEM,2022-11-30,101,@,MIN,L 101-109,240,37,87,.425,28,61,.459,9,26,.346,18,30,.600,101,41,89,.461,29,50,.580,12,39,.308,15,19,.789,109
2159,OKC,2022-11-28,101,@,NOP,L 101-105,240,34,92,.370,22,54,.407,12,38,.316,21,23,.913,101,39,87,.448,30,55,.545,9,32,.281,18,20,.900,105
2160,ATL,2022-11-28,101,@,PHI,L 101-104,240,37,74,.500,25,47,.532,12,27,.444,15,22,.682,101,39,86,.453,29,58,.500,10,28,.357,16,18,.889,104
2161,IND,2022-11-23,101,,MIN,L 101-115,240,37,96,.385,21,52,.404,16,44,.364,11,16,.688,101,47,77,.610,39,55,.709,8,22,.364,13,17,.765,115
2162,PHI,2022-11-23,101,@,CHO,L 101-107,240,38,86,.442,29,48,.604,9,38,.237,16,18,.889,101,44,92,.478,38,69,.551,6,23,.261,13,21,.619,107
2163,MIA,2022-11-21,101,@,MIN,L 101-105,240,35,90,.389,24,52,.462,11,38,.289,20,30,.667,101,37,85,.435,23,38,.605,14,47,.298,17,20,.850,105
2164,NYK,2022-11-18,101,@,GSW,L 101-111,240,30,87,.345,21,53,.396,9,34,.265,32,34,.941,101,41,91,.451,23,41,.561,18,50,.360,11,20,.550,111
2165,ATL,2022-11-16,101,,BOS,L 101-126,240,42,101,.416,35,69,.507,7,32,.219,10,13,.769,101,48,88,.545,27,42,.643,21,46,.457,9,10,.900,126
2166,HOU,2022-11-16,101,@,DAL,W 101-92,240,35,75,.467,25,53,.472,10,22,.455,21,24,.875,101,31,102,.304,19,47,.404,12,55,.218,18,19,.947,92
2167,LAC,2022-11-15,101,@,DAL,L 101-103,240,34,64,.531,22,36,.611,12,28,.429,21,26,.808,101,35,80,.438,18,37,.486,17,43,.395,16,24,.667,103
2168,CLE,2022-11-11,101,@,GSW,L 101-106,240,37,92,.402,29,62,.468,8,30,.267,19,26,.731,101,40,82,.488,25,46,.543,15,36,.417,11,14,.786,106
2169,LAL,2022-11-09,101,@,LAC,L 101-114,240,40,88,.455,30,56,.536,10,32,.313,11,17,.647,101,41,81,.506,29,48,.604,12,33,.364,20,26,.769,114
2170,SAS,2022-11-05,101,@,DEN,L 101-126,240,39,80,.488,27,50,.540,12,30,.400,11,19,.579,101,53,87,.609,38,58,.655,15,29,.517,5,10,.500,126
2171,IND,2022-11-04,101,,MIA,W 101-99,240,37,80,.463,25,41,.610,12,39,.308,15,23,.652,101,31,81,.383,20,42,.476,11,39,.282,26,26,1.000,99
2172,HOU,2022-11-02,101,,LAC,L 101-109,240,37,88,.420,26,50,.520,11,38,.289,16,21,.762,101,41,84,.488,29,51,.569,12,33,.364,15,19,.789,109
2173,UTA,2022-10-28,101,@,DEN,L 101-117,240,38,91,.418,28,52,.538,10,39,.256,15,19,.789,101,39,85,.459,22,48,.458,17,37,.459,22,34,.647,117
2174,HOU,2022-10-26,101,@,UTA,L 101-109,240,36,94,.383,25,54,.463,11,40,.275,18,24,.750,101,38,90,.422,25,45,.556,13,45,.289,20,30,.667,109
2175,MEM,2023-04-09,100,@,OKC,L 100-115,240,40,92,.435,33,55,.600,7,37,.189,13,18,.722,100,45,90,.500,33,54,.611,12,36,.333,13,16,.813,115
2176,CHO,2023-04-04,100,,TOR,L 100-120,240,36,77,.468,24,46,.522,12,31,.387,16,19,.842,100,42,88,.477,27,55,.491,15,33,.455,21,28,.750,120
2177,PHO,2023-03-31,100,,DEN,W 100-93,240,37,88,.420,27,61,.443,10,27,.370,16,21,.762,100,38,95,.400,32,69,.464,6,26,.231,11,20,.550,93
2178,MIN,2023-03-29,100,@,PHO,L 100-107,240,40,90,.444,28,55,.509,12,35,.343,8,12,.667,100,40,96,.417,34,76,.447,6,20,.300,21,27,.778,107
2179,MIA,2023-03-25,100,,BRK,L 100-129,240,38,80,.475,26,50,.520,12,30,.400,12,14,.857,100,44,89,.494,26,49,.531,18,40,.450,23,25,.920,129
2180,LAC,2023-03-21,100,,OKC,L 100-101,240,41,86,.477,35,55,.636,6,31,.194,12,21,.571,100,39,93,.419,29,56,.518,10,37,.270,13,14,.929,101
2181,DET,2023-03-19,100,,MIA,L 100-112,240,38,82,.463,28,50,.560,10,32,.313,14,17,.824,100,38,79,.481,25,40,.625,13,39,.333,23,25,.920,112
2182,DET,2023-03-16,100,,DEN,L 100-119,240,39,85,.459,27,58,.466,12,27,.444,10,18,.556,100,47,89,.528,39,65,.600,8,24,.333,17,25,.680,119
2183,MIA,2023-03-08,100,,CLE,L 100-104,240,35,70,.500,27,41,.659,8,29,.276,22,29,.759,100,39,80,.488,30,52,.577,9,28,.321,17,19,.895,104
2184,TOR,2023-03-08,100,@,LAC,L 100-108,240,37,96,.385,24,64,.375,13,32,.406,13,14,.929,100,39,71,.549,33,51,.647,6,20,.300,24,31,.774,108
2185,CHI,2023-02-16,100,,MIL,L 100-112,240,37,97,.381,27,65,.415,10,32,.313,16,21,.762,100,40,88,.455,22,41,.537,18,47,.383,14,18,.778,112
2186,ORL,2023-02-13,100,@,CHI,W 100-91,240,38,81,.469,30,54,.556,8,27,.296,16,19,.842,100,35,86,.407,32,65,.492,3,21,.143,18,19,.947,91
2187,OKC,2023-02-13,100,,NOP,L 100-103,240,38,90,.422,29,57,.509,9,33,.273,15,18,.833,100,39,74,.527,30,44,.682,9,30,.300,16,18,.889,103
2188,DET,2023-02-04,100,,PHO,L 100-116,240,35,81,.432,19,39,.487,16,42,.381,14,22,.636,100,42,75,.560,31,52,.596,11,23,.478,21,31,.677,116
2189,PHO,2023-02-01,100,,ATL,L 100-132,240,35,86,.407,31,58,.534,4,28,.143,26,31,.839,100,52,91,.571,33,58,.569,19,33,.576,9,11,.818,132
2190,MIA,2023-01-31,100,@,CLE,W 100-97,240,34,78,.436,20,47,.426,14,31,.452,18,25,.720,100,40,83,.482,29,43,.674,11,40,.275,6,12,.500,97
2191,IND,2023-01-29,100,@,MEM,L 100-112,240,36,79,.456,27,47,.574,9,32,.281,19,21,.905,100,43,89,.483,34,52,.654,9,37,.243,17,22,.773,112
2192,DAL,2023-01-28,100,@,UTA,L 100-108,240,35,80,.438,17,34,.500,18,46,.391,12,17,.706,100,39,82,.476,26,46,.565,13,36,.361,17,24,.708,108
2193,MEM,2023-01-27,100,@,MIN,L 100-111,240,38,93,.409,30,60,.500,8,33,.242,16,19,.842,100,44,86,.512,31,51,.608,13,35,.371,10,15,.667,111
2194,CLE,2023-01-27,100,@,OKC,L 100-112,240,39,88,.443,31,59,.525,8,29,.276,14,18,.778,100,40,76,.526,30,58,.517,10,18,.556,22,25,.880,112
2195,SAS,2023-01-26,100,@,LAC,L 100-138,240,37,82,.451,29,58,.500,8,24,.333,18,28,.643,100,52,89,.584,34,51,.667,18,38,.474,16,21,.762,138
2196,MEM,2023-01-23,100,@,SAC,L 100-133,240,40,98,.408,28,62,.452,12,36,.333,8,10,.800,100,49,88,.557,27,48,.563,22,40,.550,13,14,.929,133
2197,ATL,2023-01-23,100,@,CHI,L 100-111,240,39,85,.459,29,52,.558,10,33,.303,12,19,.632,100,44,95,.463,33,61,.541,11,34,.324,12,18,.667,111
2198,MIA,2023-01-22,100,,NOP,W 100-96,240,35,80,.438,27,46,.587,8,34,.235,22,27,.815,100,37,78,.474,29,48,.604,8,30,.267,14,18,.778,96
2199,HOU,2023-01-15,100,@,LAC,L 100-121,240,38,84,.452,31,53,.585,7,31,.226,17,23,.739,100,46,88,.523,32,56,.571,14,32,.438,15,21,.714,121
2200,WAS,2023-01-11,100,,CHI,W 100-97,240,38,82,.463,31,59,.525,7,23,.304,17,21,.810,100,41,88,.466,32,59,.542,9,29,.310,6,9,.667,97
2201,LAC,2023-01-02,100,,MIA,L 100-110,240,29,67,.433,17,38,.447,12,29,.414,30,34,.882,100,39,85,.459,27,49,.551,12,36,.333,20,24,.833,110
2202,ORL,2022-12-30,100,,WAS,L 100-119,240,42,100,.420,37,73,.507,5,27,.185,11,16,.688,100,42,75,.560,27,40,.675,15,35,.429,20,25,.800,119
2203,PHO,2022-12-23,100,,MEM,L 100-125,240,38,87,.437,29,52,.558,9,35,.257,15,26,.577,100,45,91,.495,38,68,.559,7,23,.304,28,38,.737,125
2204,MIL,2022-12-23,100,@,BRK,L 100-118,240,37,84,.440,28,47,.596,9,37,.243,17,22,.773,100,46,93,.495,32,61,.525,14,32,.438,12,13,.923,118
2205,CLE,2022-12-17,100,,DAL,W 100-99 (OT),265,40,94,.426,33,58,.569,7,36,.194,13,22,.591,100,36,88,.409,21,39,.538,15,49,.306,12,19,.632,99
2206,NOP,2022-12-13,100,@,UTA,L 100-121,240,37,93,.398,33,66,.500,4,27,.148,22,33,.667,100,49,103,.476,34,56,.607,15,47,.319,8,12,.667,121
2207,WAS,2022-12-12,100,,BRK,L 100-112,240,37,79,.468,26,48,.542,11,31,.355,15,22,.682,100,44,89,.494,36,62,.581,8,27,.296,16,18,.889,112
2208,IND,2022-12-04,100,@,POR,L 100-116,240,40,91,.440,30,58,.517,10,33,.303,10,12,.833,100,42,86,.488,25,46,.543,17,40,.425,15,22,.682,116
2209,NYK,2022-12-03,100,,DAL,L 100-121,240,35,77,.455,25,46,.543,10,31,.323,20,28,.714,100,43,100,.430,19,39,.487,24,61,.393,11,14,.786,121
2210,HOU,2022-11-30,100,@,DEN,L 100-120,240,37,88,.420,25,47,.532,12,41,.293,14,18,.778,100,44,83,.530,27,51,.529,17,32,.531,15,20,.750,120
2211,TOR,2022-11-28,100,,CLE,W 100-88,240,37,84,.440,25,56,.446,12,28,.429,14,17,.824,100,34,90,.378,27,52,.519,7,38,.184,13,16,.813,88
2212,IND,2022-11-27,100,@,LAC,L 100-114,240,36,94,.383,27,52,.519,9,42,.214,19,23,.826,100,42,94,.447,36,62,.581,6,32,.188,24,32,.750,114
2213,DAL,2022-11-26,100,@,TOR,L 100-105,240,35,73,.479,24,34,.706,11,39,.282,19,24,.792,100,38,88,.432,30,62,.484,8,26,.308,21,26,.808,105
2214,PHI,2022-11-07,100,,PHO,W 100-88,240,31,80,.388,19,48,.396,12,32,.375,26,31,.839,100,32,73,.438,26,54,.481,6,19,.316,18,22,.818,88
2215,CHO,2022-11-07,100,,WAS,L 100-108,240,42,101,.416,37,69,.536,5,32,.156,11,16,.688,100,42,80,.525,37,61,.607,5,19,.263,19,30,.633,108
2216,LAL,2022-11-06,100,,CLE,L 100-114,240,40,87,.460,32,60,.533,8,27,.296,12,21,.571,100,37,84,.440,29,52,.558,8,32,.250,32,36,.889,114
2217,UTA,2022-11-02,100,@,DAL,L 100-103,240,39,84,.464,29,54,.537,10,30,.333,12,14,.857,100,42,84,.500,31,46,.674,11,38,.289,8,15,.533,103
2218,SAS,2022-11-02,100,,TOR,L 100-143,240,37,94,.394,23,51,.451,14,43,.326,12,14,.857,100,57,106,.538,43,73,.589,14,33,.424,15,16,.938,143
2219,CHI,2022-10-21,100,@,WAS,L 100-102,240,33,79,.418,26,52,.500,7,27,.259,27,33,.818,100,41,80,.513,31,54,.574,10,26,.385,10,11,.909,102
2220,MIL,2023-03-30,99,,BOS,L 99-140,240,38,101,.376,24,58,.414,14,43,.326,9,13,.692,99,51,91,.560,29,48,.604,22,43,.512,16,20,.800,140
2221,MIN,2023-03-26,99,@,GSW,W 99-96,240,34,80,.425,17,40,.425,17,40,.425,14,25,.560,99,34,82,.415,19,42,.452,15,40,.375,13,17,.765,96
2222,MIA,2023-03-18,99,@,CHI,L 99-113,240,35,82,.427,25,45,.556,10,37,.270,19,24,.792,99,45,80,.563,28,46,.609,17,34,.500,6,6,1.000,113
2223,NOP,2023-03-03,99,@,GSW,L 99-108,240,34,77,.442,24,48,.500,10,29,.345,21,27,.778,99,40,78,.513,30,47,.638,10,31,.323,18,20,.900,108
2224,IND,2023-03-02,99,@,SAS,L 99-110,240,41,90,.456,33,67,.493,8,23,.348,9,11,.818,99,45,98,.459,35,66,.530,10,32,.313,10,13,.769,110
2225,HOU,2023-03-01,99,,MEM,L 99-113,240,36,90,.400,25,56,.446,11,34,.324,16,25,.640,99,40,83,.482,23,42,.548,17,41,.415,16,19,.842,113
2226,PHI,2023-02-27,99,,MIA,L 99-101,240,32,73,.438,22,46,.478,10,27,.370,25,28,.893,99,35,81,.432,20,44,.455,15,37,.405,16,22,.727,101
2227,MIA,2023-02-24,99,@,MIL,L 99-128,240,36,92,.391,27,52,.519,9,40,.225,18,25,.720,99,47,98,.480,28,52,.538,19,46,.413,15,19,.789,128
2228,PHI,2023-02-08,99,@,BOS,L 99-106,240,37,83,.446,27,52,.519,10,31,.323,15,20,.750,99,40,76,.526,21,41,.512,19,35,.543,7,10,.700,106
2229,DET,2023-02-06,99,,BOS,L 99-111,240,37,87,.425,28,54,.519,9,33,.273,16,21,.762,99,39,83,.470,23,46,.500,16,37,.432,17,21,.810,111
2230,LAC,2023-01-29,99,@,CLE,L 99-122,240,37,89,.416,35,70,.500,2,19,.105,23,27,.852,99,44,78,.564,24,45,.533,20,33,.606,14,19,.737,122
2231,DAL,2023-01-26,99,@,PHO,W 99-95,240,33,77,.429,20,43,.465,13,34,.382,20,28,.714,99,35,86,.407,22,54,.407,13,32,.406,12,16,.750,95
2232,DEN,2023-01-25,99,@,MIL,L 99-107,240,38,97,.392,27,63,.429,11,34,.324,12,16,.750,99,37,78,.474,24,48,.500,13,30,.433,20,28,.714,107
2233,DEN,2023-01-24,99,@,NOP,W 99-98,240,39,80,.488,28,47,.596,11,33,.333,10,13,.769,99,38,85,.447,33,59,.559,5,26,.192,17,20,.850,98
2234,DEN,2023-01-22,99,,OKC,L 99-101,240,36,82,.439,26,54,.481,10,28,.357,17,33,.515,99,40,89,.449,33,63,.524,7,26,.269,14,16,.875,101
2235,CHI,2023-01-09,99,@,BOS,L 99-107,240,39,86,.453,27,51,.529,12,35,.343,9,14,.643,99,38,87,.437,27,46,.587,11,41,.268,20,21,.952,107
2236,POR,2023-01-06,99,@,IND,L 99-108,240,38,94,.404,29,61,.475,9,33,.273,14,17,.824,99,38,84,.452,31,59,.525,7,25,.280,25,28,.893,108
2237,MIN,2022-12-21,99,,DAL,L 99-104,240,42,85,.494,34,55,.618,8,30,.267,7,10,.700,99,34,75,.453,21,36,.583,13,39,.333,23,27,.852,104
2238,UTA,2022-12-19,99,@,CLE,L 99-122,240,36,93,.387,26,59,.441,10,34,.294,17,23,.739,99,43,70,.614,28,44,.636,15,26,.577,21,26,.808,122
2239,DAL,2022-12-17,99,@,CLE,L 99-100 (OT),265,36,88,.409,21,39,.538,15,49,.306,12,19,.632,99,40,94,.426,33,58,.569,7,36,.194,13,22,.591,100
2240,LAC,2022-12-14,99,,MIN,W 99-88,240,34,89,.382,20,43,.465,14,46,.304,17,21,.810,99,31,74,.419,27,52,.519,4,22,.182,22,30,.733,88
2241,SAC,2022-12-11,99,@,NYK,L 99-112,240,33,83,.398,23,44,.523,10,39,.256,23,35,.657,99,40,89,.449,32,54,.593,8,35,.229,24,27,.889,112
2242,TOR,2022-12-11,99,@,ORL,L 99-111,240,30,75,.400,24,50,.480,6,25,.240,33,38,.868,99,36,77,.468,22,46,.478,14,31,.452,25,31,.806,111
2243,SAS,2022-12-02,99,,NOP,L 99-117,240,38,98,.388,27,59,.458,11,39,.282,12,16,.750,99,40,92,.435,28,50,.560,12,42,.286,25,26,.962,117
2244,ORL,2022-11-25,99,,PHI,L 99-107,240,34,80,.425,25,45,.556,9,35,.257,22,27,.815,99,39,82,.476,25,46,.543,14,36,.389,15,18,.833,107
2245,DEN,2022-11-18,99,@,DAL,L 99-127,240,38,90,.422,28,60,.467,10,30,.333,13,18,.722,99,46,77,.597,33,45,.733,13,32,.406,22,28,.786,127
2246,IND,2022-11-18,99,@,HOU,W 99-91,240,33,82,.402,21,41,.512,12,41,.293,21,27,.778,99,29,86,.337,23,58,.397,6,28,.214,27,32,.844,91
2247,CHO,2022-11-04,99,@,MEM,L 99-130,240,33,86,.384,25,59,.424,8,27,.296,25,31,.806,99,50,98,.510,34,62,.548,16,36,.444,14,18,.778,130
2248,MIA,2022-11-04,99,@,IND,L 99-101,240,31,81,.383,20,42,.476,11,39,.282,26,26,1.000,99,37,80,.463,25,41,.610,12,39,.308,15,23,.652,101
2249,NYK,2022-11-02,99,,ATL,L 99-112,240,37,90,.411,27,54,.500,10,36,.278,15,20,.750,99,44,107,.411,32,73,.438,12,34,.353,12,16,.750,112
2250,BRK,2022-11-01,99,,CHI,L 99-108,240,36,74,.486,24,42,.571,12,32,.375,15,19,.789,99,39,89,.438,27,59,.458,12,30,.400,18,21,.857,108
2251,LAL,2022-10-26,99,@,DEN,L 99-110,240,40,90,.444,32,60,.533,8,30,.267,11,16,.688,99,42,92,.457,33,58,.569,9,34,.265,17,21,.810,110
2252,BRK,2022-10-26,99,@,MIL,L 99-110,240,34,86,.395,27,59,.458,7,27,.259,24,30,.800,99,39,88,.443,29,52,.558,10,36,.278,22,29,.759,110
2253,DET,2022-10-25,99,@,WAS,L 99-120,240,36,88,.409,28,60,.467,8,28,.286,19,25,.760,99,44,85,.518,34,52,.654,10,33,.303,22,26,.846,120
2254,UTA,2023-04-06,98,,OKC,L 98-114,240,41,83,.494,36,52,.692,5,31,.161,11,16,.688,98,39,97,.402,24,52,.462,15,45,.333,21,26,.808,114
2255,CHI,2023-02-28,98,@,TOR,L 98-104,240,37,71,.521,27,46,.587,10,25,.400,14,17,.824,98,38,94,.404,23,52,.442,15,42,.357,13,19,.684,104
2256,BRK,2023-02-11,98,,PHI,L 98-101,240,37,92,.402,24,52,.462,13,40,.325,11,13,.846,98,33,75,.440,27,52,.519,6,23,.261,29,30,.967,101
2257,SAS,2023-02-08,98,@,TOR,L 98-112,240,35,87,.402,26,55,.473,9,32,.281,19,27,.704,98,43,88,.489,33,60,.550,10,28,.357,16,21,.762,112
2258,ORL,2023-02-07,98,,NYK,L 98-102,240,37,79,.468,31,54,.574,6,25,.240,18,24,.750,98,37,81,.457,22,38,.579,15,43,.349,13,19,.684,102
2259,DEN,2023-02-05,98,@,MIN,L 98-128,240,34,71,.479,28,46,.609,6,25,.240,24,31,.774,98,48,87,.552,38,60,.633,10,27,.370,22,30,.733,128
2260,CHO,2023-02-02,98,@,CHI,L 98-114,240,39,93,.419,32,58,.552,7,35,.200,13,15,.867,98,41,79,.519,30,51,.588,11,28,.393,21,26,.808,114
2261,NOP,2023-01-24,98,,DEN,L 98-99,240,38,85,.447,33,59,.559,5,26,.192,17,20,.850,98,39,80,.488,28,47,.596,11,33,.333,10,13,.769,99
2262,MIA,2023-01-24,98,,BOS,W 98-95,240,34,94,.362,22,61,.361,12,33,.364,18,23,.783,98,32,74,.432,22,42,.524,10,32,.313,21,27,.778,95
2263,BOS,2023-01-23,98,@,ORL,L 98-113,240,36,83,.434,18,37,.486,18,46,.391,8,11,.727,98,43,84,.512,32,57,.561,11,27,.407,16,24,.667,113
2264,DAL,2023-01-22,98,,LAC,L 98-112,240,35,80,.438,22,45,.489,13,35,.371,15,26,.577,98,35,77,.455,23,49,.469,12,28,.429,30,31,.968,112
2265,NOP,2023-01-18,98,,MIA,L 98-124,240,37,80,.463,24,50,.480,13,30,.433,11,18,.611,98,50,94,.532,38,59,.644,12,35,.343,12,16,.750,124
2266,BRK,2023-01-17,98,@,SAS,L 98-106,240,37,88,.420,34,65,.523,3,23,.130,21,24,.875,98,37,97,.381,30,63,.476,7,34,.206,25,28,.893,106
2267,BRK,2023-01-12,98,,BOS,L 98-109,240,38,84,.452,25,50,.500,13,34,.382,9,11,.818,98,41,86,.477,29,50,.580,12,36,.333,15,17,.882,109
2268,PHO,2023-01-08,98,,CLE,L 98-112,240,37,84,.440,23,58,.397,14,26,.538,10,11,.909,98,45,78,.577,34,49,.694,11,29,.379,11,17,.647,112
2269,LAL,2022-12-28,98,@,MIA,L 98-112,240,37,77,.481,24,41,.585,13,36,.361,11,15,.733,98,44,92,.478,33,57,.579,11,35,.314,13,16,.813,112
2270,POR,2022-12-21,98,@,OKC,L 98-101,240,39,79,.494,25,43,.581,14,36,.389,6,9,.667,98,36,77,.468,28,53,.528,8,24,.333,21,25,.840,101
2271,DET,2022-12-07,98,@,NOP,L 98-104,240,35,90,.389,20,48,.417,15,42,.357,13,16,.813,98,39,85,.459,31,58,.534,8,27,.296,18,23,.783,104
2272,PHO,2022-12-07,98,,BOS,L 98-125,240,37,93,.398,29,61,.475,8,32,.250,16,19,.842,98,49,101,.485,33,56,.589,16,45,.356,11,13,.846,125
2273,ATL,2022-11-27,98,,MIA,L 98-106,240,35,88,.398,25,52,.481,10,36,.278,18,19,.947,98,40,82,.488,31,49,.633,9,33,.273,17,19,.895,106
2274,TOR,2022-11-23,98,,BRK,L 98-112,240,36,101,.356,29,72,.403,7,29,.241,19,25,.760,98,45,82,.549,28,44,.636,17,38,.447,5,7,.714,112
2275,DEN,2022-11-20,98,@,DAL,W 98-97,240,37,78,.474,28,51,.549,9,27,.333,15,19,.789,98,35,78,.449,20,36,.556,15,42,.357,12,21,.571,97
2276,CLE,2022-11-16,98,@,MIL,L 98-113,240,36,84,.429,24,56,.429,12,28,.429,14,17,.824,98,41,86,.477,25,47,.532,16,39,.410,15,27,.556,113
2277,UTA,2022-11-13,98,@,PHI,L 98-105,240,37,94,.394,26,57,.456,11,37,.297,13,23,.565,98,40,83,.482,36,60,.600,4,23,.174,21,26,.808,105
2278,MIL,2022-11-07,98,@,ATL,L 98-117,240,36,87,.414,23,47,.489,13,40,.325,13,16,.813,98,46,99,.465,35,70,.500,11,29,.379,14,17,.824,117
2279,BRK,2022-11-05,98,@,CHO,W 98-94,240,33,84,.393,21,48,.438,12,36,.333,20,22,.909,98,32,86,.372,18,44,.409,14,42,.333,16,23,.696,94
2280,MIN,2022-10-30,98,@,SAS,L 98-107,240,40,99,.404,36,70,.514,4,29,.138,14,20,.700,98,36,86,.419,20,46,.435,16,40,.400,19,25,.760,107
2281,POR,2022-10-26,98,,MIA,L 98-119,240,34,78,.436,22,41,.537,12,37,.324,18,26,.692,98,44,87,.506,29,49,.592,15,38,.395,16,19,.842,119
2282,TOR,2022-10-24,98,@,MIA,W 98-90,240,34,86,.395,20,54,.370,14,32,.438,16,20,.800,98,29,83,.349,21,49,.429,8,34,.235,24,27,.889,90
2283,ORL,2022-10-21,98,@,ATL,L 98-108,240,33,80,.413,25,46,.543,8,34,.235,24,30,.800,98,40,89,.449,27,58,.466,13,31,.419,15,16,.938,108
2284,SAC,2023-04-07,97,,GSW,L 97-119,240,38,98,.388,27,59,.458,11,39,.282,10,18,.556,97,41,78,.526,25,42,.595,16,36,.444,21,24,.875,119
2285,BOS,2023-04-05,97,,TOR,W 97-93,240,38,89,.427,27,51,.529,11,38,.289,10,18,.556,97,37,90,.411,31,57,.544,6,33,.182,13,17,.765,93
2286,DET,2023-03-24,97,@,TOR,L 97-118,240,34,73,.466,28,48,.583,6,25,.240,23,30,.767,97,41,92,.446,28,55,.509,13,37,.351,23,29,.793,118
2287,DET,2023-03-14,97,@,WAS,L 97-117,240,38,99,.384,28,65,.431,10,34,.294,11,12,.917,97,44,85,.518,37,53,.698,7,32,.219,22,22,1.000,117
2288,IND,2023-03-13,97,@,DET,L 97-117,240,36,86,.419,26,52,.500,10,34,.294,15,24,.625,97,48,100,.480,34,64,.531,14,36,.389,7,10,.700,117
2289,MEM,2023-03-03,97,@,DEN,L 97-113,240,31,84,.369,20,52,.385,11,32,.344,24,31,.774,97,40,87,.460,32,56,.571,8,31,.258,25,31,.806,113
2290,CLE,2023-02-11,97,,CHI,W 97-89,240,36,86,.419,27,51,.529,9,35,.257,16,19,.842,97,36,74,.486,31,53,.585,5,21,.238,12,15,.800,89
2291,MIA,2023-02-10,97,,HOU,W 97-95,240,32,77,.416,20,39,.513,12,38,.316,21,22,.955,97,35,84,.417,28,54,.519,7,30,.233,18,24,.750,95
2292,PHI,2023-02-05,97,@,NYK,L 97-108,240,30,74,.405,23,49,.469,7,25,.280,30,36,.833,97,34,79,.430,22,43,.512,12,36,.333,28,39,.718,108
2293,CLE,2023-01-31,97,,MIA,L 97-100,240,40,83,.482,29,43,.674,11,40,.275,6,12,.500,97,34,78,.436,20,47,.426,14,31,.452,18,25,.720,100
2294,CHO,2023-01-24,97,@,PHO,L 97-128,240,39,96,.406,33,71,.465,6,25,.240,13,18,.722,97,47,94,.500,25,55,.455,22,39,.564,12,13,.923,128
2295,PHO,2023-01-11,97,@,DEN,L 97-126,240,39,90,.433,30,58,.517,9,32,.281,10,14,.714,97,48,85,.565,33,51,.647,15,34,.441,15,21,.714,126
2296,CHI,2023-01-11,97,@,WAS,L 97-100,240,41,88,.466,32,59,.542,9,29,.310,6,9,.667,97,38,82,.463,31,59,.525,7,23,.304,17,21,.810,100
2297,UTA,2022-12-17,97,@,MIL,L 97-123,240,39,86,.453,23,39,.590,16,47,.340,3,6,.500,97,48,90,.533,30,52,.577,18,38,.474,9,11,.818,123
2298,PHO,2022-12-13,97,@,HOU,L 97-111,240,33,103,.320,20,52,.385,13,51,.255,18,19,.947,97,34,81,.420,22,46,.478,12,35,.343,31,34,.912,111
2299,HOU,2022-12-11,97,,MIL,W 97-92,240,40,91,.440,34,64,.531,6,27,.222,11,12,.917,97,33,90,.367,21,47,.447,12,43,.279,14,18,.778,92
2300,POR,2022-11-27,97,@,BRK,L 97-111,240,35,79,.443,23,46,.500,12,33,.364,15,22,.682,97,41,78,.526,26,43,.605,15,35,.429,14,18,.778,111
2301,DAL,2022-11-20,97,,DEN,L 97-98,240,35,78,.449,20,36,.556,15,42,.357,12,21,.571,97,37,78,.474,28,51,.549,9,27,.333,15,19,.789,98
2302,SAS,2022-11-19,97,@,LAC,L 97-119,240,36,87,.414,29,61,.475,7,26,.269,18,21,.857,97,44,81,.543,23,41,.561,21,40,.525,10,19,.526,119
2303,PHO,2022-11-11,97,@,ORL,L 97-114,240,38,95,.400,25,53,.472,13,42,.310,8,9,.889,97,43,82,.524,28,49,.571,15,33,.455,13,15,.867,114
2304,TOR,2022-11-07,97,@,CHI,L 97-111,240,36,85,.424,27,57,.474,9,28,.321,16,22,.727,97,42,80,.525,33,52,.635,9,28,.321,18,22,.818,111
2305,WAS,2022-11-06,97,@,MEM,L 97-103,240,41,96,.427,33,55,.600,8,41,.195,7,10,.700,97,39,91,.429,30,62,.484,9,29,.310,16,20,.800,103
2306,LAL,2022-10-20,97,,LAC,L 97-103,240,33,94,.351,24,49,.490,9,45,.200,22,26,.846,97,37,80,.463,28,51,.549,9,29,.310,20,31,.645,103
2307,GSW,2023-03-26,96,,MIN,L 96-99,240,34,82,.415,19,42,.452,15,40,.375,13,17,.765,96,34,80,.425,17,40,.425,17,40,.425,14,25,.560,99
2308,POR,2023-03-24,96,,CHI,L 96-124,240,37,86,.430,31,55,.564,6,31,.194,16,18,.889,96,48,84,.571,31,56,.554,17,28,.607,11,14,.786,124
2309,CHO,2023-03-23,96,@,NOP,L 96-115,240,38,83,.458,29,46,.630,9,37,.243,11,16,.688,96,45,98,.459,34,64,.531,11,34,.324,14,15,.933,115
2310,BRK,2023-03-16,96,,SAC,L 96-101,240,33,80,.413,19,41,.463,14,39,.359,16,23,.696,96,32,82,.390,19,41,.463,13,41,.317,24,32,.750,101
2311,NOP,2023-03-11,96,,OKC,L 96-110,240,34,81,.420,22,47,.468,12,34,.353,16,19,.842,96,37,80,.463,28,52,.538,9,28,.321,27,32,.844,110
2312,DEN,2023-03-08,96,,CHI,L 96-117,240,37,88,.420,22,48,.458,15,40,.375,7,15,.467,96,46,89,.517,38,65,.585,8,24,.333,17,18,.944,117
2313,HOU,2023-03-07,96,,BRK,L 96-118,240,36,83,.434,29,57,.509,7,26,.269,17,24,.708,96,40,81,.494,25,41,.610,15,40,.375,23,29,.793,118
2314,MIA,2023-03-01,96,,PHI,L 96-119,240,34,78,.436,27,49,.551,7,29,.241,21,23,.913,96,41,83,.494,26,44,.591,15,39,.385,22,22,1.000,119
2315,HOU,2023-02-15,96,@,OKC,L 96-133,240,30,89,.337,20,52,.385,10,37,.270,26,38,.684,96,42,87,.483,33,53,.623,9,34,.265,40,47,.851,133
2316,BRK,2023-02-01,96,@,BOS,L 96-139,240,36,88,.409,27,49,.551,9,39,.231,15,18,.833,96,53,92,.576,27,38,.711,26,54,.481,7,10,.700,139
2317,CHI,2023-01-26,96,@,CHO,L 96-111,240,37,91,.407,33,66,.500,4,25,.160,18,22,.818,96,39,84,.464,32,52,.615,7,32,.219,26,31,.839,111
2318,NOP,2023-01-22,96,@,MIA,L 96-100,240,37,78,.474,29,48,.604,8,30,.267,14,18,.778,96,35,80,.438,27,46,.587,8,34,.235,22,27,.815,100
2319,HOU,2023-01-08,96,,MIN,L 96-104,240,38,89,.427,27,53,.509,11,36,.306,9,15,.600,96,38,80,.475,28,52,.538,10,28,.357,18,22,.818,104
2320,PHO,2023-01-06,96,,MIA,L 96-104,240,34,82,.415,28,59,.475,6,23,.261,22,25,.880,96,33,78,.423,21,40,.525,12,38,.316,26,31,.839,104
2321,OKC,2022-12-31,96,,PHI,L 96-115,240,35,92,.380,23,56,.411,12,36,.333,14,22,.636,96,46,99,.465,35,65,.538,11,34,.324,12,17,.706,115
2322,MIA,2022-12-06,96,,DET,L 96-116,240,33,77,.429,23,45,.511,10,32,.313,20,26,.769,96,43,87,.494,24,46,.522,19,41,.463,11,15,.733,116
2323,CHO,2022-12-03,96,,MIL,L 96-105,240,34,87,.391,29,63,.460,5,24,.208,23,26,.885,96,39,83,.470,27,51,.529,12,32,.375,15,19,.789,105
2324,LAC,2022-12-03,96,,SAC,L 96-123,240,33,93,.355,24,60,.400,9,33,.273,21,26,.808,96,46,89,.517,35,57,.614,11,32,.344,20,30,.667,123
2325,ORL,2022-12-02,96,@,CLE,L 96-107,240,40,81,.494,32,58,.552,8,23,.348,8,12,.667,96,41,84,.488,25,42,.595,16,42,.381,9,9,1.000,107
2326,POR,2022-11-23,96,@,CLE,L 96-114,240,35,78,.449,22,47,.468,13,31,.419,13,13,1.000,96,41,74,.554,29,47,.617,12,27,.444,20,23,.870,114
2327,LAC,2022-11-17,96,,DET,W 96-91,240,33,81,.407,22,51,.431,11,30,.367,19,24,.792,96,33,88,.375,27,57,.474,6,31,.194,19,24,.792,91
2328,DAL,2022-11-07,96,,BRK,W 96-94,240,32,72,.444,20,44,.455,12,28,.429,20,24,.833,96,35,80,.438,25,51,.490,10,29,.345,14,19,.737,94
2329,CHI,2022-10-22,96,,CLE,L 96-128,240,34,84,.405,27,55,.491,7,29,.241,21,25,.840,96,48,85,.565,32,58,.552,16,27,.593,16,18,.889,128
2330,MEM,2022-10-22,96,@,DAL,L 96-137,240,34,79,.430,25,46,.543,9,33,.273,19,24,.792,96,45,90,.500,28,51,.549,17,39,.436,30,36,.833,137
2331,SAC,2023-04-09,95,@,DEN,L 95-109,240,37,85,.435,26,42,.619,11,43,.256,10,15,.667,95,42,84,.500,35,56,.625,7,28,.250,18,25,.720,109
2332,CLE,2023-04-09,95,,CHO,L 95-106,240,35,89,.393,25,52,.481,10,37,.270,15,16,.938,95,37,81,.457,31,49,.633,6,32,.188,26,30,.867,106
2333,IND,2023-03-24,95,@,BOS,L 95-120,240,39,84,.464,35,58,.603,4,26,.154,13,22,.591,95,44,93,.473,26,51,.510,18,42,.429,14,19,.737,120
2334,NYK,2023-03-11,95,@,LAC,L 95-106,240,32,90,.356,25,59,.424,7,31,.226,24,27,.889,95,42,87,.483,32,57,.561,10,30,.333,12,16,.750,106
2335,TOR,2023-02-25,95,@,DET,W 95-91,240,33,88,.375,26,62,.419,7,26,.269,22,34,.647,95,38,94,.404,32,70,.457,6,24,.250,9,14,.643,91
2336,HOU,2023-02-10,95,@,MIA,L 95-97,240,35,84,.417,28,54,.519,7,30,.233,18,24,.750,95,32,77,.416,20,39,.513,12,38,.316,21,22,.955,97
2337,HOU,2023-01-26,95,,CLE,L 95-113,240,39,76,.513,34,55,.618,5,21,.238,12,20,.600,95,40,87,.460,25,51,.490,15,36,.417,18,22,.818,113
2338,PHO,2023-01-26,95,,DAL,L 95-99,240,35,86,.407,22,54,.407,13,32,.406,12,16,.750,95,33,77,.429,20,43,.465,13,34,.382,20,28,.714,99
2339,SAC,2023-01-25,95,,TOR,L 95-113,240,35,73,.479,22,41,.537,13,32,.406,12,13,.923,95,48,97,.495,36,57,.632,12,40,.300,5,7,.714,113
2340,BOS,2023-01-24,95,@,MIA,L 95-98,240,32,74,.432,22,42,.524,10,32,.313,21,27,.778,95,34,94,.362,22,61,.361,12,33,.364,18,23,.783,98
2341,POR,2023-01-19,95,,PHI,L 95-105,240,32,85,.376,23,48,.479,9,37,.243,22,29,.759,95,41,81,.506,33,55,.600,8,26,.308,15,19,.789,105
2342,MIL,2023-01-14,95,@,MIA,L 95-111,240,34,84,.405,15,36,.417,19,48,.396,8,12,.667,95,45,87,.517,34,65,.523,11,22,.500,10,12,.833,111
2343,DAL,2023-01-05,95,,BOS,L 95-124,240,34,90,.378,27,58,.466,7,32,.219,20,25,.800,95,41,84,.488,25,41,.610,16,43,.372,26,31,.839,124
2344,MIL,2023-01-01,95,,WAS,L 95-118,240,34,96,.354,21,47,.447,13,49,.265,14,15,.933,95,50,94,.532,43,67,.642,7,27,.259,11,16,.688,118
2345,ORL,2022-12-18,95,@,BOS,W 95-92,240,33,86,.384,21,57,.368,12,29,.414,17,19,.895,95,31,89,.348,19,42,.452,12,47,.255,18,21,.857,92
2346,HOU,2022-12-17,95,,POR,L 95-107,240,36,90,.400,33,61,.541,3,29,.103,20,29,.690,95,40,85,.471,27,49,.551,13,36,.361,14,19,.737,107
2347,LAC,2022-12-15,95,,PHO,L 95-111,240,34,90,.378,22,57,.386,12,33,.364,15,21,.714,95,44,95,.463,35,63,.556,9,32,.281,14,18,.778,111
2348,CLE,2022-12-09,95,,SAC,L 95-106,240,34,79,.430,24,49,.490,10,30,.333,17,22,.773,95,35,66,.530,19,33,.576,16,33,.485,20,32,.625,106
2349,SAS,2022-12-04,95,,PHO,L 95-133,240,38,87,.437,32,56,.571,6,31,.194,13,18,.722,95,49,94,.521,30,57,.526,19,37,.514,16,20,.800,133
2350,NYK,2022-11-20,95,@,PHO,L 95-116,240,34,85,.400,27,60,.450,7,25,.280,20,25,.800,95,43,101,.426,26,62,.419,17,39,.436,13,18,.722,116
2351,SAS,2022-11-14,95,@,GSW,L 95-132,240,36,100,.360,26,60,.433,10,40,.250,13,19,.684,95,47,88,.534,24,43,.558,23,45,.511,15,16,.938,132
2352,LAC,2022-11-12,95,,BRK,L 95-110,240,34,85,.400,23,54,.426,11,31,.355,16,20,.800,95,40,83,.482,24,48,.500,16,35,.457,14,21,.667,110
2353,NOP,2022-11-10,95,,POR,L 95-106,240,33,79,.418,23,51,.451,10,28,.357,19,24,.792,95,37,85,.435,25,51,.490,12,34,.353,20,26,.769,106
2354,PHI,2022-11-10,95,@,ATL,L 95-104,240,32,83,.386,26,53,.491,6,30,.200,25,30,.833,95,39,88,.443,33,62,.532,6,26,.231,20,23,.870,104
2355,CHO,2022-11-09,95,,POR,L 95-105,240,34,91,.374,24,51,.471,10,40,.250,17,24,.708,95,40,75,.533,29,41,.707,11,34,.324,14,25,.560,105
2356,LAC,2022-10-31,95,,HOU,W 95-93,240,37,87,.425,28,51,.549,9,36,.250,12,17,.706,95,34,88,.386,26,60,.433,8,28,.286,17,23,.739,93
2357,LAC,2022-10-23,95,,PHO,L 95-112,240,36,82,.439,27,50,.540,9,32,.281,14,20,.700,95,43,93,.462,28,51,.549,15,42,.357,11,12,.917,112
2358,ORL,2023-04-06,94,,CLE,L 94-118,240,33,83,.398,20,44,.455,13,39,.333,15,19,.789,94,46,88,.523,28,50,.560,18,38,.474,8,9,.889,118
2359,SAS,2023-04-04,94,@,PHO,L 94-115,240,35,90,.389,22,50,.440,13,40,.325,11,14,.786,94,43,89,.483,33,56,.589,10,33,.303,19,26,.731,115
2360,LAC,2023-03-31,94,@,MEM,L 94-108,240,34,90,.378,23,55,.418,11,35,.314,15,18,.833,94,43,96,.448,34,63,.540,9,33,.273,13,17,.765,108
2361,SAS,2023-03-22,94,@,MIL,L 94-130,240,36,93,.387,27,54,.500,9,39,.231,13,20,.650,94,51,98,.520,36,55,.655,15,43,.349,13,24,.542,130
2362,WAS,2023-03-17,94,@,CLE,L 94-117,240,35,76,.461,27,53,.509,8,23,.348,16,20,.800,94,48,87,.552,44,68,.647,4,19,.211,17,22,.773,117
2363,MIN,2023-03-07,94,,PHI,L 94-117,240,34,86,.395,23,50,.460,11,36,.306,15,21,.714,94,40,81,.494,25,56,.446,15,25,.600,22,23,.957,117
2364,UTA,2023-02-28,94,,SAS,L 94-102,240,30,85,.353,20,51,.392,10,34,.294,24,36,.667,94,39,91,.429,31,65,.477,8,26,.308,16,25,.640,102
2365,BOS,2023-02-27,94,@,NYK,L 94-109,240,37,84,.440,28,42,.667,9,42,.214,11,14,.786,94,37,78,.474,25,47,.532,12,31,.387,23,34,.676,109
2366,DEN,2023-02-25,94,@,MEM,L 94-112,240,36,89,.404,25,52,.481,11,37,.297,11,14,.786,94,45,95,.474,30,51,.588,15,44,.341,7,8,.875,112
2367,BOS,2023-02-03,94,,PHO,L 94-106,240,29,75,.387,19,37,.514,10,38,.263,26,31,.839,94,41,95,.432,29,63,.460,12,32,.375,12,14,.857,106
2368,ORL,2023-02-01,94,@,PHI,L 94-105,240,33,87,.379,27,49,.551,6,38,.158,22,29,.759,94,34,78,.436,20,43,.465,14,35,.400,23,26,.885,105
2369,GSW,2022-12-20,94,@,NYK,L 94-132,240,35,74,.473,23,39,.590,12,35,.343,12,13,.923,94,45,87,.517,28,47,.596,17,40,.425,25,32,.781,132
2370,DET,2022-11-27,94,,CLE,L 94-102,240,36,79,.456,28,51,.549,8,28,.286,14,26,.538,94,33,77,.429,25,49,.510,8,28,.286,28,33,.848,102
2371,SAS,2022-11-25,94,,LAL,L 94-105,240,38,100,.380,32,67,.478,6,33,.182,12,16,.750,94,40,83,.482,32,56,.571,8,27,.296,17,20,.850,105
2372,ORL,2022-11-09,94,,DAL,W 94-87,240,36,73,.493,28,52,.538,8,21,.381,14,21,.667,94,32,85,.376,21,43,.488,11,42,.262,12,19,.632,87
2373,BRK,2022-11-07,94,@,DAL,L 94-96,240,35,80,.438,25,51,.490,10,29,.345,14,19,.737,94,32,72,.444,20,44,.455,12,28,.429,20,24,.833,96
2374,CHO,2022-11-05,94,,BRK,L 94-98,240,32,86,.372,18,44,.409,14,42,.333,16,23,.696,94,33,84,.393,21,48,.438,12,36,.333,20,22,.909,98
2375,OKC,2022-11-05,94,@,MIL,L 94-108,240,36,84,.429,24,49,.490,12,35,.343,10,16,.625,94,38,90,.422,21,43,.488,17,47,.362,15,17,.882,108
2376,WAS,2022-10-30,94,@,BOS,L 94-112,240,38,98,.388,31,66,.470,7,32,.219,11,16,.688,94,36,79,.456,15,32,.469,21,47,.447,19,20,.950,112
2377,LAC,2022-10-25,94,@,OKC,L 94-108,240,35,83,.422,25,52,.481,10,31,.323,14,18,.778,94,42,110,.382,38,80,.475,4,30,.133,20,25,.800,108
2378,TOR,2023-04-05,93,@,BOS,L 93-97,240,37,90,.411,31,57,.544,6,33,.182,13,17,.765,93,38,89,.427,27,51,.529,11,38,.289,10,18,.556,97
2379,DEN,2023-03-31,93,@,PHO,L 93-100,240,38,95,.400,32,69,.464,6,26,.231,11,20,.550,93,37,88,.420,27,61,.443,10,27,.370,16,21,.762,100
2380,SAS,2023-03-26,93,@,BOS,L 93-137,240,36,97,.371,28,61,.459,8,36,.222,13,18,.722,93,52,91,.571,34,47,.723,18,44,.409,15,21,.714,137
2381,WAS,2023-03-12,93,@,PHI,L 93-112,240,34,84,.405,28,58,.483,6,26,.231,19,23,.826,93,41,80,.513,30,51,.588,11,29,.379,19,23,.826,112
2382,POR,2023-03-08,93,@,BOS,L 93-115,240,30,82,.366,19,43,.442,11,39,.282,22,27,.815,93,42,88,.477,24,39,.615,18,49,.367,13,20,.650,115
2383,NOP,2023-02-27,93,,ORL,L 93-101,240,34,76,.447,28,49,.571,6,27,.222,19,23,.826,93,36,79,.456,27,45,.600,9,34,.265,20,26,.769,101
2384,TOR,2023-02-26,93,@,CLE,L 93-118,240,36,93,.387,27,68,.397,9,25,.360,12,15,.800,93,44,84,.524,26,48,.542,18,36,.500,12,14,.857,118
2385,IND,2022-12-26,93,@,NOP,L 93-113,240,35,83,.422,26,48,.542,9,35,.257,14,20,.700,93,41,90,.456,29,50,.580,12,40,.300,19,24,.792,113
2386,DET,2022-12-21,93,@,PHI,L 93-113,240,31,79,.392,25,56,.446,6,23,.261,25,34,.735,93,41,93,.441,30,56,.536,11,37,.297,20,22,.909,113
2387,WAS,2022-12-17,93,@,LAC,L 93-102,240,36,84,.429,27,59,.458,9,25,.360,12,13,.923,93,37,86,.430,25,57,.439,12,29,.414,16,26,.615,102
2388,BOS,2022-12-12,93,@,LAC,L 93-113,240,33,76,.434,24,37,.649,9,39,.231,18,26,.692,93,44,90,.489,34,65,.523,10,25,.400,15,21,.714,113
2389,MIA,2022-12-05,93,@,MEM,L 93-101,240,31,79,.392,17,39,.436,14,40,.350,17,22,.773,93,42,90,.467,34,58,.586,8,32,.250,9,9,1.000,101
2390,MIL,2022-11-11,93,@,SAS,L 93-111,240,32,98,.327,20,55,.364,12,43,.279,17,23,.739,93,43,85,.506,31,54,.574,12,31,.387,13,15,.867,111
2391,HOU,2022-10-31,93,@,LAC,L 93-95,240,34,88,.386,26,60,.433,8,28,.286,17,23,.739,93,37,87,.425,28,51,.549,9,36,.250,12,17,.706,95
2392,CHO,2022-10-28,93,@,ORL,L 93-113,240,33,86,.384,22,48,.458,11,38,.289,16,24,.667,93,42,85,.494,32,48,.667,10,37,.270,19,26,.731,113
2393,CHI,2023-04-05,92,@,MIL,L 92-105,240,36,83,.434,25,50,.500,11,33,.333,9,11,.818,92,39,92,.424,21,46,.457,18,46,.391,9,11,.818,105
2394,MIA,2023-03-29,92,@,NYK,L 92-101,240,35,79,.443,22,40,.550,13,39,.333,9,14,.643,92,38,76,.500,25,45,.556,13,31,.419,12,23,.522,101
2395,MIA,2023-03-28,92,@,TOR,L 92-106,240,32,80,.400,22,47,.468,10,33,.303,18,19,.947,92,45,93,.484,37,57,.649,8,36,.222,8,9,.889,106
2396,BOS,2022-12-18,92,,ORL,L 92-95,240,31,89,.348,19,42,.452,12,47,.255,18,21,.857,92,33,86,.384,21,57,.368,12,29,.414,17,19,.895,95
2397,MIL,2022-12-11,92,@,HOU,L 92-97,240,33,90,.367,21,47,.447,12,43,.279,14,18,.778,92,40,91,.440,34,64,.531,6,27,.222,11,12,.917,97
2398,NYK,2022-12-04,92,,CLE,W 92-81,240,35,86,.407,30,57,.526,5,29,.172,17,21,.810,92,29,83,.349,21,48,.438,8,35,.229,15,20,.750,81
2399,BRK,2022-12-04,92,,BOS,L 92-103,240,34,84,.405,25,58,.431,9,26,.346,15,22,.682,92,35,81,.432,20,43,.465,15,38,.395,18,20,.900,103
2400,SAS,2022-11-20,92,@,LAL,L 92-123,240,41,105,.390,34,71,.479,7,34,.206,3,10,.300,92,45,85,.529,33,51,.647,12,34,.353,21,24,.875,123
2401,DAL,2022-11-16,92,,HOU,L 92-101,240,31,102,.304,19,47,.404,12,55,.218,18,19,.947,92,35,75,.467,25,53,.472,10,22,.455,21,24,.875,101
2402,MEM,2022-11-13,92,@,WAS,L 92-102,240,38,96,.396,29,68,.426,9,28,.321,7,10,.700,92,36,86,.419,17,46,.370,19,40,.475,11,21,.524,102
2403,ORL,2022-10-26,92,@,CLE,L 92-103,240,35,81,.432,29,57,.509,6,24,.250,16,21,.762,92,36,87,.414,26,54,.481,10,33,.303,21,30,.700,103
2404,CHO,2023-03-31,91,,CHI,L 91-121,240,35,77,.455,21,40,.525,14,37,.378,7,10,.700,91,45,88,.511,32,57,.561,13,31,.419,18,22,.818,121
2405,HOU,2023-03-26,91,@,CLE,L 91-108,240,35,80,.438,29,55,.527,6,25,.240,15,18,.833,91,39,83,.470,30,53,.566,9,30,.300,21,24,.875,108
2406,CHI,2023-03-22,91,,PHI,L 91-116,240,34,83,.410,28,58,.483,6,25,.240,17,22,.773,91,39,82,.476,23,45,.511,16,37,.432,22,26,.846,116
2407,LAC,2023-03-02,91,@,GSW,L 91-115,240,32,89,.360,23,46,.500,9,43,.209,18,21,.857,91,39,93,.419,25,47,.532,14,46,.304,23,27,.852,115
2408,CHO,2023-03-01,91,,PHO,L 91-105,240,32,88,.364,23,55,.418,9,33,.273,18,28,.643,91,42,89,.472,33,64,.516,9,25,.360,12,15,.800,105
2409,DET,2023-02-25,91,,TOR,L 91-95,240,38,94,.404,32,70,.457,6,24,.250,9,14,.643,91,33,88,.375,26,62,.419,7,26,.269,22,34,.647,95
2410,CHI,2023-02-13,91,,ORL,L 91-100,240,35,86,.407,32,65,.492,3,21,.143,18,19,.947,91,38,81,.469,30,54,.556,8,27,.296,16,19,.842,100
2411,WAS,2023-02-06,91,,CLE,L 91-114,240,35,82,.427,29,54,.537,6,28,.214,15,19,.789,91,44,78,.564,32,49,.653,12,29,.414,14,20,.700,114
2412,LAC,2023-01-05,91,@,DEN,L 91-122,240,34,91,.374,29,54,.537,5,37,.135,18,25,.720,91,45,89,.506,31,53,.585,14,36,.389,18,21,.857,122
2413,MEM,2022-12-20,91,@,DEN,L 91-105,240,36,81,.444,31,55,.564,5,26,.192,14,21,.667,91,40,89,.449,30,62,.484,10,27,.370,15,25,.600,105
2414,CHI,2022-12-16,91,,NYK,L 91-114,240,36,77,.468,24,47,.511,12,30,.400,7,8,.875,91,37,92,.402,20,48,.417,17,44,.386,23,32,.719,114
2415,HOU,2022-11-18,91,,IND,L 91-99,240,29,86,.337,23,58,.397,6,28,.214,27,32,.844,91,33,82,.402,21,41,.512,12,41,.293,21,27,.778,99
2416,DET,2022-11-17,91,@,LAC,L 91-96,240,33,88,.375,27,57,.474,6,31,.194,19,24,.792,91,33,81,.407,22,51,.431,11,30,.367,19,24,.792,96
2417,DET,2022-11-02,91,@,MIL,L 91-116,240,33,79,.418,22,48,.458,11,31,.355,14,15,.933,91,43,92,.467,33,54,.611,10,38,.263,20,24,.833,116
2418,LAC,2022-10-30,91,,NOP,L 91-112,240,36,86,.419,25,47,.532,11,39,.282,8,13,.615,91,46,93,.495,31,57,.544,15,36,.417,5,8,.625,112
2419,POR,2023-03-27,90,,NOP,L 90-124,240,35,90,.389,28,57,.491,7,33,.212,13,15,.867,90,49,86,.570,37,58,.638,12,28,.429,14,17,.824,124
2420,SAS,2023-03-12,90,,OKC,L 90-102,240,33,88,.375,23,52,.442,10,36,.278,14,19,.737,90,36,95,.379,26,56,.464,10,39,.256,20,23,.870,102
2421,DET,2023-03-04,90,@,CLE,L 90-114,240,33,81,.407,27,57,.474,6,24,.250,18,25,.720,90,45,91,.495,31,57,.544,14,34,.412,10,18,.556,114
2422,MIA,2023-01-20,90,@,DAL,L 90-115,240,33,69,.478,29,49,.592,4,20,.200,20,27,.741,90,37,80,.463,19,42,.452,18,38,.474,23,28,.821,115
2423,CLE,2023-01-04,90,,PHO,W 90-88,240,30,77,.390,19,41,.463,11,36,.306,19,23,.826,90,32,81,.395,22,53,.415,10,28,.357,14,18,.778,88
2424,DAL,2022-12-14,90,,CLE,L 90-105,240,29,74,.392,16,36,.444,13,38,.342,19,26,.731,90,41,78,.526,33,54,.611,8,24,.333,15,19,.789,105
2425,TOR,2022-10-28,90,,PHI,L 90-112,240,33,86,.384,24,47,.511,9,39,.231,15,24,.625,90,43,82,.524,27,44,.614,16,38,.421,10,11,.909,112
2426,MIA,2022-10-24,90,,TOR,L 90-98,240,29,83,.349,21,49,.429,8,34,.235,24,27,.889,90,34,86,.395,20,54,.370,14,32,.438,16,20,.800,98
2427,MIL,2022-10-20,90,@,PHI,W 90-88,240,34,84,.405,21,42,.500,13,42,.310,9,14,.643,90,36,83,.434,31,59,.525,5,24,.208,11,13,.846,88
2428,CHI,2023-02-11,89,@,CLE,L 89-97,240,36,74,.486,31,53,.585,5,21,.238,12,15,.800,89,36,86,.419,27,51,.529,9,35,.257,16,19,.842,97
2429,CHI,2023-02-07,89,@,MEM,L 89-104,240,32,87,.368,25,52,.481,7,35,.200,18,27,.667,89,39,81,.481,28,48,.583,11,33,.333,15,21,.714,104
2430,ATL,2022-12-07,89,@,NYK,L 89-113,240,32,85,.376,26,49,.531,6,36,.167,19,24,.792,89,37,83,.446,20,47,.426,17,36,.472,22,24,.917,113
2431,DEN,2023-03-30,88,,NOP,L 88-107,240,32,80,.400,28,52,.538,4,28,.143,20,32,.625,88,38,80,.475,25,53,.472,13,27,.481,18,22,.818,107
2432,DAL,2023-03-13,88,,MEM,L 88-104,240,35,90,.389,23,44,.523,12,46,.261,6,8,.750,88,38,83,.458,26,46,.565,12,37,.324,16,19,.842,104
2433,PHO,2023-01-04,88,@,CLE,L 88-90,240,32,81,.395,22,53,.415,10,28,.357,14,18,.778,88,30,77,.390,19,41,.463,11,36,.306,19,23,.826,90
2434,HOU,2022-12-31,88,,NYK,L 88-108,240,29,77,.377,15,31,.484,14,46,.304,16,23,.696,88,35,90,.389,20,39,.513,15,51,.294,23,32,.719,108
2435,MIN,2022-12-14,88,@,LAC,L 88-99,240,31,74,.419,27,52,.519,4,22,.182,22,30,.733,88,34,89,.382,20,43,.465,14,46,.304,17,21,.810,99
2436,CLE,2022-11-28,88,@,TOR,L 88-100,240,34,90,.378,27,52,.519,7,38,.184,13,16,.813,88,37,84,.440,25,56,.446,12,28,.429,14,17,.824,100
2437,PHO,2022-11-07,88,@,PHI,L 88-100,240,32,73,.438,26,54,.481,6,19,.316,18,22,.818,88,31,80,.388,19,48,.396,12,32,.375,26,31,.839,100
2438,DET,2022-11-04,88,,CLE,L 88-112,240,31,83,.373,18,46,.391,13,37,.351,13,15,.867,88,44,81,.543,33,55,.600,11,26,.423,13,16,.813,112
2439,CHO,2022-11-02,88,@,CHI,L 88-106,240,36,92,.391,29,60,.483,7,32,.219,9,16,.563,88,38,88,.432,24,57,.421,14,31,.452,16,18,.889,106
2440,PHI,2022-10-20,88,,MIL,L 88-90,240,36,83,.434,31,59,.525,5,24,.208,11,13,.846,88,34,84,.405,21,42,.500,13,42,.310,9,14,.643,90
2441,BRK,2023-02-24,87,@,CHI,L 87-131,240,30,81,.370,18,37,.486,12,44,.273,15,19,.789,87,50,88,.568,38,62,.613,12,26,.462,19,28,.679,131
2442,MIA,2022-12-12,87,@,IND,W 87-82,240,32,83,.386,23,49,.469,9,34,.265,14,18,.778,87,28,79,.354,17,40,.425,11,39,.282,15,20,.750,82
2443,MIA,2022-11-20,87,@,CLE,L 87-113,240,31,80,.388,25,49,.510,6,31,.194,19,22,.864,87,44,83,.530,31,46,.674,13,37,.351,12,16,.750,113
2444,DAL,2022-11-09,87,@,ORL,L 87-94,240,32,85,.376,21,43,.488,11,42,.262,12,19,.632,87,36,73,.493,28,52,.538,8,21,.381,14,21,.667,94
2445,CHO,2023-03-05,86,@,BRK,L 86-102,240,33,88,.375,25,58,.431,8,30,.267,12,15,.800,86,36,92,.391,24,49,.490,12,43,.279,18,22,.818,102
2446,WAS,2022-11-04,86,,BRK,L 86-128,240,30,83,.361,22,49,.449,8,34,.235,18,22,.818,86,50,90,.556,36,62,.581,14,28,.500,14,14,1.000,128
2447,DET,2023-02-08,85,@,CLE,L 85-113,240,30,81,.370,22,49,.449,8,32,.250,17,18,.944,85,43,87,.494,37,61,.607,6,26,.231,21,25,.840,113
2448,PHI,2022-11-30,85,@,CLE,L 85-113,240,32,77,.416,26,51,.510,6,26,.231,15,18,.833,85,45,74,.608,30,45,.667,15,29,.517,8,10,.800,113
2449,NYK,2022-11-09,85,@,BRK,L 85-112,240,28,87,.322,16,44,.364,12,43,.279,17,26,.654,85,42,87,.483,28,53,.528,14,34,.412,14,20,.700,112
2450,ORL,2023-04-07,84,@,BRK,L 84-101,240,31,87,.356,24,49,.490,7,38,.184,15,17,.882,84,35,89,.393,26,47,.553,9,42,.214,22,25,.880,101
2451,SAS,2023-03-21,84,@,NOP,L 84-119,240,30,87,.345,17,46,.370,13,41,.317,11,19,.579,84,45,81,.556,35,57,.614,10,24,.417,19,23,.826,119
2452,PHO,2023-01-02,83,@,NYK,L 83-102,240,34,87,.391,24,50,.480,10,37,.270,5,7,.714,83,36,74,.486,23,41,.561,13,33,.394,17,25,.680,102
2453,GSW,2022-11-21,83,@,NOP,L 83-128,240,28,74,.378,18,31,.581,10,43,.233,17,19,.895,83,49,91,.538,34,49,.694,15,42,.357,15,21,.714,128
2454,CHO,2023-03-17,82,,PHI,L 82-121,240,29,86,.337,24,51,.471,5,35,.143,19,26,.731,82,46,92,.500,36,60,.600,10,32,.313,19,25,.760,121
2455,WAS,2023-02-26,82,@,CHI,L 82-102,240,32,76,.421,26,48,.542,6,28,.214,12,23,.522,82,40,79,.506,32,49,.653,8,30,.267,14,17,.824,102
2456,IND,2022-12-12,82,,MIA,L 82-87,240,28,79,.354,17,40,.425,11,39,.282,15,20,.750,82,32,83,.386,23,49,.469,9,34,.265,14,18,.778,87
2457,POR,2022-11-05,82,@,PHO,L 82-102,240,30,79,.380,23,64,.359,7,15,.467,15,24,.625,82,35,82,.427,24,52,.462,11,30,.367,21,28,.750,102
2458,DET,2023-04-09,81,@,CHI,L 81-103,240,31,85,.365,22,52,.423,9,33,.273,10,13,.769,81,40,95,.421,34,65,.523,6,30,.200,17,22,.773,103
2459,CLE,2022-12-04,81,@,NYK,L 81-92,240,29,83,.349,21,48,.438,8,35,.229,15,20,.750,81,35,86,.407,30,57,.526,5,29,.172,17,21,.810,92
2460,POR,2023-03-29,80,,SAC,L 80-120,240,30,93,.323,21,54,.389,9,39,.231,11,12,.917,80,42,92,.457,24,44,.545,18,48,.375,18,24,.750,120